CountyCityName,TownshipName,VillageName,PollStationNo,DistrictName,BallotsAccepted,BallotsRejected,BallotsCast,Voters,CandidateCounts,ElectedCounts,CandidateMaleCounts,CandidateFemaleCounts,ElectedMaleCounts,ElectedFemaleCounts,BallotsRate
全國,,,0,0,2105812,37964,2143776,3022067,215,94,169,46,67,27,70.94
臺北市,,,0,6,1342187,26366,1368553,1936966,109,51,81,28,34,17,70.65
臺北市,,,0,6,277603,6358,283961,396984,18,10,13,5,6,4,71.53
臺北市,,,0,6,184506,3217,187723,260070,12,7,7,5,5,2,72.18
臺北市,,,0,6,225514,4512,230026,327581,18,9,13,5,7,2,70.22
臺北市,,,0,6,176828,3871,180699,261591,16,7,13,3,5,2,69.08
臺北市,,,0,6,187081,3958,191039,271710,17,7,14,3,5,2,70.31
臺北市,,,0,6,290655,4450,295105,419030,28,11,21,7,6,5,70.43
高雄市,,,0,5,763625,11598,775223,1085101,106,43,88,18,33,10,71.44
高雄市,,,0,5,90649,1121,91770,126187,10,5,8,2,4,1,72.73
高雄市,,,0,5,160852,2208,163060,229552,22,9,19,3,7,2,71.03
高雄市,,,0,5,177153,2652,179805,256358,26,10,21,5,7,3,70.14
高雄市,,,0,5,155175,2575,157750,219877,22,9,18,4,7,2,71.74
高雄市,,,0,5,179796,3042,182838,253127,26,10,22,4,8,2,72.23
臺北市,北投區,,0,1,127313,3532,130845,181773,2,1,2,0,1,0,71.98
臺北市,士林區,,0,1,150290,2826,153116,215211,6,1,6,0,1,0,71.15
臺北市,內湖區,,0,2,126251,2100,128351,178193,3,1,3,0,1,0,72.03
臺北市,南港區,,0,2,58255,1117,59372,81877,3,1,2,1,1,0,72.51
臺北市,松山區,,0,3,102281,1988,104269,149587,4,1,4,0,1,0,69.70
臺北市,信義區,,0,3,123233,2524,125757,177994,3,1,2,1,0,1,70.65
臺北市,中山區,,0,4,110128,2431,112559,163767,2,1,2,0,1,0,68.73
臺北市,大同區,,0,4,66700,1440,68140,97824,4,1,4,0,1,0,69.66
臺北市,中正區,,0,5,79228,1820,81048,117084,2,1,2,0,1,0,69.22
臺北市,萬華區,,0,5,107853,2138,109991,154626,4,1,3,1,1,0,71.13
臺北市,大安區,,0,6,159003,2509,161512,234425,3,1,3,0,1,0,68.90
臺北市,文山區,,0,6,131652,1941,133593,184605,4,1,4,0,1,0,72.37
高雄市,鹽埕區,,0,1,17052,248,17300,23534,3,1,3,0,1,0,73.51
高雄市,鼓山區,,0,1,57100,698,57798,79919,4,1,4,0,1,0,72.32
高雄市,旗津區,,0,1,16497,175,16672,22734,2,1,2,0,1,0,73.34
高雄市,左營區,,0,2,84428,1311,85739,122030,4,1,2,2,1,0,70.26
高雄市,楠梓區,,0,2,76424,897,77321,107522,2,1,0,2,0,1,71.91
高雄市,三民區,,0,3,177153,2652,179805,256358,3,1,2,1,1,0,70.14
高雄市,新興區,,0,4,32982,527,33509,46829,3,1,3,0,1,0,71.56
高雄市,前金區,,0,4,17608,276,17884,25371,3,1,3,0,1,0,70.49
高雄市,苓雅區,,0,4,104585,1772,106357,147677,5,1,4,1,0,1,72.02
高雄市,前鎮區,,0,5,105289,1984,107273,147153,2,1,1,1,1,0,72.90
高雄市,小港區,,0,5,74507,1058,75565,105974,3,1,3,0,1,0,71.31
臺北市,北投區,建民里,0,1,2654,41,2695,3740,3,1,3,0,1,0,72.06
臺北市,北投區,文林里,0,1,2514,49,2563,3523,7,1,6,1,1,0,72.75
臺北市,北投區,石牌里,0,1,2979,70,3049,4278,2,1,2,0,1,0,71.27
臺北市,北投區,福興里,0,1,3890,73,3963,5342,5,1,5,0,1,0,74.19
臺北市,北投區,榮光里,0,1,3905,70,3975,5517,7,1,6,1,1,0,72.05
臺北市,北投區,榮華里,0,1,3997,87,4084,5803,3,1,3,0,1,0,70.38
臺北市,北投區,裕民里,0,1,3810,76,3886,5391,2,1,1,1,1,0,72.08
臺北市,北投區,振華里,0,1,4402,91,4493,6241,4,1,3,1,1,0,71.99
臺北市,北投區,永和里,0,1,4307,76,4383,6242,4,1,3,1,0,1,70.22
臺北市,北投區,永欣里,0,1,3503,79,3582,5059,4,1,4,0,1,0,70.80
臺北市,北投區,永明里,0,1,2550,54,2604,3580,2,1,2,0,1,0,72.74
臺北市,北投區,東華里,0,1,2719,37,2756,3620,2,1,1,1,1,0,76.13
臺北市,北投區,吉利里,0,1,3605,84,3689,5050,2,1,2,0,1,0,73.05
臺北市,北投區,吉慶里,0,1,2926,64,2990,4012,4,1,4,0,1,0,74.53
臺北市,北投區,尊賢里,0,1,2731,58,2789,3865,2,1,2,0,1,0,72.16
臺北市,北投區,立賢里,0,1,2940,64,3004,4103,3,1,3,0,1,0,73.21
臺北市,北投區,立農里,0,1,4773,74,4847,6506,2,1,2,0,1,0,74.50
臺北市,北投區,八仙里,0,1,2690,59,2749,3795,2,1,1,1,1,0,72.44
臺北市,北投區,洲美里,0,1,1057,14,1071,1419,2,1,2,0,1,0,75.48
臺北市,北投區,奇岩里,0,1,5126,132,5258,7387,1,1,1,0,1,0,71.18
臺北市,北投區,清江里,0,1,4876,136,5012,7042,3,1,2,1,1,0,71.17
臺北市,北投區,中央里,0,1,4080,140,4220,5960,3,1,2,1,1,0,70.81
臺北市,北投區,長安里,0,1,3114,94,3208,4506,3,1,3,0,1,0,71.19
臺北市,北投區,大同里,0,1,3265,106,3371,4679,3,1,3,0,1,0,72.05
臺北市,北投區,溫泉里,0,1,3471,102,3573,4983,3,1,3,0,1,0,71.70
臺北市,北投區,林泉里,0,1,1773,52,1825,2727,2,1,2,0,1,0,66.92
臺北市,北投區,中心里,0,1,3064,67,3131,4792,3,1,3,0,1,0,65.34
臺北市,北投區,中庸里,0,1,2401,60,2461,3357,3,1,3,0,1,0,73.31
臺北市,北投區,開明里,0,1,3487,112,3599,5124,2,1,2,0,1,0,70.24
臺北市,北投區,中和里,0,1,2763,73,2836,3955,2,1,2,0,1,0,71.71
臺北市,北投區,智仁里,0,1,3435,99,3534,4751,2,1,2,0,1,0,74.38
臺北市,北投區,秀山里,0,1,2016,53,2069,2866,4,1,4,0,1,0,72.19
臺北市,北投區,文化里,0,1,2428,62,2490,3307,5,1,5,0,1,0,75.29
臺北市,北投區,豐年里,0,1,2364,124,2488,3297,3,1,3,0,1,0,75.46
臺北市,北投區,稻香里,0,1,2643,129,2772,3834,3,1,3,0,1,0,72.30
臺北市,北投區,桃源里,0,1,2703,289,2992,4121,5,1,5,0,1,0,72.60
臺北市,北投區,一德里,0,1,3132,192,3324,4769,4,1,4,0,1,0,69.70
臺北市,北投區,關渡里,0,1,5481,213,5694,7927,4,1,4,0,1,0,71.83
臺北市,北投區,泉源里,0,1,1368,31,1399,1931,2,1,2,0,1,0,72.45
臺北市,北投區,湖山里,0,1,1183,19,1202,1650,3,1,3,0,1,0,72.85
臺北市,北投區,大屯里,0,1,671,16,687,979,3,1,3,0,1,0,70.17
臺北市,北投區,湖田里,0,1,517,11,528,743,5,1,3,2,0,1,71.06
臺北市,士林區,仁勇里,0,1,2629,28,2657,3595,2,1,2,0,1,0,73.91
臺北市,士林區,義信里,0,1,1765,32,1797,2501,2,1,2,0,1,0,71.85
臺北市,士林區,福林里,0,1,2236,49,2285,3176,4,1,4,0,1,0,71.95
臺北市,士林區,福德里,0,1,2535,50,2585,4137,2,1,2,0,1,0,62.48
臺北市,士林區,福志里,0,1,3971,72,4043,5618,2,1,2,0,1,0,71.97
臺北市,士林區,舊佳里,0,1,3828,63,3891,5341,2,1,2,0,1,0,72.85
臺北市,士林區,福佳里,0,1,4262,70,4332,5873,3,1,3,0,1,0,73.76
臺北市,士林區,後港里,0,1,4347,77,4424,6287,2,1,2,0,1,0,70.37
臺北市,士林區,福中里,0,1,3095,65,3160,4360,2,1,2,0,1,0,72.48
臺北市,士林區,前港里,0,1,2501,42,2543,3513,2,1,2,0,1,0,72.39
臺北市,士林區,百齡里,0,1,4033,90,4123,5737,2,1,2,0,1,0,71.87
臺北市,士林區,承德里,0,1,2944,60,3004,4355,1,1,1,0,1,0,68.98
臺北市,士林區,福華里,0,1,3768,80,3848,5502,2,1,2,0,1,0,69.94
臺北市,士林區,明勝里,0,1,2718,76,2794,4065,2,1,2,0,1,0,68.73
臺北市,士林區,福順里,0,1,2924,53,2977,4346,4,1,4,0,1,0,68.50
臺北市,士林區,富光里,0,1,3285,72,3357,4697,3,1,3,0,1,0,71.47
臺北市,士林區,葫蘆里,0,1,4172,78,4250,5712,4,1,3,1,1,0,74.40
臺北市,士林區,葫東里,0,1,2204,42,2246,3070,2,1,1,1,1,0,73.16
臺北市,士林區,社子里,0,1,3456,60,3516,4994,2,1,2,0,1,0,70.40
臺北市,士林區,社新里,0,1,4541,103,4644,6560,4,1,4,0,1,0,70.79
臺北市,士林區,社園里,0,1,4030,63,4093,5549,3,1,3,0,1,0,73.76
臺北市,士林區,永倫里,0,1,4132,91,4223,5818,2,1,2,0,1,0,72.59
臺北市,士林區,福安里,0,1,2962,40,3002,3950,2,1,2,0,1,0,76.00
臺北市,士林區,富洲里,0,1,3215,40,3255,4407,4,1,3,1,1,0,73.86
臺北市,士林區,岩山里,0,1,2076,36,2112,3065,1,1,1,0,1,0,68.91
臺北市,士林區,名山里,0,1,4011,75,4086,5668,2,1,1,1,1,0,72.09
臺北市,士林區,德行里,0,1,2331,44,2375,3291,6,1,5,1,1,0,72.17
臺北市,士林區,德華里,0,1,3097,68,3165,4501,3,1,2,1,0,1,70.32
臺北市,士林區,聖山里,0,1,2974,44,3018,4166,3,1,3,0,1,0,72.44
臺北市,士林區,忠誠里,0,1,3287,41,3328,4548,2,1,1,1,1,0,73.18
臺北市,士林區,芝山里,0,1,3891,75,3966,5564,3,1,3,0,1,0,71.28
臺北市,士林區,東山里,0,1,2763,53,2816,3858,4,1,4,0,1,0,72.99
臺北市,士林區,三玉里,0,1,3074,64,3138,4412,2,1,2,0,1,0,71.12
臺北市,士林區,蘭雅里,0,1,4548,102,4650,6657,2,1,0,2,0,1,69.85
臺北市,士林區,蘭興里,0,1,3515,65,3580,4945,3,1,3,0,1,0,72.40
臺北市,士林區,天福里,0,1,3429,65,3494,4910,5,1,4,1,1,0,71.16
臺北市,士林區,天祿里,0,1,2872,54,2926,4173,3,1,3,0,1,0,70.12
臺北市,士林區,天壽里,0,1,2550,56,2606,3720,4,1,4,0,1,0,70.05
臺北市,士林區,天和里,0,1,3938,88,4026,5879,5,1,4,1,0,1,68.48
臺北市,士林區,天山里,0,1,3575,64,3639,5437,4,1,3,1,1,0,66.93
臺北市,士林區,天玉里,0,1,4415,96,4511,6561,2,1,2,0,1,0,68.75
臺北市,士林區,天母里,0,1,3561,52,3613,5094,4,1,4,0,1,0,70.93
臺北市,士林區,永福里,0,1,769,11,780,1121,3,1,3,0,1,0,69.58
臺北市,士林區,公館里,0,1,866,17,883,1236,2,1,2,0,1,0,71.44
臺北市,士林區,新安里,0,1,1215,14,1229,1736,4,1,4,0,1,0,70.79
臺北市,士林區,陽明里,0,1,1839,36,1875,2777,3,1,2,1,1,0,67.52
臺北市,士林區,菁山里,0,1,973,17,990,1362,3,1,3,0,1,0,72.69
臺北市,士林區,平等里,0,1,918,14,932,1197,2,1,1,1,1,0,77.86
臺北市,士林區,溪山里,0,1,865,20,885,1238,2,1,1,1,1,0,71.49
臺北市,士林區,翠山里,0,1,1805,20,1825,2554,2,1,1,1,1,0,71.46
臺北市,士林區,臨溪里,0,1,1580,39,1619,2378,2,1,1,1,1,0,68.08
臺北市,內湖區,西湖里,0,2,4285,83,4368,6070,2,1,1,1,1,0,71.96
臺北市,內湖區,西康里,0,2,4349,70,4419,6025,2,1,1,1,1,0,73.34
臺北市,內湖區,西安里,0,2,3384,60,3444,4782,2,1,1,1,1,0,72.02
臺北市,內湖區,港墘里,0,2,3119,40,3159,4311,2,1,1,1,1,0,73.28
臺北市,內湖區,港都里,0,2,2867,46,2913,4052,2,1,1,1,1,0,71.89
臺北市,內湖區,港富里,0,2,4969,82,5051,7064,2,1,1,1,1,0,71.50
臺北市,內湖區,港華里,0,2,4358,84,4442,6086,2,1,1,1,1,0,72.99
臺北市,內湖區,內湖里,0,2,3024,45,3069,4333,2,1,1,1,1,0,70.83
臺北市,內湖區,湖濱里,0,2,4030,82,4112,5635,2,1,1,1,1,0,72.97
臺北市,內湖區,紫星里,0,2,4597,68,4665,6293,2,1,1,1,1,0,74.13
臺北市,內湖區,大湖里,0,2,2665,46,2711,3894,3,1,3,0,1,0,69.62
臺北市,內湖區,金龍里,0,2,3113,64,3177,4400,3,1,3,0,1,0,72.20
臺北市,內湖區,金瑞里,0,2,3479,47,3526,4840,3,1,3,0,1,0,72.85
臺北市,內湖區,碧山里,0,2,3706,54,3760,5173,4,1,4,0,1,0,72.69
臺北市,內湖區,紫雲里,0,2,3258,62,3320,4461,2,1,2,0,1,0,74.42
臺北市,內湖區,清白里,0,2,3431,54,3485,4988,5,1,5,0,1,0,69.87
臺北市,內湖區,葫洲里,0,2,4707,67,4774,6624,3,1,3,0,1,0,72.07
臺北市,內湖區,紫陽里,0,2,3867,63,3930,5541,4,1,4,0,1,0,70.93
臺北市,內湖區,瑞陽里,0,2,4798,77,4875,6358,4,1,3,1,1,0,76.68
臺北市,內湖區,瑞光里,0,2,2740,37,2777,3698,2,1,2,0,1,0,75.09
臺北市,內湖區,五分里,0,2,4573,90,4663,6612,2,1,2,0,1,0,70.52
臺北市,內湖區,東湖里,0,2,3961,64,4025,5643,3,1,3,0,1,0,71.33
臺北市,內湖區,樂康里,0,2,3982,58,4040,5686,3,1,3,0,1,0,71.05
臺北市,內湖區,內溝里,0,2,2180,36,2216,3101,2,1,2,0,1,0,71.46
臺北市,內湖區,週美里,0,2,2631,57,2688,3700,4,1,4,0,1,0,72.65
臺北市,內湖區,行善里,0,2,3534,67,3601,4983,3,1,2,1,0,1,72.27
臺北市,內湖區,石潭里,0,2,1493,27,1520,2081,5,1,5,0,1,0,73.04
臺北市,內湖區,湖興里,0,2,4511,76,4587,6847,2,1,2,0,1,0,66.99
臺北市,內湖區,湖元里,0,2,2691,63,2754,3771,3,1,3,0,1,0,73.03
臺北市,內湖區,安湖里,0,2,3603,50,3653,5014,2,1,2,0,1,0,72.86
臺北市,內湖區,秀湖里,0,2,3251,55,3306,4665,3,1,3,0,1,0,70.87
臺北市,內湖區,安泰里,0,2,2456,42,2498,3468,2,1,2,0,1,0,72.03
臺北市,內湖區,金湖里,0,2,2881,38,2919,4025,3,1,3,0,1,0,72.52
臺北市,內湖區,康寧里,0,2,3844,60,3904,5546,2,1,1,1,0,1,70.39
臺北市,內湖區,明湖里,0,2,2494,32,2526,3477,2,1,1,1,1,0,72.65
臺北市,內湖區,蘆洲里,0,2,512,3,515,772,4,1,4,0,1,0,66.71
臺北市,內湖區,麗山里,0,2,2908,51,2959,4174,5,1,4,1,1,0,70.89
臺北市,南港區,南港里,0,2,3122,53,3175,4607,3,1,2,1,0,1,68.92
臺北市,南港區,中南里,0,2,2366,45,2411,3344,2,1,2,0,1,0,72.10
臺北市,南港區,新富里,0,2,2330,41,2371,3240,2,1,2,0,1,0,73.18
臺北市,南港區,三重里,0,2,1951,25,1976,2689,3,1,2,1,1,0,73.48
臺北市,南港區,東新里,0,2,3709,73,3782,5312,2,1,2,0,1,0,71.20
臺北市,南港區,新光里,0,2,2380,51,2431,3316,3,1,3,0,1,0,73.31
臺北市,南港區,東明里,0,2,2536,46,2582,3590,4,1,4,0,1,0,71.92
臺北市,南港區,西新里,0,2,2446,47,2493,3496,5,1,3,2,0,1,71.31
臺北市,南港區,玉成里,0,2,2632,40,2672,3644,2,1,2,0,1,0,73.33
臺北市,南港區,合成里,0,2,3531,84,3615,4993,3,1,3,0,1,0,72.40
臺北市,南港區,成福里,0,2,4262,94,4356,6019,2,1,2,0,1,0,72.37
臺北市,南港區,萬福里,0,2,2494,55,2549,3327,5,1,5,0,1,0,76.62
臺北市,南港區,鴻福里,0,2,2624,77,2701,3757,1,1,1,0,1,0,71.89
臺北市,南港區,百福里,0,2,2865,67,2932,3973,4,1,4,0,1,0,73.80
臺北市,南港區,聯成里,0,2,3097,56,3153,4224,3,1,3,0,1,0,74.64
臺北市,南港區,舊莊里,0,2,4603,86,4689,6561,2,1,2,0,1,0,71.47
臺北市,南港區,中研里,0,2,5234,76,5310,7182,3,1,3,0,1,0,73.93
臺北市,南港區,九如里,0,2,3205,44,3249,4437,4,1,4,0,1,0,73.23
臺北市,南港區,仁福里,0,2,2868,57,2925,4166,4,1,3,1,1,0,70.21
臺北市,松山區,莊敬里,0,3,3397,47,3444,4757,4,1,4,0,1,0,72.40
臺北市,松山區,東榮里,0,3,4652,80,4732,6853,2,1,2,0,1,0,69.05
臺北市,松山區,三民里,0,3,3846,57,3903,5628,3,1,3,0,1,0,69.35
臺北市,松山區,新益里,0,3,2573,49,2622,3715,3,1,2,1,0,1,70.58
臺北市,松山區,富錦里,0,3,2944,47,2991,4293,1,1,1,0,1,0,69.67
臺北市,松山區,新東里,0,3,2769,61,2830,4107,2,1,1,1,1,0,68.91
臺北市,松山區,富泰里,0,3,2486,34,2520,3722,3,1,2,1,0,1,67.71
臺北市,松山區,介壽里,0,3,2431,50,2481,3631,4,1,4,0,1,0,68.33
臺北市,松山區,精忠里,0,3,2414,45,2459,3610,2,1,2,0,1,0,68.12
臺北市,松山區,東光里,0,3,4115,69,4184,6075,4,1,3,1,1,0,68.87
臺北市,松山區,龍田里,0,3,3269,40,3309,4739,2,1,2,0,1,0,69.82
臺北市,松山區,東昌里,0,3,1496,32,1528,2192,2,1,2,0,1,0,69.71
臺北市,松山區,東勢里,0,3,2348,56,2404,3441,5,1,5,0,1,0,69.86
臺北市,松山區,中華里,0,3,3294,76,3370,4708,4,1,4,0,1,0,71.58
臺北市,松山區,民有里,0,3,4565,108,4673,7022,4,1,4,0,1,0,66.55
臺北市,松山區,民福里,0,3,3821,74,3895,5385,2,1,2,0,1,0,72.33
臺北市,松山區,慈祐里,0,3,3228,51,3279,5288,3,1,3,0,1,0,62.01
臺北市,松山區,安平里,0,3,5064,68,5132,6898,2,1,2,0,1,0,74.40
臺北市,松山區,鵬程里,0,3,3318,51,3369,4664,3,1,3,0,1,0,72.23
臺北市,松山區,自強里,0,3,4034,58,4092,5586,2,1,2,0,1,0,73.25
臺北市,松山區,吉祥里,0,3,4361,91,4452,6464,2,1,2,0,1,0,68.87
臺北市,松山區,新聚里,0,3,4045,82,4127,5843,2,1,1,1,0,1,70.63
臺北市,松山區,復盛里,0,3,3621,84,3705,5143,2,1,2,0,1,0,72.04
臺北市,松山區,中正里,0,3,4004,84,4088,6227,2,1,1,1,1,0,65.65
臺北市,松山區,中崙里,0,3,2168,48,2216,3084,2,1,2,0,1,0,71.85
臺北市,松山區,美仁里,0,3,1703,46,1749,2528,3,1,3,0,1,0,69.19
臺北市,松山區,吉仁里,0,3,2148,54,2202,3101,2,1,2,0,1,0,71.01
臺北市,松山區,敦化里,0,3,3764,92,3856,5473,2,1,2,0,1,0,70.45
臺北市,松山區,復源里,0,3,1650,41,1691,2444,2,1,2,0,1,0,69.19
臺北市,松山區,復建里,0,3,2050,41,2091,2975,2,1,2,0,1,0,70.29
臺北市,松山區,復勢里,0,3,3227,72,3299,4752,3,1,3,0,1,0,69.42
臺北市,松山區,福成里,0,3,1436,32,1468,2132,3,1,2,1,1,0,68.86
臺北市,松山區,松基里,0,3,2040,68,2108,3107,3,1,3,0,1,0,67.85
臺北市,信義區,西村里,0,3,2837,49,2886,4402,2,1,2,0,1,0,65.56
臺北市,信義區,正和里,0,3,2710,58,2768,3897,2,1,2,0,1,0,71.03
臺北市,信義區,興隆里,0,3,1686,27,1713,2552,1,1,1,0,1,0,67.12
臺北市,信義區,中興里,0,3,1546,27,1573,2466,3,1,3,0,1,0,63.79
臺北市,信義區,新仁里,0,3,2277,29,2306,3299,1,1,1,0,1,0,69.90
臺北市,信義區,興雅里,0,3,3341,81,3422,4816,2,1,2,0,1,0,71.05
臺北市,信義區,敦厚里,0,3,2616,51,2667,3927,2,1,2,0,1,0,67.91
臺北市,信義區,廣居里,0,3,3964,63,4027,5766,2,1,2,0,1,0,69.84
臺北市,信義區,安康里,0,3,3910,61,3971,5745,4,1,4,0,1,0,69.12
臺北市,信義區,六藝里,0,3,2059,56,2115,2926,6,1,6,0,1,0,72.28
臺北市,信義區,雅祥里,0,3,2648,60,2708,3898,3,1,2,1,0,1,69.47
臺北市,信義區,五常里,0,3,2110,40,2150,3077,6,1,6,0,1,0,69.87
臺北市,信義區,五全里,0,3,2929,66,2995,4219,2,1,2,0,1,0,70.99
臺北市,信義區,永吉里,0,3,2527,59,2586,3760,1,1,1,0,1,0,68.78
臺北市,信義區,長春里,0,3,2482,59,2541,3586,4,1,4,0,1,0,70.86
臺北市,信義區,四育里,0,3,3289,63,3352,4571,2,1,2,0,1,0,73.33
臺北市,信義區,四維里,0,3,3065,71,3136,4571,2,1,2,0,1,0,68.61
臺北市,信義區,永春里,0,3,3066,72,3138,4437,4,1,2,2,0,1,70.72
臺北市,信義區,富台里,0,3,2142,44,2186,3020,2,1,2,0,1,0,72.38
臺北市,信義區,國業里,0,3,4040,78,4118,5824,3,1,2,1,1,0,70.71
臺北市,信義區,松隆里,0,3,1625,39,1664,2369,2,1,2,0,1,0,70.24
臺北市,信義區,松友里,0,3,3523,66,3589,5245,1,1,1,0,1,0,68.43
臺北市,信義區,松光里,0,3,3271,42,3313,4516,2,1,2,0,1,0,73.36
臺北市,信義區,中坡里,0,3,2667,53,2720,3810,1,1,1,0,1,0,71.39
臺北市,信義區,中行里,0,3,4571,101,4672,6484,3,1,3,0,1,0,72.05
臺北市,信義區,大道里,0,3,3802,88,3890,5423,1,1,1,0,1,0,71.73
臺北市,信義區,大仁里,0,3,3130,129,3259,4608,2,1,2,0,1,0,70.72
臺北市,信義區,景新里,0,3,2710,52,2762,3911,2,1,2,0,1,0,70.62
臺北市,信義區,惠安里,0,3,3919,80,3999,5512,2,1,2,0,1,0,72.55
臺北市,信義區,三張里,0,3,5373,86,5459,7578,3,1,3,0,1,0,72.04
臺北市,信義區,三犁里,0,3,2878,40,2918,4139,1,1,1,0,1,0,70.50
臺北市,信義區,六合里,0,3,3647,67,3714,5367,2,1,2,0,1,0,69.20
臺北市,信義區,泰和里,0,3,4580,69,4649,6558,2,1,2,0,1,0,70.89
臺北市,信義區,景聯里,0,3,2730,62,2792,3946,3,1,3,0,1,0,70.76
臺北市,信義區,景勤里,0,3,2642,46,2688,3745,1,1,1,0,1,0,71.78
臺北市,信義區,雙和里,0,3,4225,69,4294,5874,7,1,7,0,1,0,73.10
臺北市,信義區,嘉興里,0,3,1871,35,1906,2736,2,1,2,0,1,0,69.66
臺北市,信義區,黎順里,0,3,2428,52,2480,3485,4,1,3,1,1,0,71.16
臺北市,信義區,黎平里,0,3,3961,82,4043,5621,5,1,4,1,1,0,71.93
臺北市,信義區,黎忠里,0,3,2790,85,2875,3994,3,1,3,0,1,0,71.98
臺北市,信義區,黎安里,0,3,1646,67,1713,2314,2,1,2,0,1,0,74.03
臺北市,中山區,正守里,0,4,1651,45,1696,2418,3,1,3,0,1,0,70.14
臺北市,中山區,正義里,0,4,2245,57,2302,3582,4,1,3,1,0,1,64.27
臺北市,中山區,正得里,0,4,1577,43,1620,2587,2,1,2,0,1,0,62.62
臺北市,中山區,民安里,0,4,2742,60,2802,4139,3,1,3,0,1,0,67.70
臺北市,中山區,康樂里,0,4,1116,34,1150,1873,2,1,2,0,1,0,61.40
臺北市,中山區,中山里,0,4,2748,81,2829,4440,2,1,2,0,1,0,63.72
臺北市,中山區,聚盛里,0,4,1646,51,1697,2801,3,1,3,0,1,0,60.59
臺北市,中山區,集英里,0,4,3136,65,3201,4684,2,1,2,0,1,0,68.34
臺北市,中山區,聚葉里,0,4,1884,48,1932,2989,2,1,2,0,1,0,64.64
臺北市,中山區,恆安里,0,4,1682,42,1724,2641,2,1,2,0,1,0,65.28
臺北市,中山區,晴光里,0,4,2009,52,2061,3273,1,1,1,0,1,0,62.97
臺北市,中山區,圓山里,0,4,1919,48,1967,3027,2,1,2,0,1,0,64.98
臺北市,中山區,新庄里,0,4,2728,61,2789,4054,3,1,3,0,1,0,68.80
臺北市,中山區,劍潭里,0,4,2277,25,2302,3075,3,1,2,1,1,0,74.86
臺北市,中山區,大直里,0,4,5394,94,5488,7762,4,1,4,0,1,0,70.70
臺北市,中山區,成功里,0,4,1560,39,1599,2170,4,1,4,0,1,0,73.69
臺北市,中山區,永安里,0,4,4481,102,4583,6418,2,1,2,0,1,0,71.41
臺北市,中山區,大佳里,0,4,715,10,725,1022,3,1,3,0,1,0,70.94
臺北市,中山區,新喜里,0,4,2782,52,2834,3983,2,1,2,0,1,0,71.15
臺北市,中山區,新福里,0,4,2707,92,2799,4027,2,1,2,0,1,0,69.51
臺北市,中山區,松江里,0,4,3481,74,3555,5033,3,1,3,0,1,0,70.63
臺北市,中山區,新生里,0,4,2761,62,2823,4011,2,1,2,0,1,0,70.38
臺北市,中山區,中庄里,0,4,2979,98,3077,4505,3,1,3,0,1,0,68.30
臺北市,中山區,行政里,0,4,2968,61,3029,4976,5,1,5,0,1,0,60.87
臺北市,中山區,行仁里,0,4,4636,95,4731,6678,3,1,3,0,1,0,70.84
臺北市,中山區,行孝里,0,4,2379,50,2429,3381,4,1,4,0,1,0,71.84
臺北市,中山區,下埤里,0,4,4018,90,4108,5819,2,1,2,0,1,0,70.60
臺北市,中山區,江寧里,0,4,3621,84,3705,5388,3,1,3,0,1,0,68.76
臺北市,中山區,江山里,0,4,4174,68,4242,6089,2,1,2,0,1,0,69.67
臺北市,中山區,中吉里,0,4,2848,50,2898,4189,4,1,3,1,1,0,69.18
臺北市,中山區,中原里,0,4,2491,47,2538,3798,2,1,2,0,1,0,66.82
臺北市,中山區,興亞里,0,4,2736,56,2792,4119,4,1,4,0,1,0,67.78
臺北市,中山區,中央里,0,4,1985,41,2026,2900,2,1,2,0,1,0,69.86
臺北市,中山區,朱馥里,0,4,3390,80,3470,4935,3,1,3,0,1,0,70.31
臺北市,中山區,龍洲里,0,4,3176,45,3221,4297,3,1,3,0,1,0,74.96
臺北市,中山區,朱園里,0,4,2414,48,2462,3551,2,1,1,1,1,0,69.33
臺北市,中山區,埤頭里,0,4,2306,50,2356,3393,3,1,2,1,0,1,69.44
臺北市,中山區,朱崙里,0,4,1695,35,1730,2543,2,1,2,0,1,0,68.03
臺北市,中山區,力行里,0,4,3214,82,3296,4896,2,1,2,0,1,0,67.32
臺北市,中山區,復華里,0,4,2085,40,2125,3098,5,1,5,0,1,0,68.59
臺北市,中山區,北安里,0,4,2046,50,2096,2875,2,1,2,0,1,0,72.90
臺北市,中山區,金泰里,0,4,1726,24,1750,2328,3,1,3,0,1,0,75.17
臺北市,大同區,玉泉里,0,4,1821,56,1877,2858,2,1,2,0,1,0,65.68
臺北市,大同區,建明里,0,4,1863,41,1904,2774,2,1,2,0,1,0,68.64
臺北市,大同區,建功里,0,4,2561,83,2644,3853,4,1,4,0,1,0,68.62
臺北市,大同區,建泰里,0,4,1992,43,2035,2976,4,1,4,0,1,0,68.38
臺北市,大同區,永樂里,0,4,2883,64,2947,4278,2,1,2,0,1,0,68.89
臺北市,大同區,朝陽里,0,4,2123,54,2177,3231,2,1,2,0,1,0,67.38
臺北市,大同區,星明里,0,4,2528,48,2576,3762,2,1,2,0,1,0,68.47
臺北市,大同區,光能里,0,4,2967,72,3039,4238,2,1,2,0,1,0,71.71
臺北市,大同區,大有里,0,4,2829,61,2890,4047,2,1,2,0,1,0,71.41
臺北市,大同區,延平里,0,4,2094,39,2133,3201,2,1,2,0,1,0,66.64
臺北市,大同區,雙連里,0,4,5135,105,5240,7582,1,1,1,0,1,0,69.11
臺北市,大同區,南芳里,0,4,2140,41,2181,3221,2,1,2,0,1,0,67.71
臺北市,大同區,民權里,0,4,3493,61,3554,5171,2,1,2,0,1,0,68.73
臺北市,大同區,景星里,0,4,1643,29,1672,2367,2,1,2,0,1,0,70.64
臺北市,大同區,隆和里,0,4,1828,47,1875,2655,2,1,2,0,1,0,70.62
臺北市,大同區,蓬萊里,0,4,2618,67,2685,3886,2,1,2,0,1,0,69.09
臺北市,大同區,國順里,0,4,1792,36,1828,2647,2,1,2,0,1,0,69.06
臺北市,大同區,國慶里,0,4,2140,39,2179,3093,3,1,2,1,1,0,70.45
臺北市,大同區,揚雅里,0,4,1851,47,1898,2873,2,1,2,0,1,0,66.06
臺北市,大同區,斯文里,0,4,3124,68,3192,4487,2,1,2,0,1,0,71.14
臺北市,大同區,鄰江里,0,4,3708,65,3773,5250,3,1,3,0,1,0,71.87
臺北市,大同區,至聖里,0,4,4408,86,4494,6339,1,1,1,0,1,0,70.89
臺北市,大同區,老師里,0,4,3276,64,3340,4697,2,1,2,0,1,0,71.11
臺北市,大同區,重慶里,0,4,3325,66,3391,4681,1,1,1,0,1,0,72.44
臺北市,大同區,保安里,0,4,2558,58,2616,3657,2,1,2,0,1,0,71.53
臺北市,中正區,水源里,0,5,1721,51,1772,2569,2,1,2,0,1,0,68.98
臺北市,中正區,富水里,0,5,1723,33,1756,2503,2,1,2,0,1,0,70.16
臺北市,中正區,文盛里,0,5,1510,42,1552,2261,2,1,2,0,1,0,68.64
臺北市,中正區,林興里,0,5,2624,64,2688,3828,2,1,2,0,1,0,70.22
臺北市,中正區,河堤里,0,5,2615,57,2672,3856,2,1,2,0,1,0,69.29
臺北市,中正區,頂東里,0,5,3234,62,3296,4622,3,1,3,0,1,0,71.31
臺北市,中正區,網溪里,0,5,3102,58,3160,4460,4,1,3,1,1,0,70.85
臺北市,中正區,板溪里,0,5,1948,43,1991,2841,3,1,2,1,1,0,70.08
臺北市,中正區,螢圃里,0,5,3107,51,3158,4402,2,1,2,0,1,0,71.74
臺北市,中正區,螢雪里,0,5,2536,66,2602,3641,2,1,1,1,0,1,71.46
臺北市,中正區,永功里,0,5,3489,61,3550,5070,2,1,2,0,1,0,70.02
臺北市,中正區,永昌里,0,5,3024,75,3099,4429,3,1,2,1,1,0,69.97
臺北市,中正區,龍興里,0,5,2191,40,2231,3166,3,1,3,0,1,0,70.47
臺北市,中正區,忠勤里,0,5,3921,86,4007,5759,2,1,2,0,1,0,69.58
臺北市,中正區,廈安里,0,5,2011,27,2038,2981,3,1,2,1,1,0,68.37
臺北市,中正區,愛國里,0,5,1781,27,1808,2560,3,1,3,0,1,0,70.63
臺北市,中正區,南門里,0,5,1806,28,1834,2629,2,1,2,0,1,0,69.76
臺北市,中正區,龍光里,0,5,1979,43,2022,2887,1,1,1,0,1,0,70.04
臺北市,中正區,南福里,0,5,4170,80,4250,5983,3,1,2,1,1,0,71.03
臺北市,中正區,龍福里,0,5,3287,92,3379,5046,3,1,3,0,1,0,66.96
臺北市,中正區,新營里,0,5,4349,99,4448,6213,2,1,2,0,1,0,71.59
臺北市,中正區,建國里,0,5,685,11,696,1107,2,1,2,0,1,0,62.87
臺北市,中正區,光復里,0,5,1841,48,1889,2972,3,1,3,0,1,0,63.56
臺北市,中正區,黎明里,0,5,1516,36,1552,2472,9,1,8,1,1,0,62.78
臺北市,中正區,梅花里,0,5,1853,62,1915,2825,3,1,3,0,1,0,67.79
臺北市,中正區,幸福里,0,5,2298,55,2353,3581,1,1,1,0,1,0,65.71
臺北市,中正區,幸市里,0,5,2261,78,2339,3528,3,1,3,0,1,0,66.30
臺北市,中正區,東門里,0,5,2402,53,2455,3562,3,1,3,0,1,0,68.92
臺北市,中正區,文北里,0,5,2587,82,2669,4019,3,1,3,0,1,0,66.41
臺北市,中正區,文祥里,0,5,3677,96,3773,5332,3,1,3,0,1,0,70.76
臺北市,中正區,三愛里,0,5,3980,114,4094,5980,1,1,1,0,1,0,68.46
臺北市,萬華區,福星里,0,5,2634,75,2709,4088,2,1,2,0,1,0,66.27
臺北市,萬華區,萬壽里,0,5,1658,36,1694,2733,2,1,2,0,1,0,61.98
臺北市,萬華區,西門里,0,5,1820,52,1872,2890,2,1,2,0,1,0,64.78
臺北市,萬華區,新起里,0,5,3787,100,3887,5710,2,1,2,0,1,0,68.07
臺北市,萬華區,菜園里,0,5,3366,77,3443,5162,2,1,2,0,1,0,66.70
臺北市,萬華區,青山里,0,5,2974,66,3040,4429,2,1,2,0,1,0,68.64
臺北市,萬華區,富民里,0,5,2974,60,3034,4232,2,1,2,0,1,0,71.69
臺北市,萬華區,福音里,0,5,2217,49,2266,3128,2,1,2,0,1,0,72.44
臺北市,萬華區,仁德里,0,5,2592,71,2663,3679,2,1,2,0,1,0,72.38
臺北市,萬華區,富福里,0,5,2823,44,2867,3851,2,1,2,0,1,0,74.45
臺北市,萬華區,頂碩里,0,5,4689,84,4773,6664,2,1,2,0,1,0,71.62
臺北市,萬華區,雙園里,0,5,3003,58,3061,4439,2,1,2,0,1,0,68.96
臺北市,萬華區,新忠里,0,5,2400,32,2432,3324,2,1,2,0,1,0,73.16
臺北市,萬華區,新和里,0,5,5388,84,5472,7285,2,1,2,0,1,0,75.11
臺北市,萬華區,糖部里,0,5,3159,67,3226,4610,2,1,2,0,1,0,69.98
臺北市,萬華區,和平里,0,5,4222,88,4310,5990,2,1,2,0,1,0,71.95
臺北市,萬華區,綠堤里,0,5,2618,63,2681,3950,2,1,2,0,1,0,67.87
臺北市,萬華區,華江里,0,5,4877,97,4974,7030,2,1,2,0,1,0,70.75
臺北市,萬華區,柳鄉里,0,5,3150,65,3215,4509,2,1,2,0,1,0,71.30
臺北市,萬華區,日善里,0,5,2254,43,2297,3152,2,1,2,0,1,0,72.87
臺北市,萬華區,新安里,0,5,3892,77,3969,5414,2,1,2,0,1,0,73.31
臺北市,萬華區,忠德里,0,5,2693,39,2732,3793,2,1,2,0,1,0,72.03
臺北市,萬華區,孝德里,0,5,1898,36,1934,2703,2,1,2,0,1,0,71.55
臺北市,萬華區,和德里,0,5,3872,72,3944,5857,2,1,2,0,1,0,67.34
臺北市,萬華區,錦德里,0,5,3121,62,3183,4408,2,1,2,0,1,0,72.21
臺北市,萬華區,全德里,0,5,2384,44,2428,3437,2,1,2,0,1,0,70.64
臺北市,萬華區,保德里,0,5,1759,30,1789,2413,2,1,2,0,1,0,74.14
臺北市,萬華區,銘德里,0,5,2811,49,2860,3942,2,1,2,0,1,0,72.55
臺北市,萬華區,榮德里,0,5,2385,47,2432,3291,2,1,2,0,1,0,73.90
臺北市,萬華區,壽德里,0,5,2880,51,2931,4019,2,1,2,0,1,0,72.93
臺北市,萬華區,興德里,0,5,2823,56,2879,3967,2,1,2,0,1,0,72.57
臺北市,萬華區,華中里,0,5,3680,70,3750,5203,2,1,2,0,1,0,72.07
臺北市,萬華區,日祥里,0,5,3511,55,3566,4856,2,1,2,0,1,0,73.43
臺北市,萬華區,忠貞里,0,5,3215,49,3264,4366,2,1,2,0,1,0,74.76
臺北市,萬華區,凌霄里,0,5,2491,50,2541,3529,2,1,2,0,1,0,72.00
臺北市,萬華區,騰雲里,0,5,1833,40,1873,2573,2,1,2,0,1,0,72.79
臺北市,大安區,德安里,0,6,3063,42,3105,4569,2,1,2,0,1,0,67.96
臺北市,大安區,仁慈里,0,6,2561,49,2610,3850,2,1,2,0,1,0,67.79
臺北市,大安區,和安里,0,6,3353,49,3402,4937,2,1,2,0,1,0,68.91
臺北市,大安區,民炤里,0,6,4154,70,4224,6278,2,1,2,0,1,0,67.28
臺北市,大安區,仁愛里,0,6,2752,74,2826,4547,2,1,2,0,1,0,62.15
臺北市,大安區,義村里,0,6,3777,40,3817,5492,2,1,2,0,1,0,69.50
臺北市,大安區,民輝里,0,6,3479,51,3530,5193,2,1,2,0,1,0,67.98
臺北市,大安區,昌隆里,0,6,1870,38,1908,2768,2,1,2,0,1,0,68.93
臺北市,大安區,誠安里,0,6,2459,31,2490,3657,2,1,2,0,1,0,68.09
臺北市,大安區,光武里,0,6,4027,81,4108,6385,2,1,2,0,1,0,64.34
臺北市,大安區,龍坡里,0,6,3130,40,3170,4531,2,1,2,0,1,0,69.96
臺北市,大安區,龍泉里,0,6,2429,30,2459,3604,2,1,2,0,1,0,68.23
臺北市,大安區,古風里,0,6,2236,39,2275,3308,2,1,2,0,1,0,68.77
臺北市,大安區,古莊里,0,6,3464,56,3520,5061,2,1,2,0,1,0,69.55
臺北市,大安區,龍安里,0,6,3035,38,3073,5248,2,1,2,0,1,0,58.56
臺北市,大安區,錦安里,0,6,2718,34,2752,3957,2,1,2,0,1,0,69.55
臺北市,大安區,福住里,0,6,2994,48,3042,4326,2,1,2,0,1,0,70.32
臺北市,大安區,永康里,0,6,1850,22,1872,2623,2,1,2,0,1,0,71.37
臺北市,大安區,光明里,0,6,2026,34,2060,2872,2,1,2,0,1,0,71.73
臺北市,大安區,錦泰里,0,6,2854,45,2899,3953,2,1,2,0,1,0,73.34
臺北市,大安區,錦華里,0,6,2883,61,2944,4108,2,1,2,0,1,0,71.67
臺北市,大安區,龍圖里,0,6,3601,50,3651,5291,2,1,2,0,1,0,69.00
臺北市,大安區,新龍里,0,6,3592,46,3638,5105,2,1,2,0,1,0,71.26
臺北市,大安區,龍陣里,0,6,2004,31,2035,2979,2,1,2,0,1,0,68.31
臺北市,大安區,龍雲里,0,6,2746,45,2791,4082,2,1,2,0,1,0,68.37
臺北市,大安區,龍生里,0,6,3375,50,3425,4851,2,1,2,0,1,0,70.60
臺北市,大安區,住安里,0,6,2950,54,3004,4359,2,1,2,0,1,0,68.91
臺北市,大安區,義安里,0,6,2953,44,2997,4436,2,1,2,0,1,0,67.56
臺北市,大安區,通化里,0,6,3450,56,3506,4905,2,1,2,0,1,0,71.48
臺北市,大安區,通安里,0,6,3247,64,3311,4665,2,1,2,0,1,0,70.98
臺北市,大安區,臨江里,0,6,2491,44,2535,3524,2,1,2,0,1,0,71.94
臺北市,大安區,法治里,0,6,2468,37,2505,3521,2,1,2,0,1,0,71.14
臺北市,大安區,全安里,0,6,2336,36,2372,3494,2,1,2,0,1,0,67.89
臺北市,大安區,群賢里,0,6,3339,42,3381,4949,2,1,2,0,1,0,68.32
臺北市,大安區,群英里,0,6,4319,51,4370,5963,2,1,2,0,1,0,73.29
臺北市,大安區,虎嘯里,0,6,1766,28,1794,2619,2,1,2,0,1,0,68.50
臺北市,大安區,臥龍里,0,6,1656,26,1682,2384,2,1,2,0,1,0,70.55
臺北市,大安區,龍淵里,0,6,4767,54,4821,6869,2,1,2,0,1,0,70.18
臺北市,大安區,龍門里,0,6,2126,23,2149,3226,2,1,2,0,1,0,66.62
臺北市,大安區,大學里,0,6,4228,59,4287,6442,2,1,2,0,1,0,66.55
臺北市,大安區,芳和里,0,6,3518,53,3571,4927,2,1,2,0,1,0,72.48
臺北市,大安區,黎元里,0,6,3189,52,3241,4466,2,1,2,0,1,0,72.57
臺北市,大安區,黎孝里,0,6,4347,77,4424,6052,2,1,2,0,1,0,73.10
臺北市,大安區,黎和里,0,6,2404,30,2434,3399,2,1,2,0,1,0,71.61
臺北市,大安區,建安里,0,6,2566,53,2619,4095,2,1,2,0,1,0,63.96
臺北市,大安區,建倫里,0,6,3057,48,3105,4826,2,1,2,0,1,0,64.34
臺北市,大安區,敦安里,0,6,3304,52,3356,4899,2,1,2,0,1,0,68.50
臺北市,大安區,正聲里,0,6,2505,48,2553,3872,2,1,2,0,1,0,65.93
臺北市,大安區,敦煌里,0,6,3143,58,3201,4737,2,1,2,0,1,0,67.57
臺北市,大安區,華聲里,0,6,2310,48,2358,3414,2,1,2,0,1,0,69.07
臺北市,大安區,車層里,0,6,3571,68,3639,5278,2,1,2,0,1,0,68.95
臺北市,大安區,光信里,0,6,4274,81,4355,6226,2,1,2,0,1,0,69.95
臺北市,大安區,學府里,0,6,2287,29,2316,3303,2,1,2,0,1,0,70.12
臺北市,文山區,景行里,0,6,2991,34,3025,4224,2,1,2,0,1,0,71.61
臺北市,文山區,景東里,0,6,3618,54,3672,5158,2,1,2,0,1,0,71.19
臺北市,文山區,景美里,0,6,2516,30,2546,3464,2,1,2,0,1,0,73.50
臺北市,文山區,景慶里,0,6,3514,66,3580,4922,2,1,2,0,1,0,72.73
臺北市,文山區,景仁里,0,6,2637,46,2683,3711,2,1,2,0,1,0,72.30
臺北市,文山區,景華里,0,6,3090,54,3144,4348,2,1,2,0,1,0,72.31
臺北市,文山區,萬有里,0,6,2712,35,2747,3638,2,1,2,0,1,0,75.51
臺北市,文山區,萬祥里,0,6,2493,40,2533,3513,2,1,2,0,1,0,72.10
臺北市,文山區,萬隆里,0,6,3905,60,3965,5497,2,1,2,0,1,0,72.13
臺北市,文山區,萬年里,0,6,2936,42,2978,4207,2,1,2,0,1,0,70.79
臺北市,文山區,萬和里,0,6,2080,35,2115,2816,2,1,2,0,1,0,75.11
臺北市,文山區,萬盛里,0,6,2745,27,2772,3800,2,1,2,0,1,0,72.95
臺北市,文山區,興豐里,0,6,4847,76,4923,6743,2,1,2,0,1,0,73.01
臺北市,文山區,興光里,0,6,1744,35,1779,2528,2,1,2,0,1,0,70.37
臺北市,文山區,興家里,0,6,4115,54,4169,5779,2,1,2,0,1,0,72.14
臺北市,文山區,興得里,0,6,3428,61,3489,4867,2,1,2,0,1,0,71.69
臺北市,文山區,興業里,0,6,3108,42,3150,4473,2,1,2,0,1,0,70.42
臺北市,文山區,興安里,0,6,3538,51,3589,4837,2,1,2,0,1,0,74.20
臺北市,文山區,興福里,0,6,3365,44,3409,4541,2,1,2,0,1,0,75.07
臺北市,文山區,興旺里,0,6,3858,52,3910,5384,2,1,2,0,1,0,72.62
臺北市,文山區,興泰里,0,6,2125,30,2155,2996,2,1,2,0,1,0,71.93
臺北市,文山區,興昌里,0,6,3291,47,3338,4685,2,1,2,0,1,0,71.25
臺北市,文山區,試院里,0,6,3572,40,3612,4934,2,1,2,0,1,0,73.21
臺北市,文山區,華興里,0,6,4155,63,4218,5866,2,1,2,0,1,0,71.91
臺北市,文山區,明義里,0,6,2506,64,2570,3789,2,1,2,0,1,0,67.83
臺北市,文山區,明興里,0,6,3878,61,3939,5545,2,1,2,0,1,0,71.04
臺北市,文山區,木柵里,0,6,4302,50,4352,5739,2,1,2,0,1,0,75.83
臺北市,文山區,木新里,0,6,4836,81,4917,6885,2,1,2,0,1,0,71.42
臺北市,文山區,順興里,0,6,3900,64,3964,5348,2,1,2,0,1,0,74.12
臺北市,文山區,忠順里,0,6,2108,27,2135,2892,2,1,2,0,1,0,73.82
臺北市,文山區,樟林里,0,6,4696,72,4768,6517,2,1,2,0,1,0,73.16
臺北市,文山區,樟新里,0,6,6175,79,6254,8681,2,1,2,0,1,0,72.04
臺北市,文山區,樟腳里,0,6,5223,80,5303,7217,2,1,2,0,1,0,73.48
臺北市,文山區,萬芳里,0,6,3906,50,3956,5427,2,1,2,0,1,0,72.89
臺北市,文山區,萬美里,0,6,3463,41,3504,5042,2,1,2,0,1,0,69.50
臺北市,文山區,博嘉里,0,6,2565,38,2603,3635,2,1,2,0,1,0,71.61
臺北市,文山區,萬興里,0,6,5557,88,5645,7967,2,1,2,0,1,0,70.85
臺北市,文山區,指南里,0,6,1657,21,1678,2305,2,1,2,0,1,0,72.80
臺北市,文山區,老泉里,0,6,497,7,504,685,2,1,2,0,1,0,73.58
高雄市,鹽埕區,藍橋里,0,1,929,12,941,1253,2,1,2,0,1,0,75.10
高雄市,鹽埕區,慈愛里,0,1,398,5,403,523,2,1,2,0,1,0,77.06
高雄市,鹽埕區,博愛里,0,1,576,4,580,780,2,1,2,0,1,0,74.36
高雄市,鹽埕區,壽星里,0,1,936,14,950,1324,2,1,2,0,1,0,71.75
高雄市,鹽埕區,中山里,0,1,881,20,901,1215,2,1,2,0,1,0,74.16
高雄市,鹽埕區,教仁里,0,1,1638,23,1661,2197,2,1,2,0,1,0,75.60
高雄市,鹽埕區,新樂里,0,1,692,9,701,930,2,1,2,0,1,0,75.38
高雄市,鹽埕區,中原里,0,1,511,4,515,707,2,1,2,0,1,0,72.84
高雄市,鹽埕區,光明里,0,1,817,11,828,1164,2,1,2,0,1,0,71.13
高雄市,鹽埕區,育仁里,0,1,590,7,597,838,2,1,2,0,1,0,71.24
高雄市,鹽埕區,河濱里,0,1,1354,34,1388,1848,2,1,2,0,1,0,75.11
高雄市,鹽埕區,沙地里,0,1,765,9,774,1080,2,1,2,0,1,0,71.67
高雄市,鹽埕區,南端里,0,1,813,13,826,1130,2,1,2,0,1,0,73.10
高雄市,鹽埕區,港都里,0,1,834,10,844,1160,2,1,2,0,1,0,72.76
高雄市,鹽埕區,江西里,0,1,899,9,908,1237,2,1,2,0,1,0,73.40
高雄市,鹽埕區,新豐里,0,1,534,4,538,662,2,1,2,0,1,0,81.27
高雄市,鹽埕區,府北里,0,1,1206,18,1224,1773,2,1,2,0,1,0,69.04
高雄市,鹽埕區,陸橋里,0,1,908,17,925,1270,2,1,2,0,1,0,72.83
高雄市,鹽埕區,瀨南里,0,1,548,5,553,735,2,1,2,0,1,0,75.24
高雄市,鹽埕區,新化里,0,1,589,6,595,771,2,1,2,0,1,0,77.17
高雄市,鹽埕區,江南里,0,1,634,14,648,937,2,1,2,0,1,0,69.16
高雄市,鼓山區,鼓峰里,0,1,1496,10,1506,2053,2,1,2,0,1,0,73.36
高雄市,鼓山區,雄峰里,0,1,1467,18,1485,2099,2,1,2,0,1,0,70.75
高雄市,鼓山區,前峰里,0,1,3170,31,3201,4256,2,1,2,0,1,0,75.21
高雄市,鼓山區,光榮里,0,1,2830,30,2860,3914,2,1,2,0,1,0,73.07
高雄市,鼓山區,民族里,0,1,1115,10,1125,1473,2,1,2,0,1,0,76.37
高雄市,鼓山區,內惟里,0,1,938,14,952,1223,2,1,2,0,1,0,77.84
高雄市,鼓山區,建國里,0,1,1521,15,1536,2005,2,1,2,0,1,0,76.61
高雄市,鼓山區,忠正里,0,1,2884,32,2916,3970,2,1,2,0,1,0,73.45
高雄市,鼓山區,自強里,0,1,595,7,602,847,2,1,2,0,1,0,71.07
高雄市,鼓山區,龍井里,0,1,1124,14,1138,1540,2,1,2,0,1,0,73.90
高雄市,鼓山區,正德里,0,1,1269,17,1286,1741,2,1,2,0,1,0,73.87
高雄市,鼓山區,平和里,0,1,2238,20,2258,3020,2,1,2,0,1,0,74.77
高雄市,鼓山區,民強里,0,1,2079,29,2108,2849,2,1,2,0,1,0,73.99
高雄市,鼓山區,厚生里,0,1,1560,15,1575,2113,2,1,2,0,1,0,74.54
高雄市,鼓山區,龍子里,0,1,3397,58,3455,5025,2,1,2,0,1,0,68.76
高雄市,鼓山區,龍水里,0,1,686,10,696,1007,2,1,2,0,1,0,69.12
高雄市,鼓山區,明誠里,0,1,6517,96,6613,9594,2,1,2,0,1,0,68.93
高雄市,鼓山區,華豐里,0,1,2298,33,2331,3166,2,1,2,0,1,0,73.63
高雄市,鼓山區,裕興里,0,1,2023,17,2040,2810,2,1,2,0,1,0,72.60
高雄市,鼓山區,裕豐里,0,1,1606,17,1623,2299,2,1,2,0,1,0,70.60
高雄市,鼓山區,鼓岩里,0,1,1134,12,1146,1580,2,1,2,0,1,0,72.53
高雄市,鼓山區,樹德里,0,1,754,6,760,964,2,1,2,0,1,0,78.84
高雄市,鼓山區,寶樹里,0,1,664,11,675,1004,2,1,2,0,1,0,67.23
高雄市,鼓山區,興宗里,0,1,1123,14,1137,1519,2,1,2,0,1,0,74.85
高雄市,鼓山區,光化里,0,1,1105,12,1117,1577,2,1,2,0,1,0,70.83
高雄市,鼓山區,山下里,0,1,1091,14,1105,1498,2,1,2,0,1,0,73.77
高雄市,鼓山區,河邊里,0,1,1162,15,1177,1553,2,1,2,0,1,0,75.79
高雄市,鼓山區,綠川里,0,1,1169,21,1190,1657,2,1,2,0,1,0,71.82
高雄市,鼓山區,登山里,0,1,587,8,595,836,2,1,2,0,1,0,71.17
高雄市,鼓山區,峰南里,0,1,741,9,750,1061,2,1,2,0,1,0,70.69
高雄市,鼓山區,麗興里,0,1,837,9,846,1182,2,1,2,0,1,0,71.57
高雄市,鼓山區,新民里,0,1,807,15,822,1153,2,1,2,0,1,0,71.29
高雄市,鼓山區,延平里,0,1,671,12,683,949,2,1,2,0,1,0,71.97
高雄市,鼓山區,維生里,0,1,1094,12,1106,1532,2,1,2,0,1,0,72.19
高雄市,鼓山區,惠安里,0,1,991,13,1004,1421,2,1,2,0,1,0,70.65
高雄市,鼓山區,壽山里,0,1,1047,9,1056,1577,2,1,2,0,1,0,66.96
高雄市,鼓山區,哨船頭里,0,1,846,7,853,1214,2,1,2,0,1,0,70.26
高雄市,鼓山區,桃源里,0,1,464,6,470,638,2,1,2,0,1,0,73.67
高雄市,旗津區,旗下里,0,1,945,8,953,1279,2,1,2,0,1,0,74.51
高雄市,旗津區,永安里,0,1,828,7,835,1120,2,1,2,0,1,0,74.55
高雄市,旗津區,振興里,0,1,1188,16,1204,1659,2,1,2,0,1,0,72.57
高雄市,旗津區,慈愛里,0,1,1475,22,1497,2040,2,1,2,0,1,0,73.38
高雄市,旗津區,復興里,0,1,2011,16,2027,2707,2,1,2,0,1,0,74.88
高雄市,旗津區,中華里,0,1,915,9,924,1273,2,1,2,0,1,0,72.58
高雄市,旗津區,實踐里,0,1,896,11,907,1346,2,1,2,0,1,0,67.38
高雄市,旗津區,北汕里,0,1,1732,16,1748,2403,2,1,2,0,1,0,72.74
高雄市,旗津區,南汕里,0,1,1196,14,1210,1642,2,1,2,0,1,0,73.69
高雄市,旗津區,上竹里,0,1,1854,14,1868,2567,2,1,2,0,1,0,72.77
高雄市,旗津區,中洲里,0,1,1189,12,1201,1620,2,1,2,0,1,0,74.14
高雄市,旗津區,安順里,0,1,674,8,682,965,2,1,2,0,1,0,70.67
高雄市,旗津區,中興里,0,1,1594,22,1616,2113,2,1,2,0,1,0,76.48
高雄市,左營區,進學里,0,2,1169,16,1185,1777,2,1,2,0,1,0,66.69
高雄市,左營區,尾西里,0,2,937,15,952,1254,2,1,2,0,1,0,75.92
高雄市,左營區,頂北里,0,2,446,6,452,615,2,1,2,0,1,0,73.50
高雄市,左營區,中北里,0,2,619,4,623,794,2,1,2,0,1,0,78.46
高雄市,左營區,中南里,0,2,417,6,423,565,2,1,2,0,1,0,74.87
高雄市,左營區,廟東里,0,2,703,9,712,920,2,1,2,0,1,0,77.39
高雄市,左營區,廟北里,0,2,795,4,799,1047,2,1,2,0,1,0,76.31
高雄市,左營區,尾南里,0,2,617,12,629,836,2,1,2,0,1,0,75.24
高雄市,左營區,尾北里,0,2,2153,16,2169,2941,2,1,2,0,1,0,73.75
高雄市,左營區,屏山里,0,2,1084,16,1100,1496,2,1,2,0,1,0,73.53
高雄市,左營區,祥和里,0,2,482,15,497,647,2,1,2,0,1,0,76.82
高雄市,左營區,永清里,0,2,1438,17,1455,1990,2,1,2,0,1,0,73.12
高雄市,左營區,復興里,0,2,929,12,941,1236,2,1,2,0,1,0,76.13
高雄市,左營區,莒光里,0,2,1237,12,1249,1710,2,1,2,0,1,0,73.04
高雄市,左營區,光輝里,0,2,1794,18,1812,2511,2,1,2,0,1,0,72.16
高雄市,左營區,合群里,0,2,956,10,966,1307,2,1,2,0,1,0,73.91
高雄市,左營區,自治里,0,2,1285,13,1298,1761,2,1,2,0,1,0,73.71
高雄市,左營區,明建里,0,2,1039,10,1049,1480,2,1,2,0,1,0,70.88
高雄市,左營區,自立里,0,2,710,10,720,940,2,1,2,0,1,0,76.60
高雄市,左營區,頂西里,0,2,931,10,941,1202,2,1,2,0,1,0,78.29
高雄市,左營區,聖后里,0,2,726,13,739,988,2,1,2,0,1,0,74.80
高雄市,左營區,聖西里,0,2,352,4,356,449,2,1,2,0,1,0,79.29
高雄市,左營區,聖南里,0,2,406,3,409,581,2,1,2,0,1,0,70.40
高雄市,左營區,城南里,0,2,426,5,431,589,2,1,2,0,1,0,73.17
高雄市,左營區,路東里,0,2,601,5,606,787,2,1,2,0,1,0,77.00
高雄市,左營區,部北里,0,2,403,6,409,545,2,1,2,0,1,0,75.05
高雄市,左營區,部南里,0,2,590,6,596,773,2,1,2,0,1,0,77.10
高雄市,左營區,埤西里,0,2,844,9,853,1110,2,1,2,0,1,0,76.85
高雄市,左營區,埤北里,0,2,961,22,983,1417,2,1,2,0,1,0,69.37
高雄市,左營區,埤東里,0,2,876,15,891,1214,2,1,2,0,1,0,73.39
高雄市,左營區,海勝里,0,2,2493,36,2529,3378,2,1,2,0,1,0,74.87
高雄市,左營區,自勉里,0,2,1226,20,1246,1678,2,1,2,0,1,0,74.26
高雄市,左營區,崇實里,0,2,795,15,810,1093,2,1,2,0,1,0,74.11
高雄市,左營區,自助里,0,2,1680,24,1704,2318,2,1,2,0,1,0,73.51
高雄市,左營區,果貿里,0,2,1437,12,1449,1926,2,1,2,0,1,0,75.23
高雄市,左營區,果惠里,0,2,1086,16,1102,1583,2,1,2,0,1,0,69.61
高雄市,左營區,果峰里,0,2,1256,22,1278,1775,2,1,2,0,1,0,72.00
高雄市,左營區,新下里,0,2,6398,112,6510,9169,2,1,2,0,1,0,71.00
高雄市,左營區,新上里,0,2,11489,250,11739,17404,2,1,2,0,1,0,67.45
高雄市,左營區,新中里,0,2,3010,44,3054,4306,2,1,2,0,1,0,70.92
高雄市,左營區,新光里,0,2,5769,75,5844,8373,2,1,2,0,1,0,69.80
高雄市,左營區,菜公里,0,2,10184,143,10327,15122,2,1,2,0,1,0,68.29
高雄市,左營區,福山里,0,2,11679,223,11902,18423,2,1,2,0,1,0,64.60
高雄市,楠梓區,清豐里,0,2,5496,70,5566,8009,2,1,2,0,1,0,69.50
高雄市,楠梓區,東寧里,0,2,1555,21,1576,2209,2,1,2,0,1,0,71.34
高雄市,楠梓區,五常里,0,2,2717,39,2756,4102,2,1,2,0,1,0,67.19
高雄市,楠梓區,享平里,0,2,1865,16,1881,2667,2,1,2,0,1,0,70.53
高雄市,楠梓區,中陽里,0,2,1879,18,1897,2648,2,1,2,0,1,0,71.64
高雄市,楠梓區,惠楠里,0,2,1556,18,1574,2451,2,1,2,0,1,0,64.22
高雄市,楠梓區,惠民里,0,2,2244,27,2271,3184,2,1,2,0,1,0,71.33
高雄市,楠梓區,惠豐里,0,2,1744,21,1765,2533,2,1,2,0,1,0,69.68
高雄市,楠梓區,錦屏里,0,2,2510,31,2541,3395,2,1,2,0,1,0,74.85
高雄市,楠梓區,玉屏里,0,2,1790,13,1803,2307,2,1,2,0,1,0,78.15
高雄市,楠梓區,金田里,0,2,2285,28,2313,3152,2,1,2,0,1,0,73.38
高雄市,楠梓區,稔田里,0,2,1187,13,1200,1620,2,1,2,0,1,0,74.07
高雄市,楠梓區,瑞屏里,0,2,2193,27,2220,3089,2,1,2,0,1,0,71.87
高雄市,楠梓區,翠屏里,0,2,7098,84,7182,10661,2,1,2,0,1,0,67.37
高雄市,楠梓區,宏南里,0,2,1151,25,1176,1657,2,1,2,0,1,0,70.97
高雄市,楠梓區,宏毅里,0,2,2118,28,2146,2816,2,1,2,0,1,0,76.21
高雄市,楠梓區,宏榮里,0,2,1476,23,1499,1941,2,1,2,0,1,0,77.23
高雄市,楠梓區,廣昌里,0,2,2260,29,2289,3026,2,1,2,0,1,0,75.64
高雄市,楠梓區,久昌里,0,2,1494,19,1513,2178,2,1,2,0,1,0,69.47
高雄市,楠梓區,大昌里,0,2,1484,21,1505,1996,2,1,2,0,1,0,75.40
高雄市,楠梓區,福昌里,0,2,1372,17,1389,1799,2,1,2,0,1,0,77.21
高雄市,楠梓區,盛昌里,0,2,2664,34,2698,3574,2,1,2,0,1,0,75.49
高雄市,楠梓區,泰昌里,0,2,1158,8,1166,1529,2,1,2,0,1,0,76.26
高雄市,楠梓區,興昌里,0,2,2035,19,2054,2769,2,1,2,0,1,0,74.18
高雄市,楠梓區,建昌里,0,2,1567,21,1588,2202,2,1,2,0,1,0,72.12
高雄市,楠梓區,宏昌里,0,2,1559,18,1577,2217,2,1,2,0,1,0,71.13
高雄市,楠梓區,和昌里,0,2,1548,17,1565,2085,2,1,2,0,1,0,75.06
高雄市,楠梓區,慶昌里,0,2,2179,17,2196,2997,2,1,2,0,1,0,73.27
高雄市,楠梓區,隆昌里,0,2,2344,27,2371,3231,2,1,2,0,1,0,73.38
高雄市,楠梓區,秀昌里,0,2,1397,12,1409,1973,2,1,2,0,1,0,71.41
高雄市,楠梓區,裕昌里,0,2,1852,31,1883,2515,2,1,2,0,1,0,74.87
高雄市,楠梓區,國昌里,0,2,2060,23,2083,2908,2,1,2,0,1,0,71.63
高雄市,楠梓區,加昌里,0,2,3893,42,3935,5527,2,1,2,0,1,0,71.20
高雄市,楠梓區,仁昌里,0,2,2264,28,2292,3329,2,1,2,0,1,0,68.85
高雄市,楠梓區,藍田里,0,2,688,2,690,899,2,1,2,0,1,0,76.75
高雄市,楠梓區,中興里,0,2,663,2,665,882,2,1,2,0,1,0,75.40
高雄市,楠梓區,中和里,0,2,1079,8,1087,1445,2,1,2,0,1,0,75.22
高雄市,三民區,鼎金里,0,3,2015,18,2033,2917,2,1,2,0,1,0,69.69
高雄市,三民區,鼎盛里,0,3,3863,48,3911,5511,2,1,2,0,1,0,70.97
高雄市,三民區,鼎強里,0,3,2403,40,2443,3413,2,1,2,0,1,0,71.58
高雄市,三民區,鼎力里,0,3,2338,26,2364,3343,2,1,2,0,1,0,70.71
高雄市,三民區,鼎西里,0,3,3464,58,3522,5008,2,1,2,0,1,0,70.33
高雄市,三民區,鼎中里,0,3,2188,29,2217,2928,2,1,2,0,1,0,75.72
高雄市,三民區,鼎泰里,0,3,10537,174,10711,15720,2,1,2,0,1,0,68.14
高雄市,三民區,本館里,0,3,4965,92,5057,7097,2,1,2,0,1,0,71.26
高雄市,三民區,本和里,0,3,3855,62,3917,5549,2,1,2,0,1,0,70.59
高雄市,三民區,本文里,0,3,1501,10,1511,2009,2,1,2,0,1,0,75.21
高雄市,三民區,本武里,0,3,1059,18,1077,1485,2,1,2,0,1,0,72.53
高雄市,三民區,本元里,0,3,3007,36,3043,4227,2,1,2,0,1,0,71.99
高雄市,三民區,本安里,0,3,2452,41,2493,3510,2,1,2,0,1,0,71.03
高雄市,三民區,本上里,0,3,2635,43,2678,3861,2,1,2,0,1,0,69.36
高雄市,三民區,本揚里,0,3,4133,66,4199,6110,2,1,2,0,1,0,68.72
高雄市,三民區,寶獅里,0,3,2201,29,2230,3357,2,1,2,0,1,0,66.43
高雄市,三民區,寶德里,0,3,2885,36,2921,4340,2,1,2,0,1,0,67.30
高雄市,三民區,寶泰里,0,3,1939,33,1972,2925,2,1,2,0,1,0,67.42
高雄市,三民區,寶興里,0,3,3463,45,3508,5078,2,1,2,0,1,0,69.08
高雄市,三民區,寶中里,0,3,1893,28,1921,2593,2,1,2,0,1,0,74.08
高雄市,三民區,寶華里,0,3,1812,28,1840,2649,2,1,2,0,1,0,69.46
高雄市,三民區,寶國里,0,3,3990,57,4047,5946,2,1,2,0,1,0,68.06
高雄市,三民區,寶民里,0,3,1718,30,1748,2520,2,1,2,0,1,0,69.37
高雄市,三民區,寶慶里,0,3,1578,31,1609,2372,2,1,2,0,1,0,67.83
高雄市,三民區,寶業里,0,3,2542,56,2598,3900,2,1,2,0,1,0,66.62
高雄市,三民區,寶盛里,0,3,2632,33,2665,3831,2,1,2,0,1,0,69.56
高雄市,三民區,寶安里,0,3,3696,56,3752,5663,2,1,2,0,1,0,66.25
高雄市,三民區,寶龍里,0,3,2665,41,2706,3842,2,1,2,0,1,0,70.43
高雄市,三民區,寶珠里,0,3,3023,50,3073,4415,2,1,2,0,1,0,69.60
高雄市,三民區,寶玉里,0,3,4387,53,4440,6497,2,1,2,0,1,0,68.34
高雄市,三民區,灣子里,0,3,1904,28,1932,2912,2,1,2,0,1,0,66.35
高雄市,三民區,灣愛里,0,3,1912,30,1942,2830,2,1,2,0,1,0,68.62
高雄市,三民區,灣中里,0,3,2747,42,2789,4026,2,1,2,0,1,0,69.27
高雄市,三民區,灣華里,0,3,1740,20,1760,2491,2,1,2,0,1,0,70.65
高雄市,三民區,灣勝里,0,3,1454,18,1472,2011,2,1,2,0,1,0,73.20
高雄市,三民區,灣利里,0,3,2314,33,2347,3276,2,1,2,0,1,0,71.64
高雄市,三民區,灣復里,0,3,1900,25,1925,2884,2,1,2,0,1,0,66.75
高雄市,三民區,正興里,0,3,5594,67,5661,8417,2,1,2,0,1,0,67.26
高雄市,三民區,正順里,0,3,2196,22,2218,3174,2,1,2,0,1,0,69.88
高雄市,三民區,灣興里,0,3,1071,12,1083,1542,2,1,2,0,1,0,70.23
高雄市,三民區,灣成里,0,3,1296,10,1306,1831,2,1,2,0,1,0,71.33
高雄市,三民區,安康里,0,3,1994,25,2019,2974,2,1,2,0,1,0,67.89
高雄市,三民區,安寧里,0,3,1498,12,1510,2091,2,1,2,0,1,0,72.21
高雄市,三民區,安吉里,0,3,2581,33,2614,3951,2,1,2,0,1,0,66.16
高雄市,三民區,安發里,0,3,2752,34,2786,3998,2,1,2,0,1,0,69.68
高雄市,三民區,安東里,0,3,2242,39,2281,3149,2,1,2,0,1,0,72.44
高雄市,三民區,安和里,0,3,1877,38,1915,2663,2,1,2,0,1,0,71.91
高雄市,三民區,達德里,0,3,1106,15,1121,1474,2,1,2,0,1,0,76.05
高雄市,三民區,達明里,0,3,1229,21,1250,1683,2,1,2,0,1,0,74.27
高雄市,三民區,達仁里,0,3,1032,21,1053,1448,2,1,2,0,1,0,72.72
高雄市,三民區,達勇里,0,3,739,10,749,1056,2,1,2,0,1,0,70.93
高雄市,三民區,同德里,0,3,1869,24,1893,2744,2,1,2,0,1,0,68.99
高雄市,三民區,德智里,0,3,1745,30,1775,2444,2,1,2,0,1,0,72.63
高雄市,三民區,德仁里,0,3,1315,12,1327,1950,2,1,2,0,1,0,68.05
高雄市,三民區,安生里,0,3,1227,19,1246,1726,2,1,2,0,1,0,72.19
高雄市,三民區,德東里,0,3,660,10,670,873,2,1,2,0,1,0,76.75
高雄市,三民區,德行里,0,3,787,14,801,1112,2,1,2,0,1,0,72.03
高雄市,三民區,精華里,0,3,1189,19,1208,1617,2,1,2,0,1,0,74.71
高雄市,三民區,民享里,0,3,1525,23,1548,2073,2,1,2,0,1,0,74.67
高雄市,三民區,安宜里,0,3,2405,39,2444,3249,2,1,2,0,1,0,75.22
高雄市,三民區,安泰里,0,3,2787,50,2837,3960,2,1,2,0,1,0,71.64
高雄市,三民區,安邦里,0,3,2509,42,2551,3965,2,1,2,0,1,0,64.34
高雄市,三民區,十全里,0,3,1172,9,1181,1581,2,1,2,0,1,0,74.70
高雄市,三民區,十美里,0,3,1327,16,1343,1797,2,1,2,0,1,0,74.74
高雄市,三民區,德北里,0,3,1455,18,1473,2061,2,1,2,0,1,0,71.47
高雄市,三民區,立誠里,0,3,728,9,737,976,2,1,2,0,1,0,75.51
高雄市,三民區,立業里,0,3,837,13,850,1176,2,1,2,0,1,0,72.28
高雄市,三民區,港東里,0,3,898,16,914,1395,2,1,2,0,1,0,65.52
高雄市,三民區,港新里,0,3,955,20,975,1421,2,1,2,0,1,0,68.61
高雄市,三民區,港西里,0,3,552,12,564,839,2,1,2,0,1,0,67.22
高雄市,三民區,港北里,0,3,330,8,338,452,2,1,2,0,1,0,74.78
高雄市,三民區,博愛里,0,3,794,6,800,1174,2,1,2,0,1,0,68.14
高雄市,三民區,博惠里,0,3,2747,59,2806,3965,2,1,2,0,1,0,70.77
高雄市,三民區,長明里,0,3,817,8,825,1158,2,1,2,0,1,0,71.24
高雄市,三民區,建東里,0,3,649,15,664,1086,2,1,2,0,1,0,61.14
高雄市,三民區,興德里,0,3,1064,19,1083,1571,2,1,2,0,1,0,68.94
高雄市,三民區,鳳南里,0,3,878,10,888,1148,2,1,2,0,1,0,77.35
高雄市,三民區,鳳北里,0,3,1473,25,1498,1985,2,1,2,0,1,0,75.47
高雄市,三民區,德西里,0,3,905,17,922,1252,2,1,2,0,1,0,73.64
高雄市,三民區,九如里,0,3,300,4,304,431,2,1,2,0,1,0,70.53
高雄市,三民區,豐裕里,0,3,1904,33,1937,2672,2,1,2,0,1,0,72.49
高雄市,三民區,川東里,0,3,1415,34,1449,1923,2,1,2,0,1,0,75.35
高雄市,三民區,裕民里,0,3,585,12,597,774,2,1,2,0,1,0,77.13
高雄市,三民區,力行里,0,3,902,9,911,1149,2,1,2,0,1,0,79.29
高雄市,三民區,千歲里,0,3,879,11,890,1172,2,1,2,0,1,0,75.94
高雄市,三民區,立德里,0,3,991,19,1010,1345,2,1,2,0,1,0,75.09
高雄市,三民區,千北里,0,3,961,21,982,1276,2,1,2,0,1,0,76.96
高雄市,三民區,千秋里,0,3,1600,25,1625,2369,2,1,2,0,1,0,68.59
高雄市,新興區,浩然里,0,4,1344,22,1366,1960,2,1,2,0,1,0,69.69
高雄市,新興區,振成里,0,4,874,9,883,1315,2,1,2,0,1,0,67.15
高雄市,新興區,德生里,0,4,1568,15,1583,2289,2,1,2,0,1,0,69.16
高雄市,新興區,振華里,0,4,955,12,967,1339,2,1,2,0,1,0,72.22
高雄市,新興區,正氣里,0,4,1192,22,1214,1631,2,1,2,0,1,0,74.43
高雄市,新興區,德政里,0,4,519,10,529,747,2,1,2,0,1,0,70.82
高雄市,新興區,仁聲里,0,4,546,8,554,811,2,1,2,0,1,0,68.31
高雄市,新興區,德望里,0,4,1329,36,1365,2003,2,1,2,0,1,0,68.15
高雄市,新興區,華聲里,0,4,771,6,777,1094,2,1,2,0,1,0,71.02
高雄市,新興區,蕉園里,0,4,582,5,587,790,2,1,2,0,1,0,74.30
高雄市,新興區,永寧里,0,4,1020,26,1046,1451,2,1,2,0,1,0,72.09
高雄市,新興區,玉衡里,0,4,824,4,828,1096,2,1,2,0,1,0,75.55
高雄市,新興區,順昌里,0,4,1509,34,1543,2108,2,1,2,0,1,0,73.20
高雄市,新興區,文昌里,0,4,1746,31,1777,2514,2,1,2,0,1,0,70.68
高雄市,新興區,光耀里,0,4,1696,21,1717,2443,2,1,2,0,1,0,70.28
高雄市,新興區,興昌里,0,4,1279,21,1300,1772,2,1,2,0,1,0,73.36
高雄市,新興區,開平里,0,4,2126,41,2167,2943,2,1,2,0,1,0,73.63
高雄市,新興區,成功里,0,4,828,11,839,1196,2,1,2,0,1,0,70.15
高雄市,新興區,新江里,0,4,794,5,799,1172,2,1,2,0,1,0,68.17
高雄市,新興區,黎明里,0,4,662,12,674,950,2,1,2,0,1,0,70.95
高雄市,新興區,愛平里,0,4,642,15,657,911,2,1,2,0,1,0,72.12
高雄市,新興區,南港里,0,4,1666,23,1689,2241,2,1,2,0,1,0,75.37
高雄市,新興區,中東里,0,4,1625,31,1656,2578,2,1,2,0,1,0,64.24
高雄市,新興區,明莊里,0,4,660,13,673,923,2,1,2,0,1,0,72.91
高雄市,新興區,大明里,0,4,885,16,901,1238,2,1,2,0,1,0,72.78
高雄市,新興區,秋山里,0,4,810,8,818,1150,2,1,2,0,1,0,71.13
高雄市,新興區,長驛里,0,4,685,10,695,925,2,1,2,0,1,0,75.14
高雄市,新興區,建興里,0,4,666,8,674,948,2,1,2,0,1,0,71.10
高雄市,新興區,建華里,0,4,655,7,662,962,2,1,2,0,1,0,68.81
高雄市,新興區,漢民里,0,4,669,14,683,872,2,1,2,0,1,0,78.33
高雄市,新興區,榮治里,0,4,723,10,733,987,2,1,2,0,1,0,74.27
高雄市,新興區,東坡里,0,4,1132,21,1153,1470,2,1,2,0,1,0,78.44
高雄市,前金區,三川里,0,4,559,10,569,807,2,1,2,0,1,0,70.51
高雄市,前金區,草江里,0,4,866,11,877,1212,2,1,2,0,1,0,72.36
高雄市,前金區,長城里,0,4,1030,13,1043,1448,2,1,2,0,1,0,72.03
高雄市,前金區,北金里,0,4,624,12,636,888,2,1,2,0,1,0,71.62
高雄市,前金區,東金里,0,4,613,14,627,921,2,1,2,0,1,0,68.08
高雄市,前金區,新生里,0,4,2179,36,2215,3141,2,1,2,0,1,0,70.52
高雄市,前金區,後金里,0,4,691,13,704,979,2,1,2,0,1,0,71.91
高雄市,前金區,長興里,0,4,762,12,774,1129,2,1,2,0,1,0,68.56
高雄市,前金區,青山里,0,4,932,13,945,1420,2,1,2,0,1,0,66.55
高雄市,前金區,民生里,0,4,517,6,523,777,2,1,2,0,1,0,67.31
高雄市,前金區,復元里,0,4,739,7,746,1084,2,1,2,0,1,0,68.82
高雄市,前金區,林投里,0,4,830,8,838,1232,2,1,2,0,1,0,68.02
高雄市,前金區,國民里,0,4,766,17,783,1095,2,1,2,0,1,0,71.51
高雄市,前金區,社東里,0,4,1243,21,1264,1730,2,1,2,0,1,0,73.06
高雄市,前金區,社西里,0,4,703,16,719,1038,2,1,2,0,1,0,69.27
高雄市,前金區,博孝里,0,4,718,17,735,1018,2,1,2,0,1,0,72.20
高雄市,前金區,長生里,0,4,1031,16,1047,1549,2,1,2,0,1,0,67.59
高雄市,前金區,榮復里,0,4,984,13,997,1347,2,1,2,0,1,0,74.02
高雄市,前金區,文西里,0,4,797,5,802,1103,2,1,2,0,1,0,72.71
高雄市,前金區,文東里,0,4,1024,16,1040,1453,2,1,2,0,1,0,71.58
高雄市,苓雅區,博仁里,0,4,503,10,513,681,2,1,2,0,1,0,75.33
高雄市,苓雅區,苓洲里,0,4,969,12,981,1398,2,1,2,0,1,0,70.17
高雄市,苓雅區,苓昇里,0,4,1157,19,1176,1488,2,1,2,0,1,0,79.03
高雄市,苓雅區,苓中里,0,4,1195,24,1219,1626,2,1,2,0,1,0,74.97
高雄市,苓雅區,苓雅里,0,4,1048,11,1059,1461,2,1,2,0,1,0,72.48
高雄市,苓雅區,苓東里,0,4,1083,23,1106,1527,2,1,2,0,1,0,72.43
高雄市,苓雅區,城北里,0,4,1037,24,1061,1487,2,1,2,0,1,0,71.35
高雄市,苓雅區,城西里,0,4,506,10,516,706,2,1,2,0,1,0,73.09
高雄市,苓雅區,城東里,0,4,1154,23,1177,1626,2,1,2,0,1,0,72.39
高雄市,苓雅區,意誠里,0,4,1628,35,1663,2635,2,1,2,0,1,0,63.11
高雄市,苓雅區,鼓中里,0,4,1010,11,1021,1296,2,1,2,0,1,0,78.78
高雄市,苓雅區,田西里,0,4,1077,13,1090,1486,2,1,2,0,1,0,73.35
高雄市,苓雅區,人和里,0,4,1320,19,1339,1887,2,1,2,0,1,0,70.96
高雄市,苓雅區,仁政里,0,4,1206,15,1221,1756,2,1,2,0,1,0,69.53
高雄市,苓雅區,廣澤里,0,4,1469,26,1495,1915,2,1,2,0,1,0,78.07
高雄市,苓雅區,美田里,0,4,927,11,938,1276,2,1,2,0,1,0,73.51
高雄市,苓雅區,華堂里,0,4,2002,49,2051,2993,2,1,2,0,1,0,68.53
高雄市,苓雅區,日中里,0,4,1664,29,1693,2336,2,1,2,0,1,0,72.47
高雄市,苓雅區,普照里,0,4,1863,35,1898,2626,2,1,2,0,1,0,72.28
高雄市,苓雅區,和煦里,0,4,1576,23,1599,2176,2,1,2,0,1,0,73.48
高雄市,苓雅區,晴朗里,0,4,783,10,793,1396,2,1,2,0,1,0,56.81
高雄市,苓雅區,普天里,0,4,2027,40,2067,2836,2,1,2,0,1,0,72.88
高雄市,苓雅區,林富里,0,4,1207,25,1232,1773,2,1,2,0,1,0,69.49
高雄市,苓雅區,林圍里,0,4,1388,28,1416,2016,2,1,2,0,1,0,70.24
高雄市,苓雅區,林安里,0,4,1205,8,1213,1624,2,1,2,0,1,0,74.69
高雄市,苓雅區,光華里,0,4,564,9,573,797,2,1,2,0,1,0,71.89
高雄市,苓雅區,林興里,0,4,1086,22,1108,1481,2,1,2,0,1,0,74.81
高雄市,苓雅區,林華里,0,4,2106,34,2140,3003,2,1,2,0,1,0,71.26
高雄市,苓雅區,林西里,0,4,1248,21,1269,1796,2,1,2,0,1,0,70.66
高雄市,苓雅區,林中里,0,4,2265,37,2302,3204,2,1,2,0,1,0,71.85
高雄市,苓雅區,林泉里,0,4,1235,17,1252,1799,2,1,2,0,1,0,69.59
高雄市,苓雅區,林南里,0,4,1854,34,1888,2773,2,1,2,0,1,0,68.09
高雄市,苓雅區,中正里,0,4,1686,26,1712,2490,2,1,2,0,1,0,68.76
高雄市,苓雅區,尚義里,0,4,948,16,964,1419,2,1,2,0,1,0,67.94
高雄市,苓雅區,同慶里,0,4,1121,32,1153,1590,2,1,2,0,1,0,72.52
高雄市,苓雅區,凱旋里,0,4,1482,21,1503,1961,2,1,2,0,1,0,76.64
高雄市,苓雅區,安祥里,0,4,1538,35,1573,2253,2,1,2,0,1,0,69.82
高雄市,苓雅區,奏捷里,0,4,1273,9,1282,1684,2,1,2,0,1,0,76.13
高雄市,苓雅區,福壽里,0,4,1115,11,1126,1527,2,1,2,0,1,0,73.74
高雄市,苓雅區,福南里,0,4,1811,27,1838,2469,2,1,2,0,1,0,74.44
高雄市,苓雅區,五權里,0,4,1387,25,1412,1971,2,1,2,0,1,0,71.64
高雄市,苓雅區,民主里,0,4,2536,40,2576,3768,2,1,2,0,1,0,68.37
高雄市,苓雅區,林德里,0,4,1233,16,1249,1760,2,1,2,0,1,0,70.97
高雄市,苓雅區,林貴里,0,4,976,11,987,1341,2,1,2,0,1,0,73.60
高雄市,苓雅區,林榮里,0,4,2695,53,2748,3893,2,1,2,0,1,0,70.59
高雄市,苓雅區,英明里,0,4,1388,26,1414,2032,2,1,2,0,1,0,69.59
高雄市,苓雅區,林靖里,0,4,1273,19,1292,1765,2,1,2,0,1,0,73.20
高雄市,苓雅區,朝陽里,0,4,1063,15,1078,1491,2,1,2,0,1,0,72.30
高雄市,苓雅區,福隆里,0,4,1961,29,1990,2767,2,1,2,0,1,0,71.92
高雄市,苓雅區,福祥里,0,4,929,18,947,1315,2,1,2,0,1,0,72.02
高雄市,苓雅區,福海里,0,4,783,11,794,1071,2,1,2,0,1,0,74.14
高雄市,苓雅區,福康里,0,4,1440,17,1457,1962,2,1,2,0,1,0,74.26
高雄市,苓雅區,福人里,0,4,1629,33,1662,2173,2,1,2,0,1,0,76.48
高雄市,苓雅區,福地里,0,4,2149,35,2184,2901,2,1,2,0,1,0,75.28
高雄市,苓雅區,福居里,0,4,2154,34,2188,2884,2,1,2,0,1,0,75.87
高雄市,苓雅區,福東里,0,4,1809,37,1846,2548,2,1,2,0,1,0,72.45
高雄市,苓雅區,福西里,0,4,1716,36,1752,2267,2,1,2,0,1,0,77.28
高雄市,苓雅區,永康里,0,4,1735,31,1766,2395,2,1,2,0,1,0,73.74
高雄市,苓雅區,正文里,0,4,1204,18,1222,1707,2,1,2,0,1,0,71.59
高雄市,苓雅區,正言里,0,4,1977,30,2007,2762,2,1,2,0,1,0,72.66
高雄市,苓雅區,正大里,0,4,2926,55,2981,4387,2,1,2,0,1,0,67.95
高雄市,苓雅區,五福里,0,4,2740,45,2785,3865,2,1,2,0,1,0,72.06
高雄市,苓雅區,正心里,0,4,2380,63,2443,3532,2,1,2,0,1,0,69.17
高雄市,苓雅區,正道里,0,4,2913,56,2969,4060,2,1,2,0,1,0,73.13
高雄市,苓雅區,正義里,0,4,1652,20,1672,2343,2,1,2,0,1,0,71.36
高雄市,苓雅區,正仁里,0,4,1733,25,1758,2406,2,1,2,0,1,0,73.07
高雄市,苓雅區,文昌里,0,4,2863,50,2913,3902,2,1,2,0,1,0,74.65
高雄市,苓雅區,建軍里,0,4,1495,23,1518,2009,2,1,2,0,1,0,75.56
高雄市,苓雅區,衛武里,0,4,1510,17,1527,2127,2,1,2,0,1,0,71.79
高雄市,前鎮區,草衙里,0,5,5448,106,5554,8044,2,1,2,0,1,0,69.05
高雄市,前鎮區,明孝里,0,5,1820,43,1863,2520,2,1,2,0,1,0,73.93
高雄市,前鎮區,明正里,0,5,2250,36,2286,3202,2,1,2,0,1,0,71.39
高雄市,前鎮區,明義里,0,5,1320,22,1342,1709,2,1,2,0,1,0,78.53
高雄市,前鎮區,仁愛里,0,5,1098,8,1106,1500,2,1,2,0,1,0,73.73
高雄市,前鎮區,德昌里,0,5,1349,21,1370,1896,2,1,2,0,1,0,72.26
高雄市,前鎮區,平等里,0,5,1269,28,1297,2060,2,1,2,0,1,0,62.96
高雄市,前鎮區,平昌里,0,5,559,6,565,756,2,1,2,0,1,0,74.74
高雄市,前鎮區,明禮里,0,5,1296,19,1315,1765,2,1,2,0,1,0,74.50
高雄市,前鎮區,信義里,0,5,1303,16,1319,1752,2,1,2,0,1,0,75.29
高雄市,前鎮區,信德里,0,5,1799,21,1820,2506,2,1,2,0,1,0,72.63
高雄市,前鎮區,明道里,0,5,967,11,978,1329,2,1,2,0,1,0,73.59
高雄市,前鎮區,興化里,0,5,676,11,687,920,2,1,2,0,1,0,74.67
高雄市,前鎮區,興仁里,0,5,679,12,691,983,2,1,2,0,1,0,70.30
高雄市,前鎮區,前鎮里,0,5,1226,22,1248,1584,2,1,2,0,1,0,78.79
高雄市,前鎮區,鎮東里,0,5,1551,30,1581,1983,2,1,2,0,1,0,79.73
高雄市,前鎮區,鎮榮里,0,5,1692,33,1725,2306,2,1,2,0,1,0,74.80
高雄市,前鎮區,鎮昌里,0,5,1577,28,1605,2046,2,1,2,0,1,0,78.45
高雄市,前鎮區,鎮海里,0,5,2670,42,2712,3750,2,1,2,0,1,0,72.32
高雄市,前鎮區,鎮陽里,0,5,919,14,933,1167,2,1,2,0,1,0,79.95
高雄市,前鎮區,興邦里,0,5,1424,40,1464,1986,2,1,2,0,1,0,73.72
高雄市,前鎮區,鎮中里,0,5,785,5,790,1008,2,1,2,0,1,0,78.37
高雄市,前鎮區,鎮北里,0,5,853,12,865,1074,2,1,2,0,1,0,80.54
高雄市,前鎮區,忠純里,0,5,2122,36,2158,2783,2,1,2,0,1,0,77.54
高雄市,前鎮區,忠誠里,0,5,1648,36,1684,2100,2,1,2,0,1,0,80.19
高雄市,前鎮區,西山里,0,5,2278,51,2329,3188,2,1,2,0,1,0,73.06
高雄市,前鎮區,民權里,0,5,2727,63,2790,3832,2,1,2,0,1,0,72.81
高雄市,前鎮區,建隆里,0,5,613,16,629,837,2,1,2,0,1,0,75.15
高雄市,前鎮區,振興里,0,5,1350,41,1391,1969,2,1,2,0,1,0,70.64
高雄市,前鎮區,良和里,0,5,1829,29,1858,2616,2,1,2,0,1,0,71.02
高雄市,前鎮區,西甲里,0,5,1537,18,1555,2064,2,1,2,0,1,0,75.34
高雄市,前鎮區,盛興里,0,5,1603,48,1651,2458,2,1,2,0,1,0,67.17
高雄市,前鎮區,盛豐里,0,5,1873,34,1907,2804,2,1,2,0,1,0,68.01
高雄市,前鎮區,興中里,0,5,2042,43,2085,3097,2,1,2,0,1,0,67.32
高雄市,前鎮區,興東里,0,5,2963,80,3043,4283,2,1,2,0,1,0,71.05
高雄市,前鎮區,忠孝里,0,5,1650,34,1684,2288,2,1,2,0,1,0,73.60
高雄市,前鎮區,復國里,0,5,1952,31,1983,2736,2,1,2,0,1,0,72.48
高雄市,前鎮區,竹內里,0,5,1879,29,1908,2585,2,1,2,0,1,0,73.81
高雄市,前鎮區,竹東里,0,5,1359,35,1394,2069,2,1,2,0,1,0,67.38
高雄市,前鎮區,竹南里,0,5,1779,36,1815,2568,2,1,2,0,1,0,70.68
高雄市,前鎮區,竹北里,0,5,1309,31,1340,1940,2,1,2,0,1,0,69.07
高雄市,前鎮區,竹西里,0,5,2549,57,2606,3514,2,1,2,0,1,0,74.16
高雄市,前鎮區,竹中里,0,5,1895,41,1936,2677,2,1,2,0,1,0,72.32
高雄市,前鎮區,瑞竹里,0,5,874,21,895,1262,2,1,2,0,1,0,70.92
高雄市,前鎮區,瑞南里,0,5,3297,56,3353,4461,2,1,2,0,1,0,75.16
高雄市,前鎮區,瑞豐里,0,5,1784,37,1821,2376,2,1,2,0,1,0,76.64
高雄市,前鎮區,瑞祥里,0,5,3343,56,3399,4651,2,1,2,0,1,0,73.08
高雄市,前鎮區,瑞東里,0,5,1869,37,1906,2492,2,1,2,0,1,0,76.48
高雄市,前鎮區,瑞和里,0,5,1442,18,1460,1987,2,1,2,0,1,0,73.48
高雄市,前鎮區,瑞平里,0,5,2579,44,2623,3509,2,1,2,0,1,0,74.75
高雄市,前鎮區,瑞隆里,0,5,2406,39,2445,3440,2,1,2,0,1,0,71.08
高雄市,前鎮區,瑞北里,0,5,2149,43,2192,2934,2,1,2,0,1,0,74.71
高雄市,前鎮區,瑞西里,0,5,2107,42,2149,2716,2,1,2,0,1,0,79.12
高雄市,前鎮區,瑞崗里,0,5,1987,31,2018,2701,2,1,2,0,1,0,74.71
高雄市,前鎮區,瑞興里,0,5,1936,31,1967,2701,2,1,2,0,1,0,72.82
高雄市,前鎮區,瑞誠里,0,5,1588,38,1626,2316,2,1,2,0,1,0,70.21
高雄市,前鎮區,瑞文里,0,5,1674,28,1702,2423,2,1,2,0,1,0,70.24
高雄市,前鎮區,瑞華里,0,5,2860,54,2914,4180,2,1,2,0,1,0,69.71
高雄市,前鎮區,瑞昌里,0,5,1907,34,1941,2750,2,1,2,0,1,0,70.58
高雄市,小港區,小港里,0,5,1240,18,1258,1709,2,1,2,0,1,0,73.61
高雄市,小港區,港口里,0,5,2157,35,2192,3062,2,1,2,0,1,0,71.59
高雄市,小港區,港正里,0,5,1661,24,1685,2338,2,1,2,0,1,0,72.07
高雄市,小港區,港墘里,0,5,1110,15,1125,1488,2,1,2,0,1,0,75.60
高雄市,小港區,港明里,0,5,1949,36,1985,2761,2,1,2,0,1,0,71.89
高雄市,小港區,港后里,0,5,1310,12,1322,1814,2,1,2,0,1,0,72.88
高雄市,小港區,港南里,0,5,973,15,988,1409,2,1,2,0,1,0,70.12
高雄市,小港區,港興里,0,5,1406,16,1422,1932,2,1,2,0,1,0,73.60
高雄市,小港區,鳳宮里,0,5,1168,21,1189,1747,2,1,2,0,1,0,68.06
高雄市,小港區,店鎮里,0,5,2894,42,2936,4239,2,1,2,0,1,0,69.26
高雄市,小港區,大苓里,0,5,1485,21,1506,2079,2,1,2,0,1,0,72.44
高雄市,小港區,二苓里,0,5,1974,42,2016,2887,2,1,2,0,1,0,69.83
高雄市,小港區,三苓里,0,5,1726,25,1751,2407,2,1,2,0,1,0,72.75
高雄市,小港區,正苓里,0,5,2103,25,2128,3227,2,1,2,0,1,0,65.94
高雄市,小港區,順苓里,0,5,2300,29,2329,3357,2,1,2,0,1,0,69.38
高雄市,小港區,六苓里,0,5,974,19,993,1357,2,1,2,0,1,0,73.18
高雄市,小港區,宏亮里,0,5,1647,35,1682,2370,2,1,2,0,1,0,70.97
高雄市,小港區,山東里,0,5,1676,23,1699,2461,2,1,2,0,1,0,69.04
高雄市,小港區,青島里,0,5,1154,21,1175,1589,2,1,2,0,1,0,73.95
高雄市,小港區,濟南里,0,5,2175,28,2203,2887,2,1,2,0,1,0,76.31
高雄市,小港區,泰山里,0,5,1522,13,1535,2065,2,1,2,0,1,0,74.33
高雄市,小港區,山明里,0,5,3488,39,3527,4926,2,1,2,0,1,0,71.60
高雄市,小港區,高松里,0,5,2206,37,2243,3097,2,1,2,0,1,0,72.42
高雄市,小港區,松金里,0,5,1328,27,1355,1912,2,1,2,0,1,0,70.87
高雄市,小港區,松山里,0,5,1277,22,1299,1808,2,1,2,0,1,0,71.85
高雄市,小港區,大坪里,0,5,823,14,837,1102,2,1,2,0,1,0,75.95
高雄市,小港區,坪頂里,0,5,954,15,969,1266,2,1,2,0,1,0,76.54
高雄市,小港區,孔宅里,0,5,2091,27,2118,3036,2,1,2,0,1,0,69.76
高雄市,小港區,廈莊里,0,5,1181,27,1208,1721,2,1,2,0,1,0,70.19
高雄市,小港區,合作里,0,5,1543,28,1571,2177,2,1,2,0,1,0,72.16
高雄市,小港區,桂林里,0,5,3863,51,3914,5610,2,1,2,0,1,0,69.77
高雄市,小港區,中厝里,0,5,1916,30,1946,2768,2,1,2,0,1,0,70.30
高雄市,小港區,鳳鳴里,0,5,1771,23,1794,2284,2,1,2,0,1,0,78.55
高雄市,小港區,龍鳳里,0,5,1625,21,1646,2098,2,1,2,0,1,0,78.46
高雄市,小港區,鳳森里,0,5,1193,14,1207,1535,2,1,2,0,1,0,78.63
高雄市,小港區,鳳林里,0,5,1514,18,1532,2080,2,1,2,0,1,0,73.65
高雄市,小港區,鳳興里,0,5,1241,12,1253,1653,2,1,2,0,1,0,75.80
高雄市,小港區,鳳源里,0,5,1733,27,1760,2418,2,1,2,0,1,0,72.79
高雄市,小港區,海澄里,0,5,3216,34,3250,4632,2,1,2,0,1,0,70.16
高雄市,小港區,海昌里,0,5,1580,12,1592,2369,2,1,2,0,1,0,67.20
高雄市,小港區,海豐里,0,5,1589,12,1601,2479,2,1,2,0,1,0,64.58
高雄市,小港區,海原里,0,5,1883,25,1908,2885,2,1,2,0,1,0,66.14
高雄市,小港區,海城里,0,5,1888,28,1916,2933,2,1,2,0,1,0,65.33
