CountyCityName,TownshipName,VillageName,PollStationNo,DistrictName,BallotsAccepted,BallotsRejected,BallotsCast,Voters,CandidateCounts,ElectedCounts,CandidateMaleCounts,CandidateFemaleCounts,ElectedMaleCounts,ElectedFemaleCounts,BallotsRate
全國,,,0,0,10174005,137448,10311453,15550197,434,168,353,81,131,37,66.31
臺北市,,,0,0,1221302,11979,1233281,1914578,69,20,53,16,13,7,64.42
臺北市,,,0,0,619102,6275,625377,972088,32,10,25,7,6,4,64.33
臺北市,,,0,0,602200,5704,607904,942490,37,10,28,9,7,3,64.50
高雄市,,,0,2,694094,7317,701411,1061516,36,11,30,6,10,1,66.08
高雄市,,,0,2,390190,3875,394065,600021,17,6,13,4,5,1,65.68
高雄市,,,0,2,303904,3442,307346,461495,19,5,17,2,5,0,66.60
臺北縣,,,0,3,1686473,25379,1711852,2511073,69,27,55,14,22,5,68.17
臺北縣,,,0,3,498262,7886,506148,736128,23,8,19,4,7,1,68.76
臺北縣,,,0,3,600959,9643,610602,911610,19,10,14,5,8,2,66.98
臺北縣,,,0,3,587252,7850,595102,863335,27,9,22,5,7,2,68.93
宜蘭縣,,,0,0,204046,2184,206230,323032,10,4,9,1,3,1,63.84
桃園縣,,,0,0,786642,11909,798551,1165237,26,13,21,5,10,3,68.53
新竹縣,,,0,0,204107,3519,207626,294030,6,3,5,1,3,0,70.61
苗栗縣,,,0,0,259114,3719,262833,390370,11,4,10,1,4,0,67.33
臺中縣,,,0,0,661669,10325,671994,1013034,21,11,17,4,10,1,66.33
彰化縣,,,0,0,614430,9419,623849,915095,19,10,17,2,8,2,68.17
南投縣,,,0,0,247254,2544,249798,371042,11,4,10,1,4,0,67.32
雲林縣,,,0,0,338424,4950,343374,541514,12,6,9,3,4,2,63.41
嘉義縣,,,0,0,261700,4657,266357,411071,10,4,8,2,3,1,64.80
臺南縣,,,0,0,532857,6203,539060,800940,20,8,17,3,7,1,67.30
高雄縣,,,0,0,578730,6870,585600,880896,19,9,14,5,6,3,66.48
屏東縣,,,0,0,409774,4721,414495,619161,15,7,12,3,5,2,66.94
臺東縣,,,0,0,71156,1095,72251,122239,5,1,5,0,1,0,59.11
花蓮縣,,,0,0,117947,2090,120037,195975,6,2,6,0,2,0,61.25
澎湖縣,,,0,0,40022,636,40658,67168,5,1,4,1,1,0,60.53
基隆市,,,0,0,172074,2631,174705,276434,7,3,6,1,2,1,63.20
新竹市,,,0,0,161768,2422,164190,256635,11,3,7,4,2,1,63.98
臺中市,,,0,0,432572,6535,439107,664334,20,7,17,3,5,2,66.10
嘉義市,,,0,0,119970,1497,121467,186527,6,2,4,2,1,1,65.12
臺南市,,,0,0,328303,4071,332374,522165,13,6,10,3,3,3,63.65
金門縣,,,0,0,25025,657,25682,39922,5,1,5,0,1,0,64.33
連江縣,,,0,0,4552,119,4671,6209,2,1,2,0,1,0,75.23
宜蘭縣,,,0,0,204046,2184,206230,323032,10,4,9,1,3,1,63.84
桃園縣,,,0,0,786642,11909,798551,1165237,26,13,21,5,10,3,68.53
新竹縣,,,0,0,204107,3519,207626,294030,6,3,5,1,3,0,70.61
苗栗縣,,,0,0,259114,3719,262833,390370,11,4,10,1,4,0,67.33
臺中縣,,,0,0,661669,10325,671994,1013034,21,11,17,4,10,1,66.33
彰化縣,,,0,0,614430,9419,623849,915095,19,10,17,2,8,2,68.17
南投縣,,,0,0,247254,2544,249798,371042,11,4,10,1,4,0,67.32
雲林縣,,,0,0,338424,4950,343374,541514,12,6,9,3,4,2,63.41
嘉義縣,,,0,0,261700,4657,266357,411071,10,4,8,2,3,1,64.80
臺南縣,,,0,0,532857,6203,539060,800940,20,8,17,3,7,1,67.30
高雄縣,,,0,0,578730,6870,585600,880896,19,9,14,5,6,3,66.48
屏東縣,,,0,0,409774,4721,414495,619161,15,7,12,3,5,2,66.94
臺東縣,,,0,0,71156,1095,72251,122239,5,1,5,0,1,0,59.11
花蓮縣,,,0,0,117947,2090,120037,195975,6,2,6,0,2,0,61.25
澎湖縣,,,0,0,40022,636,40658,67168,5,1,4,1,1,0,60.53
基隆市,,,0,0,172074,2631,174705,276434,7,3,6,1,2,1,63.20
新竹市,,,0,0,161768,2422,164190,256635,11,3,7,4,2,1,63.98
臺中市,,,0,0,432572,6535,439107,664334,20,7,17,3,5,2,66.10
嘉義市,,,0,0,119970,1497,121467,186527,6,2,4,2,1,1,65.12
臺南市,,,0,0,328303,4071,332374,522165,13,6,10,3,3,3,63.65
金門縣,,,0,0,25025,657,25682,39922,5,1,5,0,1,0,64.33
連江縣,,,0,0,4552,119,4671,6209,2,1,2,0,1,0,75.23
臺北市,北投區,,0,1,114781,1281,116062,179032,3,1,3,0,1,0,64.83
臺北市,士林區,,0,1,135918,1371,137289,213288,3,1,3,0,1,0,64.37
臺北市,內湖區,,0,1,110805,1088,111893,173690,3,1,3,0,1,0,64.42
臺北市,南港區,,0,1,51591,640,52231,81166,3,1,3,0,1,0,64.35
臺北市,松山區,,0,1,94234,757,94991,148431,3,1,3,0,1,0,64.00
臺北市,信義區,,0,1,111773,1138,112911,176481,3,1,3,0,1,0,63.98
臺北市,中山區,,0,2,99392,1052,100444,161246,3,1,3,0,1,0,62.29
臺北市,大同區,,0,2,60837,667,61504,97304,3,1,3,0,1,0,63.21
臺北市,中正區,,0,2,74595,641,75236,116208,3,1,3,0,1,0,64.74
臺北市,萬華區,,0,2,98868,1124,99992,153456,3,1,3,0,1,0,65.16
臺北市,大安區,,0,2,149352,1082,150434,232943,3,1,3,0,1,0,64.58
臺北市,文山區,,0,2,119156,1138,120294,181333,3,1,3,0,1,0,66.34
高雄市,鹽埕區,,0,1,15569,164,15733,23418,3,1,3,0,1,0,67.18
高雄市,鼓山區,,0,1,52387,541,52928,79129,3,1,3,0,1,0,66.89
高雄市,左營區,,0,1,76919,728,77647,118215,3,1,3,0,1,0,65.68
高雄市,楠梓區,,0,1,69609,685,70294,105519,3,1,3,0,1,0,66.62
高雄市,三民區,,0,1,161439,1558,162997,251000,3,1,3,0,1,0,64.94
高雄市,旗津區,,0,1,14267,199,14466,22740,3,1,3,0,1,0,63.61
高雄市,新興區,,0,2,29528,293,29821,45447,3,1,3,0,1,0,65.62
高雄市,前金區,,0,2,16287,161,16448,25138,3,1,3,0,1,0,65.43
高雄市,苓雅區,,0,2,94858,1124,95982,145146,3,1,3,0,1,0,66.13
高雄市,前鎮區,,0,2,95694,1066,96760,144137,3,1,3,0,1,0,67.13
高雄市,小港區,,0,2,67537,798,68335,101627,3,1,3,0,1,0,67.24
臺北縣,板橋市,,0,1,253695,4148,257843,373955,3,1,3,0,1,0,68.95
臺北縣,土城市,,0,1,102489,1571,104060,151943,3,1,3,0,1,0,68.49
臺北縣,樹林鎮,,0,1,67791,1088,68879,101391,3,1,3,0,1,0,67.93
臺北縣,鶯歌鎮,,0,1,36644,480,37124,53499,3,1,3,0,1,0,69.39
臺北縣,三峽鎮,,0,1,37643,599,38242,55340,3,1,3,0,1,0,69.10
臺北縣,三重市,,0,2,180537,3023,183560,270999,3,1,3,0,1,0,67.73
臺北縣,蘆洲市,,0,2,71173,1070,72243,110289,3,1,3,0,1,0,65.50
臺北縣,新莊市,,0,2,163000,2529,165529,248791,3,1,3,0,1,0,66.53
臺北縣,五股鄉,,0,2,31342,485,31827,47141,3,1,3,0,1,0,67.51
臺北縣,泰山鄉,,0,2,28943,462,29405,42095,3,1,3,0,1,0,69.85
臺北縣,林口鄉,,0,2,23061,336,23397,34162,3,1,3,0,1,0,68.49
臺北縣,淡水鎮,,0,2,54584,978,55562,84378,3,1,3,0,1,0,65.85
臺北縣,八里鄉,,0,2,13606,248,13854,20151,3,1,3,0,1,0,68.75
臺北縣,三芝鄉,,0,2,10575,181,10756,16225,3,1,3,0,1,0,66.29
臺北縣,石門鄉,,0,2,5450,54,5504,8182,3,1,3,0,1,0,67.27
臺北縣,金山鄉,,0,2,9886,129,10015,15233,3,1,3,0,1,0,65.75
臺北縣,萬里鄉,,0,2,8802,148,8950,13964,3,1,3,0,1,0,64.09
臺北縣,中和市,,0,3,202235,2949,205184,293044,3,1,3,0,1,0,70.02
臺北縣,永和市,,0,3,115915,1432,117347,166992,3,1,3,0,1,0,70.27
臺北縣,新店市,,0,3,136770,1661,138431,199342,3,1,3,0,1,0,69.44
臺北縣,深坑鄉,,0,3,9590,151,9741,14636,3,1,3,0,1,0,66.56
臺北縣,石碇鄉,,0,3,3946,64,4010,5904,3,1,3,0,1,0,67.92
臺北縣,坪林鄉,,0,3,3127,44,3171,4885,3,1,3,0,1,0,64.91
臺北縣,烏來鄉,,0,3,1318,11,1329,1913,3,1,3,0,1,0,69.47
臺北縣,汐止鎮,,0,3,76404,967,77371,118743,3,1,3,0,1,0,65.16
臺北縣,瑞芳鎮,,0,3,22465,358,22823,33773,3,1,3,0,1,0,67.58
臺北縣,平溪鄉,,0,3,3250,59,3309,5037,3,1,3,0,1,0,65.69
臺北縣,雙溪鄉,,0,3,5543,56,5599,8384,3,1,3,0,1,0,66.78
臺北縣,貢寮鄉,,0,3,6689,98,6787,10682,3,1,3,0,1,0,63.54
宜蘭縣,宜蘭市,,0,1,40262,435,40697,63545,3,1,3,0,1,0,64.04
宜蘭縣,羅東鎮,,0,1,29983,294,30277,47694,3,1,3,0,1,0,63.48
宜蘭縣,蘇澳鎮,,0,1,20646,203,20849,33560,3,1,3,0,1,0,62.12
宜蘭縣,頭城鎮,,0,1,15018,177,15195,23612,3,1,3,0,1,0,64.35
宜蘭縣,礁溪鄉,,0,1,17486,174,17660,27278,3,1,3,0,1,0,64.74
宜蘭縣,壯圍鄉,,0,1,12317,122,12439,19410,3,1,3,0,1,0,64.09
宜蘭縣,員山鄉,,0,1,14981,180,15161,24457,3,1,3,0,1,0,61.99
宜蘭縣,冬山鄉,,0,1,24069,254,24323,36910,3,1,3,0,1,0,65.90
宜蘭縣,五結鄉,,0,1,17993,202,18195,28242,3,1,3,0,1,0,64.43
宜蘭縣,三星鄉,,0,1,10295,123,10418,16548,3,1,3,0,1,0,62.96
宜蘭縣,大同鄉,,0,1,608,9,617,1013,3,1,3,0,1,0,60.91
宜蘭縣,南澳鄉,,0,1,388,11,399,763,3,1,3,0,1,0,52.29
桃園縣,桃園市,,0,1,147884,1761,149645,222973,3,1,3,0,1,0,67.11
桃園縣,龜山鄉,,0,1,48964,792,49756,77847,3,1,3,0,1,0,63.92
桃園縣,八德市,,0,1,74717,1458,76175,111279,3,1,3,0,1,0,68.45
桃園縣,蘆竹鄉,,0,1,43323,673,43996,65682,3,1,3,0,1,0,66.98
桃園縣,大園鄉,,0,1,34707,519,35226,50657,3,1,3,0,1,0,69.54
桃園縣,大溪鎮,,0,1,37771,571,38342,55111,3,1,3,0,1,0,69.57
桃園縣,復興鄉,,0,1,1768,34,1802,2741,3,1,3,0,1,0,65.74
桃園縣,中壢市,,0,1,153110,2206,155316,222843,3,1,3,0,1,0,69.70
桃園縣,平鎮市,,0,1,87112,1437,88549,127158,3,1,3,0,1,0,69.64
桃園縣,楊梅鎮,,0,1,58261,978,59239,87000,3,1,3,0,1,0,68.09
桃園縣,龍潭鄉,,0,1,47552,770,48322,70765,3,1,3,0,1,0,68.29
桃園縣,新屋鄉,,0,1,25288,326,25614,34493,3,1,3,0,1,0,74.26
桃園縣,觀音鄉,,0,1,26185,384,26569,36688,3,1,3,0,1,0,72.42
新竹縣,竹北市,,0,1,40436,750,41186,60991,3,1,3,0,1,0,67.53
新竹縣,竹東鎮,,0,1,41578,688,42266,59165,3,1,3,0,1,0,71.44
新竹縣,新埔鎮,,0,1,18853,342,19195,26189,3,1,3,0,1,0,73.29
新竹縣,關西鎮,,0,1,16691,271,16962,23184,3,1,3,0,1,0,73.16
新竹縣,湖口鄉,,0,1,30992,548,31540,45384,3,1,3,0,1,0,69.50
新竹縣,新豐鄉,,0,1,20555,352,20907,30670,3,1,3,0,1,0,68.17
新竹縣,芎林鄉,,0,1,10554,172,10726,14459,3,1,3,0,1,0,74.18
新竹縣,橫山鄉,,0,1,8051,131,8182,10939,3,1,3,0,1,0,74.80
新竹縣,北埔鄉,,0,1,5496,97,5593,7593,3,1,3,0,1,0,73.66
新竹縣,寶山鄉,,0,1,6381,98,6479,9119,3,1,3,0,1,0,71.05
新竹縣,峨眉鄉,,0,1,3633,53,3686,4913,3,1,3,0,1,0,75.03
新竹縣,尖石鄉,,0,1,638,15,653,989,3,1,3,0,1,0,66.03
新竹縣,五峰鄉,,0,1,249,2,251,435,3,1,3,0,1,0,57.70
苗栗縣,苗栗市,,0,1,42190,687,42877,63799,3,1,3,0,1,0,67.21
苗栗縣,苑裡鎮,,0,1,22499,283,22782,34512,3,1,3,0,1,0,66.01
苗栗縣,通霄鎮,,0,1,20187,206,20393,29641,3,1,3,0,1,0,68.80
苗栗縣,竹南鎮,,0,1,31213,434,31647,47791,3,1,3,0,1,0,66.22
苗栗縣,頭份鎮,,0,1,39710,511,40221,60515,3,1,3,0,1,0,66.46
苗栗縣,後龍鎮,,0,1,19602,320,19922,30454,3,1,3,0,1,0,65.42
苗栗縣,卓蘭鎮,,0,1,9857,149,10006,14163,3,1,3,0,1,0,70.65
苗栗縣,大湖鄉,,0,1,8233,120,8353,12610,3,1,3,0,1,0,66.24
苗栗縣,公館鄉,,0,1,16803,315,17118,24345,3,1,3,0,1,0,70.31
苗栗縣,銅鑼鄉,,0,1,9943,145,10088,14836,3,1,3,0,1,0,68.00
苗栗縣,南庄鄉,,0,1,5030,63,5093,7732,3,1,3,0,1,0,65.87
苗栗縣,頭屋鄉,,0,1,6293,81,6374,9098,3,1,3,0,1,0,70.06
苗栗縣,三義鄉,,0,1,8599,144,8743,12592,3,1,3,0,1,0,69.43
苗栗縣,西湖鄉,,0,1,4348,75,4423,6570,3,1,3,0,1,0,67.32
苗栗縣,造橋鄉,,0,1,6930,95,7025,10203,3,1,3,0,1,0,68.85
苗栗縣,三灣鄉,,0,1,3903,36,3939,5772,3,1,3,0,1,0,68.24
苗栗縣,獅潭鄉,,0,1,2813,41,2854,4257,3,1,3,0,1,0,67.04
苗栗縣,泰安鄉,,0,1,961,14,975,1480,3,1,3,0,1,0,65.88
臺中縣,豐原市,,0,1,72203,1066,73269,109640,3,1,3,0,1,0,66.83
臺中縣,東勢鎮,,0,1,26971,438,27409,41270,3,1,3,0,1,0,66.41
臺中縣,大甲鎮,,0,1,34511,529,35040,52390,3,1,3,0,1,0,66.88
臺中縣,清水鎮,,0,1,37864,591,38455,58735,3,1,3,0,1,0,65.47
臺中縣,沙鹿鎮,,0,1,33435,556,33991,49421,3,1,3,0,1,0,68.78
臺中縣,梧棲鎮,,0,1,23847,467,24314,33720,3,1,3,0,1,0,72.11
臺中縣,后里鄉,,0,1,26900,489,27389,38754,3,1,3,0,1,0,70.67
臺中縣,神岡鄉,,0,1,28800,483,29283,42722,3,1,3,0,1,0,68.54
臺中縣,潭子鄉,,0,1,37904,593,38497,60512,3,1,3,0,1,0,63.62
臺中縣,大雅鄉,,0,1,33327,533,33860,52676,3,1,3,0,1,0,64.28
臺中縣,新社鄉,,0,1,13300,269,13569,19521,3,1,3,0,1,0,69.51
臺中縣,石岡鄉,,0,1,7649,137,7786,11228,3,1,3,0,1,0,69.34
臺中縣,外埔鄉,,0,1,14575,240,14815,21657,3,1,3,0,1,0,68.41
臺中縣,大安鄉,,0,1,10734,147,10881,15189,3,1,3,0,1,0,71.64
臺中縣,烏日鄉,,0,1,29511,466,29977,44284,3,1,3,0,1,0,67.69
臺中縣,大肚鄉,,0,1,25270,363,25633,36872,3,1,3,0,1,0,69.52
臺中縣,龍井鄉,,0,1,29392,474,29866,44605,3,1,3,0,1,0,66.96
臺中縣,霧峰鄉,,0,1,30130,441,30571,45731,3,1,3,0,1,0,66.85
臺中縣,太平市,,0,1,69677,1101,70778,111981,3,1,3,0,1,0,63.21
臺中縣,大里市,,0,1,72260,891,73151,116057,3,1,3,0,1,0,63.03
臺中縣,和平鄉,,0,1,3409,51,3460,6069,3,1,3,0,1,0,57.01
彰化縣,彰化市,,0,1,105578,1600,107178,157330,3,1,3,0,1,0,68.12
彰化縣,花壇鄉,,0,1,21694,340,22034,31775,3,1,3,0,1,0,69.34
彰化縣,芬園鄉,,0,1,12636,206,12842,19188,3,1,3,0,1,0,66.93
彰化縣,鹿港鎮,,0,1,38554,582,39136,57039,3,1,3,0,1,0,68.61
彰化縣,福興鄉,,0,1,24013,353,24366,33327,3,1,3,0,1,0,73.11
彰化縣,秀水鄉,,0,1,18207,272,18479,25822,3,1,3,0,1,0,71.56
彰化縣,和美鎮,,0,1,40131,690,40821,59199,3,1,3,0,1,0,68.96
彰化縣,線西鄉,,0,1,7857,133,7990,11639,3,1,3,0,1,0,68.65
彰化縣,伸港鄉,,0,1,15396,221,15617,23005,3,1,3,0,1,0,67.89
彰化縣,員林鎮,,0,1,56977,728,57705,86089,3,1,3,0,1,0,67.03
彰化縣,大村鄉,,0,1,17118,239,17357,25291,3,1,3,0,1,0,68.63
彰化縣,永靖鄉,,0,1,19858,282,20140,28288,3,1,3,0,1,0,71.20
彰化縣,溪湖鎮,,0,1,25245,311,25556,37507,3,1,3,0,1,0,68.14
彰化縣,埔鹽鄉,,0,1,17817,280,18097,25271,3,1,3,0,1,0,71.61
彰化縣,埔心鄉,,0,1,17026,257,17283,24621,3,1,3,0,1,0,70.20
彰化縣,田中鎮,,0,1,22393,366,22759,33462,3,1,3,0,1,0,68.01
彰化縣,社頭鄉,,0,1,22206,335,22541,31674,3,1,3,0,1,0,71.17
彰化縣,二水鄉,,0,1,9694,108,9802,13693,3,1,3,0,1,0,71.58
彰化縣,北斗鎮,,0,1,15763,245,16008,23591,3,1,3,0,1,0,67.86
彰化縣,溪州鄉,,0,1,15144,280,15424,24058,3,1,3,0,1,0,64.11
彰化縣,田尾鄉,,0,1,14178,246,14424,20902,3,1,3,0,1,0,69.01
彰化縣,埤頭鄉,,0,1,14920,310,15230,23396,3,1,3,0,1,0,65.10
彰化縣,二林鎮,,0,1,25744,469,26213,40120,3,1,3,0,1,0,65.34
彰化縣,芳苑鄉,,0,1,18291,317,18608,29305,3,1,3,0,1,0,63.50
彰化縣,大城鄉,,0,1,9952,151,10103,16520,3,1,3,0,1,0,61.16
彰化縣,竹塘鄉,,0,1,8038,98,8136,12983,3,1,3,0,1,0,62.67
南投縣,南投市,,0,1,49556,388,49944,71696,3,1,3,0,1,0,69.66
南投縣,埔里鎮,,0,1,39878,456,40334,61422,3,1,3,0,1,0,65.67
南投縣,草屯鎮,,0,1,47679,461,48140,68461,3,1,3,0,1,0,70.32
南投縣,竹山鎮,,0,1,28879,316,29195,44154,3,1,3,0,1,0,66.12
南投縣,集集鎮,,0,1,6200,76,6276,9129,3,1,3,0,1,0,68.75
南投縣,名間鄉,,0,1,20662,243,20905,31046,3,1,3,0,1,0,67.34
南投縣,鹿谷鄉,,0,1,9970,106,10076,15461,3,1,3,0,1,0,65.17
南投縣,中寮鄉,,0,1,8872,107,8979,13560,3,1,3,0,1,0,66.22
南投縣,魚池鄉,,0,1,8298,81,8379,13292,3,1,3,0,1,0,63.04
南投縣,國姓鄉,,0,1,10956,121,11077,17482,3,1,3,0,1,0,63.36
南投縣,水里鄉,,0,1,10800,124,10924,16640,3,1,3,0,1,0,65.65
南投縣,信義鄉,,0,1,3978,31,4009,6042,3,1,3,0,1,0,66.35
南投縣,仁愛鄉,,0,1,1526,34,1560,2657,3,1,3,0,1,0,58.71
雲林縣,斗六市,,0,1,46197,662,46859,69810,3,1,3,0,1,0,67.12
雲林縣,斗南鎮,,0,1,22899,298,23197,34369,3,1,3,0,1,0,67.49
雲林縣,虎尾鎮,,0,1,30346,459,30805,48184,3,1,3,0,1,0,63.93
雲林縣,西螺鎮,,0,1,21972,273,22245,35917,3,1,3,0,1,0,61.93
雲林縣,土庫鎮,,0,1,15406,252,15658,23565,3,1,3,0,1,0,66.45
雲林縣,北港鎮,,0,1,21600,333,21933,33626,3,1,3,0,1,0,65.23
雲林縣,古坑鄉,,0,1,17413,237,17650,26445,3,1,3,0,1,0,66.74
雲林縣,大埤鄉,,0,1,11151,145,11296,17055,3,1,3,0,1,0,66.23
雲林縣,莿桐鄉,,0,1,15312,205,15517,23115,3,1,3,0,1,0,67.13
雲林縣,林內鄉,,0,1,10216,165,10381,15070,3,1,3,0,1,0,68.89
雲林縣,二崙鄉,,0,1,14837,175,15012,24257,3,1,3,0,1,0,61.89
雲林縣,崙背鄉,,0,1,13319,193,13512,21841,3,1,3,0,1,0,61.87
雲林縣,麥寮鄉,,0,1,13866,210,14076,23483,3,1,3,0,1,0,59.94
雲林縣,東勢鄉,,0,1,8355,148,8503,14562,3,1,3,0,1,0,58.39
雲林縣,褒忠鄉,,0,1,7309,107,7416,11333,3,1,3,0,1,0,65.44
雲林縣,台西鄉,,0,1,12571,201,12772,21830,3,1,3,0,1,0,58.51
雲林縣,元長鄉,,0,1,14191,193,14384,24651,3,1,3,0,1,0,58.35
雲林縣,四湖鄉,,0,1,11975,217,12192,22979,3,1,3,0,1,0,53.06
雲林縣,口湖鄉,,0,1,14206,220,14426,24458,3,1,3,0,1,0,58.98
雲林縣,水林鄉,,0,1,15283,257,15540,24964,3,1,3,0,1,0,62.25
嘉義縣,太保市,,0,1,14750,336,15086,22912,3,1,3,0,1,0,65.84
嘉義縣,朴子市,,0,1,20810,365,21175,31712,3,1,3,0,1,0,66.77
嘉義縣,布袋鎮,,0,1,15901,290,16191,25265,3,1,3,0,1,0,64.08
嘉義縣,大林鎮,,0,1,16902,285,17187,26500,3,1,3,0,1,0,64.86
嘉義縣,民雄鄉,,0,1,31754,499,32253,49652,3,1,3,0,1,0,64.96
嘉義縣,溪口鄉,,0,1,8632,130,8762,13581,3,1,3,0,1,0,64.52
嘉義縣,新港鄉,,0,1,16043,256,16299,26332,3,1,3,0,1,0,61.90
嘉義縣,六腳鄉,,0,1,13357,266,13623,22632,3,1,3,0,1,0,60.19
嘉義縣,東石鄉,,0,1,15164,348,15512,23600,3,1,3,0,1,0,65.73
嘉義縣,義竹鄉,,0,1,13257,296,13553,18834,3,1,3,0,1,0,71.96
嘉義縣,鹿草鄉,,0,1,8974,176,9150,14112,3,1,3,0,1,0,64.84
嘉義縣,水上鄉,,0,1,26262,514,26776,40463,3,1,3,0,1,0,66.17
嘉義縣,中埔鄉,,0,1,21401,328,21729,34519,3,1,3,0,1,0,62.95
嘉義縣,竹崎鄉,,0,1,19224,255,19479,29977,3,1,3,0,1,0,64.98
嘉義縣,梅山鄉,,0,1,10935,156,11091,17224,3,1,3,0,1,0,64.39
嘉義縣,番路鄉,,0,1,5633,110,5743,8953,3,1,3,0,1,0,64.15
嘉義縣,大埔鄉,,0,1,1676,24,1700,2983,3,1,3,0,1,0,56.99
嘉義縣,阿里山鄉,,0,1,1025,23,1048,1820,3,1,3,0,1,0,57.58
臺南縣,新營市,,0,1,34089,413,34502,54170,3,1,3,0,1,0,63.69
臺南縣,鹽水鎮,,0,1,13816,179,13995,21543,3,1,3,0,1,0,64.96
臺南縣,白河鎮,,0,1,16702,264,16966,26506,3,1,3,0,1,0,64.01
臺南縣,柳營鄉,,0,1,12215,164,12379,18012,3,1,3,0,1,0,68.73
臺南縣,後壁鄉,,0,1,14206,208,14414,21680,3,1,3,0,1,0,66.49
臺南縣,東山鄉,,0,1,11916,117,12033,19285,3,1,3,0,1,0,62.40
臺南縣,麻豆鎮,,0,1,24357,253,24610,34681,3,1,3,0,1,0,70.96
臺南縣,下營鄉,,0,1,14219,162,14381,20742,3,1,3,0,1,0,69.33
臺南縣,六甲鄉,,0,1,11939,155,12094,17942,3,1,3,0,1,0,67.41
臺南縣,官田鄉,,0,1,12107,148,12255,17619,3,1,3,0,1,0,69.56
臺南縣,大內鄉,,0,1,6217,63,6280,9612,3,1,3,0,1,0,65.33
臺南縣,佳里鎮,,0,1,28839,292,29131,41519,3,1,3,0,1,0,70.16
臺南縣,學甲鎮,,0,1,14658,144,14802,21988,3,1,3,0,1,0,67.32
臺南縣,西港鄉,,0,1,13353,150,13503,18741,3,1,3,0,1,0,72.05
臺南縣,七股鄉,,0,1,13623,199,13822,20005,3,1,3,0,1,0,69.09
臺南縣,將軍鄉,,0,1,12091,117,12208,18312,3,1,3,0,1,0,66.67
臺南縣,北門鄉,,0,1,6769,76,6845,10358,3,1,3,0,1,0,66.08
臺南縣,新化鎮,,0,1,22073,268,22341,32527,3,1,3,0,1,0,68.68
臺南縣,善化鎮,,0,1,20893,264,21157,30508,3,1,3,0,1,0,69.35
臺南縣,新市鄉,,0,1,16338,196,16534,23822,3,1,3,0,1,0,69.41
臺南縣,安定鄉,,0,1,15603,189,15792,21672,3,1,3,0,1,0,72.87
臺南縣,山上鄉,,0,1,4221,54,4275,6171,3,1,3,0,1,0,69.28
臺南縣,玉井鄉,,0,1,8607,97,8704,12657,3,1,3,0,1,0,68.77
臺南縣,楠西鄉,,0,1,6170,76,6246,9129,3,1,3,0,1,0,68.42
臺南縣,南化鄉,,0,1,5054,45,5099,7455,3,1,3,0,1,0,68.40
臺南縣,左鎮鄉,,0,1,3390,36,3426,5003,3,1,3,0,1,0,68.48
臺南縣,仁德鄉,,0,1,31854,419,32273,48260,3,1,3,0,1,0,66.87
臺南縣,歸仁鄉,,0,1,29569,307,29876,43988,3,1,3,0,1,0,67.92
臺南縣,關廟鄉,,0,1,20459,161,20620,28238,3,1,3,0,1,0,73.02
臺南縣,龍崎鄉,,0,1,2678,22,2700,3717,3,1,3,0,1,0,72.64
臺南縣,永康市,,0,1,84832,965,85797,135078,3,1,3,0,1,0,63.52
高雄縣,鳳山市,,0,1,144109,1606,145715,228524,3,1,3,0,1,0,63.76
高雄縣,林園鄉,,0,1,33654,395,34049,49889,3,1,3,0,1,0,68.25
高雄縣,大寮鄉,,0,1,54363,615,54978,82143,3,1,3,0,1,0,66.93
高雄縣,大樹鄉,,0,1,22947,238,23185,33531,3,1,3,0,1,0,69.14
高雄縣,大社鄉,,0,1,16098,195,16293,24207,3,1,3,0,1,0,67.31
高雄縣,仁武鄉,,0,1,24249,327,24576,37845,3,1,3,0,1,0,64.94
高雄縣,鳥松鄉,,0,1,18568,231,18799,28622,3,1,3,0,1,0,65.68
高雄縣,岡山鎮,,0,1,44145,520,44665,65810,3,1,3,0,1,0,67.87
高雄縣,橋頭鄉,,0,1,19322,270,19592,27630,3,1,3,0,1,0,70.91
高雄縣,燕巢鄉,,0,1,16735,242,16977,23684,3,1,3,0,1,0,71.68
高雄縣,田寮鄉,,0,1,5373,74,5447,7803,3,1,3,0,1,0,69.81
高雄縣,阿蓮鄉,,0,1,14733,177,14910,21822,3,1,3,0,1,0,68.33
高雄縣,路竹鄉,,0,1,26085,296,26381,38160,3,1,3,0,1,0,69.13
高雄縣,湖內鄉,,0,1,13464,198,13662,21065,3,1,3,0,1,0,64.86
高雄縣,茄萣鄉,,0,1,15419,169,15588,24065,3,1,3,0,1,0,64.77
高雄縣,永安鄉,,0,1,7261,74,7335,10669,3,1,3,0,1,0,68.75
高雄縣,彌陀鄉,,0,1,11668,135,11803,15643,3,1,3,0,1,0,75.45
高雄縣,梓官鄉,,0,1,19016,219,19235,28303,3,1,3,0,1,0,67.96
高雄縣,旗山鎮,,0,1,21764,232,21996,32576,3,1,3,0,1,0,67.52
高雄縣,美濃鎮,,0,1,22513,264,22777,34933,3,1,3,0,1,0,65.20
高雄縣,六龜鄉,,0,1,7496,140,7636,12770,3,1,3,0,1,0,59.80
高雄縣,甲仙鄉,,0,1,4370,71,4441,6750,3,1,3,0,1,0,65.79
高雄縣,杉林鄉,,0,1,5832,72,5904,10050,3,1,3,0,1,0,58.75
高雄縣,內門鄉,,0,1,9135,102,9237,13550,3,1,3,0,1,0,68.17
高雄縣,茂林鄉,,0,1,60,1,61,131,3,1,3,0,1,0,46.56
高雄縣,桃源鄉,,0,1,211,6,217,388,3,1,3,0,1,0,55.93
高雄縣,三民鄉,,0,1,140,1,141,333,3,1,3,0,1,0,42.34
屏東縣,屏東市,,0,1,99385,992,100377,150945,3,1,3,0,1,0,66.50
屏東縣,潮州鎮,,0,1,25888,272,26160,40262,3,1,3,0,1,0,64.97
屏東縣,東港鎮,,0,1,21943,234,22177,34244,3,1,3,0,1,0,64.76
屏東縣,恆春鎮,,0,1,13022,205,13227,22468,3,1,3,0,1,0,58.87
屏東縣,萬丹鄉,,0,1,27687,266,27953,38265,3,1,3,0,1,0,73.05
屏東縣,長治鄉,,0,1,15877,189,16066,22200,3,1,3,0,1,0,72.37
屏東縣,麟洛鄉,,0,1,6289,58,6347,8877,3,1,3,0,1,0,71.50
屏東縣,九如鄉,,0,1,11929,154,12083,16736,3,1,3,0,1,0,72.20
屏東縣,里港鄉,,0,1,13698,158,13856,19575,3,1,3,0,1,0,70.78
屏東縣,鹽埔鄉,,0,1,14200,204,14404,20522,3,1,3,0,1,0,70.19
屏東縣,高樹鄉,,0,1,14489,193,14682,22514,3,1,3,0,1,0,65.21
屏東縣,萬巒鄉,,0,1,12055,163,12218,17538,3,1,3,0,1,0,69.67
屏東縣,內埔鄉,,0,1,29228,346,29574,44643,3,1,3,0,1,0,66.25
屏東縣,竹田鄉,,0,1,10233,105,10338,14401,3,1,3,0,1,0,71.79
屏東縣,新埤鄉,,0,1,5992,59,6051,9029,3,1,3,0,1,0,67.02
屏東縣,枋寮鄉,,0,1,13566,155,13721,21606,3,1,3,0,1,0,63.51
屏東縣,新園鄉,,0,1,19962,270,20232,29233,3,1,3,0,1,0,69.21
屏東縣,崁頂鄉,,0,1,7381,90,7471,10763,3,1,3,0,1,0,69.41
屏東縣,林邊鄉,,0,1,11384,104,11488,16816,3,1,3,0,1,0,68.32
屏東縣,南州鄉,,0,1,6845,77,6922,9829,3,1,3,0,1,0,70.42
屏東縣,佳冬鄉,,0,1,11849,135,11984,17443,3,1,3,0,1,0,68.70
屏東縣,琉球鄉,,0,1,4767,80,4847,10251,3,1,3,0,1,0,47.28
屏東縣,車城鄉,,0,1,4895,84,4979,8177,3,1,3,0,1,0,60.89
屏東縣,滿州鄉,,0,1,3001,44,3045,5482,3,1,3,0,1,0,55.55
屏東縣,枋山鄉,,0,1,2913,36,2949,4949,3,1,3,0,1,0,59.59
屏東縣,三地門鄉,,0,1,249,7,256,436,3,1,3,0,1,0,58.72
屏東縣,霧台鄉,,0,1,28,1,29,66,3,1,3,0,1,0,43.94
屏東縣,瑪家鄉,,0,1,202,10,212,350,3,1,3,0,1,0,60.57
屏東縣,泰武鄉,,0,1,78,0,78,150,3,1,3,0,1,0,52.00
屏東縣,來義鄉,,0,1,203,8,211,344,3,1,3,0,1,0,61.34
屏東縣,春日鄉,,0,1,197,5,202,362,3,1,3,0,1,0,55.80
屏東縣,獅子鄉,,0,1,147,6,153,299,3,1,3,0,1,0,51.17
屏東縣,牡丹鄉,,0,1,192,11,203,386,3,1,3,0,1,0,52.59
臺東縣,台東市,,0,1,40351,547,40898,66338,3,1,3,0,1,0,61.65
臺東縣,成功鎮,,0,1,3652,53,3705,6401,3,1,3,0,1,0,57.88
臺東縣,關山鎮,,0,1,3725,45,3770,6252,3,1,3,0,1,0,60.30
臺東縣,卑南鄉,,0,1,6707,136,6843,11490,3,1,3,0,1,0,59.56
臺東縣,鹿野鄉,,0,1,2968,58,3026,5623,3,1,3,0,1,0,53.81
臺東縣,池上鄉,,0,1,3330,62,3392,6494,3,1,3,0,1,0,52.23
臺東縣,東河鄉,,0,1,2122,41,2163,4145,3,1,3,0,1,0,52.18
臺東縣,長濱鄉,,0,1,1672,36,1708,3352,3,1,3,0,1,0,50.95
臺東縣,太麻里鄉,,0,1,3588,67,3655,6323,3,1,3,0,1,0,57.80
臺東縣,大武鄉,,0,1,1298,19,1317,2479,3,1,3,0,1,0,53.13
臺東縣,綠島鄉,,0,1,1030,21,1051,1999,3,1,3,0,1,0,52.58
臺東縣,海端鄉,,0,1,195,4,199,333,3,1,3,0,1,0,59.76
臺東縣,延平鄉,,0,1,160,2,162,283,3,1,3,0,1,0,57.24
臺東縣,金峰鄉,,0,1,106,1,107,177,3,1,3,0,1,0,60.45
臺東縣,達仁鄉,,0,1,157,3,160,356,3,1,3,0,1,0,44.94
臺東縣,蘭嶼鄉,,0,1,95,0,95,194,3,1,3,0,1,0,48.97
花蓮縣,花蓮市,,0,1,44471,625,45096,71038,3,1,3,0,1,0,63.48
花蓮縣,新城鄉,,0,1,7283,155,7438,12370,3,1,3,0,1,0,60.13
花蓮縣,秀林鄉,,0,1,1055,28,1083,1896,3,1,3,0,1,0,57.12
花蓮縣,吉安鄉,,0,1,29139,464,29603,47438,3,1,3,0,1,0,62.40
花蓮縣,壽豐鄉,,0,1,6740,124,6864,11353,3,1,3,0,1,0,60.46
花蓮縣,鳳林鎮,,0,1,5817,143,5960,9319,3,1,3,0,1,0,63.96
花蓮縣,光復鄉,,0,1,3877,85,3962,6537,3,1,3,0,1,0,60.61
花蓮縣,豐濱鄉,,0,1,587,18,605,1173,3,1,3,0,1,0,51.58
花蓮縣,萬榮鄉,,0,1,172,7,179,354,3,1,3,0,1,0,50.56
花蓮縣,瑞穗鄉,,0,1,4203,68,4271,7300,3,1,3,0,1,0,58.51
花蓮縣,玉里鎮,,0,1,9625,243,9868,17779,3,1,3,0,1,0,55.50
花蓮縣,富里鄉,,0,1,4786,124,4910,9067,3,1,3,0,1,0,54.15
花蓮縣,卓溪鄉,,0,1,192,6,198,351,3,1,3,0,1,0,56.41
澎湖縣,馬公市,,0,1,23931,345,24276,37698,3,1,3,0,1,0,64.40
澎湖縣,湖西鄉,,0,1,6292,84,6376,9809,3,1,3,0,1,0,65.00
澎湖縣,白沙鄉,,0,1,3934,38,3972,7119,3,1,3,0,1,0,55.79
澎湖縣,西嶼鄉,,0,1,3668,95,3763,6506,3,1,3,0,1,0,57.84
澎湖縣,望安鄉,,0,1,1289,31,1320,3633,3,1,3,0,1,0,36.33
澎湖縣,七美鄉,,0,1,908,43,951,2403,3,1,3,0,1,0,39.58
基隆市,中正區,,0,1,24770,378,25148,40961,3,1,3,0,1,0,61.39
基隆市,信義區,,0,1,23119,289,23408,36408,3,1,3,0,1,0,64.29
基隆市,仁愛區,,0,1,24386,395,24781,37822,3,1,3,0,1,0,65.52
基隆市,中山區,,0,1,24545,409,24954,39092,3,1,3,0,1,0,63.83
基隆市,安樂區,,0,1,34835,529,35364,57004,3,1,3,0,1,0,62.04
基隆市,暖暖區,,0,1,15810,238,16048,26483,3,1,3,0,1,0,60.60
基隆市,七堵區,,0,1,24609,393,25002,38664,3,1,3,0,1,0,64.66
新竹市,東區,,0,1,75951,1106,77057,120236,3,1,3,0,1,0,64.09
新竹市,北區,,0,1,58022,871,58893,91764,3,1,3,0,1,0,64.18
新竹市,香山區,,0,1,27795,445,28240,44635,3,1,3,0,1,0,63.27
臺中市,中區,,0,1,10236,174,10410,15974,3,1,3,0,1,0,65.17
臺中市,東區,,0,1,33112,530,33642,49954,3,1,3,0,1,0,67.35
臺中市,南區,,0,1,43852,725,44577,68544,3,1,3,0,1,0,65.03
臺中市,西區,,0,1,51451,726,52177,77906,3,1,3,0,1,0,66.97
臺中市,北區,,0,1,66099,941,67040,103579,3,1,3,0,1,0,64.72
臺中市,西屯區,,0,1,75318,1128,76446,116004,3,1,3,0,1,0,65.90
臺中市,南屯區,,0,1,54778,879,55657,82739,3,1,3,0,1,0,67.27
臺中市,北屯區,,0,1,97726,1432,99158,149634,3,1,3,0,1,0,66.27
嘉義市,東區,,0,1,58269,684,58953,90848,3,1,3,0,1,0,64.89
嘉義市,西區,,0,1,61701,813,62514,95679,3,1,3,0,1,0,65.34
臺南市,東區,,0,1,79201,990,80191,126461,3,1,3,0,1,0,63.41
臺南市,南區,,0,1,60927,754,61681,97692,3,1,3,0,1,0,63.14
臺南市,西區,,0,1,21373,279,21652,33055,3,1,3,0,1,0,65.50
臺南市,北區,,0,1,54459,656,55115,87463,3,1,3,0,1,0,63.02
臺南市,中區,,0,1,20171,221,20392,31329,3,1,3,0,1,0,65.09
臺南市,安南區,,0,1,71529,954,72483,112132,3,1,3,0,1,0,64.64
臺南市,安平區,,0,1,20643,217,20860,34033,3,1,3,0,1,0,61.29
金門縣,金城鎮,,0,1,8374,184,8558,13054,3,1,3,0,1,0,65.56
金門縣,金寧鄉,,0,1,4587,132,4719,7280,3,1,3,0,1,0,64.82
金門縣,金湖鎮,,0,1,5575,139,5714,8536,3,1,3,0,1,0,66.94
金門縣,金沙鎮,,0,1,4186,117,4303,6851,3,1,3,0,1,0,62.81
金門縣,烈嶼鄉,,0,1,2266,85,2351,3919,3,1,3,0,1,0,59.99
金門縣,烏坵鄉,,0,1,37,0,37,282,3,1,3,0,1,0,13.12
連江縣,南竿鄉,,0,1,2871,71,2942,3748,3,1,3,0,1,0,78.50
連江縣,北竿鄉,,0,1,913,22,935,1270,3,1,3,0,1,0,73.62
連江縣,莒光鄉,,0,1,396,9,405,637,3,1,3,0,1,0,63.58
連江縣,東引鄉,,0,1,372,17,389,554,4,2,4,1,2,1,70.22
臺北市,北投區,建民里,0,1,2430,29,2459,3731,3,1,3,0,1,0,65.91
臺北市,北投區,文林里,0,1,2237,21,2258,3483,3,1,3,0,1,0,64.83
臺北市,北投區,石牌里,0,1,2700,20,2720,4272,3,1,3,0,1,0,63.67
臺北市,北投區,福興里,0,1,3490,39,3529,5109,3,1,3,0,1,0,69.07
臺北市,北投區,榮光里,0,1,3397,43,3440,5407,3,1,3,0,1,0,63.62
臺北市,北投區,榮華里,0,1,3672,28,3700,5716,3,1,3,0,1,0,64.73
臺北市,北投區,裕民里,0,1,3399,32,3431,5332,3,1,3,0,1,0,64.35
臺北市,北投區,振華里,0,1,4062,43,4105,6206,3,1,3,0,1,0,66.15
臺北市,北投區,永和里,0,1,3865,41,3906,6067,3,1,3,0,1,0,64.38
臺北市,北投區,永欣里,0,1,3246,20,3266,5016,3,1,3,0,1,0,65.11
臺北市,北投區,永明里,0,1,2324,18,2342,3559,3,1,3,0,1,0,65.81
臺北市,北投區,東華里,0,1,2510,19,2529,3628,3,1,3,0,1,0,69.71
臺北市,北投區,吉利里,0,1,3169,43,3212,4937,3,1,3,0,1,0,65.06
臺北市,北投區,吉慶里,0,1,2658,26,2684,3930,3,1,3,0,1,0,68.30
臺北市,北投區,尊賢里,0,1,2395,29,2424,3787,3,1,3,0,1,0,64.01
臺北市,北投區,立賢里,0,1,2651,35,2686,4091,3,1,3,0,1,0,65.66
臺北市,北投區,立農里,0,1,4276,35,4311,6427,3,1,3,0,1,0,67.08
臺北市,北投區,八仙里,0,1,2374,24,2398,3758,3,1,3,0,1,0,63.81
臺北市,北投區,洲美里,0,1,957,5,962,1338,3,1,3,0,1,0,71.90
臺北市,北投區,奇岩里,0,1,4596,46,4642,7259,3,1,3,0,1,0,63.95
臺北市,北投區,清江里,0,1,4348,62,4410,6746,3,1,3,0,1,0,65.37
臺北市,北投區,中央里,0,1,3569,73,3642,5760,3,1,3,0,1,0,63.23
臺北市,北投區,長安里,0,1,2752,44,2796,4430,3,1,3,0,1,0,63.12
臺北市,北投區,大同里,0,1,2982,31,3013,4616,3,1,3,0,1,0,65.27
臺北市,北投區,溫泉里,0,1,3158,27,3185,4953,3,1,3,0,1,0,64.30
臺北市,北投區,林泉里,0,1,1602,19,1621,2705,3,1,3,0,1,0,59.93
臺北市,北投區,中心里,0,1,2753,17,2770,4725,3,1,3,0,1,0,58.62
臺北市,北投區,中庸里,0,1,2225,23,2248,3372,3,1,3,0,1,0,66.67
臺北市,北投區,開明里,0,1,3191,40,3231,5163,3,1,3,0,1,0,62.58
臺北市,北投區,中和里,0,1,3135,35,3170,4893,3,1,3,0,1,0,64.79
臺北市,北投區,智仁里,0,1,3107,25,3132,4734,3,1,3,0,1,0,66.16
臺北市,北投區,秀山里,0,1,1910,29,1939,2913,3,1,3,0,1,0,66.56
臺北市,北投區,文化里,0,1,2255,16,2271,3285,3,1,3,0,1,0,69.13
臺北市,北投區,豐年里,0,1,2068,12,2080,3288,3,1,3,0,1,0,63.26
臺北市,北投區,稻香里,0,1,2284,47,2331,3739,3,1,3,0,1,0,62.34
臺北市,北投區,桃源里,0,1,2590,37,2627,4106,3,1,3,0,1,0,63.98
臺北市,北投區,一德里,0,1,2852,46,2898,4690,3,1,3,0,1,0,61.79
臺北市,北投區,關渡里,0,1,4820,73,4893,7602,3,1,3,0,1,0,64.36
臺北市,北投區,泉源里,0,1,1263,11,1274,1903,3,1,3,0,1,0,66.95
臺北市,北投區,湖山里,0,1,1509,18,1527,2356,3,1,3,0,1,0,64.81
臺北市,士林區,永福里,0,1,753,15,768,1142,3,1,3,0,1,0,67.25
臺北市,士林區,公舘里,0,1,753,8,761,1180,3,1,3,0,1,0,64.49
臺北市,士林區,新安里,0,1,1095,10,1105,1734,3,1,3,0,1,0,63.73
臺北市,士林區,陽明里,0,1,1638,19,1657,2723,3,1,3,0,1,0,60.85
臺北市,士林區,菁山里,0,1,861,12,873,1348,3,1,3,0,1,0,64.76
臺北市,士林區,平等里,0,1,856,8,864,1196,3,1,3,0,1,0,72.24
臺北市,士林區,溪山里,0,1,815,15,830,1221,3,1,3,0,1,0,67.98
臺北市,士林區,翠山里,0,1,3146,34,3180,4899,3,1,3,0,1,0,64.91
臺北市,士林區,三玉里,0,1,2771,24,2795,4355,3,1,3,0,1,0,64.18
臺北市,士林區,天福里,0,1,3206,24,3230,4866,3,1,3,0,1,0,66.38
臺北市,士林區,天祿里,0,1,2661,20,2681,4100,3,1,3,0,1,0,65.39
臺北市,士林區,天壽里,0,1,2351,18,2369,3602,3,1,3,0,1,0,65.77
臺北市,士林區,天和里,0,1,3605,30,3635,5808,3,1,3,0,1,0,62.59
臺北市,士林區,天山里,0,1,3340,27,3367,5466,3,1,3,0,1,0,61.60
臺北市,士林區,天玉里,0,1,4044,31,4075,6524,3,1,3,0,1,0,62.46
臺北市,士林區,天母里,0,1,3324,17,3341,5060,3,1,3,0,1,0,66.03
臺北市,士林區,岩山里,0,1,2209,19,2228,3573,3,1,3,0,1,0,62.36
臺北市,士林區,名山里,0,1,3263,40,3303,5068,3,1,3,0,1,0,65.17
臺北市,士林區,聖山里,0,1,2740,19,2759,4098,3,1,3,0,1,0,67.33
臺北市,士林區,芝山里,0,1,3483,35,3518,5505,3,1,3,0,1,0,63.91
臺北市,士林區,東山里,0,1,2636,21,2657,3882,3,1,3,0,1,0,68.44
臺北市,士林區,德行里,0,1,2095,29,2124,3307,3,1,3,0,1,0,64.23
臺北市,士林區,德華里,0,1,2782,24,2806,4487,3,1,3,0,1,0,62.54
臺北市,士林區,忠誠里,0,1,2990,21,3011,4501,3,1,3,0,1,0,66.90
臺北市,士林區,蘭雅里,0,1,4124,32,4156,6607,3,1,3,0,1,0,62.90
臺北市,士林區,蘭興里,0,1,3121,27,3148,4762,3,1,3,0,1,0,66.11
臺北市,士林區,仁勇里,0,1,2428,29,2457,3669,3,1,3,0,1,0,66.97
臺北市,士林區,義信里,0,1,1407,17,1424,2326,3,1,3,0,1,0,61.22
臺北市,士林區,福林里,0,1,2056,20,2076,3158,3,1,3,0,1,0,65.74
臺北市,士林區,福德里,0,1,2330,21,2351,3998,3,1,3,0,1,0,58.80
臺北市,士林區,福志里,0,1,3612,30,3642,5527,3,1,3,0,1,0,65.89
臺北市,士林區,舊佳里,0,1,3479,41,3520,5345,3,1,3,0,1,0,65.86
臺北市,士林區,福佳里,0,1,3781,50,3831,5813,3,1,3,0,1,0,65.90
臺北市,士林區,後港里,0,1,3876,49,3925,6261,3,1,3,0,1,0,62.69
臺北市,士林區,福中里,0,1,2733,31,2764,4289,3,1,3,0,1,0,64.44
臺北市,士林區,前港里,0,1,2195,21,2216,3471,3,1,3,0,1,0,63.84
臺北市,士林區,百齡里,0,1,3594,37,3631,5643,3,1,3,0,1,0,64.35
臺北市,士林區,承德里,0,1,2656,23,2679,4275,3,1,3,0,1,0,62.67
臺北市,士林區,福華里,0,1,3317,38,3355,5495,3,1,3,0,1,0,61.06
臺北市,士林區,明勝里,0,1,2459,32,2491,4057,3,1,3,0,1,0,61.40
臺北市,士林區,福順里,0,1,2633,28,2661,4409,3,1,3,0,1,0,60.35
臺北市,士林區,富光里,0,1,2939,38,2977,4733,3,1,3,0,1,0,62.90
臺北市,士林區,葫蘆里,0,1,3798,37,3835,5747,3,1,3,0,1,0,66.73
臺北市,士林區,葫東里,0,1,1945,14,1959,3075,3,1,3,0,1,0,63.71
臺北市,士林區,社子里,0,1,3091,32,3123,4959,3,1,3,0,1,0,62.98
臺北市,士林區,社新里,0,1,4092,53,4145,6478,3,1,3,0,1,0,63.99
臺北市,士林區,社園里,0,1,3578,69,3647,5484,3,1,3,0,1,0,66.50
臺北市,士林區,永倫里,0,1,3754,34,3788,5739,3,1,3,0,1,0,66.00
臺北市,士林區,福安里,0,1,2587,27,2614,3956,3,1,3,0,1,0,66.08
臺北市,士林區,富洲里,0,1,2916,21,2937,4367,3,1,3,0,1,0,67.25
臺北市,內湖區,西湖里,0,1,3840,39,3879,5991,3,1,3,0,1,0,64.75
臺北市,內湖區,西康里,0,1,3868,44,3912,5888,3,1,3,0,1,0,66.44
臺北市,內湖區,西安里,0,1,3041,21,3062,4799,3,1,3,0,1,0,63.80
臺北市,內湖區,港墘里,0,1,2789,23,2812,4209,3,1,3,0,1,0,66.81
臺北市,內湖區,港都里,0,1,5182,44,5226,8031,3,1,3,0,1,0,65.07
臺北市,內湖區,港富里,0,1,4483,38,4521,6984,3,1,3,0,1,0,64.73
臺北市,內湖區,港華里,0,1,3970,46,4016,6013,3,1,3,0,1,0,66.79
臺北市,內湖區,內湖里,0,1,2654,22,2676,4182,3,1,3,0,1,0,63.99
臺北市,內湖區,湖濱里,0,1,3652,32,3684,5567,3,1,3,0,1,0,66.18
臺北市,內湖區,紫星里,0,1,4013,35,4048,6188,3,1,3,0,1,0,65.42
臺北市,內湖區,大湖里,0,1,5263,41,5304,8441,3,1,3,0,1,0,62.84
臺北市,內湖區,金龍里,0,1,2825,24,2849,4397,3,1,3,0,1,0,64.79
臺北市,內湖區,金瑞里,0,1,3145,32,3177,4763,3,1,3,0,1,0,66.70
臺北市,內湖區,碧山里,0,1,3292,47,3339,5147,3,1,3,0,1,0,64.87
臺北市,內湖區,紫雲里,0,1,2913,40,2953,4372,3,1,3,0,1,0,67.54
臺北市,內湖區,清白里,0,1,2888,23,2911,4716,3,1,3,0,1,0,61.73
臺北市,內湖區,葫洲里,0,1,12076,102,12178,19138,3,1,3,0,1,0,63.63
臺北市,內湖區,紫陽里,0,1,3429,24,3453,5338,3,1,3,0,1,0,64.69
臺北市,內湖區,瑞陽里,0,1,4360,38,4398,6288,3,1,3,0,1,0,69.94
臺北市,內湖區,瑞光里,0,1,2477,14,2491,3655,3,1,3,0,1,0,68.15
臺北市,內湖區,五分里,0,1,3933,51,3984,6618,3,1,3,0,1,0,60.20
臺北市,內湖區,東湖里,0,1,6531,81,6612,10544,3,1,3,0,1,0,62.71
臺北市,內湖區,樂康里,0,1,3279,37,3316,5414,3,1,3,0,1,0,61.25
臺北市,內湖區,內溝里,0,1,4072,47,4119,6481,3,1,3,0,1,0,63.56
臺北市,內湖區,週美里,0,1,2351,29,2380,3656,3,1,3,0,1,0,65.10
臺北市,內湖區,行善里,0,1,3112,41,3153,4837,3,1,3,0,1,0,65.19
臺北市,內湖區,石潭里,0,1,1267,16,1283,2036,3,1,3,0,1,0,63.02
臺北市,內湖區,湖興里,0,1,3755,39,3794,6318,3,1,3,0,1,0,60.05
臺北市,內湖區,湖元里,0,1,2345,18,2363,3679,3,1,3,0,1,0,64.23
臺北市,南港區,百福里,0,1,2586,35,2621,4004,3,1,3,0,1,0,65.46
臺北市,南港區,鴻福里,0,1,2402,38,2440,3765,3,1,3,0,1,0,64.81
臺北市,南港區,成福里,0,1,6247,91,6338,9889,3,1,3,0,1,0,64.09
臺北市,南港區,萬福里,0,1,2288,22,2310,3337,3,1,3,0,1,0,69.22
臺北市,南港區,聯成里,0,1,2815,25,2840,4214,3,1,3,0,1,0,67.39
臺北市,南港區,新光里,0,1,2224,17,2241,3340,3,1,3,0,1,0,67.10
臺北市,南港區,合成里,0,1,3284,47,3331,5022,3,1,3,0,1,0,66.33
臺北市,南港區,玉成里,0,1,2336,24,2360,3668,3,1,3,0,1,0,64.34
臺北市,南港區,西新里,0,1,2166,25,2191,3524,3,1,3,0,1,0,62.17
臺北市,南港區,東新里,0,1,3223,44,3267,5281,3,1,3,0,1,0,61.86
臺北市,南港區,東明里,0,1,2198,27,2225,3560,3,1,3,0,1,0,62.50
臺北市,南港區,南港里,0,1,2757,33,2790,4490,3,1,3,0,1,0,62.14
臺北市,南港區,三重里,0,1,1580,21,1601,2584,3,1,3,0,1,0,61.96
臺北市,南港區,中南里,0,1,1944,43,1987,3255,3,1,3,0,1,0,61.04
臺北市,南港區,新富里,0,1,2031,27,2058,3200,3,1,3,0,1,0,64.31
臺北市,南港區,中研里,0,1,4766,33,4799,7177,3,1,3,0,1,0,66.87
臺北市,南港區,舊莊里,0,1,3873,47,3920,6410,3,1,3,0,1,0,61.15
臺北市,南港區,九如里,0,1,2871,41,2912,4446,3,1,3,0,1,0,65.50
臺北市,松山區,莊敬里,0,1,3039,23,3062,4705,3,1,3,0,1,0,65.08
臺北市,松山區,東榮里,0,1,4348,34,4382,6789,3,1,3,0,1,0,64.55
臺北市,松山區,三民里,0,1,3563,26,3589,5641,3,1,3,0,1,0,63.62
臺北市,松山區,新益里,0,1,2349,19,2368,3675,3,1,3,0,1,0,64.44
臺北市,松山區,富錦里,0,1,2733,25,2758,4230,3,1,3,0,1,0,65.20
臺北市,松山區,新東里,0,1,2576,23,2599,4090,3,1,3,0,1,0,63.55
臺北市,松山區,富泰里,0,1,2338,9,2347,3747,3,1,3,0,1,0,62.64
臺北市,松山區,介壽里,0,1,2299,20,2319,3637,3,1,3,0,1,0,63.76
臺北市,松山區,精忠里,0,1,2241,14,2255,3561,3,1,3,0,1,0,63.32
臺北市,松山區,東光里,0,1,3809,28,3837,6059,3,1,3,0,1,0,63.33
臺北市,松山區,龍田里,0,1,3125,23,3148,4695,3,1,3,0,1,0,67.05
臺北市,松山區,東昌里,0,1,2368,17,2385,3719,3,1,3,0,1,0,64.13
臺北市,松山區,東勢里,0,1,1643,13,1656,2542,3,1,3,0,1,0,65.15
臺北市,松山區,中華里,0,1,2579,10,2589,3893,3,1,3,0,1,0,66.50
臺北市,松山區,民有里,0,1,4319,25,4344,7009,3,1,3,0,1,0,61.98
臺北市,松山區,民福里,0,1,3477,27,3504,5310,3,1,3,0,1,0,65.99
臺北市,松山區,松基里,0,1,1881,16,1897,3041,3,1,3,0,1,0,62.38
臺北市,松山區,慈祐里,0,1,2963,27,2990,5087,3,1,3,0,1,0,58.78
臺北市,松山區,安平里,0,1,4529,43,4572,6876,3,1,3,0,1,0,66.49
臺北市,松山區,鵬程里,0,1,3038,20,3058,4606,3,1,3,0,1,0,66.39
臺北市,松山區,自強里,0,1,3783,37,3820,5632,3,1,3,0,1,0,67.83
臺北市,松山區,吉祥里,0,1,3910,34,3944,6305,3,1,3,0,1,0,62.55
臺北市,松山區,新聚里,0,1,3610,49,3659,5801,3,1,3,0,1,0,63.08
臺北市,松山區,復盛里,0,1,3248,28,3276,5089,3,1,3,0,1,0,64.37
臺北市,松山區,中正里,0,1,3675,31,3706,6159,3,1,3,0,1,0,60.17
臺北市,松山區,中崙里,0,1,1911,8,1919,3087,3,1,3,0,1,0,62.16
臺北市,松山區,美仁里,0,1,1651,6,1657,2583,3,1,3,0,1,0,64.15
臺北市,松山區,吉仁里,0,1,1930,12,1942,3041,3,1,3,0,1,0,63.86
臺北市,松山區,敦化里,0,1,3532,31,3563,5479,3,1,3,0,1,0,65.03
臺北市,松山區,復源里,0,1,1575,16,1591,2483,3,1,3,0,1,0,64.08
臺北市,松山區,復建里,0,1,1901,17,1918,2954,3,1,3,0,1,0,64.93
臺北市,松山區,復勢里,0,1,2971,40,3011,4768,3,1,3,0,1,0,63.15
臺北市,松山區,福成里,0,1,1320,6,1326,2138,3,1,3,0,1,0,62.02
臺北市,信義區,西村里,0,1,2629,18,2647,4078,3,1,3,0,1,0,64.91
臺北市,信義區,正和里,0,1,2539,20,2559,3947,3,1,3,0,1,0,64.83
臺北市,信義區,興隆里,0,1,1540,21,1561,2576,3,1,3,0,1,0,60.60
臺北市,信義區,中興里,0,1,1361,16,1377,2301,3,1,3,0,1,0,59.84
臺北市,信義區,新仁里,0,1,1997,13,2010,3344,3,1,3,0,1,0,60.11
臺北市,信義區,興雅里,0,1,3081,36,3117,4875,3,1,3,0,1,0,63.94
臺北市,信義區,敦厚里,0,1,2327,20,2347,3799,3,1,3,0,1,0,61.78
臺北市,信義區,廣居里,0,1,3088,26,3114,4995,3,1,3,0,1,0,62.34
臺北市,信義區,安康里,0,1,4176,28,4204,6560,3,1,3,0,1,0,64.09
臺北市,信義區,六藝里,0,1,1806,20,1826,2886,3,1,3,0,1,0,63.27
臺北市,信義區,雅祥里,0,1,2335,20,2355,3769,3,1,3,0,1,0,62.48
臺北市,信義區,五常里,0,1,1909,22,1931,3113,3,1,3,0,1,0,62.03
臺北市,信義區,五全里,0,1,2748,19,2767,4252,3,1,3,0,1,0,65.08
臺北市,信義區,永吉里,0,1,2243,26,2269,3760,3,1,3,0,1,0,60.35
臺北市,信義區,長春里,0,1,2320,27,2347,3605,3,1,3,0,1,0,65.10
臺北市,信義區,四育里,0,1,3019,34,3053,4566,3,1,3,0,1,0,66.86
臺北市,信義區,四維里,0,1,2855,21,2876,4603,3,1,3,0,1,0,62.48
臺北市,信義區,永春里,0,1,2759,26,2785,4432,3,1,3,0,1,0,62.84
臺北市,信義區,富台里,0,1,1995,16,2011,3074,3,1,3,0,1,0,65.42
臺北市,信義區,國業里,0,1,3498,31,3529,5389,3,1,3,0,1,0,65.49
臺北市,信義區,松隆里,0,1,1415,19,1434,2329,3,1,3,0,1,0,61.57
臺北市,信義區,松友里,0,1,3158,38,3196,5178,3,1,3,0,1,0,61.72
臺北市,信義區,松光里,0,1,2999,30,3029,4551,3,1,3,0,1,0,66.56
臺北市,信義區,中坡里,0,1,2462,35,2497,3826,3,1,3,0,1,0,65.26
臺北市,信義區,中行里,0,1,4115,42,4157,6484,3,1,3,0,1,0,64.11
臺北市,信義區,大道里,0,1,3328,29,3357,5213,3,1,3,0,1,0,64.40
臺北市,信義區,大仁里,0,1,3029,53,3082,4719,3,1,3,0,1,0,65.31
臺北市,信義區,景新里,0,1,2476,20,2496,3893,3,1,3,0,1,0,64.12
臺北市,信義區,惠安里,0,1,3565,40,3605,5553,3,1,3,0,1,0,64.92
臺北市,信義區,三張里,0,1,4957,44,5001,7590,3,1,3,0,1,0,65.89
臺北市,信義區,三犁里,0,1,2495,22,2517,4015,3,1,3,0,1,0,62.69
臺北市,信義區,六合里,0,1,3265,28,3293,5316,3,1,3,0,1,0,61.95
臺北市,信義區,泰和里,0,1,4112,56,4168,6562,3,1,3,0,1,0,63.52
臺北市,信義區,景聯里,0,1,2499,20,2519,3932,3,1,3,0,1,0,64.06
臺北市,信義區,景勤里,0,1,2424,27,2451,3814,3,1,3,0,1,0,64.26
臺北市,信義區,雙和里,0,1,3582,36,3618,5491,3,1,3,0,1,0,65.89
臺北市,信義區,嘉興里,0,1,1744,18,1762,2739,3,1,3,0,1,0,64.33
臺北市,信義區,黎順里,0,1,2202,27,2229,3493,3,1,3,0,1,0,63.81
臺北市,信義區,黎平里,0,1,3652,44,3696,5610,3,1,3,0,1,0,65.88
臺北市,信義區,黎忠里,0,1,2530,23,2553,3953,3,1,3,0,1,0,64.58
臺北市,信義區,黎安里,0,1,1539,27,1566,2296,3,1,3,0,1,0,68.21
臺北市,中山區,正守里,0,2,1483,23,1506,2405,3,1,3,0,1,0,62.62
臺北市,中山區,正義里,0,2,1949,30,1979,3587,3,1,3,0,1,0,55.17
臺北市,中山區,正得里,0,2,1491,13,1504,2573,3,1,3,0,1,0,58.45
臺北市,中山區,民安里,0,2,2426,35,2461,4061,3,1,3,0,1,0,60.60
臺北市,中山區,康樂里,0,2,956,12,968,1848,3,1,3,0,1,0,52.38
臺北市,中山區,中山里,0,2,2423,31,2454,4287,3,1,3,0,1,0,57.24
臺北市,中山區,聚盛里,0,2,1492,18,1510,2844,3,1,3,0,1,0,53.09
臺北市,中山區,集英里,0,2,2875,33,2908,4607,3,1,3,0,1,0,63.12
臺北市,中山區,聚葉里,0,2,1737,30,1767,2988,3,1,3,0,1,0,59.14
臺北市,中山區,恆安里,0,2,1475,27,1502,2575,3,1,3,0,1,0,58.33
臺北市,中山區,晴光里,0,2,1723,20,1743,3229,3,1,3,0,1,0,53.98
臺北市,中山區,圓山里,0,2,1784,18,1802,3073,3,1,3,0,1,0,58.64
臺北市,中山區,新庄里,0,2,2325,22,2347,3892,3,1,3,0,1,0,60.30
臺北市,中山區,劍潭里,0,2,2097,11,2108,2998,3,1,3,0,1,0,70.31
臺北市,中山區,大直里,0,2,5131,44,5175,7840,3,1,3,0,1,0,66.01
臺北市,中山區,成功里,0,2,4479,36,4515,6592,3,1,3,0,1,0,68.49
臺北市,中山區,永安里,0,2,4149,43,4192,6275,3,1,3,0,1,0,66.80
臺北市,中山區,大佳里,0,2,583,3,586,913,3,1,3,0,1,0,64.18
臺北市,中山區,新喜里,0,2,2522,28,2550,3973,3,1,3,0,1,0,64.18
臺北市,中山區,新福里,0,2,2439,28,2467,4009,3,1,3,0,1,0,61.54
臺北市,中山區,松江里,0,2,3220,30,3250,5025,3,1,3,0,1,0,64.68
臺北市,中山區,新生里,0,2,2452,37,2489,3937,3,1,3,0,1,0,63.22
臺北市,中山區,中庄里,0,2,2692,30,2722,4454,3,1,3,0,1,0,61.11
臺北市,中山區,行政里,0,2,2555,27,2582,4598,3,1,3,0,1,0,56.15
臺北市,中山區,行仁里,0,2,4024,58,4082,6618,3,1,3,0,1,0,61.68
臺北市,中山區,行孝里,0,2,2041,25,2066,3253,3,1,3,0,1,0,63.51
臺北市,中山區,下埤里,0,2,3569,30,3599,5761,3,1,3,0,1,0,62.47
臺北市,中山區,江寧里,0,2,3253,25,3278,5306,3,1,3,0,1,0,61.78
臺北市,中山區,江山里,0,2,3822,36,3858,6060,3,1,3,0,1,0,63.66
臺北市,中山區,中吉里,0,2,2595,25,2620,4166,3,1,3,0,1,0,62.89
臺北市,中山區,中原里,0,2,2306,25,2331,3776,3,1,3,0,1,0,61.73
臺北市,中山區,興亞里,0,2,2541,19,2560,4127,3,1,3,0,1,0,62.03
臺北市,中山區,中央里,0,2,1820,13,1833,2835,3,1,3,0,1,0,64.66
臺北市,中山區,朱馥里,0,2,3036,35,3071,4929,3,1,3,0,1,0,62.30
臺北市,中山區,龍洲里,0,2,2946,26,2972,4249,3,1,3,0,1,0,69.95
臺北市,中山區,朱園里,0,2,2220,23,2243,3512,3,1,3,0,1,0,63.87
臺北市,中山區,埤頭里,0,2,2161,9,2170,3369,3,1,3,0,1,0,64.41
臺北市,中山區,朱崙里,0,2,1583,20,1603,2530,3,1,3,0,1,0,63.36
臺北市,中山區,力行里,0,2,3050,35,3085,4999,3,1,3,0,1,0,61.71
臺北市,中山區,復華里,0,2,1967,19,1986,3173,3,1,3,0,1,0,62.59
臺北市,大同區,玉泉里,0,2,1852,29,1881,3121,3,1,3,0,1,0,60.27
臺北市,大同區,建明里,0,2,1948,16,1964,3123,3,1,3,0,1,0,62.89
臺北市,大同區,建功里,0,2,1994,30,2024,3305,3,1,3,0,1,0,61.24
臺北市,大同區,建泰里,0,2,1862,13,1875,2943,3,1,3,0,1,0,63.71
臺北市,大同區,永樂里,0,2,2632,29,2661,4179,3,1,3,0,1,0,63.68
臺北市,大同區,朝陽里,0,2,1951,22,1973,3140,3,1,3,0,1,0,62.83
臺北市,大同區,星明里,0,2,2204,18,2222,3634,3,1,3,0,1,0,61.14
臺北市,大同區,光能里,0,2,2854,20,2874,4230,3,1,3,0,1,0,67.94
臺北市,大同區,大有里,0,2,2579,26,2605,4031,3,1,3,0,1,0,64.62
臺北市,大同區,延平里,0,2,1880,11,1891,3137,3,1,3,0,1,0,60.28
臺北市,大同區,雙連里,0,2,4586,45,4631,7471,3,1,3,0,1,0,61.99
臺北市,大同區,南芳里,0,2,1899,22,1921,3165,3,1,3,0,1,0,60.70
臺北市,大同區,民權里,0,2,3191,82,3273,5227,3,1,3,0,1,0,62.62
臺北市,大同區,景星里,0,2,1519,22,1541,2408,3,1,3,0,1,0,64.00
臺北市,大同區,隆和里,0,2,1742,13,1755,2697,3,1,3,0,1,0,65.07
臺北市,大同區,蓬萊里,0,2,2324,22,2346,3868,3,1,3,0,1,0,60.65
臺北市,大同區,國順里,0,2,2310,29,2339,3595,3,1,3,0,1,0,65.06
臺北市,大同區,國慶里,0,2,1301,9,1310,2001,3,1,3,0,1,0,65.47
臺北市,大同區,揚雅里,0,2,1624,18,1642,2741,3,1,3,0,1,0,59.91
臺北市,大同區,斯文里,0,2,2780,45,2825,4459,3,1,3,0,1,0,63.36
臺北市,大同區,鄰江里,0,2,3272,36,3308,5196,3,1,3,0,1,0,63.66
臺北市,大同區,至聖里,0,2,4130,36,4166,6431,3,1,3,0,1,0,64.78
臺北市,大同區,文昌里,0,2,674,6,680,1079,3,1,3,0,1,0,63.02
臺北市,大同區,老師里,0,2,2271,14,2285,3643,3,1,3,0,1,0,62.72
臺北市,大同區,重慶里,0,2,2435,28,2463,3771,3,1,3,0,1,0,65.31
臺北市,大同區,保安里,0,2,3023,26,3049,4709,3,1,3,0,1,0,64.75
臺北市,中正區,水源里,0,2,1628,14,1642,2562,3,1,3,0,1,0,64.09
臺北市,中正區,富水里,0,2,1538,22,1560,2435,3,1,3,0,1,0,64.07
臺北市,中正區,文盛里,0,2,1490,6,1496,2287,3,1,3,0,1,0,65.41
臺北市,中正區,林興里,0,2,2455,15,2470,3786,3,1,3,0,1,0,65.24
臺北市,中正區,河堤里,0,2,2489,24,2513,3879,3,1,3,0,1,0,64.78
臺北市,中正區,頂東里,0,2,3125,22,3147,4580,3,1,3,0,1,0,68.71
臺北市,中正區,網溪里,0,2,2921,14,2935,4451,3,1,3,0,1,0,65.94
臺北市,中正區,板溪里,0,2,1781,30,1811,2744,3,1,3,0,1,0,66.00
臺北市,中正區,螢圃里,0,2,2898,16,2914,4314,3,1,3,0,1,0,67.55
臺北市,中正區,螢雪里,0,2,2349,21,2370,3612,3,1,3,0,1,0,65.61
臺北市,中正區,永功里,0,2,3213,23,3236,5072,3,1,3,0,1,0,63.80
臺北市,中正區,永昌里,0,2,2796,41,2837,4414,3,1,3,0,1,0,64.27
臺北市,中正區,龍興里,0,2,2029,13,2042,3174,3,1,3,0,1,0,64.34
臺北市,中正區,忠勤里,0,2,3544,66,3610,5780,3,1,3,0,1,0,62.46
臺北市,中正區,廈安里,0,2,1991,15,2006,3034,3,1,3,0,1,0,66.12
臺北市,中正區,愛國里,0,2,1708,9,1717,2589,3,1,3,0,1,0,66.32
臺北市,中正區,南門里,0,2,1764,13,1777,2687,3,1,3,0,1,0,66.13
臺北市,中正區,龍光里,0,2,1911,16,1927,2986,3,1,3,0,1,0,64.53
臺北市,中正區,南福里,0,2,3883,32,3915,5893,3,1,3,0,1,0,66.43
臺北市,中正區,龍福里,0,2,3137,25,3162,5014,3,1,3,0,1,0,63.06
臺北市,中正區,新營里,0,2,4112,34,4146,6081,3,1,3,0,1,0,68.18
臺北市,中正區,建國里,0,2,675,8,683,1138,3,1,3,0,1,0,60.02
臺北市,中正區,光復里,0,2,1680,14,1694,2875,3,1,3,0,1,0,58.92
臺北市,中正區,黎明里,0,2,1244,14,1258,2235,3,1,3,0,1,0,56.29
臺北市,中正區,梅花里,0,2,1779,8,1787,2835,3,1,3,0,1,0,63.03
臺北市,中正區,幸福里,0,2,2105,12,2117,3388,3,1,3,0,1,0,62.49
臺北市,中正區,幸市里,0,2,2188,12,2200,3535,3,1,3,0,1,0,62.23
臺北市,中正區,東門里,0,2,2230,18,2248,3516,3,1,3,0,1,0,63.94
臺北市,中正區,文北里,0,2,2571,15,2586,4052,3,1,3,0,1,0,63.82
臺北市,中正區,文祥里,0,2,3479,35,3514,5270,3,1,3,0,1,0,66.68
臺北市,中正區,三愛里,0,2,3882,34,3916,5990,3,1,3,0,1,0,65.38
臺北市,萬華區,福星里,0,2,2445,38,2483,4033,3,1,3,0,1,0,61.57
臺北市,萬華區,萬壽里,0,2,1515,20,1535,2682,3,1,3,0,1,0,57.23
臺北市,萬華區,西門里,0,2,1592,18,1610,2866,3,1,3,0,1,0,56.18
臺北市,萬華區,新起里,0,2,3530,39,3569,5676,3,1,3,0,1,0,62.88
臺北市,萬華區,菜園里,0,2,3086,27,3113,5041,3,1,3,0,1,0,61.75
臺北市,萬華區,青山里,0,2,2716,32,2748,4404,3,1,3,0,1,0,62.40
臺北市,萬華區,富民里,0,2,2785,26,2811,4261,3,1,3,0,1,0,65.97
臺北市,萬華區,福音里,0,2,2060,25,2085,3093,3,1,3,0,1,0,67.41
臺北市,萬華區,仁德里,0,2,2387,22,2409,3575,3,1,3,0,1,0,67.38
臺北市,萬華區,富福里,0,2,2627,16,2643,3868,3,1,3,0,1,0,68.33
臺北市,萬華區,糖廍里,0,2,2259,16,2275,3681,3,1,3,0,1,0,61.80
臺北市,萬華區,綠堤里,0,2,2950,34,2984,4862,3,1,3,0,1,0,61.37
臺北市,萬華區,華江里,0,2,4441,57,4498,6950,3,1,3,0,1,0,64.72
臺北市,萬華區,柳鄉里,0,2,2806,47,2853,4509,3,1,3,0,1,0,63.27
臺北市,萬華區,壽德里,0,2,2693,22,2715,4038,3,1,3,0,1,0,67.24
臺北市,萬華區,興德里,0,2,2541,30,2571,4005,3,1,3,0,1,0,64.19
臺北市,萬華區,華中里,0,2,3325,45,3370,5143,3,1,3,0,1,0,65.53
臺北市,萬華區,日祥里,0,2,3210,35,3245,4849,3,1,3,0,1,0,66.92
臺北市,萬華區,忠貞里,0,2,2966,32,2998,4292,3,1,3,0,1,0,69.85
臺北市,萬華區,凌霄里,0,2,2301,33,2334,3518,3,1,3,0,1,0,66.34
臺北市,萬華區,騰雲里,0,2,1719,15,1734,2569,3,1,3,0,1,0,67.50
臺北市,萬華區,忠德里,0,2,2456,30,2486,3721,3,1,3,0,1,0,66.81
臺北市,萬華區,孝德里,0,2,1756,24,1780,2692,3,1,3,0,1,0,66.12
臺北市,萬華區,和德里,0,2,3520,45,3565,5845,3,1,3,0,1,0,60.99
臺北市,萬華區,錦德里,0,2,2771,30,2801,4296,3,1,3,0,1,0,65.20
臺北市,萬華區,全德里,0,2,2191,28,2219,3380,3,1,3,0,1,0,65.65
臺北市,萬華區,保德里,0,2,1664,18,1682,2462,3,1,3,0,1,0,68.32
臺北市,萬華區,銘德里,0,2,2558,24,2582,3888,3,1,3,0,1,0,66.41
臺北市,萬華區,榮德里,0,2,2250,37,2287,3306,3,1,3,0,1,0,69.18
臺北市,萬華區,和平里,0,2,3845,57,3902,6031,3,1,3,0,1,0,64.70
臺北市,萬華區,日善里,0,2,2069,23,2092,3145,3,1,3,0,1,0,66.52
臺北市,萬華區,新安里,0,2,3596,53,3649,5483,3,1,3,0,1,0,66.55
臺北市,萬華區,頂碩里,0,2,4272,45,4317,6565,3,1,3,0,1,0,65.76
臺北市,萬華區,雙園里,0,2,2734,27,2761,4267,3,1,3,0,1,0,64.71
臺北市,萬華區,新忠里,0,2,2252,8,2260,3315,3,1,3,0,1,0,68.17
臺北市,萬華區,新和里,0,2,4980,46,5026,7145,3,1,3,0,1,0,70.34
臺北市,大安區,德安里,0,2,2843,22,2865,4474,3,1,3,0,1,0,64.04
臺北市,大安區,仁慈里,0,2,2460,19,2479,3870,3,1,3,0,1,0,64.06
臺北市,大安區,和安里,0,2,3185,22,3207,4909,3,1,3,0,1,0,65.33
臺北市,大安區,民炤里,0,2,3964,21,3985,6332,3,1,3,0,1,0,62.93
臺北市,大安區,仁愛里,0,2,2639,20,2659,4627,3,1,3,0,1,0,57.47
臺北市,大安區,義村里,0,2,3643,29,3672,5528,3,1,3,0,1,0,66.43
臺北市,大安區,民輝里,0,2,3246,24,3270,5163,3,1,3,0,1,0,63.34
臺北市,大安區,昌隆里,0,2,1878,19,1897,2924,3,1,3,0,1,0,64.88
臺北市,大安區,誠安里,0,2,2275,14,2289,3583,3,1,3,0,1,0,63.89
臺北市,大安區,光武里,0,2,3752,32,3784,6280,3,1,3,0,1,0,60.25
臺北市,大安區,龍坡里,0,2,2985,13,2998,4431,3,1,3,0,1,0,67.66
臺北市,大安區,龍泉里,0,2,2239,11,2250,3557,3,1,3,0,1,0,63.26
臺北市,大安區,古風里,0,2,2149,8,2157,3293,3,1,3,0,1,0,65.50
臺北市,大安區,古莊里,0,2,3253,22,3275,5021,3,1,3,0,1,0,65.23
臺北市,大安區,龍安里,0,2,2848,16,2864,4842,3,1,3,0,1,0,59.15
臺北市,大安區,錦安里,0,2,2591,12,2603,3943,3,1,3,0,1,0,66.02
臺北市,大安區,福住里,0,2,2744,20,2764,4240,3,1,3,0,1,0,65.19
臺北市,大安區,永康里,0,2,1671,16,1687,2544,3,1,3,0,1,0,66.31
臺北市,大安區,光明里,0,2,1905,11,1916,2819,3,1,3,0,1,0,67.97
臺北市,大安區,錦泰里,0,2,2771,29,2800,3987,3,1,3,0,1,0,70.23
臺北市,大安區,錦華里,0,2,2675,15,2690,4065,3,1,3,0,1,0,66.17
臺北市,大安區,龍圖里,0,2,3274,20,3294,5224,3,1,3,0,1,0,63.06
臺北市,大安區,新龍里,0,2,3432,27,3459,5084,3,1,3,0,1,0,68.04
臺北市,大安區,龍陣里,0,2,1895,15,1910,2972,3,1,3,0,1,0,64.27
臺北市,大安區,龍雲里,0,2,2621,24,2645,4063,3,1,3,0,1,0,65.10
臺北市,大安區,龍生里,0,2,3200,22,3222,4777,3,1,3,0,1,0,67.45
臺北市,大安區,住安里,0,2,2756,30,2786,4367,3,1,3,0,1,0,63.80
臺北市,大安區,義安里,0,2,2719,20,2739,4429,3,1,3,0,1,0,61.84
臺北市,大安區,通化里,0,2,3128,33,3161,4842,3,1,3,0,1,0,65.28
臺北市,大安區,通安里,0,2,2924,21,2945,4556,3,1,3,0,1,0,64.64
臺北市,大安區,臨江里,0,2,2276,24,2300,3495,3,1,3,0,1,0,65.81
臺北市,大安區,法治里,0,2,2323,18,2341,3513,3,1,3,0,1,0,66.64
臺北市,大安區,全安里,0,2,2226,12,2238,3508,3,1,3,0,1,0,63.80
臺北市,大安區,群賢里,0,2,3221,15,3236,5014,3,1,3,0,1,0,64.54
臺北市,大安區,群英里,0,2,3995,17,4012,5845,3,1,3,0,1,0,68.64
臺北市,大安區,虎嘯里,0,2,1698,13,1711,2593,3,1,3,0,1,0,65.99
臺北市,大安區,臥龍里,0,2,1572,9,1581,2421,3,1,3,0,1,0,65.30
臺北市,大安區,龍淵里,0,2,4522,29,4551,6862,3,1,3,0,1,0,66.32
臺北市,大安區,龍門里,0,2,2097,10,2107,3224,3,1,3,0,1,0,65.35
臺北市,大安區,農場里,0,2,1039,10,1049,1672,3,1,3,0,1,0,62.74
臺北市,大安區,大學里,0,2,4090,40,4130,6433,3,1,3,0,1,0,64.20
臺北市,大安區,芳和里,0,2,3288,27,3315,4970,3,1,3,0,1,0,66.70
臺北市,大安區,青峰里,0,2,1094,12,1106,1659,3,1,3,0,1,0,66.67
臺北市,大安區,黎元里,0,2,2916,35,2951,4483,3,1,3,0,1,0,65.83
臺北市,大安區,黎孝里,0,2,4084,30,4114,6034,3,1,3,0,1,0,68.18
臺北市,大安區,黎和里,0,2,2157,28,2185,3364,3,1,3,0,1,0,64.95
臺北市,大安區,建安里,0,2,2442,22,2464,4087,3,1,3,0,1,0,60.29
臺北市,大安區,建倫里,0,2,2934,17,2951,4879,3,1,3,0,1,0,60.48
臺北市,大安區,敦安里,0,2,3011,22,3033,4861,3,1,3,0,1,0,62.39
臺北市,大安區,正聲里,0,2,2313,13,2326,3774,3,1,3,0,1,0,61.63
臺北市,大安區,敦煌里,0,2,3006,11,3017,4730,3,1,3,0,1,0,63.78
臺北市,大安區,華聲里,0,2,2094,17,2111,3398,3,1,3,0,1,0,62.12
臺北市,大安區,車層里,0,2,3390,21,3411,5279,3,1,3,0,1,0,64.61
臺北市,大安區,光信里,0,2,3899,23,3922,6099,3,1,3,0,1,0,64.31
臺北市,文山區,景行里,0,2,2648,30,2678,4089,3,1,3,0,1,0,65.49
臺北市,文山區,景東里,0,2,3229,36,3265,5073,3,1,3,0,1,0,64.36
臺北市,文山區,景美里,0,2,2259,16,2275,3377,3,1,3,0,1,0,67.37
臺北市,文山區,景慶里,0,2,3248,33,3281,4907,3,1,3,0,1,0,66.86
臺北市,文山區,景仁里,0,2,2493,23,2516,3736,3,1,3,0,1,0,67.34
臺北市,文山區,景華里,0,2,2786,17,2803,4342,3,1,3,0,1,0,64.56
臺北市,文山區,萬有里,0,2,2464,15,2479,3626,3,1,3,0,1,0,68.37
臺北市,文山區,萬祥里,0,2,2296,16,2312,3457,3,1,3,0,1,0,66.88
臺北市,文山區,萬隆里,0,2,3506,15,3521,5308,3,1,3,0,1,0,66.33
臺北市,文山區,萬年里,0,2,2692,24,2716,4144,3,1,3,0,1,0,65.54
臺北市,文山區,萬和里,0,2,1981,21,2002,2824,3,1,3,0,1,0,70.89
臺北市,文山區,萬盛里,0,2,2510,12,2522,3785,3,1,3,0,1,0,66.63
臺北市,文山區,興豐里,0,2,4486,49,4535,6701,3,1,3,0,1,0,67.68
臺北市,文山區,興光里,0,2,2453,25,2478,3844,3,1,3,0,1,0,64.46
臺北市,文山區,興家里,0,2,2872,17,2889,4402,3,1,3,0,1,0,65.63
臺北市,文山區,興得里,0,2,3096,27,3123,4875,3,1,3,0,1,0,64.06
臺北市,文山區,興業里,0,2,2822,22,2844,4340,3,1,3,0,1,0,65.53
臺北市,文山區,興安里,0,2,3211,26,3237,4753,3,1,3,0,1,0,68.10
臺北市,文山區,興福里,0,2,3032,18,3050,4465,3,1,3,0,1,0,68.31
臺北市,文山區,興旺里,0,2,3267,32,3299,5016,3,1,3,0,1,0,65.77
臺北市,文山區,興泰里,0,2,1907,18,1925,2959,3,1,3,0,1,0,65.06
臺北市,文山區,興昌里,0,2,3155,23,3178,4698,3,1,3,0,1,0,67.65
臺北市,文山區,試院里,0,2,3250,27,3277,4769,3,1,3,0,1,0,68.71
臺北市,文山區,華興里,0,2,3766,28,3794,5708,3,1,3,0,1,0,66.47
臺北市,文山區,明義里,0,2,2042,48,2090,3505,3,1,3,0,1,0,59.63
臺北市,文山區,明興里,0,2,3488,32,3520,5478,3,1,3,0,1,0,64.26
臺北市,文山區,木柵里,0,2,3918,41,3959,5797,3,1,3,0,1,0,68.29
臺北市,文山區,木新里,0,2,4403,51,4454,6801,3,1,3,0,1,0,65.49
臺北市,文山區,順興里,0,2,5419,53,5472,8047,3,1,3,0,1,0,68.00
臺北市,文山區,樟林里,0,2,4200,39,4239,6508,3,1,3,0,1,0,65.14
臺北市,文山區,樟新里,0,2,5662,32,5694,8512,3,1,3,0,1,0,66.89
臺北市,文山區,樟腳里,0,2,4732,118,4850,7239,3,1,3,0,1,0,67.00
臺北市,文山區,萬芳里,0,2,6979,58,7037,10575,3,1,3,0,1,0,66.54
臺北市,文山區,博嘉里,0,2,1989,24,2013,3111,3,1,3,0,1,0,64.71
臺北市,文山區,萬興里,0,2,4994,43,5037,7610,3,1,3,0,1,0,66.19
臺北市,文山區,指南里,0,2,1464,23,1487,2278,3,1,3,0,1,0,65.28
臺北市,文山區,老泉里,0,2,437,6,443,674,3,1,3,0,1,0,65.73
高雄市,鹽埕區,藍橋里,0,1,817,7,824,1229,3,1,3,0,1,0,67.05
高雄市,鹽埕區,慈愛里,0,1,409,2,411,577,3,1,3,0,1,0,71.23
高雄市,鹽埕區,博愛里,0,1,555,11,566,771,3,1,3,0,1,0,73.41
高雄市,鹽埕區,壽星里,0,1,873,5,878,1284,3,1,3,0,1,0,68.38
高雄市,鹽埕區,中山里,0,1,783,3,786,1182,3,1,3,0,1,0,66.50
高雄市,鹽埕區,教仁里,0,1,1502,11,1513,2214,3,1,3,0,1,0,68.34
高雄市,鹽埕區,新樂里,0,1,607,5,612,876,3,1,3,0,1,0,69.86
高雄市,鹽埕區,中原里,0,1,488,4,492,687,3,1,3,0,1,0,71.62
高雄市,鹽埕區,光明里,0,1,738,9,747,1174,3,1,3,0,1,0,63.63
高雄市,鹽埕區,育仁里,0,1,516,3,519,810,3,1,3,0,1,0,64.07
高雄市,鹽埕區,河濱里,0,1,1196,17,1213,1899,3,1,3,0,1,0,63.88
高雄市,鹽埕區,沙地里,0,1,682,6,688,1074,3,1,3,0,1,0,64.06
高雄市,鹽埕區,南端里,0,1,735,7,742,1151,3,1,3,0,1,0,64.47
高雄市,鹽埕區,港都里,0,1,749,5,754,1144,3,1,3,0,1,0,65.91
高雄市,鹽埕區,江西里,0,1,824,8,832,1225,3,1,3,0,1,0,67.92
高雄市,鹽埕區,新豐里,0,1,462,5,467,651,3,1,3,0,1,0,71.74
高雄市,鹽埕區,府北里,0,1,1140,17,1157,1757,3,1,3,0,1,0,65.85
高雄市,鹽埕區,陸橋里,0,1,862,16,878,1297,3,1,3,0,1,0,67.69
高雄市,鹽埕區,瀨南里,0,1,491,4,495,705,3,1,3,0,1,0,70.21
高雄市,鹽埕區,新化里,0,1,524,8,532,773,3,1,3,0,1,0,68.82
高雄市,鹽埕區,江南里,0,1,616,11,627,938,3,1,3,0,1,0,66.84
高雄市,鼓山區,鼓峰里,0,1,1371,16,1387,2040,3,1,3,0,1,0,67.99
高雄市,鼓山區,雄峰里,0,1,1402,19,1421,2065,3,1,3,0,1,0,68.81
高雄市,鼓山區,前峰里,0,1,2938,29,2967,4189,3,1,3,0,1,0,70.83
高雄市,鼓山區,光榮里,0,1,2652,19,2671,3936,3,1,3,0,1,0,67.86
高雄市,鼓山區,民族里,0,1,1004,13,1017,1450,3,1,3,0,1,0,70.14
高雄市,鼓山區,內惟里,0,1,825,7,832,1185,3,1,3,0,1,0,70.21
高雄市,鼓山區,建國里,0,1,1437,12,1449,2044,3,1,3,0,1,0,70.89
高雄市,鼓山區,忠正里,0,1,2610,26,2636,3912,3,1,3,0,1,0,67.38
高雄市,鼓山區,自強里,0,1,593,6,599,849,3,1,3,0,1,0,70.55
高雄市,鼓山區,龍井里,0,1,1075,14,1089,1556,3,1,3,0,1,0,69.99
高雄市,鼓山區,正德里,0,1,1107,16,1123,1669,3,1,3,0,1,0,67.29
高雄市,鼓山區,平和里,0,1,2090,12,2102,3021,3,1,3,0,1,0,69.58
高雄市,鼓山區,民強里,0,1,1940,18,1958,2841,3,1,3,0,1,0,68.92
高雄市,鼓山區,厚生里,0,1,1476,12,1488,2085,3,1,3,0,1,0,71.37
高雄市,鼓山區,龍子里,0,1,3058,33,3091,5010,3,1,3,0,1,0,61.70
高雄市,鼓山區,龍水里,0,1,610,4,614,972,3,1,3,0,1,0,63.17
高雄市,鼓山區,明誠里,0,1,5823,53,5876,9167,3,1,3,0,1,0,64.10
高雄市,鼓山區,華豐里,0,1,2117,22,2139,3116,3,1,3,0,1,0,68.65
高雄市,鼓山區,裕興里,0,1,1847,19,1866,2838,3,1,3,0,1,0,65.75
高雄市,鼓山區,裕豐里,0,1,1475,4,1479,2269,3,1,3,0,1,0,65.18
高雄市,鼓山區,鼓岩里,0,1,1058,17,1075,1606,3,1,3,0,1,0,66.94
高雄市,鼓山區,樹德里,0,1,664,6,670,963,3,1,3,0,1,0,69.57
高雄市,鼓山區,寶樹里,0,1,645,8,653,992,3,1,3,0,1,0,65.83
高雄市,鼓山區,興宗里,0,1,1041,14,1055,1547,3,1,3,0,1,0,68.20
高雄市,鼓山區,光化里,0,1,1018,13,1031,1580,3,1,3,0,1,0,65.25
高雄市,鼓山區,山下里,0,1,1019,9,1028,1500,3,1,3,0,1,0,68.53
高雄市,鼓山區,河邊里,0,1,1045,14,1059,1545,3,1,3,0,1,0,68.54
高雄市,鼓山區,綠川里,0,1,1093,18,1111,1674,3,1,3,0,1,0,66.37
高雄市,鼓山區,登山里,0,1,563,4,567,839,3,1,3,0,1,0,67.58
高雄市,鼓山區,峰南里,0,1,683,10,693,1083,3,1,3,0,1,0,63.99
高雄市,鼓山區,麗興里,0,1,729,6,735,1165,3,1,3,0,1,0,63.09
高雄市,鼓山區,新民里,0,1,765,13,778,1162,3,1,3,0,1,0,66.95
高雄市,鼓山區,延平里,0,1,613,5,618,934,3,1,3,0,1,0,66.17
高雄市,鼓山區,維生里,0,1,973,17,990,1542,3,1,3,0,1,0,64.20
高雄市,鼓山區,惠安里,0,1,843,6,849,1343,3,1,3,0,1,0,63.22
高雄市,鼓山區,壽山里,0,1,955,15,970,1589,3,1,3,0,1,0,61.04
高雄市,鼓山區,哨船頭里,0,1,803,8,811,1213,3,1,3,0,1,0,66.86
高雄市,鼓山區,桃源里,0,1,427,4,431,638,3,1,3,0,1,0,67.55
高雄市,左營區,進學里,0,1,1098,13,1111,1676,3,1,3,0,1,0,66.29
高雄市,左營區,尾西里,0,1,900,9,909,1271,3,1,3,0,1,0,71.52
高雄市,左營區,頂北里,0,1,425,7,432,636,3,1,3,0,1,0,67.92
高雄市,左營區,中北里,0,1,503,2,505,707,3,1,3,0,1,0,71.43
高雄市,左營區,中南里,0,1,400,9,409,558,3,1,3,0,1,0,73.30
高雄市,左營區,廟東里,0,1,680,9,689,939,3,1,3,0,1,0,73.38
高雄市,左營區,廟北里,0,1,746,13,759,1048,3,1,3,0,1,0,72.42
高雄市,左營區,尾南里,0,1,574,8,582,834,3,1,3,0,1,0,69.78
高雄市,左營區,尾北里,0,1,1812,21,1833,2589,3,1,3,0,1,0,70.80
高雄市,左營區,海光里,0,1,219,4,223,392,3,1,3,0,1,0,56.89
高雄市,左營區,屏山里,0,1,1020,10,1030,1480,3,1,3,0,1,0,69.59
高雄市,左營區,祥和里,0,1,494,6,500,677,3,1,3,0,1,0,73.86
高雄市,左營區,永清里,0,1,1367,20,1387,1950,3,1,3,0,1,0,71.13
高雄市,左營區,復興里,0,1,898,9,907,1273,3,1,3,0,1,0,71.25
高雄市,左營區,莒光里,0,1,1159,10,1169,1680,3,1,3,0,1,0,69.58
高雄市,左營區,光輝里,0,1,1713,21,1734,2565,3,1,3,0,1,0,67.60
高雄市,左營區,合群里,0,1,926,3,929,1327,3,1,3,0,1,0,70.01
高雄市,左營區,自治里,0,1,1306,9,1315,1827,3,1,3,0,1,0,71.98
高雄市,左營區,明建里,0,1,1036,14,1050,1471,3,1,3,0,1,0,71.38
高雄市,左營區,自立里,0,1,676,3,679,942,3,1,3,0,1,0,72.08
高雄市,左營區,頂西里,0,1,869,7,876,1196,3,1,3,0,1,0,73.24
高雄市,左營區,聖后里,0,1,667,8,675,980,3,1,3,0,1,0,68.88
高雄市,左營區,聖西里,0,1,308,6,314,428,3,1,3,0,1,0,73.36
高雄市,左營區,聖南里,0,1,401,5,406,580,3,1,3,0,1,0,70.00
高雄市,左營區,城南里,0,1,400,0,400,588,3,1,3,0,1,0,68.03
高雄市,左營區,路東里,0,1,555,1,556,803,3,1,3,0,1,0,69.24
高雄市,左營區,廍北里,0,1,393,5,398,550,3,1,3,0,1,0,72.36
高雄市,左營區,廍南里,0,1,569,2,571,789,3,1,3,0,1,0,72.37
高雄市,左營區,埤西里,0,1,798,8,806,1129,3,1,3,0,1,0,71.39
高雄市,左營區,埤北里,0,1,961,9,970,1457,3,1,3,0,1,0,66.58
高雄市,左營區,埤東里,0,1,879,12,891,1271,3,1,3,0,1,0,70.10
高雄市,左營區,海勝里,0,1,2423,24,2447,3306,3,1,3,0,1,0,74.02
高雄市,左營區,自勉里,0,1,1247,19,1266,1723,3,1,3,0,1,0,73.48
高雄市,左營區,崇實里,0,1,831,8,839,1116,3,1,3,0,1,0,75.18
高雄市,左營區,自助里,0,1,1680,16,1696,2356,3,1,3,0,1,0,71.99
高雄市,左營區,果貿里,0,1,1415,13,1428,1948,3,1,3,0,1,0,73.31
高雄市,左營區,果惠里,0,1,1079,12,1091,1597,3,1,3,0,1,0,68.32
高雄市,左營區,果峰里,0,1,1268,14,1282,1786,3,1,3,0,1,0,71.78
高雄市,左營區,新下里,0,1,5567,40,5607,8738,3,1,3,0,1,0,64.17
高雄市,左營區,新上里,0,1,10129,92,10221,16627,3,1,3,0,1,0,61.47
高雄市,左營區,新中里,0,1,2863,27,2890,4350,3,1,3,0,1,0,66.44
高雄市,左營區,新光里,0,1,4906,40,4946,7749,3,1,3,0,1,0,63.83
高雄市,左營區,菜公里,0,1,8775,65,8840,14346,3,1,3,0,1,0,61.62
高雄市,左營區,福山里,0,1,9984,95,10079,16960,3,1,3,0,1,0,59.43
高雄市,楠梓區,清豐里,0,1,4701,53,4754,7689,3,1,3,0,1,0,61.83
高雄市,楠梓區,東寧里,0,1,1350,12,1362,2122,3,1,3,0,1,0,64.18
高雄市,楠梓區,五常里,0,1,2484,33,2517,4045,3,1,3,0,1,0,62.22
高雄市,楠梓區,享平里,0,1,1628,14,1642,2615,3,1,3,0,1,0,62.79
高雄市,楠梓區,中陽里,0,1,1655,17,1672,2578,3,1,3,0,1,0,64.86
高雄市,楠梓區,惠楠里,0,1,1426,22,1448,2344,3,1,3,0,1,0,61.77
高雄市,楠梓區,惠民里,0,1,2136,23,2159,3131,3,1,3,0,1,0,68.96
高雄市,楠梓區,惠豐里,0,1,1507,19,1526,2414,3,1,3,0,1,0,63.21
高雄市,楠梓區,錦屏里,0,1,2338,12,2350,3357,3,1,3,0,1,0,70.00
高雄市,楠梓區,玉屏里,0,1,1575,22,1597,2273,3,1,3,0,1,0,70.26
高雄市,楠梓區,金田里,0,1,2129,20,2149,3123,3,1,3,0,1,0,68.81
高雄市,楠梓區,稔田里,0,1,1068,13,1081,1623,3,1,3,0,1,0,66.61
高雄市,楠梓區,瑞屏里,0,1,1996,32,2028,3076,3,1,3,0,1,0,65.93
高雄市,楠梓區,翠屏里,0,1,6670,60,6730,10638,3,1,3,0,1,0,63.26
高雄市,楠梓區,宏南里,0,1,1171,9,1180,1673,3,1,3,0,1,0,70.53
高雄市,楠梓區,宏毅里,0,1,2083,21,2104,2887,3,1,3,0,1,0,72.88
高雄市,楠梓區,宏榮里,0,1,1384,13,1397,1833,3,1,3,0,1,0,76.21
高雄市,楠梓區,廣昌里,0,1,2078,24,2102,2983,3,1,3,0,1,0,70.47
高雄市,楠梓區,久昌里,0,1,1326,19,1345,2148,3,1,3,0,1,0,62.62
高雄市,楠梓區,大昌里,0,1,1376,15,1391,2034,3,1,3,0,1,0,68.39
高雄市,楠梓區,福昌里,0,1,1286,12,1298,1795,3,1,3,0,1,0,72.31
高雄市,楠梓區,盛昌里,0,1,2363,10,2373,3422,3,1,3,0,1,0,69.35
高雄市,楠梓區,泰昌里,0,1,1018,9,1027,1526,3,1,3,0,1,0,67.30
高雄市,楠梓區,興昌里,0,1,1767,12,1779,2650,3,1,3,0,1,0,67.13
高雄市,楠梓區,建昌里,0,1,1515,16,1531,2256,3,1,3,0,1,0,67.86
高雄市,楠梓區,宏昌里,0,1,1355,10,1365,2125,3,1,3,0,1,0,64.24
高雄市,楠梓區,和昌里,0,1,1483,12,1495,2097,3,1,3,0,1,0,71.29
高雄市,楠梓區,慶昌里,0,1,2101,10,2111,3020,3,1,3,0,1,0,69.90
高雄市,楠梓區,隆昌里,0,1,2196,29,2225,3206,3,1,3,0,1,0,69.40
高雄市,楠梓區,秀昌里,0,1,1267,19,1286,1945,3,1,3,0,1,0,66.12
高雄市,楠梓區,裕昌里,0,1,1637,17,1654,2454,3,1,3,0,1,0,67.40
高雄市,楠梓區,國昌里,0,1,1781,22,1803,2786,3,1,3,0,1,0,64.72
高雄市,楠梓區,加昌里,0,1,3555,31,3586,5322,3,1,3,0,1,0,67.38
高雄市,楠梓區,仁昌里,0,1,1988,15,2003,3139,3,1,3,0,1,0,63.81
高雄市,楠梓區,藍田里,0,1,643,1,644,896,3,1,3,0,1,0,71.88
高雄市,楠梓區,中興里,0,1,550,3,553,834,3,1,3,0,1,0,66.31
高雄市,楠梓區,中和里,0,1,1023,4,1027,1460,3,1,3,0,1,0,70.34
高雄市,三民區,鼎金里,0,1,1761,21,1782,2920,3,1,3,0,1,0,61.03
高雄市,三民區,鼎盛里,0,1,3362,26,3388,5237,3,1,3,0,1,0,64.69
高雄市,三民區,鼎強里,0,1,2176,17,2193,3349,3,1,3,0,1,0,65.48
高雄市,三民區,鼎力里,0,1,2121,14,2135,3265,3,1,3,0,1,0,65.39
高雄市,三民區,鼎西里,0,1,2933,29,2962,4736,3,1,3,0,1,0,62.54
高雄市,三民區,鼎中里,0,1,2094,42,2136,2967,3,1,3,0,1,0,71.99
高雄市,三民區,鼎泰里,0,1,9202,68,9270,15265,3,1,3,0,1,0,60.73
高雄市,三民區,本舘里,0,1,4564,47,4611,7075,3,1,3,0,1,0,65.17
高雄市,三民區,本和里,0,1,3457,33,3490,5297,3,1,3,0,1,0,65.89
高雄市,三民區,本文里,0,1,1334,18,1352,2002,3,1,3,0,1,0,67.53
高雄市,三民區,本武里,0,1,999,11,1010,1469,3,1,3,0,1,0,68.75
高雄市,三民區,本元里,0,1,2704,24,2728,4085,3,1,3,0,1,0,66.78
高雄市,三民區,本安里,0,1,2278,21,2299,3422,3,1,3,0,1,0,67.18
高雄市,三民區,本上里,0,1,2553,25,2578,3774,3,1,3,0,1,0,68.31
高雄市,三民區,本揚里,0,1,3739,36,3775,5963,3,1,3,0,1,0,63.31
高雄市,三民區,寶獅里,0,1,2074,22,2096,3356,3,1,3,0,1,0,62.46
高雄市,三民區,寶德里,0,1,2722,28,2750,4337,3,1,3,0,1,0,63.41
高雄市,三民區,寶泰里,0,1,1560,17,1577,2596,3,1,3,0,1,0,60.75
高雄市,三民區,寶興里,0,1,3195,27,3222,5005,3,1,3,0,1,0,64.38
高雄市,三民區,寶中里,0,1,1796,9,1805,2568,3,1,3,0,1,0,70.29
高雄市,三民區,寶華里,0,1,1732,15,1747,2587,3,1,3,0,1,0,67.53
高雄市,三民區,寶國里,0,1,3561,32,3593,5595,3,1,3,0,1,0,64.22
高雄市,三民區,寶民里,0,1,1642,15,1657,2468,3,1,3,0,1,0,67.14
高雄市,三民區,寶慶里,0,1,1476,14,1490,2302,3,1,3,0,1,0,64.73
高雄市,三民區,寶業里,0,1,2258,19,2277,3687,3,1,3,0,1,0,61.76
高雄市,三民區,寶盛里,0,1,2475,17,2492,3742,3,1,3,0,1,0,66.60
高雄市,三民區,寶安里,0,1,3346,31,3377,5416,3,1,3,0,1,0,62.35
高雄市,三民區,寶龍里,0,1,2508,42,2550,3786,3,1,3,0,1,0,67.35
高雄市,三民區,寶珠里,0,1,2717,34,2751,4450,3,1,3,0,1,0,61.82
高雄市,三民區,寶玉里,0,1,3688,28,3716,6069,3,1,3,0,1,0,61.23
高雄市,三民區,灣子里,0,1,1692,9,1701,2756,3,1,3,0,1,0,61.72
高雄市,三民區,灣愛里,0,1,1654,20,1674,2740,3,1,3,0,1,0,61.09
高雄市,三民區,灣中里,0,1,2466,29,2495,4035,3,1,3,0,1,0,61.83
高雄市,三民區,灣華里,0,1,1518,10,1528,2356,3,1,3,0,1,0,64.86
高雄市,三民區,灣勝里,0,1,1316,18,1334,2006,3,1,3,0,1,0,66.50
高雄市,三民區,灣利里,0,1,2123,22,2145,3283,3,1,3,0,1,0,65.34
高雄市,三民區,灣復里,0,1,1751,6,1757,2841,3,1,3,0,1,0,61.84
高雄市,三民區,正興里,0,1,4883,42,4925,8047,3,1,3,0,1,0,61.20
高雄市,三民區,正順里,0,1,2027,8,2035,3150,3,1,3,0,1,0,64.60
高雄市,三民區,灣興里,0,1,1013,12,1025,1545,3,1,3,0,1,0,66.34
高雄市,三民區,灣成里,0,1,1048,8,1056,1597,3,1,3,0,1,0,66.12
高雄市,三民區,安康里,0,1,1924,20,1944,3030,3,1,3,0,1,0,64.16
高雄市,三民區,安寧里,0,1,1272,25,1297,2046,3,1,3,0,1,0,63.39
高雄市,三民區,安吉里,0,1,2262,16,2278,3840,3,1,3,0,1,0,59.32
高雄市,三民區,安發里,0,1,2456,20,2476,3901,3,1,3,0,1,0,63.47
高雄市,三民區,安東里,0,1,2193,18,2211,3186,3,1,3,0,1,0,69.40
高雄市,三民區,安和里,0,1,1830,14,1844,2630,3,1,3,0,1,0,70.11
高雄市,三民區,達德里,0,1,1072,4,1076,1502,3,1,3,0,1,0,71.64
高雄市,三民區,達明里,0,1,1145,16,1161,1667,3,1,3,0,1,0,69.65
高雄市,三民區,達仁里,0,1,994,6,1000,1436,3,1,3,0,1,0,69.64
高雄市,三民區,達勇里,0,1,746,8,754,1065,3,1,3,0,1,0,70.80
高雄市,三民區,同德里,0,1,1766,19,1785,2809,3,1,3,0,1,0,63.55
高雄市,三民區,德智里,0,1,1583,11,1594,2429,3,1,3,0,1,0,65.62
高雄市,三民區,德仁里,0,1,1145,7,1152,1907,3,1,3,0,1,0,60.41
高雄市,三民區,安生里,0,1,1170,12,1182,1716,3,1,3,0,1,0,68.88
高雄市,三民區,德東里,0,1,607,10,617,885,3,1,3,0,1,0,69.72
高雄市,三民區,德行里,0,1,761,7,768,1090,3,1,3,0,1,0,70.46
高雄市,三民區,精華里,0,1,1135,16,1151,1628,3,1,3,0,1,0,70.70
高雄市,三民區,民享里,0,1,1453,11,1464,2060,3,1,3,0,1,0,71.07
高雄市,三民區,安宜里,0,1,2188,22,2210,3207,3,1,3,0,1,0,68.91
高雄市,三民區,安泰里,0,1,2544,32,2576,3989,3,1,3,0,1,0,64.58
高雄市,三民區,安邦里,0,1,2329,16,2345,3651,3,1,3,0,1,0,64.23
高雄市,三民區,十全里,0,1,1070,14,1084,1562,3,1,3,0,1,0,69.40
高雄市,三民區,十美里,0,1,1179,12,1191,1718,3,1,3,0,1,0,69.32
高雄市,三民區,德北里,0,1,1376,14,1390,2080,3,1,3,0,1,0,66.83
高雄市,三民區,立誠里,0,1,683,8,691,957,3,1,3,0,1,0,72.20
高雄市,三民區,立業里,0,1,735,21,756,1100,3,1,3,0,1,0,68.73
高雄市,三民區,港東里,0,1,811,4,815,1341,3,1,3,0,1,0,60.78
高雄市,三民區,港新里,0,1,892,9,901,1459,3,1,3,0,1,0,61.75
高雄市,三民區,港西里,0,1,526,14,540,850,3,1,3,0,1,0,63.53
高雄市,三民區,港北里,0,1,355,3,358,477,3,1,3,0,1,0,75.05
高雄市,三民區,博愛里,0,1,760,8,768,1186,3,1,3,0,1,0,64.76
高雄市,三民區,博惠里,0,1,2494,25,2519,3968,3,1,3,0,1,0,63.48
高雄市,三民區,長明里,0,1,812,7,819,1219,3,1,3,0,1,0,67.19
高雄市,三民區,建東里,0,1,600,6,606,1075,3,1,3,0,1,0,56.37
高雄市,三民區,興德里,0,1,1072,2,1074,1616,3,1,3,0,1,0,66.46
高雄市,三民區,鳳南里,0,1,818,6,824,1146,3,1,3,0,1,0,71.90
高雄市,三民區,鳳北里,0,1,1367,14,1381,1976,3,1,3,0,1,0,69.89
高雄市,三民區,德西里,0,1,836,18,854,1251,3,1,3,0,1,0,68.27
高雄市,三民區,九如里,0,1,297,4,301,443,3,1,3,0,1,0,67.95
高雄市,三民區,豐裕里,0,1,1836,24,1860,2682,3,1,3,0,1,0,69.35
高雄市,三民區,川東里,0,1,1258,17,1275,1857,3,1,3,0,1,0,68.66
高雄市,三民區,裕民里,0,1,539,10,549,769,3,1,3,0,1,0,71.39
高雄市,三民區,力行里,0,1,884,2,886,1179,3,1,3,0,1,0,75.15
高雄市,三民區,千歲里,0,1,817,9,826,1196,3,1,3,0,1,0,69.06
高雄市,三民區,立德里,0,1,879,9,888,1354,3,1,3,0,1,0,65.58
高雄市,三民區,千北里,0,1,871,6,877,1302,3,1,3,0,1,0,67.36
高雄市,三民區,千秋里,0,1,1579,16,1595,2417,3,1,3,0,1,0,65.99
高雄市,旗津區,旗下里,0,1,848,5,853,1258,3,1,3,0,1,0,67.81
高雄市,旗津區,永安里,0,1,691,12,703,1101,3,1,3,0,1,0,63.85
高雄市,旗津區,振興里,0,1,1047,12,1059,1654,3,1,3,0,1,0,64.03
高雄市,旗津區,慈愛里,0,1,1283,26,1309,2052,3,1,3,0,1,0,63.79
高雄市,旗津區,復興里,0,1,1831,34,1865,2816,3,1,3,0,1,0,66.23
高雄市,旗津區,中華里,0,1,857,13,870,1221,3,1,3,0,1,0,71.25
高雄市,旗津區,實踐里,0,1,846,9,855,1370,3,1,3,0,1,0,62.41
高雄市,旗津區,北汕里,0,1,1440,29,1469,2286,3,1,3,0,1,0,64.26
高雄市,旗津區,南汕里,0,1,1073,15,1088,1685,3,1,3,0,1,0,64.57
高雄市,旗津區,上竹里,0,1,1398,12,1410,2536,3,1,3,0,1,0,55.60
高雄市,旗津區,中洲里,0,1,1029,16,1045,1634,3,1,3,0,1,0,63.95
高雄市,旗津區,安順里,0,1,554,7,561,1019,3,1,3,0,1,0,55.05
高雄市,旗津區,中興里,0,1,1370,9,1379,2108,3,1,3,0,1,0,65.42
高雄市,新興區,浩然里,0,2,1321,15,1336,1919,3,1,3,0,1,0,69.62
高雄市,新興區,振成里,0,2,805,10,815,1295,3,1,3,0,1,0,62.93
高雄市,新興區,德生里,0,2,1355,10,1365,2210,3,1,3,0,1,0,61.76
高雄市,新興區,振華里,0,2,819,7,826,1239,3,1,3,0,1,0,66.67
高雄市,新興區,正氣里,0,2,1083,12,1095,1575,3,1,3,0,1,0,69.52
高雄市,新興區,德政里,0,2,503,8,511,747,3,1,3,0,1,0,68.41
高雄市,新興區,仁聲里,0,2,507,6,513,802,3,1,3,0,1,0,63.97
高雄市,新興區,德望里,0,2,1217,13,1230,1931,3,1,3,0,1,0,63.70
高雄市,新興區,華聲里,0,2,716,4,720,1069,3,1,3,0,1,0,67.35
高雄市,新興區,蕉園里,0,2,503,4,507,746,3,1,3,0,1,0,67.96
高雄市,新興區,永寧里,0,2,918,9,927,1449,3,1,3,0,1,0,63.98
高雄市,新興區,玉衡里,0,2,713,7,720,1076,3,1,3,0,1,0,66.91
高雄市,新興區,順昌里,0,2,1402,23,1425,2132,3,1,3,0,1,0,66.84
高雄市,新興區,文昌里,0,2,1564,11,1575,2393,3,1,3,0,1,0,65.82
高雄市,新興區,光耀里,0,2,1587,6,1593,2462,3,1,3,0,1,0,64.70
高雄市,新興區,興昌里,0,2,1202,16,1218,1794,3,1,3,0,1,0,67.89
高雄市,新興區,開平里,0,2,1925,20,1945,2897,3,1,3,0,1,0,67.14
高雄市,新興區,成功里,0,2,773,9,782,1180,3,1,3,0,1,0,66.27
高雄市,新興區,新江里,0,2,714,3,717,1157,3,1,3,0,1,0,61.97
高雄市,新興區,黎明里,0,2,577,6,583,952,3,1,3,0,1,0,61.24
高雄市,新興區,愛平里,0,2,598,6,604,918,3,1,3,0,1,0,65.80
高雄市,新興區,南港里,0,2,1472,17,1489,2212,3,1,3,0,1,0,67.31
高雄市,新興區,中東里,0,2,1434,17,1451,2548,3,1,3,0,1,0,56.95
高雄市,新興區,明莊里,0,2,572,7,579,868,3,1,3,0,1,0,66.71
高雄市,新興區,大明里,0,2,762,5,767,1173,3,1,3,0,1,0,65.39
高雄市,新興區,秋山里,0,2,675,5,680,1018,3,1,3,0,1,0,66.80
高雄市,新興區,長驛里,0,2,530,2,532,823,3,1,3,0,1,0,64.64
高雄市,新興區,建興里,0,2,577,10,587,873,3,1,3,0,1,0,67.24
高雄市,新興區,建華里,0,2,591,3,594,950,3,1,3,0,1,0,62.53
高雄市,新興區,漢民里,0,2,598,4,602,884,3,1,3,0,1,0,68.10
高雄市,新興區,榮治里,0,2,532,7,539,743,3,1,3,0,1,0,72.54
高雄市,新興區,東坡里,0,2,983,11,994,1412,3,1,3,0,1,0,70.40
高雄市,前金區,三川里,0,2,565,3,568,835,3,1,3,0,1,0,68.02
高雄市,前金區,草江里,0,2,778,8,786,1194,3,1,3,0,1,0,65.83
高雄市,前金區,長城里,0,2,958,9,967,1478,3,1,3,0,1,0,65.43
高雄市,前金區,北金里,0,2,560,5,565,867,3,1,3,0,1,0,65.17
高雄市,前金區,東金里,0,2,567,7,574,930,3,1,3,0,1,0,61.72
高雄市,前金區,新生里,0,2,2047,24,2071,3152,3,1,3,0,1,0,65.70
高雄市,前金區,後金里,0,2,660,9,669,983,3,1,3,0,1,0,68.06
高雄市,前金區,長興里,0,2,683,4,687,1110,3,1,3,0,1,0,61.89
高雄市,前金區,青山里,0,2,876,7,883,1411,3,1,3,0,1,0,62.58
高雄市,前金區,民生里,0,2,456,3,459,741,3,1,3,0,1,0,61.94
高雄市,前金區,復元里,0,2,683,4,687,1031,3,1,3,0,1,0,66.63
高雄市,前金區,林投里,0,2,820,8,828,1217,3,1,3,0,1,0,68.04
高雄市,前金區,國民里,0,2,714,5,719,1091,3,1,3,0,1,0,65.90
高雄市,前金區,社東里,0,2,1161,10,1171,1693,3,1,3,0,1,0,69.17
高雄市,前金區,社西里,0,2,709,3,712,1051,3,1,3,0,1,0,67.75
高雄市,前金區,博孝里,0,2,594,4,598,977,3,1,3,0,1,0,61.21
高雄市,前金區,長生里,0,2,993,11,1004,1614,3,1,3,0,1,0,62.21
高雄市,前金區,榮復里,0,2,850,11,861,1292,3,1,3,0,1,0,66.64
高雄市,前金區,文西里,0,2,720,14,734,1101,3,1,3,0,1,0,66.67
高雄市,前金區,文東里,0,2,893,12,905,1370,3,1,3,0,1,0,66.06
高雄市,苓雅區,博仁里,0,2,418,9,427,638,3,1,3,0,1,0,66.93
高雄市,苓雅區,苓洲里,0,2,929,8,937,1413,3,1,3,0,1,0,66.31
高雄市,苓雅區,苓昇里,0,2,948,14,962,1414,3,1,3,0,1,0,68.03
高雄市,苓雅區,苓中里,0,2,1113,11,1124,1630,3,1,3,0,1,0,68.96
高雄市,苓雅區,苓雅里,0,2,924,9,933,1409,3,1,3,0,1,0,66.22
高雄市,苓雅區,苓東里,0,2,975,13,988,1510,3,1,3,0,1,0,65.43
高雄市,苓雅區,城北里,0,2,938,5,943,1474,3,1,3,0,1,0,63.98
高雄市,苓雅區,城西里,0,2,473,5,478,678,3,1,3,0,1,0,70.50
高雄市,苓雅區,城東里,0,2,1037,8,1045,1636,3,1,3,0,1,0,63.88
高雄市,苓雅區,意誠里,0,2,1346,11,1357,2318,3,1,3,0,1,0,58.54
高雄市,苓雅區,鼓中里,0,2,812,9,821,1215,3,1,3,0,1,0,67.57
高雄市,苓雅區,田西里,0,2,1041,14,1055,1477,3,1,3,0,1,0,71.43
高雄市,苓雅區,人和里,0,2,1184,16,1200,1920,3,1,3,0,1,0,62.50
高雄市,苓雅區,仁政里,0,2,1117,12,1129,1753,3,1,3,0,1,0,64.40
高雄市,苓雅區,廣澤里,0,2,1321,21,1342,1939,3,1,3,0,1,0,69.21
高雄市,苓雅區,美田里,0,2,800,7,807,1283,3,1,3,0,1,0,62.90
高雄市,苓雅區,華堂里,0,2,1818,19,1837,2933,3,1,3,0,1,0,62.63
高雄市,苓雅區,日中里,0,2,1523,20,1543,2334,3,1,3,0,1,0,66.11
高雄市,苓雅區,普照里,0,2,1721,16,1737,2610,3,1,3,0,1,0,66.55
高雄市,苓雅區,和煦里,0,2,1448,10,1458,2174,3,1,3,0,1,0,67.07
高雄市,苓雅區,晴朗里,0,2,670,7,677,1202,3,1,3,0,1,0,56.32
高雄市,苓雅區,普天里,0,2,1777,17,1794,2772,3,1,3,0,1,0,64.72
高雄市,苓雅區,林富里,0,2,1045,12,1057,1715,3,1,3,0,1,0,61.63
高雄市,苓雅區,林圍里,0,2,1294,13,1307,2010,3,1,3,0,1,0,65.02
高雄市,苓雅區,林安里,0,2,1023,7,1030,1528,3,1,3,0,1,0,67.41
高雄市,苓雅區,光華里,0,2,545,7,552,805,3,1,3,0,1,0,68.57
高雄市,苓雅區,林興里,0,2,929,18,947,1457,3,1,3,0,1,0,65.00
高雄市,苓雅區,林華里,0,2,1926,18,1944,3003,3,1,3,0,1,0,64.74
高雄市,苓雅區,林西里,0,2,1193,6,1199,1864,3,1,3,0,1,0,64.32
高雄市,苓雅區,林中里,0,2,2147,31,2178,3252,3,1,3,0,1,0,66.97
高雄市,苓雅區,林泉里,0,2,1150,17,1167,1785,3,1,3,0,1,0,65.38
高雄市,苓雅區,林南里,0,2,1731,15,1746,2784,3,1,3,0,1,0,62.72
高雄市,苓雅區,中正里,0,2,1575,10,1585,2502,3,1,3,0,1,0,63.35
高雄市,苓雅區,尚義里,0,2,869,9,878,1388,3,1,3,0,1,0,63.26
高雄市,苓雅區,同慶里,0,2,1075,7,1082,1603,3,1,3,0,1,0,67.50
高雄市,苓雅區,凱旋里,0,2,1380,13,1393,1953,3,1,3,0,1,0,71.33
高雄市,苓雅區,安祥里,0,2,1447,16,1463,2255,3,1,3,0,1,0,64.88
高雄市,苓雅區,奏捷里,0,2,1172,12,1184,1666,3,1,3,0,1,0,71.07
高雄市,苓雅區,福壽里,0,2,1057,15,1072,1536,3,1,3,0,1,0,69.79
高雄市,苓雅區,福南里,0,2,1576,20,1596,2279,3,1,3,0,1,0,70.03
高雄市,苓雅區,五權里,0,2,1254,20,1274,1923,3,1,3,0,1,0,66.25
高雄市,苓雅區,民主里,0,2,2379,19,2398,3749,3,1,3,0,1,0,63.96
高雄市,苓雅區,林德里,0,2,1125,28,1153,1770,3,1,3,0,1,0,65.14
高雄市,苓雅區,林貴里,0,2,925,8,933,1328,3,1,3,0,1,0,70.26
高雄市,苓雅區,林榮里,0,2,2490,26,2516,3867,3,1,3,0,1,0,65.06
高雄市,苓雅區,英明里,0,2,1295,12,1307,2016,3,1,3,0,1,0,64.83
高雄市,苓雅區,林靖里,0,2,1173,8,1181,1735,3,1,3,0,1,0,68.07
高雄市,苓雅區,朝陽里,0,2,970,13,983,1514,3,1,3,0,1,0,64.93
高雄市,苓雅區,福隆里,0,2,1835,22,1857,2751,3,1,3,0,1,0,67.50
高雄市,苓雅區,福祥里,0,2,907,8,915,1328,3,1,3,0,1,0,68.90
高雄市,苓雅區,福海里,0,2,683,5,688,1031,3,1,3,0,1,0,66.73
高雄市,苓雅區,福康里,0,2,1316,12,1328,1964,3,1,3,0,1,0,67.62
高雄市,苓雅區,福人里,0,2,1518,41,1559,2168,3,1,3,0,1,0,71.91
高雄市,苓雅區,福地里,0,2,2040,29,2069,2900,3,1,3,0,1,0,71.34
高雄市,苓雅區,福居里,0,2,2022,28,2050,2849,3,1,3,0,1,0,71.96
高雄市,苓雅區,福東里,0,2,1657,22,1679,2498,3,1,3,0,1,0,67.21
高雄市,苓雅區,福西里,0,2,1486,29,1515,2235,3,1,3,0,1,0,67.79
高雄市,苓雅區,永康里,0,2,1522,22,1544,2363,3,1,3,0,1,0,65.34
高雄市,苓雅區,正文里,0,2,1096,13,1109,1697,3,1,3,0,1,0,65.35
高雄市,苓雅區,正言里,0,2,1624,19,1643,2498,3,1,3,0,1,0,65.77
高雄市,苓雅區,正大里,0,2,2535,32,2567,4225,3,1,3,0,1,0,60.76
高雄市,苓雅區,五福里,0,2,2447,25,2472,3839,3,1,3,0,1,0,64.39
高雄市,苓雅區,正心里,0,2,2252,25,2277,3471,3,1,3,0,1,0,65.60
高雄市,苓雅區,正道里,0,2,2584,35,2619,3946,3,1,3,0,1,0,66.37
高雄市,苓雅區,正義里,0,2,1434,21,1455,2168,3,1,3,0,1,0,67.11
高雄市,苓雅區,正仁里,0,2,1538,21,1559,2335,3,1,3,0,1,0,66.77
高雄市,苓雅區,文昌里,0,2,2563,32,2595,3800,3,1,3,0,1,0,68.29
高雄市,苓雅區,建軍里,0,2,1311,28,1339,1956,3,1,3,0,1,0,68.46
高雄市,苓雅區,衛武里,0,2,1410,14,1424,2105,3,1,3,0,1,0,67.65
高雄市,前鎮區,草衙里,0,2,4974,47,5021,7842,3,1,3,0,1,0,64.03
高雄市,前鎮區,明孝里,0,2,1507,20,1527,2360,3,1,3,0,1,0,64.70
高雄市,前鎮區,明正里,0,2,2107,24,2131,3199,3,1,3,0,1,0,66.61
高雄市,前鎮區,明義里,0,2,1272,17,1289,1765,3,1,3,0,1,0,73.03
高雄市,前鎮區,仁愛里,0,2,994,16,1010,1462,3,1,3,0,1,0,69.08
高雄市,前鎮區,德昌里,0,2,1249,16,1265,1925,3,1,3,0,1,0,65.71
高雄市,前鎮區,平等里,0,2,1104,8,1112,1837,3,1,3,0,1,0,60.53
高雄市,前鎮區,平昌里,0,2,491,8,499,767,3,1,3,0,1,0,65.06
高雄市,前鎮區,明禮里,0,2,1196,15,1211,1787,3,1,3,0,1,0,67.77
高雄市,前鎮區,信義里,0,2,1164,18,1182,1628,3,1,3,0,1,0,72.60
高雄市,前鎮區,信德里,0,2,1666,15,1681,2469,3,1,3,0,1,0,68.08
高雄市,前鎮區,明道里,0,2,904,10,914,1323,3,1,3,0,1,0,69.09
高雄市,前鎮區,興化里,0,2,522,3,525,716,3,1,3,0,1,0,73.32
高雄市,前鎮區,興仁里,0,2,613,9,622,943,3,1,3,0,1,0,65.96
高雄市,前鎮區,前鎮里,0,2,1099,17,1116,1561,3,1,3,0,1,0,71.49
高雄市,前鎮區,鎮東里,0,2,1390,21,1411,1884,3,1,3,0,1,0,74.89
高雄市,前鎮區,鎮榮里,0,2,1588,27,1615,2404,3,1,3,0,1,0,67.18
高雄市,前鎮區,鎮昌里,0,2,1448,21,1469,2040,3,1,3,0,1,0,72.01
高雄市,前鎮區,鎮海里,0,2,2429,26,2455,3741,3,1,3,0,1,0,65.62
高雄市,前鎮區,鎮陽里,0,2,797,13,810,1165,3,1,3,0,1,0,69.53
高雄市,前鎮區,興邦里,0,2,1230,25,1255,1861,3,1,3,0,1,0,67.44
高雄市,前鎮區,鎮中里,0,2,585,5,590,844,3,1,3,0,1,0,69.91
高雄市,前鎮區,鎮北里,0,2,757,6,763,1028,3,1,3,0,1,0,74.22
高雄市,前鎮區,忠純里,0,2,1984,28,2012,2631,3,1,3,0,1,0,76.47
高雄市,前鎮區,忠誠里,0,2,1544,16,1560,2038,3,1,3,0,1,0,76.55
高雄市,前鎮區,西山里,0,2,2173,21,2194,3243,3,1,3,0,1,0,67.65
高雄市,前鎮區,民權里,0,2,2480,19,2499,3596,3,1,3,0,1,0,69.49
高雄市,前鎮區,建隆里,0,2,597,9,606,855,3,1,3,0,1,0,70.88
高雄市,前鎮區,振興里,0,2,1554,18,1572,2130,3,1,3,0,1,0,73.80
高雄市,前鎮區,良和里,0,2,1619,13,1632,2547,3,1,3,0,1,0,64.08
高雄市,前鎮區,西甲里,0,2,1386,10,1396,2053,3,1,3,0,1,0,68.00
高雄市,前鎮區,盛興里,0,2,1375,13,1388,2404,3,1,3,0,1,0,57.74
高雄市,前鎮區,盛豐里,0,2,1757,15,1772,2850,3,1,3,0,1,0,62.18
高雄市,前鎮區,興中里,0,2,1861,18,1879,3059,3,1,3,0,1,0,61.43
高雄市,前鎮區,興東里,0,2,2802,30,2832,4159,3,1,3,0,1,0,68.09
高雄市,前鎮區,忠孝里,0,2,1534,10,1544,2215,3,1,3,0,1,0,69.71
高雄市,前鎮區,復國里,0,2,1872,6,1878,2760,3,1,3,0,1,0,68.04
高雄市,前鎮區,竹內里,0,2,1703,19,1722,2615,3,1,3,0,1,0,65.85
高雄市,前鎮區,竹東里,0,2,1251,13,1264,2048,3,1,3,0,1,0,61.72
高雄市,前鎮區,竹南里,0,2,1652,16,1668,2602,3,1,3,0,1,0,64.10
高雄市,前鎮區,竹北里,0,2,1235,11,1246,1927,3,1,3,0,1,0,64.66
高雄市,前鎮區,竹西里,0,2,2284,19,2303,3414,3,1,3,0,1,0,67.46
高雄市,前鎮區,竹中里,0,2,1724,14,1738,2699,3,1,3,0,1,0,64.39
高雄市,前鎮區,瑞竹里,0,2,856,15,871,1296,3,1,3,0,1,0,67.21
高雄市,前鎮區,瑞南里,0,2,2989,30,3019,4434,3,1,3,0,1,0,68.09
高雄市,前鎮區,瑞豐里,0,2,1621,24,1645,2306,3,1,3,0,1,0,71.34
高雄市,前鎮區,瑞祥里,0,2,3081,30,3111,4559,3,1,3,0,1,0,68.24
高雄市,前鎮區,瑞東里,0,2,1516,17,1533,2307,3,1,3,0,1,0,66.45
高雄市,前鎮區,瑞和里,0,2,1329,16,1345,1993,3,1,3,0,1,0,67.49
高雄市,前鎮區,瑞平里,0,2,2328,30,2358,3452,3,1,3,0,1,0,68.31
高雄市,前鎮區,瑞隆里,0,2,2146,25,2171,3417,3,1,3,0,1,0,63.54
高雄市,前鎮區,瑞北里,0,2,1956,19,1975,2915,3,1,3,0,1,0,67.75
高雄市,前鎮區,瑞西里,0,2,1889,27,1916,2636,3,1,3,0,1,0,72.69
高雄市,前鎮區,瑞崗里,0,2,1684,21,1705,2522,3,1,3,0,1,0,67.61
高雄市,前鎮區,瑞興里,0,2,1661,23,1684,2561,3,1,3,0,1,0,65.76
高雄市,前鎮區,瑞誠里,0,2,1434,19,1453,2238,3,1,3,0,1,0,64.92
高雄市,前鎮區,瑞文里,0,2,1532,17,1549,2342,3,1,3,0,1,0,66.14
高雄市,前鎮區,瑞華里,0,2,2535,22,2557,4074,3,1,3,0,1,0,62.76
高雄市,前鎮區,瑞昌里,0,2,1664,26,1690,2689,3,1,3,0,1,0,62.85
高雄市,小港區,小港里,0,2,1154,10,1164,1679,3,1,3,0,1,0,69.33
高雄市,小港區,港口里,0,2,1999,19,2018,2945,3,1,3,0,1,0,68.52
高雄市,小港區,港正里,0,2,1551,18,1569,2285,3,1,3,0,1,0,68.67
高雄市,小港區,港墘里,0,2,1021,13,1034,1443,3,1,3,0,1,0,71.66
高雄市,小港區,港明里,0,2,1817,14,1831,2654,3,1,3,0,1,0,68.99
高雄市,小港區,港后里,0,2,1188,10,1198,1693,3,1,3,0,1,0,70.76
高雄市,小港區,港南里,0,2,856,14,870,1287,3,1,3,0,1,0,67.60
高雄市,小港區,港興里,0,2,1265,13,1278,1850,3,1,3,0,1,0,69.08
高雄市,小港區,鳳宮里,0,2,1070,10,1080,1675,3,1,3,0,1,0,64.48
高雄市,小港區,店鎮里,0,2,2669,27,2696,4064,3,1,3,0,1,0,66.34
高雄市,小港區,大苓里,0,2,1421,9,1430,2025,3,1,3,0,1,0,70.62
高雄市,小港區,二苓里,0,2,1839,20,1859,2740,3,1,3,0,1,0,67.85
高雄市,小港區,三苓里,0,2,1561,12,1573,2339,3,1,3,0,1,0,67.25
高雄市,小港區,正苓里,0,2,2037,17,2054,3136,3,1,3,0,1,0,65.50
高雄市,小港區,順苓里,0,2,2078,24,2102,3313,3,1,3,0,1,0,63.45
高雄市,小港區,六苓里,0,2,860,16,876,1258,3,1,3,0,1,0,69.63
高雄市,小港區,宏亮里,0,2,1472,19,1491,2231,3,1,3,0,1,0,66.83
高雄市,小港區,山東里,0,2,1609,18,1627,2359,3,1,3,0,1,0,68.97
高雄市,小港區,青島里,0,2,1058,11,1069,1560,3,1,3,0,1,0,68.53
高雄市,小港區,濟南里,0,2,1861,25,1886,2712,3,1,3,0,1,0,69.54
高雄市,小港區,泰山里,0,2,1394,20,1414,1979,3,1,3,0,1,0,71.45
高雄市,小港區,山明里,0,2,2918,29,2947,4432,3,1,3,0,1,0,66.49
高雄市,小港區,高松里,0,2,1969,26,1995,2996,3,1,3,0,1,0,66.59
高雄市,小港區,松金里,0,2,1245,15,1260,1805,3,1,3,0,1,0,69.81
高雄市,小港區,松山里,0,2,1105,10,1115,1621,3,1,3,0,1,0,68.78
高雄市,小港區,大坪里,0,2,706,7,713,976,3,1,3,0,1,0,73.05
高雄市,小港區,坪頂里,0,2,764,10,774,1130,3,1,3,0,1,0,68.50
高雄市,小港區,孔宅里,0,2,1927,27,1954,2936,3,1,3,0,1,0,66.55
高雄市,小港區,廈莊里,0,2,1110,13,1123,1662,3,1,3,0,1,0,67.57
高雄市,小港區,合作里,0,2,1450,32,1482,2100,3,1,3,0,1,0,70.57
高雄市,小港區,桂林里,0,2,3502,40,3542,5349,3,1,3,0,1,0,66.22
高雄市,小港區,中厝里,0,2,1707,29,1736,2648,3,1,3,0,1,0,65.56
高雄市,小港區,鳳鳴里,0,2,1550,22,1572,2129,3,1,3,0,1,0,73.84
高雄市,小港區,龍鳳里,0,2,1485,16,1501,2015,3,1,3,0,1,0,74.49
高雄市,小港區,鳳森里,0,2,1095,12,1107,1522,3,1,3,0,1,0,72.73
高雄市,小港區,鳳林里,0,2,1402,12,1414,2082,3,1,3,0,1,0,67.92
高雄市,小港區,鳳興里,0,2,1152,11,1163,1585,3,1,3,0,1,0,73.38
高雄市,小港區,鳳源里,0,2,1724,22,1746,2405,3,1,3,0,1,0,72.60
高雄市,小港區,海澄里,0,2,2736,33,2769,4527,3,1,3,0,1,0,61.17
高雄市,小港區,海昌里,0,2,1367,15,1382,2312,3,1,3,0,1,0,59.78
高雄市,小港區,海豐里,0,2,1490,16,1506,2462,3,1,3,0,1,0,61.17
高雄市,小港區,海原里,0,2,1653,40,1693,2809,3,1,3,0,1,0,60.27
高雄市,小港區,海城里,0,2,1700,22,1722,2897,3,1,3,0,1,0,59.44
臺北縣,板橋市,留侯里,0,1,771,7,778,1119,3,1,3,0,1,0,69.53
臺北縣,板橋市,流芳里,0,1,802,8,810,1249,3,1,3,0,1,0,64.85
臺北縣,板橋市,赤松里,0,1,457,4,461,654,3,1,3,0,1,0,70.49
臺北縣,板橋市,黃石里,0,1,709,11,720,1053,3,1,3,0,1,0,68.38
臺北縣,板橋市,挹秀里,0,1,957,5,962,1581,3,1,3,0,1,0,60.85
臺北縣,板橋市,湳興里,0,1,2560,39,2599,3739,3,1,3,0,1,0,69.51
臺北縣,板橋市,新興里,0,1,1684,27,1711,2524,3,1,3,0,1,0,67.79
臺北縣,板橋市,社後里,0,1,3166,42,3208,4605,3,1,3,0,1,0,69.66
臺北縣,板橋市,香社里,0,1,2280,32,2312,3380,3,1,3,0,1,0,68.40
臺北縣,板橋市,香雅里,0,1,1455,23,1478,2147,3,1,3,0,1,0,68.84
臺北縣,板橋市,中正里,0,1,2349,36,2385,3455,3,1,3,0,1,0,69.03
臺北縣,板橋市,自強里,0,1,3141,44,3185,4400,3,1,3,0,1,0,72.39
臺北縣,板橋市,自立里,0,1,1694,25,1719,2351,3,1,3,0,1,0,73.12
臺北縣,板橋市,光華里,0,1,1493,27,1520,2180,3,1,3,0,1,0,69.72
臺北縣,板橋市,光榮里,0,1,1474,30,1504,2088,3,1,3,0,1,0,72.03
臺北縣,板橋市,國光里,0,1,2434,30,2464,3270,3,1,3,0,1,0,75.35
臺北縣,板橋市,港尾里,0,1,1338,22,1360,1875,3,1,3,0,1,0,72.53
臺北縣,板橋市,新生里,0,1,2389,23,2412,3492,3,1,3,0,1,0,69.07
臺北縣,板橋市,金華里,0,1,2167,45,2212,3269,3,1,3,0,1,0,67.67
臺北縣,板橋市,港德里,0,1,2701,67,2768,4170,3,1,3,0,1,0,66.38
臺北縣,板橋市,民權里,0,1,1688,17,1705,2408,3,1,3,0,1,0,70.81
臺北縣,板橋市,民安里,0,1,1259,13,1272,1737,3,1,3,0,1,0,73.23
臺北縣,板橋市,建國里,0,1,2157,34,2191,3097,3,1,3,0,1,0,70.75
臺北縣,板橋市,漢生里,0,1,2595,24,2619,3635,3,1,3,0,1,0,72.05
臺北縣,板橋市,新民里,0,1,2348,34,2382,3480,3,1,3,0,1,0,68.45
臺北縣,板橋市,公舘里,0,1,2139,36,2175,3124,3,1,3,0,1,0,69.62
臺北縣,板橋市,幸福里,0,1,2146,37,2183,3267,3,1,3,0,1,0,66.82
臺北縣,板橋市,文德里,0,1,1529,24,1553,2317,3,1,3,0,1,0,67.03
臺北縣,板橋市,忠誠里,0,1,1649,17,1666,2248,3,1,3,0,1,0,74.11
臺北縣,板橋市,陽明里,0,1,1579,17,1596,2352,3,1,3,0,1,0,67.86
臺北縣,板橋市,百壽里,0,1,1393,24,1417,2008,3,1,3,0,1,0,70.57
臺北縣,板橋市,介壽里,0,1,1690,31,1721,2477,3,1,3,0,1,0,69.48
臺北縣,板橋市,新埔里,0,1,1368,18,1386,2008,3,1,3,0,1,0,69.02
臺北縣,板橋市,華江里,0,1,2573,51,2624,3734,3,1,3,0,1,0,70.27
臺北縣,板橋市,江翠里,0,1,2607,40,2647,3912,3,1,3,0,1,0,67.66
臺北縣,板橋市,純翠里,0,1,2611,34,2645,4006,3,1,3,0,1,0,66.03
臺北縣,板橋市,溪頭里,0,1,3022,37,3059,4635,3,1,3,0,1,0,66.00
臺北縣,板橋市,聯翠里,0,1,1904,29,1933,2827,3,1,3,0,1,0,68.38
臺北縣,板橋市,文化里,0,1,1643,23,1666,2448,3,1,3,0,1,0,68.06
臺北縣,板橋市,宏翠里,0,1,1726,36,1762,2517,3,1,3,0,1,0,70.00
臺北縣,板橋市,仁翠里,0,1,1746,31,1777,2619,3,1,3,0,1,0,67.85
臺北縣,板橋市,新翠里,0,1,3580,75,3655,5285,3,1,3,0,1,0,69.16
臺北縣,板橋市,朝陽里,0,1,1872,26,1898,2785,3,1,3,0,1,0,68.15
臺北縣,板橋市,吉翠里,0,1,2031,36,2067,2921,3,1,3,0,1,0,70.76
臺北縣,板橋市,德翠里,0,1,2611,35,2646,3836,3,1,3,0,1,0,68.98
臺北縣,板橋市,新海里,0,1,1831,26,1857,2774,3,1,3,0,1,0,66.94
臺北縣,板橋市,滿翠里,0,1,1801,25,1826,2654,3,1,3,0,1,0,68.80
臺北縣,板橋市,明翠里,0,1,2668,42,2710,4051,3,1,3,0,1,0,66.90
臺北縣,板橋市,松翠里,0,1,1855,28,1883,2934,3,1,3,0,1,0,64.18
臺北縣,板橋市,柏翠里,0,1,1894,24,1918,2750,3,1,3,0,1,0,69.75
臺北縣,板橋市,龍翠里,0,1,2183,34,2217,3254,3,1,3,0,1,0,68.13
臺北縣,板橋市,松柏里,0,1,1194,13,1207,1788,3,1,3,0,1,0,67.51
臺北縣,板橋市,華翠里,0,1,1824,27,1851,2643,3,1,3,0,1,0,70.03
臺北縣,板橋市,莒光里,0,1,1659,25,1684,2460,3,1,3,0,1,0,68.46
臺北縣,板橋市,忠翠里,0,1,4126,54,4180,5984,3,1,3,0,1,0,69.85
臺北縣,板橋市,嵐翠里,0,1,1441,28,1469,2184,3,1,3,0,1,0,67.26
臺北縣,板橋市,文聖里,0,1,1672,39,1711,2419,3,1,3,0,1,0,70.73
臺北縣,板橋市,文翠里,0,1,2307,41,2348,3355,3,1,3,0,1,0,69.99
臺北縣,板橋市,青翠里,0,1,1654,29,1683,2534,3,1,3,0,1,0,66.42
臺北縣,板橋市,懷翠里,0,1,2922,44,2966,4409,3,1,3,0,1,0,67.27
臺北縣,板橋市,福翠里,0,1,1004,26,1030,1498,3,1,3,0,1,0,68.76
臺北縣,板橋市,港嘴里,0,1,2900,48,2948,4305,3,1,3,0,1,0,68.48
臺北縣,板橋市,振興里,0,1,2407,28,2435,3351,3,1,3,0,1,0,72.66
臺北縣,板橋市,振義里,0,1,2286,31,2317,3324,3,1,3,0,1,0,69.71
臺北縣,板橋市,光復里,0,1,1686,22,1708,2464,3,1,3,0,1,0,69.32
臺北縣,板橋市,埔墘里,0,1,2710,68,2778,4024,3,1,3,0,1,0,69.04
臺北縣,板橋市,富貴里,0,1,1230,12,1242,1795,3,1,3,0,1,0,69.19
臺北縣,板橋市,長壽里,0,1,1643,31,1674,2299,3,1,3,0,1,0,72.81
臺北縣,板橋市,福壽里,0,1,1477,26,1503,2076,3,1,3,0,1,0,72.40
臺北縣,板橋市,居仁里,0,1,1652,33,1685,2372,3,1,3,0,1,0,71.04
臺北縣,板橋市,海山里,0,1,3268,74,3342,4715,3,1,3,0,1,0,70.88
臺北縣,板橋市,九如里,0,1,1566,23,1589,2294,3,1,3,0,1,0,69.27
臺北縣,板橋市,正泰里,0,1,1647,29,1676,2305,3,1,3,0,1,0,72.71
臺北縣,板橋市,玉光里,0,1,2603,46,2649,3902,3,1,3,0,1,0,67.89
臺北縣,板橋市,光仁里,0,1,1613,31,1644,2302,3,1,3,0,1,0,71.42
臺北縣,板橋市,埤墘里,0,1,1935,30,1965,2902,3,1,3,0,1,0,67.71
臺北縣,板橋市,莊敬里,0,1,1767,29,1796,2496,3,1,3,0,1,0,71.96
臺北縣,板橋市,永安里,0,1,1753,31,1784,2540,3,1,3,0,1,0,70.24
臺北縣,板橋市,雙玉里,0,1,1969,38,2007,2843,3,1,3,0,1,0,70.59
臺北縣,板橋市,廣新里,0,1,1874,34,1908,2869,3,1,3,0,1,0,66.50
臺北縣,板橋市,深丘里,0,1,2884,32,2916,4189,3,1,3,0,1,0,69.61
臺北縣,板橋市,香丘里,0,1,1906,48,1954,2810,3,1,3,0,1,0,69.54
臺北縣,板橋市,西安里,0,1,1456,30,1486,2083,3,1,3,0,1,0,71.34
臺北縣,板橋市,東丘里,0,1,2289,40,2329,3382,3,1,3,0,1,0,68.86
臺北縣,板橋市,民生里,0,1,1073,28,1101,1570,3,1,3,0,1,0,70.13
臺北縣,板橋市,長安里,0,1,1923,27,1950,2831,3,1,3,0,1,0,68.88
臺北縣,板橋市,東安里,0,1,1327,18,1345,2105,3,1,3,0,1,0,63.90
臺北縣,板橋市,福丘里,0,1,1090,12,1102,1593,3,1,3,0,1,0,69.18
臺北縣,板橋市,福祿里,0,1,1859,38,1897,2775,3,1,3,0,1,0,68.36
臺北縣,板橋市,民族里,0,1,2036,24,2060,2932,3,1,3,0,1,0,70.26
臺北縣,板橋市,國泰里,0,1,1628,26,1654,2358,3,1,3,0,1,0,70.14
臺北縣,板橋市,後埔里,0,1,1829,21,1850,2669,3,1,3,0,1,0,69.31
臺北縣,板橋市,福德里,0,1,2774,43,2817,3935,3,1,3,0,1,0,71.59
臺北縣,板橋市,景星里,0,1,1755,35,1790,2552,3,1,3,0,1,0,70.14
臺北縣,板橋市,福星里,0,1,1746,36,1782,2479,3,1,3,0,1,0,71.88
臺北縣,板橋市,鄉雲里,0,1,1832,29,1861,2536,3,1,3,0,1,0,73.38
臺北縣,板橋市,廣德里,0,1,3124,57,3181,4537,3,1,3,0,1,0,70.11
臺北縣,板橋市,大豐里,0,1,2535,37,2572,3708,3,1,3,0,1,0,69.36
臺北縣,板橋市,重慶里,0,1,3992,61,4053,5954,3,1,3,0,1,0,68.07
臺北縣,板橋市,仁愛里,0,1,1908,20,1928,2676,3,1,3,0,1,0,72.05
臺北縣,板橋市,和平里,0,1,555,12,567,874,3,1,3,0,1,0,64.87
臺北縣,板橋市,廣福里,0,1,1618,24,1642,2428,3,1,3,0,1,0,67.63
臺北縣,板橋市,五權里,0,1,2456,27,2483,3566,3,1,3,0,1,0,69.63
臺北縣,板橋市,華興里,0,1,2031,41,2072,3001,3,1,3,0,1,0,69.04
臺北縣,板橋市,華貴里,0,1,1594,32,1626,2240,3,1,3,0,1,0,72.59
臺北縣,板橋市,華福里,0,1,1185,21,1206,1705,3,1,3,0,1,0,70.73
臺北縣,板橋市,華德里,0,1,3258,57,3315,4935,3,1,3,0,1,0,67.17
臺北縣,板橋市,華東里,0,1,2952,37,2989,4211,3,1,3,0,1,0,70.98
臺北縣,板橋市,信義里,0,1,2233,36,2269,3274,3,1,3,0,1,0,69.30
臺北縣,板橋市,浮洲里,0,1,2061,34,2095,3476,3,1,3,0,1,0,60.27
臺北縣,板橋市,華中里,0,1,2717,43,2760,4024,3,1,3,0,1,0,68.59
臺北縣,板橋市,僑中里,0,1,1945,41,1986,2796,3,1,3,0,1,0,71.03
臺北縣,板橋市,大觀里,0,1,1821,24,1845,2583,3,1,3,0,1,0,71.43
臺北縣,板橋市,歡園里,0,1,697,11,708,975,3,1,3,0,1,0,72.62
臺北縣,板橋市,中山里,0,1,2560,38,2598,3907,3,1,3,0,1,0,66.50
臺北縣,板橋市,復興里,0,1,1326,75,1401,2116,3,1,3,0,1,0,66.21
臺北縣,板橋市,大安里,0,1,2264,50,2314,3369,3,1,3,0,1,0,68.69
臺北縣,板橋市,福安里,0,1,1439,31,1470,2181,3,1,3,0,1,0,67.40
臺北縣,板橋市,聚安里,0,1,2536,48,2584,3914,3,1,3,0,1,0,66.02
臺北縣,板橋市,龍安里,0,1,1568,35,1603,2380,3,1,3,0,1,0,67.35
臺北縣,板橋市,崑崙里,0,1,3428,55,3483,5315,3,1,3,0,1,0,65.53
臺北縣,板橋市,成和里,0,1,2004,40,2044,3112,3,1,3,0,1,0,65.68
臺北縣,板橋市,溪洲里,0,1,2701,42,2743,4139,3,1,3,0,1,0,66.27
臺北縣,板橋市,溪福里,0,1,4712,89,4801,7311,3,1,3,0,1,0,65.67
臺北縣,板橋市,溪北里,0,1,1708,25,1733,2523,3,1,3,0,1,0,68.69
臺北縣,板橋市,堂春里,0,1,1852,23,1875,2773,3,1,3,0,1,0,67.62
臺北縣,土城市,祖田里,0,1,877,12,889,1204,3,1,3,0,1,0,73.84
臺北縣,土城市,頂新里,0,1,872,20,892,1205,3,1,3,0,1,0,74.02
臺北縣,土城市,頂福里,0,1,1383,25,1408,2040,3,1,3,0,1,0,69.02
臺北縣,土城市,頂埔里,0,1,3099,58,3157,4660,3,1,3,0,1,0,67.75
臺北縣,土城市,沛陂里,0,1,1595,36,1631,2378,3,1,3,0,1,0,68.59
臺北縣,土城市,永寧里,0,1,3405,51,3456,5165,3,1,3,0,1,0,66.91
臺北縣,土城市,大安里,0,1,2275,34,2309,3430,3,1,3,0,1,0,67.32
臺北縣,土城市,員仁里,0,1,2547,50,2597,3928,3,1,3,0,1,0,66.12
臺北縣,土城市,埤塘里,0,1,1386,27,1413,2289,3,1,3,0,1,0,61.73
臺北縣,土城市,土城里,0,1,1067,16,1083,1620,3,1,3,0,1,0,66.85
臺北縣,土城市,長風里,0,1,957,16,973,1273,3,1,3,0,1,0,76.43
臺北縣,土城市,員信里,0,1,2111,23,2134,3051,3,1,3,0,1,0,69.94
臺北縣,土城市,員林里,0,1,2781,44,2825,4051,3,1,3,0,1,0,69.74
臺北縣,土城市,員福里,0,1,2801,45,2846,4008,3,1,3,0,1,0,71.01
臺北縣,土城市,日和里,0,1,2583,29,2612,3882,3,1,3,0,1,0,67.28
臺北縣,土城市,日新里,0,1,2484,39,2523,3595,3,1,3,0,1,0,70.18
臺北縣,土城市,裕生里,0,1,2797,48,2845,4241,3,1,3,0,1,0,67.08
臺北縣,土城市,貨饒里,0,1,2039,27,2066,2966,3,1,3,0,1,0,69.66
臺北縣,土城市,瑞興里,0,1,1828,25,1853,2561,3,1,3,0,1,0,72.35
臺北縣,土城市,復興里,0,1,2173,32,2205,3216,3,1,3,0,1,0,68.56
臺北縣,土城市,廣福里,0,1,2611,28,2639,3747,3,1,3,0,1,0,70.43
臺北縣,土城市,學成里,0,1,1667,29,1696,2374,3,1,3,0,1,0,71.44
臺北縣,土城市,埤林里,0,1,3760,38,3798,5487,3,1,3,0,1,0,69.22
臺北縣,土城市,廣興里,0,1,1563,26,1589,2395,3,1,3,0,1,0,66.35
臺北縣,土城市,樂利里,0,1,2567,44,2611,4027,3,1,3,0,1,0,64.84
臺北縣,土城市,學府里,0,1,1640,34,1674,2478,3,1,3,0,1,0,67.55
臺北縣,土城市,明德里,0,1,2041,32,2073,3040,3,1,3,0,1,0,68.19
臺北縣,土城市,學士里,0,1,2151,25,2176,3086,3,1,3,0,1,0,70.51
臺北縣,土城市,柑林里,0,1,1281,13,1294,1830,3,1,3,0,1,0,70.71
臺北縣,土城市,中正里,0,1,1407,21,1428,2100,3,1,3,0,1,0,68.00
臺北縣,土城市,青雲里,0,1,1444,22,1466,2057,3,1,3,0,1,0,71.27
臺北縣,土城市,清和里,0,1,3046,48,3094,4533,3,1,3,0,1,0,68.26
臺北縣,土城市,清化里,0,1,875,12,887,1269,3,1,3,0,1,0,69.90
臺北縣,土城市,清溪里,0,1,3444,66,3510,4985,3,1,3,0,1,0,70.41
臺北縣,土城市,青山里,0,1,1538,24,1562,2220,3,1,3,0,1,0,70.36
臺北縣,土城市,清水里,0,1,3511,42,3553,5204,3,1,3,0,1,0,68.27
臺北縣,土城市,永豐里,0,1,1510,28,1538,2222,3,1,3,0,1,0,69.22
臺北縣,土城市,永富里,0,1,2438,45,2483,3800,3,1,3,0,1,0,65.34
臺北縣,土城市,廷寮里,0,1,2138,27,2165,3188,3,1,3,0,1,0,67.91
臺北縣,土城市,金城里,0,1,2542,32,2574,3796,3,1,3,0,1,0,67.81
臺北縣,土城市,峰廷里,0,1,3391,45,3436,5217,3,1,3,0,1,0,65.86
臺北縣,土城市,延吉里,0,1,2127,38,2165,3137,3,1,3,0,1,0,69.01
臺北縣,土城市,延壽里,0,1,2153,29,2182,3200,3,1,3,0,1,0,68.19
臺北縣,土城市,延祿里,0,1,2050,20,2070,3031,3,1,3,0,1,0,68.29
臺北縣,土城市,平和里,0,1,3288,59,3347,4803,3,1,3,0,1,0,69.69
臺北縣,土城市,安和里,0,1,2452,34,2486,3633,3,1,3,0,1,0,68.43
臺北縣,土城市,延和里,0,1,2794,53,2847,4321,3,1,3,0,1,0,65.89
臺北縣,樹林鎮,保安里,0,1,2999,53,3052,4362,3,1,3,0,1,0,69.97
臺北縣,樹林鎮,圳福里,0,1,1922,39,1961,2919,3,1,3,0,1,0,67.18
臺北縣,樹林鎮,圳安里,0,1,1537,27,1564,2384,3,1,3,0,1,0,65.60
臺北縣,樹林鎮,圳民里,0,1,1197,10,1207,1864,3,1,3,0,1,0,64.75
臺北縣,樹林鎮,圳生里,0,1,789,12,801,1128,3,1,3,0,1,0,71.01
臺北縣,樹林鎮,三龍里,0,1,1002,20,1022,1466,3,1,3,0,1,0,69.71
臺北縣,樹林鎮,三多里,0,1,1786,47,1833,2708,3,1,3,0,1,0,67.69
臺北縣,樹林鎮,三福里,0,1,2107,32,2139,3161,3,1,3,0,1,0,67.67
臺北縣,樹林鎮,三興里,0,1,2216,31,2247,3547,3,1,3,0,1,0,63.35
臺北縣,樹林鎮,羌寮里,0,1,2110,31,2141,3239,3,1,3,0,1,0,66.10
臺北縣,樹林鎮,光興里,0,1,1591,31,1622,2528,3,1,3,0,1,0,64.16
臺北縣,樹林鎮,金寮里,0,1,1711,34,1745,2692,3,1,3,0,1,0,64.82
臺北縣,樹林鎮,潭底里,0,1,2131,31,2162,3260,3,1,3,0,1,0,66.32
臺北縣,樹林鎮,文林里,0,1,2096,38,2134,3276,3,1,3,0,1,0,65.14
臺北縣,樹林鎮,樹東里,0,1,716,10,726,993,3,1,3,0,1,0,73.11
臺北縣,樹林鎮,樹北里,0,1,755,11,766,1042,3,1,3,0,1,0,73.51
臺北縣,樹林鎮,樹福里,0,1,1345,29,1374,1892,3,1,3,0,1,0,72.62
臺北縣,樹林鎮,樹德里,0,1,1973,17,1990,2848,3,1,3,0,1,0,69.87
臺北縣,樹林鎮,樹西里,0,1,2686,37,2723,3807,3,1,3,0,1,0,71.53
臺北縣,樹林鎮,育英里,0,1,1521,34,1555,2150,3,1,3,0,1,0,72.33
臺北縣,樹林鎮,樹南里,0,1,2065,26,2091,3040,3,1,3,0,1,0,68.78
臺北縣,樹林鎮,樹人里,0,1,1692,32,1724,2444,3,1,3,0,1,0,70.54
臺北縣,樹林鎮,樹興里,0,1,1866,25,1891,2723,3,1,3,0,1,0,69.45
臺北縣,樹林鎮,坡內里,0,1,843,10,853,1197,3,1,3,0,1,0,71.26
臺北縣,樹林鎮,大同里,0,1,1484,24,1508,2165,3,1,3,0,1,0,69.65
臺北縣,樹林鎮,中華里,0,1,1292,15,1307,2070,3,1,3,0,1,0,63.14
臺北縣,樹林鎮,太順里,0,1,1166,16,1182,1854,3,1,3,0,1,0,63.75
臺北縣,樹林鎮,和平里,0,1,2038,40,2078,3041,3,1,3,0,1,0,68.33
臺北縣,樹林鎮,彭興里,0,1,2383,44,2427,3832,3,1,3,0,1,0,63.34
臺北縣,樹林鎮,彭厝里,0,1,2007,37,2044,3145,3,1,3,0,1,0,64.99
臺北縣,樹林鎮,彭福里,0,1,2190,28,2218,3318,3,1,3,0,1,0,66.85
臺北縣,樹林鎮,東昇里,0,1,1989,27,2016,2817,3,1,3,0,1,0,71.57
臺北縣,樹林鎮,東陽里,0,1,2719,42,2761,4036,3,1,3,0,1,0,68.41
臺北縣,樹林鎮,東山里,0,1,1649,22,1671,2460,3,1,3,0,1,0,67.93
臺北縣,樹林鎮,山佳里,0,1,1796,25,1821,2627,3,1,3,0,1,0,69.32
臺北縣,樹林鎮,中山里,0,1,1767,33,1800,2579,3,1,3,0,1,0,69.79
臺北縣,樹林鎮,樂山里,0,1,747,7,754,1176,3,1,3,0,1,0,64.12
臺北縣,樹林鎮,東園里,0,1,880,17,897,1260,3,1,3,0,1,0,71.19
臺北縣,樹林鎮,北園里,0,1,895,12,907,1297,3,1,3,0,1,0,69.93
臺北縣,樹林鎮,柑園里,0,1,860,7,867,1204,3,1,3,0,1,0,72.01
臺北縣,樹林鎮,南園里,0,1,467,7,474,639,3,1,3,0,1,0,74.18
臺北縣,樹林鎮,西園里,0,1,806,18,824,1201,3,1,3,0,1,0,68.61
臺北縣,鶯歌鎮,建德里,0,1,312,2,314,449,3,1,3,0,1,0,69.93
臺北縣,鶯歌鎮,東鶯里,0,1,670,5,675,899,3,1,3,0,1,0,75.08
臺北縣,鶯歌鎮,北鶯里,0,1,910,9,919,1240,3,1,3,0,1,0,74.11
臺北縣,鶯歌鎮,西鶯里,0,1,1289,13,1302,1822,3,1,3,0,1,0,71.46
臺北縣,鶯歌鎮,中鶯里,0,1,588,4,592,794,3,1,3,0,1,0,74.56
臺北縣,鶯歌鎮,南鶯里,0,1,2733,30,2763,3875,3,1,3,0,1,0,71.30
臺北縣,鶯歌鎮,建國里,0,1,2593,39,2632,3932,3,1,3,0,1,0,66.94
臺北縣,鶯歌鎮,南靖里,0,1,1804,22,1826,2589,3,1,3,0,1,0,70.53
臺北縣,鶯歌鎮,尖山里,0,1,2777,35,2812,3998,3,1,3,0,1,0,70.34
臺北縣,鶯歌鎮,二橋里,0,1,3330,43,3373,4750,3,1,3,0,1,0,71.01
臺北縣,鶯歌鎮,二甲里,0,1,531,9,540,745,3,1,3,0,1,0,72.48
臺北縣,鶯歌鎮,同慶里,0,1,889,7,896,1208,3,1,3,0,1,0,74.17
臺北縣,鶯歌鎮,永昌里,0,1,3913,57,3970,5874,3,1,3,0,1,0,67.59
臺北縣,鶯歌鎮,永吉里,0,1,2329,33,2362,3365,3,1,3,0,1,0,70.19
臺北縣,鶯歌鎮,鳳鳴里,0,1,2162,33,2195,3280,3,1,3,0,1,0,66.92
臺北縣,鶯歌鎮,鳳祥里,0,1,2088,27,2115,3244,3,1,3,0,1,0,65.20
臺北縣,鶯歌鎮,鳳福里,0,1,2128,34,2162,3212,3,1,3,0,1,0,67.31
臺北縣,鶯歌鎮,大湖里,0,1,2658,38,2696,3873,3,1,3,0,1,0,69.61
臺北縣,鶯歌鎮,中湖里,0,1,2772,38,2810,4120,3,1,3,0,1,0,68.20
臺北縣,鶯歌鎮,東湖里,0,1,168,2,170,230,3,1,3,0,1,0,73.91
臺北縣,三峽鎮,三峽里,0,1,235,4,239,322,3,1,3,0,1,0,74.22
臺北縣,三峽鎮,秀川里,0,1,316,3,319,410,3,1,3,0,1,0,77.80
臺北縣,三峽鎮,八張里,0,1,1743,32,1775,2465,3,1,3,0,1,0,72.01
臺北縣,三峽鎮,中埔里,0,1,933,15,948,1365,3,1,3,0,1,0,69.45
臺北縣,三峽鎮,弘道里,0,1,587,4,591,812,3,1,3,0,1,0,72.78
臺北縣,三峽鎮,永舘里,0,1,3092,26,3118,4519,3,1,3,0,1,0,69.00
臺北縣,三峽鎮,中正里,0,1,2230,19,2249,3280,3,1,3,0,1,0,68.57
臺北縣,三峽鎮,礁溪里,0,1,1974,26,2000,2930,3,1,3,0,1,0,68.26
臺北縣,三峽鎮,介壽里,0,1,2167,27,2194,3266,3,1,3,0,1,0,67.18
臺北縣,三峽鎮,安溪里,0,1,3323,49,3372,4847,3,1,3,0,1,0,69.57
臺北縣,三峽鎮,龍埔里,0,1,3252,52,3304,4914,3,1,3,0,1,0,67.24
臺北縣,三峽鎮,鳶山里,0,1,3594,45,3639,5359,3,1,3,0,1,0,67.90
臺北縣,三峽鎮,大埔里,0,1,2150,24,2174,3128,3,1,3,0,1,0,69.50
臺北縣,三峽鎮,二鬮里,0,1,1403,20,1423,2237,3,1,3,0,1,0,63.61
臺北縣,三峽鎮,嘉添里,0,1,1757,64,1821,2581,3,1,3,0,1,0,70.55
臺北縣,三峽鎮,添福里,0,1,662,12,674,944,3,1,3,0,1,0,71.40
臺北縣,三峽鎮,五寮里,0,1,602,7,609,891,3,1,3,0,1,0,68.35
臺北縣,三峽鎮,金圳里,0,1,298,7,305,458,3,1,3,0,1,0,66.59
臺北縣,三峽鎮,插角里,0,1,559,6,565,827,3,1,3,0,1,0,68.32
臺北縣,三峽鎮,有木里,0,1,566,6,572,799,3,1,3,0,1,0,71.59
臺北縣,三峽鎮,溪南里,0,1,847,11,858,1167,3,1,3,0,1,0,73.52
臺北縣,三峽鎮,溪北里,0,1,1262,29,1291,1785,3,1,3,0,1,0,72.32
臺北縣,三峽鎮,溪東里,0,1,1504,24,1528,2213,3,1,3,0,1,0,69.05
臺北縣,三峽鎮,成福里,0,1,640,5,645,822,3,1,3,0,1,0,78.47
臺北縣,三峽鎮,安坑里,0,1,815,17,832,1264,3,1,3,0,1,0,65.82
臺北縣,三峽鎮,竹崙里,0,1,1132,65,1197,1735,3,1,3,0,1,0,68.99
臺北縣,三重市,大有里,0,2,2298,35,2333,3357,3,1,3,0,1,0,69.50
臺北縣,三重市,博愛里,0,2,788,12,800,1166,3,1,3,0,1,0,68.61
臺北縣,三重市,中興里,0,2,920,21,941,1325,3,1,3,0,1,0,71.02
臺北縣,三重市,博愛里,0,2,572,8,580,919,3,1,3,0,1,0,63.11
臺北縣,三重市,二重里,0,2,1026,26,1052,1629,3,1,3,0,1,0,64.58
臺北縣,三重市,頂崁里,0,2,1343,22,1365,1989,3,1,3,0,1,0,68.63
臺北縣,三重市,谷王里,0,2,685,10,695,959,3,1,3,0,1,0,72.47
臺北縣,三重市,五谷里,0,2,1640,36,1676,2457,3,1,3,0,1,0,68.21
臺北縣,三重市,中興里,0,2,947,13,960,1370,3,1,3,0,1,0,70.07
臺北縣,三重市,德厚里,0,2,270,2,272,374,3,1,3,0,1,0,72.73
臺北縣,三重市,成功里,0,2,2350,34,2384,3555,3,1,3,0,1,0,67.06
臺北縣,三重市,福祉里,0,2,1919,28,1947,2803,3,1,3,0,1,0,69.46
臺北縣,三重市,福德里,0,2,1998,30,2028,3043,3,1,3,0,1,0,66.64
臺北縣,三重市,福民里,0,2,1734,27,1761,2586,3,1,3,0,1,0,68.10
臺北縣,三重市,過田里,0,2,2796,42,2838,4317,3,1,3,0,1,0,65.74
臺北縣,三重市,錦田里,0,2,1146,14,1160,1712,3,1,3,0,1,0,67.76
臺北縣,三重市,重明里,0,2,1549,17,1566,2221,3,1,3,0,1,0,70.51
臺北縣,三重市,光田里,0,2,2345,42,2387,3455,3,1,3,0,1,0,69.09
臺北縣,三重市,光陽里,0,2,3171,54,3225,4683,3,1,3,0,1,0,68.87
臺北縣,三重市,田心里,0,2,2216,50,2266,3373,3,1,3,0,1,0,67.18
臺北縣,三重市,福田里,0,2,1804,27,1831,2608,3,1,3,0,1,0,70.21
臺北縣,三重市,田中里,0,2,2946,48,2994,4444,3,1,3,0,1,0,67.37
臺北縣,三重市,田安里,0,2,3242,53,3295,4740,3,1,3,0,1,0,69.51
臺北縣,三重市,三民里,0,2,1689,19,1708,2415,3,1,3,0,1,0,70.72
臺北縣,三重市,光明里,0,2,3084,39,3123,4763,3,1,3,0,1,0,65.57
臺北縣,三重市,光正里,0,2,864,17,881,1374,3,1,3,0,1,0,64.12
臺北縣,三重市,同安里,0,2,888,18,906,1466,3,1,3,0,1,0,61.80
臺北縣,三重市,同慶里,0,2,940,16,956,1424,3,1,3,0,1,0,67.13
臺北縣,三重市,菜寮里,0,2,1134,17,1151,1642,3,1,3,0,1,0,70.10
臺北縣,三重市,永春里,0,2,920,18,938,1339,3,1,3,0,1,0,70.05
臺北縣,三重市,中正里,0,2,818,17,835,1174,3,1,3,0,1,0,71.12
臺北縣,三重市,吉利里,0,2,814,17,831,1221,3,1,3,0,1,0,68.06
臺北縣,三重市,大同里,0,2,984,9,993,1507,3,1,3,0,1,0,65.89
臺北縣,三重市,中民里,0,2,774,25,799,1164,3,1,3,0,1,0,68.64
臺北縣,三重市,平和里,0,2,930,21,951,1430,3,1,3,0,1,0,66.50
臺北縣,三重市,大安里,0,2,904,20,924,1393,3,1,3,0,1,0,66.33
臺北縣,三重市,仁德里,0,2,1256,25,1281,1876,3,1,3,0,1,0,68.28
臺北縣,三重市,忠孝里,0,2,999,12,1011,1581,3,1,3,0,1,0,63.95
臺北縣,三重市,仁義里,0,2,758,17,775,1132,3,1,3,0,1,0,68.46
臺北縣,三重市,光榮里,0,2,714,6,720,1081,3,1,3,0,1,0,66.60
臺北縣,三重市,光輝里,0,2,1062,17,1079,1548,3,1,3,0,1,0,69.70
臺北縣,三重市,福星里,0,2,580,8,588,833,3,1,3,0,1,0,70.59
臺北縣,三重市,福利里,0,2,957,13,970,1496,3,1,3,0,1,0,64.84
臺北縣,三重市,清和里,0,2,1558,15,1573,2354,3,1,3,0,1,0,66.82
臺北縣,三重市,永興里,0,2,700,9,709,1121,3,1,3,0,1,0,63.25
臺北縣,三重市,中山里,0,2,1380,13,1393,2067,3,1,3,0,1,0,67.39
臺北縣,三重市,大園里,0,2,1373,19,1392,2171,3,1,3,0,1,0,64.12
臺北縣,三重市,國隆里,0,2,1478,34,1512,2087,3,1,3,0,1,0,72.45
臺北縣,三重市,重陽里,0,2,1833,30,1863,2814,3,1,3,0,1,0,66.20
臺北縣,三重市,民生里,0,2,2421,31,2452,3578,3,1,3,0,1,0,68.53
臺北縣,三重市,重新里,0,2,944,20,964,1344,3,1,3,0,1,0,71.73
臺北縣,三重市,正德里,0,2,713,15,728,1025,3,1,3,0,1,0,71.02
臺北縣,三重市,正義里,0,2,1022,15,1037,1524,3,1,3,0,1,0,68.04
臺北縣,三重市,正安里,0,2,1065,27,1092,1544,3,1,3,0,1,0,70.73
臺北縣,三重市,自強里,0,2,1117,12,1129,1567,3,1,3,0,1,0,72.05
臺北縣,三重市,文化里,0,2,1417,23,1440,2100,3,1,3,0,1,0,68.57
臺北縣,三重市,中央里,0,2,1019,20,1039,1495,3,1,3,0,1,0,69.50
臺北縣,三重市,雙園里,0,2,580,7,587,882,3,1,3,0,1,0,66.55
臺北縣,三重市,錦通里,0,2,964,16,980,1459,3,1,3,0,1,0,67.17
臺北縣,三重市,錦安里,0,2,1157,36,1193,1696,3,1,3,0,1,0,70.34
臺北縣,三重市,長安里,0,2,1268,21,1289,1982,3,1,3,0,1,0,65.04
臺北縣,三重市,光華里,0,2,1026,22,1048,1596,3,1,3,0,1,0,65.66
臺北縣,三重市,長生里,0,2,499,5,504,742,3,1,3,0,1,0,67.92
臺北縣,三重市,開元里,0,2,900,10,910,1309,3,1,3,0,1,0,69.52
臺北縣,三重市,大德里,0,2,406,5,411,579,3,1,3,0,1,0,70.98
臺北縣,三重市,長元里,0,2,1406,43,1449,2150,3,1,3,0,1,0,67.40
臺北縣,三重市,長江里,0,2,1143,26,1169,1668,3,1,3,0,1,0,70.08
臺北縣,三重市,長泰里,0,2,1361,30,1391,2048,3,1,3,0,1,0,67.92
臺北縣,三重市,長福里,0,2,898,12,910,1408,3,1,3,0,1,0,64.63
臺北縣,三重市,介壽里,0,2,732,9,741,1060,3,1,3,0,1,0,69.91
臺北縣,三重市,萬壽里,0,2,1140,20,1160,1663,3,1,3,0,1,0,69.75
臺北縣,三重市,錦江里,0,2,1326,37,1363,2015,3,1,3,0,1,0,67.64
臺北縣,三重市,龍濱里,0,2,1701,42,1743,2527,3,1,3,0,1,0,68.98
臺北縣,三重市,龍門里,0,2,1070,14,1084,1610,3,1,3,0,1,0,67.33
臺北縣,三重市,秀江里,0,2,804,8,812,1166,3,1,3,0,1,0,69.64
臺北縣,三重市,奕壽里,0,2,904,13,917,1315,3,1,3,0,1,0,69.73
臺北縣,三重市,三安里,0,2,1485,25,1510,2236,3,1,3,0,1,0,67.53
臺北縣,三重市,福安里,0,2,1548,32,1580,2417,3,1,3,0,1,0,65.37
臺北縣,三重市,信安里,0,2,998,19,1017,1461,3,1,3,0,1,0,69.61
臺北縣,三重市,安慶里,0,2,1242,28,1270,1850,3,1,3,0,1,0,68.65
臺北縣,三重市,幸福里,0,2,2454,47,2501,3769,3,1,3,0,1,0,66.36
臺北縣,三重市,六合里,0,2,2131,36,2167,3142,3,1,3,0,1,0,68.97
臺北縣,三重市,六福里,0,2,2653,40,2693,3988,3,1,3,0,1,0,67.53
臺北縣,三重市,順德里,0,2,1260,20,1280,1878,3,1,3,0,1,0,68.16
臺北縣,三重市,承德里,0,2,1138,19,1157,1631,3,1,3,0,1,0,70.94
臺北縣,三重市,瑞德里,0,2,1453,25,1478,2079,3,1,3,0,1,0,71.09
臺北縣,三重市,崇德里,0,2,2254,36,2290,3395,3,1,3,0,1,0,67.45
臺北縣,三重市,厚德里,0,2,1803,20,1823,2491,3,1,3,0,1,0,73.18
臺北縣,三重市,維德里,0,2,1565,30,1595,2318,3,1,3,0,1,0,68.81
臺北縣,三重市,尚德里,0,2,1750,31,1781,2648,3,1,3,0,1,0,67.26
臺北縣,三重市,培德里,0,2,1814,15,1829,2701,3,1,3,0,1,0,67.72
臺北縣,三重市,立德里,0,2,1736,32,1768,2615,3,1,3,0,1,0,67.61
臺北縣,三重市,永德里,0,2,2668,49,2717,4014,3,1,3,0,1,0,67.69
臺北縣,三重市,永煇里,0,2,1419,20,1439,2066,3,1,3,0,1,0,69.65
臺北縣,三重市,永發里,0,2,2343,29,2372,3389,3,1,3,0,1,0,69.99
臺北縣,三重市,永盛里,0,2,1842,31,1873,2788,3,1,3,0,1,0,67.18
臺北縣,三重市,永吉里,0,2,1501,26,1527,2339,3,1,3,0,1,0,65.28
臺北縣,三重市,永安里,0,2,1699,25,1724,2593,3,1,3,0,1,0,66.49
臺北縣,三重市,永豐里,0,2,2400,36,2436,3581,3,1,3,0,1,0,68.03
臺北縣,三重市,永福里,0,2,2524,48,2572,3935,3,1,3,0,1,0,65.36
臺北縣,三重市,永清里,0,2,2668,43,2711,4156,3,1,3,0,1,0,65.23
臺北縣,三重市,永順里,0,2,2262,25,2287,3546,3,1,3,0,1,0,64.50
臺北縣,三重市,溪美里,0,2,3372,53,3425,5056,3,1,3,0,1,0,67.74
臺北縣,三重市,福隆里,0,2,1837,37,1874,2837,3,1,3,0,1,0,66.06
臺北縣,三重市,五常里,0,2,2131,42,2173,3165,3,1,3,0,1,0,68.66
臺北縣,三重市,五福里,0,2,1426,23,1449,2202,3,1,3,0,1,0,65.80
臺北縣,三重市,仁忠里,0,2,1648,28,1676,2644,3,1,3,0,1,0,63.39
臺北縣,三重市,慈福里,0,2,1266,28,1294,1969,3,1,3,0,1,0,65.72
臺北縣,三重市,慈生里,0,2,1316,24,1340,2000,3,1,3,0,1,0,67.00
臺北縣,三重市,慈惠里,0,2,1317,18,1335,1956,3,1,3,0,1,0,68.25
臺北縣,三重市,慈愛里,0,2,2118,25,2143,3113,3,1,3,0,1,0,68.84
臺北縣,三重市,慈化里,0,2,1353,33,1386,1994,3,1,3,0,1,0,69.51
臺北縣,三重市,慈祐里,0,2,2294,40,2334,3474,3,1,3,0,1,0,67.18
臺北縣,三重市,富華里,0,2,1382,18,1400,2155,3,1,3,0,1,0,64.97
臺北縣,三重市,富貴里,0,2,1632,30,1662,2547,3,1,3,0,1,0,65.25
臺北縣,三重市,富福里,0,2,1144,17,1161,1710,3,1,3,0,1,0,67.89
臺北縣,三重市,五華里,0,2,1834,38,1872,2723,3,1,3,0,1,0,68.75
臺北縣,三重市,碧華里,0,2,1302,20,1322,2017,3,1,3,0,1,0,65.54
臺北縣,三重市,福樂里,0,2,1925,32,1957,2874,3,1,3,0,1,0,68.09
臺北縣,三重市,仁華里,0,2,1941,32,1973,2968,3,1,3,0,1,0,66.48
臺北縣,三重市,五順里,0,2,1941,28,1969,3007,3,1,3,0,1,0,65.48
臺北縣,蘆洲市,光華里,0,2,2519,34,2553,3777,3,1,3,0,1,0,67.59
臺北縣,蘆洲市,光明里,0,2,1905,26,1931,3036,3,1,3,0,1,0,63.60
臺北縣,蘆洲市,中路里,0,2,1785,36,1821,2651,3,1,3,0,1,0,68.69
臺北縣,蘆洲市,中華里,0,2,1563,20,1583,2277,3,1,3,0,1,0,69.52
臺北縣,蘆洲市,九芎里,0,2,2005,32,2037,3376,3,1,3,0,1,0,60.34
臺北縣,蘆洲市,永安里,0,2,1783,35,1818,2687,3,1,3,0,1,0,67.66
臺北縣,蘆洲市,延平里,0,2,1556,26,1582,2350,3,1,3,0,1,0,67.32
臺北縣,蘆洲市,長安里,0,2,2004,41,2045,3273,3,1,3,0,1,0,62.48
臺北縣,蘆洲市,忠義里,0,2,1040,22,1062,1632,3,1,3,0,1,0,65.07
臺北縣,蘆洲市,中原里,0,2,1753,30,1783,2708,3,1,3,0,1,0,65.84
臺北縣,蘆洲市,永康里,0,2,2233,27,2260,3517,3,1,3,0,1,0,64.26
臺北縣,蘆洲市,永德里,0,2,1671,33,1704,2738,3,1,3,0,1,0,62.24
臺北縣,蘆洲市,成功里,0,2,2627,36,2663,4225,3,1,3,0,1,0,63.03
臺北縣,蘆洲市,永樂里,0,2,2350,31,2381,3665,3,1,3,0,1,0,64.97
臺北縣,蘆洲市,南港里,0,2,2240,29,2269,3454,3,1,3,0,1,0,65.69
臺北縣,蘆洲市,正義里,0,2,108,4,112,207,3,1,3,0,1,0,54.11
臺北縣,蘆洲市,樓厝里,0,2,2554,37,2591,3827,3,1,3,0,1,0,67.70
臺北縣,蘆洲市,信義里,0,2,1986,53,2039,2946,3,1,3,0,1,0,69.21
臺北縣,蘆洲市,玉清里,0,2,1974,30,2004,3051,3,1,3,0,1,0,65.68
臺北縣,蘆洲市,復興里,0,2,1568,21,1589,2482,3,1,3,0,1,0,64.02
臺北縣,蘆洲市,福安里,0,2,1492,20,1512,2202,3,1,3,0,1,0,68.66
臺北縣,蘆洲市,鷺江里,0,2,2332,32,2364,3613,3,1,3,0,1,0,65.43
臺北縣,蘆洲市,恆德里,0,2,2791,40,2831,4377,3,1,3,0,1,0,64.68
臺北縣,蘆洲市,溪墘里,0,2,1652,18,1670,2549,3,1,3,0,1,0,65.52
臺北縣,蘆洲市,樹德里,0,2,1655,21,1676,2467,3,1,3,0,1,0,67.94
臺北縣,蘆洲市,民和里,0,2,1631,21,1652,2349,3,1,3,0,1,0,70.33
臺北縣,蘆洲市,得仁里,0,2,1353,32,1385,2057,3,1,3,0,1,0,67.33
臺北縣,蘆洲市,得勝里,0,2,1847,28,1875,2713,3,1,3,0,1,0,69.11
臺北縣,蘆洲市,仁復里,0,2,1015,17,1032,1551,3,1,3,0,1,0,66.54
臺北縣,蘆洲市,仁德里,0,2,2336,33,2369,3684,3,1,3,0,1,0,64.31
臺北縣,蘆洲市,仁義里,0,2,1315,22,1337,2058,3,1,3,0,1,0,64.97
臺北縣,蘆洲市,保和里,0,2,1384,18,1402,2088,3,1,3,0,1,0,67.15
臺北縣,蘆洲市,水湳里,0,2,3328,45,3373,5270,3,1,3,0,1,0,64.00
臺北縣,蘆洲市,水河里,0,2,3308,42,3350,5288,3,1,3,0,1,0,63.35
臺北縣,蘆洲市,仁愛里,0,2,2356,26,2382,3656,3,1,3,0,1,0,65.15
臺北縣,蘆洲市,忠孝里,0,2,1025,17,1042,1621,3,1,3,0,1,0,64.28
臺北縣,蘆洲市,保佑里,0,2,1709,19,1728,2665,3,1,3,0,1,0,64.84
臺北縣,蘆洲市,保新里,0,2,1420,16,1436,2202,3,1,3,0,1,0,65.21
臺北縣,新莊市,全安里,0,2,2360,36,2396,3369,3,1,3,0,1,0,71.12
臺北縣,新莊市,海山里,0,2,2886,44,2930,4269,3,1,3,0,1,0,68.63
臺北縣,新莊市,豐年里,0,2,1876,38,1914,2863,3,1,3,0,1,0,66.85
臺北縣,新莊市,國泰里,0,2,996,11,1007,1405,3,1,3,0,1,0,71.67
臺北縣,新莊市,文聖里,0,2,2098,29,2127,3014,3,1,3,0,1,0,70.57
臺北縣,新莊市,文衡里,0,2,1185,9,1194,1627,3,1,3,0,1,0,73.39
臺北縣,新莊市,忠孝里,0,2,2396,42,2438,3616,3,1,3,0,1,0,67.42
臺北縣,新莊市,立言里,0,2,2525,41,2566,3775,3,1,3,0,1,0,67.97
臺北縣,新莊市,興漢里,0,2,2155,28,2183,3021,3,1,3,0,1,0,72.26
臺北縣,新莊市,榮和里,0,2,1724,28,1752,2840,3,1,3,0,1,0,61.69
臺北縣,新莊市,文德里,0,2,951,9,960,1344,3,1,3,0,1,0,71.43
臺北縣,新莊市,文明里,0,2,1101,15,1116,1558,3,1,3,0,1,0,71.63
臺北縣,新莊市,全泰里,0,2,2751,42,2793,3956,3,1,3,0,1,0,70.60
臺北縣,新莊市,頭前里,0,2,2089,42,2131,3147,3,1,3,0,1,0,67.72
臺北縣,新莊市,福基里,0,2,1367,23,1390,2023,3,1,3,0,1,0,68.71
臺北縣,新莊市,幸福里,0,2,2214,34,2248,3567,3,1,3,0,1,0,63.02
臺北縣,新莊市,昌平里,0,2,1661,23,1684,2624,3,1,3,0,1,0,64.18
臺北縣,新莊市,和平里,0,2,2331,35,2366,3599,3,1,3,0,1,0,65.74
臺北縣,新莊市,昌明里,0,2,1741,26,1767,2505,3,1,3,0,1,0,70.54
臺北縣,新莊市,昌信里,0,2,1136,14,1150,1735,3,1,3,0,1,0,66.28
臺北縣,新莊市,昌隆里,0,2,1537,22,1559,2376,3,1,3,0,1,0,65.61
臺北縣,新莊市,信義里,0,2,2350,33,2383,3720,3,1,3,0,1,0,64.06
臺北縣,新莊市,化成里,0,2,1423,24,1447,2088,3,1,3,0,1,0,69.30
臺北縣,新莊市,思賢里,0,2,1899,22,1921,2726,3,1,3,0,1,0,70.47
臺北縣,新莊市,自信里,0,2,1239,22,1261,1930,3,1,3,0,1,0,65.34
臺北縣,新莊市,仁義里,0,2,1794,33,1827,2754,3,1,3,0,1,0,66.34
臺北縣,新莊市,思源里,0,2,2667,42,2709,4069,3,1,3,0,1,0,66.58
臺北縣,新莊市,仁愛里,0,2,1550,26,1576,2376,3,1,3,0,1,0,66.33
臺北縣,新莊市,自強里,0,2,1596,24,1620,2429,3,1,3,0,1,0,66.69
臺北縣,新莊市,自立里,0,2,2519,41,2560,3835,3,1,3,0,1,0,66.75
臺北縣,新莊市,福興里,0,2,1747,23,1770,2729,3,1,3,0,1,0,64.86
臺北縣,新莊市,中信里,0,2,3167,49,3216,4824,3,1,3,0,1,0,66.67
臺北縣,新莊市,中平里,0,2,3137,57,3194,4782,3,1,3,0,1,0,66.79
臺北縣,新莊市,中港里,0,2,2830,29,2859,4377,3,1,3,0,1,0,65.32
臺北縣,新莊市,立人里,0,2,1179,19,1198,1662,3,1,3,0,1,0,72.08
臺北縣,新莊市,恆安里,0,2,2463,30,2493,3656,3,1,3,0,1,0,68.19
臺北縣,新莊市,立泰里,0,2,2265,37,2302,3470,3,1,3,0,1,0,66.34
臺北縣,新莊市,立功里,0,2,1960,27,1987,3084,3,1,3,0,1,0,64.43
臺北縣,新莊市,立德里,0,2,1471,18,1489,2122,3,1,3,0,1,0,70.17
臺北縣,新莊市,中原里,0,2,3330,48,3378,4989,3,1,3,0,1,0,67.71
臺北縣,新莊市,中隆里,0,2,1678,33,1711,2509,3,1,3,0,1,0,68.19
臺北縣,新莊市,中華里,0,2,924,12,936,1331,3,1,3,0,1,0,70.32
臺北縣,新莊市,中誠里,0,2,1169,23,1192,1734,3,1,3,0,1,0,68.74
臺北縣,新莊市,中美里,0,2,3019,48,3067,4549,3,1,3,0,1,0,67.42
臺北縣,新莊市,中和里,0,2,2418,41,2459,3673,3,1,3,0,1,0,66.95
臺北縣,新莊市,立廷里,0,2,1381,20,1401,2148,3,1,3,0,1,0,65.22
臺北縣,新莊市,立志里,0,2,1981,25,2006,3015,3,1,3,0,1,0,66.53
臺北縣,新莊市,中泰里,0,2,2528,41,2569,3837,3,1,3,0,1,0,66.95
臺北縣,新莊市,中宏里,0,2,1788,23,1811,2693,3,1,3,0,1,0,67.25
臺北縣,新莊市,立基里,0,2,2735,45,2780,4158,3,1,3,0,1,0,66.86
臺北縣,新莊市,中全里,0,2,1709,22,1731,2712,3,1,3,0,1,0,63.83
臺北縣,新莊市,營盤里,0,2,1371,18,1389,1956,3,1,3,0,1,0,71.01
臺北縣,新莊市,瓊林里,0,2,2917,55,2972,4411,3,1,3,0,1,0,67.38
臺北縣,新莊市,泰豐里,0,2,1279,24,1303,1916,3,1,3,0,1,0,68.01
臺北縣,新莊市,丹鳳里,0,2,3129,38,3167,4901,3,1,3,0,1,0,64.62
臺北縣,新莊市,合鳳里,0,2,2205,53,2258,3378,3,1,3,0,1,0,66.84
臺北縣,新莊市,祥鳳里,0,2,1084,11,1095,1641,3,1,3,0,1,0,66.73
臺北縣,新莊市,雙鳳里,0,2,2415,32,2447,3708,3,1,3,0,1,0,65.99
臺北縣,新莊市,龍鳳里,0,2,2542,29,2571,4006,3,1,3,0,1,0,64.18
臺北縣,新莊市,富國里,0,2,1267,14,1281,1918,3,1,3,0,1,0,66.79
臺北縣,新莊市,後德里,0,2,1306,14,1320,2041,3,1,3,0,1,0,64.67
臺北縣,新莊市,萬安里,0,2,1649,31,1680,2525,3,1,3,0,1,0,66.53
臺北縣,新莊市,富民里,0,2,1656,26,1682,2561,3,1,3,0,1,0,65.68
臺北縣,新莊市,福營里,0,2,1419,21,1440,1983,3,1,3,0,1,0,72.62
臺北縣,新莊市,龍福里,0,2,905,17,922,1389,3,1,3,0,1,0,66.38
臺北縣,新莊市,民有里,0,2,1613,32,1645,2502,3,1,3,0,1,0,65.75
臺北縣,新莊市,民本里,0,2,1508,15,1523,2370,3,1,3,0,1,0,64.26
臺北縣,新莊市,八德里,0,2,1486,23,1509,2330,3,1,3,0,1,0,64.76
臺北縣,新莊市,民全里,0,2,1499,25,1524,2226,3,1,3,0,1,0,68.46
臺北縣,新莊市,建安里,0,2,2558,37,2595,4101,3,1,3,0,1,0,63.28
臺北縣,新莊市,民安里,0,2,2257,45,2302,3518,3,1,3,0,1,0,65.43
臺北縣,新莊市,成德里,0,2,1900,30,1930,3142,3,1,3,0,1,0,61.43
臺北縣,新莊市,光明里,0,2,1671,34,1705,2737,3,1,3,0,1,0,62.29
臺北縣,新莊市,光華里,0,2,2507,52,2559,4257,3,1,3,0,1,0,60.11
臺北縣,新莊市,龍安里,0,2,1121,19,1140,1784,3,1,3,0,1,0,63.90
臺北縣,新莊市,裕民里,0,2,2950,51,3001,4654,3,1,3,0,1,0,64.48
臺北縣,新莊市,四維里,0,2,2234,42,2276,3560,3,1,3,0,1,0,63.93
臺北縣,新莊市,南港里,0,2,2282,32,2314,3609,3,1,3,0,1,0,64.12
臺北縣,新莊市,光榮里,0,2,1659,33,1692,2605,3,1,3,0,1,0,64.95
臺北縣,新莊市,光正里,0,2,1551,15,1566,2359,3,1,3,0,1,0,66.38
臺北縣,新莊市,光和里,0,2,1120,15,1135,1784,3,1,3,0,1,0,63.62
臺北縣,新莊市,建福里,0,2,1257,15,1272,1874,3,1,3,0,1,0,67.88
臺北縣,新莊市,後港里,0,2,3104,59,3163,4768,3,1,3,0,1,0,66.34
臺北縣,新莊市,西盛里,0,2,2583,44,2627,4063,3,1,3,0,1,0,64.66
臺北縣,五股鄉,興珍村,0,2,2446,39,2485,3665,3,1,3,0,1,0,67.80
臺北縣,五股鄉,更寮村,0,2,759,14,773,1108,3,1,3,0,1,0,69.77
臺北縣,五股鄉,集福村,0,2,1446,23,1469,2246,3,1,3,0,1,0,65.41
臺北縣,五股鄉,集賢村,0,2,1595,32,1627,2491,3,1,3,0,1,0,65.32
臺北縣,五股鄉,觀音村,0,2,844,9,853,1246,3,1,3,0,1,0,68.46
臺北縣,五股鄉,成德村,0,2,1386,35,1421,2159,3,1,3,0,1,0,65.82
臺北縣,五股鄉,成州村,0,2,2460,31,2491,3752,3,1,3,0,1,0,66.39
臺北縣,五股鄉,成功村,0,2,1796,36,1832,2907,3,1,3,0,1,0,63.02
臺北縣,五股鄉,成泰村,0,2,1489,28,1517,2256,3,1,3,0,1,0,67.24
臺北縣,五股鄉,五福村,0,2,1685,23,1708,2502,3,1,3,0,1,0,68.27
臺北縣,五股鄉,六福村,0,2,1498,28,1526,2211,3,1,3,0,1,0,69.02
臺北縣,五股鄉,五龍村,0,2,793,11,804,1158,3,1,3,0,1,0,69.43
臺北縣,五股鄉,五股村,0,2,1892,35,1927,2849,3,1,3,0,1,0,67.64
臺北縣,五股鄉,民義村,0,2,1476,15,1491,2132,3,1,3,0,1,0,69.93
臺北縣,五股鄉,德音村,0,2,2225,25,2250,3278,3,1,3,0,1,0,68.64
臺北縣,五股鄉,水碓村,0,2,3209,43,3252,4885,3,1,3,0,1,0,66.57
臺北縣,五股鄉,德泰村,0,2,2585,36,2621,3887,3,1,3,0,1,0,67.43
臺北縣,五股鄉,陸一村,0,2,1369,15,1384,1864,3,1,3,0,1,0,74.25
臺北縣,五股鄉,貿商村,0,2,389,7,396,545,3,1,3,0,1,0,72.66
臺北縣,泰山鄉,大科村,0,2,632,7,639,853,3,1,3,0,1,0,74.91
臺北縣,泰山鄉,黎明村,0,2,1544,33,1577,2152,3,1,3,0,1,0,73.28
臺北縣,泰山鄉,山腳村,0,2,2994,41,3035,4482,3,1,3,0,1,0,67.72
臺北縣,泰山鄉,福泰村,0,2,2660,59,2719,3890,3,1,3,0,1,0,69.90
臺北縣,泰山鄉,楓樹村,0,2,1733,31,1764,2507,3,1,3,0,1,0,70.36
臺北縣,泰山鄉,同榮村,0,2,1875,25,1900,2709,3,1,3,0,1,0,70.14
臺北縣,泰山鄉,同興村,0,2,1417,14,1431,1887,3,1,3,0,1,0,75.83
臺北縣,泰山鄉,義學村,0,2,2064,30,2094,3009,3,1,3,0,1,0,69.59
臺北縣,泰山鄉,義仁村,0,2,2634,54,2688,3945,3,1,3,0,1,0,68.14
臺北縣,泰山鄉,明志村,0,2,1943,26,1969,2809,3,1,3,0,1,0,70.10
臺北縣,泰山鄉,泰友村,0,2,1197,15,1212,1773,3,1,3,0,1,0,68.36
臺北縣,泰山鄉,新明村,0,2,1815,36,1851,2616,3,1,3,0,1,0,70.76
臺北縣,泰山鄉,貴子村,0,2,1947,27,1974,2885,3,1,3,0,1,0,68.42
臺北縣,泰山鄉,貴賢村,0,2,1971,33,2004,2743,3,1,3,0,1,0,73.06
臺北縣,泰山鄉,貴和村,0,2,2517,31,2548,3835,3,1,3,0,1,0,66.44
臺北縣,林口鄉,東林村,0,2,2278,28,2306,3373,3,1,3,0,1,0,68.37
臺北縣,林口鄉,林口村,0,2,2241,38,2279,3452,3,1,3,0,1,0,66.02
臺北縣,林口鄉,西林村,0,2,2171,34,2205,3144,3,1,3,0,1,0,70.13
臺北縣,林口鄉,菁湖村,0,2,2148,31,2179,3106,3,1,3,0,1,0,70.15
臺北縣,林口鄉,中湖村,0,2,1612,23,1635,2291,3,1,3,0,1,0,71.37
臺北縣,林口鄉,湖北村,0,2,806,17,823,1057,3,1,3,0,1,0,77.86
臺北縣,林口鄉,湖南村,0,2,851,10,861,1227,3,1,3,0,1,0,70.17
臺北縣,林口鄉,南勢村,0,2,4449,56,4505,6790,3,1,3,0,1,0,66.35
臺北縣,林口鄉,東勢村,0,2,4001,52,4053,6060,3,1,3,0,1,0,66.88
臺北縣,林口鄉,頂福村,0,2,605,13,618,943,3,1,3,0,1,0,65.54
臺北縣,林口鄉,下福村,0,2,626,16,642,897,3,1,3,0,1,0,71.57
臺北縣,林口鄉,嘉寶村,0,2,475,8,483,644,3,1,3,0,1,0,75.00
臺北縣,林口鄉,瑞平村,0,2,280,4,284,428,3,1,3,0,1,0,66.36
臺北縣,林口鄉,太平村,0,2,518,6,524,750,3,1,3,0,1,0,69.87
臺北縣,淡水鎮,中和里,0,2,426,4,430,571,3,1,3,0,1,0,75.31
臺北縣,淡水鎮,屯山里,0,2,677,16,693,968,3,1,3,0,1,0,71.59
臺北縣,淡水鎮,賢孝里,0,2,859,19,878,1288,3,1,3,0,1,0,68.17
臺北縣,淡水鎮,興仁里,0,2,916,9,925,1368,3,1,3,0,1,0,67.62
臺北縣,淡水鎮,蕃薯里,0,2,459,1,460,760,3,1,3,0,1,0,60.53
臺北縣,淡水鎮,義山里,0,2,1309,21,1330,2140,3,1,3,0,1,0,62.15
臺北縣,淡水鎮,忠山里,0,2,539,13,552,788,3,1,3,0,1,0,70.05
臺北縣,淡水鎮,水源里,0,2,1158,28,1186,1781,3,1,3,0,1,0,66.59
臺北縣,淡水鎮,忠寮里,0,2,662,15,677,966,3,1,3,0,1,0,70.08
臺北縣,淡水鎮,樹興里,0,2,487,16,503,742,3,1,3,0,1,0,67.79
臺北縣,淡水鎮,坪頂里,0,2,608,13,621,976,3,1,3,0,1,0,63.63
臺北縣,淡水鎮,福德里,0,2,3006,33,3039,4684,3,1,3,0,1,0,64.88
臺北縣,淡水鎮,竹圍里,0,2,3997,60,4057,6294,3,1,3,0,1,0,64.46
臺北縣,淡水鎮,民生里,0,2,2576,54,2630,4013,3,1,3,0,1,0,65.54
臺北縣,淡水鎮,八勢里,0,2,866,13,879,1330,3,1,3,0,1,0,66.09
臺北縣,淡水鎮,竿蓁里,0,2,1611,27,1638,2646,3,1,3,0,1,0,61.90
臺北縣,淡水鎮,崁頂里,0,2,628,6,634,923,3,1,3,0,1,0,68.69
臺北縣,淡水鎮,埤島里,0,2,725,12,737,1067,3,1,3,0,1,0,69.07
臺北縣,淡水鎮,新興里,0,2,7868,138,8006,12482,3,1,3,0,1,0,64.14
臺北縣,淡水鎮,水碓里,0,2,5293,99,5392,8275,3,1,3,0,1,0,65.16
臺北縣,淡水鎮,北投里,0,2,1048,21,1069,1578,3,1,3,0,1,0,67.74
臺北縣,淡水鎮,鄧公里,0,2,5964,126,6090,9359,3,1,3,0,1,0,65.07
臺北縣,淡水鎮,中興里,0,2,2424,47,2471,3557,3,1,3,0,1,0,69.47
臺北縣,淡水鎮,長庚里,0,2,1015,19,1034,1543,3,1,3,0,1,0,67.01
臺北縣,淡水鎮,清文里,0,2,685,14,699,1017,3,1,3,0,1,0,68.73
臺北縣,淡水鎮,草東里,0,2,604,8,612,846,3,1,3,0,1,0,72.34
臺北縣,淡水鎮,協元里,0,2,861,10,871,1350,3,1,3,0,1,0,64.52
臺北縣,淡水鎮,永吉里,0,2,504,14,518,723,3,1,3,0,1,0,71.65
臺北縣,淡水鎮,民安里,0,2,511,5,516,727,3,1,3,0,1,0,70.98
臺北縣,淡水鎮,新生里,0,2,317,3,320,476,3,1,3,0,1,0,67.23
臺北縣,淡水鎮,文化里,0,2,835,9,844,1281,3,1,3,0,1,0,65.89
臺北縣,淡水鎮,油車里,0,2,2271,48,2319,3417,3,1,3,0,1,0,67.87
臺北縣,淡水鎮,沙崙里,0,2,2875,57,2932,4442,3,1,3,0,1,0,66.01
臺北縣,八里鄉,龍源村,0,2,2639,51,2690,3947,3,1,3,0,1,0,68.15
臺北縣,八里鄉,米倉村,0,2,1431,23,1454,2170,3,1,3,0,1,0,67.00
臺北縣,八里鄉,大崁村,0,2,992,21,1013,1374,3,1,3,0,1,0,73.73
臺北縣,八里鄉,埤頭村,0,2,1430,28,1458,2197,3,1,3,0,1,0,66.36
臺北縣,八里鄉,頂罟村,0,2,708,18,726,1034,3,1,3,0,1,0,70.21
臺北縣,八里鄉,舊城村,0,2,2387,37,2424,3817,3,1,3,0,1,0,63.51
臺北縣,八里鄉,訊塘村,0,2,1576,31,1607,2334,3,1,3,0,1,0,68.85
臺北縣,八里鄉,荖阡村,0,2,852,13,865,1222,3,1,3,0,1,0,70.79
臺北縣,八里鄉,下罟村,0,2,777,11,788,997,3,1,3,0,1,0,79.04
臺北縣,八里鄉,長坑村,0,2,814,15,829,1059,3,1,3,0,1,0,78.28
臺北縣,三芝鄉,八賢村,0,2,270,6,276,369,3,1,3,0,1,0,74.80
臺北縣,三芝鄉,埔頭村,0,2,2310,43,2353,3440,3,1,3,0,1,0,68.40
臺北縣,三芝鄉,古庄村,0,2,603,10,613,882,3,1,3,0,1,0,69.50
臺北縣,三芝鄉,新庄村,0,2,521,12,533,804,3,1,3,0,1,0,66.29
臺北縣,三芝鄉,埔坪村,0,2,2936,43,2979,4672,3,1,3,0,1,0,63.76
臺北縣,三芝鄉,茂長村,0,2,288,4,292,428,3,1,3,0,1,0,68.22
臺北縣,三芝鄉,橫山村,0,2,370,8,378,552,3,1,3,0,1,0,68.48
臺北縣,三芝鄉,錫板村,0,2,506,7,513,760,3,1,3,0,1,0,67.50
臺北縣,三芝鄉,後厝村,0,2,908,16,924,1463,3,1,3,0,1,0,63.16
臺北縣,三芝鄉,福德村,0,2,424,10,434,627,3,1,3,0,1,0,69.22
臺北縣,三芝鄉,圓山村,0,2,308,7,315,492,3,1,3,0,1,0,64.02
臺北縣,三芝鄉,店子村,0,2,443,6,449,628,3,1,3,0,1,0,71.50
臺北縣,三芝鄉,興華村,0,2,688,9,697,1108,3,1,3,0,1,0,62.91
臺北縣,石門鄉,德茂村,0,2,574,6,580,836,3,1,3,0,1,0,69.38
臺北縣,石門鄉,富基村,0,2,719,7,726,1021,3,1,3,0,1,0,71.11
臺北縣,石門鄉,老梅村,0,2,1123,16,1139,1717,3,1,3,0,1,0,66.34
臺北縣,石門鄉,山溪村,0,2,479,5,484,700,3,1,3,0,1,0,69.14
臺北縣,石門鄉,石門村,0,2,780,5,785,1162,3,1,3,0,1,0,67.56
臺北縣,石門鄉,尖鹿村,0,2,780,10,790,1206,3,1,3,0,1,0,65.51
臺北縣,石門鄉,乾華村,0,2,206,0,206,324,3,1,3,0,1,0,63.58
臺北縣,石門鄉,茂林村,0,2,331,4,335,489,3,1,3,0,1,0,68.51
臺北縣,石門鄉,草里村,0,2,458,1,459,727,3,1,3,0,1,0,63.14
臺北縣,金山鄉,和平村,0,2,287,6,293,418,3,1,3,0,1,0,70.10
臺北縣,金山鄉,大同村,0,2,432,6,438,626,3,1,3,0,1,0,69.97
臺北縣,金山鄉,豐漁村,0,2,315,4,319,459,3,1,3,0,1,0,69.50
臺北縣,金山鄉,磺港村,0,2,917,18,935,1525,3,1,3,0,1,0,61.31
臺北縣,金山鄉,美田村,0,2,4110,41,4151,6356,3,1,3,0,1,0,65.31
臺北縣,金山鄉,五湖村,0,2,957,17,974,1426,3,1,3,0,1,0,68.30
臺北縣,金山鄉,重和村,0,2,569,4,573,882,3,1,3,0,1,0,64.97
臺北縣,金山鄉,兩湖村,0,2,243,6,249,385,3,1,3,0,1,0,64.68
臺北縣,金山鄉,六股村,0,2,377,1,378,533,3,1,3,0,1,0,70.92
臺北縣,金山鄉,三界村,0,2,398,13,411,587,3,1,3,0,1,0,70.02
臺北縣,金山鄉,清泉村,0,2,501,6,507,798,3,1,3,0,1,0,63.53
臺北縣,金山鄉,西湖村,0,2,162,0,162,234,3,1,3,0,1,0,69.23
臺北縣,金山鄉,萬壽村,0,2,310,4,314,451,3,1,3,0,1,0,69.62
臺北縣,金山鄉,永興村,0,2,308,3,311,553,3,1,3,0,1,0,56.24
臺北縣,萬里鄉,萬里村,0,2,2002,28,2030,2966,3,1,3,0,1,0,68.44
臺北縣,萬里鄉,北基村,0,2,1098,26,1124,1915,3,1,3,0,1,0,58.69
臺北縣,萬里鄉,龜吼村,0,2,915,31,946,1609,3,1,3,0,1,0,58.79
臺北縣,萬里鄉,野柳村,0,2,1377,19,1396,2246,3,1,3,0,1,0,62.15
臺北縣,萬里鄉,大鵬村,0,2,1392,18,1410,2120,3,1,3,0,1,0,66.51
臺北縣,萬里鄉,磺潭村,0,2,313,1,314,465,3,1,3,0,1,0,67.53
臺北縣,萬里鄉,雙興村,0,2,488,8,496,774,3,1,3,0,1,0,64.08
臺北縣,萬里鄉,溪底村,0,2,335,6,341,527,3,1,3,0,1,0,64.71
臺北縣,萬里鄉,崁腳村,0,2,365,7,372,560,3,1,3,0,1,0,66.43
臺北縣,萬里鄉,中幅村,0,2,517,4,521,782,3,1,3,0,1,0,66.62
臺北縣,中和市,中原里,0,3,2403,50,2453,3718,3,1,3,0,1,0,65.98
臺北縣,中和市,連和里,0,3,859,11,870,1206,3,1,3,0,1,0,72.14
臺北縣,中和市,連城里,0,3,3281,36,3317,4674,3,1,3,0,1,0,70.97
臺北縣,中和市,力行里,0,3,2572,48,2620,3668,3,1,3,0,1,0,71.43
臺北縣,中和市,正行里,0,3,1442,21,1463,2125,3,1,3,0,1,0,68.85
臺北縣,中和市,德行里,0,3,2431,28,2459,3482,3,1,3,0,1,0,70.62
臺北縣,中和市,枋寮里,0,3,1893,25,1918,2786,3,1,3,0,1,0,68.84
臺北縣,中和市,漳和里,0,3,1917,29,1946,2916,3,1,3,0,1,0,66.74
臺北縣,中和市,廟美里,0,3,2555,30,2585,3724,3,1,3,0,1,0,69.41
臺北縣,中和市,福真里,0,3,2250,37,2287,3333,3,1,3,0,1,0,68.62
臺北縣,中和市,福善里,0,3,2375,54,2429,3402,3,1,3,0,1,0,71.40
臺北縣,中和市,福美里,0,3,2722,33,2755,3777,3,1,3,0,1,0,72.94
臺北縣,中和市,福祥里,0,3,2561,24,2585,3675,3,1,3,0,1,0,70.34
臺北縣,中和市,瓦窯里,0,3,2551,40,2591,3767,3,1,3,0,1,0,68.78
臺北縣,中和市,福和里,0,3,2189,27,2216,3169,3,1,3,0,1,0,69.93
臺北縣,中和市,佳和里,0,3,2783,32,2815,3963,3,1,3,0,1,0,71.03
臺北縣,中和市,新南里,0,3,3958,46,4004,5725,3,1,3,0,1,0,69.94
臺北縣,中和市,南山里,0,3,2376,21,2397,3391,3,1,3,0,1,0,70.69
臺北縣,中和市,平河里,0,3,3536,42,3578,5374,3,1,3,0,1,0,66.58
臺北縣,中和市,信和里,0,3,2402,33,2435,3556,3,1,3,0,1,0,68.48
臺北縣,中和市,仁和里,0,3,2373,44,2417,3438,3,1,3,0,1,0,70.30
臺北縣,中和市,中正里,0,3,2224,55,2279,3275,3,1,3,0,1,0,69.59
臺北縣,中和市,中山里,0,3,1312,27,1339,1871,3,1,3,0,1,0,71.57
臺北縣,中和市,建和里,0,3,2341,27,2368,3234,3,1,3,0,1,0,73.22
臺北縣,中和市,碧河里,0,3,1654,23,1677,2459,3,1,3,0,1,0,68.20
臺北縣,中和市,宜安里,0,3,1194,11,1205,1615,3,1,3,0,1,0,74.61
臺北縣,中和市,安樂里,0,3,2111,29,2140,2899,3,1,3,0,1,0,73.82
臺北縣,中和市,安和里,0,3,1794,27,1821,2469,3,1,3,0,1,0,73.75
臺北縣,中和市,安順里,0,3,2425,24,2449,3429,3,1,3,0,1,0,71.42
臺北縣,中和市,安平里,0,3,2869,36,2905,4004,3,1,3,0,1,0,72.55
臺北縣,中和市,中安里,0,3,2459,25,2484,3389,3,1,3,0,1,0,73.30
臺北縣,中和市,泰安里,0,3,2302,28,2330,3314,3,1,3,0,1,0,70.31
臺北縣,中和市,秀山里,0,3,2417,40,2457,3534,3,1,3,0,1,0,69.52
臺北縣,中和市,秀成里,0,3,1972,24,1996,2830,3,1,3,0,1,0,70.53
臺北縣,中和市,秀義里,0,3,1558,26,1584,2236,3,1,3,0,1,0,70.84
臺北縣,中和市,秀福里,0,3,2849,29,2878,3936,3,1,3,0,1,0,73.12
臺北縣,中和市,秀景里,0,3,3477,41,3518,4993,3,1,3,0,1,0,70.46
臺北縣,中和市,秀明里,0,3,2505,23,2528,3644,3,1,3,0,1,0,69.37
臺北縣,中和市,秀峰里,0,3,2255,24,2279,3224,3,1,3,0,1,0,70.69
臺北縣,中和市,秀士里,0,3,1520,18,1538,2203,3,1,3,0,1,0,69.81
臺北縣,中和市,秀水里,0,3,2327,36,2363,3373,3,1,3,0,1,0,70.06
臺北縣,中和市,秀仁里,0,3,1604,23,1627,2313,3,1,3,0,1,0,70.34
臺北縣,中和市,正南里,0,3,2108,49,2157,3137,3,1,3,0,1,0,68.76
臺北縣,中和市,頂南里,0,3,1770,20,1790,2488,3,1,3,0,1,0,71.95
臺北縣,中和市,華新里,0,3,3205,38,3243,4886,3,1,3,0,1,0,66.37
臺北縣,中和市,東南里,0,3,2822,46,2868,3911,3,1,3,0,1,0,73.33
臺北縣,中和市,華南里,0,3,2184,38,2222,3136,3,1,3,0,1,0,70.85
臺北縣,中和市,忠孝里,0,3,2891,49,2940,4330,3,1,3,0,1,0,67.90
臺北縣,中和市,崇南里,0,3,2145,25,2170,3031,3,1,3,0,1,0,71.59
臺北縣,中和市,興南里,0,3,2036,38,2074,2938,3,1,3,0,1,0,70.59
臺北縣,中和市,景南里,0,3,1923,32,1955,2705,3,1,3,0,1,0,72.27
臺北縣,中和市,景本里,0,3,1340,31,1371,1930,3,1,3,0,1,0,71.04
臺北縣,中和市,橫路里,0,3,225,5,230,303,3,1,3,0,1,0,75.91
臺北縣,中和市,內南里,0,3,2917,48,2965,4158,3,1,3,0,1,0,71.31
臺北縣,中和市,壽南里,0,3,1594,23,1617,2253,3,1,3,0,1,0,71.77
臺北縣,中和市,福南里,0,3,2122,37,2159,3154,3,1,3,0,1,0,68.45
臺北縣,中和市,外南里,0,3,2198,19,2217,3157,3,1,3,0,1,0,70.22
臺北縣,中和市,中興里,0,3,2673,32,2705,3754,3,1,3,0,1,0,72.06
臺北縣,中和市,吉興里,0,3,1373,20,1393,1986,3,1,3,0,1,0,70.14
臺北縣,中和市,復興里,0,3,3136,43,3179,4566,3,1,3,0,1,0,69.62
臺北縣,中和市,和興里,0,3,2243,36,2279,3285,3,1,3,0,1,0,69.38
臺北縣,中和市,景平里,0,3,2363,39,2402,3493,3,1,3,0,1,0,68.77
臺北縣,中和市,景新里,0,3,2100,32,2132,3018,3,1,3,0,1,0,70.64
臺北縣,中和市,景福里,0,3,2866,42,2908,4245,3,1,3,0,1,0,68.50
臺北縣,中和市,景安里,0,3,2962,31,2993,4119,3,1,3,0,1,0,72.66
臺北縣,中和市,景文里,0,3,1803,27,1830,2529,3,1,3,0,1,0,72.36
臺北縣,中和市,錦和里,0,3,2256,27,2283,3231,3,1,3,0,1,0,70.66
臺北縣,中和市,錦中里,0,3,1984,29,2013,2882,3,1,3,0,1,0,69.85
臺北縣,中和市,錦昌里,0,3,965,9,974,1393,3,1,3,0,1,0,69.92
臺北縣,中和市,錦盛里,0,3,2062,39,2101,2982,3,1,3,0,1,0,70.46
臺北縣,中和市,灰窯里,0,3,325,5,330,500,3,1,3,0,1,0,66.00
臺北縣,中和市,積穗里,0,3,3005,50,3055,4354,3,1,3,0,1,0,70.17
臺北縣,中和市,民享里,0,3,1581,28,1609,2141,3,1,3,0,1,0,75.15
臺北縣,中和市,民有里,0,3,1744,35,1779,2565,3,1,3,0,1,0,69.36
臺北縣,中和市,員山里,0,3,2309,49,2358,3471,3,1,3,0,1,0,67.93
臺北縣,中和市,員富里,0,3,1268,24,1292,2128,3,1,3,0,1,0,60.71
臺北縣,中和市,嘉穗里,0,3,1485,23,1508,2149,3,1,3,0,1,0,70.17
臺北縣,中和市,嘉慶里,0,3,1930,32,1962,3048,3,1,3,0,1,0,64.37
臺北縣,中和市,文元里,0,3,3007,40,3047,4412,3,1,3,0,1,0,69.06
臺北縣,中和市,嘉新里,0,3,2018,34,2052,3022,3,1,3,0,1,0,67.90
臺北縣,中和市,民安里,0,3,2469,34,2503,3634,3,1,3,0,1,0,68.88
臺北縣,中和市,安穗里,0,3,1967,35,2002,2946,3,1,3,0,1,0,67.96
臺北縣,中和市,瑞穗里,0,3,1302,17,1319,1830,3,1,3,0,1,0,72.08
臺北縣,中和市,冠穗里,0,3,1975,28,2003,2838,3,1,3,0,1,0,70.58
臺北縣,中和市,明穗里,0,3,2311,31,2342,3254,3,1,3,0,1,0,71.97
臺北縣,中和市,清穗里,0,3,1873,45,1918,2736,3,1,3,0,1,0,70.10
臺北縣,中和市,自強里,0,3,2550,32,2582,3854,3,1,3,0,1,0,67.00
臺北縣,中和市,德穗里,0,3,2589,24,2613,3836,3,1,3,0,1,0,68.12
臺北縣,中和市,民生里,0,3,2315,39,2354,3353,3,1,3,0,1,0,70.21
臺北縣,中和市,國光里,0,3,2041,28,2069,3014,3,1,3,0,1,0,68.65
臺北縣,中和市,國華里,0,3,1613,44,1657,2496,3,1,3,0,1,0,66.39
臺北縣,中和市,壽德里,0,3,1495,22,1517,2091,3,1,3,0,1,0,72.55
臺北縣,中和市,明德里,0,3,2199,39,2238,3259,3,1,3,0,1,0,68.67
臺北縣,永和市,光復里,0,3,1064,20,1084,1533,3,1,3,0,1,0,70.71
臺北縣,永和市,網溪里,0,3,705,9,714,1053,3,1,3,0,1,0,67.81
臺北縣,永和市,復興里,0,3,1470,20,1490,2184,3,1,3,0,1,0,68.22
臺北縣,永和市,竹林里,0,3,2330,27,2357,3390,3,1,3,0,1,0,69.53
臺北縣,永和市,桂林里,0,3,2151,42,2193,3161,3,1,3,0,1,0,69.38
臺北縣,永和市,上林里,0,3,2214,17,2231,3116,3,1,3,0,1,0,71.60
臺北縣,永和市,福林里,0,3,2075,26,2101,3105,3,1,3,0,1,0,67.67
臺北縣,永和市,勵行里,0,3,773,17,790,1106,3,1,3,0,1,0,71.43
臺北縣,永和市,中興里,0,3,1809,25,1834,2675,3,1,3,0,1,0,68.56
臺北縣,永和市,永興里,0,3,1954,24,1978,2917,3,1,3,0,1,0,67.81
臺北縣,永和市,正興里,0,3,1375,14,1389,2048,3,1,3,0,1,0,67.82
臺北縣,永和市,豫溪里,0,3,2096,25,2121,3208,3,1,3,0,1,0,66.12
臺北縣,永和市,光明里,0,3,1797,28,1825,2664,3,1,3,0,1,0,68.51
臺北縣,永和市,福和里,0,3,2639,24,2663,3929,3,1,3,0,1,0,67.78
臺北縣,永和市,得和里,0,3,2605,36,2641,3657,3,1,3,0,1,0,72.22
臺北縣,永和市,永貞里,0,3,2132,30,2162,3114,3,1,3,0,1,0,69.43
臺北縣,永和市,永福里,0,3,1757,10,1767,2533,3,1,3,0,1,0,69.76
臺北縣,永和市,河濱里,0,3,1661,24,1685,2370,3,1,3,0,1,0,71.10
臺北縣,永和市,秀和里,0,3,2576,30,2606,3659,3,1,3,0,1,0,71.22
臺北縣,永和市,永元里,0,3,2750,31,2781,3939,3,1,3,0,1,0,70.60
臺北縣,永和市,民權里,0,3,2590,40,2630,3718,3,1,3,0,1,0,70.74
臺北縣,永和市,民族里,0,3,2647,22,2669,3712,3,1,3,0,1,0,71.90
臺北縣,永和市,秀朗里,0,3,2229,27,2256,3280,3,1,3,0,1,0,68.78
臺北縣,永和市,秀成里,0,3,1685,21,1706,2423,3,1,3,0,1,0,70.41
臺北縣,永和市,秀林里,0,3,2027,19,2046,2906,3,1,3,0,1,0,70.41
臺北縣,永和市,秀得里,0,3,1521,17,1538,2158,3,1,3,0,1,0,71.27
臺北縣,永和市,秀元里,0,3,1860,14,1874,2650,3,1,3,0,1,0,70.72
臺北縣,永和市,民生里,0,3,2387,28,2415,3374,3,1,3,0,1,0,71.58
臺北縣,永和市,民本里,0,3,1708,25,1733,2444,3,1,3,0,1,0,70.91
臺北縣,永和市,民富里,0,3,1615,31,1646,2375,3,1,3,0,1,0,69.31
臺北縣,永和市,民樂里,0,3,2352,32,2384,3362,3,1,3,0,1,0,70.91
臺北縣,永和市,民治里,0,3,1792,18,1810,2610,3,1,3,0,1,0,69.35
臺北縣,永和市,智光里,0,3,2023,21,2044,2993,3,1,3,0,1,0,68.29
臺北縣,永和市,潭安里,0,3,2482,18,2500,3574,3,1,3,0,1,0,69.95
臺北縣,永和市,潭墘里,0,3,2368,30,2398,3410,3,1,3,0,1,0,70.32
臺北縣,永和市,店街里,0,3,2116,19,2135,3236,3,1,3,0,1,0,65.98
臺北縣,永和市,大新里,0,3,1453,22,1475,2089,3,1,3,0,1,0,70.61
臺北縣,永和市,永安里,0,3,2338,22,2360,3333,3,1,3,0,1,0,70.81
臺北縣,永和市,永樂里,0,3,1340,19,1359,1969,3,1,3,0,1,0,69.02
臺北縣,永和市,水源里,0,3,2377,27,2404,3403,3,1,3,0,1,0,70.64
臺北縣,永和市,協和里,0,3,1795,27,1822,2646,3,1,3,0,1,0,68.86
臺北縣,永和市,雙和里,0,3,2243,31,2274,3101,3,1,3,0,1,0,73.33
臺北縣,永和市,安和里,0,3,2190,26,2216,3050,3,1,3,0,1,0,72.66
臺北縣,永和市,前溪里,0,3,1136,8,1144,1677,3,1,3,0,1,0,68.22
臺北縣,永和市,和平里,0,3,2422,30,2452,3465,3,1,3,0,1,0,70.76
臺北縣,永和市,保平里,0,3,2416,34,2450,3379,3,1,3,0,1,0,72.51
臺北縣,永和市,中溪里,0,3,2681,25,2706,3820,3,1,3,0,1,0,70.84
臺北縣,永和市,保安里,0,3,3251,32,3283,4692,3,1,3,0,1,0,69.97
臺北縣,永和市,保順里,0,3,2655,22,2677,3890,3,1,3,0,1,0,68.82
臺北縣,永和市,下溪里,0,3,2328,38,2366,3252,3,1,3,0,1,0,72.76
臺北縣,永和市,大同里,0,3,702,14,716,956,3,1,3,0,1,0,74.90
臺北縣,永和市,新生里,0,3,564,12,576,784,3,1,3,0,1,0,73.47
臺北縣,永和市,永成里,0,3,659,5,664,922,3,1,3,0,1,0,72.02
臺北縣,永和市,忠義里,0,3,547,9,556,719,3,1,3,0,1,0,77.33
臺北縣,永和市,文化里,0,3,1789,26,1815,2469,3,1,3,0,1,0,73.51
臺北縣,永和市,仁愛里,0,3,1467,26,1493,2125,3,1,3,0,1,0,70.26
臺北縣,永和市,信義里,0,3,1498,21,1519,2163,3,1,3,0,1,0,70.23
臺北縣,永和市,後溪里,0,3,1089,16,1105,1573,3,1,3,0,1,0,70.25
臺北縣,永和市,上溪里,0,3,1239,18,1257,1803,3,1,3,0,1,0,69.72
臺北縣,永和市,頂溪里,0,3,1599,23,1622,2194,3,1,3,0,1,0,73.93
臺北縣,永和市,河堤里,0,3,1300,20,1320,1838,3,1,3,0,1,0,71.82
臺北縣,永和市,新廍里,0,3,1502,18,1520,2094,3,1,3,0,1,0,72.59
臺北縣,新店市,新店里,0,3,988,18,1006,1456,3,1,3,0,1,0,69.09
臺北縣,新店市,張南里,0,3,785,11,796,1155,3,1,3,0,1,0,68.92
臺北縣,新店市,國校里,0,3,1298,12,1310,1974,3,1,3,0,1,0,66.36
臺北縣,新店市,文中里,0,3,859,5,864,1306,3,1,3,0,1,0,66.16
臺北縣,新店市,廣明里,0,3,537,6,543,735,3,1,3,0,1,0,73.88
臺北縣,新店市,文明里,0,3,1543,20,1563,2078,3,1,3,0,1,0,75.22
臺北縣,新店市,中興里,0,3,2908,32,2940,4416,3,1,3,0,1,0,66.58
臺北縣,新店市,新生里,0,3,2888,29,2917,4096,3,1,3,0,1,0,71.22
臺北縣,新店市,新德里,0,3,1570,20,1590,2311,3,1,3,0,1,0,68.80
臺北縣,新店市,張北里,0,3,3433,48,3481,5138,3,1,3,0,1,0,67.75
臺北縣,新店市,五峰里,0,3,3898,47,3945,5657,3,1,3,0,1,0,69.74
臺北縣,新店市,長春里,0,3,1344,14,1358,1873,3,1,3,0,1,0,72.50
臺北縣,新店市,新安里,0,3,2009,18,2027,2915,3,1,3,0,1,0,69.54
臺北縣,新店市,忠誠里,0,3,1606,19,1625,2210,3,1,3,0,1,0,73.53
臺北縣,新店市,中正里,0,3,3825,43,3868,5567,3,1,3,0,1,0,69.48
臺北縣,新店市,中華里,0,3,2203,22,2225,3177,3,1,3,0,1,0,70.03
臺北縣,新店市,仁愛里,0,3,1495,15,1510,2123,3,1,3,0,1,0,71.13
臺北縣,新店市,建國里,0,3,1724,27,1751,2534,3,1,3,0,1,0,69.10
臺北縣,新店市,百忍里,0,3,2357,36,2393,3390,3,1,3,0,1,0,70.59
臺北縣,新店市,百和里,0,3,1849,12,1861,2619,3,1,3,0,1,0,71.06
臺北縣,新店市,福德里,0,3,2225,24,2249,3210,3,1,3,0,1,0,70.06
臺北縣,新店市,百福里,0,3,1811,21,1832,2497,3,1,3,0,1,0,73.37
臺北縣,新店市,福民里,0,3,2257,25,2282,3212,3,1,3,0,1,0,71.05
臺北縣,新店市,中山里,0,3,995,10,1005,1493,3,1,3,0,1,0,67.31
臺北縣,新店市,和平里,0,3,566,14,580,804,3,1,3,0,1,0,72.14
臺北縣,新店市,中央里,0,3,2211,13,2224,3150,3,1,3,0,1,0,70.60
臺北縣,新店市,國豐里,0,3,1355,21,1376,1978,3,1,3,0,1,0,69.57
臺北縣,新店市,明德里,0,3,2464,28,2492,3517,3,1,3,0,1,0,70.86
臺北縣,新店市,大豐里,0,3,2158,12,2170,3055,3,1,3,0,1,0,71.03
臺北縣,新店市,大同里,0,3,2250,26,2276,3116,3,1,3,0,1,0,73.04
臺北縣,新店市,江陵里,0,3,2372,19,2391,3478,3,1,3,0,1,0,68.75
臺北縣,新店市,復興里,0,3,1900,19,1919,2932,3,1,3,0,1,0,65.45
臺北縣,新店市,寶興里,0,3,2403,28,2431,3519,3,1,3,0,1,0,69.08
臺北縣,新店市,寶福里,0,3,2597,37,2634,3801,3,1,3,0,1,0,69.30
臺北縣,新店市,寶安里,0,3,3042,34,3076,4497,3,1,3,0,1,0,68.40
臺北縣,新店市,信義里,0,3,3389,43,3432,4994,3,1,3,0,1,0,68.72
臺北縣,新店市,忠孝里,0,3,1743,24,1767,2542,3,1,3,0,1,0,69.51
臺北縣,新店市,大鵬里,0,3,1093,10,1103,1389,3,1,3,0,1,0,79.41
臺北縣,新店市,太平里,0,3,1581,40,1621,2332,3,1,3,0,1,0,69.51
臺北縣,新店市,美城里,0,3,1435,23,1458,2075,3,1,3,0,1,0,70.27
臺北縣,新店市,頂城里,0,3,859,13,872,1327,3,1,3,0,1,0,65.71
臺北縣,新店市,下城里,0,3,1182,29,1211,1710,3,1,3,0,1,0,70.82
臺北縣,新店市,柴埕里,0,3,3866,59,3925,5711,3,1,3,0,1,0,68.73
臺北縣,新店市,安和里,0,3,2713,28,2741,3985,3,1,3,0,1,0,68.78
臺北縣,新店市,永安里,0,3,2611,51,2662,3857,3,1,3,0,1,0,69.02
臺北縣,新店市,新和里,0,3,2173,22,2195,3077,3,1,3,0,1,0,71.34
臺北縣,新店市,永平里,0,3,2541,24,2565,3720,3,1,3,0,1,0,68.95
臺北縣,新店市,公崙里,0,3,4043,53,4096,5933,3,1,3,0,1,0,69.04
臺北縣,新店市,安昌里,0,3,2096,20,2116,3007,3,1,3,0,1,0,70.37
臺北縣,新店市,德安里,0,3,4464,56,4520,6546,3,1,3,0,1,0,69.05
臺北縣,新店市,明城里,0,3,1635,9,1644,2343,3,1,3,0,1,0,70.17
臺北縣,新店市,小城里,0,3,2008,17,2025,2740,3,1,3,0,1,0,73.91
臺北縣,新店市,雙城里,0,3,3030,40,3070,4488,3,1,3,0,1,0,68.40
臺北縣,新店市,香坡里,0,3,2771,33,2804,4336,3,1,3,0,1,0,64.67
臺北縣,新店市,日興里,0,3,2774,32,2806,4115,3,1,3,0,1,0,68.19
臺北縣,新店市,玫瑰里,0,3,2938,33,2971,4129,3,1,3,0,1,0,71.95
臺北縣,新店市,吉祥里,0,3,2228,26,2254,3242,3,1,3,0,1,0,69.52
臺北縣,新店市,塗潭里,0,3,1121,10,1131,1701,3,1,3,0,1,0,66.49
臺北縣,新店市,青潭里,0,3,2256,29,2285,3327,3,1,3,0,1,0,68.68
臺北縣,新店市,美潭里,0,3,2668,29,2697,3868,3,1,3,0,1,0,69.73
臺北縣,新店市,國豐里,0,3,730,7,737,1036,3,1,3,0,1,0,71.14
臺北縣,新店市,員潭里,0,3,887,21,908,1405,3,1,3,0,1,0,64.63
臺北縣,新店市,雙坑里,0,3,482,5,487,787,3,1,3,0,1,0,61.88
臺北縣,新店市,粗坑里,0,3,1372,18,1390,2067,3,1,3,0,1,0,67.25
臺北縣,新店市,屈尺里,0,3,1474,32,1506,2213,3,1,3,0,1,0,68.05
臺北縣,新店市,龜山里,0,3,845,8,853,1346,3,1,3,0,1,0,63.37
臺北縣,新店市,廣興里,0,3,721,16,737,1054,3,1,3,0,1,0,69.92
臺北縣,新店市,直潭里,0,3,473,6,479,709,3,1,3,0,1,0,67.56
臺北縣,深坑鄉,萬順村,0,3,572,13,585,917,3,1,3,0,1,0,63.79
臺北縣,深坑鄉,萬福村,0,3,1748,38,1786,2729,3,1,3,0,1,0,65.45
臺北縣,深坑鄉,土庫村,0,3,1260,20,1280,1868,3,1,3,0,1,0,68.52
臺北縣,深坑鄉,賴仲村,0,3,930,14,944,1422,3,1,3,0,1,0,66.39
臺北縣,深坑鄉,深坑村,0,3,1514,18,1532,2309,3,1,3,0,1,0,66.35
臺北縣,深坑鄉,埔新村,0,3,2288,29,2317,3482,3,1,3,0,1,0,66.54
臺北縣,深坑鄉,昇高村,0,3,979,13,992,1454,3,1,3,0,1,0,68.23
臺北縣,深坑鄉,阿柔村,0,3,299,6,305,455,3,1,3,0,1,0,67.03
臺北縣,石碇鄉,石碇村,0,3,292,3,295,398,3,1,3,0,1,0,74.12
臺北縣,石碇鄉,潭邊村,0,3,425,9,434,663,3,1,3,0,1,0,65.46
臺北縣,石碇鄉,烏塗村,0,3,413,6,419,591,3,1,3,0,1,0,70.90
臺北縣,石碇鄉,彭山村,0,3,173,1,174,274,3,1,3,0,1,0,63.50
臺北縣,石碇鄉,豐田村,0,3,285,5,290,411,3,1,3,0,1,0,70.56
臺北縣,石碇鄉,隆盛村,0,3,456,6,462,713,3,1,3,0,1,0,64.80
臺北縣,石碇鄉,豐林村,0,3,146,1,147,223,3,1,3,0,1,0,65.92
臺北縣,石碇鄉,中民村,0,3,517,8,525,759,3,1,3,0,1,0,69.17
臺北縣,石碇鄉,永定村,0,3,388,6,394,597,3,1,3,0,1,0,66.00
臺北縣,石碇鄉,光明村,0,3,160,3,163,238,3,1,3,0,1,0,68.49
臺北縣,石碇鄉,永安村,0,3,259,4,263,416,3,1,3,0,1,0,63.22
臺北縣,石碇鄉,格頭村,0,3,432,12,444,621,3,1,3,0,1,0,71.50
臺北縣,坪林鄉,坪林村,0,3,673,12,685,997,3,1,3,0,1,0,68.71
臺北縣,坪林鄉,石曹村,0,3,232,5,237,357,3,1,3,0,1,0,66.39
臺北縣,坪林鄉,水德村,0,3,344,8,352,557,3,1,3,0,1,0,63.20
臺北縣,坪林鄉,大林村,0,3,520,3,523,886,3,1,3,0,1,0,59.03
臺北縣,坪林鄉,粗窟村,0,3,458,4,462,727,3,1,3,0,1,0,63.55
臺北縣,坪林鄉,上德村,0,3,478,9,487,685,3,1,3,0,1,0,71.09
臺北縣,坪林鄉,漁光村,0,3,422,3,425,676,3,1,3,0,1,0,62.87
臺北縣,烏來鄉,忠治村,0,3,360,4,364,530,3,1,3,0,1,0,68.68
臺北縣,烏來鄉,烏來村,0,3,697,6,703,1024,3,1,3,0,1,0,68.65
臺北縣,烏來鄉,孝義村,0,3,89,1,90,110,3,1,3,0,1,0,81.82
臺北縣,烏來鄉,信賢村,0,3,123,0,123,184,3,1,3,0,1,0,66.85
臺北縣,烏來鄉,福山村,0,3,49,0,49,65,3,1,3,0,1,0,75.38
臺北縣,汐止鎮,仁德里,0,3,1070,7,1077,1523,3,1,3,0,1,0,70.72
臺北縣,汐止鎮,義民里,0,3,799,10,809,1352,3,1,3,0,1,0,59.84
臺北縣,汐止鎮,禮門里,0,3,603,5,608,949,3,1,3,0,1,0,64.07
臺北縣,汐止鎮,智慧里,0,3,1771,20,1791,2788,3,1,3,0,1,0,64.24
臺北縣,汐止鎮,大同里,0,3,603,9,612,932,3,1,3,0,1,0,65.67
臺北縣,汐止鎮,信望里,0,3,318,4,322,483,3,1,3,0,1,0,66.67
臺北縣,汐止鎮,新昌里,0,3,2694,35,2729,4177,3,1,3,0,1,0,65.33
臺北縣,汐止鎮,福安里,0,3,1324,14,1338,1990,3,1,3,0,1,0,67.24
臺北縣,汐止鎮,秀峰里,0,3,1774,21,1795,2729,3,1,3,0,1,0,65.78
臺北縣,汐止鎮,秀山里,0,3,1739,16,1755,2561,3,1,3,0,1,0,68.53
臺北縣,汐止鎮,復興里,0,3,2847,21,2868,4204,3,1,3,0,1,0,68.22
臺北縣,汐止鎮,自強里,0,3,2018,32,2050,3157,3,1,3,0,1,0,64.94
臺北縣,汐止鎮,文化里,0,3,1689,12,1701,2590,3,1,3,0,1,0,65.68
臺北縣,汐止鎮,白雲里,0,3,1911,24,1935,2974,3,1,3,0,1,0,65.06
臺北縣,汐止鎮,茄苳里,0,3,1698,35,1733,2798,3,1,3,0,1,0,61.94
臺北縣,汐止鎮,崇德里,0,3,1728,28,1756,2796,3,1,3,0,1,0,62.80
臺北縣,汐止鎮,橋東里,0,3,4888,52,4940,7439,3,1,3,0,1,0,66.41
臺北縣,汐止鎮,長安里,0,3,958,9,967,1442,3,1,3,0,1,0,67.06
臺北縣,汐止鎮,保安里,0,3,807,8,815,1233,3,1,3,0,1,0,66.10
臺北縣,汐止鎮,東山里,0,3,308,6,314,461,3,1,3,0,1,0,68.11
臺北縣,汐止鎮,保長里,0,3,2209,32,2241,3476,3,1,3,0,1,0,64.47
臺北縣,汐止鎮,鄉長里,0,3,1161,19,1180,1678,3,1,3,0,1,0,70.32
臺北縣,汐止鎮,江北里,0,3,2537,20,2557,3961,3,1,3,0,1,0,64.55
臺北縣,汐止鎮,拱北里,0,3,2111,30,2141,3545,3,1,3,0,1,0,60.39
臺北縣,汐止鎮,烘內里,0,3,725,5,730,1148,3,1,3,0,1,0,63.59
臺北縣,汐止鎮,八連里,0,3,506,14,520,768,3,1,3,0,1,0,67.71
臺北縣,汐止鎮,長青里,0,3,628,10,638,902,3,1,3,0,1,0,70.73
臺北縣,汐止鎮,北峰里,0,3,1898,28,1926,2935,3,1,3,0,1,0,65.62
臺北縣,汐止鎮,金龍里,0,3,2073,46,2119,3391,3,1,3,0,1,0,62.49
臺北縣,汐止鎮,樟樹里,0,3,1057,26,1083,1604,3,1,3,0,1,0,67.52
臺北縣,汐止鎮,忠孝里,0,3,2963,43,3006,4695,3,1,3,0,1,0,64.03
臺北縣,汐止鎮,厚德里,0,3,2226,29,2255,3571,3,1,3,0,1,0,63.15
臺北縣,汐止鎮,山光里,0,3,864,7,871,1400,3,1,3,0,1,0,62.21
臺北縣,汐止鎮,中興里,0,3,2799,40,2839,4676,3,1,3,0,1,0,60.71
臺北縣,汐止鎮,福德里,0,3,1359,25,1384,2188,3,1,3,0,1,0,63.25
臺北縣,汐止鎮,興福里,0,3,1271,10,1281,2034,3,1,3,0,1,0,62.98
臺北縣,汐止鎮,康福里,0,3,1087,17,1104,1757,3,1,3,0,1,0,62.83
臺北縣,汐止鎮,湖光里,0,3,2175,19,2194,3476,3,1,3,0,1,0,63.12
臺北縣,汐止鎮,湖興里,0,3,2211,20,2231,3393,3,1,3,0,1,0,65.75
臺北縣,汐止鎮,北山里,0,3,2539,30,2569,3929,3,1,3,0,1,0,65.39
臺北縣,汐止鎮,忠山里,0,3,1597,9,1606,2373,3,1,3,0,1,0,67.68
臺北縣,汐止鎮,環河里,0,3,619,7,626,939,3,1,3,0,1,0,66.67
臺北縣,汐止鎮,橫科里,0,3,2692,44,2736,4005,3,1,3,0,1,0,68.31
臺北縣,汐止鎮,福山里,0,3,1831,21,1852,2802,3,1,3,0,1,0,66.10
臺北縣,汐止鎮,宜興里,0,3,1544,28,1572,2328,3,1,3,0,1,0,67.53
臺北縣,汐止鎮,東勢里,0,3,1571,15,1586,2291,3,1,3,0,1,0,69.23
臺北縣,瑞芳鎮,龍潭里,0,3,554,7,561,775,3,1,3,0,1,0,72.39
臺北縣,瑞芳鎮,龍興里,0,3,1229,15,1244,1694,3,1,3,0,1,0,73.44
臺北縣,瑞芳鎮,龍鎮里,0,3,921,11,932,1298,3,1,3,0,1,0,71.80
臺北縣,瑞芳鎮,龍安里,0,3,410,9,419,585,3,1,3,0,1,0,71.62
臺北縣,瑞芳鎮,龍川里,0,3,1005,15,1020,1531,3,1,3,0,1,0,66.62
臺北縣,瑞芳鎮,龍山里,0,3,851,15,866,1296,3,1,3,0,1,0,66.82
臺北縣,瑞芳鎮,爪峰里,0,3,2514,26,2540,3712,3,1,3,0,1,0,68.43
臺北縣,瑞芳鎮,新峰里,0,3,1552,17,1569,2327,3,1,3,0,1,0,67.43
臺北縣,瑞芳鎮,東和里,0,3,1305,14,1319,1929,3,1,3,0,1,0,68.38
臺北縣,瑞芳鎮,柑坪里,0,3,755,28,783,1126,3,1,3,0,1,0,69.54
臺北縣,瑞芳鎮,弓橋里,0,3,186,2,188,285,3,1,3,0,1,0,65.96
臺北縣,瑞芳鎮,侯硐里,0,3,365,4,369,508,3,1,3,0,1,0,72.64
臺北縣,瑞芳鎮,光復里,0,3,243,4,247,362,3,1,3,0,1,0,68.23
臺北縣,瑞芳鎮,碩仁里,0,3,108,0,108,155,3,1,3,0,1,0,69.68
臺北縣,瑞芳鎮,吉慶里,0,3,1096,15,1111,1609,3,1,3,0,1,0,69.05
臺北縣,瑞芳鎮,吉安里,0,3,1726,51,1777,2815,3,1,3,0,1,0,63.13
臺北縣,瑞芳鎮,上天里,0,3,837,14,851,1264,3,1,3,0,1,0,67.33
臺北縣,瑞芳鎮,傑魚里,0,3,1191,19,1210,1810,3,1,3,0,1,0,66.85
臺北縣,瑞芳鎮,基山里,0,3,365,7,372,586,3,1,3,0,1,0,63.48
臺北縣,瑞芳鎮,永慶里,0,3,351,4,355,594,3,1,3,0,1,0,59.76
臺北縣,瑞芳鎮,崇文里,0,3,238,2,240,417,3,1,3,0,1,0,57.55
臺北縣,瑞芳鎮,福住里,0,3,166,2,168,265,3,1,3,0,1,0,63.40
臺北縣,瑞芳鎮,頌德里,0,3,246,2,248,409,3,1,3,0,1,0,60.64
臺北縣,瑞芳鎮,瓜山里,0,3,185,7,192,284,3,1,3,0,1,0,67.61
臺北縣,瑞芳鎮,銅山里,0,3,189,2,191,272,3,1,3,0,1,0,70.22
臺北縣,瑞芳鎮,新山里,0,3,298,5,303,426,3,1,3,0,1,0,71.13
臺北縣,瑞芳鎮,石山里,0,3,276,4,280,431,3,1,3,0,1,0,64.97
臺北縣,瑞芳鎮,濂洞里,0,3,423,9,432,607,3,1,3,0,1,0,71.17
臺北縣,瑞芳鎮,濂新里,0,3,197,1,198,319,3,1,3,0,1,0,62.07
臺北縣,瑞芳鎮,南雅里,0,3,126,1,127,200,3,1,3,0,1,0,63.50
臺北縣,瑞芳鎮,鼻頭里,0,3,322,7,329,509,3,1,3,0,1,0,64.64
臺北縣,瑞芳鎮,海濱里,0,3,572,12,584,866,3,1,3,0,1,0,67.44
臺北縣,瑞芳鎮,瑞濱里,0,3,1041,17,1058,1540,3,1,3,0,1,0,68.70
臺北縣,瑞芳鎮,深澳里,0,3,622,10,632,967,3,1,3,0,1,0,65.36
臺北縣,平溪鄉,薯榔村,0,3,293,4,297,438,3,1,3,0,1,0,67.81
臺北縣,平溪鄉,菁桐村,0,3,222,4,226,320,3,1,3,0,1,0,70.63
臺北縣,平溪鄉,白石村,0,3,219,6,225,311,3,1,3,0,1,0,72.35
臺北縣,平溪鄉,石底村,0,3,373,4,377,562,3,1,3,0,1,0,67.08
臺北縣,平溪鄉,平溪村,0,3,175,3,178,282,3,1,3,0,1,0,63.12
臺北縣,平溪鄉,嶺腳村,0,3,469,11,480,703,3,1,3,0,1,0,68.28
臺北縣,平溪鄉,東勢村,0,3,244,3,247,390,3,1,3,0,1,0,63.33
臺北縣,平溪鄉,十分村,0,3,655,11,666,1027,3,1,3,0,1,0,64.85
臺北縣,平溪鄉,望古村,0,3,73,3,76,149,3,1,3,0,1,0,51.01
臺北縣,平溪鄉,南山村,0,3,310,4,314,506,3,1,3,0,1,0,62.06
臺北縣,平溪鄉,新寮村,0,3,118,3,121,185,3,1,3,0,1,0,65.41
臺北縣,平溪鄉,平湖村,0,3,99,3,102,164,3,1,3,0,1,0,62.20
臺北縣,雙溪鄉,雙溪村,0,3,373,4,377,574,3,1,3,0,1,0,65.68
臺北縣,雙溪鄉,新基村,0,3,641,5,646,931,3,1,3,0,1,0,69.39
臺北縣,雙溪鄉,三港村,0,3,293,2,295,454,3,1,3,0,1,0,64.98
臺北縣,雙溪鄉,牡丹村,0,3,1267,21,1288,1858,3,1,3,0,1,0,69.32
臺北縣,雙溪鄉,三貂村,0,3,251,2,253,357,3,1,3,0,1,0,70.87
臺北縣,雙溪鄉,平林村,0,3,581,7,588,924,3,1,3,0,1,0,63.64
臺北縣,雙溪鄉,上林村,0,3,464,7,471,721,3,1,3,0,1,0,65.33
臺北縣,雙溪鄉,外柑村,0,3,332,0,332,511,3,1,3,0,1,0,64.97
臺北縣,雙溪鄉,長源村,0,3,270,2,272,407,3,1,3,0,1,0,66.83
臺北縣,雙溪鄉,共和村,0,3,323,3,326,470,3,1,3,0,1,0,69.36
臺北縣,雙溪鄉,魚行村,0,3,488,3,491,702,3,1,3,0,1,0,69.94
臺北縣,雙溪鄉,泰平村,0,3,260,0,260,475,3,1,3,0,1,0,54.74
臺北縣,貢寮鄉,貢寮村,0,3,575,9,584,919,3,1,3,0,1,0,63.55
臺北縣,貢寮鄉,龍崗村,0,3,263,1,264,428,3,1,3,0,1,0,61.68
臺北縣,貢寮鄉,吉林村,0,3,312,7,319,477,3,1,3,0,1,0,66.88
臺北縣,貢寮鄉,雙玉村,0,3,486,8,494,792,3,1,3,0,1,0,62.37
臺北縣,貢寮鄉,福隆村,0,3,991,20,1011,1562,3,1,3,0,1,0,64.72
臺北縣,貢寮鄉,福連村,0,3,443,9,452,788,3,1,3,0,1,0,57.36
臺北縣,貢寮鄉,龍門村,0,3,415,1,416,644,3,1,3,0,1,0,64.60
臺北縣,貢寮鄉,仁里村,0,3,1016,13,1029,1549,3,1,3,0,1,0,66.43
臺北縣,貢寮鄉,真理村,0,3,1122,11,1133,1846,3,1,3,0,1,0,61.38
臺北縣,貢寮鄉,美豐村,0,3,489,6,495,783,3,1,3,0,1,0,63.22
臺北縣,貢寮鄉,和美村,0,3,577,13,590,894,3,1,3,0,1,0,66.00
宜蘭縣,宜蘭市,南門里,0,1,378,3,381,632,3,1,3,0,1,0,60.28
宜蘭縣,宜蘭市,負郭里,0,1,1402,19,1421,2107,3,1,3,0,1,0,67.44
宜蘭縣,宜蘭市,民族里,0,1,1444,23,1467,2238,3,1,3,0,1,0,65.55
宜蘭縣,宜蘭市,建軍里,0,1,1427,18,1445,2353,3,1,3,0,1,0,61.41
宜蘭縣,宜蘭市,復興里,0,1,1802,26,1828,2778,3,1,3,0,1,0,65.80
宜蘭縣,宜蘭市,思源里,0,1,2581,21,2602,4068,3,1,3,0,1,0,63.96
宜蘭縣,宜蘭市,文化里,0,1,1670,14,1684,2606,3,1,3,0,1,0,64.62
宜蘭縣,宜蘭市,神農里,0,1,439,4,443,675,3,1,3,0,1,0,65.63
宜蘭縣,宜蘭市,民生里,0,1,290,4,294,457,3,1,3,0,1,0,64.33
宜蘭縣,宜蘭市,昇平里,0,1,476,3,479,693,3,1,3,0,1,0,69.12
宜蘭縣,宜蘭市,大東里,0,1,355,6,361,577,3,1,3,0,1,0,62.56
宜蘭縣,宜蘭市,新興里,0,1,375,2,377,598,3,1,3,0,1,0,63.04
宜蘭縣,宜蘭市,和睦里,0,1,1300,16,1316,2040,3,1,3,0,1,0,64.51
宜蘭縣,宜蘭市,民權里,0,1,920,19,939,1486,3,1,3,0,1,0,63.19
宜蘭縣,宜蘭市,進士里,0,1,2882,19,2901,4442,3,1,3,0,1,0,65.31
宜蘭縣,宜蘭市,南橋里,0,1,438,2,440,630,3,1,3,0,1,0,69.84
宜蘭縣,宜蘭市,建業里,0,1,579,8,587,992,3,1,3,0,1,0,59.17
宜蘭縣,宜蘭市,南津里,0,1,473,3,476,771,3,1,3,0,1,0,61.74
宜蘭縣,宜蘭市,凱旋里,0,1,674,4,678,1108,3,1,3,0,1,0,61.19
宜蘭縣,宜蘭市,黎明里,0,1,794,5,799,1243,3,1,3,0,1,0,64.28
宜蘭縣,宜蘭市,東村里,0,1,2185,18,2203,3435,3,1,3,0,1,0,64.13
宜蘭縣,宜蘭市,延平里,0,1,2169,43,2212,3470,3,1,3,0,1,0,63.75
宜蘭縣,宜蘭市,七張里,0,1,734,5,739,1157,3,1,3,0,1,0,63.87
宜蘭縣,宜蘭市,慈安里,0,1,2408,34,2442,3905,3,1,3,0,1,0,62.54
宜蘭縣,宜蘭市,新民里,0,1,415,8,423,641,3,1,3,0,1,0,65.99
宜蘭縣,宜蘭市,東門里,0,1,363,1,364,558,3,1,3,0,1,0,65.23
宜蘭縣,宜蘭市,中正里,0,1,392,7,399,631,3,1,3,0,1,0,63.23
宜蘭縣,宜蘭市,小東里,0,1,815,1,816,1273,3,1,3,0,1,0,64.10
宜蘭縣,宜蘭市,菜園里,0,1,847,6,853,1316,3,1,3,0,1,0,64.82
宜蘭縣,宜蘭市,孝廉里,0,1,656,5,661,1054,3,1,3,0,1,0,62.71
宜蘭縣,宜蘭市,新生里,0,1,1347,11,1358,2124,3,1,3,0,1,0,63.94
宜蘭縣,宜蘭市,茭白里,0,1,1058,4,1062,1732,3,1,3,0,1,0,61.32
宜蘭縣,宜蘭市,北津里,0,1,909,4,913,1436,3,1,3,0,1,0,63.58
宜蘭縣,宜蘭市,梅洲里,0,1,1568,17,1585,2487,3,1,3,0,1,0,63.73
宜蘭縣,宜蘭市,北門里,0,1,572,4,576,898,3,1,3,0,1,0,64.14
宜蘭縣,宜蘭市,慶和里,0,1,483,11,494,744,3,1,3,0,1,0,66.40
宜蘭縣,宜蘭市,鄂王里,0,1,488,4,492,802,3,1,3,0,1,0,61.35
宜蘭縣,宜蘭市,西門里,0,1,827,16,843,1284,3,1,3,0,1,0,65.65
宜蘭縣,宜蘭市,中山里,0,1,508,9,517,803,3,1,3,0,1,0,64.38
宜蘭縣,宜蘭市,大道里,0,1,819,8,827,1301,3,1,3,0,1,0,63.57
宜蘭縣,羅東鎮,開羅里,0,1,316,4,320,515,3,1,3,0,1,0,62.14
宜蘭縣,羅東鎮,開元里,0,1,351,5,356,521,3,1,3,0,1,0,68.33
宜蘭縣,羅東鎮,東明里,0,1,307,3,310,498,3,1,3,0,1,0,62.25
宜蘭縣,羅東鎮,大新里,0,1,782,3,785,1227,3,1,3,0,1,0,63.98
宜蘭縣,羅東鎮,東安里,0,1,1290,15,1305,2115,3,1,3,0,1,0,61.70
宜蘭縣,羅東鎮,新群里,0,1,1248,12,1260,1948,3,1,3,0,1,0,64.68
宜蘭縣,羅東鎮,羅莊里,0,1,1158,18,1176,1913,3,1,3,0,1,0,61.47
宜蘭縣,羅東鎮,南昌里,0,1,1343,19,1362,2175,3,1,3,0,1,0,62.62
宜蘭縣,羅東鎮,南豪里,0,1,902,7,909,1339,3,1,3,0,1,0,67.89
宜蘭縣,羅東鎮,成功里,0,1,778,12,790,1177,3,1,3,0,1,0,67.12
宜蘭縣,羅東鎮,仁德里,0,1,547,3,550,876,3,1,3,0,1,0,62.79
宜蘭縣,羅東鎮,居仁里,0,1,439,4,443,715,3,1,3,0,1,0,61.96
宜蘭縣,羅東鎮,義和里,0,1,545,5,550,878,3,1,3,0,1,0,62.64
宜蘭縣,羅東鎮,羅東里,0,1,411,4,415,613,3,1,3,0,1,0,67.70
宜蘭縣,羅東鎮,浮崙里,0,1,454,2,456,723,3,1,3,0,1,0,63.07
宜蘭縣,羅東鎮,漢民里,0,1,2277,15,2292,3540,3,1,3,0,1,0,64.75
宜蘭縣,羅東鎮,西安里,0,1,2914,33,2947,4646,3,1,3,0,1,0,63.43
宜蘭縣,羅東鎮,北成里,0,1,3209,32,3241,5061,3,1,3,0,1,0,64.04
宜蘭縣,羅東鎮,賢文里,0,1,2081,16,2097,3349,3,1,3,0,1,0,62.62
宜蘭縣,羅東鎮,公正里,0,1,1127,13,1140,1803,3,1,3,0,1,0,63.23
宜蘭縣,羅東鎮,集祥里,0,1,607,6,613,1001,3,1,3,0,1,0,61.24
宜蘭縣,羅東鎮,信義里,0,1,1743,11,1754,2865,3,1,3,0,1,0,61.22
宜蘭縣,羅東鎮,樹林里,0,1,2072,17,2089,3290,3,1,3,0,1,0,63.50
宜蘭縣,羅東鎮,竹林里,0,1,1579,19,1598,2539,3,1,3,0,1,0,62.94
宜蘭縣,羅東鎮,仁愛里,0,1,1503,16,1519,2367,3,1,3,0,1,0,64.17
宜蘭縣,蘇澳鎮,龍德里,0,1,1847,13,1860,2965,3,1,3,0,1,0,62.73
宜蘭縣,蘇澳鎮,頂寮里,0,1,512,2,514,757,3,1,3,0,1,0,67.90
宜蘭縣,蘇澳鎮,永榮里,0,1,1875,20,1895,2925,3,1,3,0,1,0,64.79
宜蘭縣,蘇澳鎮,存仁里,0,1,694,2,696,1010,3,1,3,0,1,0,68.91
宜蘭縣,蘇澳鎮,港邊里,0,1,783,5,788,1237,3,1,3,0,1,0,63.70
宜蘭縣,蘇澳鎮,岳明里,0,1,173,5,178,305,3,1,3,0,1,0,58.36
宜蘭縣,蘇澳鎮,隘丁里,0,1,1289,10,1299,2070,3,1,3,0,1,0,62.75
宜蘭縣,蘇澳鎮,新城里,0,1,689,6,695,1102,3,1,3,0,1,0,63.07
宜蘭縣,蘇澳鎮,聖湖里,0,1,2894,33,2927,4863,3,1,3,0,1,0,60.19
宜蘭縣,蘇澳鎮,蘇西里,0,1,1417,10,1427,2230,3,1,3,0,1,0,63.99
宜蘭縣,蘇澳鎮,蘇北里,0,1,776,12,788,1229,3,1,3,0,1,0,64.12
宜蘭縣,蘇澳鎮,蘇南里,0,1,376,4,380,552,3,1,3,0,1,0,68.84
宜蘭縣,蘇澳鎮,蘇東里,0,1,297,2,299,511,3,1,3,0,1,0,58.51
宜蘭縣,蘇澳鎮,長安里,0,1,395,2,397,603,3,1,3,0,1,0,65.84
宜蘭縣,蘇澳鎮,永光里,0,1,373,3,376,570,3,1,3,0,1,0,65.96
宜蘭縣,蘇澳鎮,永春里,0,1,377,4,381,632,3,1,3,0,1,0,60.28
宜蘭縣,蘇澳鎮,永樂里,0,1,372,3,375,536,3,1,3,0,1,0,69.96
宜蘭縣,蘇澳鎮,南安里,0,1,715,10,725,1112,3,1,3,0,1,0,65.20
宜蘭縣,蘇澳鎮,南正里,0,1,626,6,632,1035,3,1,3,0,1,0,61.06
宜蘭縣,蘇澳鎮,南成里,0,1,745,5,750,1250,3,1,3,0,1,0,60.00
宜蘭縣,蘇澳鎮,南興里,0,1,915,10,925,1674,3,1,3,0,1,0,55.26
宜蘭縣,蘇澳鎮,南寧里,0,1,674,10,684,1160,3,1,3,0,1,0,58.97
宜蘭縣,蘇澳鎮,南建里,0,1,770,8,778,1335,3,1,3,0,1,0,58.28
宜蘭縣,蘇澳鎮,東澳里,0,1,187,2,189,333,3,1,3,0,1,0,56.76
宜蘭縣,蘇澳鎮,南強里,0,1,448,9,457,816,3,1,3,0,1,0,56.00
宜蘭縣,蘇澳鎮,朝陽里,0,1,427,7,434,748,3,1,3,0,1,0,58.02
宜蘭縣,頭城鎮,石城里,0,1,212,2,214,382,3,1,3,0,1,0,56.02
宜蘭縣,頭城鎮,大里里,0,1,384,7,391,709,3,1,3,0,1,0,55.15
宜蘭縣,頭城鎮,龜山里,0,1,343,9,352,622,3,1,3,0,1,0,56.59
宜蘭縣,頭城鎮,大溪里,0,1,520,4,524,930,3,1,3,0,1,0,56.34
宜蘭縣,頭城鎮,合興里,0,1,230,3,233,401,3,1,3,0,1,0,58.10
宜蘭縣,頭城鎮,更新里,0,1,939,9,948,1374,3,1,3,0,1,0,69.00
宜蘭縣,頭城鎮,外澳里,0,1,531,12,543,874,3,1,3,0,1,0,62.13
宜蘭縣,頭城鎮,港口里,0,1,427,3,430,628,3,1,3,0,1,0,68.47
宜蘭縣,頭城鎮,武營里,0,1,931,11,942,1411,3,1,3,0,1,0,66.76
宜蘭縣,頭城鎮,大坑里,0,1,753,12,765,1148,3,1,3,0,1,0,66.64
宜蘭縣,頭城鎮,城東里,0,1,522,7,529,759,3,1,3,0,1,0,69.70
宜蘭縣,頭城鎮,城北里,0,1,375,5,380,558,3,1,3,0,1,0,68.10
宜蘭縣,頭城鎮,城西里,0,1,462,4,466,652,3,1,3,0,1,0,71.47
宜蘭縣,頭城鎮,城南里,0,1,403,1,404,607,3,1,3,0,1,0,66.56
宜蘭縣,頭城鎮,竹安里,0,1,1160,12,1172,1919,3,1,3,0,1,0,61.07
宜蘭縣,頭城鎮,新建里,0,1,1124,16,1140,1779,3,1,3,0,1,0,64.08
宜蘭縣,頭城鎮,拔雅里,0,1,859,7,866,1362,3,1,3,0,1,0,63.58
宜蘭縣,頭城鎮,福成里,0,1,633,9,642,962,3,1,3,0,1,0,66.74
宜蘭縣,頭城鎮,金面里,0,1,1002,9,1011,1625,3,1,3,0,1,0,62.22
宜蘭縣,頭城鎮,金盈里,0,1,405,5,410,685,3,1,3,0,1,0,59.85
宜蘭縣,頭城鎮,頂埔里,0,1,861,10,871,1270,3,1,3,0,1,0,68.58
宜蘭縣,頭城鎮,下埔里,0,1,642,4,646,940,3,1,3,0,1,0,68.72
宜蘭縣,頭城鎮,中崙里,0,1,639,5,644,962,3,1,3,0,1,0,66.94
宜蘭縣,頭城鎮,二城里,0,1,661,11,672,1053,3,1,3,0,1,0,63.82
宜蘭縣,礁溪鄉,白雲村,0,1,849,12,861,1410,3,1,3,0,1,0,61.06
宜蘭縣,礁溪鄉,玉石村,0,1,1049,10,1059,1664,3,1,3,0,1,0,63.64
宜蘭縣,礁溪鄉,德陽村,0,1,2121,16,2137,3414,3,1,3,0,1,0,62.60
宜蘭縣,礁溪鄉,大忠村,0,1,1391,6,1397,2118,3,1,3,0,1,0,65.96
宜蘭縣,礁溪鄉,大義村,0,1,464,6,470,674,3,1,3,0,1,0,69.73
宜蘭縣,礁溪鄉,六結村,0,1,930,4,934,1383,3,1,3,0,1,0,67.53
宜蘭縣,礁溪鄉,二龍村,0,1,710,8,718,1094,3,1,3,0,1,0,65.63
宜蘭縣,礁溪鄉,時潮村,0,1,865,10,875,1337,3,1,3,0,1,0,65.45
宜蘭縣,礁溪鄉,玉田村,0,1,1184,16,1200,1880,3,1,3,0,1,0,63.83
宜蘭縣,礁溪鄉,三民村,0,1,1436,15,1451,2275,3,1,3,0,1,0,63.78
宜蘭縣,礁溪鄉,林美村,0,1,695,8,703,1050,3,1,3,0,1,0,66.95
宜蘭縣,礁溪鄉,白鵝村,0,1,477,3,480,730,3,1,3,0,1,0,65.75
宜蘭縣,礁溪鄉,玉光村,0,1,606,10,616,921,3,1,3,0,1,0,66.88
宜蘭縣,礁溪鄉,光武村,0,1,718,8,726,1103,3,1,3,0,1,0,65.82
宜蘭縣,礁溪鄉,吳沙村,0,1,1464,9,1473,2168,3,1,3,0,1,0,67.94
宜蘭縣,礁溪鄉,龍潭村,0,1,1683,23,1706,2731,3,1,3,0,1,0,62.47
宜蘭縣,礁溪鄉,匏崙村,0,1,595,7,602,920,3,1,3,0,1,0,65.43
宜蘭縣,礁溪鄉,二結村,0,1,249,3,252,406,3,1,3,0,1,0,62.07
宜蘭縣,壯圍鄉,吉祥村,0,1,1197,11,1208,1826,3,1,3,0,1,0,66.16
宜蘭縣,壯圍鄉,古結村,0,1,561,5,566,934,3,1,3,0,1,0,60.60
宜蘭縣,壯圍鄉,美福村,0,1,995,9,1004,1638,3,1,3,0,1,0,61.29
宜蘭縣,壯圍鄉,新南村,0,1,612,8,620,900,3,1,3,0,1,0,68.89
宜蘭縣,壯圍鄉,東港村,0,1,606,5,611,985,3,1,3,0,1,0,62.03
宜蘭縣,壯圍鄉,復興村,0,1,978,17,995,1582,3,1,3,0,1,0,62.90
宜蘭縣,壯圍鄉,過嶺村,0,1,943,10,953,1584,3,1,3,0,1,0,60.16
宜蘭縣,壯圍鄉,永鎮村,0,1,501,3,504,835,3,1,3,0,1,0,60.36
宜蘭縣,壯圍鄉,忠孝村,0,1,1339,14,1353,2066,3,1,3,0,1,0,65.49
宜蘭縣,壯圍鄉,古亭村,0,1,825,10,835,1277,3,1,3,0,1,0,65.39
宜蘭縣,壯圍鄉,功勞村,0,1,651,3,654,994,3,1,3,0,1,0,65.79
宜蘭縣,壯圍鄉,美城村,0,1,1287,8,1295,1930,3,1,3,0,1,0,67.10
宜蘭縣,壯圍鄉,新社村,0,1,656,7,663,1026,3,1,3,0,1,0,64.62
宜蘭縣,壯圍鄉,大福村,0,1,1166,12,1178,1833,3,1,3,0,1,0,64.27
宜蘭縣,員山鄉,員山村,0,1,2604,27,2631,4275,3,1,3,0,1,0,61.54
宜蘭縣,員山鄉,尚德村,0,1,1080,17,1097,1852,3,1,3,0,1,0,59.23
宜蘭縣,員山鄉,惠好村,0,1,796,6,802,1198,3,1,3,0,1,0,66.94
宜蘭縣,員山鄉,七賢村,0,1,644,9,653,978,3,1,3,0,1,0,66.77
宜蘭縣,員山鄉,深溝村,0,1,800,8,808,1389,3,1,3,0,1,0,58.17
宜蘭縣,員山鄉,蓁巷村,0,1,658,9,667,1139,3,1,3,0,1,0,58.56
宜蘭縣,員山鄉,內城村,0,1,922,19,941,1486,3,1,3,0,1,0,63.32
宜蘭縣,員山鄉,中華村,0,1,426,4,430,740,3,1,3,0,1,0,58.11
宜蘭縣,員山鄉,永和村,0,1,964,11,975,1580,3,1,3,0,1,0,61.71
宜蘭縣,員山鄉,頭分村,0,1,661,10,671,1054,3,1,3,0,1,0,63.66
宜蘭縣,員山鄉,枕山村,0,1,1345,20,1365,2100,3,1,3,0,1,0,65.00
宜蘭縣,員山鄉,同樂村,0,1,1518,14,1532,2394,3,1,3,0,1,0,63.99
宜蘭縣,員山鄉,湖東村,0,1,505,12,517,861,3,1,3,0,1,0,60.05
宜蘭縣,員山鄉,逸仙村,0,1,495,4,499,824,3,1,3,0,1,0,60.56
宜蘭縣,員山鄉,湖北村,0,1,700,6,706,1092,3,1,3,0,1,0,64.65
宜蘭縣,員山鄉,湖西村,0,1,863,4,867,1495,3,1,3,0,1,0,57.99
宜蘭縣,冬山鄉,武淵村,0,1,758,9,767,1101,3,1,3,0,1,0,69.66
宜蘭縣,冬山鄉,珍珠村,0,1,809,8,817,1229,3,1,3,0,1,0,66.48
宜蘭縣,冬山鄉,補城村,0,1,674,6,680,980,3,1,3,0,1,0,69.39
宜蘭縣,冬山鄉,三奇村,0,1,565,4,569,839,3,1,3,0,1,0,67.82
宜蘭縣,冬山鄉,大興村,0,1,664,8,672,935,3,1,3,0,1,0,71.87
宜蘭縣,冬山鄉,東城村,0,1,756,7,763,1145,3,1,3,0,1,0,66.64
宜蘭縣,冬山鄉,香和村,0,1,1302,15,1317,1953,3,1,3,0,1,0,67.43
宜蘭縣,冬山鄉,南興村,0,1,1257,18,1275,1851,3,1,3,0,1,0,68.88
宜蘭縣,冬山鄉,冬山村,0,1,578,5,583,811,3,1,3,0,1,0,71.89
宜蘭縣,冬山鄉,安平村,0,1,479,7,486,711,3,1,3,0,1,0,68.35
宜蘭縣,冬山鄉,太和村,0,1,944,4,948,1265,3,1,3,0,1,0,74.94
宜蘭縣,冬山鄉,八寶村,0,1,538,5,543,796,3,1,3,0,1,0,68.22
宜蘭縣,冬山鄉,丸山村,0,1,830,10,840,1234,3,1,3,0,1,0,68.07
宜蘭縣,冬山鄉,中山村,0,1,293,2,295,428,3,1,3,0,1,0,68.93
宜蘭縣,冬山鄉,順安村,0,1,2509,23,2532,4146,3,1,3,0,1,0,61.07
宜蘭縣,冬山鄉,永美村,0,1,1272,6,1278,1971,3,1,3,0,1,0,64.84
宜蘭縣,冬山鄉,群英村,0,1,2795,47,2842,4440,3,1,3,0,1,0,64.01
宜蘭縣,冬山鄉,清溝村,0,1,1673,12,1685,2667,3,1,3,0,1,0,63.18
宜蘭縣,冬山鄉,鹿埔村,0,1,1391,20,1411,2198,3,1,3,0,1,0,64.19
宜蘭縣,冬山鄉,得安村,0,1,685,10,695,998,3,1,3,0,1,0,69.64
宜蘭縣,冬山鄉,廣興村,0,1,1333,14,1347,2112,3,1,3,0,1,0,63.78
宜蘭縣,冬山鄉,廣安村,0,1,812,4,816,1247,3,1,3,0,1,0,65.44
宜蘭縣,冬山鄉,柯林村,0,1,631,8,639,1018,3,1,3,0,1,0,62.77
宜蘭縣,冬山鄉,大進村,0,1,521,2,523,835,3,1,3,0,1,0,62.63
宜蘭縣,五結鄉,三興村,0,1,1043,10,1053,1588,3,1,3,0,1,0,66.31
宜蘭縣,五結鄉,二結村,0,1,945,11,956,1437,3,1,3,0,1,0,66.53
宜蘭縣,五結鄉,鎮安村,0,1,1339,8,1347,1991,3,1,3,0,1,0,67.65
宜蘭縣,五結鄉,上四村,0,1,906,12,918,1436,3,1,3,0,1,0,63.93
宜蘭縣,五結鄉,中興村,0,1,675,6,681,1071,3,1,3,0,1,0,63.59
宜蘭縣,五結鄉,四結村,0,1,1315,11,1326,2056,3,1,3,0,1,0,64.49
宜蘭縣,五結鄉,福興村,0,1,933,13,946,1457,3,1,3,0,1,0,64.93
宜蘭縣,五結鄉,五結村,0,1,1679,13,1692,2664,3,1,3,0,1,0,63.51
宜蘭縣,五結鄉,大吉村,0,1,1740,17,1757,2673,3,1,3,0,1,0,65.73
宜蘭縣,五結鄉,協和村,0,1,1468,14,1482,2278,3,1,3,0,1,0,65.06
宜蘭縣,五結鄉,孝威村,0,1,861,15,876,1330,3,1,3,0,1,0,65.86
宜蘭縣,五結鄉,錦眾村,0,1,944,11,955,1464,3,1,3,0,1,0,65.23
宜蘭縣,五結鄉,利澤村,0,1,1185,32,1217,1991,3,1,3,0,1,0,61.13
宜蘭縣,五結鄉,成興村,0,1,1483,12,1495,2345,3,1,3,0,1,0,63.75
宜蘭縣,五結鄉,季新村,0,1,1477,17,1494,2461,3,1,3,0,1,0,60.71
宜蘭縣,三星鄉,員山村,0,1,157,1,158,239,3,1,3,0,1,0,66.11
宜蘭縣,三星鄉,天山村,0,1,374,3,377,599,3,1,3,0,1,0,62.94
宜蘭縣,三星鄉,天福村,0,1,462,6,468,781,3,1,3,0,1,0,59.92
宜蘭縣,三星鄉,雙賢村,0,1,411,8,419,675,3,1,3,0,1,0,62.07
宜蘭縣,三星鄉,人和村,0,1,288,6,294,453,3,1,3,0,1,0,64.90
宜蘭縣,三星鄉,義德村,0,1,711,8,719,1098,3,1,3,0,1,0,65.48
宜蘭縣,三星鄉,集慶村,0,1,724,5,729,1152,3,1,3,0,1,0,63.28
宜蘭縣,三星鄉,月眉村,0,1,547,7,554,820,3,1,3,0,1,0,67.56
宜蘭縣,三星鄉,拱照村,0,1,592,2,594,1024,3,1,3,0,1,0,58.01
宜蘭縣,三星鄉,大隱村,0,1,1829,19,1848,3051,3,1,3,0,1,0,60.57
宜蘭縣,三星鄉,行健村,0,1,424,6,430,687,3,1,3,0,1,0,62.59
宜蘭縣,三星鄉,萬德村,0,1,347,3,350,555,3,1,3,0,1,0,63.06
宜蘭縣,三星鄉,貴林村,0,1,285,6,291,497,3,1,3,0,1,0,58.55
宜蘭縣,三星鄉,萬富村,0,1,412,3,415,665,3,1,3,0,1,0,62.41
宜蘭縣,三星鄉,大義村,0,1,628,12,640,1088,3,1,3,0,1,0,58.82
宜蘭縣,三星鄉,尚武村,0,1,511,9,520,807,3,1,3,0,1,0,64.44
宜蘭縣,三星鄉,大洲村,0,1,868,6,874,1237,3,1,3,0,1,0,70.65
宜蘭縣,三星鄉,尾塹村,0,1,725,13,738,1120,3,1,3,0,1,0,65.89
宜蘭縣,大同鄉,寒溪村,0,1,59,0,59,105,3,1,3,0,1,0,56.19
宜蘭縣,大同鄉,崙埤村,0,1,57,1,58,94,3,1,3,0,1,0,61.70
宜蘭縣,大同鄉,松羅村,0,1,152,3,155,226,3,1,3,0,1,0,68.58
宜蘭縣,大同鄉,復興村,0,1,137,1,138,241,3,1,3,0,1,0,57.26
宜蘭縣,大同鄉,英士村,0,1,43,0,43,80,3,1,3,0,1,0,53.75
宜蘭縣,大同鄉,樂水村,0,1,29,3,32,57,3,1,3,0,1,0,56.14
宜蘭縣,大同鄉,太平村,0,1,37,0,37,53,3,1,3,0,1,0,69.81
宜蘭縣,大同鄉,茂安村,0,1,18,0,18,23,3,1,3,0,1,0,78.26
宜蘭縣,大同鄉,四季村,0,1,27,0,27,55,3,1,3,0,1,0,49.09
宜蘭縣,大同鄉,南山村,0,1,49,1,50,79,3,1,3,0,1,0,63.29
宜蘭縣,南澳鄉,東岳村,0,1,47,1,48,81,3,1,3,0,1,0,59.26
宜蘭縣,南澳鄉,南澳村,0,1,132,3,135,236,3,1,3,0,1,0,57.20
宜蘭縣,南澳鄉,碧候村,0,1,43,1,44,92,3,1,3,0,1,0,47.83
宜蘭縣,南澳鄉,金岳村,0,1,30,1,31,53,3,1,3,0,1,0,58.49
宜蘭縣,南澳鄉,武塔村,0,1,51,1,52,125,3,1,3,0,1,0,41.60
宜蘭縣,南澳鄉,金洋村,0,1,11,0,11,26,3,1,3,0,1,0,42.31
宜蘭縣,南澳鄉,澳花村,0,1,74,4,78,150,3,1,3,0,1,0,52.00
桃園縣,桃園市,大林里,0,1,3242,40,3282,4848,3,1,3,0,1,0,67.70
桃園縣,桃園市,雲林里,0,1,2438,29,2467,3632,3,1,3,0,1,0,67.92
桃園縣,桃園市,大豐里,0,1,2598,38,2636,3836,3,1,3,0,1,0,68.72
桃園縣,桃園市,福林里,0,1,2984,31,3015,4322,3,1,3,0,1,0,69.76
桃園縣,桃園市,福安里,0,1,2039,21,2060,2961,3,1,3,0,1,0,69.57
桃園縣,桃園市,豐林里,0,1,3342,50,3392,4857,3,1,3,0,1,0,69.84
桃園縣,桃園市,建國里,0,1,2676,26,2702,4040,3,1,3,0,1,0,66.88
桃園縣,桃園市,東門里,0,1,1632,18,1650,2479,3,1,3,0,1,0,66.56
桃園縣,桃園市,東山里,0,1,1237,10,1247,1810,3,1,3,0,1,0,68.90
桃園縣,桃園市,萬壽里,0,1,558,9,567,900,3,1,3,0,1,0,63.00
桃園縣,桃園市,武陵里,0,1,976,4,980,1524,3,1,3,0,1,0,64.30
桃園縣,桃園市,民生里,0,1,986,16,1002,1402,3,1,3,0,1,0,71.47
桃園縣,桃園市,文化里,0,1,535,3,538,814,3,1,3,0,1,0,66.09
桃園縣,桃園市,文明里,0,1,971,12,983,1441,3,1,3,0,1,0,68.22
桃園縣,桃園市,文昌里,0,1,657,9,666,943,3,1,3,0,1,0,70.63
桃園縣,桃園市,南門里,0,1,3047,33,3080,4590,3,1,3,0,1,0,67.10
桃園縣,桃園市,南華里,0,1,976,6,982,1360,3,1,3,0,1,0,72.21
桃園縣,桃園市,西門里,0,1,881,9,890,1334,3,1,3,0,1,0,66.72
桃園縣,桃園市,西湖里,0,1,853,9,862,1239,3,1,3,0,1,0,69.57
桃園縣,桃園市,長美里,0,1,642,3,645,936,3,1,3,0,1,0,68.91
桃園縣,桃園市,永興里,0,1,1231,11,1242,1735,3,1,3,0,1,0,71.59
桃園縣,桃園市,中興里,0,1,3125,35,3160,4461,3,1,3,0,1,0,70.84
桃園縣,桃園市,光興里,0,1,2906,38,2944,4472,3,1,3,0,1,0,65.83
桃園縣,桃園市,中路里,0,1,1913,17,1930,2864,3,1,3,0,1,0,67.39
桃園縣,桃園市,中信里,0,1,2303,27,2330,3453,3,1,3,0,1,0,67.48
桃園縣,桃園市,中山里,0,1,2603,36,2639,4002,3,1,3,0,1,0,65.94
桃園縣,桃園市,中平里,0,1,2097,26,2123,3237,3,1,3,0,1,0,65.59
桃園縣,桃園市,中原里,0,1,1700,17,1717,2504,3,1,3,0,1,0,68.57
桃園縣,桃園市,中泰里,0,1,3252,36,3288,5127,3,1,3,0,1,0,64.13
桃園縣,桃園市,中德里,0,1,2697,33,2730,4010,3,1,3,0,1,0,68.08
桃園縣,桃園市,中正里,0,1,2666,27,2693,3882,3,1,3,0,1,0,69.37
桃園縣,桃園市,文中里,0,1,1716,23,1739,2502,3,1,3,0,1,0,69.50
桃園縣,桃園市,中成里,0,1,2229,23,2252,3373,3,1,3,0,1,0,66.77
桃園縣,桃園市,玉山里,0,1,2701,39,2740,4127,3,1,3,0,1,0,66.39
桃園縣,桃園市,泰山里,0,1,1971,27,1998,2861,3,1,3,0,1,0,69.84
桃園縣,桃園市,龍岡里,0,1,2178,26,2204,3177,3,1,3,0,1,0,69.37
桃園縣,桃園市,龍安里,0,1,1385,16,1401,2120,3,1,3,0,1,0,66.08
桃園縣,桃園市,龍鳳里,0,1,2466,31,2497,3821,3,1,3,0,1,0,65.35
桃園縣,桃園市,龍祥里,0,1,3267,46,3313,5080,3,1,3,0,1,0,65.22
桃園縣,桃園市,龍山里,0,1,2264,18,2282,3345,3,1,3,0,1,0,68.22
桃園縣,桃園市,東埔里,0,1,2599,44,2643,3914,3,1,3,0,1,0,67.53
桃園縣,桃園市,信光里,0,1,2592,31,2623,3963,3,1,3,0,1,0,66.19
桃園縣,桃園市,永安里,0,1,2516,32,2548,3764,3,1,3,0,1,0,67.69
桃園縣,桃園市,中寧里,0,1,3694,50,3744,5711,3,1,3,0,1,0,65.56
桃園縣,桃園市,中埔里,0,1,1385,19,1404,1928,3,1,3,0,1,0,72.82
桃園縣,桃園市,南埔里,0,1,1683,23,1706,2605,3,1,3,0,1,0,65.49
桃園縣,桃園市,寶慶里,0,1,2819,31,2850,4405,3,1,3,0,1,0,64.70
桃園縣,桃園市,北埔里,0,1,3304,34,3338,5352,3,1,3,0,1,0,62.37
桃園縣,桃園市,西埔里,0,1,1700,24,1724,2275,3,1,3,0,1,0,75.78
桃園縣,桃園市,慈文里,0,1,2699,24,2723,4154,3,1,3,0,1,0,65.55
桃園縣,桃園市,新埔里,0,1,3259,41,3300,4763,3,1,3,0,1,0,69.28
桃園縣,桃園市,同安里,0,1,2619,28,2647,3884,3,1,3,0,1,0,68.15
桃園縣,桃園市,莊敬里,0,1,2517,30,2547,3921,3,1,3,0,1,0,64.96
桃園縣,桃園市,自強里,0,1,2759,32,2791,4163,3,1,3,0,1,0,67.04
桃園縣,桃園市,長安里,0,1,1752,22,1774,2687,3,1,3,0,1,0,66.02
桃園縣,桃園市,長德里,0,1,2018,20,2038,3014,3,1,3,0,1,0,67.62
桃園縣,桃園市,中和里,0,1,992,10,1002,1367,3,1,3,0,1,0,73.30
桃園縣,桃園市,北門里,0,1,1066,15,1081,1614,3,1,3,0,1,0,66.98
桃園縣,桃園市,朝陽里,0,1,1151,15,1166,1738,3,1,3,0,1,0,67.09
桃園縣,桃園市,青溪里,0,1,2850,36,2886,4187,3,1,3,0,1,0,68.93
桃園縣,桃園市,成功里,0,1,2237,25,2262,3217,3,1,3,0,1,0,70.31
桃園縣,桃園市,三民里,0,1,2336,25,2361,3417,3,1,3,0,1,0,69.10
桃園縣,桃園市,忠義里,0,1,3626,50,3676,5634,3,1,3,0,1,0,65.25
桃園縣,桃園市,大興里,0,1,3177,36,3213,4974,3,1,3,0,1,0,64.60
桃園縣,桃園市,會稽里,0,1,2716,34,2750,4552,3,1,3,0,1,0,60.41
桃園縣,桃園市,大有里,0,1,1295,10,1305,2221,3,1,3,0,1,0,58.76
桃園縣,桃園市,寶山里,0,1,2143,30,2173,3437,3,1,3,0,1,0,63.22
桃園縣,桃園市,春日里,0,1,2241,26,2267,3553,3,1,3,0,1,0,63.81
桃園縣,桃園市,汴洲里,0,1,2199,36,2235,3138,3,1,3,0,1,0,71.22
桃園縣,龜山鄉,龜山村,0,1,3176,58,3234,4674,3,1,3,0,1,0,69.19
桃園縣,龜山鄉,新路村,0,1,3607,46,3653,5149,3,1,3,0,1,0,70.95
桃園縣,龜山鄉,大同村,0,1,2715,50,2765,4055,3,1,3,0,1,0,68.19
桃園縣,龜山鄉,中興村,0,1,3244,61,3305,4988,3,1,3,0,1,0,66.26
桃園縣,龜山鄉,陸光村,0,1,547,8,555,812,3,1,3,0,1,0,68.35
桃園縣,龜山鄉,精忠村,0,1,1290,9,1299,1744,3,1,3,0,1,0,74.48
桃園縣,龜山鄉,福源村,0,1,1088,20,1108,1705,3,1,3,0,1,0,64.99
桃園縣,龜山鄉,兔坑村,0,1,1111,16,1127,2012,3,1,3,0,1,0,56.01
桃園縣,龜山鄉,迴龍村,0,1,2191,35,2226,3802,3,1,3,0,1,0,58.55
桃園縣,龜山鄉,龍華村,0,1,1440,29,1469,2406,3,1,3,0,1,0,61.06
桃園縣,龜山鄉,龍壽村,0,1,924,15,939,1459,3,1,3,0,1,0,64.36
桃園縣,龜山鄉,嶺頂村,0,1,1760,28,1788,2977,3,1,3,0,1,0,60.06
桃園縣,龜山鄉,新嶺村,0,1,1594,39,1633,2796,3,1,3,0,1,0,58.40
桃園縣,龜山鄉,舊路村,0,1,1207,18,1225,1837,3,1,3,0,1,0,66.68
桃園縣,龜山鄉,山德村,0,1,3046,36,3082,4688,3,1,3,0,1,0,65.74
桃園縣,龜山鄉,山頂村,0,1,2243,29,2272,3835,3,1,3,0,1,0,59.24
桃園縣,龜山鄉,山福村,0,1,1757,32,1789,2742,3,1,3,0,1,0,65.24
桃園縣,龜山鄉,幸福村,0,1,2482,51,2533,4007,3,1,3,0,1,0,63.21
桃園縣,龜山鄉,大崗村,0,1,3797,39,3836,6347,3,1,3,0,1,0,60.44
桃園縣,龜山鄉,公西村,0,1,1408,32,1440,2275,3,1,3,0,1,0,63.30
桃園縣,龜山鄉,文化村,0,1,1314,20,1334,2358,3,1,3,0,1,0,56.57
桃園縣,龜山鄉,樂善村,0,1,2761,60,2821,4667,3,1,3,0,1,0,60.45
桃園縣,龜山鄉,大坑村,0,1,832,8,840,1289,3,1,3,0,1,0,65.17
桃園縣,龜山鄉,南上村,0,1,822,12,834,1248,3,1,3,0,1,0,66.83
桃園縣,龜山鄉,南美村,0,1,786,10,796,1226,3,1,3,0,1,0,64.93
桃園縣,龜山鄉,楓樹村,0,1,1822,31,1853,2749,3,1,3,0,1,0,67.41
桃園縣,八德市,興仁里,0,1,2075,35,2110,3238,3,1,3,0,1,0,65.16
桃園縣,八德市,福興里,0,1,1908,56,1964,2739,3,1,3,0,1,0,71.71
桃園縣,八德市,瑞豐里,0,1,2180,59,2239,3190,3,1,3,0,1,0,70.19
桃園縣,八德市,瑞泰里,0,1,1830,30,1860,2779,3,1,3,0,1,0,66.93
桃園縣,八德市,瑞發里,0,1,2097,46,2143,3076,3,1,3,0,1,0,69.67
桃園縣,八德市,瑞德里,0,1,2157,36,2193,2960,3,1,3,0,1,0,74.09
桃園縣,八德市,瑞祥里,0,1,1949,38,1987,2803,3,1,3,0,1,0,70.89
桃園縣,八德市,廣興里,0,1,3096,67,3163,4581,3,1,3,0,1,0,69.05
桃園縣,八德市,廣隆里,0,1,1999,40,2039,2810,3,1,3,0,1,0,72.56
桃園縣,八德市,竹園里,0,1,1782,40,1822,2691,3,1,3,0,1,0,67.71
桃園縣,八德市,霄裡里,0,1,2656,59,2715,3733,3,1,3,0,1,0,72.73
桃園縣,八德市,茄明里,0,1,1733,24,1757,2749,3,1,3,0,1,0,63.91
桃園縣,八德市,茄苳里,0,1,2655,44,2699,3989,3,1,3,0,1,0,67.66
桃園縣,八德市,高明里,0,1,1887,39,1926,2920,3,1,3,0,1,0,65.96
桃園縣,八德市,高城里,0,1,1306,23,1329,1919,3,1,3,0,1,0,69.25
桃園縣,八德市,白鷺里,0,1,1535,24,1559,2285,3,1,3,0,1,0,68.23
桃園縣,八德市,大湳里,0,1,1554,28,1582,2507,3,1,3,0,1,0,63.10
桃園縣,八德市,大發里,0,1,1047,35,1082,1584,3,1,3,0,1,0,68.31
桃園縣,八德市,大仁里,0,1,2038,42,2080,3021,3,1,3,0,1,0,68.85
桃園縣,八德市,大明里,0,1,1313,26,1339,1986,3,1,3,0,1,0,67.42
桃園縣,八德市,大安里,0,1,1514,21,1535,2273,3,1,3,0,1,0,67.53
桃園縣,八德市,大竹里,0,1,969,14,983,1424,3,1,3,0,1,0,69.03
桃園縣,八德市,大興里,0,1,2687,55,2742,3949,3,1,3,0,1,0,69.44
桃園縣,八德市,大華里,0,1,2505,41,2546,3714,3,1,3,0,1,0,68.55
桃園縣,八德市,大和里,0,1,1690,22,1712,2527,3,1,3,0,1,0,67.75
桃園縣,八德市,大昌里,0,1,1775,25,1800,2574,3,1,3,0,1,0,69.93
桃園縣,八德市,大同里,0,1,1791,29,1820,2415,3,1,3,0,1,0,75.36
桃園縣,八德市,大慶里,0,1,919,11,930,1336,3,1,3,0,1,0,69.61
桃園縣,八德市,大成里,0,1,2351,45,2396,3343,3,1,3,0,1,0,71.67
桃園縣,八德市,大義里,0,1,2019,38,2057,3016,3,1,3,0,1,0,68.20
桃園縣,八德市,大忠里,0,1,1210,23,1233,1805,3,1,3,0,1,0,68.31
桃園縣,八德市,大智里,0,1,2974,45,3019,4267,3,1,3,0,1,0,70.75
桃園縣,八德市,大正里,0,1,1776,18,1794,2531,3,1,3,0,1,0,70.88
桃園縣,八德市,大福里,0,1,2218,22,2240,3247,3,1,3,0,1,0,68.99
桃園縣,八德市,大強里,0,1,1620,41,1661,2443,3,1,3,0,1,0,67.99
桃園縣,八德市,大勇里,0,1,1435,21,1456,2167,3,1,3,0,1,0,67.19
桃園縣,八德市,大榮里,0,1,967,17,984,1472,3,1,3,0,1,0,66.85
桃園縣,八德市,大千里,0,1,2565,58,2623,3866,3,1,3,0,1,0,67.85
桃園縣,八德市,大信里,0,1,2935,121,3056,5350,3,1,3,0,1,0,57.12
桃園縣,蘆竹鄉,新興村,0,1,2130,41,2171,3126,3,1,3,0,1,0,69.45
桃園縣,蘆竹鄉,中福村,0,1,2161,32,2193,3159,3,1,3,0,1,0,69.42
桃園縣,蘆竹鄉,新莊村,0,1,2011,33,2044,2839,3,1,3,0,1,0,72.00
桃園縣,蘆竹鄉,上竹村,0,1,1392,23,1415,2051,3,1,3,0,1,0,68.99
桃園縣,蘆竹鄉,宏竹村,0,1,1453,30,1483,2099,3,1,3,0,1,0,70.65
桃園縣,蘆竹鄉,大竹村,0,1,1751,22,1773,2542,3,1,3,0,1,0,69.75
桃園縣,蘆竹鄉,富竹村,0,1,744,7,751,1036,3,1,3,0,1,0,72.49
桃園縣,蘆竹鄉,大華村,0,1,1230,22,1252,1655,3,1,3,0,1,0,75.65
桃園縣,蘆竹鄉,蘆竹村,0,1,2091,28,2119,2841,3,1,3,0,1,0,74.59
桃園縣,蘆竹鄉,南興村,0,1,4266,62,4328,6992,3,1,3,0,1,0,61.90
桃園縣,蘆竹鄉,南榮村,0,1,1386,23,1409,2252,3,1,3,0,1,0,62.57
桃園縣,蘆竹鄉,南崁村,0,1,1552,32,1584,2432,3,1,3,0,1,0,65.13
桃園縣,蘆竹鄉,錦興村,0,1,1773,24,1797,2669,3,1,3,0,1,0,67.33
桃園縣,蘆竹鄉,錦中村,0,1,1143,15,1158,1750,3,1,3,0,1,0,66.17
桃園縣,蘆竹鄉,長興村,0,1,1009,21,1030,1608,3,1,3,0,1,0,64.05
桃園縣,蘆竹鄉,五福村,0,1,1870,17,1887,3041,3,1,3,0,1,0,62.05
桃園縣,蘆竹鄉,羊稠村,0,1,2736,22,2758,4322,3,1,3,0,1,0,63.81
桃園縣,蘆竹鄉,營盤村,0,1,1857,26,1883,2996,3,1,3,0,1,0,62.85
桃園縣,蘆竹鄉,瓦窯村,0,1,794,10,804,1458,3,1,3,0,1,0,55.14
桃園縣,蘆竹鄉,內厝村,0,1,1260,28,1288,1822,3,1,3,0,1,0,70.69
桃園縣,蘆竹鄉,山鼻村,0,1,954,16,970,1388,3,1,3,0,1,0,69.88
桃園縣,蘆竹鄉,山腳村,0,1,2124,46,2170,3112,3,1,3,0,1,0,69.73
桃園縣,蘆竹鄉,外社村,0,1,889,16,905,1241,3,1,3,0,1,0,72.93
桃園縣,蘆竹鄉,坑子村,0,1,1109,23,1132,1568,3,1,3,0,1,0,72.19
桃園縣,蘆竹鄉,坑口村,0,1,1437,23,1460,2085,3,1,3,0,1,0,70.02
桃園縣,蘆竹鄉,海湖村,0,1,2201,31,2232,3598,3,1,3,0,1,0,62.03
桃園縣,大園鄉,大園村,0,1,3570,55,3625,4911,3,1,3,0,1,0,73.81
桃園縣,大園鄉,田心村,0,1,2781,44,2825,4049,3,1,3,0,1,0,69.77
桃園縣,大園鄉,溪海村,0,1,2088,35,2123,3058,3,1,3,0,1,0,69.42
桃園縣,大園鄉,和平村,0,1,987,9,996,1383,3,1,3,0,1,0,72.02
桃園縣,大園鄉,橫峰村,0,1,3218,38,3256,4757,3,1,3,0,1,0,68.45
桃園縣,大園鄉,五權村,0,1,2510,46,2556,3628,3,1,3,0,1,0,70.45
桃園縣,大園鄉,埔心村,0,1,2877,41,2918,4167,3,1,3,0,1,0,70.03
桃園縣,大園鄉,大海村,0,1,934,19,953,1258,3,1,3,0,1,0,75.76
桃園縣,大園鄉,建華村,0,1,681,14,695,939,3,1,3,0,1,0,74.01
桃園縣,大園鄉,三石村,0,1,1742,30,1772,2429,3,1,3,0,1,0,72.95
桃園縣,大園鄉,菓林村,0,1,2732,57,2789,4157,3,1,3,0,1,0,67.09
桃園縣,大園鄉,竹圍村,0,1,1493,12,1505,2206,3,1,3,0,1,0,68.22
桃園縣,大園鄉,海口村,0,1,864,15,879,1333,3,1,3,0,1,0,65.94
桃園縣,大園鄉,沙崙村,0,1,1642,22,1664,2492,3,1,3,0,1,0,66.77
桃園縣,大園鄉,后厝村,0,1,1156,12,1168,1627,3,1,3,0,1,0,71.79
桃園縣,大園鄉,圳頭村,0,1,1313,20,1333,1881,3,1,3,0,1,0,70.87
桃園縣,大園鄉,內海村,0,1,1218,17,1235,1714,3,1,3,0,1,0,72.05
桃園縣,大園鄉,北港村,0,1,1467,13,1480,2199,3,1,3,0,1,0,67.30
桃園縣,大園鄉,南港村,0,1,1434,20,1454,2469,3,1,3,0,1,0,58.89
桃園縣,大溪鎮,興和里,0,1,1184,15,1199,1631,3,1,3,0,1,0,73.51
桃園縣,大溪鎮,福仁里,0,1,750,4,754,1111,3,1,3,0,1,0,67.87
桃園縣,大溪鎮,田心里,0,1,2359,31,2390,3524,3,1,3,0,1,0,67.82
桃園縣,大溪鎮,一心里,0,1,2149,22,2171,3133,3,1,3,0,1,0,69.29
桃園縣,大溪鎮,一德里,0,1,2554,32,2586,3797,3,1,3,0,1,0,68.11
桃園縣,大溪鎮,月眉里,0,1,733,12,745,1012,3,1,3,0,1,0,73.62
桃園縣,大溪鎮,永福里,0,1,574,19,593,898,3,1,3,0,1,0,66.04
桃園縣,大溪鎮,康安里,0,1,708,11,719,995,3,1,3,0,1,0,72.26
桃園縣,大溪鎮,義和里,0,1,1090,16,1106,1545,3,1,3,0,1,0,71.59
桃園縣,大溪鎮,美華里,0,1,1815,14,1829,2633,3,1,3,0,1,0,69.46
桃園縣,大溪鎮,福安里,0,1,1411,29,1440,2110,3,1,3,0,1,0,68.25
桃園縣,大溪鎮,復興里,0,1,604,12,616,916,3,1,3,0,1,0,67.25
桃園縣,大溪鎮,新峰里,0,1,607,12,619,940,3,1,3,0,1,0,65.85
桃園縣,大溪鎮,中新里,0,1,1105,23,1128,1542,3,1,3,0,1,0,73.15
桃園縣,大溪鎮,瑞興里,0,1,1420,25,1445,2041,3,1,3,0,1,0,70.80
桃園縣,大溪鎮,仁善里,0,1,1576,26,1602,2352,3,1,3,0,1,0,68.11
桃園縣,大溪鎮,僑愛里,0,1,580,7,587,821,3,1,3,0,1,0,71.50
桃園縣,大溪鎮,仁義里,0,1,1917,39,1956,2641,3,1,3,0,1,0,74.06
桃園縣,大溪鎮,仁和里,0,1,1225,22,1247,1928,3,1,3,0,1,0,64.68
桃園縣,大溪鎮,仁愛里,0,1,1218,14,1232,1770,3,1,3,0,1,0,69.60
桃園縣,大溪鎮,仁武里,0,1,1823,21,1844,2535,3,1,3,0,1,0,72.74
桃園縣,大溪鎮,仁文里,0,1,1914,34,1948,2819,3,1,3,0,1,0,69.10
桃園縣,大溪鎮,南興里,0,1,2594,42,2636,3765,3,1,3,0,1,0,70.01
桃園縣,大溪鎮,員林里,0,1,770,11,781,1127,3,1,3,0,1,0,69.30
桃園縣,大溪鎮,光明里,0,1,1127,22,1149,1740,3,1,3,0,1,0,66.03
桃園縣,大溪鎮,瑞源里,0,1,1960,32,1992,2863,3,1,3,0,1,0,69.58
桃園縣,大溪鎮,三元里,0,1,2004,24,2028,2922,3,1,3,0,1,0,69.40
桃園縣,復興鄉,三民村,0,1,779,18,797,1168,3,1,3,0,1,0,68.24
桃園縣,復興鄉,澤仁村,0,1,451,5,456,638,3,1,3,0,1,0,71.47
桃園縣,復興鄉,霞雲村,0,1,30,2,32,45,3,1,3,0,1,0,71.11
桃園縣,復興鄉,義盛村,0,1,29,1,30,45,3,1,3,0,1,0,66.67
桃園縣,復興鄉,羅浮村,0,1,191,3,194,310,3,1,3,0,1,0,62.58
桃園縣,復興鄉,奎輝村,0,1,19,0,19,43,3,1,3,0,1,0,44.19
桃園縣,復興鄉,長興村,0,1,62,2,64,95,3,1,3,0,1,0,67.37
桃園縣,復興鄉,高義村,0,1,27,1,28,50,3,1,3,0,1,0,56.00
桃園縣,復興鄉,三光村,0,1,22,0,22,46,3,1,3,0,1,0,47.83
桃園縣,復興鄉,華陵村,0,1,158,2,160,301,3,1,3,0,1,0,53.16
桃園縣,中壢市,後寮里,0,1,1915,23,1938,2990,3,1,3,0,1,0,64.82
桃園縣,中壢市,明德里,0,1,2156,25,2181,3145,3,1,3,0,1,0,69.35
桃園縣,中壢市,至善里,0,1,2648,39,2687,4047,3,1,3,0,1,0,66.39
桃園縣,中壢市,龍興里,0,1,2338,33,2371,3373,3,1,3,0,1,0,70.29
桃園縣,中壢市,龍德里,0,1,1950,31,1981,2744,3,1,3,0,1,0,72.19
桃園縣,中壢市,龍岡里,0,1,2572,40,2612,3695,3,1,3,0,1,0,70.69
桃園縣,中壢市,龍東里,0,1,2861,56,2917,4051,3,1,3,0,1,0,72.01
桃園縣,中壢市,龍昌里,0,1,3006,71,3077,4335,3,1,3,0,1,0,70.98
桃園縣,中壢市,龍平里,0,1,2051,36,2087,2846,3,1,3,0,1,0,73.33
桃園縣,中壢市,龍安里,0,1,1751,29,1780,2396,3,1,3,0,1,0,74.29
桃園縣,中壢市,仁美里,0,1,2299,37,2336,3259,3,1,3,0,1,0,71.68
桃園縣,中壢市,仁福里,0,1,2410,39,2449,3532,3,1,3,0,1,0,69.34
桃園縣,中壢市,仁愛里,0,1,2614,44,2658,3754,3,1,3,0,1,0,70.80
桃園縣,中壢市,仁德里,0,1,3040,50,3090,4450,3,1,3,0,1,0,69.44
桃園縣,中壢市,仁祥里,0,1,1759,27,1786,2574,3,1,3,0,1,0,69.39
桃園縣,中壢市,華勛里,0,1,1977,31,2008,2753,3,1,3,0,1,0,72.94
桃園縣,中壢市,中堅里,0,1,2790,67,2857,4025,3,1,3,0,1,0,70.98
桃園縣,中壢市,普仁里,0,1,2038,36,2074,3105,3,1,3,0,1,0,66.80
桃園縣,中壢市,普忠里,0,1,1480,16,1496,2328,3,1,3,0,1,0,64.26
桃園縣,中壢市,普強里,0,1,1981,23,2004,2723,3,1,3,0,1,0,73.60
桃園縣,中壢市,信義里,0,1,2062,22,2084,2910,3,1,3,0,1,0,71.62
桃園縣,中壢市,正義里,0,1,2197,33,2230,3182,3,1,3,0,1,0,70.08
桃園縣,中壢市,普慶里,0,1,1631,21,1652,2251,3,1,3,0,1,0,73.39
桃園縣,中壢市,普義里,0,1,1218,21,1239,1783,3,1,3,0,1,0,69.49
桃園縣,中壢市,德義里,0,1,1507,18,1525,2185,3,1,3,0,1,0,69.79
桃園縣,中壢市,仁義里,0,1,1551,27,1578,2325,3,1,3,0,1,0,67.87
桃園縣,中壢市,忠義里,0,1,1013,15,1028,1476,3,1,3,0,1,0,69.65
桃園縣,中壢市,興仁里,0,1,2543,32,2575,3644,3,1,3,0,1,0,70.66
桃園縣,中壢市,中正里,0,1,2249,31,2280,3348,3,1,3,0,1,0,68.10
桃園縣,中壢市,中山里,0,1,2864,42,2906,4395,3,1,3,0,1,0,66.12
桃園縣,中壢市,篤行里,0,1,1067,14,1081,1572,3,1,3,0,1,0,68.77
桃園縣,中壢市,自立里,0,1,1655,18,1673,2474,3,1,3,0,1,0,67.62
桃園縣,中壢市,自強里,0,1,3073,43,3116,4554,3,1,3,0,1,0,68.42
桃園縣,中壢市,內壢里,0,1,1618,27,1645,2406,3,1,3,0,1,0,68.37
桃園縣,中壢市,成功里,0,1,1874,21,1895,2761,3,1,3,0,1,0,68.63
桃園縣,中壢市,福德里,0,1,1739,21,1760,2461,3,1,3,0,1,0,71.52
桃園縣,中壢市,中原里,0,1,2534,44,2578,3597,3,1,3,0,1,0,71.67
桃園縣,中壢市,忠孝里,0,1,1337,25,1362,1945,3,1,3,0,1,0,70.03
桃園縣,中壢市,復興里,0,1,2616,36,2652,4040,3,1,3,0,1,0,65.64
桃園縣,中壢市,復華里,0,1,2354,32,2386,3308,3,1,3,0,1,0,72.13
桃園縣,中壢市,文化里,0,1,3058,47,3105,4477,3,1,3,0,1,0,69.35
桃園縣,中壢市,和平里,0,1,1302,24,1326,1884,3,1,3,0,1,0,70.38
桃園縣,中壢市,內定里,0,1,2163,25,2188,3077,3,1,3,0,1,0,71.11
桃園縣,中壢市,石頭里,0,1,1146,14,1160,2023,3,1,3,0,1,0,57.34
桃園縣,中壢市,中央里,0,1,2276,27,2303,3312,3,1,3,0,1,0,69.54
桃園縣,中壢市,新興里,0,1,3747,57,3804,5616,3,1,3,0,1,0,67.74
桃園縣,中壢市,振興里,0,1,2646,35,2681,3791,3,1,3,0,1,0,70.72
桃園縣,中壢市,東興里,0,1,3594,53,3647,5227,3,1,3,0,1,0,69.77
桃園縣,中壢市,水尾里,0,1,3390,42,3432,4868,3,1,3,0,1,0,70.50
桃園縣,中壢市,忠福里,0,1,3510,61,3571,5018,3,1,3,0,1,0,71.16
桃園縣,中壢市,幸福里,0,1,2566,24,2590,3906,3,1,3,0,1,0,66.31
桃園縣,中壢市,永福里,0,1,2707,30,2737,3992,3,1,3,0,1,0,68.56
桃園縣,中壢市,青埔里,0,1,762,9,771,1088,3,1,3,0,1,0,70.86
桃園縣,中壢市,新街里,0,1,1251,6,1257,1858,3,1,3,0,1,0,67.65
桃園縣,中壢市,興南里,0,1,1091,8,1099,1640,3,1,3,0,1,0,67.01
桃園縣,中壢市,興國里,0,1,3087,36,3123,4499,3,1,3,0,1,0,69.42
桃園縣,中壢市,興和里,0,1,1747,16,1763,2456,3,1,3,0,1,0,71.78
桃園縣,中壢市,永興里,0,1,707,16,723,1014,3,1,3,0,1,0,71.30
桃園縣,中壢市,中壢里,0,1,590,6,596,838,3,1,3,0,1,0,71.12
桃園縣,中壢市,中榮里,0,1,654,5,659,996,3,1,3,0,1,0,66.16
桃園縣,中壢市,中建里,0,1,715,6,721,1100,3,1,3,0,1,0,65.55
桃園縣,中壢市,舊明里,0,1,1520,18,1538,2127,3,1,3,0,1,0,72.31
桃園縣,中壢市,新明里,0,1,2471,37,2508,3530,3,1,3,0,1,0,71.05
桃園縣,中壢市,光明里,0,1,2937,37,2974,4319,3,1,3,0,1,0,68.86
桃園縣,中壢市,永光里,0,1,2199,26,2225,3183,3,1,3,0,1,0,69.90
桃園縣,中壢市,三民里,0,1,1747,34,1781,2501,3,1,3,0,1,0,71.21
桃園縣,中壢市,五權里,0,1,2604,44,2648,3930,3,1,3,0,1,0,67.38
桃園縣,中壢市,五福里,0,1,2182,25,2207,3213,3,1,3,0,1,0,68.69
桃園縣,中壢市,芝芭里,0,1,1405,21,1426,1961,3,1,3,0,1,0,72.72
桃園縣,中壢市,洽溪里,0,1,818,12,830,1216,3,1,3,0,1,0,68.26
桃園縣,中壢市,內厝里,0,1,2341,22,2363,3395,3,1,3,0,1,0,69.60
桃園縣,中壢市,月眉里,0,1,2172,29,2201,2987,3,1,3,0,1,0,73.69
桃園縣,中壢市,山東里,0,1,1956,38,1994,2737,3,1,3,0,1,0,72.85
桃園縣,中壢市,過嶺里,0,1,1711,20,1731,2322,3,1,3,0,1,0,74.55
桃園縣,平鎮市,新勢里,0,1,2300,39,2339,3372,3,1,3,0,1,0,69.37
桃園縣,平鎮市,新榮里,0,1,2487,38,2525,3749,3,1,3,0,1,0,67.35
桃園縣,平鎮市,新富里,0,1,3144,34,3178,4724,3,1,3,0,1,0,67.27
桃園縣,平鎮市,新貴里,0,1,1784,26,1810,2523,3,1,3,0,1,0,71.74
桃園縣,平鎮市,北安里,0,1,1116,13,1129,1574,3,1,3,0,1,0,71.73
桃園縣,平鎮市,北勢里,0,1,1564,29,1593,2285,3,1,3,0,1,0,69.72
桃園縣,平鎮市,北華里,0,1,1538,25,1563,2217,3,1,3,0,1,0,70.50
桃園縣,平鎮市,金陵里,0,1,1166,17,1183,1597,3,1,3,0,1,0,74.08
桃園縣,平鎮市,北興里,0,1,2418,36,2454,3462,3,1,3,0,1,0,70.88
桃園縣,平鎮市,北貴里,0,1,2017,37,2054,2878,3,1,3,0,1,0,71.37
桃園縣,平鎮市,北富里,0,1,2054,30,2084,2942,3,1,3,0,1,0,70.84
桃園縣,平鎮市,龍恩里,0,1,1693,32,1725,2520,3,1,3,0,1,0,68.45
桃園縣,平鎮市,東社里,0,1,2147,24,2171,3043,3,1,3,0,1,0,71.34
桃園縣,平鎮市,龍興里,0,1,1497,32,1529,2157,3,1,3,0,1,0,70.89
桃園縣,平鎮市,忠貞里,0,1,893,26,919,1282,3,1,3,0,1,0,71.68
桃園縣,平鎮市,中正里,0,1,899,16,915,1264,3,1,3,0,1,0,72.39
桃園縣,平鎮市,貿易里,0,1,1655,15,1670,2223,3,1,3,0,1,0,75.12
桃園縣,平鎮市,建安里,0,1,2272,45,2317,3277,3,1,3,0,1,0,70.70
桃園縣,平鎮市,華安里,0,1,2157,27,2184,3053,3,1,3,0,1,0,71.54
桃園縣,平鎮市,新安里,0,1,1887,30,1917,2809,3,1,3,0,1,0,68.24
桃園縣,平鎮市,東安里,0,1,1507,31,1538,2145,3,1,3,0,1,0,71.70
桃園縣,平鎮市,東勢里,0,1,2556,47,2603,3683,3,1,3,0,1,0,70.68
桃園縣,平鎮市,莊敬里,0,1,2695,49,2744,3875,3,1,3,0,1,0,70.81
桃園縣,平鎮市,福林里,0,1,1373,20,1393,1942,3,1,3,0,1,0,71.73
桃園縣,平鎮市,山峰里,0,1,1573,28,1601,2209,3,1,3,0,1,0,72.48
桃園縣,平鎮市,湧豐里,0,1,936,16,952,1365,3,1,3,0,1,0,69.74
桃園縣,平鎮市,湧光里,0,1,3035,37,3072,4369,3,1,3,0,1,0,70.31
桃園縣,平鎮市,湧安里,0,1,1785,48,1833,2729,3,1,3,0,1,0,67.17
桃園縣,平鎮市,廣興里,0,1,2503,35,2538,3695,3,1,3,0,1,0,68.69
桃園縣,平鎮市,廣達里,0,1,2016,29,2045,2952,3,1,3,0,1,0,69.28
桃園縣,平鎮市,復旦里,0,1,4082,47,4129,5969,3,1,3,0,1,0,69.17
桃園縣,平鎮市,義興里,0,1,3304,49,3353,4686,3,1,3,0,1,0,71.55
桃園縣,平鎮市,義民里,0,1,2087,26,2113,3183,3,1,3,0,1,0,66.38
桃園縣,平鎮市,宋屋里,0,1,3164,61,3225,5084,3,1,3,0,1,0,63.43
桃園縣,平鎮市,廣仁里,0,1,2201,44,2245,3411,3,1,3,0,1,0,65.82
桃園縣,平鎮市,雙連里,0,1,2490,49,2539,3601,3,1,3,0,1,0,70.51
桃園縣,平鎮市,高雙里,0,1,1847,30,1877,2633,3,1,3,0,1,0,71.29
桃園縣,平鎮市,平鎮里,0,1,2152,44,2196,3125,3,1,3,0,1,0,70.27
桃園縣,平鎮市,鎮興里,0,1,1539,33,1572,2206,3,1,3,0,1,0,71.26
桃園縣,平鎮市,金星里,0,1,5295,105,5400,7974,3,1,3,0,1,0,67.72
桃園縣,平鎮市,南勢里,0,1,2284,38,2322,3371,3,1,3,0,1,0,68.88
桃園縣,楊梅鎮,仁美里,0,1,2602,53,2655,3782,3,1,3,0,1,0,70.20
桃園縣,楊梅鎮,埔心里,0,1,1049,13,1062,1479,3,1,3,0,1,0,71.81
桃園縣,楊梅鎮,光華里,0,1,1847,28,1875,2567,3,1,3,0,1,0,73.04
桃園縣,楊梅鎮,金龍里,0,1,997,11,1008,1317,3,1,3,0,1,0,76.54
桃園縣,楊梅鎮,四維里,0,1,1339,19,1358,1869,3,1,3,0,1,0,72.66
桃園縣,楊梅鎮,永平里,0,1,815,23,838,1330,3,1,3,0,1,0,63.01
桃園縣,楊梅鎮,瑞塘里,0,1,2310,38,2348,3568,3,1,3,0,1,0,65.81
桃園縣,楊梅鎮,瑞坪里,0,1,1456,25,1481,2310,3,1,3,0,1,0,64.11
桃園縣,楊梅鎮,梅溪里,0,1,1656,29,1685,2627,3,1,3,0,1,0,64.14
桃園縣,楊梅鎮,金溪里,0,1,2059,23,2082,3344,3,1,3,0,1,0,62.26
桃園縣,楊梅鎮,楊明里,0,1,1727,26,1753,2570,3,1,3,0,1,0,68.21
桃園縣,楊梅鎮,裕成里,0,1,1805,21,1826,3025,3,1,3,0,1,0,60.36
桃園縣,楊梅鎮,大同里,0,1,1911,31,1942,2815,3,1,3,0,1,0,68.99
桃園縣,楊梅鎮,中山里,0,1,1320,11,1331,1998,3,1,3,0,1,0,66.62
桃園縣,楊梅鎮,楊梅里,0,1,2026,25,2051,2802,3,1,3,0,1,0,73.20
桃園縣,楊梅鎮,楊江里,0,1,807,7,814,1206,3,1,3,0,1,0,67.50
桃園縣,楊梅鎮,梅新里,0,1,1073,21,1094,1561,3,1,3,0,1,0,70.08
桃園縣,楊梅鎮,紅梅里,0,1,1453,21,1474,2115,3,1,3,0,1,0,69.69
桃園縣,楊梅鎮,永寧里,0,1,2327,57,2384,3408,3,1,3,0,1,0,69.95
桃園縣,楊梅鎮,大平里,0,1,1955,33,1988,2883,3,1,3,0,1,0,68.96
桃園縣,楊梅鎮,秀才里,0,1,1813,38,1851,2677,3,1,3,0,1,0,69.14
桃園縣,楊梅鎮,東流里,0,1,1438,33,1471,2176,3,1,3,0,1,0,67.60
桃園縣,楊梅鎮,豐野里,0,1,2026,39,2065,2911,3,1,3,0,1,0,70.94
桃園縣,楊梅鎮,富岡里,0,1,2815,40,2855,4022,3,1,3,0,1,0,70.98
桃園縣,楊梅鎮,員本里,0,1,1210,23,1233,1736,3,1,3,0,1,0,71.03
桃園縣,楊梅鎮,三湖里,0,1,1818,32,1850,2966,3,1,3,0,1,0,62.37
桃園縣,楊梅鎮,上湖里,0,1,1976,41,2017,3061,3,1,3,0,1,0,65.89
桃園縣,楊梅鎮,上田里,0,1,1507,18,1525,2179,3,1,3,0,1,0,69.99
桃園縣,楊梅鎮,高山里,0,1,2340,42,2382,3543,3,1,3,0,1,0,67.23
桃園縣,楊梅鎮,青山里,0,1,915,26,941,1622,3,1,3,0,1,0,58.01
桃園縣,楊梅鎮,高榮里,0,1,1393,22,1415,2045,3,1,3,0,1,0,69.19
桃園縣,楊梅鎮,雙榮里,0,1,1044,15,1059,1449,3,1,3,0,1,0,73.08
桃園縣,楊梅鎮,新榮里,0,1,1423,22,1445,2097,3,1,3,0,1,0,68.91
桃園縣,楊梅鎮,水美里,0,1,2056,34,2090,3031,3,1,3,0,1,0,68.95
桃園縣,楊梅鎮,瑞原里,0,1,1953,38,1991,2909,3,1,3,0,1,0,68.44
桃園縣,龍潭鄉,黃唐村,0,1,3664,76,3740,5657,3,1,3,0,1,0,66.11
桃園縣,龍潭鄉,中山村,0,1,2627,38,2665,3687,3,1,3,0,1,0,72.28
桃園縣,龍潭鄉,烏林村,0,1,4293,63,4356,6625,3,1,3,0,1,0,65.75
桃園縣,龍潭鄉,干城村,0,1,460,15,475,628,3,1,3,0,1,0,75.64
桃園縣,龍潭鄉,凌雲村,0,1,3375,53,3428,5043,3,1,3,0,1,0,67.98
桃園縣,龍潭鄉,八德村,0,1,3393,49,3442,5094,3,1,3,0,1,0,67.57
桃園縣,龍潭鄉,上林村,0,1,1741,34,1775,2680,3,1,3,0,1,0,66.23
桃園縣,龍潭鄉,龍潭村,0,1,1450,18,1468,1995,3,1,3,0,1,0,73.58
桃園縣,龍潭鄉,中正村,0,1,5004,86,5090,7273,3,1,3,0,1,0,69.98
桃園縣,龍潭鄉,九龍村,0,1,2832,48,2880,4519,3,1,3,0,1,0,63.73
桃園縣,龍潭鄉,中興村,0,1,5309,110,5419,7984,3,1,3,0,1,0,67.87
桃園縣,龍潭鄉,佳安村,0,1,2201,31,2232,3097,3,1,3,0,1,0,72.07
桃園縣,龍潭鄉,三坑村,0,1,879,12,891,1293,3,1,3,0,1,0,68.91
桃園縣,龍潭鄉,大平村,0,1,665,3,668,964,3,1,3,0,1,0,69.29
桃園縣,龍潭鄉,三林村,0,1,5192,58,5250,7463,3,1,3,0,1,0,70.35
桃園縣,龍潭鄉,高平村,0,1,1574,34,1608,2398,3,1,3,0,1,0,67.06
桃園縣,龍潭鄉,高原村,0,1,1695,22,1717,2671,3,1,3,0,1,0,64.28
桃園縣,龍潭鄉,三和村,0,1,710,8,718,1035,3,1,3,0,1,0,69.37
桃園縣,龍潭鄉,三水村,0,1,488,12,500,659,3,1,3,0,1,0,75.87
桃園縣,新屋鄉,新屋村,0,1,1697,19,1716,2303,3,1,3,0,1,0,74.51
桃園縣,新屋鄉,新生村,0,1,2200,22,2222,2910,3,1,3,0,1,0,76.36
桃園縣,新屋鄉,後湖村,0,1,887,8,895,1194,3,1,3,0,1,0,74.96
桃園縣,新屋鄉,清華村,0,1,2022,31,2053,2860,3,1,3,0,1,0,71.78
桃園縣,新屋鄉,石磊村,0,1,1221,12,1233,1644,3,1,3,0,1,0,75.00
桃園縣,新屋鄉,東明村,0,1,831,14,845,1120,3,1,3,0,1,0,75.45
桃園縣,新屋鄉,社子村,0,1,1023,12,1035,1341,3,1,3,0,1,0,77.18
桃園縣,新屋鄉,埔頂村,0,1,1454,26,1480,1990,3,1,3,0,1,0,74.37
桃園縣,新屋鄉,九斗村,0,1,1202,21,1223,1744,3,1,3,0,1,0,70.13
桃園縣,新屋鄉,頭洲村,0,1,1976,26,2002,2726,3,1,3,0,1,0,73.44
桃園縣,新屋鄉,大坡村,0,1,964,12,976,1329,3,1,3,0,1,0,73.44
桃園縣,新屋鄉,望間村,0,1,1110,8,1118,1452,3,1,3,0,1,0,77.00
桃園縣,新屋鄉,後庄村,0,1,758,14,772,1126,3,1,3,0,1,0,68.56
桃園縣,新屋鄉,蚵間村,0,1,549,2,551,835,3,1,3,0,1,0,65.99
桃園縣,新屋鄉,深圳村,0,1,467,6,473,667,3,1,3,0,1,0,70.91
桃園縣,新屋鄉,康榔村,0,1,795,13,808,1070,3,1,3,0,1,0,75.51
桃園縣,新屋鄉,笨港村,0,1,768,16,784,1032,3,1,3,0,1,0,75.97
桃園縣,新屋鄉,永安村,0,1,1648,22,1670,2184,3,1,3,0,1,0,76.47
桃園縣,新屋鄉,永興村,0,1,653,6,659,910,3,1,3,0,1,0,72.42
桃園縣,新屋鄉,下埔村,0,1,538,8,546,697,3,1,3,0,1,0,78.34
桃園縣,新屋鄉,石牌村,0,1,626,6,632,811,3,1,3,0,1,0,77.93
桃園縣,新屋鄉,下田村,0,1,1124,11,1135,1512,3,1,3,0,1,0,75.07
桃園縣,新屋鄉,赤欄村,0,1,775,11,786,1036,3,1,3,0,1,0,75.87
桃園縣,觀音鄉,觀音村,0,1,1731,25,1756,2402,3,1,3,0,1,0,73.11
桃園縣,觀音鄉,白玉村,0,1,860,11,871,1140,3,1,3,0,1,0,76.40
桃園縣,觀音鄉,廣興村,0,1,897,22,919,1291,3,1,3,0,1,0,71.19
桃園縣,觀音鄉,大潭村,0,1,794,9,803,1073,3,1,3,0,1,0,74.84
桃園縣,觀音鄉,保生村,0,1,1036,9,1045,1401,3,1,3,0,1,0,74.59
桃園縣,觀音鄉,武威村,0,1,469,10,479,643,3,1,3,0,1,0,74.49
桃園縣,觀音鄉,三和村,0,1,562,4,566,745,3,1,3,0,1,0,75.97
桃園縣,觀音鄉,新興村,0,1,502,11,513,670,3,1,3,0,1,0,76.57
桃園縣,觀音鄉,坑尾村,0,1,836,25,861,1181,3,1,3,0,1,0,72.90
桃園縣,觀音鄉,金湖村,0,1,1263,31,1294,1842,3,1,3,0,1,0,70.25
桃園縣,觀音鄉,藍埔村,0,1,1350,14,1364,1869,3,1,3,0,1,0,72.98
桃園縣,觀音鄉,大同村,0,1,1204,17,1221,1663,3,1,3,0,1,0,73.42
桃園縣,觀音鄉,大堀村,0,1,687,5,692,979,3,1,3,0,1,0,70.68
桃園縣,觀音鄉,崙坪村,0,1,2342,42,2384,3396,3,1,3,0,1,0,70.20
桃園縣,觀音鄉,富源村,0,1,1232,13,1245,1771,3,1,3,0,1,0,70.30
桃園縣,觀音鄉,上大村,0,1,1131,14,1145,1663,3,1,3,0,1,0,68.85
桃園縣,觀音鄉,新坡村,0,1,1849,17,1866,2534,3,1,3,0,1,0,73.64
桃園縣,觀音鄉,廣福村,0,1,1343,14,1357,1758,3,1,3,0,1,0,77.19
桃園縣,觀音鄉,塔腳村,0,1,686,9,695,949,3,1,3,0,1,0,73.23
桃園縣,觀音鄉,保障村,0,1,1216,21,1237,1752,3,1,3,0,1,0,70.61
桃園縣,觀音鄉,草漯村,0,1,2185,35,2220,3079,3,1,3,0,1,0,72.10
桃園縣,觀音鄉,樹林村,0,1,1063,12,1075,1555,3,1,3,0,1,0,69.13
桃園縣,觀音鄉,富林村,0,1,947,14,961,1332,3,1,3,0,1,0,72.15
新竹縣,竹北市,鹿場里,0,1,653,14,667,890,3,1,3,0,1,0,74.94
新竹縣,竹北市,東平里,0,1,249,10,259,310,3,1,3,0,1,0,83.55
新竹縣,竹北市,中興里,0,1,775,22,797,1174,3,1,3,0,1,0,67.89
新竹縣,竹北市,隘口里,0,1,414,6,420,560,3,1,3,0,1,0,75.00
新竹縣,竹北市,東海里,0,1,1726,31,1757,2406,3,1,3,0,1,0,73.03
新竹縣,竹北市,十興里,0,1,2962,55,3017,4335,3,1,3,0,1,0,69.60
新竹縣,竹北市,斗崙里,0,1,2540,43,2583,3799,3,1,3,0,1,0,67.99
新竹縣,竹北市,北崙里,0,1,1431,24,1455,2116,3,1,3,0,1,0,68.76
新竹縣,竹北市,新崙里,0,1,2198,32,2230,3345,3,1,3,0,1,0,66.67
新竹縣,竹北市,竹北里,0,1,2016,27,2043,3010,3,1,3,0,1,0,67.87
新竹縣,竹北市,竹仁里,0,1,4008,81,4089,6107,3,1,3,0,1,0,66.96
新竹縣,竹北市,福德里,0,1,1853,44,1897,2806,3,1,3,0,1,0,67.61
新竹縣,竹北市,竹義里,0,1,2407,34,2441,3692,3,1,3,0,1,0,66.12
新竹縣,竹北市,泰和里,0,1,2213,35,2248,3351,3,1,3,0,1,0,67.08
新竹縣,竹北市,新社里,0,1,3070,56,3126,4986,3,1,3,0,1,0,62.70
新竹縣,竹北市,新國里,0,1,2009,42,2051,3288,3,1,3,0,1,0,62.38
新竹縣,竹北市,聯興里,0,1,1953,41,1994,2958,3,1,3,0,1,0,67.41
新竹縣,竹北市,麻園里,0,1,757,12,769,1144,3,1,3,0,1,0,67.22
新竹縣,竹北市,溪州里,0,1,1099,24,1123,1636,3,1,3,0,1,0,68.64
新竹縣,竹北市,新庄里,0,1,559,5,564,898,3,1,3,0,1,0,62.81
新竹縣,竹北市,白地里,0,1,1071,25,1096,1625,3,1,3,0,1,0,67.45
新竹縣,竹北市,新港里,0,1,682,23,705,1030,3,1,3,0,1,0,68.45
新竹縣,竹北市,大眉里,0,1,779,15,794,1243,3,1,3,0,1,0,63.88
新竹縣,竹北市,大義里,0,1,917,19,936,1323,3,1,3,0,1,0,70.75
新竹縣,竹北市,尚義里,0,1,968,14,982,1328,3,1,3,0,1,0,73.95
新竹縣,竹北市,崇義里,0,1,1127,16,1143,1631,3,1,3,0,1,0,70.08
新竹縣,竹東鎮,上坪里,0,1,285,6,291,405,3,1,3,0,1,0,71.85
新竹縣,竹東鎮,瑞峰里,0,1,228,2,230,330,3,1,3,0,1,0,69.70
新竹縣,竹東鎮,軟橋里,0,1,265,8,273,362,3,1,3,0,1,0,75.41
新竹縣,竹東鎮,員崠里,0,1,1227,21,1248,1758,3,1,3,0,1,0,70.99
新竹縣,竹東鎮,上舘里,0,1,4180,81,4261,6082,3,1,3,0,1,0,70.06
新竹縣,竹東鎮,東寧里,0,1,1895,36,1931,2696,3,1,3,0,1,0,71.62
新竹縣,竹東鎮,中正里,0,1,1044,14,1058,1462,3,1,3,0,1,0,72.37
新竹縣,竹東鎮,大鄉里,0,1,2314,38,2352,3274,3,1,3,0,1,0,71.84
新竹縣,竹東鎮,中山里,0,1,1295,18,1313,1763,3,1,3,0,1,0,74.48
新竹縣,竹東鎮,南華里,0,1,857,18,875,1171,3,1,3,0,1,0,74.72
新竹縣,竹東鎮,東華里,0,1,589,9,598,778,3,1,3,0,1,0,76.86
新竹縣,竹東鎮,商華里,0,1,1509,26,1535,2171,3,1,3,0,1,0,70.70
新竹縣,竹東鎮,鷄林里,0,1,2309,40,2349,3288,3,1,3,0,1,0,71.44
新竹縣,竹東鎮,仁愛里,0,1,1947,29,1976,2677,3,1,3,0,1,0,73.81
新竹縣,竹東鎮,竹東里,0,1,1076,11,1087,1446,3,1,3,0,1,0,75.17
新竹縣,竹東鎮,忠孝里,0,1,920,10,930,1360,3,1,3,0,1,0,68.38
新竹縣,竹東鎮,榮樂里,0,1,1082,14,1096,1452,3,1,3,0,1,0,75.48
新竹縣,竹東鎮,榮華里,0,1,3791,62,3853,5148,3,1,3,0,1,0,74.84
新竹縣,竹東鎮,五豐里,0,1,3465,54,3519,5116,3,1,3,0,1,0,68.78
新竹縣,竹東鎮,陸豐里,0,1,347,5,352,484,3,1,3,0,1,0,72.73
新竹縣,竹東鎮,三重里,0,1,3099,56,3155,4690,3,1,3,0,1,0,67.27
新竹縣,竹東鎮,二重里,0,1,4041,72,4113,5834,3,1,3,0,1,0,70.50
新竹縣,竹東鎮,頭重里,0,1,2321,40,2361,3363,3,1,3,0,1,0,70.21
新竹縣,竹東鎮,員山里,0,1,1032,15,1047,1410,3,1,3,0,1,0,74.26
新竹縣,竹東鎮,柯湖里,0,1,460,3,463,645,3,1,3,0,1,0,71.78
新竹縣,新埔鎮,新埔里,0,1,762,8,770,1012,3,1,3,0,1,0,76.09
新竹縣,新埔鎮,新生里,0,1,500,9,509,681,3,1,3,0,1,0,74.74
新竹縣,新埔鎮,新民里,0,1,776,18,794,1043,3,1,3,0,1,0,76.13
新竹縣,新埔鎮,田新里,0,1,1654,27,1681,2290,3,1,3,0,1,0,73.41
新竹縣,新埔鎮,旱坑里,0,1,1133,19,1152,1690,3,1,3,0,1,0,68.17
新竹縣,新埔鎮,五埔里,0,1,1316,31,1347,1821,3,1,3,0,1,0,73.97
新竹縣,新埔鎮,四座里,0,1,1978,49,2027,2772,3,1,3,0,1,0,73.12
新竹縣,新埔鎮,照門里,0,1,991,21,1012,1356,3,1,3,0,1,0,74.63
新竹縣,新埔鎮,清水里,0,1,330,4,334,438,3,1,3,0,1,0,76.26
新竹縣,新埔鎮,鹿鳴里,0,1,540,7,547,713,3,1,3,0,1,0,76.72
新竹縣,新埔鎮,新北里,0,1,451,7,458,604,3,1,3,0,1,0,75.83
新竹縣,新埔鎮,巨埔里,0,1,820,10,830,1066,3,1,3,0,1,0,77.86
新竹縣,新埔鎮,內立里,0,1,787,19,806,1080,3,1,3,0,1,0,74.63
新竹縣,新埔鎮,寶石里,0,1,608,11,619,799,3,1,3,0,1,0,77.47
新竹縣,新埔鎮,文山里,0,1,2594,42,2636,3799,3,1,3,0,1,0,69.39
新竹縣,新埔鎮,上寮里,0,1,1157,13,1170,1658,3,1,3,0,1,0,70.57
新竹縣,新埔鎮,下寮里,0,1,1237,26,1263,1728,3,1,3,0,1,0,73.09
新竹縣,新埔鎮,南平里,0,1,723,19,742,974,3,1,3,0,1,0,76.18
新竹縣,新埔鎮,北平里,0,1,496,2,498,665,3,1,3,0,1,0,74.89
新竹縣,關西鎮,東興里,0,1,420,5,425,550,3,1,3,0,1,0,77.27
新竹縣,關西鎮,西安里,0,1,1204,18,1222,1669,3,1,3,0,1,0,73.22
新竹縣,關西鎮,南雄里,0,1,530,10,540,747,3,1,3,0,1,0,72.29
新竹縣,關西鎮,北斗里,0,1,2464,36,2500,3490,3,1,3,0,1,0,71.63
新竹縣,關西鎮,北山里,0,1,543,12,555,725,3,1,3,0,1,0,76.55
新竹縣,關西鎮,仁安里,0,1,761,8,769,1067,3,1,3,0,1,0,72.07
新竹縣,關西鎮,南山里,0,1,674,14,688,1016,3,1,3,0,1,0,67.72
新竹縣,關西鎮,東安里,0,1,1920,27,1947,2799,3,1,3,0,1,0,69.56
新竹縣,關西鎮,東山里,0,1,559,11,570,760,3,1,3,0,1,0,75.00
新竹縣,關西鎮,東光里,0,1,823,15,838,1118,3,1,3,0,1,0,74.96
新竹縣,關西鎮,南新里,0,1,701,5,706,975,3,1,3,0,1,0,72.41
新竹縣,關西鎮,新富里,0,1,414,12,426,591,3,1,3,0,1,0,72.08
新竹縣,關西鎮,玉山里,0,1,372,10,382,522,3,1,3,0,1,0,73.18
新竹縣,關西鎮,金山里,0,1,417,4,421,637,3,1,3,0,1,0,66.09
新竹縣,關西鎮,錦山里,0,1,596,12,608,879,3,1,3,0,1,0,69.17
新竹縣,關西鎮,大同里,0,1,535,11,546,713,3,1,3,0,1,0,76.58
新竹縣,關西鎮,石光里,0,1,1351,32,1383,1785,3,1,3,0,1,0,77.48
新竹縣,關西鎮,東平里,0,1,675,9,684,934,3,1,3,0,1,0,73.23
新竹縣,關西鎮,上林里,0,1,632,4,636,812,3,1,3,0,1,0,78.33
新竹縣,關西鎮,新力里,0,1,488,7,495,620,3,1,3,0,1,0,79.84
新竹縣,關西鎮,南和里,0,1,612,9,621,775,3,1,3,0,1,0,80.13
新竹縣,湖口鄉,和興村,0,1,1711,26,1737,2338,3,1,3,0,1,0,74.29
新竹縣,湖口鄉,東興村,0,1,1631,18,1649,2359,3,1,3,0,1,0,69.90
新竹縣,湖口鄉,德盛村,0,1,2318,43,2361,3329,3,1,3,0,1,0,70.92
新竹縣,湖口鄉,愛勢村,0,1,2570,42,2612,3715,3,1,3,0,1,0,70.31
新竹縣,湖口鄉,仁勢村,0,1,580,10,590,850,3,1,3,0,1,0,69.41
新竹縣,湖口鄉,孝勢村,0,1,838,20,858,1222,3,1,3,0,1,0,70.21
新竹縣,湖口鄉,中勢村,0,1,1613,26,1639,2274,3,1,3,0,1,0,72.08
新竹縣,湖口鄉,中正村,0,1,1486,21,1507,2058,3,1,3,0,1,0,73.23
新竹縣,湖口鄉,信勢村,0,1,2281,30,2311,3252,3,1,3,0,1,0,71.06
新竹縣,湖口鄉,信義村,0,1,1480,18,1498,2105,3,1,3,0,1,0,71.16
新竹縣,湖口鄉,波羅村,0,1,1023,14,1037,1677,3,1,3,0,1,0,61.84
新竹縣,湖口鄉,長嶺村,0,1,1695,41,1736,2443,3,1,3,0,1,0,71.06
新竹縣,湖口鄉,長安村,0,1,724,5,729,995,3,1,3,0,1,0,73.27
新竹縣,湖口鄉,湖口村,0,1,1504,25,1529,2223,3,1,3,0,1,0,68.78
新竹縣,湖口鄉,湖鏡村,0,1,1466,19,1485,2085,3,1,3,0,1,0,71.22
新竹縣,湖口鄉,湖南村,0,1,845,25,870,1280,3,1,3,0,1,0,67.97
新竹縣,湖口鄉,中興村,0,1,2227,47,2274,3430,3,1,3,0,1,0,66.30
新竹縣,湖口鄉,鳳凰村,0,1,1928,40,1968,3069,3,1,3,0,1,0,64.13
新竹縣,湖口鄉,勝利村,0,1,1444,40,1484,2164,3,1,3,0,1,0,68.58
新竹縣,湖口鄉,鳳山村,0,1,1628,38,1666,2516,3,1,3,0,1,0,66.22
新竹縣,新豐鄉,福興村,0,1,635,16,651,865,3,1,3,0,1,0,75.26
新竹縣,新豐鄉,後湖村,0,1,1147,37,1184,1639,3,1,3,0,1,0,72.24
新竹縣,新豐鄉,青埔村,0,1,959,12,971,1338,3,1,3,0,1,0,72.57
新竹縣,新豐鄉,埔和村,0,1,1466,26,1492,2153,3,1,3,0,1,0,69.30
新竹縣,新豐鄉,坡頭村,0,1,547,18,565,771,3,1,3,0,1,0,73.28
新竹縣,新豐鄉,新豐村,0,1,1413,22,1435,2036,3,1,3,0,1,0,70.48
新竹縣,新豐鄉,瑞興村,0,1,908,10,918,1316,3,1,3,0,1,0,69.76
新竹縣,新豐鄉,中崙村,0,1,1416,22,1438,2116,3,1,3,0,1,0,67.96
新竹縣,新豐鄉,重興村,0,1,3703,58,3761,5610,3,1,3,0,1,0,67.04
新竹縣,新豐鄉,上坑村,0,1,814,10,824,1226,3,1,3,0,1,0,67.21
新竹縣,新豐鄉,鳳坑村,0,1,623,17,640,902,3,1,3,0,1,0,70.95
新竹縣,新豐鄉,員山村,0,1,4358,57,4415,6609,3,1,3,0,1,0,66.80
新竹縣,新豐鄉,松林村,0,1,2566,47,2613,4089,3,1,3,0,1,0,63.90
新竹縣,芎林鄉,華龍村,0,1,350,5,355,435,3,1,3,0,1,0,81.61
新竹縣,芎林鄉,五龍村,0,1,368,7,375,494,3,1,3,0,1,0,75.91
新竹縣,芎林鄉,秀湖村,0,1,602,12,614,829,3,1,3,0,1,0,74.07
新竹縣,芎林鄉,永興村,0,1,315,1,316,397,3,1,3,0,1,0,79.60
新竹縣,芎林鄉,石潭村,0,1,1689,26,1715,2310,3,1,3,0,1,0,74.24
新竹縣,芎林鄉,新鳳村,0,1,1019,29,1048,1370,3,1,3,0,1,0,76.50
新竹縣,芎林鄉,中坑村,0,1,408,8,416,542,3,1,3,0,1,0,76.75
新竹縣,芎林鄉,水坑村,0,1,457,4,461,618,3,1,3,0,1,0,74.60
新竹縣,芎林鄉,文林村,0,1,1474,21,1495,2027,3,1,3,0,1,0,73.75
新竹縣,芎林鄉,芎林村,0,1,1092,26,1118,1458,3,1,3,0,1,0,76.68
新竹縣,芎林鄉,上山村,0,1,1998,26,2024,2938,3,1,3,0,1,0,68.89
新竹縣,芎林鄉,下山村,0,1,782,7,789,1041,3,1,3,0,1,0,75.79
新竹縣,橫山鄉,橫山村,0,1,2246,28,2274,3197,3,1,3,0,1,0,71.13
新竹縣,橫山鄉,田寮村,0,1,626,9,635,832,3,1,3,0,1,0,76.32
新竹縣,橫山鄉,南昌村,0,1,124,3,127,156,3,1,3,0,1,0,81.41
新竹縣,橫山鄉,豐鄉村,0,1,107,2,109,144,3,1,3,0,1,0,75.69
新竹縣,橫山鄉,豐田村,0,1,259,3,262,334,3,1,3,0,1,0,78.44
新竹縣,橫山鄉,內灣村,0,1,752,15,767,1041,3,1,3,0,1,0,73.68
新竹縣,橫山鄉,力行村,0,1,613,15,628,837,3,1,3,0,1,0,75.03
新竹縣,橫山鄉,福興村,0,1,345,4,349,456,3,1,3,0,1,0,76.54
新竹縣,橫山鄉,沙坑村,0,1,847,16,863,1115,3,1,3,0,1,0,77.40
新竹縣,橫山鄉,新興村,0,1,1138,14,1152,1492,3,1,3,0,1,0,77.21
新竹縣,橫山鄉,大肚村,0,1,994,22,1016,1335,3,1,3,0,1,0,76.10
新竹縣,北埔鄉,北埔村,0,1,775,12,787,1111,3,1,3,0,1,0,70.84
新竹縣,北埔鄉,南興村,0,1,948,22,970,1297,3,1,3,0,1,0,74.79
新竹縣,北埔鄉,大湖村,0,1,356,5,361,485,3,1,3,0,1,0,74.43
新竹縣,北埔鄉,埔尾村,0,1,1730,28,1758,2336,3,1,3,0,1,0,75.26
新竹縣,北埔鄉,水際村,0,1,527,11,538,744,3,1,3,0,1,0,72.31
新竹縣,北埔鄉,南埔村,0,1,260,2,262,339,3,1,3,0,1,0,77.29
新竹縣,北埔鄉,大林村,0,1,447,8,455,623,3,1,3,0,1,0,73.03
新竹縣,北埔鄉,南坑村,0,1,227,4,231,328,3,1,3,0,1,0,70.43
新竹縣,北埔鄉,外坪村,0,1,226,5,231,330,3,1,3,0,1,0,70.00
新竹縣,寶山鄉,雙溪村,0,1,2271,37,2308,3517,3,1,3,0,1,0,65.62
新竹縣,寶山鄉,大崎村,0,1,576,13,589,839,3,1,3,0,1,0,70.20
新竹縣,寶山鄉,三峰村,0,1,544,9,553,731,3,1,3,0,1,0,75.65
新竹縣,寶山鄉,新城村,0,1,770,12,782,1057,3,1,3,0,1,0,73.98
新竹縣,寶山鄉,寶斗村,0,1,479,8,487,625,3,1,3,0,1,0,77.92
新竹縣,寶山鄉,深井村,0,1,519,5,524,693,3,1,3,0,1,0,75.61
新竹縣,寶山鄉,寶山村,0,1,460,5,465,613,3,1,3,0,1,0,75.86
新竹縣,寶山鄉,油田村,0,1,408,4,412,539,3,1,3,0,1,0,76.44
新竹縣,寶山鄉,山湖村,0,1,354,5,359,505,3,1,3,0,1,0,71.09
新竹縣,峨眉鄉,峨眉村,0,1,665,7,672,889,3,1,3,0,1,0,75.59
新竹縣,峨眉鄉,中盛村,0,1,550,4,554,717,3,1,3,0,1,0,77.27
新竹縣,峨眉鄉,石井村,0,1,454,6,460,602,3,1,3,0,1,0,76.41
新竹縣,峨眉鄉,七星村,0,1,458,7,465,611,3,1,3,0,1,0,76.10
新竹縣,峨眉鄉,富興村,0,1,859,19,878,1220,3,1,3,0,1,0,71.97
新竹縣,峨眉鄉,湖光村,0,1,647,10,657,874,3,1,3,0,1,0,75.17
新竹縣,尖石鄉,嘉樂村,0,1,288,4,292,413,3,1,3,0,1,0,70.70
新竹縣,尖石鄉,義興村,0,1,24,0,24,34,3,1,3,0,1,0,70.59
新竹縣,尖石鄉,嘉樂村,0,1,78,2,80,119,3,1,3,0,1,0,67.23
新竹縣,尖石鄉,新樂村,0,1,113,3,116,179,3,1,3,0,1,0,64.80
新竹縣,尖石鄉,錦屏村,0,1,65,0,65,116,3,1,3,0,1,0,56.03
新竹縣,尖石鄉,梅花村,0,1,23,3,26,39,3,1,3,0,1,0,66.67
新竹縣,尖石鄉,玉峰村,0,1,16,0,16,31,3,1,3,0,1,0,51.61
新竹縣,尖石鄉,秀巒村,0,1,31,3,34,58,3,1,3,0,1,0,58.62
新竹縣,五峰鄉,大隘村,0,1,90,1,91,146,3,1,3,0,1,0,62.33
新竹縣,五峰鄉,花園村,0,1,43,0,43,82,3,1,3,0,1,0,52.44
新竹縣,五峰鄉,竹林村,0,1,12,0,12,17,3,1,3,0,1,0,70.59
新竹縣,五峰鄉,桃山村,0,1,104,1,105,190,3,1,3,0,1,0,55.26
苗栗縣,苗栗市,中苗里,0,1,620,8,628,915,3,1,3,0,1,0,68.63
苗栗縣,苗栗市,青苗里,0,1,647,8,655,1014,3,1,3,0,1,0,64.60
苗栗縣,苗栗市,維祥里,0,1,1973,36,2009,3000,3,1,3,0,1,0,66.97
苗栗縣,苗栗市,維新里,0,1,2386,41,2427,3667,3,1,3,0,1,0,66.18
苗栗縣,苗栗市,玉清里,0,1,1480,22,1502,2272,3,1,3,0,1,0,66.11
苗栗縣,苗栗市,玉華里,0,1,2146,39,2185,3265,3,1,3,0,1,0,66.92
苗栗縣,苗栗市,綠苗里,0,1,583,16,599,905,3,1,3,0,1,0,66.19
苗栗縣,苗栗市,高苗里,0,1,1603,24,1627,2546,3,1,3,0,1,0,63.90
苗栗縣,苗栗市,新苗里,0,1,653,16,669,962,3,1,3,0,1,0,69.54
苗栗縣,苗栗市,玉苗里,0,1,696,13,709,1064,3,1,3,0,1,0,66.64
苗栗縣,苗栗市,大同里,0,1,391,6,397,647,3,1,3,0,1,0,61.36
苗栗縣,苗栗市,恭敬里,0,1,1089,16,1105,1556,3,1,3,0,1,0,71.02
苗栗縣,苗栗市,水源里,0,1,1549,21,1570,2315,3,1,3,0,1,0,67.82
苗栗縣,苗栗市,勝利里,0,1,2311,36,2347,3439,3,1,3,0,1,0,68.25
苗栗縣,苗栗市,清華里,0,1,2031,23,2054,2983,3,1,3,0,1,0,68.86
苗栗縣,苗栗市,上苗里,0,1,1220,19,1239,1735,3,1,3,0,1,0,71.41
苗栗縣,苗栗市,北苗里,0,1,2802,41,2843,4152,3,1,3,0,1,0,68.47
苗栗縣,苗栗市,嘉盛里,0,1,3765,47,3812,5410,3,1,3,0,1,0,70.46
苗栗縣,苗栗市,福星里,0,1,3617,54,3671,5572,3,1,3,0,1,0,65.88
苗栗縣,苗栗市,建功里,0,1,2367,33,2400,3467,3,1,3,0,1,0,69.22
苗栗縣,苗栗市,福麗里,0,1,2592,47,2639,4055,3,1,3,0,1,0,65.08
苗栗縣,苗栗市,文山里,0,1,2992,63,3055,4604,3,1,3,0,1,0,66.36
苗栗縣,苗栗市,新川里,0,1,703,7,710,1098,3,1,3,0,1,0,64.66
苗栗縣,苗栗市,新英里,0,1,1974,51,2025,3156,3,1,3,0,1,0,64.16
苗栗縣,苑裡鎮,苑東里,0,1,1137,10,1147,1756,3,1,3,0,1,0,65.32
苗栗縣,苑裡鎮,苑南里,0,1,1067,12,1079,1602,3,1,3,0,1,0,67.35
苗栗縣,苑裡鎮,苑北里,0,1,611,9,620,892,3,1,3,0,1,0,69.51
苗栗縣,苑裡鎮,西平里,0,1,804,13,817,1268,3,1,3,0,1,0,64.43
苗栗縣,苑裡鎮,苑港里,0,1,752,9,761,1120,3,1,3,0,1,0,67.95
苗栗縣,苑裡鎮,西勢里,0,1,1075,8,1083,1634,3,1,3,0,1,0,66.28
苗栗縣,苑裡鎮,海岸里,0,1,651,12,663,991,3,1,3,0,1,0,66.90
苗栗縣,苑裡鎮,房裡里,0,1,1334,23,1357,2094,3,1,3,0,1,0,64.80
苗栗縣,苑裡鎮,客庄里,0,1,2092,21,2113,3155,3,1,3,0,1,0,66.97
苗栗縣,苑裡鎮,中正里,0,1,1171,12,1183,1766,3,1,3,0,1,0,66.99
苗栗縣,苑裡鎮,苑坑里,0,1,618,9,627,997,3,1,3,0,1,0,62.89
苗栗縣,苑裡鎮,水坡里,0,1,374,4,378,597,3,1,3,0,1,0,63.32
苗栗縣,苑裡鎮,新復里,0,1,747,4,751,1107,3,1,3,0,1,0,67.84
苗栗縣,苑裡鎮,山腳里,0,1,993,9,1002,1528,3,1,3,0,1,0,65.58
苗栗縣,苑裡鎮,舊社里,0,1,1049,12,1061,1624,3,1,3,0,1,0,65.33
苗栗縣,苑裡鎮,福田里,0,1,772,13,785,1224,3,1,3,0,1,0,64.13
苗栗縣,苑裡鎮,石鎮里,0,1,444,4,448,616,3,1,3,0,1,0,72.73
苗栗縣,苑裡鎮,蕉埔里,0,1,617,14,631,896,3,1,3,0,1,0,70.42
苗栗縣,苑裡鎮,南勢里,0,1,464,12,476,718,3,1,3,0,1,0,66.30
苗栗縣,苑裡鎮,泰田里,0,1,933,7,940,1447,3,1,3,0,1,0,64.96
苗栗縣,苑裡鎮,上館里,0,1,960,23,983,1501,3,1,3,0,1,0,65.49
苗栗縣,苑裡鎮,玉田里,0,1,986,15,1001,1548,3,1,3,0,1,0,64.66
苗栗縣,苑裡鎮,社苓里,0,1,1219,15,1234,1961,3,1,3,0,1,0,62.93
苗栗縣,苑裡鎮,山柑里,0,1,771,6,777,1157,3,1,3,0,1,0,67.16
苗栗縣,苑裡鎮,田心里,0,1,858,7,865,1313,3,1,3,0,1,0,65.88
苗栗縣,通霄鎮,通東里,0,1,873,10,883,1262,3,1,3,0,1,0,69.97
苗栗縣,通霄鎮,通西里,0,1,1545,8,1553,2151,3,1,3,0,1,0,72.20
苗栗縣,通霄鎮,平元里,0,1,2419,20,2439,3591,3,1,3,0,1,0,67.92
苗栗縣,通霄鎮,五南里,0,1,926,7,933,1296,3,1,3,0,1,0,71.99
苗栗縣,通霄鎮,五北里,0,1,1013,5,1018,1435,3,1,3,0,1,0,70.94
苗栗縣,通霄鎮,梅南里,0,1,1023,9,1032,1479,3,1,3,0,1,0,69.78
苗栗縣,通霄鎮,通南里,0,1,1625,12,1637,2502,3,1,3,0,1,0,65.43
苗栗縣,通霄鎮,坪頂里,0,1,824,5,829,1184,3,1,3,0,1,0,70.02
苗栗縣,通霄鎮,福興里,0,1,440,9,449,647,3,1,3,0,1,0,69.40
苗栗縣,通霄鎮,南和里,0,1,612,5,617,827,3,1,3,0,1,0,74.61
苗栗縣,通霄鎮,城南里,0,1,665,11,676,1016,3,1,3,0,1,0,66.54
苗栗縣,通霄鎮,城北里,0,1,446,10,456,695,3,1,3,0,1,0,65.61
苗栗縣,通霄鎮,圳頭里,0,1,543,1,544,753,3,1,3,0,1,0,72.24
苗栗縣,通霄鎮,內湖里,0,1,1231,11,1242,1749,3,1,3,0,1,0,71.01
苗栗縣,通霄鎮,楓樹里,0,1,386,5,391,560,3,1,3,0,1,0,69.82
苗栗縣,通霄鎮,烏眉里,0,1,645,11,656,937,3,1,3,0,1,0,70.01
苗栗縣,通霄鎮,福龍里,0,1,342,1,343,509,3,1,3,0,1,0,67.39
苗栗縣,通霄鎮,福源里,0,1,514,5,519,779,3,1,3,0,1,0,66.62
苗栗縣,通霄鎮,通灣里,0,1,1414,16,1430,2128,3,1,3,0,1,0,67.20
苗栗縣,通霄鎮,新埔里,0,1,872,19,891,1254,3,1,3,0,1,0,71.05
苗栗縣,通霄鎮,內島里,0,1,495,9,504,759,3,1,3,0,1,0,66.40
苗栗縣,通霄鎮,白東里,0,1,805,12,817,1315,3,1,3,0,1,0,62.13
苗栗縣,通霄鎮,白西里,0,1,529,5,534,813,3,1,3,0,1,0,65.68
苗栗縣,竹南鎮,竹南里,0,1,1249,15,1264,1858,3,1,3,0,1,0,68.03
苗栗縣,竹南鎮,照南里,0,1,1586,11,1597,2318,3,1,3,0,1,0,68.90
苗栗縣,竹南鎮,正南里,0,1,1431,20,1451,2218,3,1,3,0,1,0,65.42
苗栗縣,竹南鎮,新南里,0,1,1785,17,1802,2701,3,1,3,0,1,0,66.72
苗栗縣,竹南鎮,大厝里,0,1,2063,33,2096,3066,3,1,3,0,1,0,68.36
苗栗縣,竹南鎮,營盤里,0,1,1648,17,1665,2469,3,1,3,0,1,0,67.44
苗栗縣,竹南鎮,聖福里,0,1,1391,15,1406,2175,3,1,3,0,1,0,64.64
苗栗縣,竹南鎮,竹興里,0,1,1718,46,1764,2708,3,1,3,0,1,0,65.14
苗栗縣,竹南鎮,龍鳳里,0,1,2787,28,2815,4160,3,1,3,0,1,0,67.67
苗栗縣,竹南鎮,山佳里,0,1,3030,26,3056,4860,3,1,3,0,1,0,62.88
苗栗縣,竹南鎮,中港里,0,1,598,10,608,883,3,1,3,0,1,0,68.86
苗栗縣,竹南鎮,中華里,0,1,1450,23,1473,2194,3,1,3,0,1,0,67.14
苗栗縣,竹南鎮,中英里,0,1,796,12,808,1150,3,1,3,0,1,0,70.26
苗栗縣,竹南鎮,中美里,0,1,1002,17,1019,1547,3,1,3,0,1,0,65.87
苗栗縣,竹南鎮,開元里,0,1,366,6,372,526,3,1,3,0,1,0,70.72
苗栗縣,竹南鎮,海口里,0,1,1257,16,1273,2046,3,1,3,0,1,0,62.22
苗栗縣,竹南鎮,港墘里,0,1,987,11,998,1382,3,1,3,0,1,0,72.21
苗栗縣,竹南鎮,公館里,0,1,687,13,700,1087,3,1,3,0,1,0,64.40
苗栗縣,竹南鎮,大埔里,0,1,1904,46,1950,2973,3,1,3,0,1,0,65.59
苗栗縣,竹南鎮,頂埔里,0,1,1366,24,1390,2116,3,1,3,0,1,0,65.69
苗栗縣,竹南鎮,崎頂里,0,1,1560,21,1581,2458,3,1,3,0,1,0,64.32
苗栗縣,竹南鎮,公義里,0,1,552,7,559,896,3,1,3,0,1,0,62.39
苗栗縣,頭份鎮,流東里,0,1,1356,24,1380,2003,3,1,3,0,1,0,68.90
苗栗縣,頭份鎮,珊湖里,0,1,1235,14,1249,1771,3,1,3,0,1,0,70.53
苗栗縣,頭份鎮,斗煥里,0,1,1863,16,1879,2735,3,1,3,0,1,0,68.70
苗栗縣,頭份鎮,新華里,0,1,2263,26,2289,3415,3,1,3,0,1,0,67.03
苗栗縣,頭份鎮,興隆里,0,1,1785,19,1804,2809,3,1,3,0,1,0,64.22
苗栗縣,頭份鎮,上埔里,0,1,1560,22,1582,2305,3,1,3,0,1,0,68.63
苗栗縣,頭份鎮,土牛里,0,1,524,5,529,780,3,1,3,0,1,0,67.82
苗栗縣,頭份鎮,頭份里,0,1,1651,18,1669,2638,3,1,3,0,1,0,63.27
苗栗縣,頭份鎮,忠孝里,0,1,2768,24,2792,4234,3,1,3,0,1,0,65.94
苗栗縣,頭份鎮,仁愛里,0,1,955,28,983,1510,3,1,3,0,1,0,65.10
苗栗縣,頭份鎮,信義里,0,1,532,7,539,736,3,1,3,0,1,0,73.23
苗栗縣,頭份鎮,和平里,0,1,679,5,684,983,3,1,3,0,1,0,69.58
苗栗縣,頭份鎮,上興里,0,1,756,8,764,1098,3,1,3,0,1,0,69.58
苗栗縣,頭份鎮,下興里,0,1,1293,16,1309,1998,3,1,3,0,1,0,65.52
苗栗縣,頭份鎮,山下里,0,1,1474,19,1493,2184,3,1,3,0,1,0,68.36
苗栗縣,頭份鎮,後庄里,0,1,2908,39,2947,4501,3,1,3,0,1,0,65.47
苗栗縣,頭份鎮,建國里,0,1,1536,22,1558,2415,3,1,3,0,1,0,64.51
苗栗縣,頭份鎮,成功里,0,1,1597,20,1617,2518,3,1,3,0,1,0,64.22
苗栗縣,頭份鎮,蟠桃里,0,1,1331,18,1349,2118,3,1,3,0,1,0,63.69
苗栗縣,頭份鎮,東庄里,0,1,1462,21,1483,2313,3,1,3,0,1,0,64.12
苗栗縣,頭份鎮,民族里,0,1,990,18,1008,1543,3,1,3,0,1,0,65.33
苗栗縣,頭份鎮,民權里,0,1,1038,14,1052,1632,3,1,3,0,1,0,64.46
苗栗縣,頭份鎮,民生里,0,1,1197,20,1217,1890,3,1,3,0,1,0,64.39
苗栗縣,頭份鎮,田寮里,0,1,1727,22,1749,2657,3,1,3,0,1,0,65.83
苗栗縣,頭份鎮,蘆竹里,0,1,915,11,926,1293,3,1,3,0,1,0,71.62
苗栗縣,頭份鎮,尖山里,0,1,897,15,912,1269,3,1,3,0,1,0,71.87
苗栗縣,頭份鎮,廣興里,0,1,613,7,620,866,3,1,3,0,1,0,71.59
苗栗縣,頭份鎮,尖下里,0,1,1522,22,1544,2371,3,1,3,0,1,0,65.12
苗栗縣,頭份鎮,濫坑里,0,1,1283,11,1294,1930,3,1,3,0,1,0,67.05
苗栗縣,後龍鎮,南龍里,0,1,947,19,966,1449,3,1,3,0,1,0,66.67
苗栗縣,後龍鎮,中龍里,0,1,716,7,723,955,3,1,3,0,1,0,75.71
苗栗縣,後龍鎮,北龍里,0,1,929,16,945,1403,3,1,3,0,1,0,67.36
苗栗縣,後龍鎮,大庄里,0,1,2258,27,2285,3286,3,1,3,0,1,0,69.54
苗栗縣,後龍鎮,溪洲里,0,1,1368,24,1392,2177,3,1,3,0,1,0,63.94
苗栗縣,後龍鎮,豐富里,0,1,890,8,898,1264,3,1,3,0,1,0,71.04
苗栗縣,後龍鎮,校椅里,0,1,873,13,886,1180,3,1,3,0,1,0,75.08
苗栗縣,後龍鎮,埔頂里,0,1,1495,27,1522,2233,3,1,3,0,1,0,68.16
苗栗縣,後龍鎮,新民里,0,1,916,17,933,1307,3,1,3,0,1,0,71.38
苗栗縣,後龍鎮,復興里,0,1,450,5,455,649,3,1,3,0,1,0,70.11
苗栗縣,後龍鎮,東明里,0,1,870,6,876,1399,3,1,3,0,1,0,62.62
苗栗縣,後龍鎮,大山里,0,1,969,14,983,1609,3,1,3,0,1,0,61.09
苗栗縣,後龍鎮,灣寶里,0,1,802,15,817,1319,3,1,3,0,1,0,61.94
苗栗縣,後龍鎮,海寶里,0,1,607,17,624,999,3,1,3,0,1,0,62.46
苗栗縣,後龍鎮,外埔里,0,1,657,13,670,1157,3,1,3,0,1,0,57.91
苗栗縣,後龍鎮,海埔里,0,1,600,13,613,1033,3,1,3,0,1,0,59.34
苗栗縣,後龍鎮,秀水里,0,1,471,9,480,721,3,1,3,0,1,0,66.57
苗栗縣,後龍鎮,水尾里,0,1,677,20,697,1108,3,1,3,0,1,0,62.91
苗栗縣,後龍鎮,龍津里,0,1,417,6,423,644,3,1,3,0,1,0,65.68
苗栗縣,後龍鎮,龍坑里,0,1,805,12,817,1250,3,1,3,0,1,0,65.36
苗栗縣,後龍鎮,福寧里,0,1,528,3,531,816,3,1,3,0,1,0,65.07
苗栗縣,後龍鎮,中和里,0,1,641,10,651,1224,3,1,3,0,1,0,53.19
苗栗縣,後龍鎮,南港里,0,1,716,19,735,1272,3,1,3,0,1,0,57.78
苗栗縣,卓蘭鎮,老庄里,0,1,1510,17,1527,2110,3,1,3,0,1,0,72.37
苗栗縣,卓蘭鎮,新榮里,0,1,845,5,850,1168,3,1,3,0,1,0,72.77
苗栗縣,卓蘭鎮,中街里,0,1,598,8,606,814,3,1,3,0,1,0,74.45
苗栗縣,卓蘭鎮,新厝里,0,1,1073,9,1082,1565,3,1,3,0,1,0,69.14
苗栗縣,卓蘭鎮,豐田里,0,1,733,14,747,1011,3,1,3,0,1,0,73.89
苗栗縣,卓蘭鎮,西坪里,0,1,373,8,381,564,3,1,3,0,1,0,67.55
苗栗縣,卓蘭鎮,苗豐里,0,1,507,17,524,723,3,1,3,0,1,0,72.48
苗栗縣,卓蘭鎮,上新里,0,1,1353,24,1377,1999,3,1,3,0,1,0,68.88
苗栗縣,卓蘭鎮,內灣里,0,1,1486,18,1504,2075,3,1,3,0,1,0,72.48
苗栗縣,卓蘭鎮,坪林里,0,1,933,18,951,1441,3,1,3,0,1,0,66.00
苗栗縣,卓蘭鎮,景山里,0,1,446,11,457,693,3,1,3,0,1,0,65.95
苗栗縣,大湖鄉,大湖村,0,1,1137,18,1155,1701,3,1,3,0,1,0,67.90
苗栗縣,大湖鄉,明湖村,0,1,508,3,511,673,3,1,3,0,1,0,75.93
苗栗縣,大湖鄉,靜湖村,0,1,1077,11,1088,1636,3,1,3,0,1,0,66.50
苗栗縣,大湖鄉,富興村,0,1,874,24,898,1364,3,1,3,0,1,0,65.84
苗栗縣,大湖鄉,大南村,0,1,403,9,412,662,3,1,3,0,1,0,62.24
苗栗縣,大湖鄉,大寮村,0,1,800,11,811,1238,3,1,3,0,1,0,65.51
苗栗縣,大湖鄉,南湖村,0,1,497,10,507,749,3,1,3,0,1,0,67.69
苗栗縣,大湖鄉,義和村,0,1,957,11,968,1516,3,1,3,0,1,0,63.85
苗栗縣,大湖鄉,東興村,0,1,503,3,506,745,3,1,3,0,1,0,67.92
苗栗縣,大湖鄉,武榮村,0,1,356,3,359,528,3,1,3,0,1,0,67.99
苗栗縣,大湖鄉,栗林村,0,1,575,7,582,910,3,1,3,0,1,0,63.96
苗栗縣,大湖鄉,新開村,0,1,546,10,556,888,3,1,3,0,1,0,62.61
苗栗縣,公館鄉,館中村,0,1,1103,19,1122,1522,3,1,3,0,1,0,73.72
苗栗縣,公館鄉,館東村,0,1,1453,39,1492,2129,3,1,3,0,1,0,70.08
苗栗縣,公館鄉,館南村,0,1,1820,22,1842,2674,3,1,3,0,1,0,68.89
苗栗縣,公館鄉,中義村,0,1,1281,28,1309,1941,3,1,3,0,1,0,67.44
苗栗縣,公館鄉,玉泉村,0,1,1141,22,1163,1656,3,1,3,0,1,0,70.23
苗栗縣,公館鄉,大坑村,0,1,654,21,675,963,3,1,3,0,1,0,70.09
苗栗縣,公館鄉,福基村,0,1,736,14,750,1062,3,1,3,0,1,0,70.62
苗栗縣,公館鄉,福德村,0,1,278,5,283,406,3,1,3,0,1,0,69.70
苗栗縣,公館鄉,福星村,0,1,1081,21,1102,1634,3,1,3,0,1,0,67.44
苗栗縣,公館鄉,石墻村,0,1,981,21,1002,1416,3,1,3,0,1,0,70.76
苗栗縣,公館鄉,開礦村,0,1,250,2,252,318,3,1,3,0,1,0,79.25
苗栗縣,公館鄉,五谷村,0,1,1197,23,1220,1756,3,1,3,0,1,0,69.48
苗栗縣,公館鄉,玉谷村,0,1,763,12,775,1078,3,1,3,0,1,0,71.89
苗栗縣,公館鄉,鶴岡村,0,1,1029,14,1043,1401,3,1,3,0,1,0,74.45
苗栗縣,公館鄉,鶴山村,0,1,929,14,943,1325,3,1,3,0,1,0,71.17
苗栗縣,公館鄉,尖山村,0,1,897,17,914,1367,3,1,3,0,1,0,66.86
苗栗縣,公館鄉,仁安村,0,1,815,12,827,1159,3,1,3,0,1,0,71.35
苗栗縣,公館鄉,南河村,0,1,160,4,164,233,3,1,3,0,1,0,70.39
苗栗縣,公館鄉,北河村,0,1,235,5,240,305,3,1,3,0,1,0,78.69
苗栗縣,銅鑼鄉,福興村,0,1,723,7,730,1046,3,1,3,0,1,0,69.79
苗栗縣,銅鑼鄉,朝陽村,0,1,1106,25,1131,1639,3,1,3,0,1,0,69.01
苗栗縣,銅鑼鄉,竹森村,0,1,698,9,707,1078,3,1,3,0,1,0,65.58
苗栗縣,銅鑼鄉,銅鑼村,0,1,2816,28,2844,4130,3,1,3,0,1,0,68.86
苗栗縣,銅鑼鄉,九湖村,0,1,879,16,895,1263,3,1,3,0,1,0,70.86
苗栗縣,銅鑼鄉,樟樹村,0,1,840,11,851,1244,3,1,3,0,1,0,68.41
苗栗縣,銅鑼鄉,中平村,0,1,1767,28,1795,2737,3,1,3,0,1,0,65.58
苗栗縣,銅鑼鄉,興隆村,0,1,432,7,439,634,3,1,3,0,1,0,69.24
苗栗縣,銅鑼鄉,盛隆村,0,1,318,9,327,499,3,1,3,0,1,0,65.53
苗栗縣,銅鑼鄉,新隆村,0,1,364,5,369,566,3,1,3,0,1,0,65.19
苗栗縣,南庄鄉,東,0,1,847,11,858,1268,3,1,3,0,1,0,67.67
苗栗縣,南庄鄉,西,0,1,447,7,454,674,3,1,3,0,1,0,67.36
苗栗縣,南庄鄉,南江村,0,1,716,12,728,1063,3,1,3,0,1,0,68.49
苗栗縣,南庄鄉,田美村,0,1,521,8,529,865,3,1,3,0,1,0,61.16
苗栗縣,南庄鄉,獅山村,0,1,625,5,630,1001,3,1,3,0,1,0,62.94
苗栗縣,南庄鄉,南富村,0,1,750,10,760,1066,3,1,3,0,1,0,71.29
苗栗縣,南庄鄉,員林村,0,1,683,6,689,1059,3,1,3,0,1,0,65.06
苗栗縣,南庄鄉,蓬萊村,0,1,274,3,277,450,3,1,3,0,1,0,61.56
苗栗縣,南庄鄉,東河村,0,1,167,1,168,286,3,1,3,0,1,0,58.74
苗栗縣,頭屋鄉,頭屋村,0,1,1674,13,1687,2367,3,1,3,0,1,0,71.27
苗栗縣,頭屋鄉,獅潭村,0,1,1079,15,1094,1586,3,1,3,0,1,0,68.98
苗栗縣,頭屋鄉,北坑村,0,1,440,9,449,658,3,1,3,0,1,0,68.24
苗栗縣,頭屋鄉,曲洞村,0,1,623,4,627,851,3,1,3,0,1,0,73.68
苗栗縣,頭屋鄉,飛鳳村,0,1,246,0,246,344,3,1,3,0,1,0,71.51
苗栗縣,頭屋鄉,象山村,0,1,1210,27,1237,1856,3,1,3,0,1,0,66.65
苗栗縣,頭屋鄉,明德村,0,1,796,12,808,1104,3,1,3,0,1,0,73.19
苗栗縣,頭屋鄉,鳴鳳村,0,1,225,1,226,332,3,1,3,0,1,0,68.07
苗栗縣,三義鄉,廣盛村,0,1,2661,45,2706,3881,3,1,3,0,1,0,69.72
苗栗縣,三義鄉,勝興村,0,1,1805,27,1832,2875,3,1,3,0,1,0,63.72
苗栗縣,三義鄉,雙湖村,0,1,1151,16,1167,1627,3,1,3,0,1,0,71.73
苗栗縣,三義鄉,雙潭村,0,1,948,24,972,1352,3,1,3,0,1,0,71.89
苗栗縣,三義鄉,西湖村,0,1,895,15,910,1282,3,1,3,0,1,0,70.98
苗栗縣,三義鄉,龍騰村,0,1,304,7,311,403,3,1,3,0,1,0,77.17
苗栗縣,三義鄉,鯉魚潭村,0,1,835,10,845,1172,3,1,3,0,1,0,72.10
苗栗縣,西湖鄉,高埔村,0,1,418,7,425,606,3,1,3,0,1,0,70.13
苗栗縣,西湖鄉,下埔村,0,1,407,0,407,560,3,1,3,0,1,0,72.68
苗栗縣,西湖鄉,五湖村,0,1,603,9,612,915,3,1,3,0,1,0,66.89
苗栗縣,西湖鄉,四湖村,0,1,448,6,454,645,3,1,3,0,1,0,70.39
苗栗縣,西湖鄉,三湖村,0,1,630,13,643,971,3,1,3,0,1,0,66.22
苗栗縣,西湖鄉,龍洞村,0,1,353,4,357,540,3,1,3,0,1,0,66.11
苗栗縣,西湖鄉,金獅村,0,1,338,8,346,538,3,1,3,0,1,0,64.31
苗栗縣,西湖鄉,湖東村,0,1,734,21,755,1145,3,1,3,0,1,0,65.94
苗栗縣,西湖鄉,二湖村,0,1,417,7,424,650,3,1,3,0,1,0,65.23
苗栗縣,造橋鄉,造橋村,0,1,1132,13,1145,1669,3,1,3,0,1,0,68.60
苗栗縣,造橋鄉,平興村,0,1,340,9,349,477,3,1,3,0,1,0,73.17
苗栗縣,造橋鄉,豐湖村,0,1,678,7,685,971,3,1,3,0,1,0,70.55
苗栗縣,造橋鄉,大西村,0,1,1980,27,2007,2964,3,1,3,0,1,0,67.71
苗栗縣,造橋鄉,錦水村,0,1,373,7,380,538,3,1,3,0,1,0,70.63
苗栗縣,造橋鄉,大龍村,0,1,380,2,382,506,3,1,3,0,1,0,75.49
苗栗縣,造橋鄉,朝陽村,0,1,886,10,896,1363,3,1,3,0,1,0,65.74
苗栗縣,造橋鄉,談文村,0,1,485,8,493,712,3,1,3,0,1,0,69.24
苗栗縣,造橋鄉,龍昇村,0,1,676,12,688,1003,3,1,3,0,1,0,68.59
苗栗縣,三灣鄉,三灣村,0,1,1408,10,1418,2099,3,1,3,0,1,0,67.56
苗栗縣,三灣鄉,內灣村,0,1,428,4,432,598,3,1,3,0,1,0,72.24
苗栗縣,三灣鄉,銅鏡村,0,1,562,7,569,840,3,1,3,0,1,0,67.74
苗栗縣,三灣鄉,頂寮村,0,1,162,3,165,231,3,1,3,0,1,0,71.43
苗栗縣,三灣鄉,北埔村,0,1,367,4,371,546,3,1,3,0,1,0,67.95
苗栗縣,三灣鄉,大河村,0,1,411,2,413,622,3,1,3,0,1,0,66.40
苗栗縣,三灣鄉,大坪村,0,1,316,4,320,484,3,1,3,0,1,0,66.12
苗栗縣,三灣鄉,永和村,0,1,249,2,251,352,3,1,3,0,1,0,71.31
苗栗縣,獅潭鄉,百壽村,0,1,176,4,180,272,3,1,3,0,1,0,66.18
苗栗縣,獅潭鄉,永興村,0,1,398,8,406,643,3,1,3,0,1,0,63.14
苗栗縣,獅潭鄉,新店村,0,1,666,5,671,958,3,1,3,0,1,0,70.04
苗栗縣,獅潭鄉,和興村,0,1,416,5,421,628,3,1,3,0,1,0,67.04
苗栗縣,獅潭鄉,豐林村,0,1,425,8,433,641,3,1,3,0,1,0,67.55
苗栗縣,獅潭鄉,新豐村,0,1,223,4,227,352,3,1,3,0,1,0,64.49
苗栗縣,獅潭鄉,竹木村,0,1,509,7,516,763,3,1,3,0,1,0,67.63
苗栗縣,泰安鄉,八卦村,0,1,99,3,102,137,3,1,3,0,1,0,74.45
苗栗縣,泰安鄉,錦水村,0,1,236,3,239,391,3,1,3,0,1,0,61.13
苗栗縣,泰安鄉,清安村,0,1,412,6,418,622,3,1,3,0,1,0,67.20
苗栗縣,泰安鄉,大興村,0,1,67,0,67,104,3,1,3,0,1,0,64.42
苗栗縣,泰安鄉,中興村,0,1,85,1,86,120,3,1,3,0,1,0,71.67
苗栗縣,泰安鄉,梅園村,0,1,17,0,17,26,3,1,3,0,1,0,65.38
苗栗縣,泰安鄉,象鼻村,0,1,30,0,30,49,3,1,3,0,1,0,61.22
苗栗縣,泰安鄉,士林村,0,1,15,1,16,31,3,1,3,0,1,0,51.61
臺中縣,豐原市,豐原里,0,1,1248,19,1267,1920,3,1,3,0,1,0,65.99
臺中縣,豐原市,豐榮里,0,1,664,8,672,1033,3,1,3,0,1,0,65.05
臺中縣,豐原市,頂街里,0,1,561,3,564,880,3,1,3,0,1,0,64.09
臺中縣,豐原市,中山里,0,1,675,6,681,945,3,1,3,0,1,0,72.06
臺中縣,豐原市,下街里,0,1,549,5,554,801,3,1,3,0,1,0,69.16
臺中縣,豐原市,中陽里,0,1,2981,34,3015,4447,3,1,3,0,1,0,67.80
臺中縣,豐原市,大湳里,0,1,1387,11,1398,2065,3,1,3,0,1,0,67.70
臺中縣,豐原市,北湳里,0,1,1588,23,1611,2431,3,1,3,0,1,0,66.27
臺中縣,豐原市,東湳里,0,1,2410,45,2455,3621,3,1,3,0,1,0,67.80
臺中縣,豐原市,西湳里,0,1,3921,73,3994,6141,3,1,3,0,1,0,65.04
臺中縣,豐原市,豐西里,0,1,1174,14,1188,1732,3,1,3,0,1,0,68.59
臺中縣,豐原市,圳寮里,0,1,851,13,864,1208,3,1,3,0,1,0,71.52
臺中縣,豐原市,豐圳里,0,1,1759,24,1783,2685,3,1,3,0,1,0,66.41
臺中縣,豐原市,富春里,0,1,660,6,666,880,3,1,3,0,1,0,75.68
臺中縣,豐原市,葫蘆里,0,1,566,6,572,808,3,1,3,0,1,0,70.79
臺中縣,豐原市,西安里,0,1,3157,34,3191,4667,3,1,3,0,1,0,68.37
臺中縣,豐原市,西勢里,0,1,1457,17,1474,2143,3,1,3,0,1,0,68.78
臺中縣,豐原市,中興里,0,1,1810,40,1850,2719,3,1,3,0,1,0,68.04
臺中縣,豐原市,社皮里,0,1,4538,61,4599,7293,3,1,3,0,1,0,63.06
臺中縣,豐原市,三村里,0,1,3015,49,3064,4675,3,1,3,0,1,0,65.54
臺中縣,豐原市,東勢里,0,1,969,17,986,1420,3,1,3,0,1,0,69.44
臺中縣,豐原市,民生里,0,1,664,7,671,1052,3,1,3,0,1,0,63.78
臺中縣,豐原市,田心里,0,1,2926,44,2970,4510,3,1,3,0,1,0,65.85
臺中縣,豐原市,豐田里,0,1,5365,113,5478,8281,3,1,3,0,1,0,66.15
臺中縣,豐原市,鐮村里,0,1,2253,39,2292,3394,3,1,3,0,1,0,67.53
臺中縣,豐原市,陽明里,0,1,1584,29,1613,2372,3,1,3,0,1,0,68.00
臺中縣,豐原市,南陽里,0,1,4236,66,4302,6530,3,1,3,0,1,0,65.88
臺中縣,豐原市,北陽里,0,1,6249,74,6323,9475,3,1,3,0,1,0,66.73
臺中縣,豐原市,東陽里,0,1,950,10,960,1433,3,1,3,0,1,0,66.99
臺中縣,豐原市,南村里,0,1,2551,30,2581,3904,3,1,3,0,1,0,66.11
臺中縣,豐原市,南田里,0,1,1959,21,1980,2907,3,1,3,0,1,0,68.11
臺中縣,豐原市,南嵩里,0,1,1790,24,1814,2697,3,1,3,0,1,0,67.26
臺中縣,豐原市,翁明里,0,1,1115,19,1134,1636,3,1,3,0,1,0,69.32
臺中縣,豐原市,翁子里,0,1,1550,26,1576,2319,3,1,3,0,1,0,67.96
臺中縣,豐原市,翁社里,0,1,1228,27,1255,1799,3,1,3,0,1,0,69.76
臺中縣,豐原市,朴子里,0,1,1843,29,1872,2817,3,1,3,0,1,0,66.45
臺中縣,東勢鎮,北興里,0,1,757,11,768,1137,3,1,3,0,1,0,67.55
臺中縣,東勢鎮,中寧里,0,1,568,11,579,830,3,1,3,0,1,0,69.76
臺中縣,東勢鎮,東安里,0,1,857,19,876,1341,3,1,3,0,1,0,65.32
臺中縣,東勢鎮,南平里,0,1,1257,19,1276,1815,3,1,3,0,1,0,70.30
臺中縣,東勢鎮,延平里,0,1,1481,24,1505,2228,3,1,3,0,1,0,67.55
臺中縣,東勢鎮,上新里,0,1,640,10,650,964,3,1,3,0,1,0,67.43
臺中縣,東勢鎮,廣興里,0,1,1009,19,1028,1538,3,1,3,0,1,0,66.84
臺中縣,東勢鎮,泰昌里,0,1,1989,28,2017,3060,3,1,3,0,1,0,65.92
臺中縣,東勢鎮,中嵙里,0,1,1129,14,1143,1820,3,1,3,0,1,0,62.80
臺中縣,東勢鎮,福隆里,0,1,1964,34,1998,3022,3,1,3,0,1,0,66.12
臺中縣,東勢鎮,隆興里,0,1,852,14,866,1347,3,1,3,0,1,0,64.29
臺中縣,東勢鎮,新盛里,0,1,3057,64,3121,4618,3,1,3,0,1,0,67.58
臺中縣,東勢鎮,詒福里,0,1,932,13,945,1447,3,1,3,0,1,0,65.31
臺中縣,東勢鎮,上城里,0,1,658,11,669,977,3,1,3,0,1,0,68.47
臺中縣,東勢鎮,下城里,0,1,644,3,647,887,3,1,3,0,1,0,72.94
臺中縣,東勢鎮,慶東里,0,1,1282,10,1292,1918,3,1,3,0,1,0,67.36
臺中縣,東勢鎮,慶福里,0,1,814,16,830,1390,3,1,3,0,1,0,59.71
臺中縣,東勢鎮,東新里,0,1,1318,14,1332,1981,3,1,3,0,1,0,67.24
臺中縣,東勢鎮,粵寧里,0,1,1095,18,1113,1694,3,1,3,0,1,0,65.70
臺中縣,東勢鎮,下新里,0,1,1037,17,1054,1580,3,1,3,0,1,0,66.71
臺中縣,東勢鎮,興隆里,0,1,759,10,769,1221,3,1,3,0,1,0,62.98
臺中縣,東勢鎮,茂興里,0,1,989,17,1006,1684,3,1,3,0,1,0,59.74
臺中縣,東勢鎮,泰興里,0,1,473,10,483,734,3,1,3,0,1,0,65.80
臺中縣,東勢鎮,埤頭里,0,1,487,9,496,657,3,1,3,0,1,0,75.49
臺中縣,東勢鎮,明正里,0,1,923,23,946,1380,3,1,3,0,1,0,68.55
臺中縣,大甲鎮,朝陽里,0,1,859,12,871,1249,3,1,3,0,1,0,69.74
臺中縣,大甲鎮,大甲里,0,1,762,12,774,1161,3,1,3,0,1,0,66.67
臺中縣,大甲鎮,順天里,0,1,1088,13,1101,1644,3,1,3,0,1,0,66.97
臺中縣,大甲鎮,孔門里,0,1,516,8,524,745,3,1,3,0,1,0,70.34
臺中縣,大甲鎮,平安里,0,1,1236,21,1257,1886,3,1,3,0,1,0,66.65
臺中縣,大甲鎮,庄美里,0,1,1306,14,1320,1923,3,1,3,0,1,0,68.64
臺中縣,大甲鎮,新美里,0,1,2080,34,2114,3090,3,1,3,0,1,0,68.41
臺中縣,大甲鎮,岷山里,0,1,1144,18,1162,1689,3,1,3,0,1,0,68.80
臺中縣,大甲鎮,中山里,0,1,2001,36,2037,3176,3,1,3,0,1,0,64.14
臺中縣,大甲鎮,南陽里,0,1,570,5,575,845,3,1,3,0,1,0,68.05
臺中縣,大甲鎮,薰風里,0,1,585,5,590,892,3,1,3,0,1,0,66.14
臺中縣,大甲鎮,義和里,0,1,1650,35,1685,2541,3,1,3,0,1,0,66.31
臺中縣,大甲鎮,武陵里,0,1,797,18,815,1056,3,1,3,0,1,0,77.18
臺中縣,大甲鎮,文曲里,0,1,709,19,728,1068,3,1,3,0,1,0,68.16
臺中縣,大甲鎮,武曲里,0,1,1031,18,1049,1493,3,1,3,0,1,0,70.26
臺中縣,大甲鎮,文武里,0,1,2798,28,2826,4304,3,1,3,0,1,0,65.66
臺中縣,大甲鎮,奉化里,0,1,825,20,845,1234,3,1,3,0,1,0,68.48
臺中縣,大甲鎮,德化里,0,1,1008,13,1021,1551,3,1,3,0,1,0,65.83
臺中縣,大甲鎮,江南里,0,1,669,9,678,979,3,1,3,0,1,0,69.25
臺中縣,大甲鎮,頂店里,0,1,2110,33,2143,3224,3,1,3,0,1,0,66.47
臺中縣,大甲鎮,太白里,0,1,736,10,746,1193,3,1,3,0,1,0,62.53
臺中縣,大甲鎮,孟春里,0,1,1933,19,1952,3069,3,1,3,0,1,0,63.60
臺中縣,大甲鎮,幸福里,0,1,1452,20,1472,2300,3,1,3,0,1,0,64.00
臺中縣,大甲鎮,日南里,0,1,2351,28,2379,3805,3,1,3,0,1,0,62.52
臺中縣,大甲鎮,龍泉里,0,1,913,17,930,1358,3,1,3,0,1,0,68.48
臺中縣,大甲鎮,西岐里,0,1,991,20,1011,1424,3,1,3,0,1,0,71.00
臺中縣,大甲鎮,銅安里,0,1,763,24,787,1186,3,1,3,0,1,0,66.36
臺中縣,大甲鎮,福德里,0,1,752,12,764,1048,3,1,3,0,1,0,72.90
臺中縣,大甲鎮,建興里,0,1,876,8,884,1257,3,1,3,0,1,0,70.33
臺中縣,清水鎮,鰲峰里,0,1,776,5,781,1183,3,1,3,0,1,0,66.02
臺中縣,清水鎮,靈泉里,0,1,732,12,744,1063,3,1,3,0,1,0,69.99
臺中縣,清水鎮,清水里,0,1,1340,11,1351,2027,3,1,3,0,1,0,66.65
臺中縣,清水鎮,文昌里,0,1,473,6,479,731,3,1,3,0,1,0,65.53
臺中縣,清水鎮,南寧里,0,1,1245,12,1257,1840,3,1,3,0,1,0,68.32
臺中縣,清水鎮,西寧里,0,1,944,12,956,1438,3,1,3,0,1,0,66.48
臺中縣,清水鎮,北寧里,0,1,509,8,517,736,3,1,3,0,1,0,70.24
臺中縣,清水鎮,中興里,0,1,302,6,308,450,3,1,3,0,1,0,68.44
臺中縣,清水鎮,西社里,0,1,1572,36,1608,2408,3,1,3,0,1,0,66.78
臺中縣,清水鎮,南社里,0,1,3151,46,3197,4752,3,1,3,0,1,0,67.28
臺中縣,清水鎮,裕嘉里,0,1,733,17,750,1158,3,1,3,0,1,0,64.77
臺中縣,清水鎮,臨江里,0,1,929,19,948,1434,3,1,3,0,1,0,66.11
臺中縣,清水鎮,秀水里,0,1,2180,33,2213,3371,3,1,3,0,1,0,65.65
臺中縣,清水鎮,武鹿里,0,1,1723,29,1752,2634,3,1,3,0,1,0,66.51
臺中縣,清水鎮,海濱里,0,1,1214,26,1240,1842,3,1,3,0,1,0,67.32
臺中縣,清水鎮,康榔里,0,1,2167,40,2207,3377,3,1,3,0,1,0,65.35
臺中縣,清水鎮,中社里,0,1,983,9,992,1453,3,1,3,0,1,0,68.27
臺中縣,清水鎮,高西里,0,1,830,21,851,1315,3,1,3,0,1,0,64.71
臺中縣,清水鎮,高南里,0,1,836,15,851,1285,3,1,3,0,1,0,66.23
臺中縣,清水鎮,高東里,0,1,750,13,763,1263,3,1,3,0,1,0,60.41
臺中縣,清水鎮,高北里,0,1,677,21,698,1061,3,1,3,0,1,0,65.79
臺中縣,清水鎮,高美里,0,1,804,6,810,1222,3,1,3,0,1,0,66.28
臺中縣,清水鎮,國姓里,0,1,1199,15,1214,1967,3,1,3,0,1,0,61.72
臺中縣,清水鎮,菁埔里,0,1,1348,26,1374,2152,3,1,3,0,1,0,63.85
臺中縣,清水鎮,頂湳里,0,1,1069,13,1082,1708,3,1,3,0,1,0,63.35
臺中縣,清水鎮,田寮里,0,1,1245,21,1266,2072,3,1,3,0,1,0,61.10
臺中縣,清水鎮,橋頭里,0,1,3369,39,3408,5429,3,1,3,0,1,0,62.77
臺中縣,清水鎮,下湳里,0,1,1827,19,1846,2840,3,1,3,0,1,0,65.00
臺中縣,清水鎮,東山里,0,1,712,17,729,1102,3,1,3,0,1,0,66.15
臺中縣,清水鎮,吳厝里,0,1,899,17,916,1244,3,1,3,0,1,0,73.63
臺中縣,清水鎮,楊厝里,0,1,649,10,659,1004,3,1,3,0,1,0,65.64
臺中縣,清水鎮,海風里,0,1,677,11,688,1174,3,1,3,0,1,0,58.60
臺中縣,沙鹿鎮,居仁里,0,1,936,11,947,1384,3,1,3,0,1,0,68.42
臺中縣,沙鹿鎮,洛泉里,0,1,1507,24,1531,2176,3,1,3,0,1,0,70.36
臺中縣,沙鹿鎮,沙鹿里,0,1,789,6,795,1164,3,1,3,0,1,0,68.30
臺中縣,沙鹿鎮,美仁里,0,1,413,4,417,557,3,1,3,0,1,0,74.87
臺中縣,沙鹿鎮,興仁里,0,1,1493,28,1521,2249,3,1,3,0,1,0,67.63
臺中縣,沙鹿鎮,興安里,0,1,1740,31,1771,2509,3,1,3,0,1,0,70.59
臺中縣,沙鹿鎮,斗抵里,0,1,2380,45,2425,3533,3,1,3,0,1,0,68.64
臺中縣,沙鹿鎮,鹿峰里,0,1,2360,41,2401,3711,3,1,3,0,1,0,64.70
臺中縣,沙鹿鎮,鹿寮里,0,1,3202,47,3249,4898,3,1,3,0,1,0,66.33
臺中縣,沙鹿鎮,竹林里,0,1,3448,60,3508,5183,3,1,3,0,1,0,67.68
臺中縣,沙鹿鎮,犁分里,0,1,587,7,594,843,3,1,3,0,1,0,70.46
臺中縣,沙鹿鎮,福興里,0,1,1444,16,1460,2107,3,1,3,0,1,0,69.29
臺中縣,沙鹿鎮,北勢里,0,1,2082,40,2122,3082,3,1,3,0,1,0,68.85
臺中縣,沙鹿鎮,晉江里,0,1,849,18,867,1189,3,1,3,0,1,0,72.92
臺中縣,沙鹿鎮,六路里,0,1,1357,27,1384,2044,3,1,3,0,1,0,67.71
臺中縣,沙鹿鎮,南勢里,0,1,1271,25,1296,1764,3,1,3,0,1,0,73.47
臺中縣,沙鹿鎮,埔子里,0,1,2844,47,2891,3923,3,1,3,0,1,0,73.69
臺中縣,沙鹿鎮,公明里,0,1,2201,31,2232,3370,3,1,3,0,1,0,66.23
臺中縣,沙鹿鎮,清泉里,0,1,1198,17,1215,1750,3,1,3,0,1,0,69.43
臺中縣,沙鹿鎮,西勢里,0,1,1334,31,1365,1985,3,1,3,0,1,0,68.77
臺中縣,梧棲鎮,頂寮里,0,1,1693,25,1718,2416,3,1,3,0,1,0,71.11
臺中縣,梧棲鎮,下寮里,0,1,1387,33,1420,1947,3,1,3,0,1,0,72.93
臺中縣,梧棲鎮,中正里,0,1,2177,38,2215,3182,3,1,3,0,1,0,69.61
臺中縣,梧棲鎮,中和里,0,1,414,5,419,554,3,1,3,0,1,0,75.63
臺中縣,梧棲鎮,文化里,0,1,888,19,907,1151,3,1,3,0,1,0,78.80
臺中縣,梧棲鎮,安仁里,0,1,537,10,547,741,3,1,3,0,1,0,73.82
臺中縣,梧棲鎮,草湳里,0,1,3405,61,3466,4833,3,1,3,0,1,0,71.72
臺中縣,梧棲鎮,南簡里,0,1,1633,35,1668,2283,3,1,3,0,1,0,73.06
臺中縣,梧棲鎮,福德里,0,1,1849,32,1881,2640,3,1,3,0,1,0,71.25
臺中縣,梧棲鎮,大庄里,0,1,3248,73,3321,4730,3,1,3,0,1,0,70.21
臺中縣,梧棲鎮,大村里,0,1,2281,45,2326,3301,3,1,3,0,1,0,70.46
臺中縣,梧棲鎮,興農里,0,1,1239,27,1266,1712,3,1,3,0,1,0,73.95
臺中縣,梧棲鎮,永寧里,0,1,1527,32,1559,2052,3,1,3,0,1,0,75.97
臺中縣,梧棲鎮,永安里,0,1,1569,32,1601,2178,3,1,3,0,1,0,73.51
臺中縣,后里鄉,廣福村,0,1,1295,32,1327,1841,3,1,3,0,1,0,72.08
臺中縣,后里鄉,仁里村,0,1,1618,22,1640,2258,3,1,3,0,1,0,72.63
臺中縣,后里鄉,義里村,0,1,3375,52,3427,5049,3,1,3,0,1,0,67.87
臺中縣,后里鄉,后里村,0,1,2324,39,2363,3318,3,1,3,0,1,0,71.22
臺中縣,后里鄉,厚里村,0,1,1233,19,1252,1777,3,1,3,0,1,0,70.46
臺中縣,后里鄉,墩東村,0,1,2746,48,2794,3903,3,1,3,0,1,0,71.59
臺中縣,后里鄉,墩西村,0,1,1306,21,1327,1811,3,1,3,0,1,0,73.27
臺中縣,后里鄉,墩南村,0,1,1675,24,1699,2458,3,1,3,0,1,0,69.12
臺中縣,后里鄉,墩北村,0,1,1910,36,1946,2702,3,1,3,0,1,0,72.02
臺中縣,后里鄉,中和村,0,1,1327,22,1349,1866,3,1,3,0,1,0,72.29
臺中縣,后里鄉,舊社村,0,1,863,29,892,1226,3,1,3,0,1,0,72.76
臺中縣,后里鄉,聯合村,0,1,988,23,1011,1461,3,1,3,0,1,0,69.20
臺中縣,后里鄉,太平村,0,1,1333,25,1358,1915,3,1,3,0,1,0,70.91
臺中縣,后里鄉,眉山村,0,1,1607,25,1632,2382,3,1,3,0,1,0,68.51
臺中縣,后里鄉,樂業村,0,1,234,8,242,331,3,1,3,0,1,0,73.11
臺中縣,后里鄉,月眉村,0,1,1081,24,1105,1538,3,1,3,0,1,0,71.85
臺中縣,后里鄉,公舘村,0,1,1141,22,1163,1687,3,1,3,0,1,0,68.94
臺中縣,后里鄉,泰安村,0,1,844,18,862,1231,3,1,3,0,1,0,70.02
臺中縣,神岡鄉,神岡村,0,1,1630,16,1646,2353,3,1,3,0,1,0,69.95
臺中縣,神岡鄉,庄前村,0,1,1012,9,1021,1468,3,1,3,0,1,0,69.55
臺中縣,神岡鄉,北庄村,0,1,1409,20,1429,2025,3,1,3,0,1,0,70.57
臺中縣,神岡鄉,庄後村,0,1,1288,27,1315,1920,3,1,3,0,1,0,68.49
臺中縣,神岡鄉,圳前村,0,1,1406,29,1435,2058,3,1,3,0,1,0,69.73
臺中縣,神岡鄉,圳堵村,0,1,1364,22,1386,1917,3,1,3,0,1,0,72.30
臺中縣,神岡鄉,新庄村,0,1,2262,38,2300,3432,3,1,3,0,1,0,67.02
臺中縣,神岡鄉,山皮村,0,1,645,11,656,897,3,1,3,0,1,0,73.13
臺中縣,神岡鄉,社口村,0,1,3336,35,3371,4931,3,1,3,0,1,0,68.36
臺中縣,神岡鄉,社南村,0,1,2503,50,2553,3816,3,1,3,0,1,0,66.90
臺中縣,神岡鄉,三角村,0,1,1357,21,1378,2027,3,1,3,0,1,0,67.98
臺中縣,神岡鄉,大社村,0,1,1861,28,1889,2938,3,1,3,0,1,0,64.30
臺中縣,神岡鄉,岸裡村,0,1,1659,24,1683,2378,3,1,3,0,1,0,70.77
臺中縣,神岡鄉,豐洲村,0,1,3870,76,3946,5941,3,1,3,0,1,0,66.42
臺中縣,神岡鄉,神洲村,0,1,1490,37,1527,2203,3,1,3,0,1,0,69.31
臺中縣,神岡鄉,溪洲村,0,1,1708,40,1748,2418,3,1,3,0,1,0,72.29
臺中縣,潭子鄉,潭秀村,0,1,923,8,931,1357,3,1,3,0,1,0,68.61
臺中縣,潭子鄉,潭北村,0,1,1279,26,1305,1998,3,1,3,0,1,0,65.32
臺中縣,潭子鄉,潭陽村,0,1,5099,64,5163,8159,3,1,3,0,1,0,63.28
臺中縣,潭子鄉,福仁村,0,1,4100,72,4172,6697,3,1,3,0,1,0,62.30
臺中縣,潭子鄉,頭家村,0,1,7235,108,7343,11975,3,1,3,0,1,0,61.32
臺中縣,潭子鄉,甘蔗村,0,1,3619,51,3670,5873,3,1,3,0,1,0,62.49
臺中縣,潭子鄉,東寶村,0,1,5358,80,5438,8319,3,1,3,0,1,0,65.37
臺中縣,潭子鄉,大富村,0,1,1042,22,1064,1678,3,1,3,0,1,0,63.41
臺中縣,潭子鄉,大豐村,0,1,1877,27,1904,2960,3,1,3,0,1,0,64.32
臺中縣,潭子鄉,栗林村,0,1,2668,36,2704,4017,3,1,3,0,1,0,67.31
臺中縣,潭子鄉,嘉仁村,0,1,2112,47,2159,3235,3,1,3,0,1,0,66.74
臺中縣,潭子鄉,新田村,0,1,861,18,879,1442,3,1,3,0,1,0,60.96
臺中縣,潭子鄉,聚興村,0,1,1731,34,1765,2802,3,1,3,0,1,0,62.99
臺中縣,大雅鄉,上雅村,0,1,2179,36,2215,3569,3,1,3,0,1,0,62.06
臺中縣,大雅鄉,大雅村,0,1,2336,24,2360,3649,3,1,3,0,1,0,64.68
臺中縣,大雅鄉,文雅村,0,1,2545,53,2598,4145,3,1,3,0,1,0,62.68
臺中縣,大雅鄉,三和村,0,1,2156,39,2195,3481,3,1,3,0,1,0,63.06
臺中縣,大雅鄉,二和村,0,1,2078,29,2107,3415,3,1,3,0,1,0,61.70
臺中縣,大雅鄉,四德村,0,1,1724,20,1744,2785,3,1,3,0,1,0,62.62
臺中縣,大雅鄉,西寶村,0,1,1853,27,1880,2910,3,1,3,0,1,0,64.60
臺中縣,大雅鄉,上楓村,0,1,5539,107,5646,9253,3,1,3,0,1,0,61.02
臺中縣,大雅鄉,員林村,0,1,3546,53,3599,5420,3,1,3,0,1,0,66.40
臺中縣,大雅鄉,六寶村,0,1,3350,48,3398,5116,3,1,3,0,1,0,66.42
臺中縣,大雅鄉,秀山村,0,1,1786,32,1818,2632,3,1,3,0,1,0,69.07
臺中縣,大雅鄉,橫山村,0,1,2077,33,2110,3139,3,1,3,0,1,0,67.22
臺中縣,大雅鄉,忠義村,0,1,2158,32,2190,3162,3,1,3,0,1,0,69.26
臺中縣,新社鄉,新社村,0,1,1949,28,1977,2777,3,1,3,0,1,0,71.19
臺中縣,新社鄉,復盛村,0,1,1126,20,1146,1675,3,1,3,0,1,0,68.42
臺中縣,新社鄉,中正村,0,1,843,18,861,1208,3,1,3,0,1,0,71.27
臺中縣,新社鄉,月湖村,0,1,606,12,618,911,3,1,3,0,1,0,67.84
臺中縣,新社鄉,崑山村,0,1,806,21,827,1194,3,1,3,0,1,0,69.26
臺中縣,新社鄉,大南村,0,1,1309,25,1334,1939,3,1,3,0,1,0,68.80
臺中縣,新社鄉,永源村,0,1,1723,61,1784,2564,3,1,3,0,1,0,69.58
臺中縣,新社鄉,中興村,0,1,547,10,557,770,3,1,3,0,1,0,72.34
臺中縣,新社鄉,協成村,0,1,1735,24,1759,2500,3,1,3,0,1,0,70.36
臺中縣,新社鄉,東興村,0,1,870,14,884,1269,3,1,3,0,1,0,69.66
臺中縣,新社鄉,慶西村,0,1,587,11,598,861,3,1,3,0,1,0,69.45
臺中縣,新社鄉,中和村,0,1,378,7,385,584,3,1,3,0,1,0,65.92
臺中縣,新社鄉,福興村,0,1,821,18,839,1269,3,1,3,0,1,0,66.12
臺中縣,石岡鄉,石岡村,0,1,661,14,675,975,3,1,3,0,1,0,69.23
臺中縣,石岡鄉,萬安村,0,1,761,8,769,1070,3,1,3,0,1,0,71.87
臺中縣,石岡鄉,九房村,0,1,722,19,741,1037,3,1,3,0,1,0,71.46
臺中縣,石岡鄉,金星村,0,1,758,22,780,1185,3,1,3,0,1,0,65.82
臺中縣,石岡鄉,龍興村,0,1,461,3,464,649,3,1,3,0,1,0,71.49
臺中縣,石岡鄉,萬興村,0,1,921,12,933,1264,3,1,3,0,1,0,73.81
臺中縣,石岡鄉,梅子村,0,1,1084,13,1097,1677,3,1,3,0,1,0,65.41
臺中縣,石岡鄉,土牛村,0,1,606,11,617,920,3,1,3,0,1,0,67.07
臺中縣,石岡鄉,德興村,0,1,832,18,850,1236,3,1,3,0,1,0,68.77
臺中縣,石岡鄉,和盛村,0,1,843,17,860,1215,3,1,3,0,1,0,70.78
臺中縣,外埔鄉,永豐村,0,1,697,18,715,982,3,1,3,0,1,0,72.81
臺中縣,外埔鄉,六分村,0,1,993,17,1010,1471,3,1,3,0,1,0,68.66
臺中縣,外埔鄉,三崁村,0,1,1062,17,1079,1675,3,1,3,0,1,0,64.42
臺中縣,外埔鄉,大同村,0,1,2351,29,2380,3414,3,1,3,0,1,0,69.71
臺中縣,外埔鄉,水美村,0,1,1733,31,1764,2690,3,1,3,0,1,0,65.58
臺中縣,外埔鄉,大東村,0,1,2818,48,2866,4437,3,1,3,0,1,0,64.59
臺中縣,外埔鄉,馬鳴村,0,1,893,12,905,1323,3,1,3,0,1,0,68.41
臺中縣,外埔鄉,中山村,0,1,761,8,769,1004,3,1,3,0,1,0,76.59
臺中縣,外埔鄉,鐵山村,0,1,1395,26,1421,1982,3,1,3,0,1,0,71.70
臺中縣,外埔鄉,土城村,0,1,1063,17,1080,1516,3,1,3,0,1,0,71.24
臺中縣,外埔鄉,廍子村,0,1,809,17,826,1163,3,1,3,0,1,0,71.02
臺中縣,大安鄉,南埔村,0,1,785,10,795,1061,3,1,3,0,1,0,74.93
臺中縣,大安鄉,南庄村,0,1,781,15,796,1104,3,1,3,0,1,0,72.10
臺中縣,大安鄉,中庄村,0,1,1571,24,1595,2338,3,1,3,0,1,0,68.22
臺中縣,大安鄉,東安村,0,1,857,11,868,1172,3,1,3,0,1,0,74.06
臺中縣,大安鄉,福興村,0,1,762,8,770,1115,3,1,3,0,1,0,69.06
臺中縣,大安鄉,龜殼村,0,1,1174,26,1200,1563,3,1,3,0,1,0,76.78
臺中縣,大安鄉,頂安村,0,1,602,10,612,856,3,1,3,0,1,0,71.50
臺中縣,大安鄉,永安村,0,1,1105,13,1118,1581,3,1,3,0,1,0,70.71
臺中縣,大安鄉,福住村,0,1,652,7,659,985,3,1,3,0,1,0,66.90
臺中縣,大安鄉,海墘村,0,1,982,12,994,1353,3,1,3,0,1,0,73.47
臺中縣,大安鄉,西安村,0,1,896,8,904,1333,3,1,3,0,1,0,67.82
臺中縣,大安鄉,松雅村,0,1,567,3,570,728,3,1,3,0,1,0,78.30
臺中縣,烏日鄉,烏日村,0,1,3630,59,3689,5425,3,1,3,0,1,0,68.00
臺中縣,烏日鄉,湖日村,0,1,1422,19,1441,2176,3,1,3,0,1,0,66.22
臺中縣,烏日鄉,三和村,0,1,2291,39,2330,3372,3,1,3,0,1,0,69.10
臺中縣,烏日鄉,榮泉村,0,1,1787,34,1821,2588,3,1,3,0,1,0,70.36
臺中縣,烏日鄉,學田村,0,1,1313,23,1336,1930,3,1,3,0,1,0,69.22
臺中縣,烏日鄉,九德村,0,1,5758,77,5835,8953,3,1,3,0,1,0,65.17
臺中縣,烏日鄉,仁德村,0,1,2919,49,2968,4727,3,1,3,0,1,0,62.79
臺中縣,烏日鄉,前竹村,0,1,1383,27,1410,2010,3,1,3,0,1,0,70.15
臺中縣,烏日鄉,五光村,0,1,1010,12,1022,1426,3,1,3,0,1,0,71.67
臺中縣,烏日鄉,光明村,0,1,1386,14,1400,2006,3,1,3,0,1,0,69.79
臺中縣,烏日鄉,東園村,0,1,1128,18,1146,1575,3,1,3,0,1,0,72.76
臺中縣,烏日鄉,溪埧村,0,1,2318,30,2348,3441,3,1,3,0,1,0,68.24
臺中縣,烏日鄉,螺潭村,0,1,1038,20,1058,1487,3,1,3,0,1,0,71.15
臺中縣,烏日鄉,北里村,0,1,867,14,881,1292,3,1,3,0,1,0,68.19
臺中縣,烏日鄉,南里村,0,1,752,13,765,1065,3,1,3,0,1,0,71.83
臺中縣,烏日鄉,溪尾村,0,1,509,18,527,811,3,1,3,0,1,0,64.98
臺中縣,大肚鄉,王田村,0,1,2363,40,2403,3489,3,1,3,0,1,0,68.87
臺中縣,大肚鄉,中和村,0,1,602,7,609,786,3,1,3,0,1,0,77.48
臺中縣,大肚鄉,福山村,0,1,2072,32,2104,3123,3,1,3,0,1,0,67.37
臺中縣,大肚鄉,營埔村,0,1,916,17,933,1251,3,1,3,0,1,0,74.58
臺中縣,大肚鄉,社腳村,0,1,1553,25,1578,2164,3,1,3,0,1,0,72.92
臺中縣,大肚鄉,新興村,0,1,1384,13,1397,2112,3,1,3,0,1,0,66.15
臺中縣,大肚鄉,大東村,0,1,1726,23,1749,2534,3,1,3,0,1,0,69.02
臺中縣,大肚鄉,大肚村,0,1,1302,10,1312,1786,3,1,3,0,1,0,73.46
臺中縣,大肚鄉,永和村,0,1,642,4,646,840,3,1,3,0,1,0,76.90
臺中縣,大肚鄉,磺溪村,0,1,921,9,930,1296,3,1,3,0,1,0,71.76
臺中縣,大肚鄉,永順村,0,1,1031,14,1045,1475,3,1,3,0,1,0,70.85
臺中縣,大肚鄉,成功村,0,1,597,4,601,856,3,1,3,0,1,0,70.21
臺中縣,大肚鄉,山陽村,0,1,884,20,904,1308,3,1,3,0,1,0,69.11
臺中縣,大肚鄉,頂街村,0,1,2755,37,2792,4138,3,1,3,0,1,0,67.47
臺中縣,大肚鄉,瑞井村,0,1,2469,40,2509,3599,3,1,3,0,1,0,69.71
臺中縣,大肚鄉,蔗廍村,0,1,4053,68,4121,6115,3,1,3,0,1,0,67.39
臺中縣,龍井鄉,竹坑村,0,1,1392,22,1414,2120,3,1,3,0,1,0,66.70
臺中縣,龍井鄉,龍東村,0,1,1458,20,1478,2220,3,1,3,0,1,0,66.58
臺中縣,龍井鄉,龍西村,0,1,1069,17,1086,1495,3,1,3,0,1,0,72.64
臺中縣,龍井鄉,田中村,0,1,1635,25,1660,2417,3,1,3,0,1,0,68.68
臺中縣,龍井鄉,福田村,0,1,668,23,691,970,3,1,3,0,1,0,71.24
臺中縣,龍井鄉,麗水村,0,1,1376,28,1404,1952,3,1,3,0,1,0,71.93
臺中縣,龍井鄉,龍津村,0,1,2822,54,2876,4120,3,1,3,0,1,0,69.81
臺中縣,龍井鄉,三德村,0,1,1582,35,1617,2379,3,1,3,0,1,0,67.97
臺中縣,龍井鄉,忠和村,0,1,2562,40,2602,3686,3,1,3,0,1,0,70.59
臺中縣,龍井鄉,山腳村,0,1,2279,28,2307,3584,3,1,3,0,1,0,64.37
臺中縣,龍井鄉,龍泉村,0,1,2664,39,2703,4056,3,1,3,0,1,0,66.64
臺中縣,龍井鄉,龍崗村,0,1,1270,30,1300,1940,3,1,3,0,1,0,67.01
臺中縣,龍井鄉,新庄村,0,1,2808,46,2854,4232,3,1,3,0,1,0,67.44
臺中縣,龍井鄉,南寮村,0,1,923,13,936,1307,3,1,3,0,1,0,71.61
臺中縣,龍井鄉,東海村,0,1,3045,35,3080,5114,3,1,3,0,1,0,60.23
臺中縣,龍井鄉,新東村,0,1,1839,19,1858,3013,3,1,3,0,1,0,61.67
臺中縣,霧峰鄉,桐林村,0,1,811,11,822,1141,3,1,3,0,1,0,72.04
臺中縣,霧峰鄉,吉峰村,0,1,4459,46,4505,7164,3,1,3,0,1,0,62.88
臺中縣,霧峰鄉,甲寅村,0,1,2482,41,2523,3940,3,1,3,0,1,0,64.04
臺中縣,霧峰鄉,本鄉村,0,1,1210,18,1228,1824,3,1,3,0,1,0,67.32
臺中縣,霧峰鄉,中正村,0,1,1035,8,1043,1551,3,1,3,0,1,0,67.25
臺中縣,霧峰鄉,錦榮村,0,1,617,5,622,927,3,1,3,0,1,0,67.10
臺中縣,霧峰鄉,萊園村,0,1,639,10,649,1026,3,1,3,0,1,0,63.26
臺中縣,霧峰鄉,本堂村,0,1,3044,44,3088,4794,3,1,3,0,1,0,64.41
臺中縣,霧峰鄉,北柳村,0,1,1932,25,1957,2875,3,1,3,0,1,0,68.07
臺中縣,霧峰鄉,南柳村,0,1,918,18,936,1324,3,1,3,0,1,0,70.69
臺中縣,霧峰鄉,四德村,0,1,1324,25,1349,1958,3,1,3,0,1,0,68.90
臺中縣,霧峰鄉,五福村,0,1,1651,26,1677,2293,3,1,3,0,1,0,73.14
臺中縣,霧峰鄉,丁台村,0,1,1285,14,1299,1817,3,1,3,0,1,0,71.49
臺中縣,霧峰鄉,北勢村,0,1,1062,18,1080,1585,3,1,3,0,1,0,68.14
臺中縣,霧峰鄉,南勢村,0,1,744,12,756,1142,3,1,3,0,1,0,66.20
臺中縣,霧峰鄉,萬豐村,0,1,1527,23,1550,2377,3,1,3,0,1,0,65.21
臺中縣,霧峰鄉,舊正村,0,1,1395,17,1412,2012,3,1,3,0,1,0,70.18
臺中縣,霧峰鄉,坑口村,0,1,1895,38,1933,2842,3,1,3,0,1,0,68.02
臺中縣,霧峰鄉,峰谷村,0,1,677,9,686,1037,3,1,3,0,1,0,66.15
臺中縣,霧峰鄉,六股村,0,1,1423,33,1456,2102,3,1,3,0,1,0,69.27
臺中縣,太平市,太平里,0,1,3200,52,3252,4972,3,1,3,0,1,0,65.41
臺中縣,太平市,長億里,0,1,4590,49,4639,7434,3,1,3,0,1,0,62.40
臺中縣,太平市,中平里,0,1,3687,58,3745,5986,3,1,3,0,1,0,62.56
臺中縣,太平市,中興里,0,1,3872,49,3921,6479,3,1,3,0,1,0,60.52
臺中縣,太平市,東平里,0,1,5678,89,5767,8761,3,1,3,0,1,0,65.83
臺中縣,太平市,建國里,0,1,2962,49,3011,4743,3,1,3,0,1,0,63.48
臺中縣,太平市,坪林里,0,1,4770,76,4846,7227,3,1,3,0,1,0,67.05
臺中縣,太平市,光華里,0,1,4603,72,4675,7138,3,1,3,0,1,0,65.49
臺中縣,太平市,中山里,0,1,3918,72,3990,6101,3,1,3,0,1,0,65.40
臺中縣,太平市,宜欣里,0,1,6910,114,7024,11677,3,1,3,0,1,0,60.15
臺中縣,太平市,新坪里,0,1,5888,91,5979,10431,3,1,3,0,1,0,57.32
臺中縣,太平市,新光里,0,1,5298,90,5388,8600,3,1,3,0,1,0,62.65
臺中縣,太平市,新福里,0,1,2422,44,2466,3818,3,1,3,0,1,0,64.59
臺中縣,太平市,頭汴里,0,1,2130,29,2159,3307,3,1,3,0,1,0,65.29
臺中縣,太平市,東汴里,0,1,784,11,795,1202,3,1,3,0,1,0,66.14
臺中縣,太平市,興隆里,0,1,3486,55,3541,5495,3,1,3,0,1,0,64.44
臺中縣,太平市,黃竹里,0,1,634,13,647,879,3,1,3,0,1,0,73.61
臺中縣,太平市,光隆里,0,1,2816,58,2874,4439,3,1,3,0,1,0,64.74
臺中縣,太平市,德隆里,0,1,2029,30,2059,3292,3,1,3,0,1,0,62.55
臺中縣,大里市,大里里,0,1,2058,26,2084,3088,3,1,3,0,1,0,67.49
臺中縣,大里市,新里里,0,1,5721,48,5769,8975,3,1,3,0,1,0,64.28
臺中縣,大里市,樹王里,0,1,1788,21,1809,2679,3,1,3,0,1,0,67.53
臺中縣,大里市,祥興里,0,1,3083,40,3123,5301,3,1,3,0,1,0,58.91
臺中縣,大里市,內新里,0,1,5271,70,5341,8510,3,1,3,0,1,0,62.76
臺中縣,大里市,東昇里,0,1,1636,14,1650,2565,3,1,3,0,1,0,64.33
臺中縣,大里市,大元里,0,1,2184,23,2207,3274,3,1,3,0,1,0,67.41
臺中縣,大里市,西湖里,0,1,1335,21,1356,2003,3,1,3,0,1,0,67.70
臺中縣,大里市,夏田里,0,1,668,13,681,926,3,1,3,0,1,0,73.54
臺中縣,大里市,仁化里,0,1,5714,56,5770,9401,3,1,3,0,1,0,61.38
臺中縣,大里市,健民里,0,1,2659,48,2707,4256,3,1,3,0,1,0,63.60
臺中縣,大里市,塗城里,0,1,4010,48,4058,6346,3,1,3,0,1,0,63.95
臺中縣,大里市,東湖里,0,1,3509,54,3563,5921,3,1,3,0,1,0,60.18
臺中縣,大里市,東興里,0,1,6192,67,6259,9793,3,1,3,0,1,0,63.91
臺中縣,大里市,日新里,0,1,1974,36,2010,3121,3,1,3,0,1,0,64.40
臺中縣,大里市,西榮里,0,1,6897,90,6987,11046,3,1,3,0,1,0,63.25
臺中縣,大里市,金城里,0,1,4629,50,4679,7725,3,1,3,0,1,0,60.57
臺中縣,大里市,立仁里,0,1,4525,64,4589,7331,3,1,3,0,1,0,62.60
臺中縣,大里市,新仁里,0,1,3580,50,3630,5825,3,1,3,0,1,0,62.32
臺中縣,大里市,瑞城里,0,1,4827,52,4879,7971,3,1,3,0,1,0,61.21
臺中縣,和平鄉,南勢村,0,1,873,14,887,1397,3,1,3,0,1,0,63.49
臺中縣,和平鄉,天輪村,0,1,268,4,272,454,3,1,3,0,1,0,59.91
臺中縣,和平鄉,博愛村,0,1,652,11,663,1074,3,1,3,0,1,0,61.73
臺中縣,和平鄉,自由村,0,1,301,4,305,529,3,1,3,0,1,0,57.66
臺中縣,和平鄉,達觀村,0,1,332,2,334,545,3,1,3,0,1,0,61.28
臺中縣,和平鄉,中坑村,0,1,233,3,236,309,3,1,3,0,1,0,76.38
臺中縣,和平鄉,梨山村,0,1,557,7,564,1347,3,1,3,0,1,0,41.87
臺中縣,和平鄉,平等村,0,1,193,6,199,414,3,1,3,0,1,0,48.07
彰化縣,彰化市,桃源里,0,1,1824,32,1856,2798,3,1,3,0,1,0,66.33
彰化縣,彰化市,卦山里,0,1,1470,19,1489,2230,3,1,3,0,1,0,66.77
彰化縣,彰化市,東興里,0,1,1090,17,1107,1580,3,1,3,0,1,0,70.06
彰化縣,彰化市,華北里,0,1,1035,7,1042,1539,3,1,3,0,1,0,67.71
彰化縣,彰化市,華陽里,0,1,1590,99,1689,2416,3,1,3,0,1,0,69.91
彰化縣,彰化市,建寶里,0,1,1657,23,1680,2309,3,1,3,0,1,0,72.76
彰化縣,彰化市,光南里,0,1,936,9,945,1357,3,1,3,0,1,0,69.64
彰化縣,彰化市,介壽里,0,1,1289,18,1307,1909,3,1,3,0,1,0,68.47
彰化縣,彰化市,延平里,0,1,3820,46,3866,5764,3,1,3,0,1,0,67.07
彰化縣,彰化市,延和里,0,1,2251,29,2280,3316,3,1,3,0,1,0,68.76
彰化縣,彰化市,南興里,0,1,3217,53,3270,4808,3,1,3,0,1,0,68.01
彰化縣,彰化市,南磘里,0,1,3976,52,4028,6158,3,1,3,0,1,0,65.41
彰化縣,彰化市,成功里,0,1,987,16,1003,1458,3,1,3,0,1,0,68.79
彰化縣,彰化市,大同里,0,1,740,15,755,1085,3,1,3,0,1,0,69.59
彰化縣,彰化市,永生里,0,1,1011,17,1028,1445,3,1,3,0,1,0,71.14
彰化縣,彰化市,福安里,0,1,734,9,743,1046,3,1,3,0,1,0,71.03
彰化縣,彰化市,西安里,0,1,1794,21,1815,2689,3,1,3,0,1,0,67.50
彰化縣,彰化市,彰安里,0,1,2024,19,2043,3045,3,1,3,0,1,0,67.09
彰化縣,彰化市,中央里,0,1,653,3,656,918,3,1,3,0,1,0,71.46
彰化縣,彰化市,富貴里,0,1,692,10,702,1012,3,1,3,0,1,0,69.37
彰化縣,彰化市,民權里,0,1,849,8,857,1238,3,1,3,0,1,0,69.22
彰化縣,彰化市,長樂里,0,1,845,10,855,1210,3,1,3,0,1,0,70.66
彰化縣,彰化市,萬壽里,0,1,679,8,687,976,3,1,3,0,1,0,70.39
彰化縣,彰化市,西興里,0,1,1471,12,1483,2197,3,1,3,0,1,0,67.50
彰化縣,彰化市,平和里,0,1,2231,24,2255,3373,3,1,3,0,1,0,66.85
彰化縣,彰化市,崙平里,0,1,2759,39,2798,4129,3,1,3,0,1,0,67.76
彰化縣,彰化市,向陽里,0,1,1756,22,1778,2672,3,1,3,0,1,0,66.54
彰化縣,彰化市,莿桐里,0,1,1612,23,1635,2347,3,1,3,0,1,0,69.66
彰化縣,彰化市,南美里,0,1,990,12,1002,1460,3,1,3,0,1,0,68.63
彰化縣,彰化市,南安里,0,1,1182,14,1196,1680,3,1,3,0,1,0,71.19
彰化縣,彰化市,東芳里,0,1,1825,26,1851,2757,3,1,3,0,1,0,67.14
彰化縣,彰化市,磚磘里,0,1,1711,36,1747,2548,3,1,3,0,1,0,68.56
彰化縣,彰化市,西勢里,0,1,1663,36,1699,2380,3,1,3,0,1,0,71.39
彰化縣,彰化市,忠權里,0,1,1693,16,1709,2454,3,1,3,0,1,0,69.64
彰化縣,彰化市,忠孝里,0,1,803,7,810,1159,3,1,3,0,1,0,69.89
彰化縣,彰化市,五權里,0,1,2033,31,2064,3094,3,1,3,0,1,0,66.71
彰化縣,彰化市,新興里,0,1,2591,33,2624,3786,3,1,3,0,1,0,69.31
彰化縣,彰化市,新華里,0,1,1208,18,1226,1828,3,1,3,0,1,0,67.07
彰化縣,彰化市,興北里,0,1,946,9,955,1404,3,1,3,0,1,0,68.02
彰化縣,彰化市,信義里,0,1,609,8,617,898,3,1,3,0,1,0,68.71
彰化縣,彰化市,民生里,0,1,939,12,951,1401,3,1,3,0,1,0,67.88
彰化縣,彰化市,光復里,0,1,499,7,506,765,3,1,3,0,1,0,66.14
彰化縣,彰化市,永福里,0,1,618,3,621,948,3,1,3,0,1,0,65.51
彰化縣,彰化市,光華里,0,1,598,7,605,874,3,1,3,0,1,0,69.22
彰化縣,彰化市,中正里,0,1,897,14,911,1354,3,1,3,0,1,0,67.28
彰化縣,彰化市,中山里,0,1,574,8,582,835,3,1,3,0,1,0,69.70
彰化縣,彰化市,龍山里,0,1,1447,24,1471,2185,3,1,3,0,1,0,67.32
彰化縣,彰化市,文化里,0,1,948,14,962,1428,3,1,3,0,1,0,67.37
彰化縣,彰化市,陽明里,0,1,1181,15,1196,1757,3,1,3,0,1,0,68.07
彰化縣,彰化市,萬安里,0,1,2382,27,2409,3577,3,1,3,0,1,0,67.35
彰化縣,彰化市,下廍里,0,1,2390,38,2428,3527,3,1,3,0,1,0,68.84
彰化縣,彰化市,茄苳里,0,1,527,15,542,775,3,1,3,0,1,0,69.94
彰化縣,彰化市,茄南里,0,1,1382,22,1404,2061,3,1,3,0,1,0,68.12
彰化縣,彰化市,寶廍里,0,1,710,13,723,994,3,1,3,0,1,0,72.74
彰化縣,彰化市,古夷里,0,1,1360,29,1389,2150,3,1,3,0,1,0,64.60
彰化縣,彰化市,阿夷里,0,1,3189,56,3245,4993,3,1,3,0,1,0,64.99
彰化縣,彰化市,和調里,0,1,1464,37,1501,2195,3,1,3,0,1,0,68.38
彰化縣,彰化市,復興里,0,1,2568,34,2602,3869,3,1,3,0,1,0,67.25
彰化縣,彰化市,中庄里,0,1,1332,24,1356,2060,3,1,3,0,1,0,65.83
彰化縣,彰化市,國聖里,0,1,1583,30,1613,2215,3,1,3,0,1,0,72.82
彰化縣,彰化市,福山里,0,1,3707,71,3778,5645,3,1,3,0,1,0,66.93
彰化縣,彰化市,安溪里,0,1,630,13,643,930,3,1,3,0,1,0,69.14
彰化縣,彰化市,竹中里,0,1,1032,15,1047,1589,3,1,3,0,1,0,65.89
彰化縣,彰化市,三村里,0,1,698,10,708,961,3,1,3,0,1,0,73.67
彰化縣,彰化市,大竹里,0,1,1675,24,1699,2564,3,1,3,0,1,0,66.26
彰化縣,彰化市,香山里,0,1,1704,31,1735,2448,3,1,3,0,1,0,70.87
彰化縣,彰化市,牛埔里,0,1,1879,30,1909,2710,3,1,3,0,1,0,70.44
彰化縣,彰化市,台鳳里,0,1,2060,22,2082,3250,3,1,3,0,1,0,64.06
彰化縣,彰化市,田中里,0,1,560,6,566,798,3,1,3,0,1,0,70.93
彰化縣,彰化市,快官里,0,1,639,10,649,978,3,1,3,0,1,0,66.36
彰化縣,彰化市,竹巷里,0,1,560,4,564,778,3,1,3,0,1,0,72.49
彰化縣,彰化市,福田里,0,1,833,13,846,1151,3,1,3,0,1,0,73.50
彰化縣,彰化市,石牌里,0,1,767,16,783,1093,3,1,3,0,1,0,71.64
彰化縣,花壇鄉,花壇村,0,1,1932,29,1961,2730,3,1,3,0,1,0,71.83
彰化縣,花壇鄉,金墩村,0,1,1074,16,1090,1569,3,1,3,0,1,0,69.47
彰化縣,花壇鄉,中庄村,0,1,1454,22,1476,2155,3,1,3,0,1,0,68.49
彰化縣,花壇鄉,劉厝村,0,1,739,9,748,1000,3,1,3,0,1,0,74.80
彰化縣,花壇鄉,崙雅村,0,1,930,17,947,1339,3,1,3,0,1,0,70.72
彰化縣,花壇鄉,南口村,0,1,961,18,979,1374,3,1,3,0,1,0,71.25
彰化縣,花壇鄉,中口村,0,1,487,6,493,656,3,1,3,0,1,0,75.15
彰化縣,花壇鄉,北口村,0,1,1128,11,1139,1522,3,1,3,0,1,0,74.84
彰化縣,花壇鄉,長沙村,0,1,2538,42,2580,3611,3,1,3,0,1,0,71.45
彰化縣,花壇鄉,文德村,0,1,1506,32,1538,2204,3,1,3,0,1,0,69.78
彰化縣,花壇鄉,白沙村,0,1,2196,40,2236,3403,3,1,3,0,1,0,65.71
彰化縣,花壇鄉,岩竹村,0,1,871,13,884,1283,3,1,3,0,1,0,68.90
彰化縣,花壇鄉,橋頭村,0,1,1895,29,1924,2835,3,1,3,0,1,0,67.87
彰化縣,花壇鄉,灣雅村,0,1,538,11,549,824,3,1,3,0,1,0,66.63
彰化縣,花壇鄉,灣東村,0,1,614,5,619,936,3,1,3,0,1,0,66.13
彰化縣,花壇鄉,三春村,0,1,966,11,977,1559,3,1,3,0,1,0,62.67
彰化縣,花壇鄉,永春村,0,1,924,15,939,1400,3,1,3,0,1,0,67.07
彰化縣,花壇鄉,長春村,0,1,941,14,955,1375,3,1,3,0,1,0,69.45
彰化縣,芬園鄉,舊社村,0,1,1059,20,1079,1663,3,1,3,0,1,0,64.88
彰化縣,芬園鄉,大埔村,0,1,920,7,927,1302,3,1,3,0,1,0,71.20
彰化縣,芬園鄉,竹林村,0,1,1040,24,1064,1561,3,1,3,0,1,0,68.16
彰化縣,芬園鄉,楓坑村,0,1,386,8,394,565,3,1,3,0,1,0,69.73
彰化縣,芬園鄉,社口村,0,1,1458,24,1482,2235,3,1,3,0,1,0,66.31
彰化縣,芬園鄉,茄荖村,0,1,1393,24,1417,2128,3,1,3,0,1,0,66.59
彰化縣,芬園鄉,嘉興村,0,1,987,14,1001,1452,3,1,3,0,1,0,68.94
彰化縣,芬園鄉,芬園村,0,1,581,6,587,872,3,1,3,0,1,0,67.32
彰化縣,芬園鄉,進芬村,0,1,595,14,609,898,3,1,3,0,1,0,67.82
彰化縣,芬園鄉,縣庄村,0,1,694,11,705,1056,3,1,3,0,1,0,66.76
彰化縣,芬園鄉,圳墘村,0,1,476,4,480,688,3,1,3,0,1,0,69.77
彰化縣,芬園鄉,溪頭村,0,1,962,22,984,1456,3,1,3,0,1,0,67.58
彰化縣,芬園鄉,同安村,0,1,856,10,866,1260,3,1,3,0,1,0,68.73
彰化縣,芬園鄉,中崙村,0,1,612,9,621,986,3,1,3,0,1,0,62.98
彰化縣,芬園鄉,大竹村,0,1,617,9,626,1066,3,1,3,0,1,0,58.72
彰化縣,鹿港鎮,大有里,0,1,779,9,788,1155,3,1,3,0,1,0,68.23
彰化縣,鹿港鎮,中興里,0,1,374,5,379,556,3,1,3,0,1,0,68.17
彰化縣,鹿港鎮,洛津里,0,1,683,4,687,1061,3,1,3,0,1,0,64.75
彰化縣,鹿港鎮,順興里,0,1,608,12,620,870,3,1,3,0,1,0,71.26
彰化縣,鹿港鎮,菜園里,0,1,706,8,714,1019,3,1,3,0,1,0,70.07
彰化縣,鹿港鎮,街尾里,0,1,1253,16,1269,1859,3,1,3,0,1,0,68.26
彰化縣,鹿港鎮,泰興里,0,1,815,15,830,1182,3,1,3,0,1,0,70.22
彰化縣,鹿港鎮,長興里,0,1,203,3,206,315,3,1,3,0,1,0,65.40
彰化縣,鹿港鎮,興化里,0,1,489,6,495,686,3,1,3,0,1,0,72.16
彰化縣,鹿港鎮,龍山里,0,1,540,10,550,760,3,1,3,0,1,0,72.37
彰化縣,鹿港鎮,景福里,0,1,785,12,797,1123,3,1,3,0,1,0,70.97
彰化縣,鹿港鎮,郭厝里,0,1,376,3,379,580,3,1,3,0,1,0,65.34
彰化縣,鹿港鎮,新宮里,0,1,646,8,654,926,3,1,3,0,1,0,70.63
彰化縣,鹿港鎮,玉順里,0,1,859,14,873,1288,3,1,3,0,1,0,67.78
彰化縣,鹿港鎮,東石里,0,1,2062,34,2096,3053,3,1,3,0,1,0,68.65
彰化縣,鹿港鎮,永安里,0,1,2379,34,2413,3517,3,1,3,0,1,0,68.61
彰化縣,鹿港鎮,埔崙里,0,1,2020,38,2058,3042,3,1,3,0,1,0,67.65
彰化縣,鹿港鎮,頂厝里,0,1,3308,44,3352,4847,3,1,3,0,1,0,69.16
彰化縣,鹿港鎮,東崎里,0,1,2543,39,2582,3933,3,1,3,0,1,0,65.65
彰化縣,鹿港鎮,廖厝里,0,1,2064,28,2092,2994,3,1,3,0,1,0,69.87
彰化縣,鹿港鎮,詔安里,0,1,979,17,996,1579,3,1,3,0,1,0,63.08
彰化縣,鹿港鎮,海埔里,0,1,1789,28,1817,2739,3,1,3,0,1,0,66.34
彰化縣,鹿港鎮,洋厝里,0,1,1559,20,1579,2307,3,1,3,0,1,0,68.44
彰化縣,鹿港鎮,草中里,0,1,1846,39,1885,2775,3,1,3,0,1,0,67.93
彰化縣,鹿港鎮,山崙里,0,1,1940,26,1966,2832,3,1,3,0,1,0,69.42
彰化縣,鹿港鎮,頭南里,0,1,1172,26,1198,1750,3,1,3,0,1,0,68.46
彰化縣,鹿港鎮,頭崙里,0,1,1528,19,1547,2097,3,1,3,0,1,0,73.77
彰化縣,鹿港鎮,頂番里,0,1,2036,30,2066,2947,3,1,3,0,1,0,70.11
彰化縣,鹿港鎮,溝墘里,0,1,2213,35,2248,3247,3,1,3,0,1,0,69.23
彰化縣,福興鄉,番婆村,0,1,1391,29,1420,2012,3,1,3,0,1,0,70.58
彰化縣,福興鄉,大崙村,0,1,800,5,805,1077,3,1,3,0,1,0,74.74
彰化縣,福興鄉,外埔村,0,1,756,8,764,1023,3,1,3,0,1,0,74.68
彰化縣,福興鄉,三汴村,0,1,892,14,906,1167,3,1,3,0,1,0,77.63
彰化縣,福興鄉,萬豐村,0,1,509,9,518,697,3,1,3,0,1,0,74.32
彰化縣,福興鄉,外中村,0,1,898,8,906,1144,3,1,3,0,1,0,79.20
彰化縣,福興鄉,元中村,0,1,756,14,770,1064,3,1,3,0,1,0,72.37
彰化縣,福興鄉,橋頭村,0,1,1485,17,1502,2063,3,1,3,0,1,0,72.81
彰化縣,福興鄉,社尾村,0,1,1062,10,1072,1331,3,1,3,0,1,0,80.54
彰化縣,福興鄉,番社村,0,1,936,8,944,1245,3,1,3,0,1,0,75.82
彰化縣,福興鄉,同安村,0,1,1373,26,1399,1993,3,1,3,0,1,0,70.20
彰化縣,福興鄉,西勢村,0,1,1133,19,1152,1609,3,1,3,0,1,0,71.60
彰化縣,福興鄉,秀厝村,0,1,1407,20,1427,1962,3,1,3,0,1,0,72.73
彰化縣,福興鄉,鎮平村,0,1,784,15,799,1095,3,1,3,0,1,0,72.97
彰化縣,福興鄉,三和村,0,1,710,13,723,1018,3,1,3,0,1,0,71.02
彰化縣,福興鄉,麥厝村,0,1,1352,27,1379,2021,3,1,3,0,1,0,68.23
彰化縣,福興鄉,廈粘村,0,1,1263,24,1287,1767,3,1,3,0,1,0,72.84
彰化縣,福興鄉,頂粘村,0,1,1469,22,1491,1979,3,1,3,0,1,0,75.34
彰化縣,福興鄉,福寶村,0,1,849,14,863,1147,3,1,3,0,1,0,75.24
彰化縣,福興鄉,二港村,0,1,935,13,948,1241,3,1,3,0,1,0,76.39
彰化縣,福興鄉,福興村,0,1,1785,19,1804,2608,3,1,3,0,1,0,69.17
彰化縣,福興鄉,福南村,0,1,1468,19,1487,2064,3,1,3,0,1,0,72.04
彰化縣,秀水鄉,秀水村,0,1,1082,12,1094,1567,3,1,3,0,1,0,69.81
彰化縣,秀水鄉,安溪村,0,1,972,21,993,1432,3,1,3,0,1,0,69.34
彰化縣,秀水鄉,莊雅村,0,1,1354,16,1370,1983,3,1,3,0,1,0,69.09
彰化縣,秀水鄉,陝西村,0,1,832,6,838,1165,3,1,3,0,1,0,71.93
彰化縣,秀水鄉,金興村,0,1,1152,19,1171,1634,3,1,3,0,1,0,71.66
彰化縣,秀水鄉,安東村,0,1,2137,31,2168,3123,3,1,3,0,1,0,69.42
彰化縣,秀水鄉,鶴鳴村,0,1,1801,29,1830,2539,3,1,3,0,1,0,72.08
彰化縣,秀水鄉,馬興村,0,1,1428,25,1453,1904,3,1,3,0,1,0,76.31
彰化縣,秀水鄉,義興村,0,1,759,14,773,1090,3,1,3,0,1,0,70.92
彰化縣,秀水鄉,福安村,0,1,2176,34,2210,3195,3,1,3,0,1,0,69.17
彰化縣,秀水鄉,埔崙村,0,1,1218,19,1237,1694,3,1,3,0,1,0,73.02
彰化縣,秀水鄉,曾厝村,0,1,944,13,957,1303,3,1,3,0,1,0,73.45
彰化縣,秀水鄉,金陵村,0,1,984,16,1000,1364,3,1,3,0,1,0,73.31
彰化縣,秀水鄉,下崙村,0,1,1368,17,1385,1829,3,1,3,0,1,0,75.72
彰化縣,和美鎮,竹營里,0,1,2506,39,2545,3754,3,1,3,0,1,0,67.79
彰化縣,和美鎮,和東里,0,1,2190,36,2226,3303,3,1,3,0,1,0,67.39
彰化縣,和美鎮,和南里,0,1,348,5,353,465,3,1,3,0,1,0,75.91
彰化縣,和美鎮,和北里,0,1,936,13,949,1338,3,1,3,0,1,0,70.93
彰化縣,和美鎮,和西里,0,1,1984,33,2017,2995,3,1,3,0,1,0,67.35
彰化縣,和美鎮,四張里,0,1,1452,23,1475,2188,3,1,3,0,1,0,67.41
彰化縣,和美鎮,頭前里,0,1,894,23,917,1257,3,1,3,0,1,0,72.95
彰化縣,和美鎮,還社里,0,1,563,11,574,767,3,1,3,0,1,0,74.84
彰化縣,和美鎮,面前里,0,1,1193,16,1209,1617,3,1,3,0,1,0,74.77
彰化縣,和美鎮,鎮平里,0,1,1579,16,1595,2275,3,1,3,0,1,0,70.11
彰化縣,和美鎮,大霞里,0,1,864,16,880,1235,3,1,3,0,1,0,71.26
彰化縣,和美鎮,源埤里,0,1,1057,14,1071,1510,3,1,3,0,1,0,70.93
彰化縣,和美鎮,南佃里,0,1,1090,24,1114,1615,3,1,3,0,1,0,68.98
彰化縣,和美鎮,雅溝里,0,1,870,12,882,1224,3,1,3,0,1,0,72.06
彰化縣,和美鎮,山犁里,0,1,3332,46,3378,5044,3,1,3,0,1,0,66.97
彰化縣,和美鎮,嘉犁里,0,1,972,21,993,1527,3,1,3,0,1,0,65.03
彰化縣,和美鎮,詔安里,0,1,1062,19,1081,1599,3,1,3,0,1,0,67.60
彰化縣,和美鎮,鐵山里,0,1,1432,30,1462,2289,3,1,3,0,1,0,63.87
彰化縣,和美鎮,柑井里,0,1,1806,37,1843,2613,3,1,3,0,1,0,70.53
彰化縣,和美鎮,竹園里,0,1,615,6,621,779,3,1,3,0,1,0,79.72
彰化縣,和美鎮,新庄里,0,1,1461,29,1490,2180,3,1,3,0,1,0,68.35
彰化縣,和美鎮,犁盛里,0,1,1445,34,1479,2008,3,1,3,0,1,0,73.66
彰化縣,和美鎮,中寮里,0,1,712,14,726,1051,3,1,3,0,1,0,69.08
彰化縣,和美鎮,中圍里,0,1,1611,32,1643,2482,3,1,3,0,1,0,66.20
彰化縣,和美鎮,糖友里,0,1,1596,16,1612,2368,3,1,3,0,1,0,68.07
彰化縣,和美鎮,塗厝里,0,1,1061,19,1080,1602,3,1,3,0,1,0,67.42
彰化縣,和美鎮,地潭里,0,1,548,10,558,834,3,1,3,0,1,0,66.91
彰化縣,和美鎮,湖內里,0,1,885,7,892,1227,3,1,3,0,1,0,72.70
彰化縣,和美鎮,嘉寶里,0,1,1119,30,1149,1683,3,1,3,0,1,0,68.27
彰化縣,和美鎮,月眉里,0,1,1854,35,1889,2745,3,1,3,0,1,0,68.82
彰化縣,和美鎮,好修里,0,1,1094,24,1118,1625,3,1,3,0,1,0,68.80
彰化縣,線西鄉,線西村,0,1,1212,27,1239,1840,3,1,3,0,1,0,67.34
彰化縣,線西鄉,頂庄村,0,1,761,7,768,1115,3,1,3,0,1,0,68.88
彰化縣,線西鄉,寓埔村,0,1,1217,21,1238,1882,3,1,3,0,1,0,65.78
彰化縣,線西鄉,塭仔村,0,1,796,9,805,1143,3,1,3,0,1,0,70.43
彰化縣,線西鄉,溝內村,0,1,666,14,680,976,3,1,3,0,1,0,69.67
彰化縣,線西鄉,下犁村,0,1,1072,24,1096,1574,3,1,3,0,1,0,69.63
彰化縣,線西鄉,頂犁村,0,1,1414,21,1435,2086,3,1,3,0,1,0,68.79
彰化縣,線西鄉,德興村,0,1,719,10,729,1023,3,1,3,0,1,0,71.26
彰化縣,伸港鄉,新港村,0,1,2503,34,2537,3927,3,1,3,0,1,0,64.60
彰化縣,伸港鄉,什股村,0,1,953,16,969,1448,3,1,3,0,1,0,66.92
彰化縣,伸港鄉,大同村,0,1,851,16,867,1206,3,1,3,0,1,0,71.89
彰化縣,伸港鄉,海尾村,0,1,1137,16,1153,1564,3,1,3,0,1,0,73.72
彰化縣,伸港鄉,全興村,0,1,919,14,933,1418,3,1,3,0,1,0,65.80
彰化縣,伸港鄉,溪底村,0,1,1031,11,1042,1505,3,1,3,0,1,0,69.24
彰化縣,伸港鄉,定興村,0,1,1341,22,1363,2093,3,1,3,0,1,0,65.12
彰化縣,伸港鄉,泉州村,0,1,1090,18,1108,1590,3,1,3,0,1,0,69.69
彰化縣,伸港鄉,泉厝村,0,1,744,14,758,1122,3,1,3,0,1,0,67.56
彰化縣,伸港鄉,曾家村,0,1,955,12,967,1459,3,1,3,0,1,0,66.28
彰化縣,伸港鄉,蚵寮村,0,1,746,8,754,1121,3,1,3,0,1,0,67.26
彰化縣,伸港鄉,埤墘村,0,1,580,11,591,886,3,1,3,0,1,0,66.70
彰化縣,伸港鄉,七嘉村,0,1,1240,17,1257,1786,3,1,3,0,1,0,70.38
彰化縣,伸港鄉,汴頭村,0,1,1306,12,1318,1880,3,1,3,0,1,0,70.11
彰化縣,員林鎮,東和里,0,1,694,13,707,1064,3,1,3,0,1,0,66.45
彰化縣,員林鎮,民生里,0,1,1658,23,1681,2547,3,1,3,0,1,0,66.00
彰化縣,員林鎮,中正里,0,1,1838,18,1856,2832,3,1,3,0,1,0,65.54
彰化縣,員林鎮,仁美里,0,1,1836,15,1851,2711,3,1,3,0,1,0,68.28
彰化縣,員林鎮,新興里,0,1,574,3,577,816,3,1,3,0,1,0,70.71
彰化縣,員林鎮,和平里,0,1,1685,20,1705,2586,3,1,3,0,1,0,65.93
彰化縣,員林鎮,光明里,0,1,675,6,681,948,3,1,3,0,1,0,71.84
彰化縣,員林鎮,中山里,0,1,499,4,503,718,3,1,3,0,1,0,70.06
彰化縣,員林鎮,黎明里,0,1,1178,20,1198,1762,3,1,3,0,1,0,67.99
彰化縣,員林鎮,惠來里,0,1,2758,30,2788,4212,3,1,3,0,1,0,66.19
彰化縣,員林鎮,三義里,0,1,1457,23,1480,2223,3,1,3,0,1,0,66.58
彰化縣,員林鎮,新生里,0,1,2463,29,2492,3645,3,1,3,0,1,0,68.37
彰化縣,員林鎮,南平里,0,1,2250,25,2275,3391,3,1,3,0,1,0,67.09
彰化縣,員林鎮,南興里,0,1,2744,42,2786,4076,3,1,3,0,1,0,68.35
彰化縣,員林鎮,源潭里,0,1,969,8,977,1424,3,1,3,0,1,0,68.61
彰化縣,員林鎮,大埔里,0,1,1154,16,1170,1688,3,1,3,0,1,0,69.31
彰化縣,員林鎮,三條里,0,1,3269,43,3312,4988,3,1,3,0,1,0,66.40
彰化縣,員林鎮,三和里,0,1,3054,31,3085,4663,3,1,3,0,1,0,66.16
彰化縣,員林鎮,三橋里,0,1,1620,26,1646,2444,3,1,3,0,1,0,67.35
彰化縣,員林鎮,三愛里,0,1,1498,11,1509,2317,3,1,3,0,1,0,65.13
彰化縣,員林鎮,三信里,0,1,1242,16,1258,1864,3,1,3,0,1,0,67.49
彰化縣,員林鎮,三多里,0,1,1235,14,1249,1890,3,1,3,0,1,0,66.08
彰化縣,員林鎮,中央里,0,1,960,15,975,1435,3,1,3,0,1,0,67.94
彰化縣,員林鎮,溝皂里,0,1,1325,14,1339,1991,3,1,3,0,1,0,67.25
彰化縣,員林鎮,大饒里,0,1,1625,17,1642,2436,3,1,3,0,1,0,67.41
彰化縣,員林鎮,大明里,0,1,1290,29,1319,1948,3,1,3,0,1,0,67.71
彰化縣,員林鎮,萬年里,0,1,1965,29,1994,2945,3,1,3,0,1,0,67.71
彰化縣,員林鎮,崙雅里,0,1,1550,16,1566,2191,3,1,3,0,1,0,71.47
彰化縣,員林鎮,振興里,0,1,1407,24,1431,2169,3,1,3,0,1,0,65.98
彰化縣,員林鎮,林厝里,0,1,1386,26,1412,2218,3,1,3,0,1,0,63.66
彰化縣,員林鎮,出水里,0,1,1015,17,1032,1677,3,1,3,0,1,0,61.54
彰化縣,員林鎮,湖水里,0,1,814,9,823,1272,3,1,3,0,1,0,64.70
彰化縣,員林鎮,大峰里,0,1,438,6,444,730,3,1,3,0,1,0,60.82
彰化縣,員林鎮,鎮興里,0,1,1130,17,1147,1743,3,1,3,0,1,0,65.81
彰化縣,員林鎮,浮圳里,0,1,1337,9,1346,1980,3,1,3,0,1,0,67.98
彰化縣,員林鎮,西東里,0,1,1094,15,1109,1568,3,1,3,0,1,0,70.73
彰化縣,員林鎮,南東里,0,1,1047,17,1064,1607,3,1,3,0,1,0,66.21
彰化縣,員林鎮,中東里,0,1,917,13,930,1412,3,1,3,0,1,0,65.86
彰化縣,員林鎮,東北里,0,1,1327,19,1346,1958,3,1,3,0,1,0,68.74
彰化縣,大村鄉,大村村,0,1,1358,25,1383,1930,3,1,3,0,1,0,71.66
彰化縣,大村鄉,茄苳村,0,1,1067,16,1083,1526,3,1,3,0,1,0,70.97
彰化縣,大村鄉,田洋村,0,1,619,11,630,871,3,1,3,0,1,0,72.33
彰化縣,大村鄉,貢旗村,0,1,893,11,904,1299,3,1,3,0,1,0,69.59
彰化縣,大村鄉,加錫村,0,1,837,6,843,1217,3,1,3,0,1,0,69.27
彰化縣,大村鄉,大崙村,0,1,990,15,1005,1406,3,1,3,0,1,0,71.48
彰化縣,大村鄉,新興村,0,1,782,5,787,1130,3,1,3,0,1,0,69.65
彰化縣,大村鄉,南勢村,0,1,781,19,800,1173,3,1,3,0,1,0,68.20
彰化縣,大村鄉,擺塘村,0,1,1432,17,1449,2082,3,1,3,0,1,0,69.60
彰化縣,大村鄉,過溝村,0,1,1322,11,1333,1882,3,1,3,0,1,0,70.83
彰化縣,大村鄉,大橋村,0,1,1119,12,1131,1769,3,1,3,0,1,0,63.93
彰化縣,大村鄉,村上村,0,1,863,11,874,1182,3,1,3,0,1,0,73.94
彰化縣,大村鄉,美港村,0,1,1592,23,1615,2469,3,1,3,0,1,0,65.41
彰化縣,大村鄉,黃厝村,0,1,1154,16,1170,1705,3,1,3,0,1,0,68.62
彰化縣,大村鄉,福興村,0,1,1096,16,1112,1711,3,1,3,0,1,0,64.99
彰化縣,大村鄉,平和村,0,1,1213,25,1238,1939,3,1,3,0,1,0,63.85
彰化縣,永靖鄉,永東村,0,1,601,8,609,812,3,1,3,0,1,0,75.00
彰化縣,永靖鄉,永西村,0,1,1012,12,1024,1446,3,1,3,0,1,0,70.82
彰化縣,永靖鄉,永南村,0,1,1215,17,1232,1788,3,1,3,0,1,0,68.90
彰化縣,永靖鄉,永北村,0,1,1216,19,1235,1810,3,1,3,0,1,0,68.23
彰化縣,永靖鄉,港西村,0,1,1092,24,1116,1591,3,1,3,0,1,0,70.14
彰化縣,永靖鄉,五福村,0,1,848,16,864,1275,3,1,3,0,1,0,67.76
彰化縣,永靖鄉,湳港村,0,1,651,12,663,906,3,1,3,0,1,0,73.18
彰化縣,永靖鄉,新莊村,0,1,570,8,578,835,3,1,3,0,1,0,69.22
彰化縣,永靖鄉,瑚璉村,0,1,1413,14,1427,1981,3,1,3,0,1,0,72.03
彰化縣,永靖鄉,五汴村,0,1,913,7,920,1268,3,1,3,0,1,0,72.56
彰化縣,永靖鄉,浮圳村,0,1,779,16,795,1055,3,1,3,0,1,0,75.36
彰化縣,永靖鄉,光雲村,0,1,1022,20,1042,1487,3,1,3,0,1,0,70.07
彰化縣,永靖鄉,東寧村,0,1,1055,10,1065,1608,3,1,3,0,1,0,66.23
彰化縣,永靖鄉,永興村,0,1,1058,8,1066,1487,3,1,3,0,1,0,71.69
彰化縣,永靖鄉,崙子村,0,1,797,16,813,1149,3,1,3,0,1,0,70.76
彰化縣,永靖鄉,獨鰲村,0,1,579,9,588,834,3,1,3,0,1,0,70.50
彰化縣,永靖鄉,敦厚村,0,1,483,5,488,690,3,1,3,0,1,0,70.72
彰化縣,永靖鄉,崙美村,0,1,540,5,545,726,3,1,3,0,1,0,75.07
彰化縣,永靖鄉,同安村,0,1,487,8,495,664,3,1,3,0,1,0,74.55
彰化縣,永靖鄉,同仁村,0,1,658,10,668,931,3,1,3,0,1,0,71.75
彰化縣,永靖鄉,湳墘村,0,1,610,11,621,834,3,1,3,0,1,0,74.46
彰化縣,永靖鄉,四芳村,0,1,488,7,495,657,3,1,3,0,1,0,75.34
彰化縣,永靖鄉,福興村,0,1,823,10,833,1119,3,1,3,0,1,0,74.44
彰化縣,永靖鄉,竹子村,0,1,948,10,958,1335,3,1,3,0,1,0,71.76
彰化縣,溪湖鎮,光平里,0,1,848,7,855,1208,3,1,3,0,1,0,70.78
彰化縣,溪湖鎮,平和里,0,1,569,3,572,759,3,1,3,0,1,0,75.36
彰化縣,溪湖鎮,太平里,0,1,923,8,931,1317,3,1,3,0,1,0,70.69
彰化縣,溪湖鎮,光華里,0,1,350,5,355,485,3,1,3,0,1,0,73.20
彰化縣,溪湖鎮,東寮里,0,1,1790,18,1808,2745,3,1,3,0,1,0,65.87
彰化縣,溪湖鎮,西寮里,0,1,1227,16,1243,1810,3,1,3,0,1,0,68.67
彰化縣,溪湖鎮,大突里,0,1,1379,20,1399,1991,3,1,3,0,1,0,70.27
彰化縣,溪湖鎮,北勢里,0,1,876,10,886,1241,3,1,3,0,1,0,71.39
彰化縣,溪湖鎮,汴頭里,0,1,1509,17,1526,2182,3,1,3,0,1,0,69.94
彰化縣,溪湖鎮,大竹里,0,1,1491,10,1501,2169,3,1,3,0,1,0,69.20
彰化縣,溪湖鎮,湖西里,0,1,1229,10,1239,1836,3,1,3,0,1,0,67.48
彰化縣,溪湖鎮,田中里,0,1,513,11,524,746,3,1,3,0,1,0,70.24
彰化縣,溪湖鎮,河東里,0,1,1067,16,1083,1577,3,1,3,0,1,0,68.67
彰化縣,溪湖鎮,中山里,0,1,1488,15,1503,2160,3,1,3,0,1,0,69.58
彰化縣,溪湖鎮,中竹里,0,1,508,9,517,781,3,1,3,0,1,0,66.20
彰化縣,溪湖鎮,東溪里,0,1,791,14,805,1214,3,1,3,0,1,0,66.31
彰化縣,溪湖鎮,西溪里,0,1,983,13,996,1452,3,1,3,0,1,0,68.60
彰化縣,溪湖鎮,湖東里,0,1,2330,32,2362,3449,3,1,3,0,1,0,68.48
彰化縣,溪湖鎮,頂庄里,0,1,448,9,457,661,3,1,3,0,1,0,69.14
彰化縣,溪湖鎮,忠覺里,0,1,790,11,801,1184,3,1,3,0,1,0,67.65
彰化縣,溪湖鎮,湳底里,0,1,494,7,501,701,3,1,3,0,1,0,71.47
彰化縣,溪湖鎮,大庭里,0,1,782,8,790,1211,3,1,3,0,1,0,65.24
彰化縣,溪湖鎮,媽厝里,0,1,827,12,839,1312,3,1,3,0,1,0,63.95
彰化縣,溪湖鎮,西勢里,0,1,1152,15,1167,1833,3,1,3,0,1,0,63.67
彰化縣,溪湖鎮,番婆里,0,1,881,15,896,1483,3,1,3,0,1,0,60.42
彰化縣,埔鹽鄉,埔鹽村,0,1,1060,24,1084,1461,3,1,3,0,1,0,74.20
彰化縣,埔鹽鄉,埔南村,0,1,980,23,1003,1449,3,1,3,0,1,0,69.22
彰化縣,埔鹽鄉,廍子村,0,1,788,15,803,1092,3,1,3,0,1,0,73.53
彰化縣,埔鹽鄉,出水村,0,1,600,10,610,787,3,1,3,0,1,0,77.51
彰化縣,埔鹽鄉,南港村,0,1,1180,15,1195,1579,3,1,3,0,1,0,75.68
彰化縣,埔鹽鄉,打廉村,0,1,645,8,653,917,3,1,3,0,1,0,71.21
彰化縣,埔鹽鄉,豐澤村,0,1,840,14,854,1258,3,1,3,0,1,0,67.89
彰化縣,埔鹽鄉,崑崙村,0,1,714,10,724,1001,3,1,3,0,1,0,72.33
彰化縣,埔鹽鄉,角樹村,0,1,519,5,524,676,3,1,3,0,1,0,77.51
彰化縣,埔鹽鄉,瓦窯村,0,1,814,15,829,1141,3,1,3,0,1,0,72.66
彰化縣,埔鹽鄉,好修村,0,1,911,11,922,1259,3,1,3,0,1,0,73.23
彰化縣,埔鹽鄉,西湖村,0,1,1328,35,1363,1921,3,1,3,0,1,0,70.95
彰化縣,埔鹽鄉,大有村,0,1,877,14,891,1226,3,1,3,0,1,0,72.68
彰化縣,埔鹽鄉,新興村,0,1,275,1,276,392,3,1,3,0,1,0,70.41
彰化縣,埔鹽鄉,永平村,0,1,677,8,685,1007,3,1,3,0,1,0,68.02
彰化縣,埔鹽鄉,永樂村,0,1,557,4,561,750,3,1,3,0,1,0,74.80
彰化縣,埔鹽鄉,石埤村,0,1,884,14,898,1301,3,1,3,0,1,0,69.02
彰化縣,埔鹽鄉,天盛村,0,1,620,3,623,809,3,1,3,0,1,0,77.01
彰化縣,埔鹽鄉,太平村,0,1,925,7,932,1454,3,1,3,0,1,0,64.10
彰化縣,埔鹽鄉,新水村,0,1,914,16,930,1301,3,1,3,0,1,0,71.48
彰化縣,埔鹽鄉,三省村,0,1,848,17,865,1258,3,1,3,0,1,0,68.76
彰化縣,埔鹽鄉,南新村,0,1,861,11,872,1232,3,1,3,0,1,0,70.78
彰化縣,埔心鄉,東門村,0,1,1665,21,1686,2476,3,1,3,0,1,0,68.09
彰化縣,埔心鄉,埔心村,0,1,821,9,830,1195,3,1,3,0,1,0,69.46
彰化縣,埔心鄉,義民村,0,1,981,14,995,1401,3,1,3,0,1,0,71.02
彰化縣,埔心鄉,油車村,0,1,761,18,779,1090,3,1,3,0,1,0,71.47
彰化縣,埔心鄉,瓦北村,0,1,1044,16,1060,1540,3,1,3,0,1,0,68.83
彰化縣,埔心鄉,瓦中村,0,1,1116,17,1133,1591,3,1,3,0,1,0,71.21
彰化縣,埔心鄉,瓦南村,0,1,937,13,950,1307,3,1,3,0,1,0,72.69
彰化縣,埔心鄉,經口村,0,1,1046,7,1053,1528,3,1,3,0,1,0,68.91
彰化縣,埔心鄉,太平村,0,1,1187,19,1206,1688,3,1,3,0,1,0,71.45
彰化縣,埔心鄉,大華村,0,1,414,4,418,590,3,1,3,0,1,0,70.85
彰化縣,埔心鄉,仁里村,0,1,678,13,691,1022,3,1,3,0,1,0,67.61
彰化縣,埔心鄉,舊舘村,0,1,782,12,794,1124,3,1,3,0,1,0,70.64
彰化縣,埔心鄉,南舘村,0,1,483,10,493,705,3,1,3,0,1,0,69.93
彰化縣,埔心鄉,新舘村,0,1,567,13,580,849,3,1,3,0,1,0,68.32
彰化縣,埔心鄉,芎蕉村,0,1,1101,22,1123,1608,3,1,3,0,1,0,69.84
彰化縣,埔心鄉,羅厝村,0,1,901,8,909,1285,3,1,3,0,1,0,70.74
彰化縣,埔心鄉,梧鳳村,0,1,590,6,596,861,3,1,3,0,1,0,69.22
彰化縣,埔心鄉,二重村,0,1,805,8,813,1174,3,1,3,0,1,0,69.25
彰化縣,埔心鄉,埤霞村,0,1,539,17,556,757,3,1,3,0,1,0,73.45
彰化縣,埔心鄉,埤腳村,0,1,608,10,618,830,3,1,3,0,1,0,74.46
彰化縣,田中鎮,香山里,0,1,606,5,611,884,3,1,3,0,1,0,69.12
彰化縣,田中鎮,碧峰里,0,1,1242,81,1323,2348,3,1,3,0,1,0,56.35
彰化縣,田中鎮,東源里,0,1,415,5,420,644,3,1,3,0,1,0,65.22
彰化縣,田中鎮,復興里,0,1,1008,18,1026,1459,3,1,3,0,1,0,70.32
彰化縣,田中鎮,平和里,0,1,964,24,988,1448,3,1,3,0,1,0,68.23
彰化縣,田中鎮,頂潭里,0,1,850,11,861,1202,3,1,3,0,1,0,71.63
彰化縣,田中鎮,中潭里,0,1,1119,9,1128,1642,3,1,3,0,1,0,68.70
彰化縣,田中鎮,龍潭里,0,1,449,6,455,638,3,1,3,0,1,0,71.32
彰化縣,田中鎮,北路里,0,1,1892,18,1910,2718,3,1,3,0,1,0,70.27
彰化縣,田中鎮,西路里,0,1,1444,20,1464,2101,3,1,3,0,1,0,69.68
彰化縣,田中鎮,東路里,0,1,798,10,808,1070,3,1,3,0,1,0,75.51
彰化縣,田中鎮,南路里,0,1,893,9,902,1258,3,1,3,0,1,0,71.70
彰化縣,田中鎮,中路里,0,1,1389,12,1401,1963,3,1,3,0,1,0,71.37
彰化縣,田中鎮,新庄里,0,1,1305,29,1334,2013,3,1,3,0,1,0,66.27
彰化縣,田中鎮,三安里,0,1,1062,18,1080,1608,3,1,3,0,1,0,67.16
彰化縣,田中鎮,大崙里,0,1,876,6,882,1272,3,1,3,0,1,0,69.34
彰化縣,田中鎮,沙崙里,0,1,983,13,996,1540,3,1,3,0,1,0,64.68
彰化縣,田中鎮,新民里,0,1,2123,32,2155,3250,3,1,3,0,1,0,66.31
彰化縣,田中鎮,梅州里,0,1,844,14,858,1295,3,1,3,0,1,0,66.25
彰化縣,田中鎮,三民里,0,1,1017,14,1031,1482,3,1,3,0,1,0,69.57
彰化縣,田中鎮,三光里,0,1,573,9,582,861,3,1,3,0,1,0,67.60
彰化縣,田中鎮,大社里,0,1,541,3,544,766,3,1,3,0,1,0,71.02
彰化縣,社頭鄉,社頭村,0,1,1741,16,1757,2567,3,1,3,0,1,0,68.45
彰化縣,社頭鄉,廣興村,0,1,2481,39,2520,3557,3,1,3,0,1,0,70.85
彰化縣,社頭鄉,仁雅村,0,1,1659,12,1671,2407,3,1,3,0,1,0,69.42
彰化縣,社頭鄉,崙雅村,0,1,523,11,534,770,3,1,3,0,1,0,69.35
彰化縣,社頭鄉,美雅村,0,1,701,10,711,994,3,1,3,0,1,0,71.53
彰化縣,社頭鄉,里仁村,0,1,693,13,706,990,3,1,3,0,1,0,71.31
彰化縣,社頭鄉,舊社村,0,1,937,15,952,1341,3,1,3,0,1,0,70.99
彰化縣,社頭鄉,松竹村,0,1,636,7,643,881,3,1,3,0,1,0,72.99
彰化縣,社頭鄉,東興村,0,1,844,20,864,1215,3,1,3,0,1,0,71.11
彰化縣,社頭鄉,廣福村,0,1,575,12,587,826,3,1,3,0,1,0,71.07
彰化縣,社頭鄉,橋頭村,0,1,1319,17,1336,1836,3,1,3,0,1,0,72.77
彰化縣,社頭鄉,湳底村,0,1,1026,10,1036,1436,3,1,3,0,1,0,72.14
彰化縣,社頭鄉,新厝村,0,1,985,13,998,1375,3,1,3,0,1,0,72.58
彰化縣,社頭鄉,張厝村,0,1,750,20,770,1065,3,1,3,0,1,0,72.30
彰化縣,社頭鄉,埤斗村,0,1,712,10,722,978,3,1,3,0,1,0,73.82
彰化縣,社頭鄉,清水村,0,1,770,9,779,1046,3,1,3,0,1,0,74.47
彰化縣,社頭鄉,山湖村,0,1,680,8,688,921,3,1,3,0,1,0,74.70
彰化縣,社頭鄉,朝興村,0,1,713,12,725,1020,3,1,3,0,1,0,71.08
彰化縣,社頭鄉,仁和村,0,1,456,12,468,669,3,1,3,0,1,0,69.96
彰化縣,社頭鄉,泰安村,0,1,580,8,588,827,3,1,3,0,1,0,71.10
彰化縣,社頭鄉,平和村,0,1,682,10,692,958,3,1,3,0,1,0,72.23
彰化縣,社頭鄉,龍井村,0,1,537,5,542,782,3,1,3,0,1,0,69.31
彰化縣,社頭鄉,湳雅村,0,1,898,17,915,1340,3,1,3,0,1,0,68.28
彰化縣,社頭鄉,協和村,0,1,1308,29,1337,1873,3,1,3,0,1,0,71.38
彰化縣,二水鄉,復興村,0,1,724,11,735,1018,3,1,3,0,1,0,72.20
彰化縣,二水鄉,十五村,0,1,487,7,494,704,3,1,3,0,1,0,70.17
彰化縣,二水鄉,合和村,0,1,590,9,599,879,3,1,3,0,1,0,68.15
彰化縣,二水鄉,上豐村,0,1,711,10,721,1017,3,1,3,0,1,0,70.89
彰化縣,二水鄉,過圳村,0,1,465,4,469,631,3,1,3,0,1,0,74.33
彰化縣,二水鄉,五伯村,0,1,492,1,493,660,3,1,3,0,1,0,74.70
彰化縣,二水鄉,光化村,0,1,716,10,726,965,3,1,3,0,1,0,75.23
彰化縣,二水鄉,文化村,0,1,730,5,735,1012,3,1,3,0,1,0,72.63
彰化縣,二水鄉,二水村,0,1,612,8,620,877,3,1,3,0,1,0,70.70
彰化縣,二水鄉,聖化村,0,1,371,1,372,513,3,1,3,0,1,0,72.51
彰化縣,二水鄉,裕民村,0,1,592,8,600,910,3,1,3,0,1,0,65.93
彰化縣,二水鄉,惠民村,0,1,606,10,616,862,3,1,3,0,1,0,71.46
彰化縣,二水鄉,大園村,0,1,589,2,591,758,3,1,3,0,1,0,77.97
彰化縣,二水鄉,修仁村,0,1,577,7,584,811,3,1,3,0,1,0,72.01
彰化縣,二水鄉,合興村,0,1,552,4,556,768,3,1,3,0,1,0,72.40
彰化縣,二水鄉,源泉村,0,1,454,6,460,688,3,1,3,0,1,0,66.86
彰化縣,二水鄉,倡和村,0,1,426,5,431,620,3,1,3,0,1,0,69.52
彰化縣,北斗鎮,中寮里,0,1,1518,31,1549,2287,3,1,3,0,1,0,67.73
彰化縣,北斗鎮,大道里,0,1,1192,7,1199,1680,3,1,3,0,1,0,71.37
彰化縣,北斗鎮,西德里,0,1,2576,46,2622,3795,3,1,3,0,1,0,69.09
彰化縣,北斗鎮,西安里,0,1,984,15,999,1555,3,1,3,0,1,0,64.24
彰化縣,北斗鎮,光復里,0,1,915,5,920,1360,3,1,3,0,1,0,67.65
彰化縣,北斗鎮,新政里,0,1,566,5,571,783,3,1,3,0,1,0,72.92
彰化縣,北斗鎮,重慶里,0,1,452,11,463,632,3,1,3,0,1,0,73.26
彰化縣,北斗鎮,五權里,0,1,521,8,529,767,3,1,3,0,1,0,68.97
彰化縣,北斗鎮,七星里,0,1,891,11,902,1395,3,1,3,0,1,0,64.66
彰化縣,北斗鎮,居仁里,0,1,882,14,896,1288,3,1,3,0,1,0,69.57
彰化縣,北斗鎮,東光里,0,1,1094,16,1110,1686,3,1,3,0,1,0,65.84
彰化縣,北斗鎮,文昌里,0,1,1449,15,1464,2199,3,1,3,0,1,0,66.58
彰化縣,北斗鎮,中和里,0,1,702,9,711,1033,3,1,3,0,1,0,68.83
彰化縣,北斗鎮,新生里,0,1,1106,25,1131,1653,3,1,3,0,1,0,68.42
彰化縣,北斗鎮,大新里,0,1,915,27,942,1478,3,1,3,0,1,0,63.73
彰化縣,溪州鄉,溪厝村,0,1,1007,29,1036,1719,3,1,3,0,1,0,60.27
彰化縣,溪州鄉,坑厝村,0,1,441,13,454,675,3,1,3,0,1,0,67.26
彰化縣,溪州鄉,瓦厝村,0,1,593,12,605,922,3,1,3,0,1,0,65.62
彰化縣,溪州鄉,溪州村,0,1,1047,23,1070,1587,3,1,3,0,1,0,67.42
彰化縣,溪州鄉,尾厝村,0,1,866,14,880,1314,3,1,3,0,1,0,66.97
彰化縣,溪州鄉,東州村,0,1,1142,20,1162,1718,3,1,3,0,1,0,67.64
彰化縣,溪州鄉,舊眉村,0,1,826,9,835,1246,3,1,3,0,1,0,67.01
彰化縣,溪州鄉,圳寮村,0,1,845,14,859,1417,3,1,3,0,1,0,60.62
彰化縣,溪州鄉,西畔村,0,1,1267,18,1285,1997,3,1,3,0,1,0,64.35
彰化縣,溪州鄉,成功村,0,1,1113,17,1130,1801,3,1,3,0,1,0,62.74
彰化縣,溪州鄉,大庄村,0,1,1175,15,1190,1887,3,1,3,0,1,0,63.06
彰化縣,溪州鄉,榮光村,0,1,495,18,513,793,3,1,3,0,1,0,64.69
彰化縣,溪州鄉,柑園村,0,1,721,14,735,1091,3,1,3,0,1,0,67.37
彰化縣,溪州鄉,潮洋村,0,1,546,2,548,946,3,1,3,0,1,0,57.93
彰化縣,溪州鄉,張厝村,0,1,411,10,421,750,3,1,3,0,1,0,56.13
彰化縣,溪州鄉,菜公村,0,1,578,7,585,865,3,1,3,0,1,0,67.63
彰化縣,溪州鄉,三圳村,0,1,766,14,780,1219,3,1,3,0,1,0,63.99
彰化縣,溪州鄉,三條村,0,1,610,10,620,901,3,1,3,0,1,0,68.81
彰化縣,溪州鄉,水尾村,0,1,695,21,716,1210,3,1,3,0,1,0,59.17
彰化縣,田尾鄉,田尾村,0,1,767,9,776,1208,3,1,3,0,1,0,64.24
彰化縣,田尾鄉,豐田村,0,1,465,6,471,678,3,1,3,0,1,0,69.47
彰化縣,田尾鄉,饒平村,0,1,1308,24,1332,1911,3,1,3,0,1,0,69.70
彰化縣,田尾鄉,北曾村,0,1,753,16,769,1198,3,1,3,0,1,0,64.19
彰化縣,田尾鄉,南曾村,0,1,807,13,820,1159,3,1,3,0,1,0,70.75
彰化縣,田尾鄉,睦宜村,0,1,664,15,679,1005,3,1,3,0,1,0,67.56
彰化縣,田尾鄉,新生村,0,1,819,8,827,1132,3,1,3,0,1,0,73.06
彰化縣,田尾鄉,北鎮村,0,1,637,10,647,959,3,1,3,0,1,0,67.47
彰化縣,田尾鄉,南鎮村,0,1,449,14,463,669,3,1,3,0,1,0,69.21
彰化縣,田尾鄉,福田村,0,1,588,9,597,842,3,1,3,0,1,0,70.90
彰化縣,田尾鄉,新興村,0,1,710,15,725,1004,3,1,3,0,1,0,72.21
彰化縣,田尾鄉,溪畔村,0,1,831,17,848,1211,3,1,3,0,1,0,70.02
彰化縣,田尾鄉,打簾村,0,1,1137,20,1157,1700,3,1,3,0,1,0,68.06
彰化縣,田尾鄉,柳鳳村,0,1,587,5,592,810,3,1,3,0,1,0,73.09
彰化縣,田尾鄉,陸豐村,0,1,593,6,599,845,3,1,3,0,1,0,70.89
彰化縣,田尾鄉,海豐村,0,1,947,21,968,1465,3,1,3,0,1,0,66.08
彰化縣,田尾鄉,仁里村,0,1,1015,15,1030,1504,3,1,3,0,1,0,68.48
彰化縣,田尾鄉,新厝村,0,1,208,6,214,298,3,1,3,0,1,0,71.81
彰化縣,田尾鄉,溪頂村,0,1,400,8,408,608,3,1,3,0,1,0,67.11
彰化縣,田尾鄉,正義村,0,1,493,9,502,696,3,1,3,0,1,0,72.13
彰化縣,埤頭鄉,和豐村,0,1,1363,41,1404,2217,3,1,3,0,1,0,63.33
彰化縣,埤頭鄉,興農村,0,1,982,26,1008,1493,3,1,3,0,1,0,67.52
彰化縣,埤頭鄉,埤頭村,0,1,992,13,1005,1556,3,1,3,0,1,0,64.59
彰化縣,埤頭鄉,豐崙村,0,1,1301,22,1323,2085,3,1,3,0,1,0,63.45
彰化縣,埤頭鄉,崙子村,0,1,706,22,728,1119,3,1,3,0,1,0,65.06
彰化縣,埤頭鄉,永豐村,0,1,946,13,959,1431,3,1,3,0,1,0,67.02
彰化縣,埤頭鄉,合興村,0,1,1965,42,2007,2917,3,1,3,0,1,0,68.80
彰化縣,埤頭鄉,平原村,0,1,1046,19,1065,1603,3,1,3,0,1,0,66.44
彰化縣,埤頭鄉,崙腳村,0,1,453,10,463,683,3,1,3,0,1,0,67.79
彰化縣,埤頭鄉,元埔村,0,1,382,3,385,594,3,1,3,0,1,0,64.81
彰化縣,埤頭鄉,芙朝村,0,1,1030,25,1055,1649,3,1,3,0,1,0,63.98
彰化縣,埤頭鄉,新庄村,0,1,710,8,718,1159,3,1,3,0,1,0,61.95
彰化縣,埤頭鄉,陸嘉村,0,1,532,17,549,831,3,1,3,0,1,0,66.06
彰化縣,埤頭鄉,竹圍村,0,1,547,15,562,853,3,1,3,0,1,0,65.89
彰化縣,埤頭鄉,中和村,0,1,790,12,802,1293,3,1,3,0,1,0,62.03
彰化縣,埤頭鄉,庄內村,0,1,547,13,560,928,3,1,3,0,1,0,60.34
彰化縣,埤頭鄉,大湖村,0,1,628,9,637,985,3,1,3,0,1,0,64.67
彰化縣,二林鎮,東和里,0,1,1393,13,1406,2066,3,1,3,0,1,0,68.05
彰化縣,二林鎮,南光里,0,1,1837,33,1870,2760,3,1,3,0,1,0,67.75
彰化縣,二林鎮,西平里,0,1,879,13,892,1296,3,1,3,0,1,0,68.83
彰化縣,二林鎮,北平里,0,1,1615,39,1654,2562,3,1,3,0,1,0,64.56
彰化縣,二林鎮,中西里,0,1,934,18,952,1573,3,1,3,0,1,0,60.52
彰化縣,二林鎮,廣興里,0,1,876,21,897,1453,3,1,3,0,1,0,61.73
彰化縣,二林鎮,香田里,0,1,722,20,742,1181,3,1,3,0,1,0,62.83
彰化縣,二林鎮,外竹里,0,1,709,18,727,1087,3,1,3,0,1,0,66.88
彰化縣,二林鎮,興華里,0,1,686,14,700,1085,3,1,3,0,1,0,64.52
彰化縣,二林鎮,東興里,0,1,778,10,788,1179,3,1,3,0,1,0,66.84
彰化縣,二林鎮,後厝里,0,1,1407,24,1431,2320,3,1,3,0,1,0,61.68
彰化縣,二林鎮,豐田里,0,1,1321,26,1347,2087,3,1,3,0,1,0,64.54
彰化縣,二林鎮,頂厝里,0,1,819,14,833,1363,3,1,3,0,1,0,61.12
彰化縣,二林鎮,趙甲里,0,1,1081,31,1112,1637,3,1,3,0,1,0,67.93
彰化縣,二林鎮,振興里,0,1,812,22,834,1281,3,1,3,0,1,0,65.11
彰化縣,二林鎮,萬興里,0,1,535,12,547,786,3,1,3,0,1,0,69.59
彰化縣,二林鎮,永興里,0,1,960,8,968,1501,3,1,3,0,1,0,64.49
彰化縣,二林鎮,西庄里,0,1,790,9,799,1222,3,1,3,0,1,0,65.38
彰化縣,二林鎮,梅芳里,0,1,689,20,709,1065,3,1,3,0,1,0,66.57
彰化縣,二林鎮,華崙里,0,1,2238,31,2269,3469,3,1,3,0,1,0,65.41
彰化縣,二林鎮,萬合里,0,1,808,17,825,1309,3,1,3,0,1,0,63.03
彰化縣,二林鎮,東勢里,0,1,641,9,650,1002,3,1,3,0,1,0,64.87
彰化縣,二林鎮,大永里,0,1,573,11,584,864,3,1,3,0,1,0,67.59
彰化縣,二林鎮,原斗里,0,1,798,8,806,1206,3,1,3,0,1,0,66.83
彰化縣,二林鎮,西斗里,0,1,663,11,674,1011,3,1,3,0,1,0,66.67
彰化縣,二林鎮,東華里,0,1,673,10,683,1010,3,1,3,0,1,0,67.62
彰化縣,二林鎮,復豐里,0,1,507,7,514,745,3,1,3,0,1,0,68.99
彰化縣,芳苑鄉,芳苑村,0,1,595,12,607,1035,3,1,3,0,1,0,58.65
彰化縣,芳苑鄉,芳中村,0,1,317,7,324,537,3,1,3,0,1,0,60.34
彰化縣,芳苑鄉,仁愛村,0,1,553,14,567,898,3,1,3,0,1,0,63.14
彰化縣,芳苑鄉,信義村,0,1,398,4,402,673,3,1,3,0,1,0,59.73
彰化縣,芳苑鄉,後寮村,0,1,589,14,603,934,3,1,3,0,1,0,64.56
彰化縣,芳苑鄉,三合村,0,1,1161,23,1184,1812,3,1,3,0,1,0,65.34
彰化縣,芳苑鄉,永興村,0,1,875,16,891,1399,3,1,3,0,1,0,63.69
彰化縣,芳苑鄉,新街村,0,1,543,5,548,1062,3,1,3,0,1,0,51.60
彰化縣,芳苑鄉,路上村,0,1,467,8,475,763,3,1,3,0,1,0,62.25
彰化縣,芳苑鄉,路平村,0,1,495,8,503,768,3,1,3,0,1,0,65.49
彰化縣,芳苑鄉,三成村,0,1,644,15,659,1020,3,1,3,0,1,0,64.61
彰化縣,芳苑鄉,福榮村,0,1,392,13,405,679,3,1,3,0,1,0,59.65
彰化縣,芳苑鄉,頂廍村,0,1,382,8,390,645,3,1,3,0,1,0,60.47
彰化縣,芳苑鄉,王功村,0,1,1253,23,1276,2065,3,1,3,0,1,0,61.79
彰化縣,芳苑鄉,博愛村,0,1,526,5,531,792,3,1,3,0,1,0,67.05
彰化縣,芳苑鄉,和平村,0,1,519,9,528,809,3,1,3,0,1,0,65.27
彰化縣,芳苑鄉,興仁村,0,1,799,9,808,1369,3,1,3,0,1,0,59.02
彰化縣,芳苑鄉,民生村,0,1,475,9,484,789,3,1,3,0,1,0,61.34
彰化縣,芳苑鄉,新寶村,0,1,931,8,939,1330,3,1,3,0,1,0,70.60
彰化縣,芳苑鄉,五俊村,0,1,309,6,315,578,3,1,3,0,1,0,54.50
彰化縣,芳苑鄉,草湖村,0,1,882,13,895,1420,3,1,3,0,1,0,63.03
彰化縣,芳苑鄉,建平村,0,1,1284,20,1304,2029,3,1,3,0,1,0,64.27
彰化縣,芳苑鄉,崙腳村,0,1,514,4,518,728,3,1,3,0,1,0,71.15
彰化縣,芳苑鄉,文津村,0,1,682,16,698,1019,3,1,3,0,1,0,68.50
彰化縣,芳苑鄉,新生村,0,1,824,16,840,1368,3,1,3,0,1,0,61.40
彰化縣,芳苑鄉,漢寶村,0,1,1882,32,1914,2784,3,1,3,0,1,0,68.75
彰化縣,大城鄉,潭墘村,0,1,832,15,847,1371,3,1,3,0,1,0,61.78
彰化縣,大城鄉,山腳村,0,1,829,18,847,1422,3,1,3,0,1,0,59.56
彰化縣,大城鄉,西城村,0,1,568,11,579,908,3,1,3,0,1,0,63.77
彰化縣,大城鄉,東城村,0,1,827,9,836,1289,3,1,3,0,1,0,64.86
彰化縣,大城鄉,大城村,0,1,666,6,672,1068,3,1,3,0,1,0,62.92
彰化縣,大城鄉,上山村,0,1,712,11,723,1206,3,1,3,0,1,0,59.95
彰化縣,大城鄉,永和村,0,1,470,6,476,761,3,1,3,0,1,0,62.55
彰化縣,大城鄉,公館村,0,1,740,10,750,1234,3,1,3,0,1,0,60.78
彰化縣,大城鄉,豐美村,0,1,539,7,546,919,3,1,3,0,1,0,59.41
彰化縣,大城鄉,三豐村,0,1,411,12,423,760,3,1,3,0,1,0,55.66
彰化縣,大城鄉,菜寮村,0,1,765,10,775,1206,3,1,3,0,1,0,64.26
彰化縣,大城鄉,東港村,0,1,821,12,833,1351,3,1,3,0,1,0,61.66
彰化縣,大城鄉,西港村,0,1,663,9,672,1138,3,1,3,0,1,0,59.05
彰化縣,大城鄉,頂庄村,0,1,465,7,472,811,3,1,3,0,1,0,58.20
彰化縣,大城鄉,台西村,0,1,644,8,652,1076,3,1,3,0,1,0,60.59
彰化縣,竹塘鄉,竹元村,0,1,680,5,685,1081,3,1,3,0,1,0,63.37
彰化縣,竹塘鄉,竹塘村,0,1,1082,8,1090,1651,3,1,3,0,1,0,66.02
彰化縣,竹塘鄉,小西村,0,1,529,9,538,831,3,1,3,0,1,0,64.74
彰化縣,竹塘鄉,民靖村,0,1,497,5,502,796,3,1,3,0,1,0,63.07
彰化縣,竹塘鄉,五庄村,0,1,904,15,919,1525,3,1,3,0,1,0,60.26
彰化縣,竹塘鄉,樹腳村,0,1,420,8,428,628,3,1,3,0,1,0,68.15
彰化縣,竹塘鄉,田頭村,0,1,603,8,611,957,3,1,3,0,1,0,63.85
彰化縣,竹塘鄉,新廣村,0,1,769,3,772,1183,3,1,3,0,1,0,65.26
彰化縣,竹塘鄉,溪墘村,0,1,352,7,359,570,3,1,3,0,1,0,62.98
彰化縣,竹塘鄉,竹林村,0,1,546,9,555,888,3,1,3,0,1,0,62.50
彰化縣,竹塘鄉,土庫村,0,1,431,5,436,723,3,1,3,0,1,0,60.30
彰化縣,竹塘鄉,內新村,0,1,377,5,382,669,3,1,3,0,1,0,57.10
彰化縣,竹塘鄉,長安村,0,1,474,6,480,774,3,1,3,0,1,0,62.02
彰化縣,竹塘鄉,永安村,0,1,374,5,379,707,3,1,3,0,1,0,53.61
南投縣,南投市,龍泉里,0,1,635,5,640,949,3,1,3,0,1,0,67.44
南投縣,南投市,康壽里,0,1,924,8,932,1347,3,1,3,0,1,0,69.19
南投縣,南投市,三民里,0,1,535,3,538,704,3,1,3,0,1,0,76.42
南投縣,南投市,仁和里,0,1,412,1,413,527,3,1,3,0,1,0,78.37
南投縣,南投市,南投里,0,1,493,6,499,701,3,1,3,0,1,0,71.18
南投縣,南投市,彰仁里,0,1,326,1,327,437,3,1,3,0,1,0,74.83
南投縣,南投市,崇文里,0,1,751,8,759,1042,3,1,3,0,1,0,72.84
南投縣,南投市,三興里,0,1,2794,32,2826,4158,3,1,3,0,1,0,67.97
南投縣,南投市,三和里,0,1,1997,8,2005,2772,3,1,3,0,1,0,72.33
南投縣,南投市,嘉興里,0,1,1174,8,1182,1712,3,1,3,0,1,0,69.04
南投縣,南投市,嘉和里,0,1,2019,16,2035,2857,3,1,3,0,1,0,71.23
南投縣,南投市,平和里,0,1,3410,16,3426,4961,3,1,3,0,1,0,69.06
南投縣,南投市,振興里,0,1,1361,6,1367,1917,3,1,3,0,1,0,71.31
南投縣,南投市,千秋里,0,1,557,6,563,857,3,1,3,0,1,0,65.69
南投縣,南投市,軍功里,0,1,2507,23,2530,3664,3,1,3,0,1,0,69.05
南投縣,南投市,東山里,0,1,250,3,253,384,3,1,3,0,1,0,65.89
南投縣,南投市,營南里,0,1,1385,14,1399,1889,3,1,3,0,1,0,74.06
南投縣,南投市,營北里,0,1,3226,21,3247,4570,3,1,3,0,1,0,71.05
南投縣,南投市,內興里,0,1,3334,22,3356,4787,3,1,3,0,1,0,70.11
南投縣,南投市,內新里,0,1,941,5,946,1299,3,1,3,0,1,0,72.83
南投縣,南投市,光輝里,0,1,372,5,377,561,3,1,3,0,1,0,67.20
南投縣,南投市,光榮里,0,1,1265,8,1273,1844,3,1,3,0,1,0,69.03
南投縣,南投市,光明里,0,1,1383,8,1391,1940,3,1,3,0,1,0,71.70
南投縣,南投市,光華里,0,1,1040,6,1046,1482,3,1,3,0,1,0,70.58
南投縣,南投市,漳興里,0,1,1660,11,1671,2301,3,1,3,0,1,0,72.62
南投縣,南投市,漳和里,0,1,3838,32,3870,5462,3,1,3,0,1,0,70.85
南投縣,南投市,平山里,0,1,2636,21,2657,3905,3,1,3,0,1,0,68.04
南投縣,南投市,新興里,0,1,2292,23,2315,3388,3,1,3,0,1,0,68.33
南投縣,南投市,永豐里,0,1,1508,17,1525,2262,3,1,3,0,1,0,67.42
南投縣,南投市,福興里,0,1,1677,19,1696,2503,3,1,3,0,1,0,67.76
南投縣,南投市,鳳山里,0,1,741,6,747,1269,3,1,3,0,1,0,58.87
南投縣,南投市,永興里,0,1,525,4,529,752,3,1,3,0,1,0,70.35
南投縣,南投市,鳳鳴里,0,1,510,5,515,763,3,1,3,0,1,0,67.50
南投縣,南投市,福山里,0,1,1078,11,1089,1730,3,1,3,0,1,0,62.95
南投縣,埔里鎮,東門里,0,1,1899,14,1913,2880,3,1,3,0,1,0,66.42
南投縣,埔里鎮,西門里,0,1,1907,12,1919,3026,3,1,3,0,1,0,63.42
南投縣,埔里鎮,南門里,0,1,621,8,629,943,3,1,3,0,1,0,66.70
南投縣,埔里鎮,北門里,0,1,1463,25,1488,2274,3,1,3,0,1,0,65.44
南投縣,埔里鎮,北安里,0,1,1967,14,1981,2987,3,1,3,0,1,0,66.32
南投縣,埔里鎮,泰安里,0,1,1250,15,1265,1878,3,1,3,0,1,0,67.36
南投縣,埔里鎮,北梅里,0,1,1332,12,1344,2100,3,1,3,0,1,0,64.00
南投縣,埔里鎮,同聲里,0,1,1420,30,1450,2169,3,1,3,0,1,0,66.85
南投縣,埔里鎮,清新里,0,1,2174,23,2197,3443,3,1,3,0,1,0,63.81
南投縣,埔里鎮,薰化里,0,1,863,11,874,1250,3,1,3,0,1,0,69.92
南投縣,埔里鎮,大城里,0,1,3553,38,3591,5532,3,1,3,0,1,0,64.91
南投縣,埔里鎮,籃城里,0,1,619,6,625,913,3,1,3,0,1,0,68.46
南投縣,埔里鎮,杷城里,0,1,1468,14,1482,2210,3,1,3,0,1,0,67.06
南投縣,埔里鎮,枇杷里,0,1,3392,46,3438,5322,3,1,3,0,1,0,64.60
南投縣,埔里鎮,水頭里,0,1,1846,29,1875,3033,3,1,3,0,1,0,61.82
南投縣,埔里鎮,麒麟里,0,1,607,6,613,963,3,1,3,0,1,0,63.66
南投縣,埔里鎮,珠格里,0,1,651,6,657,956,3,1,3,0,1,0,68.72
南投縣,埔里鎮,溪南里,0,1,522,3,525,765,3,1,3,0,1,0,68.63
南投縣,埔里鎮,桃米里,0,1,594,4,598,938,3,1,3,0,1,0,63.75
南投縣,埔里鎮,成功里,0,1,200,2,202,347,3,1,3,0,1,0,58.21
南投縣,埔里鎮,南村里,0,1,815,13,828,1299,3,1,3,0,1,0,63.74
南投縣,埔里鎮,愛蘭里,0,1,820,15,835,1315,3,1,3,0,1,0,63.50
南投縣,埔里鎮,鐵山里,0,1,999,7,1006,1530,3,1,3,0,1,0,65.75
南投縣,埔里鎮,房里里,0,1,779,10,789,1189,3,1,3,0,1,0,66.36
南投縣,埔里鎮,向善里,0,1,481,4,485,664,3,1,3,0,1,0,73.04
南投縣,埔里鎮,一新里,0,1,889,15,904,1196,3,1,3,0,1,0,75.59
南投縣,埔里鎮,合成里,0,1,1061,6,1067,1536,3,1,3,0,1,0,69.47
南投縣,埔里鎮,廣成里,0,1,673,9,682,1140,3,1,3,0,1,0,59.82
南投縣,埔里鎮,史港里,0,1,382,2,384,633,3,1,3,0,1,0,60.66
南投縣,埔里鎮,福興里,0,1,603,9,612,981,3,1,3,0,1,0,62.39
南投縣,埔里鎮,牛眠里,0,1,1604,18,1622,2371,3,1,3,0,1,0,68.41
南投縣,埔里鎮,大湳里,0,1,805,8,813,1187,3,1,3,0,1,0,68.49
南投縣,埔里鎮,蜈蚣里,0,1,1619,22,1641,2452,3,1,3,0,1,0,66.92
南投縣,草屯鎮,玉峰里,0,1,1317,16,1333,1878,3,1,3,0,1,0,70.98
南投縣,草屯鎮,明正里,0,1,2289,12,2301,3318,3,1,3,0,1,0,69.35
南投縣,草屯鎮,炎峰里,0,1,1472,11,1483,2048,3,1,3,0,1,0,72.41
南投縣,草屯鎮,中正里,0,1,541,8,549,726,3,1,3,0,1,0,75.62
南投縣,草屯鎮,和平里,0,1,919,7,926,1262,3,1,3,0,1,0,73.38
南投縣,草屯鎮,中山里,0,1,1533,14,1547,2233,3,1,3,0,1,0,69.28
南投縣,草屯鎮,敦和里,0,1,3585,37,3622,5189,3,1,3,0,1,0,69.80
南投縣,草屯鎮,山腳里,0,1,4089,30,4119,5814,3,1,3,0,1,0,70.85
南投縣,草屯鎮,新厝里,0,1,1899,20,1919,2694,3,1,3,0,1,0,71.23
南投縣,草屯鎮,上林里,0,1,1653,20,1673,2300,3,1,3,0,1,0,72.74
南投縣,草屯鎮,碧峰里,0,1,2171,18,2189,3258,3,1,3,0,1,0,67.19
南投縣,草屯鎮,碧洲里,0,1,1193,9,1202,1620,3,1,3,0,1,0,74.20
南投縣,草屯鎮,復興里,0,1,1845,27,1872,2696,3,1,3,0,1,0,69.44
南投縣,草屯鎮,御史里,0,1,3310,32,3342,4951,3,1,3,0,1,0,67.50
南投縣,草屯鎮,新豐里,0,1,2314,24,2338,3291,3,1,3,0,1,0,71.04
南投縣,草屯鎮,新庄里,0,1,1956,22,1978,2794,3,1,3,0,1,0,70.79
南投縣,草屯鎮,加老里,0,1,1420,15,1435,1916,3,1,3,0,1,0,74.90
南投縣,草屯鎮,石川里,0,1,859,4,863,1203,3,1,3,0,1,0,71.74
南投縣,草屯鎮,北投里,0,1,1646,12,1658,2322,3,1,3,0,1,0,71.40
南投縣,草屯鎮,富寮里,0,1,2910,32,2942,4272,3,1,3,0,1,0,68.87
南投縣,草屯鎮,北勢里,0,1,1259,18,1277,1840,3,1,3,0,1,0,69.40
南投縣,草屯鎮,中原里,0,1,1261,15,1276,1764,3,1,3,0,1,0,72.34
南投縣,草屯鎮,南埔里,0,1,2241,24,2265,3192,3,1,3,0,1,0,70.96
南投縣,草屯鎮,坪頂里,0,1,684,4,688,943,3,1,3,0,1,0,72.96
南投縣,草屯鎮,土城里,0,1,1052,15,1067,1639,3,1,3,0,1,0,65.10
南投縣,草屯鎮,平林里,0,1,717,4,721,994,3,1,3,0,1,0,72.54
南投縣,草屯鎮,雙冬里,0,1,1544,11,1555,2304,3,1,3,0,1,0,67.49
南投縣,竹山鎮,竹山里,0,1,1433,10,1443,2121,3,1,3,0,1,0,68.03
南投縣,竹山鎮,中正里,0,1,527,7,534,745,3,1,3,0,1,0,71.68
南投縣,竹山鎮,中山里,0,1,2884,27,2911,4291,3,1,3,0,1,0,67.84
南投縣,竹山鎮,雲林里,0,1,2106,18,2124,3173,3,1,3,0,1,0,66.94
南投縣,竹山鎮,竹圍里,0,1,1380,24,1404,2192,3,1,3,0,1,0,64.05
南投縣,竹山鎮,桂林里,0,1,2166,17,2183,3277,3,1,3,0,1,0,66.62
南投縣,竹山鎮,下坪里,0,1,703,7,710,1055,3,1,3,0,1,0,67.30
南投縣,竹山鎮,中和里,0,1,729,10,739,1028,3,1,3,0,1,0,71.89
南投縣,竹山鎮,中崎里,0,1,803,8,811,1274,3,1,3,0,1,0,63.66
南投縣,竹山鎮,秀林里,0,1,511,4,515,768,3,1,3,0,1,0,67.06
南投縣,竹山鎮,大鞍里,0,1,277,4,281,368,3,1,3,0,1,0,76.36
南投縣,竹山鎮,延和里,0,1,2564,15,2579,4014,3,1,3,0,1,0,64.25
南投縣,竹山鎮,延祥里,0,1,2034,20,2054,3180,3,1,3,0,1,0,64.59
南投縣,竹山鎮,延正里,0,1,1085,20,1105,1641,3,1,3,0,1,0,67.34
南投縣,竹山鎮,延平里,0,1,1728,26,1754,2690,3,1,3,0,1,0,65.20
南投縣,竹山鎮,延山里,0,1,389,5,394,666,3,1,3,0,1,0,59.16
南投縣,竹山鎮,山崇里,0,1,1164,14,1178,1873,3,1,3,0,1,0,62.89
南投縣,竹山鎮,社寮里,0,1,648,2,650,916,3,1,3,0,1,0,70.96
南投縣,竹山鎮,中央里,0,1,946,10,956,1377,3,1,3,0,1,0,69.43
南投縣,竹山鎮,富州里,0,1,434,11,445,705,3,1,3,0,1,0,63.12
南投縣,竹山鎮,田子里,0,1,409,6,415,634,3,1,3,0,1,0,65.46
南投縣,竹山鎮,硘磘里,0,1,914,5,919,1366,3,1,3,0,1,0,67.28
南投縣,竹山鎮,德興里,0,1,634,10,644,923,3,1,3,0,1,0,69.77
南投縣,竹山鎮,福興里,0,1,376,6,382,565,3,1,3,0,1,0,67.61
南投縣,竹山鎮,鯉魚里,0,1,553,10,563,891,3,1,3,0,1,0,63.19
南投縣,竹山鎮,坪頂里,0,1,345,4,349,571,3,1,3,0,1,0,61.12
南投縣,竹山鎮,瑞竹里,0,1,487,7,494,769,3,1,3,0,1,0,64.24
南投縣,竹山鎮,桶頭里,0,1,650,9,659,1081,3,1,3,0,1,0,60.96
南投縣,集集鎮,集集里,0,1,628,8,636,890,3,1,3,0,1,0,71.46
南投縣,集集鎮,和平里,0,1,637,10,647,950,3,1,3,0,1,0,68.11
南投縣,集集鎮,林尾里,0,1,376,2,378,556,3,1,3,0,1,0,67.99
南投縣,集集鎮,田寮里,0,1,732,10,742,1121,3,1,3,0,1,0,66.19
南投縣,集集鎮,隘寮里,0,1,389,5,394,554,3,1,3,0,1,0,71.12
南投縣,集集鎮,玉映里,0,1,330,5,335,464,3,1,3,0,1,0,72.20
南投縣,集集鎮,吳厝里,0,1,627,8,635,896,3,1,3,0,1,0,70.87
南投縣,集集鎮,八張里,0,1,902,13,915,1357,3,1,3,0,1,0,67.43
南投縣,集集鎮,永昌里,0,1,646,10,656,915,3,1,3,0,1,0,71.69
南投縣,集集鎮,廣明里,0,1,681,2,683,1017,3,1,3,0,1,0,67.16
南投縣,集集鎮,富山里,0,1,252,3,255,409,3,1,3,0,1,0,62.35
南投縣,名間鄉,南雅村,0,1,706,3,709,1012,3,1,3,0,1,0,70.06
南投縣,名間鄉,中正村,0,1,1882,19,1901,2863,3,1,3,0,1,0,66.40
南投縣,名間鄉,中山村,0,1,1272,21,1293,1953,3,1,3,0,1,0,66.21
南投縣,名間鄉,濁水村,0,1,1029,14,1043,1550,3,1,3,0,1,0,67.29
南投縣,名間鄉,新民村,0,1,714,10,724,1031,3,1,3,0,1,0,70.22
南投縣,名間鄉,炭寮村,0,1,640,13,653,1002,3,1,3,0,1,0,65.17
南投縣,名間鄉,新街村,0,1,2368,23,2391,3432,3,1,3,0,1,0,69.67
南投縣,名間鄉,東湖村,0,1,1041,8,1049,1625,3,1,3,0,1,0,64.55
南投縣,名間鄉,仁和村,0,1,584,6,590,848,3,1,3,0,1,0,69.58
南投縣,名間鄉,萬丹村,0,1,731,8,739,989,3,1,3,0,1,0,74.72
南投縣,名間鄉,田仔.大庄.部下.大坑村,0,1,3032,32,3064,4560,3,1,3,0,1,0,67.19
南投縣,名間鄉,赤水村,0,1,840,14,854,1255,3,1,3,0,1,0,68.05
南投縣,名間鄉,竹圍村,0,1,622,8,630,918,3,1,3,0,1,0,68.63
南投縣,名間鄉,三崙村,0,1,933,12,945,1455,3,1,3,0,1,0,64.95
南投縣,名間鄉,松山村,0,1,889,11,900,1410,3,1,3,0,1,0,63.83
南投縣,名間鄉,松柏村,0,1,717,8,725,1093,3,1,3,0,1,0,66.33
南投縣,名間鄉,崁腳村,0,1,559,5,564,799,3,1,3,0,1,0,70.59
南投縣,名間鄉,埔中村,0,1,551,11,562,849,3,1,3,0,1,0,66.20
南投縣,名間鄉,新厝村,0,1,533,6,539,819,3,1,3,0,1,0,65.81
南投縣,名間鄉,新光村,0,1,1019,11,1030,1583,3,1,3,0,1,0,65.07
南投縣,鹿谷鄉,初鄉村,0,1,950,15,965,1553,3,1,3,0,1,0,62.14
南投縣,鹿谷鄉,鹿谷村,0,1,1094,10,1104,1648,3,1,3,0,1,0,66.99
南投縣,鹿谷鄉,彰雅村,0,1,770,10,780,1125,3,1,3,0,1,0,69.33
南投縣,鹿谷鄉,廣興村,0,1,1281,7,1288,1850,3,1,3,0,1,0,69.62
南投縣,鹿谷鄉,內湖村,0,1,672,9,681,1019,3,1,3,0,1,0,66.83
南投縣,鹿谷鄉,和雅村,0,1,405,6,411,623,3,1,3,0,1,0,65.97
南投縣,鹿谷鄉,竹林村,0,1,928,9,937,1522,3,1,3,0,1,0,61.56
南投縣,鹿谷鄉,竹豐村,0,1,557,1,558,882,3,1,3,0,1,0,63.27
南投縣,鹿谷鄉,鳳凰村,0,1,913,9,922,1325,3,1,3,0,1,0,69.58
南投縣,鹿谷鄉,永隆村,0,1,883,9,892,1276,3,1,3,0,1,0,69.91
南投縣,鹿谷鄉,秀峰村,0,1,609,8,617,1085,3,1,3,0,1,0,56.87
南投縣,鹿谷鄉,清水村,0,1,438,3,441,751,3,1,3,0,1,0,58.72
南投縣,鹿谷鄉,瑞田村,0,1,470,10,480,802,3,1,3,0,1,0,59.85
南投縣,中寮鄉,廣興村,0,1,543,7,550,856,3,1,3,0,1,0,64.25
南投縣,中寮鄉,崁頂村,0,1,352,5,357,513,3,1,3,0,1,0,69.59
南投縣,中寮鄉,八仙村,0,1,502,5,507,756,3,1,3,0,1,0,67.06
南投縣,中寮鄉,福盛村,0,1,488,4,492,812,3,1,3,0,1,0,60.59
南投縣,中寮鄉,和興村,0,1,400,3,403,691,3,1,3,0,1,0,58.32
南投縣,中寮鄉,復興村,0,1,717,6,723,1007,3,1,3,0,1,0,71.80
南投縣,中寮鄉,永平村,0,1,738,5,743,1069,3,1,3,0,1,0,69.50
南投縣,中寮鄉,中寮村,0,1,465,8,473,698,3,1,3,0,1,0,67.77
南投縣,中寮鄉,廣福村,0,1,332,6,338,542,3,1,3,0,1,0,62.36
南投縣,中寮鄉,永福村,0,1,734,7,741,1090,3,1,3,0,1,0,67.98
南投縣,中寮鄉,義和村,0,1,787,6,793,1113,3,1,3,0,1,0,71.25
南投縣,中寮鄉,清水村,0,1,599,12,611,993,3,1,3,0,1,0,61.53
南投縣,中寮鄉,內城村,0,1,309,3,312,463,3,1,3,0,1,0,67.39
南投縣,中寮鄉,龍安村,0,1,466,7,473,703,3,1,3,0,1,0,67.28
南投縣,中寮鄉,爽文村,0,1,377,6,383,590,3,1,3,0,1,0,64.92
南投縣,中寮鄉,龍岩村,0,1,416,7,423,676,3,1,3,0,1,0,62.57
南投縣,中寮鄉,永芳村,0,1,289,4,293,435,3,1,3,0,1,0,67.36
南投縣,中寮鄉,永和村,0,1,358,6,364,553,3,1,3,0,1,0,65.82
南投縣,魚池鄉,魚池村,0,1,1135,8,1143,1842,3,1,3,0,1,0,62.05
南投縣,魚池鄉,東池村,0,1,933,7,940,1525,3,1,3,0,1,0,61.64
南投縣,魚池鄉,大林村,0,1,643,1,644,1037,3,1,3,0,1,0,62.10
南投縣,魚池鄉,東光村,0,1,728,8,736,1183,3,1,3,0,1,0,62.21
南投縣,魚池鄉,共和村,0,1,608,13,621,955,3,1,3,0,1,0,65.03
南投縣,魚池鄉,新城村,0,1,884,10,894,1318,3,1,3,0,1,0,67.83
南投縣,魚池鄉,大雁村,0,1,422,1,423,656,3,1,3,0,1,0,64.48
南投縣,魚池鄉,五城村,0,1,473,5,478,707,3,1,3,0,1,0,67.61
南投縣,魚池鄉,中明村,0,1,622,6,628,977,3,1,3,0,1,0,64.28
南投縣,魚池鄉,水社村,0,1,489,7,496,771,3,1,3,0,1,0,64.33
南投縣,魚池鄉,日月村,0,1,326,3,329,539,3,1,3,0,1,0,61.04
南投縣,魚池鄉,頭社村,0,1,589,5,594,992,3,1,3,0,1,0,59.88
南投縣,魚池鄉,武登村,0,1,446,7,453,790,3,1,3,0,1,0,57.34
南投縣,國姓鄉,國姓村,0,1,1073,16,1089,1668,3,1,3,0,1,0,65.29
南投縣,國姓鄉,石門村,0,1,1027,10,1037,1641,3,1,3,0,1,0,63.19
南投縣,國姓鄉,大旗村,0,1,492,5,497,765,3,1,3,0,1,0,64.97
南投縣,國姓鄉,長流村,0,1,908,9,917,1540,3,1,3,0,1,0,59.55
南投縣,國姓鄉,長福村,0,1,427,8,435,717,3,1,3,0,1,0,60.67
南投縣,國姓鄉,長豐村,0,1,492,5,497,860,3,1,3,0,1,0,57.79
南投縣,國姓鄉,北港村,0,1,1219,9,1228,2052,3,1,3,0,1,0,59.84
南投縣,國姓鄉,福龜村,0,1,1274,16,1290,1840,3,1,3,0,1,0,70.11
南投縣,國姓鄉,乾溝村,0,1,582,3,585,881,3,1,3,0,1,0,66.40
南投縣,國姓鄉,柑林村,0,1,812,4,816,1205,3,1,3,0,1,0,67.72
南投縣,國姓鄉,大石村,0,1,465,3,468,757,3,1,3,0,1,0,61.82
南投縣,國姓鄉,北山村,0,1,1034,14,1048,1640,3,1,3,0,1,0,63.90
南投縣,國姓鄉,南港村,0,1,1151,19,1170,1916,3,1,3,0,1,0,61.06
南投縣,水里鄉,水里村,0,1,536,10,546,893,3,1,3,0,1,0,61.14
南投縣,水里鄉,新城村,0,1,1031,15,1046,1681,3,1,3,0,1,0,62.22
南投縣,水里鄉,中央村,0,1,478,6,484,718,3,1,3,0,1,0,67.41
南投縣,水里鄉,城中村,0,1,721,6,727,1069,3,1,3,0,1,0,68.01
南投縣,水里鄉,農富村,0,1,379,9,388,553,3,1,3,0,1,0,70.16
南投縣,水里鄉,北埔村,0,1,653,5,658,986,3,1,3,0,1,0,66.73
南投縣,水里鄉,南光村,0,1,844,4,848,1288,3,1,3,0,1,0,65.84
南投縣,水里鄉,鉅工村,0,1,755,7,762,1062,3,1,3,0,1,0,71.75
南投縣,水里鄉,永豐村,0,1,916,12,928,1382,3,1,3,0,1,0,67.15
南投縣,水里鄉,民和村,0,1,638,6,644,1044,3,1,3,0,1,0,61.69
南投縣,水里鄉,頂崁村,0,1,714,10,724,1111,3,1,3,0,1,0,65.17
南投縣,水里鄉,新山村,0,1,226,4,230,371,3,1,3,0,1,0,61.99
南投縣,水里鄉,郡坑村,0,1,249,2,251,392,3,1,3,0,1,0,64.03
南投縣,水里鄉,上安村,0,1,733,8,741,1183,3,1,3,0,1,0,62.64
南投縣,水里鄉,興隆村,0,1,206,0,206,357,3,1,3,0,1,0,57.70
南投縣,水里鄉,永興村,0,1,254,1,255,387,3,1,3,0,1,0,65.89
南投縣,水里鄉,玉峰村,0,1,665,6,671,914,3,1,3,0,1,0,73.41
南投縣,水里鄉,車埕村,0,1,356,5,361,558,3,1,3,0,1,0,64.70
南投縣,水里鄉,新興村,0,1,446,8,454,691,3,1,3,0,1,0,65.70
南投縣,信義鄉,明德村,0,1,749,5,754,1116,3,1,3,0,1,0,67.56
南投縣,信義鄉,愛國村,0,1,374,2,376,527,3,1,3,0,1,0,71.35
南投縣,信義鄉,自強村,0,1,510,7,517,731,3,1,3,0,1,0,70.73
南投縣,信義鄉,豐丘村,0,1,224,2,226,329,3,1,3,0,1,0,68.69
南投縣,信義鄉,新鄉村,0,1,47,0,47,74,3,1,3,0,1,0,63.51
南投縣,信義鄉,羅娜村,0,1,142,3,145,241,3,1,3,0,1,0,60.17
南投縣,信義鄉,望美村,0,1,189,0,189,296,3,1,3,0,1,0,63.85
南投縣,信義鄉,東埔村,0,1,173,3,176,260,3,1,3,0,1,0,67.69
南投縣,信義鄉,神木村,0,1,450,4,454,750,3,1,3,0,1,0,60.53
南投縣,信義鄉,同富村,0,1,897,5,902,1334,3,1,3,0,1,0,67.62
南投縣,信義鄉,人和村,0,1,126,0,126,230,3,1,3,0,1,0,54.78
南投縣,信義鄉,雙龍村,0,1,8,0,8,12,3,1,3,0,1,0,66.67
南投縣,信義鄉,地利村,0,1,61,0,61,94,3,1,3,0,1,0,64.89
南投縣,信義鄉,潭南村,0,1,28,0,28,48,3,1,3,0,1,0,58.33
南投縣,仁愛鄉,南豐村,0,1,324,5,329,533,3,1,3,0,1,0,61.73
南投縣,仁愛鄉,大同村,0,1,653,14,667,1037,3,1,3,0,1,0,64.32
南投縣,仁愛鄉,榮興村,0,1,53,2,55,85,3,1,3,0,1,0,64.71
南投縣,仁愛鄉,春陽村,0,1,34,1,35,63,3,1,3,0,1,0,55.56
南投縣,仁愛鄉,精英村,0,1,71,1,72,147,3,1,3,0,1,0,48.98
南投縣,仁愛鄉,合作村,0,1,13,1,14,24,3,1,3,0,1,0,58.33
南投縣,仁愛鄉,力行村,0,1,10,0,10,20,3,1,3,0,1,0,50.00
南投縣,仁愛鄉,翠華村,0,1,106,7,113,254,3,1,3,0,1,0,44.49
南投縣,仁愛鄉,發祥村,0,1,32,1,33,64,3,1,3,0,1,0,51.56
南投縣,仁愛鄉,親愛村,0,1,46,0,46,90,3,1,3,0,1,0,51.11
南投縣,仁愛鄉,萬豐村,0,1,25,0,25,50,3,1,3,0,1,0,50.00
南投縣,仁愛鄉,法治村,0,1,9,1,10,26,3,1,3,0,1,0,38.46
南投縣,仁愛鄉,中正村,0,1,44,0,44,83,3,1,3,0,1,0,53.01
南投縣,仁愛鄉,互助村,0,1,68,1,69,125,3,1,3,0,1,0,55.20
南投縣,仁愛鄉,新生村,0,1,38,0,38,56,3,1,3,0,1,0,67.86
雲林縣,斗六市,信義里,0,1,654,6,660,952,3,1,3,0,1,0,69.33
雲林縣,斗六市,四維里,0,1,505,9,514,727,3,1,3,0,1,0,70.70
雲林縣,斗六市,太平里,0,1,527,5,532,762,3,1,3,0,1,0,69.82
雲林縣,斗六市,中和里,0,1,432,6,438,600,3,1,3,0,1,0,73.00
雲林縣,斗六市,光興里,0,1,571,3,574,909,3,1,3,0,1,0,63.15
雲林縣,斗六市,鎮西里,0,1,1626,19,1645,2565,3,1,3,0,1,0,64.13
雲林縣,斗六市,鎮東里,0,1,2258,30,2288,3455,3,1,3,0,1,0,66.22
雲林縣,斗六市,三平里,0,1,2134,35,2169,3266,3,1,3,0,1,0,66.41
雲林縣,斗六市,鎮北里,0,1,3790,48,3838,5932,3,1,3,0,1,0,64.70
雲林縣,斗六市,忠孝里,0,1,992,12,1004,1480,3,1,3,0,1,0,67.84
雲林縣,斗六市,仁愛里,0,1,736,14,750,1142,3,1,3,0,1,0,65.67
雲林縣,斗六市,八德里,0,1,1635,23,1658,2468,3,1,3,0,1,0,67.18
雲林縣,斗六市,公正里,0,1,1552,22,1574,2355,3,1,3,0,1,0,66.84
雲林縣,斗六市,重光里,0,1,1301,24,1325,1998,3,1,3,0,1,0,66.32
雲林縣,斗六市,林頭里,0,1,3505,57,3562,5322,3,1,3,0,1,0,66.93
雲林縣,斗六市,鎮南里,0,1,2034,23,2057,3189,3,1,3,0,1,0,64.50
雲林縣,斗六市,社口里,0,1,1394,22,1416,2126,3,1,3,0,1,0,66.60
雲林縣,斗六市,龍潭里,0,1,654,10,664,989,3,1,3,0,1,0,67.14
雲林縣,斗六市,嘉東里,0,1,510,11,521,715,3,1,3,0,1,0,72.87
雲林縣,斗六市,崙峰里,0,1,1104,16,1120,1659,3,1,3,0,1,0,67.51
雲林縣,斗六市,溝埧里,0,1,376,7,383,564,3,1,3,0,1,0,67.91
雲林縣,斗六市,江厝里,0,1,809,14,823,1232,3,1,3,0,1,0,66.80
雲林縣,斗六市,三光里,0,1,384,1,385,569,3,1,3,0,1,0,67.66
雲林縣,斗六市,久安里,0,1,1254,21,1275,1784,3,1,3,0,1,0,71.47
雲林縣,斗六市,虎溪里,0,1,2629,32,2661,4201,3,1,3,0,1,0,63.34
雲林縣,斗六市,保庄里,0,1,1961,16,1977,2923,3,1,3,0,1,0,67.64
雲林縣,斗六市,長平里,0,1,1078,13,1091,1509,3,1,3,0,1,0,72.30
雲林縣,斗六市,榴中里,0,1,2442,26,2468,3624,3,1,3,0,1,0,68.10
雲林縣,斗六市,榴北里,0,1,649,8,657,918,3,1,3,0,1,0,71.57
雲林縣,斗六市,榴南里,0,1,623,17,640,917,3,1,3,0,1,0,69.79
雲林縣,斗六市,梅林里,0,1,1159,20,1179,1740,3,1,3,0,1,0,67.76
雲林縣,斗六市,湖山里,0,1,910,24,934,1304,3,1,3,0,1,0,71.63
雲林縣,斗六市,長安里,0,1,1634,32,1666,2435,3,1,3,0,1,0,68.42
雲林縣,斗六市,溪洲里,0,1,1602,23,1625,2361,3,1,3,0,1,0,68.83
雲林縣,斗六市,十三里,0,1,773,13,786,1118,3,1,3,0,1,0,70.30
雲林縣,斗南鎮,東仁里,0,1,761,19,780,1140,3,1,3,0,1,0,68.42
雲林縣,斗南鎮,西岐里,0,1,2654,42,2696,4196,3,1,3,0,1,0,64.25
雲林縣,斗南鎮,南昌里,0,1,1252,11,1263,2008,3,1,3,0,1,0,62.90
雲林縣,斗南鎮,北銘里,0,1,857,5,862,1269,3,1,3,0,1,0,67.93
雲林縣,斗南鎮,中天里,0,1,854,9,863,1255,3,1,3,0,1,0,68.76
雲林縣,斗南鎮,林子里,0,1,790,10,800,1194,3,1,3,0,1,0,67.00
雲林縣,斗南鎮,石龜里,0,1,583,13,596,863,3,1,3,0,1,0,69.06
雲林縣,斗南鎮,石溪里,0,1,597,10,607,905,3,1,3,0,1,0,67.07
雲林縣,斗南鎮,靖興里,0,1,611,10,621,876,3,1,3,0,1,0,70.89
雲林縣,斗南鎮,新南里,0,1,480,6,486,738,3,1,3,0,1,0,65.85
雲林縣,斗南鎮,阿丹里,0,1,850,14,864,1160,3,1,3,0,1,0,74.48
雲林縣,斗南鎮,將軍里,0,1,929,9,938,1413,3,1,3,0,1,0,66.38
雲林縣,斗南鎮,舊社里,0,1,1129,17,1146,1781,3,1,3,0,1,0,64.35
雲林縣,斗南鎮,明昌里,0,1,2771,36,2807,4243,3,1,3,0,1,0,66.16
雲林縣,斗南鎮,大東里,0,1,699,13,712,982,3,1,3,0,1,0,72.51
雲林縣,斗南鎮,埤麻里,0,1,592,6,598,851,3,1,3,0,1,0,70.27
雲林縣,斗南鎮,西伯里,0,1,638,7,645,932,3,1,3,0,1,0,69.21
雲林縣,斗南鎮,新崙里,0,1,1098,8,1106,1604,3,1,3,0,1,0,68.95
雲林縣,斗南鎮,東明里,0,1,688,10,698,995,3,1,3,0,1,0,70.15
雲林縣,斗南鎮,新光里,0,1,1611,17,1628,2384,3,1,3,0,1,0,68.29
雲林縣,斗南鎮,田頭里,0,1,1437,12,1449,2028,3,1,3,0,1,0,71.45
雲林縣,斗南鎮,小東里,0,1,1018,14,1032,1552,3,1,3,0,1,0,66.49
雲林縣,虎尾鎮,東仁里,0,1,1451,10,1461,2228,3,1,3,0,1,0,65.57
雲林縣,虎尾鎮,新興里,0,1,1087,14,1101,1709,3,1,3,0,1,0,64.42
雲林縣,虎尾鎮,公安里,0,1,1644,14,1658,2616,3,1,3,0,1,0,63.38
雲林縣,虎尾鎮,德興里,0,1,1366,18,1384,2332,3,1,3,0,1,0,59.35
雲林縣,虎尾鎮,中山里,0,1,706,8,714,1130,3,1,3,0,1,0,63.19
雲林縣,虎尾鎮,西安里,0,1,1721,21,1742,2883,3,1,3,0,1,0,60.42
雲林縣,虎尾鎮,立仁里,0,1,2011,25,2036,3319,3,1,3,0,1,0,61.34
雲林縣,虎尾鎮,安慶里,0,1,888,14,902,1328,3,1,3,0,1,0,67.92
雲林縣,虎尾鎮,平和里,0,1,721,15,736,1120,3,1,3,0,1,0,65.71
雲林縣,虎尾鎮,興南里,0,1,1040,20,1060,1672,3,1,3,0,1,0,63.40
雲林縣,虎尾鎮,新吉里,0,1,1291,25,1316,2137,3,1,3,0,1,0,61.58
雲林縣,虎尾鎮,穎川里,0,1,1022,7,1029,1618,3,1,3,0,1,0,63.60
雲林縣,虎尾鎮,延平里,0,1,563,10,573,881,3,1,3,0,1,0,65.04
雲林縣,虎尾鎮,建國里,0,1,470,1,471,717,3,1,3,0,1,0,65.69
雲林縣,虎尾鎮,埒內里,0,1,1477,27,1504,2285,3,1,3,0,1,0,65.82
雲林縣,虎尾鎮,堀頭里,0,1,549,7,556,790,3,1,3,0,1,0,70.38
雲林縣,虎尾鎮,安溪里,0,1,1008,24,1032,1670,3,1,3,0,1,0,61.80
雲林縣,虎尾鎮,興中里,0,1,1006,26,1032,1515,3,1,3,0,1,0,68.12
雲林縣,虎尾鎮,廉使里,0,1,1784,24,1808,2843,3,1,3,0,1,0,63.59
雲林縣,虎尾鎮,惠來里,0,1,1376,30,1406,2251,3,1,3,0,1,0,62.46
雲林縣,虎尾鎮,頂溪里,0,1,1551,22,1573,2356,3,1,3,0,1,0,66.77
雲林縣,虎尾鎮,中溪里,0,1,799,12,811,1283,3,1,3,0,1,0,63.21
雲林縣,虎尾鎮,下溪里,0,1,817,16,833,1294,3,1,3,0,1,0,64.37
雲林縣,虎尾鎮,東屯里,0,1,754,11,765,1143,3,1,3,0,1,0,66.93
雲林縣,虎尾鎮,西屯里,0,1,994,23,1017,1475,3,1,3,0,1,0,68.95
雲林縣,虎尾鎮,芳草里,0,1,535,9,544,864,3,1,3,0,1,0,62.96
雲林縣,虎尾鎮,墾地里,0,1,551,10,561,948,3,1,3,0,1,0,59.18
雲林縣,虎尾鎮,北溪里,0,1,504,7,511,766,3,1,3,0,1,0,66.71
雲林縣,虎尾鎮,三合里,0,1,660,9,669,1011,3,1,3,0,1,0,66.17
雲林縣,西螺鎮,振興里,0,1,959,10,969,1567,3,1,3,0,1,0,61.84
雲林縣,西螺鎮,大園里,0,1,907,13,920,1440,3,1,3,0,1,0,63.89
雲林縣,西螺鎮,廣福里,0,1,952,8,960,1608,3,1,3,0,1,0,59.70
雲林縣,西螺鎮,正興里,0,1,1765,17,1782,2859,3,1,3,0,1,0,62.33
雲林縣,西螺鎮,永安里,0,1,280,7,287,450,3,1,3,0,1,0,63.78
雲林縣,西螺鎮,中和里,0,1,491,1,492,734,3,1,3,0,1,0,67.03
雲林縣,西螺鎮,福興里,0,1,399,7,406,671,3,1,3,0,1,0,60.51
雲林縣,西螺鎮,光華里,0,1,618,8,626,986,3,1,3,0,1,0,63.49
雲林縣,西螺鎮,中興里,0,1,1338,14,1352,2153,3,1,3,0,1,0,62.80
雲林縣,西螺鎮,漢光里,0,1,1994,23,2017,3300,3,1,3,0,1,0,61.12
雲林縣,西螺鎮,新安里,0,1,753,12,765,1274,3,1,3,0,1,0,60.05
雲林縣,西螺鎮,新豐里,0,1,901,15,916,1422,3,1,3,0,1,0,64.42
雲林縣,西螺鎮,大新里,0,1,1095,8,1103,1729,3,1,3,0,1,0,63.79
雲林縣,西螺鎮,埤頭里,0,1,533,11,544,904,3,1,3,0,1,0,60.18
雲林縣,西螺鎮,東興里,0,1,685,6,691,1119,3,1,3,0,1,0,61.75
雲林縣,西螺鎮,鹿場里,0,1,885,11,896,1481,3,1,3,0,1,0,60.50
雲林縣,西螺鎮,廣興里,0,1,533,8,541,871,3,1,3,0,1,0,62.11
雲林縣,西螺鎮,頂湳里,0,1,645,9,654,974,3,1,3,0,1,0,67.15
雲林縣,西螺鎮,吳厝里,0,1,842,13,855,1374,3,1,3,0,1,0,62.23
雲林縣,西螺鎮,九隆里,0,1,458,8,466,742,3,1,3,0,1,0,62.80
雲林縣,西螺鎮,下湳里,0,1,539,5,544,796,3,1,3,0,1,0,68.34
雲林縣,西螺鎮,七座里,0,1,612,6,618,1005,3,1,3,0,1,0,61.49
雲林縣,西螺鎮,公舘里,0,1,791,14,805,1389,3,1,3,0,1,0,57.96
雲林縣,西螺鎮,詔安里,0,1,557,10,567,955,3,1,3,0,1,0,59.37
雲林縣,西螺鎮,河南里,0,1,516,10,526,927,3,1,3,0,1,0,56.74
雲林縣,西螺鎮,安定里,0,1,1033,9,1042,1795,3,1,3,0,1,0,58.05
雲林縣,西螺鎮,福田里,0,1,891,10,901,1392,3,1,3,0,1,0,64.73
雲林縣,土庫鎮,忠正里,0,1,657,5,662,967,3,1,3,0,1,0,68.46
雲林縣,土庫鎮,順天里,0,1,685,8,693,1003,3,1,3,0,1,0,69.09
雲林縣,土庫鎮,宮北里,0,1,870,5,875,1320,3,1,3,0,1,0,66.29
雲林縣,土庫鎮,越港里,0,1,620,14,634,874,3,1,3,0,1,0,72.54
雲林縣,土庫鎮,溪邊里,0,1,799,10,809,1147,3,1,3,0,1,0,70.53
雲林縣,土庫鎮,石廟里,0,1,941,11,952,1524,3,1,3,0,1,0,62.47
雲林縣,土庫鎮,興新里,0,1,794,17,811,1306,3,1,3,0,1,0,62.10
雲林縣,土庫鎮,奮起里,0,1,857,15,872,1462,3,1,3,0,1,0,59.64
雲林縣,土庫鎮,埤腳里,0,1,955,16,971,1465,3,1,3,0,1,0,66.28
雲林縣,土庫鎮,後埔里,0,1,1469,23,1492,2309,3,1,3,0,1,0,64.62
雲林縣,土庫鎮,崙內里,0,1,1025,16,1041,1502,3,1,3,0,1,0,69.31
雲林縣,土庫鎮,大荖里,0,1,554,9,563,850,3,1,3,0,1,0,66.24
雲林縣,土庫鎮,東平里,0,1,1194,21,1215,1854,3,1,3,0,1,0,65.53
雲林縣,土庫鎮,南平里,0,1,1200,20,1220,1773,3,1,3,0,1,0,68.81
雲林縣,土庫鎮,西平里,0,1,1188,24,1212,1793,3,1,3,0,1,0,67.60
雲林縣,土庫鎮,北平里,0,1,674,12,686,974,3,1,3,0,1,0,70.43
雲林縣,土庫鎮,新庄里,0,1,924,26,950,1442,3,1,3,0,1,0,65.88
雲林縣,北港鎮,東陽里,0,1,603,14,617,818,3,1,3,0,1,0,75.43
雲林縣,北港鎮,光民里,0,1,584,10,594,797,3,1,3,0,1,0,74.53
雲林縣,北港鎮,東華里,0,1,376,3,379,511,3,1,3,0,1,0,74.17
雲林縣,北港鎮,南安里,0,1,733,8,741,1049,3,1,3,0,1,0,70.64
雲林縣,北港鎮,中和里,0,1,281,5,286,412,3,1,3,0,1,0,69.42
雲林縣,北港鎮,義民里,0,1,298,4,302,447,3,1,3,0,1,0,67.56
雲林縣,北港鎮,共榮里,0,1,317,6,323,467,3,1,3,0,1,0,69.16
雲林縣,北港鎮,西勢里,0,1,612,7,619,922,3,1,3,0,1,0,67.14
雲林縣,北港鎮,仁和里,0,1,408,7,415,551,3,1,3,0,1,0,75.32
雲林縣,北港鎮,賜福里,0,1,275,6,281,398,3,1,3,0,1,0,70.60
雲林縣,北港鎮,公舘里,0,1,431,9,440,651,3,1,3,0,1,0,67.59
雲林縣,北港鎮,大同里,0,1,876,13,889,1343,3,1,3,0,1,0,66.20
雲林縣,北港鎮,仁安里,0,1,321,8,329,485,3,1,3,0,1,0,67.84
雲林縣,北港鎮,華勝里,0,1,3218,46,3264,4926,3,1,3,0,1,0,66.26
雲林縣,北港鎮,光復里,0,1,820,11,831,1271,3,1,3,0,1,0,65.38
雲林縣,北港鎮,新街里,0,1,3086,42,3128,4798,3,1,3,0,1,0,65.19
雲林縣,北港鎮,劉厝里,0,1,722,11,733,1148,3,1,3,0,1,0,63.85
雲林縣,北港鎮,後溝里,0,1,608,11,619,1014,3,1,3,0,1,0,61.05
雲林縣,北港鎮,新厝里,0,1,259,3,262,411,3,1,3,0,1,0,63.75
雲林縣,北港鎮,府番里,0,1,505,5,510,849,3,1,3,0,1,0,60.07
雲林縣,北港鎮,草湖里,0,1,881,16,897,1407,3,1,3,0,1,0,63.75
雲林縣,北港鎮,溝皂里,0,1,709,11,720,1255,3,1,3,0,1,0,57.37
雲林縣,北港鎮,番溝里,0,1,522,16,538,1049,3,1,3,0,1,0,51.29
雲林縣,北港鎮,大北里,0,1,342,12,354,639,3,1,3,0,1,0,55.40
雲林縣,北港鎮,好收里,0,1,1107,22,1129,1615,3,1,3,0,1,0,69.91
雲林縣,北港鎮,樹腳里,0,1,1662,15,1677,2734,3,1,3,0,1,0,61.34
雲林縣,北港鎮,扶朝里,0,1,675,7,682,1067,3,1,3,0,1,0,63.92
雲林縣,北港鎮,水埔里,0,1,369,5,374,592,3,1,3,0,1,0,63.18
雲林縣,古坑鄉,棋盤村,0,1,1432,23,1455,2075,3,1,3,0,1,0,70.12
雲林縣,古坑鄉,新庄村,0,1,1013,15,1028,1509,3,1,3,0,1,0,68.12
雲林縣,古坑鄉,東和村,0,1,1705,30,1735,2796,3,1,3,0,1,0,62.05
雲林縣,古坑鄉,荷苞村,0,1,958,17,975,1461,3,1,3,0,1,0,66.74
雲林縣,古坑鄉,高林村,0,1,813,7,820,1142,3,1,3,0,1,0,71.80
雲林縣,古坑鄉,水碓村,0,1,784,13,797,1200,3,1,3,0,1,0,66.42
雲林縣,古坑鄉,田心村,0,1,657,2,659,946,3,1,3,0,1,0,69.66
雲林縣,古坑鄉,古坑村,0,1,1318,17,1335,2011,3,1,3,0,1,0,66.38
雲林縣,古坑鄉,朝陽村,0,1,1304,15,1319,1950,3,1,3,0,1,0,67.64
雲林縣,古坑鄉,西平村,0,1,951,11,962,1383,3,1,3,0,1,0,69.56
雲林縣,古坑鄉,湳仔村,0,1,501,6,507,686,3,1,3,0,1,0,73.91
雲林縣,古坑鄉,永光村,0,1,1171,10,1181,1874,3,1,3,0,1,0,63.02
雲林縣,古坑鄉,永昌村,0,1,1283,17,1300,2009,3,1,3,0,1,0,64.71
雲林縣,古坑鄉,麻園村,0,1,473,6,479,650,3,1,3,0,1,0,73.69
雲林縣,古坑鄉,崁腳村,0,1,886,17,903,1302,3,1,3,0,1,0,69.35
雲林縣,古坑鄉,華南村,0,1,213,3,216,335,3,1,3,0,1,0,64.48
雲林縣,古坑鄉,華山村,0,1,465,7,472,785,3,1,3,0,1,0,60.13
雲林縣,古坑鄉,桂林村,0,1,738,6,744,1153,3,1,3,0,1,0,64.53
雲林縣,古坑鄉,樟湖村,0,1,320,9,329,519,3,1,3,0,1,0,63.39
雲林縣,古坑鄉,草嶺村,0,1,428,6,434,659,3,1,3,0,1,0,65.86
雲林縣,大埤鄉,北和村,0,1,530,7,537,785,3,1,3,0,1,0,68.41
雲林縣,大埤鄉,南和村,0,1,1374,15,1389,2044,3,1,3,0,1,0,67.95
雲林縣,大埤鄉,大德村,0,1,709,8,717,1125,3,1,3,0,1,0,63.73
雲林縣,大埤鄉,松竹村,0,1,669,8,677,1037,3,1,3,0,1,0,65.28
雲林縣,大埤鄉,尚義村,0,1,1174,3,1177,1796,3,1,3,0,1,0,65.53
雲林縣,大埤鄉,嘉興村,0,1,1217,21,1238,1788,3,1,3,0,1,0,69.24
雲林縣,大埤鄉,豐田村,0,1,824,12,836,1291,3,1,3,0,1,0,64.76
雲林縣,大埤鄉,三結村,0,1,835,9,844,1247,3,1,3,0,1,0,67.68
雲林縣,大埤鄉,吉田村,0,1,500,14,514,807,3,1,3,0,1,0,63.69
雲林縣,大埤鄉,豐岡村,0,1,494,10,504,700,3,1,3,0,1,0,72.00
雲林縣,大埤鄉,聯美村,0,1,750,10,760,1227,3,1,3,0,1,0,61.94
雲林縣,大埤鄉,怡然村,0,1,543,11,554,836,3,1,3,0,1,0,66.27
雲林縣,大埤鄉,北鎮村,0,1,436,7,443,723,3,1,3,0,1,0,61.27
雲林縣,大埤鄉,興安村,0,1,537,6,543,838,3,1,3,0,1,0,64.80
雲林縣,大埤鄉,西鎮村,0,1,559,4,563,811,3,1,3,0,1,0,69.42
雲林縣,莿桐鄉,莿桐村,0,1,2282,39,2321,3420,3,1,3,0,1,0,67.87
雲林縣,莿桐鄉,甘厝村,0,1,623,9,632,914,3,1,3,0,1,0,69.15
雲林縣,莿桐鄉,甘西村,0,1,990,7,997,1601,3,1,3,0,1,0,62.27
雲林縣,莿桐鄉,興桐村,0,1,864,10,874,1273,3,1,3,0,1,0,68.66
雲林縣,莿桐鄉,義和村,0,1,767,4,771,1145,3,1,3,0,1,0,67.34
雲林縣,莿桐鄉,埔子村,0,1,1164,7,1171,1741,3,1,3,0,1,0,67.26
雲林縣,莿桐鄉,大美村,0,1,1540,31,1571,2381,3,1,3,0,1,0,65.98
雲林縣,莿桐鄉,埔尾村,0,1,844,12,856,1223,3,1,3,0,1,0,69.99
雲林縣,莿桐鄉,興貴村,0,1,1262,22,1284,1860,3,1,3,0,1,0,69.03
雲林縣,莿桐鄉,饒平村,0,1,826,10,836,1149,3,1,3,0,1,0,72.76
雲林縣,莿桐鄉,四合村,0,1,1129,18,1147,1755,3,1,3,0,1,0,65.36
雲林縣,莿桐鄉,麻園村,0,1,1027,9,1036,1570,3,1,3,0,1,0,65.99
雲林縣,莿桐鄉,五華村,0,1,866,14,880,1331,3,1,3,0,1,0,66.12
雲林縣,莿桐鄉,六合村,0,1,1128,13,1141,1752,3,1,3,0,1,0,65.13
雲林縣,林內鄉,林南村,0,1,723,15,738,1036,3,1,3,0,1,0,71.24
雲林縣,林內鄉,林中村,0,1,2156,44,2200,3299,3,1,3,0,1,0,66.69
雲林縣,林內鄉,林北村,0,1,1404,23,1427,2111,3,1,3,0,1,0,67.60
雲林縣,林內鄉,坪頂村,0,1,464,3,467,626,3,1,3,0,1,0,74.60
雲林縣,林內鄉,林茂村,0,1,632,11,643,934,3,1,3,0,1,0,68.84
雲林縣,林內鄉,九芎村,0,1,1699,18,1717,2502,3,1,3,0,1,0,68.63
雲林縣,林內鄉,湖本村,0,1,451,8,459,640,3,1,3,0,1,0,71.72
雲林縣,林內鄉,烏塗村,0,1,776,13,789,1129,3,1,3,0,1,0,69.88
雲林縣,林內鄉,烏麻村,0,1,724,6,730,1054,3,1,3,0,1,0,69.26
雲林縣,林內鄉,重興村,0,1,1187,24,1211,1739,3,1,3,0,1,0,69.64
雲林縣,二崙鄉,崙東村,0,1,902,11,913,1405,3,1,3,0,1,0,64.98
雲林縣,二崙鄉,崙西村,0,1,1019,12,1031,1633,3,1,3,0,1,0,63.14
雲林縣,二崙鄉,來惠村,0,1,1134,8,1142,1811,3,1,3,0,1,0,63.06
雲林縣,二崙鄉,三和村,0,1,1027,11,1038,1653,3,1,3,0,1,0,62.79
雲林縣,二崙鄉,湳仔村,0,1,813,14,827,1226,3,1,3,0,1,0,67.46
雲林縣,二崙鄉,田尾村,0,1,1268,11,1279,1993,3,1,3,0,1,0,64.17
雲林縣,二崙鄉,定安村,0,1,577,9,586,964,3,1,3,0,1,0,60.79
雲林縣,二崙鄉,永定村,0,1,786,8,794,1336,3,1,3,0,1,0,59.43
雲林縣,二崙鄉,大華村,0,1,544,9,553,958,3,1,3,0,1,0,57.72
雲林縣,二崙鄉,義庄村,0,1,455,6,461,785,3,1,3,0,1,0,58.73
雲林縣,二崙鄉,楊賢村,0,1,951,9,960,1534,3,1,3,0,1,0,62.58
雲林縣,二崙鄉,港後村,0,1,1101,17,1118,1914,3,1,3,0,1,0,58.41
雲林縣,二崙鄉,大義村,0,1,558,9,567,903,3,1,3,0,1,0,62.79
雲林縣,二崙鄉,油車村,0,1,1101,13,1114,1803,3,1,3,0,1,0,61.79
雲林縣,二崙鄉,大庄村,0,1,804,13,817,1417,3,1,3,0,1,0,57.66
雲林縣,二崙鄉,庄西村,0,1,585,7,592,1012,3,1,3,0,1,0,58.50
雲林縣,二崙鄉,大同村,0,1,544,1,545,851,3,1,3,0,1,0,64.04
雲林縣,二崙鄉,復興村,0,1,668,7,675,1059,3,1,3,0,1,0,63.74
雲林縣,崙背鄉,東明村,0,1,805,6,811,1284,3,1,3,0,1,0,63.16
雲林縣,崙背鄉,西榮村,0,1,866,12,878,1414,3,1,3,0,1,0,62.09
雲林縣,崙背鄉,南陽村,0,1,1414,24,1438,2228,3,1,3,0,1,0,64.54
雲林縣,崙背鄉,崙前村,0,1,1223,20,1243,2023,3,1,3,0,1,0,61.44
雲林縣,崙背鄉,羅厝村,0,1,1272,23,1295,2007,3,1,3,0,1,0,64.52
雲林縣,崙背鄉,港尾村,0,1,847,19,866,1358,3,1,3,0,1,0,63.77
雲林縣,崙背鄉,阿勸村,0,1,1296,17,1313,1988,3,1,3,0,1,0,66.05
雲林縣,崙背鄉,五魁村,0,1,564,5,569,883,3,1,3,0,1,0,64.44
雲林縣,崙背鄉,大有村,0,1,1064,12,1076,1791,3,1,3,0,1,0,60.08
雲林縣,崙背鄉,豐榮村,0,1,1132,7,1139,2049,3,1,3,0,1,0,55.59
雲林縣,崙背鄉,草湖村,0,1,803,17,820,1472,3,1,3,0,1,0,55.71
雲林縣,崙背鄉,舊庄村,0,1,710,17,727,1196,3,1,3,0,1,0,60.79
雲林縣,崙背鄉,水尾村,0,1,802,7,809,1279,3,1,3,0,1,0,63.25
雲林縣,崙背鄉,枋南村,0,1,521,7,528,869,3,1,3,0,1,0,60.76
雲林縣,麥寮鄉,麥豐村,0,1,2002,20,2022,3148,3,1,3,0,1,0,64.23
雲林縣,麥寮鄉,麥津村,0,1,1601,23,1624,2576,3,1,3,0,1,0,63.04
雲林縣,麥寮鄉,瓦窯村,0,1,853,9,862,1372,3,1,3,0,1,0,62.83
雲林縣,麥寮鄉,興華村,0,1,1115,20,1135,1846,3,1,3,0,1,0,61.48
雲林縣,麥寮鄉,海豐村,0,1,880,17,897,1446,3,1,3,0,1,0,62.03
雲林縣,麥寮鄉,後安村,0,1,1181,18,1199,2098,3,1,3,0,1,0,57.15
雲林縣,麥寮鄉,三盛村,0,1,1324,19,1343,2154,3,1,3,0,1,0,62.35
雲林縣,麥寮鄉,崙後村,0,1,991,15,1006,1846,3,1,3,0,1,0,54.50
雲林縣,麥寮鄉,橋頭村,0,1,1538,25,1563,2535,3,1,3,0,1,0,61.66
雲林縣,麥寮鄉,新吉村,0,1,446,9,455,793,3,1,3,0,1,0,57.38
雲林縣,麥寮鄉,施厝村,0,1,1163,18,1181,2167,3,1,3,0,1,0,54.50
雲林縣,麥寮鄉,雷厝村,0,1,772,17,789,1502,3,1,3,0,1,0,52.53
雲林縣,東勢鄉,月眉村,0,1,676,8,684,1291,3,1,3,0,1,0,52.98
雲林縣,東勢鄉,復興村,0,1,272,1,273,492,3,1,3,0,1,0,55.49
雲林縣,東勢鄉,嘉隆村,0,1,1022,16,1038,1792,3,1,3,0,1,0,57.92
雲林縣,東勢鄉,東南村,0,1,910,15,925,1442,3,1,3,0,1,0,64.15
雲林縣,東勢鄉,東北村,0,1,715,7,722,1210,3,1,3,0,1,0,59.67
雲林縣,東勢鄉,昌南村,0,1,591,9,600,976,3,1,3,0,1,0,61.48
雲林縣,東勢鄉,同安村,0,1,1314,36,1350,2190,3,1,3,0,1,0,61.64
雲林縣,東勢鄉,四美村,0,1,718,9,727,1318,3,1,3,0,1,0,55.16
雲林縣,東勢鄉,新坤村,0,1,777,16,793,1284,3,1,3,0,1,0,61.76
雲林縣,東勢鄉,安南村,0,1,495,14,509,949,3,1,3,0,1,0,53.64
雲林縣,東勢鄉,龍潭村,0,1,508,14,522,1036,3,1,3,0,1,0,50.39
雲林縣,東勢鄉,程海村,0,1,357,3,360,582,3,1,3,0,1,0,61.86
雲林縣,褒忠鄉,中民村,0,1,1238,19,1257,1842,3,1,3,0,1,0,68.24
雲林縣,褒忠鄉,埔姜村,0,1,900,16,916,1378,3,1,3,0,1,0,66.47
雲林縣,褒忠鄉,中勝村,0,1,867,12,879,1385,3,1,3,0,1,0,63.47
雲林縣,褒忠鄉,馬鳴村,0,1,899,11,910,1376,3,1,3,0,1,0,66.13
雲林縣,褒忠鄉,新湖村,0,1,851,13,864,1320,3,1,3,0,1,0,65.45
雲林縣,褒忠鄉,有才村,0,1,587,7,594,970,3,1,3,0,1,0,61.24
雲林縣,褒忠鄉,田洋村,0,1,542,8,550,830,3,1,3,0,1,0,66.27
雲林縣,褒忠鄉,龍岩村,0,1,847,14,861,1259,3,1,3,0,1,0,68.39
雲林縣,褒忠鄉,潮厝村,0,1,578,7,585,973,3,1,3,0,1,0,60.12
雲林縣,台西鄉,台西村,0,1,818,8,826,1312,3,1,3,0,1,0,62.96
雲林縣,台西鄉,海南村,0,1,623,7,630,1032,3,1,3,0,1,0,61.05
雲林縣,台西鄉,海北村,0,1,589,9,598,1062,3,1,3,0,1,0,56.31
雲林縣,台西鄉,海口村,0,1,1115,16,1131,1958,3,1,3,0,1,0,57.76
雲林縣,台西鄉,山寮村,0,1,482,8,490,931,3,1,3,0,1,0,52.63
雲林縣,台西鄉,溪頂村,0,1,781,19,800,1552,3,1,3,0,1,0,51.55
雲林縣,台西鄉,牛厝村,0,1,1045,17,1062,1979,3,1,3,0,1,0,53.66
雲林縣,台西鄉,泉州村,0,1,296,15,311,635,3,1,3,0,1,0,48.98
雲林縣,台西鄉,五榔村,0,1,259,3,262,539,3,1,3,0,1,0,48.61
雲林縣,台西鄉,光華村,0,1,382,11,393,671,3,1,3,0,1,0,58.57
雲林縣,台西鄉,五港村,0,1,1115,12,1127,1917,3,1,3,0,1,0,58.79
雲林縣,台西鄉,富琦村,0,1,909,20,929,1551,3,1,3,0,1,0,59.90
雲林縣,台西鄉,永豐村,0,1,873,9,882,1418,3,1,3,0,1,0,62.20
雲林縣,台西鄉,和豐村,0,1,1824,21,1845,3248,3,1,3,0,1,0,56.80
雲林縣,台西鄉,蚊港村,0,1,1460,26,1486,2025,3,1,3,0,1,0,73.38
雲林縣,元長鄉,長南村,0,1,1831,30,1861,3095,3,1,3,0,1,0,60.13
雲林縣,元長鄉,長北村,0,1,895,14,909,1619,3,1,3,0,1,0,56.15
雲林縣,元長鄉,子茂村,0,1,831,10,841,1506,3,1,3,0,1,0,55.84
雲林縣,元長鄉,後湖村,0,1,484,4,488,780,3,1,3,0,1,0,62.56
雲林縣,元長鄉,山內村,0,1,601,9,610,1049,3,1,3,0,1,0,58.15
雲林縣,元長鄉,合和村,0,1,629,11,640,1211,3,1,3,0,1,0,52.85
雲林縣,元長鄉,五塊村,0,1,603,7,610,1034,3,1,3,0,1,0,58.99
雲林縣,元長鄉,潭西村,0,1,460,8,468,938,3,1,3,0,1,0,49.89
雲林縣,元長鄉,潭東村,0,1,405,1,406,706,3,1,3,0,1,0,57.51
雲林縣,元長鄉,客厝村,0,1,516,7,523,876,3,1,3,0,1,0,59.70
雲林縣,元長鄉,卓運村,0,1,262,2,264,470,3,1,3,0,1,0,56.17
雲林縣,元長鄉,頂寮村,0,1,712,9,721,1256,3,1,3,0,1,0,57.40
雲林縣,元長鄉,下寮村,0,1,903,15,918,1586,3,1,3,0,1,0,57.88
雲林縣,元長鄉,龍岩村,0,1,649,5,654,1113,3,1,3,0,1,0,58.76
雲林縣,元長鄉,西莊村,0,1,568,11,579,942,3,1,3,0,1,0,61.46
雲林縣,元長鄉,鹿北村,0,1,805,7,812,1359,3,1,3,0,1,0,59.75
雲林縣,元長鄉,鹿南村,0,1,616,6,622,1060,3,1,3,0,1,0,58.68
雲林縣,元長鄉,瓦窯村,0,1,988,11,999,1686,3,1,3,0,1,0,59.25
雲林縣,元長鄉,內寮村,0,1,416,4,420,687,3,1,3,0,1,0,61.14
雲林縣,元長鄉,崙仔村,0,1,545,17,562,945,3,1,3,0,1,0,59.47
雲林縣,元長鄉,新吉村,0,1,472,5,477,733,3,1,3,0,1,0,65.08
雲林縣,四湖鄉,四湖村,0,1,997,21,1018,1736,3,1,3,0,1,0,58.64
雲林縣,四湖鄉,湖西村,0,1,1278,21,1299,2087,3,1,3,0,1,0,62.24
雲林縣,四湖鄉,新庄村,0,1,398,6,404,709,3,1,3,0,1,0,56.98
雲林縣,四湖鄉,溪底村,0,1,624,17,641,1112,3,1,3,0,1,0,57.64
雲林縣,四湖鄉,鹿場村,0,1,598,9,607,1136,3,1,3,0,1,0,53.43
雲林縣,四湖鄉,蔡厝村,0,1,506,5,511,979,3,1,3,0,1,0,52.20
雲林縣,四湖鄉,湖寮村,0,1,492,10,502,922,3,1,3,0,1,0,54.45
雲林縣,四湖鄉,施湖村,0,1,655,11,666,1227,3,1,3,0,1,0,54.28
雲林縣,四湖鄉,羊調村,0,1,583,13,596,1143,3,1,3,0,1,0,52.14
雲林縣,四湖鄉,內湖村,0,1,442,4,446,982,3,1,3,0,1,0,45.42
雲林縣,四湖鄉,飛東村,0,1,367,5,372,682,3,1,3,0,1,0,54.55
雲林縣,四湖鄉,飛沙村,0,1,509,12,521,993,3,1,3,0,1,0,52.47
雲林縣,四湖鄉,三姓村,0,1,236,2,238,411,3,1,3,0,1,0,57.91
雲林縣,四湖鄉,崙北村,0,1,912,16,928,1770,3,1,3,0,1,0,52.43
雲林縣,四湖鄉,崙南村,0,1,471,12,483,911,3,1,3,0,1,0,53.02
雲林縣,四湖鄉,廣溝村,0,1,389,9,398,814,3,1,3,0,1,0,48.89
雲林縣,四湖鄉,箔子村,0,1,465,8,473,1004,3,1,3,0,1,0,47.11
雲林縣,四湖鄉,箔東村,0,1,533,10,543,1138,3,1,3,0,1,0,47.72
雲林縣,四湖鄉,林厝村,0,1,649,10,659,1299,3,1,3,0,1,0,50.73
雲林縣,四湖鄉,林東村,0,1,503,12,515,1088,3,1,3,0,1,0,47.33
雲林縣,四湖鄉,溪尾村,0,1,368,4,372,836,3,1,3,0,1,0,44.50
雲林縣,口湖鄉,口湖村,0,1,654,3,657,1033,3,1,3,0,1,0,63.60
雲林縣,口湖鄉,湖東村,0,1,831,16,847,1255,3,1,3,0,1,0,67.49
雲林縣,口湖鄉,頂湖村,0,1,372,8,380,708,3,1,3,0,1,0,53.67
雲林縣,口湖鄉,埔南村,0,1,383,2,385,649,3,1,3,0,1,0,59.32
雲林縣,口湖鄉,埔北村,0,1,453,5,458,927,3,1,3,0,1,0,49.41
雲林縣,口湖鄉,謝厝村,0,1,591,11,602,997,3,1,3,0,1,0,60.38
雲林縣,口湖鄉,蚵寮村,0,1,888,13,901,1435,3,1,3,0,1,0,62.79
雲林縣,口湖鄉,下崙村,0,1,1019,11,1030,1996,3,1,3,0,1,0,51.60
雲林縣,口湖鄉,崙中村,0,1,885,18,903,1732,3,1,3,0,1,0,52.14
雲林縣,口湖鄉,崙東村,0,1,843,13,856,1517,3,1,3,0,1,0,56.43
雲林縣,口湖鄉,青蚶村,0,1,291,8,299,543,3,1,3,0,1,0,55.06
雲林縣,口湖鄉,港東村,0,1,845,19,864,1439,3,1,3,0,1,0,60.04
雲林縣,口湖鄉,港西村,0,1,447,0,447,743,3,1,3,0,1,0,60.16
雲林縣,口湖鄉,台子村,0,1,996,18,1014,1621,3,1,3,0,1,0,62.55
雲林縣,口湖鄉,成龍村,0,1,622,6,628,1019,3,1,3,0,1,0,61.63
雲林縣,口湖鄉,梧南村,0,1,1159,19,1178,1866,3,1,3,0,1,0,63.13
雲林縣,口湖鄉,梧北村,0,1,782,9,791,1323,3,1,3,0,1,0,59.79
雲林縣,口湖鄉,水井村,0,1,635,12,647,1049,3,1,3,0,1,0,61.68
雲林縣,口湖鄉,後厝村,0,1,468,8,476,812,3,1,3,0,1,0,58.62
雲林縣,口湖鄉,湖口村,0,1,602,12,614,1036,3,1,3,0,1,0,59.27
雲林縣,口湖鄉,過港村,0,1,440,9,449,758,3,1,3,0,1,0,59.23
雲林縣,水林鄉,水北村,0,1,1507,25,1532,2283,3,1,3,0,1,0,67.10
雲林縣,水林鄉,水南村,0,1,1232,15,1247,1891,3,1,3,0,1,0,65.94
雲林縣,水林鄉,萬興村,0,1,478,6,484,785,3,1,3,0,1,0,61.66
雲林縣,水林鄉,尖山村,0,1,441,16,457,765,3,1,3,0,1,0,59.74
雲林縣,水林鄉,大溝村,0,1,675,16,691,1083,3,1,3,0,1,0,63.80
雲林縣,水林鄉,順興村,0,1,532,13,545,948,3,1,3,0,1,0,57.49
雲林縣,水林鄉,大山村,0,1,708,14,722,1222,3,1,3,0,1,0,59.08
雲林縣,水林鄉,後寮村,0,1,483,9,492,808,3,1,3,0,1,0,60.89
雲林縣,水林鄉,春埔村,0,1,608,6,614,1067,3,1,3,0,1,0,57.54
雲林縣,水林鄉,西井村,0,1,433,12,445,770,3,1,3,0,1,0,57.79
雲林縣,水林鄉,車港村,0,1,416,4,420,693,3,1,3,0,1,0,60.61
雲林縣,水林鄉,蘇秦村,0,1,666,8,674,1235,3,1,3,0,1,0,54.57
雲林縣,水林鄉,灣東村,0,1,456,10,466,759,3,1,3,0,1,0,61.40
雲林縣,水林鄉,灣西村,0,1,651,9,660,1073,3,1,3,0,1,0,61.51
雲林縣,水林鄉,蕃薯村,0,1,658,9,667,1060,3,1,3,0,1,0,62.92
雲林縣,水林鄉,山腳村,0,1,555,14,569,904,3,1,3,0,1,0,62.94
雲林縣,水林鄉,松北村,0,1,899,9,908,1267,3,1,3,0,1,0,71.67
雲林縣,水林鄉,松中村,0,1,401,5,406,634,3,1,3,0,1,0,64.04
雲林縣,水林鄉,松西村,0,1,524,9,533,834,3,1,3,0,1,0,63.91
雲林縣,水林鄉,舊埔村,0,1,516,10,526,878,3,1,3,0,1,0,59.91
雲林縣,水林鄉,塭底村,0,1,440,7,447,811,3,1,3,0,1,0,55.12
雲林縣,水林鄉,海埔村,0,1,703,9,712,1099,3,1,3,0,1,0,64.79
雲林縣,水林鄉,土厝村,0,1,762,14,776,1269,3,1,3,0,1,0,61.15
雲林縣,水林鄉,溪墘村,0,1,539,8,547,826,3,1,3,0,1,0,66.22
嘉義縣,太保市,太保里,0,1,1100,28,1128,1704,3,1,3,0,1,0,66.20
嘉義縣,太保市,後庄里,0,1,298,7,305,486,3,1,3,0,1,0,62.76
嘉義縣,太保市,前潭里,0,1,895,14,909,1367,3,1,3,0,1,0,66.50
嘉義縣,太保市,後潭里,0,1,1009,23,1032,1503,3,1,3,0,1,0,68.66
嘉義縣,太保市,梅埔里,0,1,780,17,797,1082,3,1,3,0,1,0,73.66
嘉義縣,太保市,春珠里,0,1,560,17,577,804,3,1,3,0,1,0,71.77
嘉義縣,太保市,崙頂里,0,1,568,7,575,800,3,1,3,0,1,0,71.88
嘉義縣,太保市,安仁里,0,1,684,16,700,935,3,1,3,0,1,0,74.87
嘉義縣,太保市,東勢里,0,1,583,11,594,890,3,1,3,0,1,0,66.74
嘉義縣,太保市,新埤里,0,1,750,17,767,1183,3,1,3,0,1,0,64.84
嘉義縣,太保市,舊埤里,0,1,1068,19,1087,1690,3,1,3,0,1,0,64.32
嘉義縣,太保市,田尾里,0,1,438,14,452,715,3,1,3,0,1,0,63.22
嘉義縣,太保市,港尾里,0,1,362,7,369,576,3,1,3,0,1,0,64.06
嘉義縣,太保市,過溝里,0,1,1238,33,1271,1969,3,1,3,0,1,0,64.55
嘉義縣,太保市,麻寮里,0,1,1604,41,1645,2630,3,1,3,0,1,0,62.55
嘉義縣,太保市,南新里,0,1,1086,30,1116,1686,3,1,3,0,1,0,66.19
嘉義縣,太保市,北新里,0,1,1270,27,1297,2185,3,1,3,0,1,0,59.36
嘉義縣,太保市,埤鄉里,0,1,457,8,465,707,3,1,3,0,1,0,65.77
嘉義縣,朴子市,安福里,0,1,1157,16,1173,1808,3,1,3,0,1,0,64.88
嘉義縣,朴子市,平和里,0,1,1224,16,1240,1827,3,1,3,0,1,0,67.87
嘉義縣,朴子市,內厝里,0,1,731,9,740,1103,3,1,3,0,1,0,67.09
嘉義縣,朴子市,開元里,0,1,326,3,329,503,3,1,3,0,1,0,65.41
嘉義縣,朴子市,順天里,0,1,464,5,469,754,3,1,3,0,1,0,62.20
嘉義縣,朴子市,中正里,0,1,535,4,539,758,3,1,3,0,1,0,71.11
嘉義縣,朴子市,博厚里,0,1,511,5,516,748,3,1,3,0,1,0,68.98
嘉義縣,朴子市,文化里,0,1,1255,15,1270,1821,3,1,3,0,1,0,69.74
嘉義縣,朴子市,永和里,0,1,1532,28,1560,2435,3,1,3,0,1,0,64.07
嘉義縣,朴子市,竹圍里,0,1,2379,31,2410,3649,3,1,3,0,1,0,66.05
嘉義縣,朴子市,新寮里,0,1,448,8,456,652,3,1,3,0,1,0,69.94
嘉義縣,朴子市,雙溪里,0,1,427,7,434,684,3,1,3,0,1,0,63.45
嘉義縣,朴子市,溪口里,0,1,545,14,559,810,3,1,3,0,1,0,69.01
嘉義縣,朴子市,德興里,0,1,726,8,734,1016,3,1,3,0,1,0,72.24
嘉義縣,朴子市,仁和里,0,1,398,7,405,571,3,1,3,0,1,0,70.93
嘉義縣,朴子市,大鄉里,0,1,1747,39,1786,2572,3,1,3,0,1,0,69.44
嘉義縣,朴子市,大葛里,0,1,1137,36,1173,1710,3,1,3,0,1,0,68.60
嘉義縣,朴子市,佳禾里,0,1,393,6,399,596,3,1,3,0,1,0,66.95
嘉義縣,朴子市,竹村里,0,1,600,14,614,975,3,1,3,0,1,0,62.97
嘉義縣,朴子市,崁前里,0,1,649,20,669,989,3,1,3,0,1,0,67.64
嘉義縣,朴子市,崁後里,0,1,529,14,543,875,3,1,3,0,1,0,62.06
嘉義縣,朴子市,順安里,0,1,207,3,210,296,3,1,3,0,1,0,70.95
嘉義縣,朴子市,德家里,0,1,519,18,537,821,3,1,3,0,1,0,65.41
嘉義縣,朴子市,新庄里,0,1,375,7,382,597,3,1,3,0,1,0,63.99
嘉義縣,朴子市,梅華里,0,1,722,12,734,1153,3,1,3,0,1,0,63.66
嘉義縣,朴子市,松華里,0,1,910,17,927,1428,3,1,3,0,1,0,64.92
嘉義縣,朴子市,南竹里,0,1,364,3,367,561,3,1,3,0,1,0,65.42
嘉義縣,布袋鎮,岱江里,0,1,412,13,425,748,3,1,3,0,1,0,56.82
嘉義縣,布袋鎮,九龍里,0,1,268,4,272,438,3,1,3,0,1,0,62.10
嘉義縣,布袋鎮,岑海里,0,1,1018,12,1030,1586,3,1,3,0,1,0,64.94
嘉義縣,布袋鎮,興中里,0,1,801,17,818,1285,3,1,3,0,1,0,63.66
嘉義縣,布袋鎮,光復里,0,1,1179,14,1193,1823,3,1,3,0,1,0,65.44
嘉義縣,布袋鎮,見龍里,0,1,565,9,574,925,3,1,3,0,1,0,62.05
嘉義縣,布袋鎮,新厝里,0,1,475,16,491,817,3,1,3,0,1,0,60.10
嘉義縣,布袋鎮,龍江里,0,1,532,12,544,849,3,1,3,0,1,0,64.08
嘉義縣,布袋鎮,西安里,0,1,912,12,924,1432,3,1,3,0,1,0,64.53
嘉義縣,布袋鎮,中安里,0,1,955,17,972,1599,3,1,3,0,1,0,60.79
嘉義縣,布袋鎮,東安里,0,1,945,11,956,1548,3,1,3,0,1,0,61.76
嘉義縣,布袋鎮,樹林里,0,1,388,6,394,572,3,1,3,0,1,0,68.88
嘉義縣,布袋鎮,貴舍里,0,1,480,13,493,752,3,1,3,0,1,0,65.56
嘉義縣,布袋鎮,永安里,0,1,734,11,745,1192,3,1,3,0,1,0,62.50
嘉義縣,布袋鎮,東港里,0,1,1180,22,1202,1932,3,1,3,0,1,0,62.22
嘉義縣,布袋鎮,江山里,0,1,235,8,243,362,3,1,3,0,1,0,67.13
嘉義縣,布袋鎮,菜舖里,0,1,285,4,289,465,3,1,3,0,1,0,62.15
嘉義縣,布袋鎮,考試里,0,1,210,3,213,350,3,1,3,0,1,0,60.86
嘉義縣,布袋鎮,振寮里,0,1,539,9,548,794,3,1,3,0,1,0,69.02
嘉義縣,布袋鎮,新岑里,0,1,654,10,664,1029,3,1,3,0,1,0,64.53
嘉義縣,布袋鎮,新民里,0,1,833,16,849,1236,3,1,3,0,1,0,68.69
嘉義縣,布袋鎮,復興里,0,1,1584,31,1615,2429,3,1,3,0,1,0,66.49
嘉義縣,布袋鎮,好美里,0,1,717,20,737,1102,3,1,3,0,1,0,66.88
嘉義縣,大林鎮,東林里,0,1,314,5,319,500,3,1,3,0,1,0,63.80
嘉義縣,大林鎮,西林里,0,1,1173,12,1185,1906,3,1,3,0,1,0,62.17
嘉義縣,大林鎮,吉林里,0,1,609,10,619,988,3,1,3,0,1,0,62.65
嘉義縣,大林鎮,平林里,0,1,2983,41,3024,4822,3,1,3,0,1,0,62.71
嘉義縣,大林鎮,明華里,0,1,730,12,742,1146,3,1,3,0,1,0,64.75
嘉義縣,大林鎮,明和里,0,1,844,12,856,1340,3,1,3,0,1,0,63.88
嘉義縣,大林鎮,排路里,0,1,448,2,450,695,3,1,3,0,1,0,64.75
嘉義縣,大林鎮,西結里,0,1,496,9,505,838,3,1,3,0,1,0,60.26
嘉義縣,大林鎮,湖北里,0,1,473,15,488,684,3,1,3,0,1,0,71.35
嘉義縣,大林鎮,大糖里,0,1,191,8,199,319,3,1,3,0,1,0,62.38
嘉義縣,大林鎮,大美里,0,1,1107,25,1132,1748,3,1,3,0,1,0,64.76
嘉義縣,大林鎮,過溪里,0,1,937,35,972,1461,3,1,3,0,1,0,66.53
嘉義縣,大林鎮,中坑里,0,1,1010,18,1028,1528,3,1,3,0,1,0,67.28
嘉義縣,大林鎮,上林里,0,1,532,14,546,815,3,1,3,0,1,0,66.99
嘉義縣,大林鎮,中林里,0,1,1011,13,1024,1525,3,1,3,0,1,0,67.15
嘉義縣,大林鎮,三和里,0,1,1186,12,1198,1885,3,1,3,0,1,0,63.55
嘉義縣,大林鎮,溝背里,0,1,658,9,667,987,3,1,3,0,1,0,67.58
嘉義縣,大林鎮,義和里,0,1,489,6,495,693,3,1,3,0,1,0,71.43
嘉義縣,大林鎮,內林里,0,1,540,5,545,773,3,1,3,0,1,0,70.50
嘉義縣,大林鎮,三角里,0,1,679,14,693,1093,3,1,3,0,1,0,63.40
嘉義縣,大林鎮,三村里,0,1,492,8,500,754,3,1,3,0,1,0,66.31
嘉義縣,民雄鄉,東榮村,0,1,1347,13,1360,1992,3,1,3,0,1,0,68.27
嘉義縣,民雄鄉,中樂村,0,1,1026,10,1036,1554,3,1,3,0,1,0,66.67
嘉義縣,民雄鄉,西安村,0,1,1901,24,1925,2963,3,1,3,0,1,0,64.97
嘉義縣,民雄鄉,寮頂村,0,1,1288,16,1304,1961,3,1,3,0,1,0,66.50
嘉義縣,民雄鄉,福權村,0,1,852,12,864,1258,3,1,3,0,1,0,68.68
嘉義縣,民雄鄉,東湖村,0,1,1210,17,1227,1799,3,1,3,0,1,0,68.20
嘉義縣,民雄鄉,頂崙村,0,1,834,13,847,1321,3,1,3,0,1,0,64.12
嘉義縣,民雄鄉,菁埔村,0,1,1159,22,1181,1629,3,1,3,0,1,0,72.50
嘉義縣,民雄鄉,中和村,0,1,479,0,479,731,3,1,3,0,1,0,65.53
嘉義縣,民雄鄉,平和村,0,1,485,7,492,734,3,1,3,0,1,0,67.03
嘉義縣,民雄鄉,西昌村,0,1,500,11,511,776,3,1,3,0,1,0,65.85
嘉義縣,民雄鄉,豐收村,0,1,1208,21,1229,1856,3,1,3,0,1,0,66.22
嘉義縣,民雄鄉,三興村,0,1,519,8,527,827,3,1,3,0,1,0,63.72
嘉義縣,民雄鄉,東興村,0,1,348,4,352,584,3,1,3,0,1,0,60.27
嘉義縣,民雄鄉,鎮北村,0,1,553,10,563,880,3,1,3,0,1,0,63.98
嘉義縣,民雄鄉,北斗村,0,1,2055,30,2085,3068,3,1,3,0,1,0,67.96
嘉義縣,民雄鄉,雙福村,0,1,1063,14,1077,1692,3,1,3,0,1,0,63.65
嘉義縣,民雄鄉,福樂村,0,1,2362,34,2396,3839,3,1,3,0,1,0,62.41
嘉義縣,民雄鄉,大崎村,0,1,1230,22,1252,1978,3,1,3,0,1,0,63.30
嘉義縣,民雄鄉,秀林村,0,1,1269,19,1288,2092,3,1,3,0,1,0,61.57
嘉義縣,民雄鄉,松山村,0,1,913,13,926,1588,3,1,3,0,1,0,58.31
嘉義縣,民雄鄉,興中村,0,1,1090,24,1114,1694,3,1,3,0,1,0,65.76
嘉義縣,民雄鄉,興南村,0,1,1228,26,1254,2152,3,1,3,0,1,0,58.27
嘉義縣,民雄鄉,金興村,0,1,1524,33,1557,2499,3,1,3,0,1,0,62.30
嘉義縣,民雄鄉,福興村,0,1,1066,22,1088,1667,3,1,3,0,1,0,65.27
嘉義縣,民雄鄉,文隆村,0,1,1216,26,1242,1945,3,1,3,0,1,0,63.86
嘉義縣,民雄鄉,山中村,0,1,2250,39,2289,3370,3,1,3,0,1,0,67.92
嘉義縣,民雄鄉,中央村,0,1,779,9,788,1203,3,1,3,0,1,0,65.50
嘉義縣,溪口鄉,溪東村,0,1,882,11,893,1383,3,1,3,0,1,0,64.57
嘉義縣,溪口鄉,溪西村,0,1,479,5,484,738,3,1,3,0,1,0,65.58
嘉義縣,溪口鄉,溪北村,0,1,431,11,442,720,3,1,3,0,1,0,61.39
嘉義縣,溪口鄉,柴林村,0,1,542,6,548,848,3,1,3,0,1,0,64.62
嘉義縣,溪口鄉,林腳村,0,1,584,12,596,880,3,1,3,0,1,0,67.73
嘉義縣,溪口鄉,美南村,0,1,784,10,794,1246,3,1,3,0,1,0,63.72
嘉義縣,溪口鄉,美北村,0,1,624,5,629,984,3,1,3,0,1,0,63.92
嘉義縣,溪口鄉,本厝村,0,1,688,10,698,977,3,1,3,0,1,0,71.44
嘉義縣,溪口鄉,游東村,0,1,646,8,654,1108,3,1,3,0,1,0,59.03
嘉義縣,溪口鄉,游西村,0,1,460,8,468,785,3,1,3,0,1,0,59.62
嘉義縣,溪口鄉,柳溝村,0,1,872,15,887,1279,3,1,3,0,1,0,69.35
嘉義縣,溪口鄉,疊溪村,0,1,598,7,605,997,3,1,3,0,1,0,60.68
嘉義縣,溪口鄉,妙崙村,0,1,442,7,449,736,3,1,3,0,1,0,61.01
嘉義縣,溪口鄉,坪頂村,0,1,600,15,615,900,3,1,3,0,1,0,68.33
嘉義縣,新港鄉,宮前村,0,1,1114,13,1127,1716,3,1,3,0,1,0,65.68
嘉義縣,新港鄉,宮後村,0,1,1019,15,1034,1674,3,1,3,0,1,0,61.77
嘉義縣,新港鄉,大興村,0,1,834,15,849,1408,3,1,3,0,1,0,60.30
嘉義縣,新港鄉,福德村,0,1,882,15,897,1471,3,1,3,0,1,0,60.98
嘉義縣,新港鄉,古民村,0,1,689,7,696,1186,3,1,3,0,1,0,58.68
嘉義縣,新港鄉,中庄村,0,1,933,13,946,1530,3,1,3,0,1,0,61.83
嘉義縣,新港鄉,大潭村,0,1,1021,15,1036,1605,3,1,3,0,1,0,64.55
嘉義縣,新港鄉,西庄村,0,1,591,8,599,968,3,1,3,0,1,0,61.88
嘉義縣,新港鄉,月眉村,0,1,1042,15,1057,1682,3,1,3,0,1,0,62.84
嘉義縣,新港鄉,月潭村,0,1,906,14,920,1457,3,1,3,0,1,0,63.14
嘉義縣,新港鄉,溪北村,0,1,848,18,866,1419,3,1,3,0,1,0,61.03
嘉義縣,新港鄉,菜公村,0,1,541,7,548,891,3,1,3,0,1,0,61.50
嘉義縣,新港鄉,中洋村,0,1,620,9,629,1021,3,1,3,0,1,0,61.61
嘉義縣,新港鄉,三間村,0,1,543,15,558,911,3,1,3,0,1,0,61.25
嘉義縣,新港鄉,安和村,0,1,680,16,696,1109,3,1,3,0,1,0,62.76
嘉義縣,新港鄉,潭大村,0,1,660,14,674,1135,3,1,3,0,1,0,59.38
嘉義縣,新港鄉,南港村,0,1,626,6,632,1089,3,1,3,0,1,0,58.03
嘉義縣,新港鄉,板頭村,0,1,391,3,394,594,3,1,3,0,1,0,66.33
嘉義縣,新港鄉,共和村,0,1,479,5,484,834,3,1,3,0,1,0,58.03
嘉義縣,新港鄉,埤子村,0,1,370,8,378,591,3,1,3,0,1,0,63.96
嘉義縣,新港鄉,南崙村,0,1,604,10,614,936,3,1,3,0,1,0,65.60
嘉義縣,新港鄉,北崙村,0,1,326,8,334,604,3,1,3,0,1,0,55.30
嘉義縣,新港鄉,海瀛村,0,1,324,7,331,501,3,1,3,0,1,0,66.07
嘉義縣,六腳鄉,蒜頭村,0,1,832,7,839,1292,3,1,3,0,1,0,64.94
嘉義縣,六腳鄉,蒜東村,0,1,532,15,547,950,3,1,3,0,1,0,57.58
嘉義縣,六腳鄉,蒜南村,0,1,553,12,565,877,3,1,3,0,1,0,64.42
嘉義縣,六腳鄉,工廠村,0,1,210,4,214,317,3,1,3,0,1,0,67.51
嘉義縣,六腳鄉,灣南村,0,1,777,15,792,1261,3,1,3,0,1,0,62.81
嘉義縣,六腳鄉,灣北村,0,1,777,18,795,1316,3,1,3,0,1,0,60.41
嘉義縣,六腳鄉,雙涵村,0,1,521,10,531,894,3,1,3,0,1,0,59.40
嘉義縣,六腳鄉,塗師村,0,1,449,8,457,740,3,1,3,0,1,0,61.76
嘉義縣,六腳鄉,三義村,0,1,429,12,441,797,3,1,3,0,1,0,55.33
嘉義縣,六腳鄉,正義村,0,1,891,9,900,1442,3,1,3,0,1,0,62.41
嘉義縣,六腳鄉,溪厝村,0,1,368,10,378,634,3,1,3,0,1,0,59.62
嘉義縣,六腳鄉,港美村,0,1,475,8,483,770,3,1,3,0,1,0,62.73
嘉義縣,六腳鄉,豐美村,0,1,627,10,637,1065,3,1,3,0,1,0,59.81
嘉義縣,六腳鄉,六斗村,0,1,559,7,566,883,3,1,3,0,1,0,64.10
嘉義縣,六腳鄉,崙陽村,0,1,628,13,641,1033,3,1,3,0,1,0,62.05
嘉義縣,六腳鄉,蘇厝村,0,1,858,20,878,1431,3,1,3,0,1,0,61.36
嘉義縣,六腳鄉,竹本村,0,1,409,5,414,730,3,1,3,0,1,0,56.71
嘉義縣,六腳鄉,永賢村,0,1,319,6,325,573,3,1,3,0,1,0,56.72
嘉義縣,六腳鄉,魚寮村,0,1,411,7,418,807,3,1,3,0,1,0,51.80
嘉義縣,六腳鄉,潭墘村,0,1,508,15,523,961,3,1,3,0,1,0,54.42
嘉義縣,六腳鄉,六腳村,0,1,508,9,517,905,3,1,3,0,1,0,57.13
嘉義縣,六腳鄉,六南村,0,1,365,15,380,645,3,1,3,0,1,0,58.91
嘉義縣,六腳鄉,崩山村,0,1,483,8,491,812,3,1,3,0,1,0,60.47
嘉義縣,六腳鄉,古林村,0,1,523,10,533,872,3,1,3,0,1,0,61.12
嘉義縣,六腳鄉,更寮村,0,1,345,13,358,625,3,1,3,0,1,0,57.28
嘉義縣,東石鄉,東石村,0,1,1138,28,1166,1726,3,1,3,0,1,0,67.56
嘉義縣,東石鄉,猿樹村,0,1,602,19,621,1001,3,1,3,0,1,0,62.04
嘉義縣,東石鄉,塭港村,0,1,997,23,1020,1564,3,1,3,0,1,0,65.22
嘉義縣,東石鄉,型厝村,0,1,985,19,1004,1475,3,1,3,0,1,0,68.07
嘉義縣,東石鄉,三家村,0,1,805,26,831,1247,3,1,3,0,1,0,66.64
嘉義縣,東石鄉,永屯村,0,1,482,13,495,724,3,1,3,0,1,0,68.37
嘉義縣,東石鄉,海埔村,0,1,279,3,282,461,3,1,3,0,1,0,61.17
嘉義縣,東石鄉,龍港村,0,1,591,12,603,1002,3,1,3,0,1,0,60.18
嘉義縣,東石鄉,副瀨村,0,1,661,14,675,1133,3,1,3,0,1,0,59.58
嘉義縣,東石鄉,下揖村,0,1,554,15,569,885,3,1,3,0,1,0,64.29
嘉義縣,東石鄉,頂揖村,0,1,243,6,249,441,3,1,3,0,1,0,56.46
嘉義縣,東石鄉,溪下村,0,1,712,13,725,1113,3,1,3,0,1,0,65.14
嘉義縣,東石鄉,港口村,0,1,255,4,259,394,3,1,3,0,1,0,65.74
嘉義縣,東石鄉,鰲鼓村,0,1,972,28,1000,1412,3,1,3,0,1,0,70.82
嘉義縣,東石鄉,港墘村,0,1,869,14,883,1301,3,1,3,0,1,0,67.87
嘉義縣,東石鄉,蔦松村,0,1,614,27,641,933,3,1,3,0,1,0,68.70
嘉義縣,東石鄉,圍潭村,0,1,474,7,481,780,3,1,3,0,1,0,61.67
嘉義縣,東石鄉,洲仔村,0,1,633,19,652,966,3,1,3,0,1,0,67.49
嘉義縣,東石鄉,東崙村,0,1,489,12,501,799,3,1,3,0,1,0,62.70
嘉義縣,東石鄉,西崙村,0,1,661,15,676,1096,3,1,3,0,1,0,61.68
嘉義縣,東石鄉,塭仔村,0,1,731,15,746,1017,3,1,3,0,1,0,73.35
嘉義縣,東石鄉,網寮村,0,1,843,11,854,1304,3,1,3,0,1,0,65.49
嘉義縣,東石鄉,掌潭村,0,1,574,5,579,826,3,1,3,0,1,0,70.10
嘉義縣,義竹鄉,岸腳村,0,1,644,19,663,898,3,1,3,0,1,0,73.83
嘉義縣,義竹鄉,義竹村,0,1,1158,27,1185,1608,3,1,3,0,1,0,73.69
嘉義縣,義竹鄉,六桂村,0,1,1042,21,1063,1451,3,1,3,0,1,0,73.26
嘉義縣,義竹鄉,仁里村,0,1,818,13,831,1033,3,1,3,0,1,0,80.45
嘉義縣,義竹鄉,傳芳村,0,1,508,23,531,767,3,1,3,0,1,0,69.23
嘉義縣,義竹鄉,頭竹村,0,1,1013,13,1026,1378,3,1,3,0,1,0,74.46
嘉義縣,義竹鄉,五厝村,0,1,288,7,295,437,3,1,3,0,1,0,67.51
嘉義縣,義竹鄉,中平村,0,1,349,13,362,500,3,1,3,0,1,0,72.40
嘉義縣,義竹鄉,埤前村,0,1,625,13,638,842,3,1,3,0,1,0,75.77
嘉義縣,義竹鄉,平溪村,0,1,324,7,331,464,3,1,3,0,1,0,71.34
嘉義縣,義竹鄉,後鎮村,0,1,366,8,374,527,3,1,3,0,1,0,70.97
嘉義縣,義竹鄉,北華村,0,1,412,11,423,612,3,1,3,0,1,0,69.12
嘉義縣,義竹鄉,新店村,0,1,1104,24,1128,1552,3,1,3,0,1,0,72.68
嘉義縣,義竹鄉,東過村,0,1,592,11,603,871,3,1,3,0,1,0,69.23
嘉義縣,義竹鄉,西過村,0,1,632,15,647,933,3,1,3,0,1,0,69.35
嘉義縣,義竹鄉,官和村,0,1,596,10,606,878,3,1,3,0,1,0,69.02
嘉義縣,義竹鄉,官順村,0,1,351,11,362,556,3,1,3,0,1,0,65.11
嘉義縣,義竹鄉,新富村,0,1,441,8,449,583,3,1,3,0,1,0,77.02
嘉義縣,義竹鄉,東光村,0,1,662,13,675,911,3,1,3,0,1,0,74.09
嘉義縣,義竹鄉,東榮村,0,1,337,5,342,517,3,1,3,0,1,0,66.15
嘉義縣,義竹鄉,龍蛟村,0,1,484,9,493,744,3,1,3,0,1,0,66.26
嘉義縣,義竹鄉,溪洲村,0,1,511,15,526,772,3,1,3,0,1,0,68.13
嘉義縣,鹿草鄉,後寮村,0,1,312,6,318,492,3,1,3,0,1,0,64.63
嘉義縣,鹿草鄉,鹿東村,0,1,452,7,459,646,3,1,3,0,1,0,71.05
嘉義縣,鹿草鄉,鹿草村,0,1,843,14,857,1315,3,1,3,0,1,0,65.17
嘉義縣,鹿草鄉,西井村,0,1,763,16,779,1150,3,1,3,0,1,0,67.74
嘉義縣,鹿草鄉,豐稠村,0,1,280,5,285,430,3,1,3,0,1,0,66.28
嘉義縣,鹿草鄉,重寮村,0,1,683,9,692,1147,3,1,3,0,1,0,60.33
嘉義縣,鹿草鄉,施家村,0,1,304,7,311,528,3,1,3,0,1,0,58.90
嘉義縣,鹿草鄉,下潭村,0,1,551,6,557,905,3,1,3,0,1,0,61.55
嘉義縣,鹿草鄉,光潭村,0,1,685,10,695,1130,3,1,3,0,1,0,61.50
嘉義縣,鹿草鄉,碧潭村,0,1,644,21,665,1117,3,1,3,0,1,0,59.53
嘉義縣,鹿草鄉,松竹村,0,1,563,12,575,931,3,1,3,0,1,0,61.76
嘉義縣,鹿草鄉,竹山村,0,1,530,9,539,912,3,1,3,0,1,0,59.10
嘉義縣,鹿草鄉,後堀村,0,1,913,16,929,1291,3,1,3,0,1,0,71.96
嘉義縣,鹿草鄉,三角村,0,1,1053,32,1085,1540,3,1,3,0,1,0,70.45
嘉義縣,鹿草鄉,下麻村,0,1,398,6,404,578,3,1,3,0,1,0,69.90
嘉義縣,水上鄉,水上村,0,1,1979,32,2011,2956,3,1,3,0,1,0,68.03
嘉義縣,水上鄉,水頭村,0,1,1407,16,1423,2071,3,1,3,0,1,0,68.71
嘉義縣,水上鄉,粗溪村,0,1,952,31,983,1474,3,1,3,0,1,0,66.69
嘉義縣,水上鄉,下寮村,0,1,978,19,997,1581,3,1,3,0,1,0,63.06
嘉義縣,水上鄉,三和村,0,1,1138,26,1164,1763,3,1,3,0,1,0,66.02
嘉義縣,水上鄉,回歸村,0,1,471,12,483,664,3,1,3,0,1,0,72.74
嘉義縣,水上鄉,大堀村,0,1,1032,13,1045,1411,3,1,3,0,1,0,74.06
嘉義縣,水上鄉,大崙村,0,1,1265,18,1283,1874,3,1,3,0,1,0,68.46
嘉義縣,水上鄉,塗溝村,0,1,576,15,591,823,3,1,3,0,1,0,71.81
嘉義縣,水上鄉,龍德村,0,1,1215,27,1242,1780,3,1,3,0,1,0,69.78
嘉義縣,水上鄉,溪洲村,0,1,731,12,743,1094,3,1,3,0,1,0,67.92
嘉義縣,水上鄉,三鎮村,0,1,440,9,449,616,3,1,3,0,1,0,72.89
嘉義縣,水上鄉,靖和村,0,1,396,5,401,531,3,1,3,0,1,0,75.52
嘉義縣,水上鄉,南和村,0,1,845,16,861,1238,3,1,3,0,1,0,69.55
嘉義縣,水上鄉,柳新村,0,1,1394,30,1424,2163,3,1,3,0,1,0,65.83
嘉義縣,水上鄉,柳林村,0,1,1095,21,1116,1770,3,1,3,0,1,0,63.05
嘉義縣,水上鄉,柳鄉村,0,1,1186,24,1210,1802,3,1,3,0,1,0,67.15
嘉義縣,水上鄉,內溪村,0,1,605,9,614,990,3,1,3,0,1,0,62.02
嘉義縣,水上鄉,寬士村,0,1,1975,41,2016,3465,3,1,3,0,1,0,58.18
嘉義縣,水上鄉,民生村,0,1,1687,30,1717,2832,3,1,3,0,1,0,60.63
嘉義縣,水上鄉,義興村,0,1,524,8,532,755,3,1,3,0,1,0,70.46
嘉義縣,水上鄉,中庄村,0,1,1165,25,1190,1822,3,1,3,0,1,0,65.31
嘉義縣,水上鄉,忠和村,0,1,1165,26,1191,1831,3,1,3,0,1,0,65.05
嘉義縣,水上鄉,南鄉村,0,1,545,15,560,801,3,1,3,0,1,0,69.91
嘉義縣,水上鄉,三界村,0,1,727,17,744,1055,3,1,3,0,1,0,70.52
嘉義縣,水上鄉,國姓村,0,1,769,17,786,1301,3,1,3,0,1,0,60.42
嘉義縣,中埔鄉,中埔村,0,1,997,21,1018,1606,3,1,3,0,1,0,63.39
嘉義縣,中埔鄉,塩舘村,0,1,561,11,572,816,3,1,3,0,1,0,70.10
嘉義縣,中埔鄉,龍門村,0,1,466,13,479,734,3,1,3,0,1,0,65.26
嘉義縣,中埔鄉,裕民村,0,1,524,7,531,850,3,1,3,0,1,0,62.47
嘉義縣,中埔鄉,金蘭村,0,1,792,9,801,1347,3,1,3,0,1,0,59.47
嘉義縣,中埔鄉,富收村,0,1,1493,25,1518,2544,3,1,3,0,1,0,59.67
嘉義縣,中埔鄉,和睦村,0,1,1538,29,1567,2536,3,1,3,0,1,0,61.79
嘉義縣,中埔鄉,和美村,0,1,3236,40,3276,5298,3,1,3,0,1,0,61.83
嘉義縣,中埔鄉,和興村,0,1,2677,62,2739,4762,3,1,3,0,1,0,57.52
嘉義縣,中埔鄉,隆興村,0,1,1046,13,1059,1698,3,1,3,0,1,0,62.37
嘉義縣,中埔鄉,義仁村,0,1,847,7,854,1295,3,1,3,0,1,0,65.95
嘉義縣,中埔鄉,社口村,0,1,1250,18,1268,2060,3,1,3,0,1,0,61.55
嘉義縣,中埔鄉,灣潭村,0,1,662,12,674,1068,3,1,3,0,1,0,63.11
嘉義縣,中埔鄉,石硦村,0,1,779,7,786,1185,3,1,3,0,1,0,66.33
嘉義縣,中埔鄉,頂埔村,0,1,663,9,672,938,3,1,3,0,1,0,71.64
嘉義縣,中埔鄉,同仁村,0,1,1226,14,1240,1941,3,1,3,0,1,0,63.88
嘉義縣,中埔鄉,深坑村,0,1,532,10,542,736,3,1,3,0,1,0,73.64
嘉義縣,中埔鄉,三層村,0,1,419,6,425,627,3,1,3,0,1,0,67.78
嘉義縣,中埔鄉,瑞豐村,0,1,498,4,502,707,3,1,3,0,1,0,71.00
嘉義縣,中埔鄉,沄水村,0,1,754,8,762,1117,3,1,3,0,1,0,68.22
嘉義縣,中埔鄉,東興村,0,1,207,3,210,331,3,1,3,0,1,0,63.44
嘉義縣,中埔鄉,中崙村,0,1,234,0,234,323,3,1,3,0,1,0,72.45
嘉義縣,竹崎鄉,竹崎村,0,1,1419,27,1446,2200,3,1,3,0,1,0,65.73
嘉義縣,竹崎鄉,和平村,0,1,1153,23,1176,1866,3,1,3,0,1,0,63.02
嘉義縣,竹崎鄉,坑頭村,0,1,522,6,528,764,3,1,3,0,1,0,69.11
嘉義縣,竹崎鄉,沙坑村,0,1,587,6,593,868,3,1,3,0,1,0,68.32
嘉義縣,竹崎鄉,獅埜村,0,1,840,12,852,1293,3,1,3,0,1,0,65.89
嘉義縣,竹崎鄉,義和村,0,1,416,5,421,545,3,1,3,0,1,0,77.25
嘉義縣,竹崎鄉,義仁村,0,1,652,4,656,1049,3,1,3,0,1,0,62.54
嘉義縣,竹崎鄉,灣橋村,0,1,2829,42,2871,4641,3,1,3,0,1,0,61.86
嘉義縣,竹崎鄉,鹿滿村,0,1,802,14,816,1265,3,1,3,0,1,0,64.51
嘉義縣,竹崎鄉,紫雲村,0,1,830,7,837,1296,3,1,3,0,1,0,64.58
嘉義縣,竹崎鄉,內埔村,0,1,1008,12,1020,1591,3,1,3,0,1,0,64.11
嘉義縣,竹崎鄉,昇平村,0,1,1140,14,1154,1724,3,1,3,0,1,0,66.94
嘉義縣,竹崎鄉,桃源村,0,1,720,10,730,1068,3,1,3,0,1,0,68.35
嘉義縣,竹崎鄉,白杞村,0,1,470,10,480,773,3,1,3,0,1,0,62.10
嘉義縣,竹崎鄉,塘興村,0,1,598,6,604,904,3,1,3,0,1,0,66.81
嘉義縣,竹崎鄉,義隆村,0,1,403,4,407,586,3,1,3,0,1,0,69.45
嘉義縣,竹崎鄉,龍山村,0,1,1073,9,1082,1645,3,1,3,0,1,0,65.78
嘉義縣,竹崎鄉,文峯村,0,1,476,5,481,751,3,1,3,0,1,0,64.05
嘉義縣,竹崎鄉,金獅村,0,1,321,0,321,480,3,1,3,0,1,0,66.88
嘉義縣,竹崎鄉,復金村,0,1,1199,14,1213,1830,3,1,3,0,1,0,66.28
嘉義縣,竹崎鄉,緞繻村,0,1,642,8,650,1016,3,1,3,0,1,0,63.98
嘉義縣,竹崎鄉,仁壽村,0,1,163,2,165,298,3,1,3,0,1,0,55.37
嘉義縣,竹崎鄉,中和村,0,1,500,10,510,780,3,1,3,0,1,0,65.38
嘉義縣,竹崎鄉,光華村,0,1,461,5,466,744,3,1,3,0,1,0,62.63
嘉義縣,梅山鄉,梅東村,0,1,1466,21,1487,2371,3,1,3,0,1,0,62.72
嘉義縣,梅山鄉,梅南村,0,1,667,9,676,997,3,1,3,0,1,0,67.80
嘉義縣,梅山鄉,梅北村,0,1,2349,28,2377,3732,3,1,3,0,1,0,63.69
嘉義縣,梅山鄉,過山村,0,1,402,5,407,620,3,1,3,0,1,0,65.65
嘉義縣,梅山鄉,圳南村,0,1,325,4,329,501,3,1,3,0,1,0,65.67
嘉義縣,梅山鄉,圳北村,0,1,435,6,441,669,3,1,3,0,1,0,65.92
嘉義縣,梅山鄉,双溪村,0,1,433,1,434,573,3,1,3,0,1,0,75.74
嘉義縣,梅山鄉,大南村,0,1,1080,24,1104,1707,3,1,3,0,1,0,64.67
嘉義縣,梅山鄉,安靖村,0,1,541,5,546,934,3,1,3,0,1,0,58.46
嘉義縣,梅山鄉,永興村,0,1,292,7,299,503,3,1,3,0,1,0,59.44
嘉義縣,梅山鄉,半天村,0,1,281,3,284,456,3,1,3,0,1,0,62.28
嘉義縣,梅山鄉,太平村,0,1,315,4,319,497,3,1,3,0,1,0,64.19
嘉義縣,梅山鄉,太興村,0,1,278,6,284,395,3,1,3,0,1,0,71.90
嘉義縣,梅山鄉,龍眼村,0,1,264,6,270,478,3,1,3,0,1,0,56.49
嘉義縣,梅山鄉,碧湖村,0,1,187,0,187,291,3,1,3,0,1,0,64.26
嘉義縣,梅山鄉,瑞峯村,0,1,454,7,461,743,3,1,3,0,1,0,62.05
嘉義縣,梅山鄉,瑞里村,0,1,493,8,501,736,3,1,3,0,1,0,68.07
嘉義縣,梅山鄉,太和村,0,1,673,12,685,1021,3,1,3,0,1,0,67.09
嘉義縣,番路鄉,江西村,0,1,669,13,682,994,3,1,3,0,1,0,68.61
嘉義縣,番路鄉,內甕村,0,1,236,4,240,389,3,1,3,0,1,0,61.70
嘉義縣,番路鄉,新福村,0,1,532,6,538,799,3,1,3,0,1,0,67.33
嘉義縣,番路鄉,下坑村,0,1,1011,24,1035,1604,3,1,3,0,1,0,64.53
嘉義縣,番路鄉,番路村,0,1,551,13,564,815,3,1,3,0,1,0,69.20
嘉義縣,番路鄉,民和村,0,1,466,13,479,773,3,1,3,0,1,0,61.97
嘉義縣,番路鄉,觸口村,0,1,595,10,605,834,3,1,3,0,1,0,72.54
嘉義縣,番路鄉,大湖村,0,1,462,4,466,821,3,1,3,0,1,0,56.76
嘉義縣,番路鄉,公田村,0,1,567,15,582,949,3,1,3,0,1,0,61.33
嘉義縣,番路鄉,公興村,0,1,304,6,310,581,3,1,3,0,1,0,53.36
嘉義縣,番路鄉,草山村,0,1,240,2,242,394,3,1,3,0,1,0,61.42
嘉義縣,大埔鄉,大埔村,0,1,568,9,577,1043,3,1,3,0,1,0,55.32
嘉義縣,大埔鄉,和平村,0,1,263,5,268,470,3,1,3,0,1,0,57.02
嘉義縣,大埔鄉,永樂村,0,1,237,4,241,342,3,1,3,0,1,0,70.47
嘉義縣,大埔鄉,茄苳村,0,1,404,6,410,760,3,1,3,0,1,0,53.95
嘉義縣,大埔鄉,西興村,0,1,204,0,204,368,3,1,3,0,1,0,55.43
嘉義縣,阿里山鄉,中山村,0,1,187,4,191,333,3,1,3,0,1,0,57.36
嘉義縣,阿里山鄉,中正村,0,1,95,1,96,163,3,1,3,0,1,0,58.90
嘉義縣,阿里山鄉,香林村,0,1,102,1,103,216,3,1,3,0,1,0,47.69
嘉義縣,阿里山鄉,十字村,0,1,149,5,154,299,3,1,3,0,1,0,51.51
嘉義縣,阿里山鄉,豐山村,0,1,165,3,168,254,3,1,3,0,1,0,66.14
嘉義縣,阿里山鄉,來吉村,0,1,17,1,18,25,3,1,3,0,1,0,72.00
嘉義縣,阿里山鄉,樂野村,0,1,170,5,175,254,3,1,3,0,1,0,68.90
嘉義縣,阿里山鄉,達邦村,0,1,59,0,59,116,3,1,3,0,1,0,50.86
嘉義縣,阿里山鄉,里佳村,0,1,6,0,6,18,3,1,3,0,1,0,33.33
嘉義縣,阿里山鄉,山美村,0,1,9,2,11,26,3,1,3,0,1,0,42.31
嘉義縣,阿里山鄉,新美村,0,1,10,0,10,22,3,1,3,0,1,0,45.45
嘉義縣,阿里山鄉,茶山村,0,1,56,1,57,94,3,1,3,0,1,0,60.64
臺南縣,新營市,忠政里,0,1,2731,23,2754,4233,3,1,3,0,1,0,65.06
臺南縣,新營市,民權里,0,1,1577,14,1591,2448,3,1,3,0,1,0,64.99
臺南縣,新營市,三仙里,0,1,1682,13,1695,2684,3,1,3,0,1,0,63.15
臺南縣,新營市,好平里,0,1,518,6,524,900,3,1,3,0,1,0,58.22
臺南縣,新營市,延平里,0,1,783,10,793,1260,3,1,3,0,1,0,62.94
臺南縣,新營市,永生里,0,1,651,7,658,966,3,1,3,0,1,0,68.12
臺南縣,新營市,大宏里,0,1,1963,23,1986,3232,3,1,3,0,1,0,61.45
臺南縣,新營市,王公里,0,1,3803,50,3853,5989,3,1,3,0,1,0,64.33
臺南縣,新營市,中營里,0,1,628,8,636,1010,3,1,3,0,1,0,62.97
臺南縣,新營市,土庫里,0,1,886,16,902,1422,3,1,3,0,1,0,63.43
臺南縣,新營市,興安里,0,1,309,4,313,470,3,1,3,0,1,0,66.60
臺南縣,新營市,南興里,0,1,1534,23,1557,2406,3,1,3,0,1,0,64.71
臺南縣,新營市,興業里,0,1,979,5,984,1535,3,1,3,0,1,0,64.10
臺南縣,新營市,民生里,0,1,1801,20,1821,2975,3,1,3,0,1,0,61.21
臺南縣,新營市,新北里,0,1,1963,16,1979,3187,3,1,3,0,1,0,62.10
臺南縣,新營市,新南里,0,1,1547,19,1566,2466,3,1,3,0,1,0,63.50
臺南縣,新營市,民榮里,0,1,2293,38,2331,3797,3,1,3,0,1,0,61.39
臺南縣,新營市,埤寮里,0,1,993,12,1005,1583,3,1,3,0,1,0,63.49
臺南縣,新營市,護鎮里,0,1,796,11,807,1239,3,1,3,0,1,0,65.13
臺南縣,新營市,太南里,0,1,889,14,903,1464,3,1,3,0,1,0,61.68
臺南縣,新營市,太北里,0,1,1007,16,1023,1508,3,1,3,0,1,0,67.84
臺南縣,新營市,南紙里,0,1,1759,24,1783,2791,3,1,3,0,1,0,63.88
臺南縣,新營市,嘉芳里,0,1,935,17,952,1466,3,1,3,0,1,0,64.94
臺南縣,新營市,舊埔里,0,1,232,1,233,359,3,1,3,0,1,0,64.90
臺南縣,新營市,角帶里,0,1,322,5,327,457,3,1,3,0,1,0,71.55
臺南縣,新營市,鐵線里,0,1,490,4,494,743,3,1,3,0,1,0,66.49
臺南縣,新營市,五興里,0,1,630,9,639,996,3,1,3,0,1,0,64.16
臺南縣,新營市,姑爺里,0,1,388,5,393,584,3,1,3,0,1,0,67.29
臺南縣,鹽水鎮,水秀里,0,1,843,15,858,1341,3,1,3,0,1,0,63.98
臺南縣,鹽水鎮,福得里,0,1,367,0,367,549,3,1,3,0,1,0,66.85
臺南縣,鹽水鎮,三生里,0,1,259,2,261,386,3,1,3,0,1,0,67.62
臺南縣,鹽水鎮,武廟里,0,1,378,4,382,556,3,1,3,0,1,0,68.71
臺南縣,鹽水鎮,中境里,0,1,376,3,379,541,3,1,3,0,1,0,70.06
臺南縣,鹽水鎮,水仙里,0,1,239,4,243,392,3,1,3,0,1,0,61.99
臺南縣,鹽水鎮,水正里,0,1,519,7,526,785,3,1,3,0,1,0,67.01
臺南縣,鹽水鎮,橋南里,0,1,1856,27,1883,3118,3,1,3,0,1,0,60.39
臺南縣,鹽水鎮,舊營里,0,1,477,3,480,753,3,1,3,0,1,0,63.75
臺南縣,鹽水鎮,汫水里,0,1,611,10,621,1000,3,1,3,0,1,0,62.10
臺南縣,鹽水鎮,岸內里,0,1,2083,25,2108,3207,3,1,3,0,1,0,65.73
臺南縣,鹽水鎮,義稠里,0,1,414,1,415,696,3,1,3,0,1,0,59.63
臺南縣,鹽水鎮,下中里,0,1,483,11,494,787,3,1,3,0,1,0,62.77
臺南縣,鹽水鎮,歡雅里,0,1,1040,8,1048,1620,3,1,3,0,1,0,64.69
臺南縣,鹽水鎮,大莊里,0,1,339,6,345,512,3,1,3,0,1,0,67.38
臺南縣,鹽水鎮,桐寮里,0,1,216,5,221,284,3,1,3,0,1,0,77.82
臺南縣,鹽水鎮,後宅里,0,1,420,8,428,702,3,1,3,0,1,0,60.97
臺南縣,鹽水鎮,孫厝里,0,1,298,5,303,497,3,1,3,0,1,0,60.97
臺南縣,鹽水鎮,竹埔里,0,1,562,8,570,805,3,1,3,0,1,0,70.81
臺南縣,鹽水鎮,下林里,0,1,288,4,292,437,3,1,3,0,1,0,66.82
臺南縣,鹽水鎮,田寮里,0,1,192,3,195,274,3,1,3,0,1,0,71.17
臺南縣,鹽水鎮,大豐里,0,1,277,4,281,375,3,1,3,0,1,0,74.93
臺南縣,鹽水鎮,飯店里,0,1,251,3,254,412,3,1,3,0,1,0,61.65
臺南縣,鹽水鎮,河南里,0,1,367,8,375,573,3,1,3,0,1,0,65.45
臺南縣,鹽水鎮,南港里,0,1,661,5,666,941,3,1,3,0,1,0,70.78
臺南縣,白河鎮,白河里,0,1,1212,15,1227,1876,3,1,3,0,1,0,65.41
臺南縣,白河鎮,永安里,0,1,1733,13,1746,2752,3,1,3,0,1,0,63.44
臺南縣,白河鎮,外角里,0,1,910,13,923,1455,3,1,3,0,1,0,63.44
臺南縣,白河鎮,庄內里,0,1,964,11,975,1514,3,1,3,0,1,0,64.40
臺南縣,白河鎮,秀祐里,0,1,530,11,541,864,3,1,3,0,1,0,62.62
臺南縣,白河鎮,河東里,0,1,824,16,840,1369,3,1,3,0,1,0,61.36
臺南縣,白河鎮,虎山里,0,1,298,4,302,477,3,1,3,0,1,0,63.31
臺南縣,白河鎮,大林里,0,1,369,7,376,621,3,1,3,0,1,0,60.55
臺南縣,白河鎮,崁頭里,0,1,321,2,323,479,3,1,3,0,1,0,67.43
臺南縣,白河鎮,六溪里,0,1,362,9,371,658,3,1,3,0,1,0,56.38
臺南縣,白河鎮,關嶺里,0,1,721,7,728,1238,3,1,3,0,1,0,58.80
臺南縣,白河鎮,仙草里,0,1,1125,44,1169,2000,3,1,3,0,1,0,58.45
臺南縣,白河鎮,玉豐里,0,1,827,11,838,1242,3,1,3,0,1,0,67.47
臺南縣,白河鎮,大竹里,0,1,876,14,890,1356,3,1,3,0,1,0,65.63
臺南縣,白河鎮,詔安里,0,1,602,10,612,883,3,1,3,0,1,0,69.31
臺南縣,白河鎮,廣安里,0,1,443,8,451,684,3,1,3,0,1,0,65.94
臺南縣,白河鎮,蓮潭里,0,1,612,10,622,904,3,1,3,0,1,0,68.81
臺南縣,白河鎮,竹門里,0,1,608,8,616,931,3,1,3,0,1,0,66.17
臺南縣,白河鎮,崎內里,0,1,512,8,520,781,3,1,3,0,1,0,66.58
臺南縣,白河鎮,昇安里,0,1,825,13,838,1275,3,1,3,0,1,0,65.73
臺南縣,白河鎮,汴頭里,0,1,507,9,516,751,3,1,3,0,1,0,68.71
臺南縣,白河鎮,內角里,0,1,496,9,505,785,3,1,3,0,1,0,64.33
臺南縣,白河鎮,草店里,0,1,609,7,616,936,3,1,3,0,1,0,65.81
臺南縣,白河鎮,甘宅里,0,1,416,5,421,675,3,1,3,0,1,0,62.37
臺南縣,柳營鄉,士林村,0,1,970,14,984,1481,3,1,3,0,1,0,66.44
臺南縣,柳營鄉,光福村,0,1,1195,11,1206,1741,3,1,3,0,1,0,69.27
臺南縣,柳營鄉,中埕村,0,1,482,7,489,702,3,1,3,0,1,0,69.66
臺南縣,柳營鄉,東昇村,0,1,1609,35,1644,2428,3,1,3,0,1,0,67.71
臺南縣,柳營鄉,八翁村,0,1,867,4,871,1253,3,1,3,0,1,0,69.51
臺南縣,柳營鄉,人和村,0,1,539,8,547,780,3,1,3,0,1,0,70.13
臺南縣,柳營鄉,太康村,0,1,1060,15,1075,1481,3,1,3,0,1,0,72.59
臺南縣,柳營鄉,重溪村,0,1,1285,16,1301,1783,3,1,3,0,1,0,72.97
臺南縣,柳營鄉,篤農村,0,1,924,13,937,1398,3,1,3,0,1,0,67.02
臺南縣,柳營鄉,大農村,0,1,465,4,469,666,3,1,3,0,1,0,70.42
臺南縣,柳營鄉,神農村,0,1,894,13,907,1394,3,1,3,0,1,0,65.06
臺南縣,柳營鄉,果毅村,0,1,834,12,846,1242,3,1,3,0,1,0,68.12
臺南縣,柳營鄉,旭山村,0,1,1091,12,1103,1663,3,1,3,0,1,0,66.33
臺南縣,後壁鄉,後壁村,0,1,1013,15,1028,1508,3,1,3,0,1,0,68.17
臺南縣,後壁鄉,侯伯村,0,1,865,6,871,1282,3,1,3,0,1,0,67.94
臺南縣,後壁鄉,嘉苳村,0,1,821,9,830,1279,3,1,3,0,1,0,64.89
臺南縣,後壁鄉,土溝村,0,1,855,18,873,1309,3,1,3,0,1,0,66.69
臺南縣,後壁鄉,嘉田村,0,1,787,12,799,1173,3,1,3,0,1,0,68.12
臺南縣,後壁鄉,嘉民村,0,1,813,7,820,1240,3,1,3,0,1,0,66.13
臺南縣,後壁鄉,菁豐村,0,1,481,8,489,806,3,1,3,0,1,0,60.67
臺南縣,後壁鄉,崁頂村,0,1,350,8,358,499,3,1,3,0,1,0,71.74
臺南縣,後壁鄉,後廍村,0,1,306,18,324,565,3,1,3,0,1,0,57.35
臺南縣,後壁鄉,墨林村,0,1,519,9,528,809,3,1,3,0,1,0,65.27
臺南縣,後壁鄉,菁寮村,0,1,305,1,306,450,3,1,3,0,1,0,68.00
臺南縣,後壁鄉,新嘉村,0,1,743,11,754,1139,3,1,3,0,1,0,66.20
臺南縣,後壁鄉,頂長村,0,1,351,4,355,538,3,1,3,0,1,0,65.99
臺南縣,後壁鄉,平安村,0,1,673,7,680,1046,3,1,3,0,1,0,65.01
臺南縣,後壁鄉,仕安村,0,1,367,4,371,568,3,1,3,0,1,0,65.32
臺南縣,後壁鄉,竹新村,0,1,1022,15,1037,1426,3,1,3,0,1,0,72.72
臺南縣,後壁鄉,新東村,0,1,975,10,985,1486,3,1,3,0,1,0,66.29
臺南縣,後壁鄉,頂安村,0,1,748,16,764,1195,3,1,3,0,1,0,63.93
臺南縣,後壁鄉,長安村,0,1,927,8,935,1370,3,1,3,0,1,0,68.25
臺南縣,後壁鄉,福安村,0,1,758,9,767,1147,3,1,3,0,1,0,66.87
臺南縣,後壁鄉,烏樹村,0,1,527,13,540,845,3,1,3,0,1,0,63.91
臺南縣,東山鄉,東山村,0,1,864,11,875,1459,3,1,3,0,1,0,59.97
臺南縣,東山鄉,東中村,0,1,1483,12,1495,2327,3,1,3,0,1,0,64.25
臺南縣,東山鄉,東正村,0,1,952,14,966,1571,3,1,3,0,1,0,61.49
臺南縣,東山鄉,三榮村,0,1,595,9,604,945,3,1,3,0,1,0,63.92
臺南縣,東山鄉,大客村,0,1,656,4,660,1175,3,1,3,0,1,0,56.17
臺南縣,東山鄉,科里村,0,1,941,13,954,1384,3,1,3,0,1,0,68.93
臺南縣,東山鄉,東河村,0,1,561,7,568,908,3,1,3,0,1,0,62.56
臺南縣,東山鄉,聖賢村,0,1,1277,8,1285,1874,3,1,3,0,1,0,68.57
臺南縣,東山鄉,南溪村,0,1,349,6,355,517,3,1,3,0,1,0,68.67
臺南縣,東山鄉,水雲村,0,1,280,1,281,499,3,1,3,0,1,0,56.31
臺南縣,東山鄉,林安村,0,1,249,3,252,396,3,1,3,0,1,0,63.64
臺南縣,東山鄉,東原村,0,1,1364,14,1378,2259,3,1,3,0,1,0,61.00
臺南縣,東山鄉,嶺南村,0,1,414,1,415,776,3,1,3,0,1,0,53.48
臺南縣,東山鄉,南勢村,0,1,668,4,672,1130,3,1,3,0,1,0,59.47
臺南縣,東山鄉,青山村,0,1,679,7,686,1116,3,1,3,0,1,0,61.47
臺南縣,東山鄉,高原村,0,1,584,3,587,949,3,1,3,0,1,0,61.85
臺南縣,麻豆鎮,穀興里,0,1,466,2,468,632,3,1,3,0,1,0,74.05
臺南縣,麻豆鎮,保安里,0,1,422,2,424,614,3,1,3,0,1,0,69.06
臺南縣,麻豆鎮,東角里,0,1,1413,12,1425,2022,3,1,3,0,1,0,70.47
臺南縣,麻豆鎮,晉江里,0,1,1513,21,1534,2295,3,1,3,0,1,0,66.84
臺南縣,麻豆鎮,巷口里,0,1,965,7,972,1393,3,1,3,0,1,0,69.78
臺南縣,麻豆鎮,中興里,0,1,1242,9,1251,1865,3,1,3,0,1,0,67.08
臺南縣,麻豆鎮,興農里,0,1,915,14,929,1320,3,1,3,0,1,0,70.38
臺南縣,麻豆鎮,新建里,0,1,699,4,703,1013,3,1,3,0,1,0,69.40
臺南縣,麻豆鎮,油車里,0,1,1945,15,1960,2882,3,1,3,0,1,0,68.01
臺南縣,麻豆鎮,北勢里,0,1,825,9,834,1151,3,1,3,0,1,0,72.46
臺南縣,麻豆鎮,大埕里,0,1,1634,17,1651,2438,3,1,3,0,1,0,67.72
臺南縣,麻豆鎮,總榮里,0,1,469,3,472,645,3,1,3,0,1,0,73.18
臺南縣,麻豆鎮,龍泉里,0,1,551,9,560,722,3,1,3,0,1,0,77.56
臺南縣,麻豆鎮,南勢里,0,1,1547,20,1567,2245,3,1,3,0,1,0,69.80
臺南縣,麻豆鎮,寮廍里,0,1,1040,9,1049,1466,3,1,3,0,1,0,71.56
臺南縣,麻豆鎮,小埤里,0,1,662,6,668,912,3,1,3,0,1,0,73.25
臺南縣,麻豆鎮,埤頭里,0,1,966,14,980,1298,3,1,3,0,1,0,75.50
臺南縣,麻豆鎮,大山里,0,1,395,4,399,514,3,1,3,0,1,0,77.63
臺南縣,麻豆鎮,海埔里,0,1,739,6,745,977,3,1,3,0,1,0,76.25
臺南縣,麻豆鎮,莊禮里,0,1,404,3,407,537,3,1,3,0,1,0,75.79
臺南縣,麻豆鎮,港尾里,0,1,740,12,752,1104,3,1,3,0,1,0,68.12
臺南縣,麻豆鎮,麻口里,0,1,731,5,736,1021,3,1,3,0,1,0,72.09
臺南縣,麻豆鎮,安東里,0,1,433,4,437,602,3,1,3,0,1,0,72.59
臺南縣,麻豆鎮,安業里,0,1,464,4,468,673,3,1,3,0,1,0,69.54
臺南縣,麻豆鎮,安西里,0,1,496,6,502,710,3,1,3,0,1,0,70.70
臺南縣,麻豆鎮,謝安里,0,1,666,9,675,895,3,1,3,0,1,0,75.42
臺南縣,麻豆鎮,中民里,0,1,619,7,626,813,3,1,3,0,1,0,77.00
臺南縣,麻豆鎮,安正里,0,1,578,8,586,802,3,1,3,0,1,0,73.07
臺南縣,麻豆鎮,磚井里,0,1,818,12,830,1120,3,1,3,0,1,0,74.11
臺南縣,下營鄉,下營村,0,1,680,2,682,980,3,1,3,0,1,0,69.59
臺南縣,下營鄉,仁里村,0,1,1717,18,1735,2582,3,1,3,0,1,0,67.20
臺南縣,下營鄉,宅內村,0,1,756,10,766,1149,3,1,3,0,1,0,66.67
臺南縣,下營鄉,後街村,0,1,1032,14,1046,1514,3,1,3,0,1,0,69.09
臺南縣,下營鄉,新興村,0,1,1391,14,1405,2079,3,1,3,0,1,0,67.58
臺南縣,下營鄉,營前村,0,1,1421,13,1434,2139,3,1,3,0,1,0,67.04
臺南縣,下營鄉,大屯村,0,1,570,3,573,785,3,1,3,0,1,0,72.99
臺南縣,下營鄉,大埤村,0,1,550,10,560,766,3,1,3,0,1,0,73.11
臺南縣,下營鄉,茅港村,0,1,830,13,843,1189,3,1,3,0,1,0,70.90
臺南縣,下營鄉,中營村,0,1,790,10,800,1107,3,1,3,0,1,0,72.27
臺南縣,下營鄉,開化村,0,1,1271,13,1284,1816,3,1,3,0,1,0,70.70
臺南縣,下營鄉,西連村,0,1,640,8,648,893,3,1,3,0,1,0,72.56
臺南縣,下營鄉,賀建村,0,1,883,9,892,1317,3,1,3,0,1,0,67.73
臺南縣,下營鄉,甲中村,0,1,836,10,846,1181,3,1,3,0,1,0,71.63
臺南縣,下營鄉,紅厝村,0,1,852,15,867,1245,3,1,3,0,1,0,69.64
臺南縣,六甲鄉,六甲村,0,1,1849,21,1870,2747,3,1,3,0,1,0,68.07
臺南縣,六甲鄉,甲東村,0,1,1579,18,1597,2463,3,1,3,0,1,0,64.84
臺南縣,六甲鄉,甲南村,0,1,900,7,907,1336,3,1,3,0,1,0,67.89
臺南縣,六甲鄉,龍湖村,0,1,696,6,702,1040,3,1,3,0,1,0,67.50
臺南縣,六甲鄉,七甲村,0,1,595,8,603,863,3,1,3,0,1,0,69.87
臺南縣,六甲鄉,二甲村,0,1,1849,28,1877,2799,3,1,3,0,1,0,67.06
臺南縣,六甲鄉,水林村,0,1,1271,19,1290,1856,3,1,3,0,1,0,69.50
臺南縣,六甲鄉,中社村,0,1,1030,17,1047,1551,3,1,3,0,1,0,67.50
臺南縣,六甲鄉,龜港村,0,1,737,12,749,1087,3,1,3,0,1,0,68.91
臺南縣,六甲鄉,菁埔村,0,1,392,6,398,583,3,1,3,0,1,0,68.27
臺南縣,六甲鄉,王爺村,0,1,565,6,571,881,3,1,3,0,1,0,64.81
臺南縣,六甲鄉,大丘村,0,1,476,7,483,736,3,1,3,0,1,0,65.63
臺南縣,官田鄉,官田村,0,1,1265,18,1283,1925,3,1,3,0,1,0,66.65
臺南縣,官田鄉,二鎮村,0,1,1581,9,1590,2336,3,1,3,0,1,0,68.07
臺南縣,官田鄉,湖山村,0,1,727,13,740,1040,3,1,3,0,1,0,71.15
臺南縣,官田鄉,嘉南村,0,1,204,4,208,316,3,1,3,0,1,0,65.82
臺南縣,官田鄉,大崎村,0,1,324,1,325,500,3,1,3,0,1,0,65.00
臺南縣,官田鄉,隆田村,0,1,1257,10,1267,1834,3,1,3,0,1,0,69.08
臺南縣,官田鄉,隆本村,0,1,1941,27,1968,2799,3,1,3,0,1,0,70.31
臺南縣,官田鄉,南廍村,0,1,711,12,723,1095,3,1,3,0,1,0,66.03
臺南縣,官田鄉,東庄村,0,1,1008,11,1019,1387,3,1,3,0,1,0,73.47
臺南縣,官田鄉,西庄村,0,1,474,7,481,671,3,1,3,0,1,0,71.68
臺南縣,官田鄉,拔林村,0,1,448,5,453,601,3,1,3,0,1,0,75.37
臺南縣,官田鄉,渡頭村,0,1,1560,23,1583,2202,3,1,3,0,1,0,71.89
臺南縣,官田鄉,社子村,0,1,607,8,615,913,3,1,3,0,1,0,67.36
臺南縣,大內鄉,石湖村,0,1,725,11,736,1105,3,1,3,0,1,0,66.61
臺南縣,大內鄉,石林村,0,1,502,2,504,760,3,1,3,0,1,0,66.32
臺南縣,大內鄉,石城村,0,1,978,6,984,1524,3,1,3,0,1,0,64.57
臺南縣,大內鄉,內江村,0,1,746,12,758,1110,3,1,3,0,1,0,68.29
臺南縣,大內鄉,大內村,0,1,576,8,584,847,3,1,3,0,1,0,68.95
臺南縣,大內鄉,內郭村,0,1,434,6,440,690,3,1,3,0,1,0,63.77
臺南縣,大內鄉,頭社村,0,1,655,4,659,1057,3,1,3,0,1,0,62.35
臺南縣,大內鄉,環湖村,0,1,590,4,594,915,3,1,3,0,1,0,64.92
臺南縣,大內鄉,二溪村,0,1,557,9,566,954,3,1,3,0,1,0,59.33
臺南縣,大內鄉,曲溪村,0,1,454,1,455,650,3,1,3,0,1,0,70.00
臺南縣,佳里鎮,東寧里,0,1,1231,13,1244,1808,3,1,3,0,1,0,68.81
臺南縣,佳里鎮,忠仁里,0,1,1820,22,1842,2637,3,1,3,0,1,0,69.85
臺南縣,佳里鎮,鎮山里,0,1,3133,25,3158,4554,3,1,3,0,1,0,69.35
臺南縣,佳里鎮,建南里,0,1,3818,38,3856,5679,3,1,3,0,1,0,67.90
臺南縣,佳里鎮,安西里,0,1,5514,56,5570,8270,3,1,3,0,1,0,67.35
臺南縣,佳里鎮,六安里,0,1,2183,22,2205,3113,3,1,3,0,1,0,70.83
臺南縣,佳里鎮,佳化里,0,1,1323,19,1342,1833,3,1,3,0,1,0,73.21
臺南縣,佳里鎮,禮化里,0,1,634,4,638,848,3,1,3,0,1,0,75.24
臺南縣,佳里鎮,興化里,0,1,1059,9,1068,1339,3,1,3,0,1,0,79.76
臺南縣,佳里鎮,營頂里,0,1,491,2,493,691,3,1,3,0,1,0,71.35
臺南縣,佳里鎮,溪洲里,0,1,293,2,295,395,3,1,3,0,1,0,74.68
臺南縣,佳里鎮,海澄里,0,1,907,12,919,1355,3,1,3,0,1,0,67.82
臺南縣,佳里鎮,漳洲里,0,1,474,1,475,644,3,1,3,0,1,0,73.76
臺南縣,佳里鎮,頂廍里,0,1,588,10,598,830,3,1,3,0,1,0,72.05
臺南縣,佳里鎮,嘉福里,0,1,684,5,689,970,3,1,3,0,1,0,71.03
臺南縣,佳里鎮,通興里,0,1,757,10,767,1093,3,1,3,0,1,0,70.17
臺南縣,佳里鎮,蚶寮里,0,1,611,6,617,813,3,1,3,0,1,0,75.89
臺南縣,佳里鎮,龍安里,0,1,764,6,770,995,3,1,3,0,1,0,77.39
臺南縣,佳里鎮,民安里,0,1,894,11,905,1255,3,1,3,0,1,0,72.11
臺南縣,佳里鎮,子龍里,0,1,1068,13,1081,1534,3,1,3,0,1,0,70.47
臺南縣,佳里鎮,三協里,0,1,593,6,599,863,3,1,3,0,1,0,69.41
臺南縣,學甲鎮,一秀里,0,1,797,8,805,1177,3,1,3,0,1,0,68.39
臺南縣,學甲鎮,西明里,0,1,854,7,861,1307,3,1,3,0,1,0,65.88
臺南縣,學甲鎮,宜民里,0,1,350,4,354,503,3,1,3,0,1,0,70.38
臺南縣,學甲鎮,煥昌里,0,1,607,6,613,870,3,1,3,0,1,0,70.46
臺南縣,學甲鎮,慈生里,0,1,432,4,436,625,3,1,3,0,1,0,69.76
臺南縣,學甲鎮,仁得里,0,1,2353,16,2369,3524,3,1,3,0,1,0,67.22
臺南縣,學甲鎮,新生里,0,1,958,14,972,1481,3,1,3,0,1,0,65.63
臺南縣,學甲鎮,百福里,0,1,913,9,922,1322,3,1,3,0,1,0,69.74
臺南縣,學甲鎮,新榮里,0,1,922,10,932,1409,3,1,3,0,1,0,66.15
臺南縣,學甲鎮,文化里,0,1,404,2,406,559,3,1,3,0,1,0,72.63
臺南縣,學甲鎮,大安里,0,1,363,1,364,521,3,1,3,0,1,0,69.87
臺南縣,學甲鎮,美豐里,0,1,566,3,569,834,3,1,3,0,1,0,68.23
臺南縣,學甲鎮,美和里,0,1,211,5,216,327,3,1,3,0,1,0,66.06
臺南縣,學甲鎮,達明里,0,1,446,6,452,662,3,1,3,0,1,0,68.28
臺南縣,學甲鎮,光明里,0,1,210,4,214,336,3,1,3,0,1,0,63.69
臺南縣,學甲鎮,民吉里,0,1,298,3,301,423,3,1,3,0,1,0,71.16
臺南縣,學甲鎮,西進里,0,1,324,3,327,505,3,1,3,0,1,0,64.75
臺南縣,學甲鎮,白渚里,0,1,217,1,218,332,3,1,3,0,1,0,65.66
臺南縣,學甲鎮,光華里,0,1,587,4,591,885,3,1,3,0,1,0,66.78
臺南縣,學甲鎮,頭港里,0,1,291,2,293,444,3,1,3,0,1,0,65.99
臺南縣,學甲鎮,宅港里,0,1,694,5,699,1093,3,1,3,0,1,0,63.95
臺南縣,學甲鎮,平東里,0,1,332,7,339,505,3,1,3,0,1,0,67.13
臺南縣,學甲鎮,平西里,0,1,450,10,460,710,3,1,3,0,1,0,64.79
臺南縣,學甲鎮,頂洲里,0,1,467,4,471,684,3,1,3,0,1,0,68.86
臺南縣,學甲鎮,紅茄里,0,1,313,3,316,489,3,1,3,0,1,0,64.62
臺南縣,學甲鎮,新芳里,0,1,299,3,302,461,3,1,3,0,1,0,65.51
臺南縣,西港鄉,西港村,0,1,1933,23,1956,2744,3,1,3,0,1,0,71.28
臺南縣,西港鄉,慶安村,0,1,2406,15,2421,3453,3,1,3,0,1,0,70.11
臺南縣,西港鄉,南海村,0,1,1404,24,1428,1910,3,1,3,0,1,0,74.76
臺南縣,西港鄉,港東村,0,1,939,9,948,1311,3,1,3,0,1,0,72.31
臺南縣,西港鄉,檨林村,0,1,1093,21,1114,1562,3,1,3,0,1,0,71.32
臺南縣,西港鄉,後營村,0,1,922,10,932,1316,3,1,3,0,1,0,70.82
臺南縣,西港鄉,營西村,0,1,891,5,896,1285,3,1,3,0,1,0,69.73
臺南縣,西港鄉,金砂村,0,1,590,9,599,827,3,1,3,0,1,0,72.43
臺南縣,西港鄉,劉厝村,0,1,850,9,859,1152,3,1,3,0,1,0,74.57
臺南縣,西港鄉,竹林村,0,1,845,10,855,1171,3,1,3,0,1,0,73.01
臺南縣,西港鄉,永樂村,0,1,665,5,670,876,3,1,3,0,1,0,76.48
臺南縣,西港鄉,新復村,0,1,531,6,537,727,3,1,3,0,1,0,73.87
臺南縣,西港鄉,永樂村,0,1,284,4,288,407,3,1,3,0,1,0,70.76
臺南縣,七股鄉,後港村,0,1,370,5,375,537,3,1,3,0,1,0,69.83
臺南縣,七股鄉,大潭村,0,1,463,4,467,743,3,1,3,0,1,0,62.85
臺南縣,七股鄉,城內村,0,1,411,4,415,511,3,1,3,0,1,0,81.21
臺南縣,七股鄉,篤加村,0,1,548,9,557,817,3,1,3,0,1,0,68.18
臺南縣,七股鄉,頂山村,0,1,663,3,666,939,3,1,3,0,1,0,70.93
臺南縣,七股鄉,西寮村,0,1,375,6,381,550,3,1,3,0,1,0,69.27
臺南縣,七股鄉,鹽埕村,0,1,301,5,306,458,3,1,3,0,1,0,66.81
臺南縣,七股鄉,中寮村,0,1,544,11,555,784,3,1,3,0,1,0,70.79
臺南縣,七股鄉,龍山村,0,1,1151,19,1170,1680,3,1,3,0,1,0,69.64
臺南縣,七股鄉,溪南村,0,1,284,7,291,382,3,1,3,0,1,0,76.18
臺南縣,七股鄉,七股村,0,1,563,7,570,882,3,1,3,0,1,0,64.63
臺南縣,七股鄉,玉成村,0,1,550,5,555,822,3,1,3,0,1,0,67.52
臺南縣,七股鄉,大埕村,0,1,885,15,900,1359,3,1,3,0,1,0,66.23
臺南縣,七股鄉,大寮村,0,1,655,7,662,949,3,1,3,0,1,0,69.76
臺南縣,七股鄉,看坪村,0,1,363,5,368,580,3,1,3,0,1,0,63.45
臺南縣,七股鄉,樹林村,0,1,699,4,703,1026,3,1,3,0,1,0,68.52
臺南縣,七股鄉,竹港村,0,1,439,2,441,586,3,1,3,0,1,0,75.26
臺南縣,七股鄉,竹橋村,0,1,552,8,560,751,3,1,3,0,1,0,74.57
臺南縣,七股鄉,義合村,0,1,664,3,667,995,3,1,3,0,1,0,67.04
臺南縣,七股鄉,康榔村,0,1,462,12,474,641,3,1,3,0,1,0,73.95
臺南縣,七股鄉,永吉村,0,1,575,7,582,878,3,1,3,0,1,0,66.29
臺南縣,七股鄉,三股村,0,1,1225,39,1264,1809,3,1,3,0,1,0,69.87
臺南縣,七股鄉,十份村,0,1,881,12,893,1326,3,1,3,0,1,0,67.35
臺南縣,將軍鄉,長榮村,0,1,640,3,643,921,3,1,3,0,1,0,69.82
臺南縣,將軍鄉,西華村,0,1,892,6,898,1296,3,1,3,0,1,0,69.29
臺南縣,將軍鄉,西和村,0,1,716,12,728,1038,3,1,3,0,1,0,70.13
臺南縣,將軍鄉,忠興村,0,1,981,5,986,1477,3,1,3,0,1,0,66.76
臺南縣,將軍鄉,嘉昌村,0,1,642,12,654,920,3,1,3,0,1,0,71.09
臺南縣,將軍鄉,保源村,0,1,742,12,754,1029,3,1,3,0,1,0,73.28
臺南縣,將軍鄉,苓和村,0,1,695,3,698,1047,3,1,3,0,1,0,66.67
臺南縣,將軍鄉,仁和村,0,1,509,3,512,793,3,1,3,0,1,0,64.56
臺南縣,將軍鄉,北埔村,0,1,441,1,442,644,3,1,3,0,1,0,68.63
臺南縣,將軍鄉,將富村,0,1,450,5,455,718,3,1,3,0,1,0,63.37
臺南縣,將軍鄉,將貴村,0,1,415,5,420,609,3,1,3,0,1,0,68.97
臺南縣,將軍鄉,三吉村,0,1,301,1,302,426,3,1,3,0,1,0,70.89
臺南縣,將軍鄉,玉山村,0,1,577,7,584,895,3,1,3,0,1,0,65.25
臺南縣,將軍鄉,廣山村,0,1,476,7,483,715,3,1,3,0,1,0,67.55
臺南縣,將軍鄉,長沙村,0,1,898,13,911,1444,3,1,3,0,1,0,63.09
臺南縣,將軍鄉,平沙村,0,1,810,5,815,1307,3,1,3,0,1,0,62.36
臺南縣,將軍鄉,鯤鯓村,0,1,1296,9,1305,2021,3,1,3,0,1,0,64.57
臺南縣,將軍鄉,鯤溟村,0,1,610,8,618,1012,3,1,3,0,1,0,61.07
臺南縣,北門鄉,北門村,0,1,623,7,630,906,3,1,3,0,1,0,69.54
臺南縣,北門鄉,永隆村,0,1,347,2,349,509,3,1,3,0,1,0,68.57
臺南縣,北門鄉,永華村,0,1,268,7,275,405,3,1,3,0,1,0,67.90
臺南縣,北門鄉,玉港村,0,1,522,7,529,785,3,1,3,0,1,0,67.39
臺南縣,北門鄉,保吉村,0,1,884,7,891,1334,3,1,3,0,1,0,66.79
臺南縣,北門鄉,東壁村,0,1,456,10,466,749,3,1,3,0,1,0,62.22
臺南縣,北門鄉,鯤江村,0,1,516,3,519,761,3,1,3,0,1,0,68.20
臺南縣,北門鄉,雙春村,0,1,383,3,386,594,3,1,3,0,1,0,64.98
臺南縣,北門鄉,錦湖村,0,1,679,7,686,1087,3,1,3,0,1,0,63.11
臺南縣,北門鄉,慈安村,0,1,424,6,430,653,3,1,3,0,1,0,65.85
臺南縣,北門鄉,三光村,0,1,767,7,774,1156,3,1,3,0,1,0,66.96
臺南縣,北門鄉,中樞村,0,1,418,4,422,707,3,1,3,0,1,0,59.69
臺南縣,北門鄉,仁里村,0,1,482,6,488,712,3,1,3,0,1,0,68.54
臺南縣,新化鎮,武安里,0,1,1108,10,1118,1602,3,1,3,0,1,0,69.79
臺南縣,新化鎮,東榮里,0,1,2433,21,2454,3715,3,1,3,0,1,0,66.06
臺南縣,新化鎮,護國里,0,1,1033,22,1055,1605,3,1,3,0,1,0,65.73
臺南縣,新化鎮,太平里,0,1,2481,25,2506,3653,3,1,3,0,1,0,68.60
臺南縣,新化鎮,中央里,0,1,301,1,302,438,3,1,3,0,1,0,68.95
臺南縣,新化鎮,觀音里,0,1,430,2,432,633,3,1,3,0,1,0,68.25
臺南縣,新化鎮,竹林里,0,1,317,5,322,435,3,1,3,0,1,0,74.02
臺南縣,新化鎮,清水里,0,1,694,7,701,1008,3,1,3,0,1,0,69.54
臺南縣,新化鎮,協興里,0,1,1966,30,1996,2932,3,1,3,0,1,0,68.08
臺南縣,新化鎮,唪口里,0,1,1091,14,1105,1600,3,1,3,0,1,0,69.06
臺南縣,新化鎮,北勢里,0,1,809,2,811,1147,3,1,3,0,1,0,70.71
臺南縣,新化鎮,豐榮里,0,1,1657,20,1677,2397,3,1,3,0,1,0,69.96
臺南縣,新化鎮,全興里,0,1,1307,9,1316,1919,3,1,3,0,1,0,68.58
臺南縣,新化鎮,崙頂里,0,1,1205,22,1227,1722,3,1,3,0,1,0,71.25
臺南縣,新化鎮,知義里,0,1,1414,35,1449,2072,3,1,3,0,1,0,69.93
臺南縣,新化鎮,山腳里,0,1,861,5,866,1268,3,1,3,0,1,0,68.30
臺南縣,新化鎮,大坑里,0,1,337,5,342,499,3,1,3,0,1,0,68.54
臺南縣,新化鎮,那拔里,0,1,1353,20,1373,2002,3,1,3,0,1,0,68.58
臺南縣,新化鎮,羊林里,0,1,549,5,554,838,3,1,3,0,1,0,66.11
臺南縣,新化鎮,礁坑里,0,1,727,8,735,1042,3,1,3,0,1,0,70.54
臺南縣,善化鎮,東關里,0,1,620,4,624,926,3,1,3,0,1,0,67.39
臺南縣,善化鎮,坐駕里,0,1,1749,25,1774,2564,3,1,3,0,1,0,69.19
臺南縣,善化鎮,光文里,0,1,2667,38,2705,3969,3,1,3,0,1,0,68.15
臺南縣,善化鎮,文昌里,0,1,1358,7,1365,2058,3,1,3,0,1,0,66.33
臺南縣,善化鎮,南關里,0,1,853,9,862,1306,3,1,3,0,1,0,66.00
臺南縣,善化鎮,西關里,0,1,439,7,446,663,3,1,3,0,1,0,67.27
臺南縣,善化鎮,北關里,0,1,324,3,327,470,3,1,3,0,1,0,69.57
臺南縣,善化鎮,文正里,0,1,761,12,773,1160,3,1,3,0,1,0,66.64
臺南縣,善化鎮,胡家里,0,1,966,12,978,1274,3,1,3,0,1,0,76.77
臺南縣,善化鎮,胡厝里,0,1,1308,31,1339,1845,3,1,3,0,1,0,72.57
臺南縣,善化鎮,什乃里,0,1,625,15,640,879,3,1,3,0,1,0,72.81
臺南縣,善化鎮,溪美里,0,1,1152,8,1160,1608,3,1,3,0,1,0,72.14
臺南縣,善化鎮,六分里,0,1,477,4,481,667,3,1,3,0,1,0,72.11
臺南縣,善化鎮,六德里,0,1,736,8,744,1070,3,1,3,0,1,0,69.53
臺南縣,善化鎮,田寮里,0,1,1230,16,1246,1748,3,1,3,0,1,0,71.28
臺南縣,善化鎮,東隆里,0,1,633,9,642,860,3,1,3,0,1,0,74.65
臺南縣,善化鎮,東昌里,0,1,658,5,663,1006,3,1,3,0,1,0,65.90
臺南縣,善化鎮,牛庄里,0,1,917,13,930,1368,3,1,3,0,1,0,67.98
臺南縣,善化鎮,嘉北里,0,1,958,10,968,1351,3,1,3,0,1,0,71.65
臺南縣,善化鎮,嘉南里,0,1,692,6,698,1038,3,1,3,0,1,0,67.24
臺南縣,善化鎮,小新里,0,1,1770,22,1792,2678,3,1,3,0,1,0,66.92
臺南縣,新市鄉,新市村,0,1,1589,23,1612,2395,3,1,3,0,1,0,67.31
臺南縣,新市鄉,新和村,0,1,3441,41,3482,5139,3,1,3,0,1,0,67.76
臺南縣,新市鄉,社內村,0,1,1253,10,1263,1806,3,1,3,0,1,0,69.93
臺南縣,新市鄉,大洲村,0,1,436,9,445,603,3,1,3,0,1,0,73.80
臺南縣,新市鄉,豐華村,0,1,571,7,578,881,3,1,3,0,1,0,65.61
臺南縣,新市鄉,三舍村,0,1,730,4,734,1003,3,1,3,0,1,0,73.18
臺南縣,新市鄉,大營村,0,1,1661,20,1681,2315,3,1,3,0,1,0,72.61
臺南縣,新市鄉,大社村,0,1,2216,28,2244,3212,3,1,3,0,1,0,69.86
臺南縣,新市鄉,潭頂村,0,1,1060,14,1074,1500,3,1,3,0,1,0,71.60
臺南縣,新市鄉,港墘村,0,1,1915,21,1936,2806,3,1,3,0,1,0,69.00
臺南縣,新市鄉,永就村,0,1,1466,19,1485,2162,3,1,3,0,1,0,68.69
臺南縣,安定鄉,蘇林村,0,1,1416,18,1434,2030,3,1,3,0,1,0,70.64
臺南縣,安定鄉,蘇厝村,0,1,1181,14,1195,1750,3,1,3,0,1,0,68.29
臺南縣,安定鄉,安定村,0,1,958,8,966,1336,3,1,3,0,1,0,72.31
臺南縣,安定鄉,安加村,0,1,858,7,865,1150,3,1,3,0,1,0,75.22
臺南縣,安定鄉,保西村,0,1,547,7,554,718,3,1,3,0,1,0,77.16
臺南縣,安定鄉,港尾村,0,1,1200,15,1215,1501,3,1,3,0,1,0,80.95
臺南縣,安定鄉,中榮村,0,1,681,11,692,961,3,1,3,0,1,0,72.01
臺南縣,安定鄉,港口村,0,1,1526,22,1548,2114,3,1,3,0,1,0,73.23
臺南縣,安定鄉,港南村,0,1,1516,22,1538,2148,3,1,3,0,1,0,71.60
臺南縣,安定鄉,大同村,0,1,470,7,477,643,3,1,3,0,1,0,74.18
臺南縣,安定鄉,六嘉村,0,1,917,10,927,1348,3,1,3,0,1,0,68.77
臺南縣,安定鄉,中沙村,0,1,496,2,498,697,3,1,3,0,1,0,71.45
臺南縣,安定鄉,新吉村,0,1,1211,20,1231,1710,3,1,3,0,1,0,71.99
臺南縣,安定鄉,海寮村,0,1,1574,17,1591,2168,3,1,3,0,1,0,73.39
臺南縣,安定鄉,管寮村,0,1,659,2,661,908,3,1,3,0,1,0,72.80
臺南縣,安定鄉,南安村,0,1,393,7,400,490,3,1,3,0,1,0,81.63
臺南縣,山上鄉,明和村,0,1,1158,18,1176,1741,3,1,3,0,1,0,67.55
臺南縣,山上鄉,南洲村,0,1,1100,5,1105,1516,3,1,3,0,1,0,72.89
臺南縣,山上鄉,山上村,0,1,590,13,603,886,3,1,3,0,1,0,68.06
臺南縣,山上鄉,新莊村,0,1,491,5,496,746,3,1,3,0,1,0,66.49
臺南縣,山上鄉,玉峰村,0,1,387,5,392,576,3,1,3,0,1,0,68.06
臺南縣,山上鄉,平陽村,0,1,259,5,264,352,3,1,3,0,1,0,75.00
臺南縣,山上鄉,豐德村,0,1,236,3,239,354,3,1,3,0,1,0,67.51
臺南縣,玉井鄉,玉井村,0,1,641,4,645,914,3,1,3,0,1,0,70.57
臺南縣,玉井鄉,玉田村,0,1,2677,31,2708,4051,3,1,3,0,1,0,66.85
臺南縣,玉井鄉,中正村,0,1,890,12,902,1279,3,1,3,0,1,0,70.52
臺南縣,玉井鄉,竹圍村,0,1,875,4,879,1370,3,1,3,0,1,0,64.16
臺南縣,玉井鄉,沙田村,0,1,346,6,352,496,3,1,3,0,1,0,70.97
臺南縣,玉井鄉,三埔村,0,1,310,1,311,489,3,1,3,0,1,0,63.60
臺南縣,玉井鄉,三和村,0,1,553,5,558,776,3,1,3,0,1,0,71.91
臺南縣,玉井鄉,望明村,0,1,1104,21,1125,1579,3,1,3,0,1,0,71.25
臺南縣,玉井鄉,層林村,0,1,526,4,530,682,3,1,3,0,1,0,77.71
臺南縣,玉井鄉,豐里村,0,1,685,9,694,1021,3,1,3,0,1,0,67.97
臺南縣,楠西鄉,楠西村,0,1,1273,19,1292,1935,3,1,3,0,1,0,66.77
臺南縣,楠西鄉,灣丘村,0,1,784,17,801,1261,3,1,3,0,1,0,63.52
臺南縣,楠西鄉,密枝村,0,1,599,3,602,856,3,1,3,0,1,0,70.33
臺南縣,楠西鄉,照興村,0,1,696,13,709,1066,3,1,3,0,1,0,66.51
臺南縣,楠西鄉,鹿田村,0,1,737,3,740,1040,3,1,3,0,1,0,71.15
臺南縣,楠西鄉,龜丹村,0,1,513,9,522,720,3,1,3,0,1,0,72.50
臺南縣,楠西鄉,東勢村,0,1,1568,12,1580,2251,3,1,3,0,1,0,70.19
臺南縣,南化鄉,南化村,0,1,982,10,992,1388,3,1,3,0,1,0,71.47
臺南縣,南化鄉,小崙村,0,1,558,4,562,801,3,1,3,0,1,0,70.16
臺南縣,南化鄉,東和村,0,1,451,1,452,673,3,1,3,0,1,0,67.16
臺南縣,南化鄉,中坑村,0,1,339,3,342,495,3,1,3,0,1,0,69.09
臺南縣,南化鄉,北平村,0,1,431,1,432,585,3,1,3,0,1,0,73.85
臺南縣,南化鄉,西埔村,0,1,552,7,559,825,3,1,3,0,1,0,67.76
臺南縣,南化鄉,北寮村,0,1,805,9,814,1222,3,1,3,0,1,0,66.61
臺南縣,南化鄉,玉山村,0,1,638,6,644,917,3,1,3,0,1,0,70.23
臺南縣,南化鄉,關山村,0,1,298,4,302,549,3,1,3,0,1,0,55.01
臺南縣,左鎮鄉,光和村,0,1,267,4,271,429,3,1,3,0,1,0,63.17
臺南縣,左鎮鄉,榮和村,0,1,502,8,510,720,3,1,3,0,1,0,70.83
臺南縣,左鎮鄉,左鎮村,0,1,342,2,344,530,3,1,3,0,1,0,64.91
臺南縣,左鎮鄉,中正村,0,1,651,3,654,904,3,1,3,0,1,0,72.35
臺南縣,左鎮鄉,睦光村,0,1,264,3,267,370,3,1,3,0,1,0,72.16
臺南縣,左鎮鄉,內庄村,0,1,311,8,319,463,3,1,3,0,1,0,68.90
臺南縣,左鎮鄉,岡林村,0,1,288,2,290,430,3,1,3,0,1,0,67.44
臺南縣,左鎮鄉,草山村,0,1,209,3,212,328,3,1,3,0,1,0,64.63
臺南縣,左鎮鄉,二寮村,0,1,172,1,173,244,3,1,3,0,1,0,70.90
臺南縣,左鎮鄉,澄山村,0,1,384,2,386,585,3,1,3,0,1,0,65.98
臺南縣,仁德鄉,太子村,0,1,2729,22,2751,3946,3,1,3,0,1,0,69.72
臺南縣,仁德鄉,土庫村,0,1,1602,13,1615,2221,3,1,3,0,1,0,72.71
臺南縣,仁德鄉,一甲村,0,1,1227,13,1240,1830,3,1,3,0,1,0,67.76
臺南縣,仁德鄉,仁德村,0,1,2354,23,2377,3865,3,1,3,0,1,0,61.50
臺南縣,仁德鄉,仁義村,0,1,4195,53,4248,6358,3,1,3,0,1,0,66.81
臺南縣,仁德鄉,新田村,0,1,1624,19,1643,2509,3,1,3,0,1,0,65.48
臺南縣,仁德鄉,後壁村,0,1,3912,54,3966,6233,3,1,3,0,1,0,63.63
臺南縣,仁德鄉,上崙村,0,1,2390,27,2417,3928,3,1,3,0,1,0,61.53
臺南縣,仁德鄉,田厝村,0,1,974,14,988,1303,3,1,3,0,1,0,75.83
臺南縣,仁德鄉,三甲村,0,1,472,2,474,697,3,1,3,0,1,0,68.01
臺南縣,仁德鄉,保安村,0,1,1407,21,1428,2145,3,1,3,0,1,0,66.57
臺南縣,仁德鄉,成功村,0,1,2339,33,2372,3554,3,1,3,0,1,0,66.74
臺南縣,仁德鄉,仁和村,0,1,755,19,774,1123,3,1,3,0,1,0,68.92
臺南縣,仁德鄉,仁愛村,0,1,1279,31,1310,1989,3,1,3,0,1,0,65.86
臺南縣,仁德鄉,二行村,0,1,1357,30,1387,1996,3,1,3,0,1,0,69.49
臺南縣,仁德鄉,大甲村,0,1,1396,27,1423,1928,3,1,3,0,1,0,73.81
臺南縣,仁德鄉,中洲村,0,1,859,6,865,1242,3,1,3,0,1,0,69.65
臺南縣,仁德鄉,中生村,0,1,983,12,995,1393,3,1,3,0,1,0,71.43
臺南縣,歸仁鄉,南保村,0,1,2965,31,2996,4533,3,1,3,0,1,0,66.09
臺南縣,歸仁鄉,南興村,0,1,1728,11,1739,2682,3,1,3,0,1,0,64.84
臺南縣,歸仁鄉,六甲村,0,1,1966,32,1998,2997,3,1,3,0,1,0,66.67
臺南縣,歸仁鄉,歸南村,0,1,1283,19,1302,1954,3,1,3,0,1,0,66.63
臺南縣,歸仁鄉,後市村,0,1,2013,19,2032,2915,3,1,3,0,1,0,69.71
臺南縣,歸仁鄉,文化村,0,1,1430,21,1451,2274,3,1,3,0,1,0,63.81
臺南縣,歸仁鄉,辜厝村,0,1,1685,23,1708,2583,3,1,3,0,1,0,66.12
臺南縣,歸仁鄉,新厝村,0,1,1373,7,1380,2010,3,1,3,0,1,0,68.66
臺南縣,歸仁鄉,許厝村,0,1,1882,13,1895,2730,3,1,3,0,1,0,69.41
臺南縣,歸仁鄉,看西村,0,1,968,11,979,1334,3,1,3,0,1,0,73.39
臺南縣,歸仁鄉,看東村,0,1,876,7,883,1305,3,1,3,0,1,0,67.66
臺南縣,歸仁鄉,崙頂村,0,1,1351,9,1360,1878,3,1,3,0,1,0,72.42
臺南縣,歸仁鄉,沙崙村,0,1,395,5,400,568,3,1,3,0,1,0,70.42
臺南縣,歸仁鄉,大潭村,0,1,1134,16,1150,1678,3,1,3,0,1,0,68.53
臺南縣,歸仁鄉,武東村,0,1,728,10,738,1173,3,1,3,0,1,0,62.92
臺南縣,歸仁鄉,歸仁村,0,1,1316,10,1326,1944,3,1,3,0,1,0,68.21
臺南縣,歸仁鄉,八甲村,0,1,1450,13,1463,2070,3,1,3,0,1,0,70.68
臺南縣,歸仁鄉,七甲村,0,1,1397,9,1406,2042,3,1,3,0,1,0,68.85
臺南縣,歸仁鄉,媽廟村,0,1,1235,5,1240,1804,3,1,3,0,1,0,68.74
臺南縣,歸仁鄉,西埔村,0,1,931,12,943,1307,3,1,3,0,1,0,72.15
臺南縣,歸仁鄉,大廟村,0,1,1463,24,1487,2207,3,1,3,0,1,0,67.38
臺南縣,關廟鄉,關廟村,0,1,1379,4,1383,1903,3,1,3,0,1,0,72.67
臺南縣,關廟鄉,山西村,0,1,1366,8,1374,1838,3,1,3,0,1,0,74.76
臺南縣,關廟鄉,香洋村,0,1,2501,18,2519,3409,3,1,3,0,1,0,73.89
臺南縣,關廟鄉,北勢村,0,1,1905,10,1915,2500,3,1,3,0,1,0,76.60
臺南縣,關廟鄉,新埔村,0,1,615,6,621,840,3,1,3,0,1,0,73.93
臺南縣,關廟鄉,新光村,0,1,533,4,537,745,3,1,3,0,1,0,72.08
臺南縣,關廟鄉,五甲村,0,1,1861,16,1877,2617,3,1,3,0,1,0,71.72
臺南縣,關廟鄉,東勢村,0,1,2038,24,2062,2943,3,1,3,0,1,0,70.06
臺南縣,關廟鄉,松腳村,0,1,1367,10,1377,1874,3,1,3,0,1,0,73.48
臺南縣,關廟鄉,南花村,0,1,1045,5,1050,1425,3,1,3,0,1,0,73.68
臺南縣,關廟鄉,北花村,0,1,1489,19,1508,2076,3,1,3,0,1,0,72.64
臺南縣,關廟鄉,深坑村,0,1,1127,11,1138,1511,3,1,3,0,1,0,75.31
臺南縣,關廟鄉,布袋村,0,1,794,9,803,1196,3,1,3,0,1,0,67.14
臺南縣,關廟鄉,田中村,0,1,532,4,536,730,3,1,3,0,1,0,73.42
臺南縣,關廟鄉,龜洞村,0,1,566,3,569,761,3,1,3,0,1,0,74.77
臺南縣,關廟鄉,埤頭村,0,1,1051,8,1059,1494,3,1,3,0,1,0,70.88
臺南縣,關廟鄉,下湖村,0,1,290,2,292,376,3,1,3,0,1,0,77.66
臺南縣,龍崎鄉,崎頂村,0,1,838,7,845,1145,3,1,3,0,1,0,73.80
臺南縣,龍崎鄉,土崎村,0,1,498,2,500,694,3,1,3,0,1,0,72.05
臺南縣,龍崎鄉,中坑村,0,1,115,1,116,197,3,1,3,0,1,0,58.88
臺南縣,龍崎鄉,楠坑村,0,1,224,4,228,306,3,1,3,0,1,0,74.51
臺南縣,龍崎鄉,牛埔村,0,1,204,1,205,270,3,1,3,0,1,0,75.93
臺南縣,龍崎鄉,大坪村,0,1,207,2,209,297,3,1,3,0,1,0,70.37
臺南縣,龍崎鄉,龍船村,0,1,324,1,325,425,3,1,3,0,1,0,76.47
臺南縣,龍崎鄉,石曹村,0,1,268,4,272,383,3,1,3,0,1,0,71.02
臺南縣,永康市,五王里,0,1,2218,22,2240,3824,3,1,3,0,1,0,58.58
臺南縣,永康市,三合里,0,1,1692,17,1709,2787,3,1,3,0,1,0,61.32
臺南縣,永康市,六合里,0,1,1856,25,1881,3285,3,1,3,0,1,0,57.26
臺南縣,永康市,網寮里,0,1,2432,18,2450,3929,3,1,3,0,1,0,62.36
臺南縣,永康市,二王里,0,1,3342,46,3388,5481,3,1,3,0,1,0,61.81
臺南縣,永康市,永康里,0,1,3475,39,3514,5735,3,1,3,0,1,0,61.27
臺南縣,永康市,埔園里,0,1,3196,36,3232,5276,3,1,3,0,1,0,61.26
臺南縣,永康市,正強里,0,1,3467,35,3502,5506,3,1,3,0,1,0,63.60
臺南縣,永康市,大橋里,0,1,2425,13,2438,3963,3,1,3,0,1,0,61.52
臺南縣,永康市,東橋里,0,1,1400,17,1417,2204,3,1,3,0,1,0,64.29
臺南縣,永康市,西橋里,0,1,1392,19,1411,2325,3,1,3,0,1,0,60.69
臺南縣,永康市,安康里,0,1,1957,14,1971,3352,3,1,3,0,1,0,58.80
臺南縣,永康市,蔦松里,0,1,1016,16,1032,1456,3,1,3,0,1,0,70.88
臺南縣,永康市,三民里,0,1,747,13,760,1067,3,1,3,0,1,0,71.23
臺南縣,永康市,鹽行里,0,1,3647,35,3682,5934,3,1,3,0,1,0,62.05
臺南縣,永康市,鹽洲里,0,1,2756,36,2792,4259,3,1,3,0,1,0,65.56
臺南縣,永康市,甲頂里,0,1,1448,16,1464,2164,3,1,3,0,1,0,67.65
臺南縣,永康市,尚頂里,0,1,2084,24,2108,3273,3,1,3,0,1,0,64.41
臺南縣,永康市,龍潭里,0,1,3878,47,3925,6203,3,1,3,0,1,0,63.28
臺南縣,永康市,王行里,0,1,1241,13,1254,1814,3,1,3,0,1,0,69.13
臺南縣,永康市,烏竹里,0,1,1007,16,1023,1558,3,1,3,0,1,0,65.66
臺南縣,永康市,西勢里,0,1,2538,31,2569,3846,3,1,3,0,1,0,66.80
臺南縣,永康市,新樹里,0,1,794,4,798,1253,3,1,3,0,1,0,63.69
臺南縣,永康市,大灣里,0,1,2005,16,2021,2882,3,1,3,0,1,0,70.12
臺南縣,永康市,東灣里,0,1,2044,29,2073,3033,3,1,3,0,1,0,68.35
臺南縣,永康市,西灣里,0,1,3189,44,3233,4926,3,1,3,0,1,0,65.63
臺南縣,永康市,南灣里,0,1,2287,25,2312,3425,3,1,3,0,1,0,67.50
臺南縣,永康市,崑山里,0,1,3257,36,3293,5071,3,1,3,0,1,0,64.94
臺南縣,永康市,北灣里,0,1,3420,36,3456,5228,3,1,3,0,1,0,66.11
臺南縣,永康市,復興里,0,1,1162,31,1193,1741,3,1,3,0,1,0,68.52
臺南縣,永康市,光復里,0,1,765,13,778,1122,3,1,3,0,1,0,69.34
臺南縣,永康市,建國里,0,1,1320,30,1350,1982,3,1,3,0,1,0,68.11
臺南縣,永康市,復國里,0,1,1325,12,1337,2002,3,1,3,0,1,0,66.78
臺南縣,永康市,復華里,0,1,5708,55,5763,9641,3,1,3,0,1,0,59.78
臺南縣,永康市,神洲里,0,1,1108,16,1124,1699,3,1,3,0,1,0,66.16
臺南縣,永康市,成功里,0,1,1365,21,1386,2126,3,1,3,0,1,0,65.19
臺南縣,永康市,中華里,0,1,1254,5,1259,1968,3,1,3,0,1,0,63.97
臺南縣,永康市,中興里,0,1,1687,16,1703,2683,3,1,3,0,1,0,63.47
臺南縣,永康市,勝利里,0,1,2928,28,2956,5055,3,1,3,0,1,0,58.48
高雄縣,鳳山市,鳳崗里,0,1,792,9,801,1263,3,1,3,0,1,0,63.42
高雄縣,鳳山市,縣衙里,0,1,560,4,564,862,3,1,3,0,1,0,65.43
高雄縣,鳳山市,曹公里,0,1,1507,16,1523,2282,3,1,3,0,1,0,66.74
高雄縣,鳳山市,鎮西里,0,1,3164,38,3202,5008,3,1,3,0,1,0,63.94
高雄縣,鳳山市,北門里,0,1,2355,22,2377,3734,3,1,3,0,1,0,63.66
高雄縣,鳳山市,鎮北里,0,1,2671,21,2692,4213,3,1,3,0,1,0,63.90
高雄縣,鳳山市,武松里,0,1,1478,11,1489,2344,3,1,3,0,1,0,63.52
高雄縣,鳳山市,忠誠里,0,1,1895,26,1921,2947,3,1,3,0,1,0,65.18
高雄縣,鳳山市,文英里,0,1,1827,19,1846,2838,3,1,3,0,1,0,65.05
高雄縣,鳳山市,文華里,0,1,2717,36,2753,4152,3,1,3,0,1,0,66.31
高雄縣,鳳山市,文山里,0,1,3156,34,3190,4933,3,1,3,0,1,0,64.67
高雄縣,鳳山市,文德里,0,1,2844,22,2866,4908,3,1,3,0,1,0,58.39
高雄縣,鳳山市,文衡里,0,1,1313,9,1322,2041,3,1,3,0,1,0,64.77
高雄縣,鳳山市,文福里,0,1,3136,38,3174,5377,3,1,3,0,1,0,59.03
高雄縣,鳳山市,成功里,0,1,526,6,532,761,3,1,3,0,1,0,69.91
高雄縣,鳳山市,縣口里,0,1,324,1,325,497,3,1,3,0,1,0,65.39
高雄縣,鳳山市,光明里,0,1,939,7,946,1381,3,1,3,0,1,0,68.50
高雄縣,鳳山市,和德里,0,1,1059,9,1068,1634,3,1,3,0,1,0,65.36
高雄縣,鳳山市,和興里,0,1,3028,30,3058,4535,3,1,3,0,1,0,67.43
高雄縣,鳳山市,南興里,0,1,724,12,736,1082,3,1,3,0,1,0,68.02
高雄縣,鳳山市,三民里,0,1,734,10,744,1082,3,1,3,0,1,0,68.76
高雄縣,鳳山市,新興里,0,1,819,9,828,1250,3,1,3,0,1,0,66.24
高雄縣,鳳山市,興仁里,0,1,2342,24,2366,3617,3,1,3,0,1,0,65.41
高雄縣,鳳山市,興中里,0,1,503,6,509,777,3,1,3,0,1,0,65.51
高雄縣,鳳山市,協和里,0,1,2378,23,2401,3597,3,1,3,0,1,0,66.75
高雄縣,鳳山市,忠義里,0,1,2491,21,2512,4008,3,1,3,0,1,0,62.67
高雄縣,鳳山市,忠孝里,0,1,3433,37,3470,5385,3,1,3,0,1,0,64.44
高雄縣,鳳山市,中和里,0,1,2167,33,2200,3255,3,1,3,0,1,0,67.59
高雄縣,鳳山市,誠正里,0,1,670,7,677,980,3,1,3,0,1,0,69.08
高雄縣,鳳山市,誠義里,0,1,382,4,386,574,3,1,3,0,1,0,67.25
高雄縣,鳳山市,生明里,0,1,1000,2,1002,1436,3,1,3,0,1,0,69.78
高雄縣,鳳山市,鎮東里,0,1,1344,10,1354,2124,3,1,3,0,1,0,63.75
高雄縣,鳳山市,瑞竹里,0,1,3235,35,3270,4853,3,1,3,0,1,0,67.38
高雄縣,鳳山市,瑞興里,0,1,2333,27,2360,3776,3,1,3,0,1,0,62.50
高雄縣,鳳山市,東門里,0,1,2429,23,2452,3769,3,1,3,0,1,0,65.06
高雄縣,鳳山市,誠德里,0,1,1306,11,1317,2030,3,1,3,0,1,0,64.88
高雄縣,鳳山市,誠信里,0,1,1066,9,1075,1707,3,1,3,0,1,0,62.98
高雄縣,鳳山市,誠智里,0,1,1360,24,1384,2251,3,1,3,0,1,0,61.48
高雄縣,鳳山市,鳳東里,0,1,2529,26,2555,3877,3,1,3,0,1,0,65.90
高雄縣,鳳山市,埤頂里,0,1,2940,32,2972,4384,3,1,3,0,1,0,67.79
高雄縣,鳳山市,美齡里,0,1,575,6,581,849,3,1,3,0,1,0,68.43
高雄縣,鳳山市,中正里,0,1,1245,17,1262,1973,3,1,3,0,1,0,63.96
高雄縣,鳳山市,海光里,0,1,2569,30,2599,3862,3,1,3,0,1,0,67.30
高雄縣,鳳山市,海風里,0,1,1701,14,1715,2344,3,1,3,0,1,0,73.17
高雄縣,鳳山市,國泰里,0,1,2473,25,2498,3880,3,1,3,0,1,0,64.38
高雄縣,鳳山市,國光里,0,1,2184,21,2205,3556,3,1,3,0,1,0,62.01
高雄縣,鳳山市,國隆里,0,1,1562,17,1579,2607,3,1,3,0,1,0,60.57
高雄縣,鳳山市,國富里,0,1,1289,24,1313,2060,3,1,3,0,1,0,63.74
高雄縣,鳳山市,武慶里,0,1,1262,16,1278,1968,3,1,3,0,1,0,64.94
高雄縣,鳳山市,武漢里,0,1,2294,33,2327,3712,3,1,3,0,1,0,62.69
高雄縣,鳳山市,新甲里,0,1,1466,11,1477,2290,3,1,3,0,1,0,64.50
高雄縣,鳳山市,新武里,0,1,1141,16,1157,1887,3,1,3,0,1,0,61.31
高雄縣,鳳山市,新泰里,0,1,1528,16,1544,2567,3,1,3,0,1,0,60.15
高雄縣,鳳山市,新樂里,0,1,1961,19,1980,3218,3,1,3,0,1,0,61.53
高雄縣,鳳山市,新強里,0,1,2298,17,2315,3483,3,1,3,0,1,0,66.47
高雄縣,鳳山市,海洋里,0,1,1805,19,1824,2859,3,1,3,0,1,0,63.80
高雄縣,鳳山市,新富里,0,1,2031,23,2054,3347,3,1,3,0,1,0,61.37
高雄縣,鳳山市,老爺里,0,1,3563,43,3606,5851,3,1,3,0,1,0,61.63
高雄縣,鳳山市,中民里,0,1,1879,14,1893,3254,3,1,3,0,1,0,58.17
高雄縣,鳳山市,中崙里,0,1,1206,22,1228,1863,3,1,3,0,1,0,65.92
高雄縣,鳳山市,中榮里,0,1,2377,33,2410,3904,3,1,3,0,1,0,61.73
高雄縣,鳳山市,過埤里,0,1,1652,22,1674,2710,3,1,3,0,1,0,61.77
高雄縣,鳳山市,正義里,0,1,3639,37,3676,5979,3,1,3,0,1,0,61.48
高雄縣,鳳山市,一甲里,0,1,1905,22,1927,3155,3,1,3,0,1,0,61.08
高雄縣,鳳山市,二甲里,0,1,1853,24,1877,3091,3,1,3,0,1,0,60.72
高雄縣,鳳山市,龍成里,0,1,1554,31,1585,2599,3,1,3,0,1,0,60.98
高雄縣,鳳山市,鎮南里,0,1,2455,32,2487,3909,3,1,3,0,1,0,63.62
高雄縣,鳳山市,富甲里,0,1,1267,19,1286,1946,3,1,3,0,1,0,66.08
高雄縣,鳳山市,善美里,0,1,2432,30,2462,4357,3,1,3,0,1,0,56.51
高雄縣,鳳山市,富榮里,0,1,1161,8,1169,1894,3,1,3,0,1,0,61.72
高雄縣,鳳山市,南和里,0,1,1578,19,1597,2547,3,1,3,0,1,0,62.70
高雄縣,鳳山市,南成里,0,1,2216,26,2242,3488,3,1,3,0,1,0,64.28
高雄縣,鳳山市,天興里,0,1,2163,32,2195,3402,3,1,3,0,1,0,64.52
高雄縣,鳳山市,大德里,0,1,2010,25,2035,3190,3,1,3,0,1,0,63.79
高雄縣,鳳山市,五福里,0,1,2014,23,2037,2995,3,1,3,0,1,0,68.01
高雄縣,鳳山市,福興里,0,1,3248,38,3286,5223,3,1,3,0,1,0,62.91
高雄縣,鳳山市,福祥里,0,1,1428,17,1445,2441,3,1,3,0,1,0,59.20
高雄縣,鳳山市,福誠里,0,1,1649,22,1671,2740,3,1,3,0,1,0,60.99
高雄縣,林園鄉,仁愛村,0,1,1768,17,1785,2525,3,1,3,0,1,0,70.69
高雄縣,林園鄉,林園村,0,1,2029,25,2054,2941,3,1,3,0,1,0,69.84
高雄縣,林園鄉,文賢村,0,1,1408,13,1421,2078,3,1,3,0,1,0,68.38
高雄縣,林園鄉,東林村,0,1,1628,16,1644,2475,3,1,3,0,1,0,66.42
高雄縣,林園鄉,溪州村,0,1,2112,20,2132,3209,3,1,3,0,1,0,66.44
高雄縣,林園鄉,五福村,0,1,1123,18,1141,1807,3,1,3,0,1,0,63.14
高雄縣,林園鄉,潭頭村,0,1,1495,20,1515,2337,3,1,3,0,1,0,64.83
高雄縣,林園鄉,中厝村,0,1,1727,21,1748,2555,3,1,3,0,1,0,68.41
高雄縣,林園鄉,林內村,0,1,1205,16,1221,1738,3,1,3,0,1,0,70.25
高雄縣,林園鄉,王公村,0,1,2040,18,2058,2943,3,1,3,0,1,0,69.93
高雄縣,林園鄉,廣應村,0,1,1970,22,1992,2843,3,1,3,0,1,0,70.07
高雄縣,林園鄉,林家村,0,1,908,11,919,1224,3,1,3,0,1,0,75.08
高雄縣,林園鄉,龔厝村,0,1,1153,12,1165,1623,3,1,3,0,1,0,71.78
高雄縣,林園鄉,中門村,0,1,1340,14,1354,1950,3,1,3,0,1,0,69.44
高雄縣,林園鄉,頂厝村,0,1,2256,29,2285,3414,3,1,3,0,1,0,66.93
高雄縣,林園鄉,港埔村,0,1,1129,12,1141,1640,3,1,3,0,1,0,69.57
高雄縣,林園鄉,港嘴村,0,1,929,18,947,1282,3,1,3,0,1,0,73.87
高雄縣,林園鄉,西溪村,0,1,1810,18,1828,2697,3,1,3,0,1,0,67.78
高雄縣,林園鄉,中芸村,0,1,1164,12,1176,1704,3,1,3,0,1,0,69.01
高雄縣,林園鄉,鳳芸村,0,1,1190,12,1202,1692,3,1,3,0,1,0,71.04
高雄縣,林園鄉,東汕村,0,1,614,10,624,917,3,1,3,0,1,0,68.05
高雄縣,林園鄉,西汕村,0,1,449,15,464,704,3,1,3,0,1,0,65.91
高雄縣,林園鄉,中汕村,0,1,1339,17,1356,2130,3,1,3,0,1,0,63.66
高雄縣,林園鄉,北汕村,0,1,868,9,877,1461,3,1,3,0,1,0,60.03
高雄縣,大寮鄉,義和村,0,1,1334,19,1353,1975,3,1,3,0,1,0,68.51
高雄縣,大寮鄉,溪寮村,0,1,1011,13,1024,1386,3,1,3,0,1,0,73.88
高雄縣,大寮鄉,江山村,0,1,1069,8,1077,1492,3,1,3,0,1,0,72.18
高雄縣,大寮鄉,中庄村,0,1,5242,57,5299,8124,3,1,3,0,1,0,65.23
高雄縣,大寮鄉,後庄村,0,1,3119,62,3181,4989,3,1,3,0,1,0,63.76
高雄縣,大寮鄉,前庄村,0,1,1316,14,1330,1965,3,1,3,0,1,0,67.68
高雄縣,大寮鄉,中興村,0,1,3673,50,3723,5530,3,1,3,0,1,0,67.32
高雄縣,大寮鄉,忠義村,0,1,1669,20,1689,2357,3,1,3,0,1,0,71.66
高雄縣,大寮鄉,光武村,0,1,1422,20,1442,2001,3,1,3,0,1,0,72.06
高雄縣,大寮鄉,復興村,0,1,2563,37,2600,3566,3,1,3,0,1,0,72.91
高雄縣,大寮鄉,翁園村,0,1,1780,21,1801,2596,3,1,3,0,1,0,69.38
高雄縣,大寮鄉,琉球村,0,1,2007,21,2028,2958,3,1,3,0,1,0,68.56
高雄縣,大寮鄉,永芳村,0,1,3787,36,3823,5858,3,1,3,0,1,0,65.26
高雄縣,大寮鄉,山頂村,0,1,3543,33,3576,5496,3,1,3,0,1,0,65.07
高雄縣,大寮鄉,會社村,0,1,2957,20,2977,4410,3,1,3,0,1,0,67.51
高雄縣,大寮鄉,三隆村,0,1,2540,23,2563,3853,3,1,3,0,1,0,66.52
高雄縣,大寮鄉,上寮村,0,1,1385,6,1391,2031,3,1,3,0,1,0,68.49
高雄縣,大寮鄉,大寮村,0,1,3281,30,3311,5331,3,1,3,0,1,0,62.11
高雄縣,大寮鄉,拷潭村,0,1,877,12,889,1272,3,1,3,0,1,0,69.89
高雄縣,大寮鄉,內坑村,0,1,1991,23,2014,3422,3,1,3,0,1,0,58.85
高雄縣,大寮鄉,新厝村,0,1,872,18,890,1367,3,1,3,0,1,0,65.11
高雄縣,大寮鄉,過溪村,0,1,1152,17,1169,1727,3,1,3,0,1,0,67.69
高雄縣,大寮鄉,潮寮村,0,1,1803,16,1819,2540,3,1,3,0,1,0,71.61
高雄縣,大寮鄉,會結村,0,1,867,13,880,1219,3,1,3,0,1,0,72.19
高雄縣,大寮鄉,昭明村,0,1,1927,15,1942,2920,3,1,3,0,1,0,66.51
高雄縣,大寮鄉,義仁村,0,1,1176,11,1187,1758,3,1,3,0,1,0,67.52
高雄縣,大樹鄉,竹寮村,0,1,1331,15,1346,2050,3,1,3,0,1,0,65.66
高雄縣,大樹鄉,九曲村,0,1,2577,40,2617,4022,3,1,3,0,1,0,65.07
高雄縣,大樹鄉,久堂村,0,1,2770,38,2808,4011,3,1,3,0,1,0,70.01
高雄縣,大樹鄉,水安村,0,1,1492,12,1504,2146,3,1,3,0,1,0,70.08
高雄縣,大樹鄉,水寮村,0,1,1586,15,1601,2233,3,1,3,0,1,0,71.70
高雄縣,大樹鄉,井腳村,0,1,1089,13,1102,1551,3,1,3,0,1,0,71.05
高雄縣,大樹鄉,小坪村,0,1,874,9,883,1226,3,1,3,0,1,0,72.02
高雄縣,大樹鄉,龍目村,0,1,1153,11,1164,1566,3,1,3,0,1,0,74.33
高雄縣,大樹鄉,大樹村,0,1,1573,15,1588,2168,3,1,3,0,1,0,73.25
高雄縣,大樹鄉,檨腳村,0,1,2111,16,2127,3097,3,1,3,0,1,0,68.68
高雄縣,大樹鄉,興山村,0,1,721,6,727,1061,3,1,3,0,1,0,68.52
高雄縣,大樹鄉,和山村,0,1,674,4,678,952,3,1,3,0,1,0,71.22
高雄縣,大樹鄉,姑山村,0,1,689,12,701,988,3,1,3,0,1,0,70.95
高雄縣,大樹鄉,三和村,0,1,557,4,561,831,3,1,3,0,1,0,67.51
高雄縣,大樹鄉,大坑村,0,1,916,7,923,1328,3,1,3,0,1,0,69.50
高雄縣,大樹鄉,溪埔村,0,1,1220,10,1230,1765,3,1,3,0,1,0,69.69
高雄縣,大樹鄉,興田村,0,1,1164,5,1169,1905,3,1,3,0,1,0,61.36
高雄縣,大樹鄉,鐘鈴村,0,1,450,6,456,631,3,1,3,0,1,0,72.27
高雄縣,大社鄉,嘉誠村,0,1,623,15,638,965,3,1,3,0,1,0,66.11
高雄縣,大社鄉,保社村,0,1,1302,21,1323,2018,3,1,3,0,1,0,65.56
高雄縣,大社鄉,大社村,0,1,2639,30,2669,3977,3,1,3,0,1,0,67.11
高雄縣,大社鄉,保安村,0,1,1697,12,1709,2501,3,1,3,0,1,0,68.33
高雄縣,大社鄉,三奶村,0,1,1717,17,1734,2533,3,1,3,0,1,0,68.46
高雄縣,大社鄉,觀音村,0,1,3040,34,3074,4536,3,1,3,0,1,0,67.77
高雄縣,大社鄉,神農村,0,1,2223,25,2248,3488,3,1,3,0,1,0,64.45
高雄縣,大社鄉,中里村,0,1,1827,23,1850,2740,3,1,3,0,1,0,67.52
高雄縣,大社鄉,翠屏村,0,1,1030,18,1048,1449,3,1,3,0,1,0,72.33
高雄縣,仁武鄉,仁武村,0,1,2677,31,2708,4022,3,1,3,0,1,0,67.33
高雄縣,仁武鄉,文武村,0,1,2838,29,2867,4521,3,1,3,0,1,0,63.42
高雄縣,仁武鄉,後安村,0,1,1317,15,1332,2064,3,1,3,0,1,0,64.53
高雄縣,仁武鄉,竹後村,0,1,1474,22,1496,2165,3,1,3,0,1,0,69.10
高雄縣,仁武鄉,中華村,0,1,780,12,792,1264,3,1,3,0,1,0,62.66
高雄縣,仁武鄉,八卦村,0,1,2949,42,2991,4894,3,1,3,0,1,0,61.12
高雄縣,仁武鄉,五和村,0,1,1347,24,1371,2126,3,1,3,0,1,0,64.49
高雄縣,仁武鄉,高楠村,0,1,1175,26,1201,1698,3,1,3,0,1,0,70.73
高雄縣,仁武鄉,大灣村,0,1,994,14,1008,1622,3,1,3,0,1,0,62.15
高雄縣,仁武鄉,赤山村,0,1,1167,23,1190,1816,3,1,3,0,1,0,65.53
高雄縣,仁武鄉,仁和村,0,1,1135,13,1148,1794,3,1,3,0,1,0,63.99
高雄縣,仁武鄉,灣內村,0,1,1839,18,1857,2879,3,1,3,0,1,0,64.50
高雄縣,仁武鄉,仁慈村,0,1,767,7,774,1217,3,1,3,0,1,0,63.60
高雄縣,仁武鄉,考潭村,0,1,1633,25,1658,2521,3,1,3,0,1,0,65.77
高雄縣,仁武鄉,烏林村,0,1,1745,20,1765,2671,3,1,3,0,1,0,66.08
高雄縣,仁武鄉,仁福村,0,1,412,6,418,571,3,1,3,0,1,0,73.20
高雄縣,鳥松鄉,鳥松村,0,1,4365,49,4414,7065,3,1,3,0,1,0,62.48
高雄縣,鳥松鄉,夢裡村,0,1,1622,23,1645,2456,3,1,3,0,1,0,66.98
高雄縣,鳥松鄉,大華村,0,1,4308,53,4361,7032,3,1,3,0,1,0,62.02
高雄縣,鳥松鄉,濫埔村,0,1,1932,29,1961,2762,3,1,3,0,1,0,71.00
高雄縣,鳥松鄉,仁美村,0,1,3765,46,3811,5571,3,1,3,0,1,0,68.41
高雄縣,鳥松鄉,華美村,0,1,2125,26,2151,3079,3,1,3,0,1,0,69.86
高雄縣,鳥松鄉,大竹村,0,1,451,5,456,657,3,1,3,0,1,0,69.41
高雄縣,岡山鎮,岡山里,0,1,2342,19,2361,3636,3,1,3,0,1,0,64.93
高雄縣,岡山鎮,平安里,0,1,865,7,872,1273,3,1,3,0,1,0,68.50
高雄縣,岡山鎮,壽天里,0,1,1873,25,1898,2932,3,1,3,0,1,0,64.73
高雄縣,岡山鎮,維仁里,0,1,822,7,829,1235,3,1,3,0,1,0,67.13
高雄縣,岡山鎮,灣裡里,0,1,830,11,841,1219,3,1,3,0,1,0,68.99
高雄縣,岡山鎮,大遼里,0,1,853,9,862,1212,3,1,3,0,1,0,71.12
高雄縣,岡山鎮,後紅里,0,1,1819,16,1835,2891,3,1,3,0,1,0,63.47
高雄縣,岡山鎮,碧紅里,0,1,1811,18,1829,2865,3,1,3,0,1,0,63.84
高雄縣,岡山鎮,程香里,0,1,1839,18,1857,2744,3,1,3,0,1,0,67.67
高雄縣,岡山鎮,竹圍里,0,1,2547,31,2578,3976,3,1,3,0,1,0,64.84
高雄縣,岡山鎮,台上里,0,1,2208,26,2234,3349,3,1,3,0,1,0,66.71
高雄縣,岡山鎮,為隨里,0,1,415,3,418,572,3,1,3,0,1,0,73.08
高雄縣,岡山鎮,前峰里,0,1,1596,30,1626,2449,3,1,3,0,1,0,66.39
高雄縣,岡山鎮,壽峰里,0,1,1182,20,1202,1743,3,1,3,0,1,0,68.96
高雄縣,岡山鎮,仁壽里,0,1,2233,17,2250,3260,3,1,3,0,1,0,69.02
高雄縣,岡山鎮,協和里,0,1,2013,23,2036,3084,3,1,3,0,1,0,66.02
高雄縣,岡山鎮,本洲里,0,1,973,6,979,1360,3,1,3,0,1,0,71.99
高雄縣,岡山鎮,後協里,0,1,2940,36,2976,4649,3,1,3,0,1,0,64.01
高雄縣,岡山鎮,協榮里,0,1,1285,14,1299,1925,3,1,3,0,1,0,67.48
高雄縣,岡山鎮,劉厝里,0,1,934,9,943,1357,3,1,3,0,1,0,69.49
高雄縣,岡山鎮,白米里,0,1,658,5,663,872,3,1,3,0,1,0,76.03
高雄縣,岡山鎮,石潭里,0,1,874,7,881,1215,3,1,3,0,1,0,72.51
高雄縣,岡山鎮,福興里,0,1,747,8,755,1035,3,1,3,0,1,0,72.95
高雄縣,岡山鎮,嘉興里,0,1,2128,27,2155,3180,3,1,3,0,1,0,67.77
高雄縣,岡山鎮,嘉峰里,0,1,1177,15,1192,1624,3,1,3,0,1,0,73.40
高雄縣,岡山鎮,潭底里,0,1,555,18,573,737,3,1,3,0,1,0,77.75
高雄縣,岡山鎮,華崗里,0,1,1077,11,1088,1341,3,1,3,0,1,0,81.13
高雄縣,岡山鎮,三和里,0,1,539,6,545,731,3,1,3,0,1,0,74.56
高雄縣,岡山鎮,大莊里,0,1,594,12,606,869,3,1,3,0,1,0,69.74
高雄縣,岡山鎮,忠孝里,0,1,286,2,288,430,3,1,3,0,1,0,66.98
高雄縣,岡山鎮,和平里,0,1,613,11,624,916,3,1,3,0,1,0,68.12
高雄縣,岡山鎮,信義里,0,1,1433,19,1452,2124,3,1,3,0,1,0,68.36
高雄縣,岡山鎮,仁愛里,0,1,929,12,941,1361,3,1,3,0,1,0,69.14
高雄縣,岡山鎮,四維里,0,1,869,13,882,1194,3,1,3,0,1,0,73.87
高雄縣,岡山鎮,復興里,0,1,286,9,295,450,3,1,3,0,1,0,65.56
高雄縣,橋頭鄉,橋頭村,0,1,1107,15,1122,1620,3,1,3,0,1,0,69.26
高雄縣,橋頭鄉,橋南村,0,1,592,15,607,881,3,1,3,0,1,0,68.90
高雄縣,橋頭鄉,興糖村,0,1,186,1,187,258,3,1,3,0,1,0,72.48
高雄縣,橋頭鄉,仕隆村,0,1,1452,12,1464,2137,3,1,3,0,1,0,68.51
高雄縣,橋頭鄉,仕豐村,0,1,1410,17,1427,2134,3,1,3,0,1,0,66.87
高雄縣,橋頭鄉,仕和村,0,1,2140,24,2164,3167,3,1,3,0,1,0,68.33
高雄縣,橋頭鄉,新莊村,0,1,960,14,974,1282,3,1,3,0,1,0,75.98
高雄縣,橋頭鄉,甲北村,0,1,1295,25,1320,1907,3,1,3,0,1,0,69.22
高雄縣,橋頭鄉,甲南村,0,1,1462,24,1486,2034,3,1,3,0,1,0,73.06
高雄縣,橋頭鄉,頂鹽村,0,1,781,10,791,1069,3,1,3,0,1,0,73.99
高雄縣,橋頭鄉,白樹村,0,1,1790,28,1818,2629,3,1,3,0,1,0,69.15
高雄縣,橋頭鄉,芋寮村,0,1,1322,14,1336,1846,3,1,3,0,1,0,72.37
高雄縣,橋頭鄉,西林村,0,1,1071,20,1091,1467,3,1,3,0,1,0,74.37
高雄縣,橋頭鄉,東林村,0,1,1529,23,1552,2116,3,1,3,0,1,0,73.35
高雄縣,橋頭鄉,德松村,0,1,726,9,735,1023,3,1,3,0,1,0,71.85
高雄縣,橋頭鄉,筆秀村,0,1,1067,17,1084,1413,3,1,3,0,1,0,76.72
高雄縣,橋頭鄉,中崎村,0,1,432,2,434,647,3,1,3,0,1,0,67.08
高雄縣,燕巢鄉,金山村,0,1,317,1,318,432,3,1,3,0,1,0,73.61
高雄縣,燕巢鄉,尖山村,0,1,802,16,818,1113,3,1,3,0,1,0,73.50
高雄縣,燕巢鄉,東燕村,0,1,1654,16,1670,2208,3,1,3,0,1,0,75.63
高雄縣,燕巢鄉,西燕村,0,1,2113,11,2124,2969,3,1,3,0,1,0,71.54
高雄縣,燕巢鄉,南燕村,0,1,1889,22,1911,2621,3,1,3,0,1,0,72.91
高雄縣,燕巢鄉,瓊林村,0,1,1213,13,1226,1724,3,1,3,0,1,0,71.11
高雄縣,燕巢鄉,安招村,0,1,2752,62,2814,4037,3,1,3,0,1,0,69.71
高雄縣,燕巢鄉,角宿村,0,1,1521,29,1550,2135,3,1,3,0,1,0,72.60
高雄縣,燕巢鄉,鳳雄村,0,1,1567,26,1593,2252,3,1,3,0,1,0,70.74
高雄縣,燕巢鄉,橫山村,0,1,1206,16,1222,1764,3,1,3,0,1,0,69.27
高雄縣,燕巢鄉,深水村,0,1,1701,30,1731,2429,3,1,3,0,1,0,71.26
高雄縣,田寮鄉,鹿埔村,0,1,243,1,244,356,3,1,3,0,1,0,68.54
高雄縣,田寮鄉,古亭村,0,1,428,6,434,672,3,1,3,0,1,0,64.58
高雄縣,田寮鄉,崇德村,0,1,718,10,728,966,3,1,3,0,1,0,75.36
高雄縣,田寮鄉,三和村,0,1,278,5,283,437,3,1,3,0,1,0,64.76
高雄縣,田寮鄉,西德村,0,1,570,14,584,898,3,1,3,0,1,0,65.03
高雄縣,田寮鄉,南安村,0,1,919,14,933,1352,3,1,3,0,1,0,69.01
高雄縣,田寮鄉,大同村,0,1,299,1,300,417,3,1,3,0,1,0,71.94
高雄縣,田寮鄉,田寮村,0,1,295,2,297,452,3,1,3,0,1,0,65.71
高雄縣,田寮鄉,七星村,0,1,639,4,643,921,3,1,3,0,1,0,69.82
高雄縣,田寮鄉,新興村,0,1,984,17,1001,1332,3,1,3,0,1,0,75.15
高雄縣,阿蓮鄉,阿蓮村,0,1,2639,20,2659,4021,3,1,3,0,1,0,66.13
高雄縣,阿蓮鄉,南蓮村,0,1,1793,22,1815,2647,3,1,3,0,1,0,68.57
高雄縣,阿蓮鄉,清蓮村,0,1,1648,18,1666,2508,3,1,3,0,1,0,66.43
高雄縣,阿蓮鄉,和蓮村,0,1,1334,14,1348,1990,3,1,3,0,1,0,67.74
高雄縣,阿蓮鄉,青旗村,0,1,875,11,886,1289,3,1,3,0,1,0,68.74
高雄縣,阿蓮鄉,石安村,0,1,804,14,818,1279,3,1,3,0,1,0,63.96
高雄縣,阿蓮鄉,中路村,0,1,1218,15,1233,1911,3,1,3,0,1,0,64.52
高雄縣,阿蓮鄉,峰山村,0,1,837,11,848,1125,3,1,3,0,1,0,75.38
高雄縣,阿蓮鄉,港後村,0,1,1296,16,1312,1809,3,1,3,0,1,0,72.53
高雄縣,阿蓮鄉,崗山村,0,1,481,7,488,701,3,1,3,0,1,0,69.61
高雄縣,阿蓮鄉,復安村,0,1,1122,17,1139,1575,3,1,3,0,1,0,72.32
高雄縣,阿蓮鄉,玉庫村,0,1,686,12,698,967,3,1,3,0,1,0,72.18
高雄縣,路竹鄉,竹園村,0,1,1176,16,1192,1704,3,1,3,0,1,0,69.95
高雄縣,路竹鄉,下坑村,0,1,1801,22,1823,2465,3,1,3,0,1,0,73.96
高雄縣,路竹鄉,甲南村,0,1,2085,46,2131,2912,3,1,3,0,1,0,73.18
高雄縣,路竹鄉,甲北村,0,1,1318,10,1328,1937,3,1,3,0,1,0,68.56
高雄縣,路竹鄉,社東村,0,1,1079,12,1091,1599,3,1,3,0,1,0,68.23
高雄縣,路竹鄉,社中村,0,1,641,5,646,897,3,1,3,0,1,0,72.02
高雄縣,路竹鄉,社西村,0,1,1518,21,1539,2217,3,1,3,0,1,0,69.42
高雄縣,路竹鄉,社南村,0,1,2183,26,2209,3393,3,1,3,0,1,0,65.10
高雄縣,路竹鄉,竹東村,0,1,1713,15,1728,2711,3,1,3,0,1,0,63.74
高雄縣,路竹鄉,竹南村,0,1,1777,5,1782,2621,3,1,3,0,1,0,67.99
高雄縣,路竹鄉,竹西村,0,1,1429,21,1450,2027,3,1,3,0,1,0,71.53
高雄縣,路竹鄉,文南村,0,1,1391,14,1405,2073,3,1,3,0,1,0,67.78
高雄縣,路竹鄉,文北村,0,1,1797,23,1820,2584,3,1,3,0,1,0,70.43
高雄縣,路竹鄉,竹滬村,0,1,1526,11,1537,2448,3,1,3,0,1,0,62.79
高雄縣,路竹鄉,頂寮村,0,1,826,7,833,1165,3,1,3,0,1,0,71.50
高雄縣,路竹鄉,新達村,0,1,761,11,772,1153,3,1,3,0,1,0,66.96
高雄縣,路竹鄉,後鄉村,0,1,664,8,672,916,3,1,3,0,1,0,73.36
高雄縣,路竹鄉,北嶺村,0,1,796,7,803,1061,3,1,3,0,1,0,75.68
高雄縣,路竹鄉,三爺村,0,1,629,6,635,852,3,1,3,0,1,0,74.53
高雄縣,路竹鄉,鴨寮村,0,1,975,10,985,1425,3,1,3,0,1,0,69.12
高雄縣,湖內鄉,大湖村,0,1,1671,17,1688,2497,3,1,3,0,1,0,67.60
高雄縣,湖內鄉,田尾村,0,1,723,16,739,1048,3,1,3,0,1,0,70.52
高雄縣,湖內鄉,湖內村,0,1,2785,37,2822,4472,3,1,3,0,1,0,63.10
高雄縣,湖內鄉,海埔村,0,1,1097,16,1113,1710,3,1,3,0,1,0,65.09
高雄縣,湖內鄉,海山村,0,1,790,12,802,1167,3,1,3,0,1,0,68.72
高雄縣,湖內鄉,劉家村,0,1,679,5,684,1081,3,1,3,0,1,0,63.27
高雄縣,湖內鄉,太爺村,0,1,549,8,557,838,3,1,3,0,1,0,66.47
高雄縣,湖內鄉,公舘村,0,1,961,15,976,1573,3,1,3,0,1,0,62.05
高雄縣,湖內鄉,葉厝村,0,1,1121,20,1141,1772,3,1,3,0,1,0,64.39
高雄縣,湖內鄉,文賢村,0,1,783,13,796,1157,3,1,3,0,1,0,68.80
高雄縣,湖內鄉,中賢村,0,1,1276,20,1296,2019,3,1,3,0,1,0,64.19
高雄縣,湖內鄉,逸賢村,0,1,551,15,566,992,3,1,3,0,1,0,57.06
高雄縣,湖內鄉,忠興村,0,1,478,4,482,739,3,1,3,0,1,0,65.22
高雄縣,茄萣鄉,福德村,0,1,736,13,749,1056,3,1,3,0,1,0,70.93
高雄縣,茄萣鄉,萬福村,0,1,606,6,612,878,3,1,3,0,1,0,69.70
高雄縣,茄萣鄉,白雲村,0,1,1053,12,1065,1563,3,1,3,0,1,0,68.14
高雄縣,茄萣鄉,嘉賜村,0,1,1720,16,1736,2790,3,1,3,0,1,0,62.22
高雄縣,茄萣鄉,嘉安村,0,1,910,5,915,1392,3,1,3,0,1,0,65.73
高雄縣,茄萣鄉,嘉樂村,0,1,1168,9,1177,1853,3,1,3,0,1,0,63.52
高雄縣,茄萣鄉,嘉泰村,0,1,755,8,763,1194,3,1,3,0,1,0,63.90
高雄縣,茄萣鄉,嘉福村,0,1,659,5,664,1006,3,1,3,0,1,0,66.00
高雄縣,茄萣鄉,和協村,0,1,791,10,801,1270,3,1,3,0,1,0,63.07
高雄縣,茄萣鄉,嘉定村,0,1,868,18,886,1304,3,1,3,0,1,0,67.94
高雄縣,茄萣鄉,保定村,0,1,1782,21,1803,2903,3,1,3,0,1,0,62.11
高雄縣,茄萣鄉,大定村,0,1,766,8,774,1205,3,1,3,0,1,0,64.23
高雄縣,茄萣鄉,光定村,0,1,680,5,685,1053,3,1,3,0,1,0,65.05
高雄縣,茄萣鄉,吉定村,0,1,774,7,781,1239,3,1,3,0,1,0,63.03
高雄縣,茄萣鄉,崎漏村,0,1,2151,26,2177,3359,3,1,3,0,1,0,64.81
高雄縣,永安鄉,永安村,0,1,1055,16,1071,1528,3,1,3,0,1,0,70.09
高雄縣,永安鄉,永華村,0,1,1165,8,1173,1731,3,1,3,0,1,0,67.76
高雄縣,永安鄉,新港村,0,1,1634,12,1646,2370,3,1,3,0,1,0,69.45
高雄縣,永安鄉,鹽田村,0,1,255,1,256,416,3,1,3,0,1,0,61.54
高雄縣,永安鄉,保寧村,0,1,1450,18,1468,2089,3,1,3,0,1,0,70.27
高雄縣,永安鄉,維新村,0,1,1702,19,1721,2535,3,1,3,0,1,0,67.89
高雄縣,彌陀鄉,舊港村,0,1,1144,12,1156,1472,3,1,3,0,1,0,78.53
高雄縣,彌陀鄉,文安村,0,1,1316,12,1328,1788,3,1,3,0,1,0,74.27
高雄縣,彌陀鄉,鹽埕村,0,1,1385,29,1414,1878,3,1,3,0,1,0,75.29
高雄縣,彌陀鄉,過港村,0,1,736,8,744,961,3,1,3,0,1,0,77.42
高雄縣,彌陀鄉,光和村,0,1,773,11,784,1051,3,1,3,0,1,0,74.60
高雄縣,彌陀鄉,彌靖村,0,1,1357,8,1365,1841,3,1,3,0,1,0,74.14
高雄縣,彌陀鄉,彌仁村,0,1,420,6,426,574,3,1,3,0,1,0,74.22
高雄縣,彌陀鄉,彌壽村,0,1,556,3,559,728,3,1,3,0,1,0,76.79
高雄縣,彌陀鄉,彌陀村,0,1,1125,6,1131,1553,3,1,3,0,1,0,72.83
高雄縣,彌陀鄉,海尾村,0,1,582,19,601,842,3,1,3,0,1,0,71.38
高雄縣,彌陀鄉,漯底村,0,1,775,6,781,964,3,1,3,0,1,0,81.02
高雄縣,彌陀鄉,南寮村,0,1,1499,15,1514,1991,3,1,3,0,1,0,76.04
高雄縣,梓官鄉,梓信村,0,1,1271,20,1291,1903,3,1,3,0,1,0,67.84
高雄縣,梓官鄉,梓義村,0,1,1342,13,1355,1982,3,1,3,0,1,0,68.37
高雄縣,梓官鄉,梓和村,0,1,1572,16,1588,2270,3,1,3,0,1,0,69.96
高雄縣,梓官鄉,梓平村,0,1,790,4,794,1058,3,1,3,0,1,0,75.05
高雄縣,梓官鄉,中崙村,0,1,718,15,733,1055,3,1,3,0,1,0,69.48
高雄縣,梓官鄉,同安村,0,1,699,5,704,936,3,1,3,0,1,0,75.21
高雄縣,梓官鄉,大舍村,0,1,2267,29,2296,3371,3,1,3,0,1,0,68.11
高雄縣,梓官鄉,赤崁村,0,1,1287,9,1296,1905,3,1,3,0,1,0,68.03
高雄縣,梓官鄉,赤東村,0,1,1553,17,1570,2357,3,1,3,0,1,0,66.61
高雄縣,梓官鄉,赤西村,0,1,427,5,432,660,3,1,3,0,1,0,65.45
高雄縣,梓官鄉,禮蚵村,0,1,1595,13,1608,2349,3,1,3,0,1,0,68.45
高雄縣,梓官鄉,智蚵村,0,1,1475,18,1493,2364,3,1,3,0,1,0,63.16
高雄縣,梓官鄉,信蚵村,0,1,937,13,950,1526,3,1,3,0,1,0,62.25
高雄縣,梓官鄉,茄苳村,0,1,1440,19,1459,2171,3,1,3,0,1,0,67.20
高雄縣,梓官鄉,典寶村,0,1,1643,23,1666,2396,3,1,3,0,1,0,69.53
高雄縣,旗山鎮,太平里,0,1,1397,16,1413,2296,3,1,3,0,1,0,61.54
高雄縣,旗山鎮,大德里,0,1,1621,17,1638,2434,3,1,3,0,1,0,67.30
高雄縣,旗山鎮,湄洲里,0,1,581,3,584,885,3,1,3,0,1,0,65.99
高雄縣,旗山鎮,鼓山里,0,1,417,5,422,605,3,1,3,0,1,0,69.75
高雄縣,旗山鎮,新山里,0,1,561,6,567,807,3,1,3,0,1,0,70.26
高雄縣,旗山鎮,和平里,0,1,496,6,502,736,3,1,3,0,1,0,68.21
高雄縣,旗山鎮,竹峰里,0,1,350,1,351,527,3,1,3,0,1,0,66.60
高雄縣,旗山鎮,瑞吉里,0,1,1187,10,1197,1888,3,1,3,0,1,0,63.40
高雄縣,旗山鎮,永和里,0,1,1864,15,1879,2955,3,1,3,0,1,0,63.59
高雄縣,旗山鎮,三協里,0,1,1178,15,1193,1926,3,1,3,0,1,0,61.94
高雄縣,旗山鎮,圓富里,0,1,1189,15,1204,1919,3,1,3,0,1,0,62.74
高雄縣,旗山鎮,中正里,0,1,1039,13,1052,1533,3,1,3,0,1,0,68.62
高雄縣,旗山鎮,大林里,0,1,1005,12,1017,1538,3,1,3,0,1,0,66.12
高雄縣,旗山鎮,上洲里,0,1,703,8,711,984,3,1,3,0,1,0,72.26
高雄縣,旗山鎮,鯤洲里,0,1,634,8,642,903,3,1,3,0,1,0,71.10
高雄縣,旗山鎮,大山里,0,1,950,13,963,1346,3,1,3,0,1,0,71.55
高雄縣,旗山鎮,中洲里,0,1,708,3,711,931,3,1,3,0,1,0,76.37
高雄縣,旗山鎮,南洲里,0,1,1019,14,1033,1371,3,1,3,0,1,0,75.35
高雄縣,旗山鎮,新光里,0,1,669,12,681,896,3,1,3,0,1,0,76.00
高雄縣,旗山鎮,南勝里,0,1,1663,23,1686,2377,3,1,3,0,1,0,70.93
高雄縣,旗山鎮,東平里,0,1,1221,13,1234,1881,3,1,3,0,1,0,65.60
高雄縣,旗山鎮,東昌里,0,1,453,1,454,655,3,1,3,0,1,0,69.31
高雄縣,旗山鎮,糖廠里,0,1,281,0,281,376,3,1,3,0,1,0,74.73
高雄縣,旗山鎮,廣福里,0,1,431,3,434,602,3,1,3,0,1,0,72.09
高雄縣,旗山鎮,中寮里,0,1,147,0,147,205,3,1,3,0,1,0,71.71
高雄縣,美濃鎮,中圳里,0,1,1141,17,1158,1763,3,1,3,0,1,0,65.68
高雄縣,美濃鎮,東門里,0,1,899,11,910,1397,3,1,3,0,1,0,65.14
高雄縣,美濃鎮,泰安里,0,1,934,6,940,1438,3,1,3,0,1,0,65.37
高雄縣,美濃鎮,合和里,0,1,1428,20,1448,2248,3,1,3,0,1,0,64.41
高雄縣,美濃鎮,瀰濃里,0,1,1402,19,1421,2211,3,1,3,0,1,0,64.27
高雄縣,美濃鎮,福安里,0,1,1563,18,1581,2477,3,1,3,0,1,0,63.83
高雄縣,美濃鎮,祿興里,0,1,1609,15,1624,2509,3,1,3,0,1,0,64.73
高雄縣,美濃鎮,中壇里,0,1,1297,16,1313,2045,3,1,3,0,1,0,64.21
高雄縣,美濃鎮,德興里,0,1,1046,13,1059,1492,3,1,3,0,1,0,70.98
高雄縣,美濃鎮,清水里,0,1,1124,12,1136,1719,3,1,3,0,1,0,66.08
高雄縣,美濃鎮,吉和里,0,1,923,8,931,1423,3,1,3,0,1,0,65.43
高雄縣,美濃鎮,吉洋里,0,1,1268,21,1289,1989,3,1,3,0,1,0,64.81
高雄縣,美濃鎮,吉東里,0,1,1055,12,1067,1663,3,1,3,0,1,0,64.16
高雄縣,美濃鎮,龍山里,0,1,1404,22,1426,2191,3,1,3,0,1,0,65.08
高雄縣,美濃鎮,獅山里,0,1,1581,19,1600,2352,3,1,3,0,1,0,68.03
高雄縣,美濃鎮,龍肚里,0,1,1092,10,1102,1620,3,1,3,0,1,0,68.02
高雄縣,美濃鎮,廣德里,0,1,921,9,930,1426,3,1,3,0,1,0,65.22
高雄縣,美濃鎮,興隆里,0,1,777,10,787,1212,3,1,3,0,1,0,64.93
高雄縣,美濃鎮,廣林里,0,1,1049,6,1055,1758,3,1,3,0,1,0,60.01
高雄縣,六龜鄉,六龜村,0,1,642,18,660,1073,3,1,3,0,1,0,61.51
高雄縣,六龜鄉,義寶村,0,1,795,12,807,1187,3,1,3,0,1,0,67.99
高雄縣,六龜鄉,文武村,0,1,867,15,882,1612,3,1,3,0,1,0,54.71
高雄縣,六龜鄉,中興村,0,1,818,13,831,1346,3,1,3,0,1,0,61.74
高雄縣,六龜鄉,興龍村,0,1,558,11,569,926,3,1,3,0,1,0,61.45
高雄縣,六龜鄉,新威村,0,1,507,2,509,841,3,1,3,0,1,0,60.52
高雄縣,六龜鄉,新興村,0,1,439,8,447,759,3,1,3,0,1,0,58.89
高雄縣,六龜鄉,新寮村,0,1,416,10,426,650,3,1,3,0,1,0,65.54
高雄縣,六龜鄉,大津村,0,1,241,2,243,359,3,1,3,0,1,0,67.69
高雄縣,六龜鄉,新發村,0,1,735,9,744,1390,3,1,3,0,1,0,53.53
高雄縣,六龜鄉,荖濃村,0,1,799,26,825,1537,3,1,3,0,1,0,53.68
高雄縣,六龜鄉,寶來村,0,1,679,14,693,1090,3,1,3,0,1,0,63.58
高雄縣,甲仙鄉,東安村,0,1,398,2,400,628,3,1,3,0,1,0,63.69
高雄縣,甲仙鄉,西安村,0,1,787,9,796,1084,3,1,3,0,1,0,73.43
高雄縣,甲仙鄉,和安村,0,1,550,9,559,849,3,1,3,0,1,0,65.84
高雄縣,甲仙鄉,大田村,0,1,1009,28,1037,1601,3,1,3,0,1,0,64.77
高雄縣,甲仙鄉,寶隆村,0,1,481,7,488,733,3,1,3,0,1,0,66.58
高雄縣,甲仙鄉,關山村,0,1,472,4,476,726,3,1,3,0,1,0,65.56
高雄縣,甲仙鄉,小林村,0,1,673,12,685,1129,3,1,3,0,1,0,60.67
高雄縣,杉林鄉,杉林村,0,1,509,8,517,811,3,1,3,0,1,0,63.75
高雄縣,杉林鄉,木梓村,0,1,439,5,444,788,3,1,3,0,1,0,56.35
高雄縣,杉林鄉,集來村,0,1,1035,15,1050,1930,3,1,3,0,1,0,54.40
高雄縣,杉林鄉,新庄村,0,1,1114,16,1130,1823,3,1,3,0,1,0,61.99
高雄縣,杉林鄉,上平村,0,1,939,14,953,1531,3,1,3,0,1,0,62.25
高雄縣,杉林鄉,月眉村,0,1,1080,8,1088,1819,3,1,3,0,1,0,59.81
高雄縣,杉林鄉,月美村,0,1,716,6,722,1348,3,1,3,0,1,0,53.56
高雄縣,內門鄉,金竹村,0,1,526,4,530,790,3,1,3,0,1,0,67.09
高雄縣,內門鄉,溝坪村,0,1,623,15,638,1051,3,1,3,0,1,0,60.70
高雄縣,內門鄉,永興村,0,1,317,5,322,492,3,1,3,0,1,0,65.45
高雄縣,內門鄉,永吉村,0,1,348,4,352,494,3,1,3,0,1,0,71.26
高雄縣,內門鄉,永富村,0,1,699,12,711,1051,3,1,3,0,1,0,67.65
高雄縣,內門鄉,觀亭村,0,1,1212,10,1222,1796,3,1,3,0,1,0,68.04
高雄縣,內門鄉,中埔村,0,1,455,6,461,609,3,1,3,0,1,0,75.70
高雄縣,內門鄉,瑞山村,0,1,252,3,255,363,3,1,3,0,1,0,70.25
高雄縣,內門鄉,內南村,0,1,279,2,281,382,3,1,3,0,1,0,73.56
高雄縣,內門鄉,內東村,0,1,602,6,608,773,3,1,3,0,1,0,78.65
高雄縣,內門鄉,光興村,0,1,448,6,454,643,3,1,3,0,1,0,70.61
高雄縣,內門鄉,東埔村,0,1,312,4,316,500,3,1,3,0,1,0,63.20
高雄縣,內門鄉,內豐村,0,1,772,6,778,1126,3,1,3,0,1,0,69.09
高雄縣,內門鄉,內門村,0,1,666,3,669,977,3,1,3,0,1,0,68.47
高雄縣,內門鄉,石坑村,0,1,339,1,340,512,3,1,3,0,1,0,66.41
高雄縣,內門鄉,三平村,0,1,473,5,478,688,3,1,3,0,1,0,69.48
高雄縣,內門鄉,木柵村,0,1,408,7,415,680,3,1,3,0,1,0,61.03
高雄縣,內門鄉,內興村,0,1,404,3,407,623,3,1,3,0,1,0,65.33
高雄縣,茂林鄉,茂林村,0,1,35,0,35,81,3,1,3,0,1,0,43.21
高雄縣,茂林鄉,萬山村,0,1,11,0,11,23,3,1,3,0,1,0,47.83
高雄縣,茂林鄉,多納村,0,1,14,1,15,27,3,1,3,0,1,0,55.56
高雄縣,桃源鄉,寶山村,0,1,28,1,29,53,3,1,3,0,1,0,54.72
高雄縣,桃源鄉,建山村,0,1,53,0,53,75,3,1,3,0,1,0,70.67
高雄縣,桃源鄉,高中村,0,1,33,3,36,71,3,1,3,0,1,0,50.70
高雄縣,桃源鄉,桃源村,0,1,68,2,70,128,3,1,3,0,1,0,54.69
高雄縣,桃源鄉,勤和村,0,1,7,0,7,14,3,1,3,0,1,0,50.00
高雄縣,桃源鄉,復興村,0,1,8,0,8,15,3,1,3,0,1,0,53.33
高雄縣,桃源鄉,梅蘭村,0,1,6,0,6,12,3,1,3,0,1,0,50.00
高雄縣,桃源鄉,梅山村,0,1,8,0,8,20,3,1,3,0,1,0,40.00
高雄縣,三民鄉,民族村,0,1,54,0,54,171,3,1,3,0,1,0,31.58
高雄縣,三民鄉,民權村,0,1,23,0,23,49,3,1,3,0,1,0,46.94
高雄縣,三民鄉,民生村,0,1,63,1,64,113,3,1,3,0,1,0,56.64
屏東縣,屏東市,端正里、武廟里,0,1,769,6,775,1186,3,1,3,0,1,0,65.35
屏東縣,屏東市,光榮里、民權里,0,1,982,12,994,1488,3,1,3,0,1,0,66.80
屏東縣,屏東市,大同里,0,1,549,5,554,756,3,1,3,0,1,0,73.28
屏東縣,屏東市,泰安里、文明里,0,1,901,8,909,1392,3,1,3,0,1,0,65.30
屏東縣,屏東市,維新里,0,1,1931,19,1950,2889,3,1,3,0,1,0,67.50
屏東縣,屏東市,大埔里、必信里,0,1,952,10,962,1424,3,1,3,0,1,0,67.56
屏東縣,屏東市,崇禮里、崇智里,0,1,621,6,627,890,3,1,3,0,1,0,70.45
屏東縣,屏東市,楠樹里、慶春里,0,1,607,4,611,815,3,1,3,0,1,0,74.97
屏東縣,屏東市,金泉里、勝峰里,0,1,832,10,842,1249,3,1,3,0,1,0,67.41
屏東縣,屏東市,平和里,0,1,597,5,602,890,3,1,3,0,1,0,67.64
屏東縣,屏東市,安樂里、扶風里,0,1,772,7,779,1088,3,1,3,0,1,0,71.60
屏東縣,屏東市,橋南里,0,1,979,6,985,1524,3,1,3,0,1,0,64.63
屏東縣,屏東市,橋北里,0,1,637,4,641,920,3,1,3,0,1,0,69.67
屏東縣,屏東市,長春里,0,1,1303,16,1319,2105,3,1,3,0,1,0,62.66
屏東縣,屏東市,豐榮里,0,1,1613,13,1626,2433,3,1,3,0,1,0,66.83
屏東縣,屏東市,豐田里,0,1,2507,19,2526,3822,3,1,3,0,1,0,66.09
屏東縣,屏東市,大連里,0,1,5333,39,5372,8068,3,1,3,0,1,0,66.58
屏東縣,屏東市,豐源里,0,1,2422,26,2448,3620,3,1,3,0,1,0,67.62
屏東縣,屏東市,湖南里,0,1,670,5,675,973,3,1,3,0,1,0,69.37
屏東縣,屏東市,湖西里,0,1,923,3,926,1375,3,1,3,0,1,0,67.35
屏東縣,屏東市,歸心里,0,1,737,8,745,1127,3,1,3,0,1,0,66.10
屏東縣,屏東市,瑞光里,0,1,3834,49,3883,6075,3,1,3,0,1,0,63.92
屏東縣,屏東市,永光里,0,1,811,6,817,1149,3,1,3,0,1,0,71.11
屏東縣,屏東市,安鎮里,0,1,1262,14,1276,1893,3,1,3,0,1,0,67.41
屏東縣,屏東市,永昌里、永順里,0,1,841,6,847,1269,3,1,3,0,1,0,66.75
屏東縣,屏東市,長安里,0,1,1296,23,1319,2017,3,1,3,0,1,0,65.39
屏東縣,屏東市,崇武里,0,1,1112,9,1121,1723,3,1,3,0,1,0,65.06
屏東縣,屏東市,大武里,0,1,3006,33,3039,4601,3,1,3,0,1,0,66.05
屏東縣,屏東市,清溪里,0,1,2725,31,2756,4187,3,1,3,0,1,0,65.82
屏東縣,屏東市,前進里,0,1,832,16,848,1196,3,1,3,0,1,0,70.90
屏東縣,屏東市,大洲里,0,1,723,9,732,1034,3,1,3,0,1,0,70.79
屏東縣,屏東市,凌雲里,0,1,947,9,956,1406,3,1,3,0,1,0,67.99
屏東縣,屏東市,鵬程里,0,1,947,15,962,1358,3,1,3,0,1,0,70.84
屏東縣,屏東市,一心里、義勇里,0,1,1034,11,1045,1590,3,1,3,0,1,0,65.72
屏東縣,屏東市,建國里、擇仁里,0,1,1031,11,1042,1645,3,1,3,0,1,0,63.34
屏東縣,屏東市,光華里,0,1,474,9,483,771,3,1,3,0,1,0,62.65
屏東縣,屏東市,萬年里,0,1,527,3,530,787,3,1,3,0,1,0,67.34
屏東縣,屏東市,厚生里,0,1,1988,14,2002,3122,3,1,3,0,1,0,64.13
屏東縣,屏東市,永安里,0,1,4080,49,4129,6547,3,1,3,0,1,0,63.07
屏東縣,屏東市,新生里,0,1,3014,26,3040,4564,3,1,3,0,1,0,66.61
屏東縣,屏東市,頂宅里,0,1,372,4,376,516,3,1,3,0,1,0,72.87
屏東縣,屏東市,頂柳里,0,1,715,7,722,980,3,1,3,0,1,0,73.67
屏東縣,屏東市,龍華里,0,1,1633,11,1644,2391,3,1,3,0,1,0,68.76
屏東縣,屏東市,大湖里,0,1,1003,19,1022,1424,3,1,3,0,1,0,71.77
屏東縣,屏東市,新興里,0,1,1500,12,1512,2177,3,1,3,0,1,0,69.45
屏東縣,屏東市,公館里,0,1,1069,19,1088,1473,3,1,3,0,1,0,73.86
屏東縣,屏東市,玉成里,0,1,965,10,975,1318,3,1,3,0,1,0,73.98
屏東縣,屏東市,勝利里,0,1,2637,22,2659,4196,3,1,3,0,1,0,63.37
屏東縣,屏東市,永城里,0,1,1449,12,1461,2322,3,1,3,0,1,0,62.92
屏東縣,屏東市,崇蘭里,0,1,4339,46,4385,6626,3,1,3,0,1,0,66.18
屏東縣,屏東市,廣興里,0,1,1225,7,1232,1787,3,1,3,0,1,0,68.94
屏東縣,屏東市,空翔里,0,1,1048,13,1061,1587,3,1,3,0,1,0,66.86
屏東縣,屏東市,大鵬里,0,1,444,10,454,700,3,1,3,0,1,0,64.86
屏東縣,屏東市,潭墘里,0,1,4401,47,4448,7207,3,1,3,0,1,0,61.72
屏東縣,屏東市,興樂里,0,1,649,4,653,967,3,1,3,0,1,0,67.53
屏東縣,屏東市,斯文里,0,1,1342,12,1354,1953,3,1,3,0,1,0,69.33
屏東縣,屏東市,太平里、明正里,0,1,672,6,678,1028,3,1,3,0,1,0,65.95
屏東縣,屏東市,華山里,0,1,2915,22,2937,4350,3,1,3,0,1,0,67.52
屏東縣,屏東市,溝美里,0,1,1642,19,1661,2548,3,1,3,0,1,0,65.19
屏東縣,屏東市,中正里,0,1,2077,18,2095,3211,3,1,3,0,1,0,65.24
屏東縣,屏東市,仁愛里,0,1,1371,9,1380,2115,3,1,3,0,1,0,65.25
屏東縣,屏東市,北興里,0,1,3371,46,3417,5286,3,1,3,0,1,0,64.64
屏東縣,屏東市,北勢里,0,1,1667,12,1679,2380,3,1,3,0,1,0,70.55
屏東縣,屏東市,三山里,0,1,849,9,858,1216,3,1,3,0,1,0,70.56
屏東縣,屏東市,海豐里,0,1,596,5,601,839,3,1,3,0,1,0,71.63
屏東縣,屏東市,仁義里,0,1,688,5,693,1005,3,1,3,0,1,0,68.96
屏東縣,屏東市,信和里,0,1,1004,9,1013,1440,3,1,3,0,1,0,70.35
屏東縣,屏東市,和興里,0,1,621,3,624,935,3,1,3,0,1,0,66.74
屏東縣,潮州鎮,潮州里,0,1,413,1,414,627,3,1,3,0,1,0,66.03
屏東縣,潮州鎮,光華里,0,1,2342,25,2367,3774,3,1,3,0,1,0,62.72
屏東縣,潮州鎮,同榮里,0,1,514,4,518,736,3,1,3,0,1,0,70.38
屏東縣,潮州鎮,新生里,0,1,761,10,771,1170,3,1,3,0,1,0,65.90
屏東縣,潮州鎮,新榮里,0,1,957,15,972,1484,3,1,3,0,1,0,65.50
屏東縣,潮州鎮,彭城里,0,1,584,5,589,791,3,1,3,0,1,0,74.46
屏東縣,潮州鎮,三星里,0,1,2730,29,2759,4169,3,1,3,0,1,0,66.18
屏東縣,潮州鎮,三共里,0,1,3417,20,3437,5326,3,1,3,0,1,0,64.53
屏東縣,潮州鎮,三和里,0,1,1149,13,1162,1769,3,1,3,0,1,0,65.69
屏東縣,潮州鎮,五魁里,0,1,701,10,711,1133,3,1,3,0,1,0,62.75
屏東縣,潮州鎮,蓬萊里,0,1,1140,12,1152,1776,3,1,3,0,1,0,64.86
屏東縣,潮州鎮,八爺里,0,1,1239,15,1254,1978,3,1,3,0,1,0,63.40
屏東縣,潮州鎮,永春里,0,1,3015,29,3044,4786,3,1,3,0,1,0,63.60
屏東縣,潮州鎮,富春里,0,1,880,8,888,1434,3,1,3,0,1,0,61.92
屏東縣,潮州鎮,光春里,0,1,831,11,842,1307,3,1,3,0,1,0,64.42
屏東縣,潮州鎮,興美里,0,1,569,6,575,825,3,1,3,0,1,0,69.70
屏東縣,潮州鎮,檨子里,0,1,379,2,381,591,3,1,3,0,1,0,64.47
屏東縣,潮州鎮,九塊里,0,1,997,10,1007,1559,3,1,3,0,1,0,64.59
屏東縣,潮州鎮,泗林里,0,1,1019,15,1034,1514,3,1,3,0,1,0,68.30
屏東縣,潮州鎮,四春里,0,1,1244,17,1261,1925,3,1,3,0,1,0,65.51
屏東縣,潮州鎮,崙東里,0,1,1007,15,1022,1588,3,1,3,0,1,0,64.36
屏東縣,東港鎮,新勝里,0,1,1598,15,1613,2329,3,1,3,0,1,0,69.26
屏東縣,東港鎮,頂新里,0,1,376,3,379,565,3,1,3,0,1,0,67.08
屏東縣,東港鎮,頂中里,0,1,349,6,355,479,3,1,3,0,1,0,74.11
屏東縣,東港鎮,東和里,0,1,445,9,454,724,3,1,3,0,1,0,62.71
屏東縣,東港鎮,興台里,0,1,363,4,367,565,3,1,3,0,1,0,64.96
屏東縣,東港鎮,興東里,0,1,3463,41,3504,5512,3,1,3,0,1,0,63.57
屏東縣,東港鎮,興農里,0,1,516,3,519,732,3,1,3,0,1,0,70.90
屏東縣,東港鎮,中興里,0,1,513,8,521,770,3,1,3,0,1,0,67.66
屏東縣,東港鎮,朝安里,0,1,1179,13,1192,1798,3,1,3,0,1,0,66.30
屏東縣,東港鎮,八德里,0,1,560,3,563,855,3,1,3,0,1,0,65.85
屏東縣,東港鎮,東隆里,0,1,870,7,877,1359,3,1,3,0,1,0,64.53
屏東縣,東港鎮,豐漁里,0,1,452,4,456,724,3,1,3,0,1,0,62.98
屏東縣,東港鎮,盛漁里,0,1,746,10,756,1304,3,1,3,0,1,0,57.98
屏東縣,東港鎮,興漁里,0,1,1177,13,1190,1870,3,1,3,0,1,0,63.64
屏東縣,東港鎮,鎮海里,0,1,1553,17,1570,2507,3,1,3,0,1,0,62.62
屏東縣,東港鎮,嘉蓮里,0,1,966,10,976,1540,3,1,3,0,1,0,63.38
屏東縣,東港鎮,南平里,0,1,1084,12,1096,1770,3,1,3,0,1,0,61.92
屏東縣,東港鎮,船頭里,0,1,2209,19,2228,3631,3,1,3,0,1,0,61.36
屏東縣,東港鎮,下廍里,0,1,1209,10,1219,1783,3,1,3,0,1,0,68.37
屏東縣,東港鎮,大潭里,0,1,1056,12,1068,1557,3,1,3,0,1,0,68.59
屏東縣,東港鎮,興和里,0,1,612,7,619,874,3,1,3,0,1,0,70.82
屏東縣,東港鎮,共和里,0,1,454,4,458,700,3,1,3,0,1,0,65.43
屏東縣,東港鎮,大鵬里,0,1,193,4,197,296,3,1,3,0,1,0,66.55
屏東縣,恆春鎮,城南里,0,1,614,5,619,973,3,1,3,0,1,0,63.62
屏東縣,恆春鎮,城北里,0,1,1156,23,1179,1895,3,1,3,0,1,0,62.22
屏東縣,恆春鎮,城西里,0,1,725,5,730,1143,3,1,3,0,1,0,63.87
屏東縣,恆春鎮,山腳里,0,1,1833,28,1861,3385,3,1,3,0,1,0,54.98
屏東縣,恆春鎮,網紗里,0,1,1444,22,1466,2582,3,1,3,0,1,0,56.78
屏東縣,恆春鎮,仁壽里,0,1,423,10,433,789,3,1,3,0,1,0,54.88
屏東縣,恆春鎮,茄湖里,0,1,286,4,290,493,3,1,3,0,1,0,58.82
屏東縣,恆春鎮,頭溝里,0,1,244,5,249,472,3,1,3,0,1,0,52.75
屏東縣,恆春鎮,四溝里,0,1,528,10,538,916,3,1,3,0,1,0,58.73
屏東縣,恆春鎮,德和里,0,1,391,12,403,663,3,1,3,0,1,0,60.78
屏東縣,恆春鎮,龍水里,0,1,576,6,582,928,3,1,3,0,1,0,62.72
屏東縣,恆春鎮,山海里,0,1,919,8,927,1498,3,1,3,0,1,0,61.88
屏東縣,恆春鎮,大光里,0,1,1013,22,1035,1794,3,1,3,0,1,0,57.69
屏東縣,恆春鎮,水泉里,0,1,712,10,722,1371,3,1,3,0,1,0,52.66
屏東縣,恆春鎮,南灣里,0,1,769,13,782,1343,3,1,3,0,1,0,58.23
屏東縣,恆春鎮,墾丁里,0,1,754,10,764,1173,3,1,3,0,1,0,65.13
屏東縣,恆春鎮,鵝鑾里,0,1,635,12,647,1050,3,1,3,0,1,0,61.62
屏東縣,萬丹鄉,社上村,0,1,968,8,976,1414,3,1,3,0,1,0,69.02
屏東縣,萬丹鄉,社中村,0,1,955,15,970,1392,3,1,3,0,1,0,69.68
屏東縣,萬丹鄉,社皮村,0,1,1268,12,1280,1775,3,1,3,0,1,0,72.11
屏東縣,萬丹鄉,磚寮村,0,1,664,6,670,887,3,1,3,0,1,0,75.54
屏東縣,萬丹鄉,社口村,0,1,879,5,884,1144,3,1,3,0,1,0,77.27
屏東縣,萬丹鄉,加興村,0,1,803,9,812,1092,3,1,3,0,1,0,74.36
屏東縣,萬丹鄉,上村村,0,1,516,2,518,655,3,1,3,0,1,0,79.08
屏東縣,萬丹鄉,廈北村,0,1,1156,18,1174,1573,3,1,3,0,1,0,74.63
屏東縣,萬丹鄉,廈南村,0,1,975,8,983,1357,3,1,3,0,1,0,72.44
屏東縣,萬丹鄉,崙頂村,0,1,1099,9,1108,1563,3,1,3,0,1,0,70.89
屏東縣,萬丹鄉,田厝村,0,1,624,10,634,855,3,1,3,0,1,0,74.15
屏東縣,萬丹鄉,後村村,0,1,811,6,817,1011,3,1,3,0,1,0,80.81
屏東縣,萬丹鄉,灣內村,0,1,881,9,890,1226,3,1,3,0,1,0,72.59
屏東縣,萬丹鄉,香社村,0,1,1014,6,1020,1389,3,1,3,0,1,0,73.43
屏東縣,萬丹鄉,新庄村,0,1,1300,14,1314,1810,3,1,3,0,1,0,72.60
屏東縣,萬丹鄉,新鐘村,0,1,1336,13,1349,1829,3,1,3,0,1,0,73.76
屏東縣,萬丹鄉,水仙村,0,1,407,3,410,513,3,1,3,0,1,0,79.92
屏東縣,萬丹鄉,興安村,0,1,581,6,587,802,3,1,3,0,1,0,73.19
屏東縣,萬丹鄉,興全村,0,1,840,7,847,1111,3,1,3,0,1,0,76.24
屏東縣,萬丹鄉,甘棠村,0,1,252,1,253,347,3,1,3,0,1,0,72.91
屏東縣,萬丹鄉,水泉村,0,1,894,11,905,1276,3,1,3,0,1,0,70.92
屏東縣,萬丹鄉,竹林村,0,1,1063,13,1076,1463,3,1,3,0,1,0,73.55
屏東縣,萬丹鄉,廣安村,0,1,1334,18,1352,1861,3,1,3,0,1,0,72.65
屏東縣,萬丹鄉,四維村,0,1,1183,22,1205,1734,3,1,3,0,1,0,69.49
屏東縣,萬丹鄉,寶厝村,0,1,1378,11,1389,1974,3,1,3,0,1,0,70.36
屏東縣,萬丹鄉,萬生村,0,1,884,10,894,1233,3,1,3,0,1,0,72.51
屏東縣,萬丹鄉,萬惠村,0,1,541,2,543,715,3,1,3,0,1,0,75.94
屏東縣,萬丹鄉,萬安村,0,1,403,1,404,563,3,1,3,0,1,0,71.76
屏東縣,萬丹鄉,萬後村,0,1,353,1,354,465,3,1,3,0,1,0,76.13
屏東縣,萬丹鄉,萬全村,0,1,2325,10,2335,3236,3,1,3,0,1,0,72.16
屏東縣,長治鄉,進興村,0,1,1468,17,1485,2111,3,1,3,0,1,0,70.35
屏東縣,長治鄉,新潭村,0,1,1811,18,1829,2608,3,1,3,0,1,0,70.13
屏東縣,長治鄉,潭頭村,0,1,1038,8,1046,1452,3,1,3,0,1,0,72.04
屏東縣,長治鄉,香楊村,0,1,1133,12,1145,1689,3,1,3,0,1,0,67.79
屏東縣,長治鄉,長興村,0,1,732,5,737,998,3,1,3,0,1,0,73.85
屏東縣,長治鄉,崙上村,0,1,1058,17,1075,1441,3,1,3,0,1,0,74.60
屏東縣,長治鄉,德榮村,0,1,786,8,794,1066,3,1,3,0,1,0,74.48
屏東縣,長治鄉,德和村,0,1,543,10,553,772,3,1,3,0,1,0,71.63
屏東縣,長治鄉,復興村,0,1,1008,8,1016,1383,3,1,3,0,1,0,73.46
屏東縣,長治鄉,德成村,0,1,642,5,647,848,3,1,3,0,1,0,76.30
屏東縣,長治鄉,德協村,0,1,786,10,796,1091,3,1,3,0,1,0,72.96
屏東縣,長治鄉,繁榮村,0,1,917,11,928,1314,3,1,3,0,1,0,70.62
屏東縣,長治鄉,繁昌村,0,1,1236,17,1253,1644,3,1,3,0,1,0,76.22
屏東縣,長治鄉,繁隆村,0,1,800,16,816,1057,3,1,3,0,1,0,77.20
屏東縣,長治鄉,繁華村,0,1,1601,21,1622,2231,3,1,3,0,1,0,72.70
屏東縣,長治鄉,榮華村,0,1,318,6,324,495,3,1,3,0,1,0,65.45
屏東縣,麟洛鄉,新田村,0,1,1191,10,1201,1691,3,1,3,0,1,0,71.02
屏東縣,麟洛鄉,麟頂村,0,1,651,5,656,898,3,1,3,0,1,0,73.05
屏東縣,麟洛鄉,麟蹄村,0,1,1090,10,1100,1559,3,1,3,0,1,0,70.56
屏東縣,麟洛鄉,麟趾村,0,1,1481,13,1494,2165,3,1,3,0,1,0,69.01
屏東縣,麟洛鄉,田中村,0,1,800,7,807,1067,3,1,3,0,1,0,75.63
屏東縣,麟洛鄉,田心村,0,1,576,8,584,823,3,1,3,0,1,0,70.96
屏東縣,麟洛鄉,田道村,0,1,500,5,505,674,3,1,3,0,1,0,74.93
屏東縣,九如鄉,九清村,0,1,1098,13,1111,1541,3,1,3,0,1,0,72.10
屏東縣,九如鄉,九塊村,0,1,898,8,906,1262,3,1,3,0,1,0,71.79
屏東縣,九如鄉,九明村,0,1,974,15,989,1381,3,1,3,0,1,0,71.61
屏東縣,九如鄉,大坵村,0,1,707,8,715,972,3,1,3,0,1,0,73.56
屏東縣,九如鄉,玉水村,0,1,898,18,916,1220,3,1,3,0,1,0,75.08
屏東縣,九如鄉,玉泉村,0,1,982,20,1002,1439,3,1,3,0,1,0,69.63
屏東縣,九如鄉,東寧村,0,1,2395,23,2418,3474,3,1,3,0,1,0,69.60
屏東縣,九如鄉,三塊村,0,1,929,9,938,1290,3,1,3,0,1,0,72.71
屏東縣,九如鄉,耆老村,0,1,852,12,864,1234,3,1,3,0,1,0,70.02
屏東縣,九如鄉,後庄村,0,1,1254,17,1271,1644,3,1,3,0,1,0,77.31
屏東縣,九如鄉,洽興村,0,1,942,11,953,1279,3,1,3,0,1,0,74.51
屏東縣,里港鄉,玉田村,0,1,1404,14,1418,2046,3,1,3,0,1,0,69.31
屏東縣,里港鄉,塔樓村,0,1,938,8,946,1362,3,1,3,0,1,0,69.46
屏東縣,里港鄉,潮厝村,0,1,940,8,948,1359,3,1,3,0,1,0,69.76
屏東縣,里港鄉,大平村,0,1,803,6,809,1116,3,1,3,0,1,0,72.49
屏東縣,里港鄉,永春村,0,1,561,5,566,785,3,1,3,0,1,0,72.10
屏東縣,里港鄉,春林村,0,1,819,11,830,1189,3,1,3,0,1,0,69.81
屏東縣,里港鄉,過江村,0,1,1128,17,1145,1654,3,1,3,0,1,0,69.23
屏東縣,里港鄉,鐵店村,0,1,861,6,867,1232,3,1,3,0,1,0,70.37
屏東縣,里港鄉,茄苳村,0,1,1212,9,1221,1571,3,1,3,0,1,0,77.72
屏東縣,里港鄉,載興村,0,1,1640,21,1661,2297,3,1,3,0,1,0,72.31
屏東縣,里港鄉,土庫村,0,1,1315,25,1340,1989,3,1,3,0,1,0,67.37
屏東縣,里港鄉,三廍村,0,1,1212,21,1233,1717,3,1,3,0,1,0,71.81
屏東縣,里港鄉,中和村,0,1,541,3,544,805,3,1,3,0,1,0,67.58
屏東縣,里港鄉,瀰力村,0,1,324,4,328,453,3,1,3,0,1,0,72.41
屏東縣,鹽埔鄉,鹽北村,0,1,1233,13,1246,1703,3,1,3,0,1,0,73.17
屏東縣,鹽埔鄉,鹽中村,0,1,1608,27,1635,2211,3,1,3,0,1,0,73.95
屏東縣,鹽埔鄉,鹽南村,0,1,1083,14,1097,1600,3,1,3,0,1,0,68.56
屏東縣,鹽埔鄉,仕絨村,0,1,743,11,754,911,3,1,3,0,1,0,82.77
屏東縣,鹽埔鄉,高朗村,0,1,1891,25,1916,2658,3,1,3,0,1,0,72.08
屏東縣,鹽埔鄉,振興村,0,1,1271,24,1295,1878,3,1,3,0,1,0,68.96
屏東縣,鹽埔鄉,久愛村,0,1,625,17,642,850,3,1,3,0,1,0,75.53
屏東縣,鹽埔鄉,新圍村,0,1,1793,27,1820,2782,3,1,3,0,1,0,65.42
屏東縣,鹽埔鄉,新二村,0,1,1900,21,1921,2957,3,1,3,0,1,0,64.96
屏東縣,鹽埔鄉,彭厝村,0,1,639,9,648,958,3,1,3,0,1,0,67.64
屏東縣,鹽埔鄉,洛陽村,0,1,1002,13,1015,1443,3,1,3,0,1,0,70.34
屏東縣,鹽埔鄉,永隆村,0,1,412,3,415,571,3,1,3,0,1,0,72.68
屏東縣,高樹鄉,高樹村,0,1,1404,10,1414,2181,3,1,3,0,1,0,64.83
屏東縣,高樹鄉,長榮村,0,1,922,15,937,1380,3,1,3,0,1,0,67.90
屏東縣,高樹鄉,東興村,0,1,580,10,590,828,3,1,3,0,1,0,71.26
屏東縣,高樹鄉,東振村,0,1,392,3,395,630,3,1,3,0,1,0,62.70
屏東縣,高樹鄉,源泉村,0,1,675,4,679,1025,3,1,3,0,1,0,66.24
屏東縣,高樹鄉,建興村,0,1,738,8,746,1185,3,1,3,0,1,0,62.95
屏東縣,高樹鄉,大埔村,0,1,419,9,428,675,3,1,3,0,1,0,63.41
屏東縣,高樹鄉,菜寮村,0,1,564,10,574,824,3,1,3,0,1,0,69.66
屏東縣,高樹鄉,司馬村,0,1,504,5,509,751,3,1,3,0,1,0,67.78
屏東縣,高樹鄉,舊寮村,0,1,793,12,805,1314,3,1,3,0,1,0,61.26
屏東縣,高樹鄉,新豐村,0,1,925,13,938,1518,3,1,3,0,1,0,61.79
屏東縣,高樹鄉,泰山村,0,1,1192,22,1214,1983,3,1,3,0,1,0,61.22
屏東縣,高樹鄉,南華村,0,1,770,11,781,1239,3,1,3,0,1,0,63.03
屏東縣,高樹鄉,廣福村,0,1,643,9,652,968,3,1,3,0,1,0,67.36
屏東縣,高樹鄉,廣興村,0,1,674,9,683,1046,3,1,3,0,1,0,65.30
屏東縣,高樹鄉,舊庄村,0,1,692,14,706,1037,3,1,3,0,1,0,68.08
屏東縣,高樹鄉,田子村,0,1,767,10,777,1126,3,1,3,0,1,0,69.01
屏東縣,高樹鄉,鹽樹村,0,1,909,10,919,1366,3,1,3,0,1,0,67.28
屏東縣,高樹鄉,新南村,0,1,926,9,935,1438,3,1,3,0,1,0,65.02
屏東縣,萬巒鄉,萬巒村,0,1,854,12,866,1263,3,1,3,0,1,0,68.57
屏東縣,萬巒鄉,萬全村,0,1,560,3,563,782,3,1,3,0,1,0,71.99
屏東縣,萬巒鄉,萬和村,0,1,981,14,995,1421,3,1,3,0,1,0,70.02
屏東縣,萬巒鄉,鹿寮村,0,1,648,3,651,899,3,1,3,0,1,0,72.41
屏東縣,萬巒鄉,硫黃村,0,1,375,8,383,542,3,1,3,0,1,0,70.66
屏東縣,萬巒鄉,泗溝村,0,1,866,13,879,1264,3,1,3,0,1,0,69.54
屏東縣,萬巒鄉,五溝村,0,1,836,15,851,1144,3,1,3,0,1,0,74.39
屏東縣,萬巒鄉,成德村,0,1,960,14,974,1372,3,1,3,0,1,0,70.99
屏東縣,萬巒鄉,赤山村,0,1,991,17,1008,1673,3,1,3,0,1,0,60.25
屏東縣,萬巒鄉,萬金村,0,1,1254,26,1280,1891,3,1,3,0,1,0,67.69
屏東縣,萬巒鄉,佳佐村,0,1,1105,7,1112,1535,3,1,3,0,1,0,72.44
屏東縣,萬巒鄉,佳和村,0,1,1092,12,1104,1493,3,1,3,0,1,0,73.95
屏東縣,萬巒鄉,新厝村,0,1,741,7,748,1075,3,1,3,0,1,0,69.58
屏東縣,萬巒鄉,新置村,0,1,792,12,804,1184,3,1,3,0,1,0,67.91
屏東縣,內埔鄉,內埔村,0,1,2136,12,2148,3161,3,1,3,0,1,0,67.95
屏東縣,內埔鄉,內田村,0,1,1787,14,1801,2740,3,1,3,0,1,0,65.73
屏東縣,內埔鄉,興南村,0,1,945,6,951,1314,3,1,3,0,1,0,72.37
屏東縣,內埔鄉,義亭村,0,1,397,8,405,590,3,1,3,0,1,0,68.64
屏東縣,內埔鄉,美和村,0,1,1410,14,1424,2083,3,1,3,0,1,0,68.36
屏東縣,內埔鄉,和興村,0,1,1264,11,1275,1848,3,1,3,0,1,0,68.99
屏東縣,內埔鄉,東寧村,0,1,2697,30,2727,3962,3,1,3,0,1,0,68.83
屏東縣,內埔鄉,豐田村,0,1,1496,11,1507,2436,3,1,3,0,1,0,61.86
屏東縣,內埔鄉,振豐村,0,1,1187,7,1194,1644,3,1,3,0,1,0,72.63
屏東縣,內埔鄉,富田村,0,1,1332,9,1341,1905,3,1,3,0,1,0,70.39
屏東縣,內埔鄉,竹圍村,0,1,996,16,1012,1532,3,1,3,0,1,0,66.06
屏東縣,內埔鄉,東勢村,0,1,1905,19,1924,2875,3,1,3,0,1,0,66.92
屏東縣,內埔鄉,東片村,0,1,658,9,667,948,3,1,3,0,1,0,70.36
屏東縣,內埔鄉,上樹村,0,1,740,6,746,1068,3,1,3,0,1,0,69.85
屏東縣,內埔鄉,老埤村,0,1,1388,17,1405,2359,3,1,3,0,1,0,59.56
屏東縣,內埔鄉,中林村,0,1,896,18,914,1453,3,1,3,0,1,0,62.90
屏東縣,內埔鄉,龍泉村,0,1,1584,17,1601,2464,3,1,3,0,1,0,64.98
屏東縣,內埔鄉,龍潭村,0,1,1641,21,1662,2559,3,1,3,0,1,0,64.95
屏東縣,內埔鄉,建興村,0,1,1041,49,1090,1845,3,1,3,0,1,0,59.08
屏東縣,內埔鄉,大新村,0,1,1131,13,1144,1726,3,1,3,0,1,0,66.28
屏東縣,內埔鄉,黎明村,0,1,1424,13,1437,2201,3,1,3,0,1,0,65.29
屏東縣,內埔鄉,隘寮村,0,1,680,18,698,1146,3,1,3,0,1,0,60.91
屏東縣,內埔鄉,水門村,0,1,493,8,501,784,3,1,3,0,1,0,63.90
屏東縣,竹田鄉,竹田村,0,1,1036,16,1052,1437,3,1,3,0,1,0,73.21
屏東縣,竹田鄉,竹南村,0,1,573,3,576,843,3,1,3,0,1,0,68.33
屏東縣,竹田鄉,糶糴村,0,1,509,3,512,676,3,1,3,0,1,0,75.74
屏東縣,竹田鄉,履豐村,0,1,427,1,428,596,3,1,3,0,1,0,71.81
屏東縣,竹田鄉,頭崙村,0,1,920,9,929,1315,3,1,3,0,1,0,70.65
屏東縣,竹田鄉,二崙村,0,1,718,7,725,960,3,1,3,0,1,0,75.52
屏東縣,竹田鄉,美崙村,0,1,439,6,445,606,3,1,3,0,1,0,73.43
屏東縣,竹田鄉,南勢村,0,1,345,4,349,464,3,1,3,0,1,0,75.22
屏東縣,竹田鄉,西勢村,0,1,1786,20,1806,2538,3,1,3,0,1,0,71.16
屏東縣,竹田鄉,福田村,0,1,355,1,356,442,3,1,3,0,1,0,80.54
屏東縣,竹田鄉,永豐村,0,1,420,3,423,608,3,1,3,0,1,0,69.57
屏東縣,竹田鄉,六巷村,0,1,501,6,507,673,3,1,3,0,1,0,75.33
屏東縣,竹田鄉,泗洲村,0,1,714,12,726,1089,3,1,3,0,1,0,66.67
屏東縣,竹田鄉,大湖村,0,1,812,4,816,1171,3,1,3,0,1,0,69.68
屏東縣,竹田鄉,鳳明村,0,1,678,10,688,983,3,1,3,0,1,0,69.99
屏東縣,新埤鄉,新埤村,0,1,1279,11,1290,1909,3,1,3,0,1,0,67.57
屏東縣,新埤鄉,建功村,0,1,872,3,875,1227,3,1,3,0,1,0,71.31
屏東縣,新埤鄉,打鐵村,0,1,739,6,745,1014,3,1,3,0,1,0,73.47
屏東縣,新埤鄉,南豐村,0,1,519,5,524,758,3,1,3,0,1,0,69.13
屏東縣,新埤鄉,萬隆村,0,1,1084,14,1098,1686,3,1,3,0,1,0,65.12
屏東縣,新埤鄉,餉潭村,0,1,792,8,800,1345,3,1,3,0,1,0,59.48
屏東縣,新埤鄉,箕湖村,0,1,707,12,719,1090,3,1,3,0,1,0,65.96
屏東縣,枋寮鄉,枋寮村,0,1,758,10,768,1282,3,1,3,0,1,0,59.91
屏東縣,枋寮鄉,新龍村,0,1,543,6,549,839,3,1,3,0,1,0,65.44
屏東縣,枋寮鄉,保生村,0,1,624,5,629,937,3,1,3,0,1,0,67.13
屏東縣,枋寮鄉,中寮村,0,1,429,5,434,684,3,1,3,0,1,0,63.45
屏東縣,枋寮鄉,安樂村,0,1,1130,15,1145,1819,3,1,3,0,1,0,62.95
屏東縣,枋寮鄉,隆山村,0,1,2090,24,2114,3668,3,1,3,0,1,0,57.63
屏東縣,枋寮鄉,天時村,0,1,1340,8,1348,2028,3,1,3,0,1,0,66.47
屏東縣,枋寮鄉,地利村,0,1,1175,9,1184,1678,3,1,3,0,1,0,70.56
屏東縣,枋寮鄉,人和村,0,1,1429,18,1447,2195,3,1,3,0,1,0,65.92
屏東縣,枋寮鄉,內寮村,0,1,410,6,416,741,3,1,3,0,1,0,56.14
屏東縣,枋寮鄉,新開村,0,1,562,20,582,974,3,1,3,0,1,0,59.75
屏東縣,枋寮鄉,東海村,0,1,1779,14,1793,2764,3,1,3,0,1,0,64.87
屏東縣,枋寮鄉,大庄村,0,1,406,2,408,608,3,1,3,0,1,0,67.11
屏東縣,枋寮鄉,太源村,0,1,598,11,609,948,3,1,3,0,1,0,64.24
屏東縣,枋寮鄉,玉泉村,0,1,293,2,295,441,3,1,3,0,1,0,66.89
屏東縣,新園鄉,瓦磘村,0,1,1163,7,1170,1595,3,1,3,0,1,0,73.35
屏東縣,新園鄉,仙吉村,0,1,1637,13,1650,2351,3,1,3,0,1,0,70.18
屏東縣,新園鄉,田洋村,0,1,1401,16,1417,2017,3,1,3,0,1,0,70.25
屏東縣,新園鄉,港墘村,0,1,497,12,509,774,3,1,3,0,1,0,65.76
屏東縣,新園鄉,內庄村,0,1,588,5,593,789,3,1,3,0,1,0,75.16
屏東縣,新園鄉,新東村,0,1,1521,36,1557,2227,3,1,3,0,1,0,69.91
屏東縣,新園鄉,新園村,0,1,1378,14,1392,1927,3,1,3,0,1,0,72.24
屏東縣,新園鄉,港西村,0,1,1670,16,1686,2164,3,1,3,0,1,0,77.91
屏東縣,新園鄉,五房村,0,1,1866,38,1904,2809,3,1,3,0,1,0,67.78
屏東縣,新園鄉,烏龍村,0,1,935,11,946,1265,3,1,3,0,1,0,74.78
屏東縣,新園鄉,興龍村,0,1,1427,20,1447,2084,3,1,3,0,1,0,69.43
屏東縣,新園鄉,中洲村,0,1,1132,13,1145,1713,3,1,3,0,1,0,66.84
屏東縣,新園鄉,南龍村,0,1,947,10,957,1405,3,1,3,0,1,0,68.11
屏東縣,新園鄉,鹽埔村,0,1,2395,29,2424,3898,3,1,3,0,1,0,62.19
屏東縣,新園鄉,共和村,0,1,1405,30,1435,2215,3,1,3,0,1,0,64.79
屏東縣,崁頂鄉,崁頂村,0,1,1405,15,1420,2009,3,1,3,0,1,0,70.68
屏東縣,崁頂鄉,園寮村,0,1,1074,4,1078,1654,3,1,3,0,1,0,65.18
屏東縣,崁頂鄉,力社村,0,1,777,16,793,1100,3,1,3,0,1,0,72.09
屏東縣,崁頂鄉,圍內村,0,1,779,7,786,1118,3,1,3,0,1,0,70.30
屏東縣,崁頂鄉,洲子村,0,1,570,6,576,874,3,1,3,0,1,0,65.90
屏東縣,崁頂鄉,北勢村,0,1,1036,12,1048,1497,3,1,3,0,1,0,70.01
屏東縣,崁頂鄉,越溪村,0,1,544,10,554,774,3,1,3,0,1,0,71.58
屏東縣,崁頂鄉,港東村,0,1,1196,20,1216,1737,3,1,3,0,1,0,70.01
屏東縣,林邊鄉,林邊村,0,1,1023,11,1034,1460,3,1,3,0,1,0,70.82
屏東縣,林邊鄉,光林村,0,1,1070,13,1083,1625,3,1,3,0,1,0,66.65
屏東縣,林邊鄉,中林村,0,1,581,5,586,843,3,1,3,0,1,0,69.51
屏東縣,林邊鄉,仁和村,0,1,1111,6,1117,1588,3,1,3,0,1,0,70.34
屏東縣,林邊鄉,永樂村,0,1,2293,21,2314,3196,3,1,3,0,1,0,72.40
屏東縣,林邊鄉,田厝村,0,1,632,2,634,905,3,1,3,0,1,0,70.06
屏東縣,林邊鄉,崎峰村,0,1,815,9,824,1329,3,1,3,0,1,0,62.00
屏東縣,林邊鄉,水利村,0,1,1178,10,1188,1864,3,1,3,0,1,0,63.73
屏東縣,林邊鄉,竹林村,0,1,1906,18,1924,2876,3,1,3,0,1,0,66.90
屏東縣,林邊鄉,鎮安村,0,1,775,9,784,1130,3,1,3,0,1,0,69.38
屏東縣,南州鄉,溪洲村,0,1,1256,12,1268,1778,3,1,3,0,1,0,71.32
屏東縣,南州鄉,溪南村,0,1,695,2,697,1003,3,1,3,0,1,0,69.49
屏東縣,南州鄉,仁里村,0,1,380,5,385,574,3,1,3,0,1,0,67.07
屏東縣,南州鄉,溪北村,0,1,555,12,567,777,3,1,3,0,1,0,72.97
屏東縣,南州鄉,七塊村,0,1,720,9,729,1040,3,1,3,0,1,0,70.10
屏東縣,南州鄉,萬華村,0,1,706,6,712,1002,3,1,3,0,1,0,71.06
屏東縣,南州鄉,米崙村,0,1,742,9,751,1019,3,1,3,0,1,0,73.70
屏東縣,南州鄉,壽元村,0,1,728,13,741,1105,3,1,3,0,1,0,67.06
屏東縣,南州鄉,同安村,0,1,645,5,650,949,3,1,3,0,1,0,68.49
屏東縣,南州鄉,南安村,0,1,418,4,422,582,3,1,3,0,1,0,72.51
屏東縣,佳冬鄉,佳冬村,0,1,1027,9,1036,1510,3,1,3,0,1,0,68.61
屏東縣,佳冬鄉,六根村,0,1,1109,14,1123,1625,3,1,3,0,1,0,69.11
屏東縣,佳冬鄉,賴家村,0,1,641,7,648,959,3,1,3,0,1,0,67.57
屏東縣,佳冬鄉,萬建村,0,1,1156,8,1164,1687,3,1,3,0,1,0,69.00
屏東縣,佳冬鄉,石光村,0,1,1273,21,1294,1920,3,1,3,0,1,0,67.40
屏東縣,佳冬鄉,玉光村,0,1,1413,16,1429,2185,3,1,3,0,1,0,65.40
屏東縣,佳冬鄉,昌隆村,0,1,818,9,827,1126,3,1,3,0,1,0,73.45
屏東縣,佳冬鄉,豐隆村,0,1,629,7,636,840,3,1,3,0,1,0,75.71
屏東縣,佳冬鄉,大同村,0,1,868,13,881,1215,3,1,3,0,1,0,72.51
屏東縣,佳冬鄉,羌園村,0,1,717,11,728,1037,3,1,3,0,1,0,70.20
屏東縣,佳冬鄉,燄溫村,0,1,711,8,719,1103,3,1,3,0,1,0,65.19
屏東縣,佳冬鄉,塭豐村,0,1,1487,12,1499,2236,3,1,3,0,1,0,67.04
屏東縣,琉球鄉,本福村,0,1,1036,19,1055,1968,3,1,3,0,1,0,53.61
屏東縣,琉球鄉,中福村,0,1,599,10,609,1108,3,1,3,0,1,0,54.96
屏東縣,琉球鄉,漁福村,0,1,485,9,494,1018,3,1,3,0,1,0,48.53
屏東縣,琉球鄉,大福村,0,1,750,9,759,1587,3,1,3,0,1,0,47.83
屏東縣,琉球鄉,南福村,0,1,492,9,501,1231,3,1,3,0,1,0,40.70
屏東縣,琉球鄉,天福村,0,1,432,10,442,1083,3,1,3,0,1,0,40.81
屏東縣,琉球鄉,上福村,0,1,626,11,637,1477,3,1,3,0,1,0,43.13
屏東縣,琉球鄉,杉福村,0,1,347,3,350,779,3,1,3,0,1,0,44.93
屏東縣,車城鄉,福興村,0,1,874,17,891,1350,3,1,3,0,1,0,66.00
屏東縣,車城鄉,福安村,0,1,390,3,393,564,3,1,3,0,1,0,69.68
屏東縣,車城鄉,田中村,0,1,440,6,446,743,3,1,3,0,1,0,60.03
屏東縣,車城鄉,海口村,0,1,478,6,484,810,3,1,3,0,1,0,59.75
屏東縣,車城鄉,統埔村,0,1,255,4,259,429,3,1,3,0,1,0,60.37
屏東縣,車城鄉,溫泉村,0,1,543,13,556,997,3,1,3,0,1,0,55.77
屏東縣,車城鄉,保力村,0,1,784,14,798,1377,3,1,3,0,1,0,57.95
屏東縣,車城鄉,新街村,0,1,287,2,289,427,3,1,3,0,1,0,67.68
屏東縣,車城鄉,埔墘村,0,1,242,7,249,455,3,1,3,0,1,0,54.73
屏東縣,車城鄉,射寮村,0,1,327,2,329,537,3,1,3,0,1,0,61.27
屏東縣,車城鄉,後灣村,0,1,275,10,285,488,3,1,3,0,1,0,58.40
屏東縣,滿州鄉,滿州村,0,1,742,9,751,1346,3,1,3,0,1,0,55.79
屏東縣,滿州鄉,里德村,0,1,136,5,141,271,3,1,3,0,1,0,52.03
屏東縣,滿州鄉,永靖村,0,1,650,14,664,1170,3,1,3,0,1,0,56.75
屏東縣,滿州鄉,港口村,0,1,666,5,671,1108,3,1,3,0,1,0,60.56
屏東縣,滿州鄉,響林村,0,1,217,3,220,412,3,1,3,0,1,0,53.40
屏東縣,滿州鄉,長樂村,0,1,313,8,321,646,3,1,3,0,1,0,49.69
屏東縣,滿州鄉,九棚村,0,1,112,0,112,227,3,1,3,0,1,0,49.34
屏東縣,滿州鄉,港仔村,0,1,165,0,165,302,3,1,3,0,1,0,54.64
屏東縣,枋山鄉,加祿村,0,1,1232,15,1247,1838,3,1,3,0,1,0,67.85
屏東縣,枋山鄉,枋山村,0,1,683,8,691,1059,3,1,3,0,1,0,65.25
屏東縣,枋山鄉,楓港村,0,1,537,10,547,1067,3,1,3,0,1,0,51.27
屏東縣,枋山鄉,善餘村,0,1,461,3,464,985,3,1,3,0,1,0,47.11
屏東縣,三地門鄉,三地村,0,1,79,2,81,122,3,1,3,0,1,0,66.39
屏東縣,三地門鄉,達來村,0,1,9,0,9,17,3,1,3,0,1,0,52.94
屏東縣,三地門鄉,德文村,0,1,6,0,6,15,3,1,3,0,1,0,40.00
屏東縣,三地門鄉,大社村,0,1,6,0,6,20,3,1,3,0,1,0,30.00
屏東縣,三地門鄉,賽嘉村,0,1,25,3,28,49,3,1,3,0,1,0,57.14
屏東縣,三地門鄉,口社村,0,1,30,0,30,42,3,1,3,0,1,0,71.43
屏東縣,三地門鄉,馬兒村,0,1,9,0,9,15,3,1,3,0,1,0,60.00
屏東縣,三地門鄉,安坡村,0,1,21,0,21,38,3,1,3,0,1,0,55.26
屏東縣,三地門鄉,青山村,0,1,49,1,50,79,3,1,3,0,1,0,63.29
屏東縣,三地門鄉,青葉村,0,1,15,1,16,39,3,1,3,0,1,0,41.03
屏東縣,霧台鄉,霧台村,0,1,10,1,11,24,3,1,3,0,1,0,45.83
屏東縣,霧台鄉,好茶村,0,1,7,0,7,15,3,1,3,0,1,0,46.67
屏東縣,霧台鄉,阿禮村,0,1,2,0,2,3,3,1,3,0,1,0,66.67
屏東縣,霧台鄉,吉露村,0,1,2,0,2,3,3,1,3,0,1,0,66.67
屏東縣,霧台鄉,大武村,0,1,6,0,6,17,3,1,3,0,1,0,35.29
屏東縣,霧台鄉,佳暮村,0,1,1,0,1,4,3,1,3,0,1,0,25.00
屏東縣,瑪家鄉,瑪家村,0,1,10,0,10,18,3,1,3,0,1,0,55.56
屏東縣,瑪家鄉,北葉村,0,1,57,0,57,86,3,1,3,0,1,0,66.28
屏東縣,瑪家鄉,涼山村,0,1,34,0,34,59,3,1,3,0,1,0,57.63
屏東縣,瑪家鄉,佳義村,0,1,27,2,29,53,3,1,3,0,1,0,54.72
屏東縣,瑪家鄉,排灣村,0,1,5,0,5,12,3,1,3,0,1,0,41.67
屏東縣,瑪家鄉,三和村,0,1,69,8,77,122,3,1,3,0,1,0,63.11
屏東縣,泰武鄉,佳平村,0,1,28,0,28,39,3,1,3,0,1,0,71.79
屏東縣,泰武鄉,武潭村,0,1,17,0,17,42,3,1,3,0,1,0,40.48
屏東縣,泰武鄉,平和村,0,1,10,0,10,22,3,1,3,0,1,0,45.45
屏東縣,泰武鄉,佳興村,0,1,7,0,7,12,3,1,3,0,1,0,58.33
屏東縣,泰武鄉,泰武村,0,1,2,0,2,6,3,1,3,0,1,0,33.33
屏東縣,泰武鄉,萬安村,0,1,14,0,14,29,3,1,3,0,1,0,48.28
屏東縣,來義鄉,來義村,0,1,15,0,15,26,3,1,3,0,1,0,57.69
屏東縣,來義鄉,義林村,0,1,15,0,15,27,3,1,3,0,1,0,55.56
屏東縣,來義鄉,丹林村,0,1,35,0,35,60,3,1,3,0,1,0,58.33
屏東縣,來義鄉,古樓村,0,1,42,2,44,73,3,1,3,0,1,0,60.27
屏東縣,來義鄉,文樂村,0,1,26,1,27,45,3,1,3,0,1,0,60.00
屏東縣,來義鄉,望嘉村,0,1,39,2,41,53,3,1,3,0,1,0,77.36
屏東縣,來義鄉,南和村,0,1,31,3,34,60,3,1,3,0,1,0,56.67
屏東縣,春日鄉,春日村,0,1,20,3,23,54,3,1,3,0,1,0,42.59
屏東縣,春日鄉,古華村,0,1,27,1,28,45,3,1,3,0,1,0,62.22
屏東縣,春日鄉,士文村,0,1,2,0,2,9,3,1,3,0,1,0,22.22
屏東縣,春日鄉,歸崇村,0,1,64,0,64,125,3,1,3,0,1,0,51.20
屏東縣,春日鄉,七佳村,0,1,78,1,79,113,3,1,3,0,1,0,69.91
屏東縣,春日鄉,力里村,0,1,6,0,6,16,3,1,3,0,1,0,37.50
屏東縣,獅子鄉,楓林村,0,1,30,1,31,50,3,1,3,0,1,0,62.00
屏東縣,獅子鄉,丹路村,0,1,37,1,38,75,3,1,3,0,1,0,50.67
屏東縣,獅子鄉,草埔村,0,1,20,1,21,48,3,1,3,0,1,0,43.75
屏東縣,獅子鄉,內文村,0,1,7,0,7,22,3,1,3,0,1,0,31.82
屏東縣,獅子鄉,竹坑村,0,1,15,2,17,29,3,1,3,0,1,0,58.62
屏東縣,獅子鄉,獅子村,0,1,9,0,9,17,3,1,3,0,1,0,52.94
屏東縣,獅子鄉,內獅村,0,1,21,1,22,35,3,1,3,0,1,0,62.86
屏東縣,獅子鄉,南世村,0,1,8,0,8,23,3,1,3,0,1,0,34.78
屏東縣,牡丹鄉,石門村,0,1,98,4,102,161,3,1,3,0,1,0,63.35
屏東縣,牡丹鄉,牡丹村,0,1,16,1,17,31,3,1,3,0,1,0,54.84
屏東縣,牡丹鄉,東源村,0,1,13,1,14,23,3,1,3,0,1,0,60.87
屏東縣,牡丹鄉,旭海村,0,1,44,3,47,108,3,1,3,0,1,0,43.52
屏東縣,牡丹鄉,高士村,0,1,14,0,14,37,3,1,3,0,1,0,37.84
屏東縣,牡丹鄉,四林村,0,1,7,2,9,26,3,1,3,0,1,0,34.62
臺東縣,台東市,文化里,0,1,682,9,691,1054,3,1,3,0,1,0,65.56
臺東縣,台東市,民族里,0,1,1000,8,1008,1457,3,1,3,0,1,0,69.18
臺東縣,台東市,自強里,0,1,2014,17,2031,3265,3,1,3,0,1,0,62.21
臺東縣,台東市,民生里,0,1,1719,26,1745,2741,3,1,3,0,1,0,63.66
臺東縣,台東市,寶桑里,0,1,442,5,447,765,3,1,3,0,1,0,58.43
臺東縣,台東市,民權里,0,1,639,7,646,1086,3,1,3,0,1,0,59.48
臺東縣,台東市,四維里,0,1,264,5,269,462,3,1,3,0,1,0,58.23
臺東縣,台東市,中華里,0,1,989,17,1006,1654,3,1,3,0,1,0,60.82
臺東縣,台東市,仁愛里,0,1,463,9,472,733,3,1,3,0,1,0,64.39
臺東縣,台東市,強國里,0,1,392,4,396,637,3,1,3,0,1,0,62.17
臺東縣,台東市,大同里,0,1,458,5,463,771,3,1,3,0,1,0,60.05
臺東縣,台東市,成功里,0,1,524,9,533,867,3,1,3,0,1,0,61.48
臺東縣,台東市,建國里,0,1,805,14,819,1355,3,1,3,0,1,0,60.44
臺東縣,台東市,中正里,0,1,551,7,558,887,3,1,3,0,1,0,62.91
臺東縣,台東市,中山里,0,1,640,6,646,998,3,1,3,0,1,0,64.73
臺東縣,台東市,興國里,0,1,444,6,450,721,3,1,3,0,1,0,62.41
臺東縣,台東市,鐵花里,0,1,302,2,304,441,3,1,3,0,1,0,68.93
臺東縣,台東市,東海里,0,1,1751,18,1769,2844,3,1,3,0,1,0,62.20
臺東縣,台東市,復國里,0,1,397,7,404,701,3,1,3,0,1,0,57.63
臺東縣,台東市,復興里,0,1,267,6,273,474,3,1,3,0,1,0,57.59
臺東縣,台東市,新興里,0,1,678,8,686,1173,3,1,3,0,1,0,58.48
臺東縣,台東市,新生里,0,1,2680,27,2707,4440,3,1,3,0,1,0,60.97
臺東縣,台東市,中心里,0,1,1297,14,1311,2138,3,1,3,0,1,0,61.32
臺東縣,台東市,馬蘭里,0,1,1774,16,1790,2743,3,1,3,0,1,0,65.26
臺東縣,台東市,光明里,0,1,846,12,858,1420,3,1,3,0,1,0,60.42
臺東縣,台東市,豐年里,0,1,949,18,967,1657,3,1,3,0,1,0,58.36
臺東縣,台東市,豐樂里,0,1,561,4,565,865,3,1,3,0,1,0,65.32
臺東縣,台東市,永樂里,0,1,720,9,729,1092,3,1,3,0,1,0,66.76
臺東縣,台東市,康樂里,0,1,686,13,699,1078,3,1,3,0,1,0,64.84
臺東縣,台東市,豐榮里,0,1,3225,29,3254,5491,3,1,3,0,1,0,59.26
臺東縣,台東市,豐谷里,0,1,1749,29,1778,3029,3,1,3,0,1,0,58.70
臺東縣,台東市,豐里里,0,1,907,13,920,1578,3,1,3,0,1,0,58.30
臺東縣,台東市,豐原里,0,1,557,11,568,939,3,1,3,0,1,0,60.49
臺東縣,台東市,富岡里,0,1,680,22,702,1108,3,1,3,0,1,0,63.36
臺東縣,台東市,富豐里,0,1,274,7,281,479,3,1,3,0,1,0,58.66
臺東縣,台東市,南榮里,0,1,955,30,985,1596,3,1,3,0,1,0,61.72
臺東縣,台東市,岩灣里,0,1,643,4,647,1080,3,1,3,0,1,0,59.91
臺東縣,台東市,卑南里,0,1,1224,15,1239,1791,3,1,3,0,1,0,69.18
臺東縣,台東市,南王里,0,1,849,12,861,1439,3,1,3,0,1,0,59.83
臺東縣,台東市,豐田里,0,1,1097,14,1111,1780,3,1,3,0,1,0,62.42
臺東縣,台東市,新園里,0,1,569,5,574,993,3,1,3,0,1,0,57.80
臺東縣,台東市,建和里,0,1,499,5,504,866,3,1,3,0,1,0,58.20
臺東縣,台東市,建興里,0,1,516,6,522,831,3,1,3,0,1,0,62.82
臺東縣,台東市,建業里,0,1,531,4,535,836,3,1,3,0,1,0,64.00
臺東縣,台東市,知本里,0,1,519,10,529,870,3,1,3,0,1,0,60.80
臺東縣,台東市,建農里,0,1,623,23,646,1113,3,1,3,0,1,0,58.04
臺東縣,成功鎮,信義里,0,1,238,3,241,466,3,1,3,0,1,0,51.72
臺東縣,成功鎮,和平里,0,1,84,3,87,163,3,1,3,0,1,0,53.37
臺東縣,成功鎮,忠仁里,0,1,1455,21,1476,2443,3,1,3,0,1,0,60.42
臺東縣,成功鎮,忠智里,0,1,680,7,687,1048,3,1,3,0,1,0,65.55
臺東縣,成功鎮,三民里,0,1,602,7,609,1087,3,1,3,0,1,0,56.03
臺東縣,成功鎮,三仙里,0,1,292,8,300,591,3,1,3,0,1,0,50.76
臺東縣,成功鎮,忠孝里,0,1,254,2,256,494,3,1,3,0,1,0,51.82
臺東縣,成功鎮,博愛里,0,1,47,2,49,109,3,1,3,0,1,0,44.95
臺東縣,關山鎮,里壟里,0,1,971,14,985,1618,3,1,3,0,1,0,60.88
臺東縣,關山鎮,中福里,0,1,547,8,555,863,3,1,3,0,1,0,64.31
臺東縣,關山鎮,新福里,0,1,394,5,399,670,3,1,3,0,1,0,59.55
臺東縣,關山鎮,豐泉里,0,1,622,4,626,957,3,1,3,0,1,0,65.41
臺東縣,關山鎮,月眉里,0,1,363,3,366,682,3,1,3,0,1,0,53.67
臺東縣,關山鎮,德高里,0,1,727,10,737,1233,3,1,3,0,1,0,59.77
臺東縣,關山鎮,電光里,0,1,101,1,102,229,3,1,3,0,1,0,44.54
臺東縣,卑南鄉,賓朗村,0,1,1085,18,1103,1799,3,1,3,0,1,0,61.31
臺東縣,卑南鄉,美農村,0,1,561,5,566,956,3,1,3,0,1,0,59.21
臺東縣,卑南鄉,初鹿村,0,1,619,12,631,1092,3,1,3,0,1,0,57.78
臺東縣,卑南鄉,明峰村,0,1,562,8,570,1051,3,1,3,0,1,0,54.23
臺東縣,卑南鄉,嘉豐村,0,1,124,4,128,233,3,1,3,0,1,0,54.94
臺東縣,卑南鄉,太平村,0,1,1706,44,1750,2841,3,1,3,0,1,0,61.60
臺東縣,卑南鄉,泰安村,0,1,394,10,404,697,3,1,3,0,1,0,57.96
臺東縣,卑南鄉,利嘉村,0,1,242,6,248,423,3,1,3,0,1,0,58.63
臺東縣,卑南鄉,東興村,0,1,154,6,160,268,3,1,3,0,1,0,59.70
臺東縣,卑南鄉,溫泉村,0,1,628,7,635,1064,3,1,3,0,1,0,59.68
臺東縣,卑南鄉,富山村,0,1,261,7,268,448,3,1,3,0,1,0,59.82
臺東縣,卑南鄉,富源村,0,1,236,3,239,373,3,1,3,0,1,0,64.08
臺東縣,卑南鄉,利吉村,0,1,135,6,141,245,3,1,3,0,1,0,57.55
臺東縣,鹿野鄉,鹿野村,0,1,440,10,450,771,3,1,3,0,1,0,58.37
臺東縣,鹿野鄉,龍田村,0,1,564,12,576,1046,3,1,3,0,1,0,55.07
臺東縣,鹿野鄉,永安村,0,1,514,6,520,1046,3,1,3,0,1,0,49.71
臺東縣,鹿野鄉,瑞隆村,0,1,392,10,402,782,3,1,3,0,1,0,51.41
臺東縣,鹿野鄉,瑞源村,0,1,320,10,330,633,3,1,3,0,1,0,52.13
臺東縣,鹿野鄉,瑞和村,0,1,193,4,197,361,3,1,3,0,1,0,54.57
臺東縣,鹿野鄉,瑞豐村,0,1,545,6,551,984,3,1,3,0,1,0,56.00
臺東縣,池上鄉,福原村,0,1,1044,13,1057,1865,3,1,3,0,1,0,56.68
臺東縣,池上鄉,福文村,0,1,646,11,657,1307,3,1,3,0,1,0,50.27
臺東縣,池上鄉,慶豐村,0,1,307,2,309,679,3,1,3,0,1,0,45.51
臺東縣,池上鄉,大坡村,0,1,47,2,49,109,3,1,3,0,1,0,44.95
臺東縣,池上鄉,大埔村,0,1,239,3,242,410,3,1,3,0,1,0,59.02
臺東縣,池上鄉,新興村,0,1,406,11,417,809,3,1,3,0,1,0,51.55
臺東縣,池上鄉,錦園村,0,1,208,2,210,426,3,1,3,0,1,0,49.30
臺東縣,池上鄉,萬安村,0,1,181,8,189,374,3,1,3,0,1,0,50.53
臺東縣,池上鄉,富興村,0,1,185,5,190,354,3,1,3,0,1,0,53.67
臺東縣,池上鄉,振興村,0,1,67,5,72,161,3,1,3,0,1,0,44.72
臺東縣,東河鄉,都蘭村,0,1,667,10,677,1229,3,1,3,0,1,0,55.09
臺東縣,東河鄉,興昌村,0,1,323,8,331,606,3,1,3,0,1,0,54.62
臺東縣,東河鄉,隆昌村,0,1,110,2,112,219,3,1,3,0,1,0,51.14
臺東縣,東河鄉,東河村,0,1,155,4,159,315,3,1,3,0,1,0,50.48
臺東縣,東河鄉,泰源村,0,1,346,6,352,652,3,1,3,0,1,0,53.99
臺東縣,東河鄉,北源村,0,1,443,10,453,945,3,1,3,0,1,0,47.94
臺東縣,東河鄉,尚德村,0,1,78,1,79,179,3,1,3,0,1,0,44.13
臺東縣,長濱鄉,寧埔村,0,1,172,3,175,377,3,1,3,0,1,0,46.42
臺東縣,長濱鄉,竹湖村,0,1,182,3,185,406,3,1,3,0,1,0,45.57
臺東縣,長濱鄉,長濱村,0,1,587,7,594,1104,3,1,3,0,1,0,53.80
臺東縣,長濱鄉,忠勇村,0,1,252,12,264,537,3,1,3,0,1,0,49.16
臺東縣,長濱鄉,長濱村,0,1,103,2,105,215,3,1,3,0,1,0,48.84
臺東縣,長濱鄉,三間村,0,1,209,9,218,437,3,1,3,0,1,0,49.89
臺東縣,長濱鄉,樟原村,0,1,167,0,167,276,3,1,3,0,1,0,60.51
臺東縣,太麻里鄉,美和村,0,1,514,10,524,924,3,1,3,0,1,0,56.71
臺東縣,太麻里鄉,三和村,0,1,347,11,358,614,3,1,3,0,1,0,58.31
臺東縣,太麻里鄉,華源村,0,1,376,8,384,701,3,1,3,0,1,0,54.78
臺東縣,太麻里鄉,北里村,0,1,227,5,232,380,3,1,3,0,1,0,61.05
臺東縣,太麻里鄉,大王村,0,1,680,9,689,1190,3,1,3,0,1,0,57.90
臺東縣,太麻里鄉,泰和村,0,1,785,9,794,1265,3,1,3,0,1,0,62.77
臺東縣,太麻里鄉,香蘭村,0,1,270,7,277,493,3,1,3,0,1,0,56.19
臺東縣,太麻里鄉,金崙村,0,1,264,3,267,509,3,1,3,0,1,0,52.46
臺東縣,太麻里鄉,多良村,0,1,125,5,130,247,3,1,3,0,1,0,52.63
臺東縣,大武鄉,南興村,0,1,128,0,128,248,3,1,3,0,1,0,51.61
臺東縣,大武鄉,尚武村,0,1,597,9,606,1178,3,1,3,0,1,0,51.44
臺東縣,大武鄉,大武村,0,1,481,10,491,861,3,1,3,0,1,0,57.03
臺東縣,大武鄉,大鳥村,0,1,47,0,47,104,3,1,3,0,1,0,45.19
臺東縣,大武鄉,大竹村,0,1,45,0,45,88,3,1,3,0,1,0,51.14
臺東縣,綠島鄉,南寮村,0,1,356,7,363,663,3,1,3,0,1,0,54.75
臺東縣,綠島鄉,中寮村,0,1,341,7,348,738,3,1,3,0,1,0,47.15
臺東縣,綠島鄉,公館村,0,1,333,7,340,598,3,1,3,0,1,0,56.86
臺東縣,海端鄉,加拿村,0,1,13,1,14,27,3,1,3,0,1,0,51.85
臺東縣,海端鄉,崁頂村,0,1,34,0,34,55,3,1,3,0,1,0,61.82
臺東縣,海端鄉,海端村,0,1,71,2,73,125,3,1,3,0,1,0,58.40
臺東縣,海端鄉,廣原村,0,1,44,1,45,75,3,1,3,0,1,0,60.00
臺東縣,海端鄉,霧鹿村,0,1,14,0,14,22,3,1,3,0,1,0,63.64
臺東縣,海端鄉,利稻村,0,1,19,0,19,29,3,1,3,0,1,0,65.52
臺東縣,延平鄉,桃源村,0,1,58,1,59,95,3,1,3,0,1,0,62.11
臺東縣,延平鄉,紅葉村,0,1,14,0,14,24,3,1,3,0,1,0,58.33
臺東縣,延平鄉,永康村,0,1,13,0,13,22,3,1,3,0,1,0,59.09
臺東縣,延平鄉,武陵村,0,1,19,0,19,40,3,1,3,0,1,0,47.50
臺東縣,延平鄉,鸞山村,0,1,56,1,57,102,3,1,3,0,1,0,55.88
臺東縣,金峰鄉,嘉蘭村,0,1,46,1,47,77,3,1,3,0,1,0,61.04
臺東縣,金峰鄉,正興村,0,1,31,0,31,46,3,1,3,0,1,0,67.39
臺東縣,金峰鄉,新興村,0,1,16,0,16,31,3,1,3,0,1,0,51.61
臺東縣,金峰鄉,賓茂村,0,1,5,0,5,8,3,1,3,0,1,0,62.50
臺東縣,金峰鄉,歷坵村,0,1,8,0,8,15,3,1,3,0,1,0,53.33
臺東縣,達仁鄉,安朔村,0,1,83,0,83,163,3,1,3,0,1,0,50.92
臺東縣,達仁鄉,南田村,0,1,19,1,20,55,3,1,3,0,1,0,36.36
臺東縣,達仁鄉,森永村,0,1,30,2,32,67,3,1,3,0,1,0,47.76
臺東縣,達仁鄉,新化村,0,1,3,0,3,12,3,1,3,0,1,0,25.00
臺東縣,達仁鄉,台板村,0,1,13,0,13,35,3,1,3,0,1,0,37.14
臺東縣,達仁鄉,土板村,0,1,9,0,9,24,3,1,3,0,1,0,37.50
臺東縣,蘭嶼鄉,椰油村,0,1,37,0,37,80,3,1,3,0,1,0,46.25
臺東縣,蘭嶼鄉,紅頭村,0,1,42,0,42,79,3,1,3,0,1,0,53.16
臺東縣,蘭嶼鄉,東清村,0,1,6,0,6,20,3,1,3,0,1,0,30.00
臺東縣,蘭嶼鄉,朗島村,0,1,10,0,10,15,3,1,3,0,1,0,66.67
花蓮縣,花蓮市,民德里,0,1,954,8,962,1412,3,1,3,0,1,0,68.13
花蓮縣,花蓮市,民勤里,0,1,2055,28,2083,3153,3,1,3,0,1,0,66.06
花蓮縣,花蓮市,民意里,0,1,1474,49,1523,2622,3,1,3,0,1,0,58.09
花蓮縣,花蓮市,民心里,0,1,430,4,434,748,3,1,3,0,1,0,58.02
花蓮縣,花蓮市,民享里,0,1,1907,26,1933,3052,3,1,3,0,1,0,63.34
花蓮縣,花蓮市,民運里,0,1,1150,30,1180,1766,3,1,3,0,1,0,66.82
花蓮縣,花蓮市,民政里,0,1,1675,20,1695,2596,3,1,3,0,1,0,65.29
花蓮縣,花蓮市,民立里,0,1,863,16,879,1326,3,1,3,0,1,0,66.29
花蓮縣,花蓮市,民樂里,0,1,289,7,296,511,3,1,3,0,1,0,57.93
花蓮縣,花蓮市,民有里,0,1,406,5,411,626,3,1,3,0,1,0,65.65
花蓮縣,花蓮市,民主里,0,1,392,10,402,592,3,1,3,0,1,0,67.91
花蓮縣,花蓮市,民治里,0,1,256,5,261,379,3,1,3,0,1,0,68.87
花蓮縣,花蓮市,民族里,0,1,370,5,375,577,3,1,3,0,1,0,64.99
花蓮縣,花蓮市,民生里,0,1,838,7,845,1294,3,1,3,0,1,0,65.30
花蓮縣,花蓮市,民權里,0,1,267,4,271,435,3,1,3,0,1,0,62.30
花蓮縣,花蓮市,主商里,0,1,501,1,502,741,3,1,3,0,1,0,67.75
花蓮縣,花蓮市,主勤里,0,1,643,11,654,966,3,1,3,0,1,0,67.70
花蓮縣,花蓮市,主工里,0,1,419,5,424,632,3,1,3,0,1,0,67.09
花蓮縣,花蓮市,主信里,0,1,441,8,449,731,3,1,3,0,1,0,61.42
花蓮縣,花蓮市,主睦里、主義里,0,1,657,10,667,1016,3,1,3,0,1,0,65.65
花蓮縣,花蓮市,主計里,0,1,472,7,479,818,3,1,3,0,1,0,58.56
花蓮縣,花蓮市,主和里,0,1,1684,29,1713,2693,3,1,3,0,1,0,63.61
花蓮縣,花蓮市,主學里,0,1,1057,10,1067,1678,3,1,3,0,1,0,63.59
花蓮縣,花蓮市,主農里,0,1,3242,41,3283,5062,3,1,3,0,1,0,64.86
花蓮縣,花蓮市,主權里,0,1,2406,34,2440,3931,3,1,3,0,1,0,62.07
花蓮縣,花蓮市,主力里,0,1,1493,15,1508,2347,3,1,3,0,1,0,64.25
花蓮縣,花蓮市,國風里,0,1,1901,23,1924,3049,3,1,3,0,1,0,63.10
花蓮縣,花蓮市,國威里,0,1,966,7,973,1630,3,1,3,0,1,0,59.69
花蓮縣,花蓮市,國治里,0,1,678,12,690,1078,3,1,3,0,1,0,64.01
花蓮縣,花蓮市,國安里,0,1,272,10,282,439,3,1,3,0,1,0,64.24
花蓮縣,花蓮市,國光里,0,1,919,17,936,1396,3,1,3,0,1,0,67.05
花蓮縣,花蓮市,國防里,0,1,475,7,482,772,3,1,3,0,1,0,62.44
花蓮縣,花蓮市,國華里,0,1,1289,12,1301,2031,3,1,3,0,1,0,64.06
花蓮縣,花蓮市,國魂里,0,1,1120,17,1137,1737,3,1,3,0,1,0,65.46
花蓮縣,花蓮市,國聯里,0,1,2586,35,2621,4443,3,1,3,0,1,0,58.99
花蓮縣,花蓮市,國強里,0,1,739,10,749,1148,3,1,3,0,1,0,65.24
花蓮縣,花蓮市,國富里,0,1,2723,21,2744,4269,3,1,3,0,1,0,64.28
花蓮縣,花蓮市,國裕里,0,1,1937,25,1962,3106,3,1,3,0,1,0,63.17
花蓮縣,花蓮市,國慶里,0,1,2050,24,2074,3378,3,1,3,0,1,0,61.40
花蓮縣,花蓮市,國福里,0,1,475,10,485,858,3,1,3,0,1,0,56.53
花蓮縣,新城鄉,新城村,0,1,761,12,773,1265,3,1,3,0,1,0,61.11
花蓮縣,新城鄉,順安村,0,1,489,10,499,844,3,1,3,0,1,0,59.12
花蓮縣,新城鄉,康樂村,0,1,1089,18,1107,1935,3,1,3,0,1,0,57.21
花蓮縣,新城鄉,大漢村,0,1,984,28,1012,1692,3,1,3,0,1,0,59.81
花蓮縣,新城鄉,北埔村,0,1,1417,19,1436,2405,3,1,3,0,1,0,59.71
花蓮縣,新城鄉,佳林村,0,1,329,5,334,555,3,1,3,0,1,0,60.18
花蓮縣,新城鄉,嘉里村,0,1,1578,41,1619,2632,3,1,3,0,1,0,61.51
花蓮縣,新城鄉,嘉新村,0,1,636,22,658,1042,3,1,3,0,1,0,63.15
花蓮縣,秀林鄉,和平村,0,1,187,5,192,379,3,1,3,0,1,0,50.66
花蓮縣,秀林鄉,崇德村,0,1,222,3,225,367,3,1,3,0,1,0,61.31
花蓮縣,秀林鄉,富世村,0,1,231,3,234,432,3,1,3,0,1,0,54.17
花蓮縣,秀林鄉,秀林村,0,1,69,1,70,137,3,1,3,0,1,0,51.09
花蓮縣,秀林鄉,景美村,0,1,74,4,78,149,3,1,3,0,1,0,52.35
花蓮縣,秀林鄉,佳民村,0,1,87,2,89,141,3,1,3,0,1,0,63.12
花蓮縣,秀林鄉,水源村,0,1,83,5,88,112,3,1,3,0,1,0,78.57
花蓮縣,秀林鄉,銅門村,0,1,56,1,57,87,3,1,3,0,1,0,65.52
花蓮縣,秀林鄉,文蘭村,0,1,46,4,50,92,3,1,3,0,1,0,54.35
花蓮縣,吉安鄉,永安村,0,1,1791,20,1811,3019,3,1,3,0,1,0,59.99
花蓮縣,吉安鄉,太昌村,0,1,1454,30,1484,2407,3,1,3,0,1,0,61.65
花蓮縣,吉安鄉,慶豐村,0,1,2643,39,2682,4173,3,1,3,0,1,0,64.27
花蓮縣,吉安鄉,吉安村,0,1,1793,34,1827,2999,3,1,3,0,1,0,60.92
花蓮縣,吉安鄉,福興村,0,1,1247,18,1265,1941,3,1,3,0,1,0,65.17
花蓮縣,吉安鄉,南華村,0,1,708,21,729,1108,3,1,3,0,1,0,65.79
花蓮縣,吉安鄉,干城村,0,1,475,14,489,833,3,1,3,0,1,0,58.70
花蓮縣,吉安鄉,永興村,0,1,1236,16,1252,2043,3,1,3,0,1,0,61.28
花蓮縣,吉安鄉,稻香村,0,1,1510,29,1539,2372,3,1,3,0,1,0,64.88
花蓮縣,吉安鄉,南昌村,0,1,1202,11,1213,1990,3,1,3,0,1,0,60.95
花蓮縣,吉安鄉,宜昌村,0,1,1585,24,1609,2586,3,1,3,0,1,0,62.22
花蓮縣,吉安鄉,北昌村,0,1,3609,53,3662,5660,3,1,3,0,1,0,64.70
花蓮縣,吉安鄉,勝安村,0,1,2050,31,2081,3317,3,1,3,0,1,0,62.74
花蓮縣,吉安鄉,仁里村,0,1,2718,29,2747,4398,3,1,3,0,1,0,62.46
花蓮縣,吉安鄉,東昌村,0,1,1853,22,1875,3043,3,1,3,0,1,0,61.62
花蓮縣,吉安鄉,仁安村,0,1,812,16,828,1389,3,1,3,0,1,0,59.61
花蓮縣,吉安鄉,仁和村,0,1,1921,38,1959,3271,3,1,3,0,1,0,59.89
花蓮縣,吉安鄉,光華村,0,1,532,19,551,889,3,1,3,0,1,0,61.98
花蓮縣,壽豐鄉,溪口村,0,1,416,10,426,704,3,1,3,0,1,0,60.51
花蓮縣,壽豐鄉,樹湖村,0,1,199,7,206,320,3,1,3,0,1,0,64.38
花蓮縣,壽豐鄉,豐山村,0,1,1104,21,1125,1825,3,1,3,0,1,0,61.64
花蓮縣,壽豐鄉,豐裡村,0,1,683,9,692,1166,3,1,3,0,1,0,59.35
花蓮縣,壽豐鄉,豐坪村,0,1,396,9,405,635,3,1,3,0,1,0,63.78
花蓮縣,壽豐鄉,壽豐村,0,1,649,3,652,1050,3,1,3,0,1,0,62.10
花蓮縣,壽豐鄉,共和村,0,1,338,12,350,530,3,1,3,0,1,0,66.04
花蓮縣,壽豐鄉,光榮村,0,1,87,3,90,152,3,1,3,0,1,0,59.21
花蓮縣,壽豐鄉,池南村,0,1,328,6,334,565,3,1,3,0,1,0,59.12
花蓮縣,壽豐鄉,平和村,0,1,630,8,638,1035,3,1,3,0,1,0,61.64
花蓮縣,壽豐鄉,志學村,0,1,1303,24,1327,2203,3,1,3,0,1,0,60.24
花蓮縣,壽豐鄉,米棧村,0,1,78,3,81,131,3,1,3,0,1,0,61.83
花蓮縣,壽豐鄉,月眉村,0,1,132,2,134,249,3,1,3,0,1,0,53.82
花蓮縣,壽豐鄉,鹽寮村,0,1,183,2,185,349,3,1,3,0,1,0,53.01
花蓮縣,壽豐鄉,水璉村,0,1,214,5,219,439,3,1,3,0,1,0,49.89
花蓮縣,鳳林鎮,鳳仁里,0,1,730,20,750,1127,3,1,3,0,1,0,66.55
花蓮縣,鳳林鎮,鳳義里,0,1,433,9,442,640,3,1,3,0,1,0,69.06
花蓮縣,鳳林鎮,鳳禮里,0,1,494,2,496,698,3,1,3,0,1,0,71.06
花蓮縣,鳳林鎮,鳳智里,0,1,730,15,745,1129,3,1,3,0,1,0,65.99
花蓮縣,鳳林鎮,鳳信里,0,1,563,15,578,864,3,1,3,0,1,0,66.90
花蓮縣,鳳林鎮,山興里,0,1,141,3,144,241,3,1,3,0,1,0,59.75
花蓮縣,鳳林鎮,大榮里,0,1,734,24,758,1276,3,1,3,0,1,0,59.40
花蓮縣,鳳林鎮,北林里,0,1,365,14,379,631,3,1,3,0,1,0,60.06
花蓮縣,鳳林鎮,南平里,0,1,385,4,389,689,3,1,3,0,1,0,56.46
花蓮縣,鳳林鎮,林榮里,0,1,554,18,572,853,3,1,3,0,1,0,67.06
花蓮縣,鳳林鎮,長橋里,0,1,602,19,621,1042,3,1,3,0,1,0,59.60
花蓮縣,鳳林鎮,森榮里,0,1,86,0,86,129,3,1,3,0,1,0,66.67
花蓮縣,光復鄉,大華村,0,1,608,8,616,993,3,1,3,0,1,0,62.03
花蓮縣,光復鄉,大安村,0,1,559,6,565,861,3,1,3,0,1,0,65.62
花蓮縣,光復鄉,大馬村,0,1,227,10,237,399,3,1,3,0,1,0,59.40
花蓮縣,光復鄉,大平村,0,1,155,6,161,300,3,1,3,0,1,0,53.67
花蓮縣,光復鄉,大同村,0,1,427,3,430,713,3,1,3,0,1,0,60.31
花蓮縣,光復鄉,東富村,0,1,110,0,110,229,3,1,3,0,1,0,48.03
花蓮縣,光復鄉,西富村,0,1,77,1,78,122,3,1,3,0,1,0,63.93
花蓮縣,光復鄉,南富村,0,1,55,2,57,110,3,1,3,0,1,0,51.82
花蓮縣,光復鄉,北富村,0,1,103,2,105,189,3,1,3,0,1,0,55.56
花蓮縣,光復鄉,西富村,0,1,132,2,134,227,3,1,3,0,1,0,59.03
花蓮縣,光復鄉,大進村,0,1,331,5,336,469,3,1,3,0,1,0,71.64
花蓮縣,光復鄉,大全村,0,1,374,17,391,641,3,1,3,0,1,0,61.00
花蓮縣,光復鄉,大興村,0,1,179,6,185,328,3,1,3,0,1,0,56.40
花蓮縣,光復鄉,大富村,0,1,218,9,227,367,3,1,3,0,1,0,61.85
花蓮縣,光復鄉,大豐村,0,1,322,8,330,589,3,1,3,0,1,0,56.03
花蓮縣,豐濱鄉,靜浦村,0,1,43,3,46,113,3,1,3,0,1,0,40.71
花蓮縣,豐濱鄉,港口村,0,1,70,4,74,146,3,1,3,0,1,0,50.68
花蓮縣,豐濱鄉,豐濱村,0,1,373,7,380,707,3,1,3,0,1,0,53.75
花蓮縣,豐濱鄉,新社村,0,1,44,2,46,107,3,1,3,0,1,0,42.99
花蓮縣,豐濱鄉,磯崎村,0,1,57,2,59,100,3,1,3,0,1,0,59.00
花蓮縣,萬榮鄉,西林村,0,1,26,3,29,60,3,1,3,0,1,0,48.33
花蓮縣,萬榮鄉,見晴村,0,1,9,2,11,31,3,1,3,0,1,0,35.48
花蓮縣,萬榮鄉,萬榮村,0,1,31,0,31,61,3,1,3,0,1,0,50.82
花蓮縣,萬榮鄉,明利村,0,1,37,1,38,60,3,1,3,0,1,0,63.33
花蓮縣,萬榮鄉,馬遠村,0,1,13,1,14,38,3,1,3,0,1,0,36.84
花蓮縣,萬榮鄉,紅葉村,0,1,56,0,56,104,3,1,3,0,1,0,53.85
花蓮縣,瑞穗鄉,瑞穗村,0,1,1109,11,1120,1813,3,1,3,0,1,0,61.78
花蓮縣,瑞穗鄉,瑞美村,0,1,901,13,914,1586,3,1,3,0,1,0,57.63
花蓮縣,瑞穗鄉,瑞良村,0,1,246,1,247,395,3,1,3,0,1,0,62.53
花蓮縣,瑞穗鄉,瑞祥村,0,1,475,12,487,857,3,1,3,0,1,0,56.83
花蓮縣,瑞穗鄉,瑞北村,0,1,244,0,244,422,3,1,3,0,1,0,57.82
花蓮縣,瑞穗鄉,舞鶴村,0,1,272,7,279,505,3,1,3,0,1,0,55.25
花蓮縣,瑞穗鄉,鶴岡村,0,1,140,4,144,285,3,1,3,0,1,0,50.53
花蓮縣,瑞穗鄉,奇美村,0,1,24,0,24,51,3,1,3,0,1,0,47.06
花蓮縣,瑞穗鄉,富源村,0,1,383,11,394,619,3,1,3,0,1,0,63.65
花蓮縣,瑞穗鄉,富民村,0,1,143,3,146,305,3,1,3,0,1,0,47.87
花蓮縣,瑞穗鄉,富興村,0,1,266,6,272,462,3,1,3,0,1,0,58.87
花蓮縣,玉里鎮,中城里,0,1,2538,35,2573,4216,3,1,3,0,1,0,61.03
花蓮縣,玉里鎮,國武里,0,1,837,9,846,1338,3,1,3,0,1,0,63.23
花蓮縣,玉里鎮,啟模里,0,1,994,17,1011,1701,3,1,3,0,1,0,59.44
花蓮縣,玉里鎮,泰昌里,0,1,1174,73,1247,2886,3,1,3,0,1,0,43.21
花蓮縣,玉里鎮,永昌里,0,1,624,17,641,1078,3,1,3,0,1,0,59.46
花蓮縣,玉里鎮,源城里,0,1,619,15,634,1100,3,1,3,0,1,0,57.64
花蓮縣,玉里鎮,長良里,0,1,286,21,307,619,3,1,3,0,1,0,49.60
花蓮縣,玉里鎮,樂合里,0,1,198,6,204,401,3,1,3,0,1,0,50.87
花蓮縣,玉里鎮,東豐里,0,1,189,1,190,334,3,1,3,0,1,0,56.89
花蓮縣,玉里鎮,觀音里,0,1,510,12,522,1011,3,1,3,0,1,0,51.63
花蓮縣,玉里鎮,松浦里,0,1,253,8,261,532,3,1,3,0,1,0,49.06
花蓮縣,玉里鎮,春日里,0,1,232,7,239,474,3,1,3,0,1,0,50.42
花蓮縣,玉里鎮,德武里,0,1,29,1,30,81,3,1,3,0,1,0,37.04
花蓮縣,玉里鎮,三民里,0,1,556,13,569,974,3,1,3,0,1,0,58.42
花蓮縣,玉里鎮,大禹里,0,1,586,8,594,1034,3,1,3,0,1,0,57.45
花蓮縣,富里鄉,吳江村,0,1,225,7,232,435,3,1,3,0,1,0,53.33
花蓮縣,富里鄉,東里村,0,1,593,16,609,1199,3,1,3,0,1,0,50.79
花蓮縣,富里鄉,萬寧村,0,1,287,7,294,623,3,1,3,0,1,0,47.19
花蓮縣,富里鄉,新興村,0,1,289,9,298,571,3,1,3,0,1,0,52.19
花蓮縣,富里鄉,竹田村,0,1,554,19,573,1012,3,1,3,0,1,0,56.62
花蓮縣,富里鄉,羅山村,0,1,219,5,224,457,3,1,3,0,1,0,49.02
花蓮縣,富里鄉,石牌村,0,1,482,15,497,855,3,1,3,0,1,0,58.13
花蓮縣,富里鄉,明里村,0,1,245,5,250,400,3,1,3,0,1,0,62.50
花蓮縣,富里鄉,富里村,0,1,880,24,904,1578,3,1,3,0,1,0,57.29
花蓮縣,富里鄉,永豐村,0,1,255,2,257,519,3,1,3,0,1,0,49.52
花蓮縣,富里鄉,豐南村,0,1,167,4,171,345,3,1,3,0,1,0,49.57
花蓮縣,富里鄉,富南村,0,1,270,6,276,523,3,1,3,0,1,0,52.77
花蓮縣,富里鄉,學田村,0,1,320,5,325,550,3,1,3,0,1,0,59.09
花蓮縣,卓溪鄉,崙山村,0,1,13,2,15,27,3,1,3,0,1,0,55.56
花蓮縣,卓溪鄉,立山村,0,1,15,0,15,40,3,1,3,0,1,0,37.50
花蓮縣,卓溪鄉,太平村,0,1,25,0,25,34,3,1,3,0,1,0,73.53
花蓮縣,卓溪鄉,卓溪村,0,1,38,0,38,78,3,1,3,0,1,0,48.72
花蓮縣,卓溪鄉,卓清村,0,1,47,2,49,88,3,1,3,0,1,0,55.68
花蓮縣,卓溪鄉,古風村,0,1,54,2,56,84,3,1,3,0,1,0,66.67
澎湖縣,馬公市,新復里,0,1,210,3,213,341,3,1,3,0,1,0,62.46
澎湖縣,馬公市,復興里,0,1,232,5,237,333,3,1,3,0,1,0,71.17
澎湖縣,馬公市,長安里,0,1,346,4,350,534,3,1,3,0,1,0,65.54
澎湖縣,馬公市,中央里,0,1,322,5,327,484,3,1,3,0,1,0,67.56
澎湖縣,馬公市,啟明里,0,1,534,5,539,855,3,1,3,0,1,0,63.04
澎湖縣,馬公市,重慶里,0,1,657,8,665,988,3,1,3,0,1,0,67.31
澎湖縣,馬公市,中興里,0,1,509,10,519,755,3,1,3,0,1,0,68.74
澎湖縣,馬公市,光復里,0,1,1180,13,1193,1826,3,1,3,0,1,0,65.33
澎湖縣,馬公市,光明里,0,1,768,19,787,1189,3,1,3,0,1,0,66.19
澎湖縣,馬公市,光榮里,0,1,1448,19,1467,2196,3,1,3,0,1,0,66.80
澎湖縣,馬公市,朝陽里,0,1,2701,23,2724,4278,3,1,3,0,1,0,63.67
澎湖縣,馬公市,陽明里,0,1,1405,14,1419,2233,3,1,3,0,1,0,63.55
澎湖縣,馬公市,重光里,0,1,702,6,708,1069,3,1,3,0,1,0,66.23
澎湖縣,馬公市,西衛里,0,1,1740,28,1768,2610,3,1,3,0,1,0,67.74
澎湖縣,馬公市,西文里,0,1,1225,23,1248,1902,3,1,3,0,1,0,65.62
澎湖縣,馬公市,東文里,0,1,1188,16,1204,1841,3,1,3,0,1,0,65.40
澎湖縣,馬公市,案山里,0,1,822,20,842,1207,3,1,3,0,1,0,69.76
澎湖縣,馬公市,光華里,0,1,359,7,366,584,3,1,3,0,1,0,62.67
澎湖縣,馬公市,前寮里,0,1,358,5,363,519,3,1,3,0,1,0,69.94
澎湖縣,馬公市,石泉里,0,1,889,10,899,1392,3,1,3,0,1,0,64.58
澎湖縣,馬公市,菜園里,0,1,223,1,224,313,3,1,3,0,1,0,71.57
澎湖縣,馬公市,東衛里,0,1,871,10,881,1290,3,1,3,0,1,0,68.29
澎湖縣,馬公市,安宅里,0,1,282,7,289,427,3,1,3,0,1,0,67.68
澎湖縣,馬公市,興仁里,0,1,372,5,377,550,3,1,3,0,1,0,68.55
澎湖縣,馬公市,烏崁里,0,1,523,10,533,791,3,1,3,0,1,0,67.38
澎湖縣,馬公市,鐵線里,0,1,262,2,264,365,3,1,3,0,1,0,72.33
澎湖縣,馬公市,鎖港里,0,1,1178,19,1197,1982,3,1,3,0,1,0,60.39
澎湖縣,馬公市,山水里,0,1,732,10,742,1310,3,1,3,0,1,0,56.64
澎湖縣,馬公市,五德里,0,1,114,3,117,175,3,1,3,0,1,0,66.86
澎湖縣,馬公市,井垵里,0,1,208,5,213,332,3,1,3,0,1,0,64.16
澎湖縣,馬公市,時裡里,0,1,661,10,671,1016,3,1,3,0,1,0,66.04
澎湖縣,馬公市,風櫃里,0,1,626,12,638,1126,3,1,3,0,1,0,56.66
澎湖縣,馬公市,虎井里,0,1,194,8,202,691,3,1,3,0,1,0,29.23
澎湖縣,馬公市,桶盤里,0,1,90,0,90,194,3,1,3,0,1,0,46.39
澎湖縣,湖西鄉,湖西村,0,1,549,6,555,824,3,1,3,0,1,0,67.35
澎湖縣,湖西鄉,湖東村,0,1,202,1,203,295,3,1,3,0,1,0,68.81
澎湖縣,湖西鄉,青螺村,0,1,120,1,121,203,3,1,3,0,1,0,59.61
澎湖縣,湖西鄉,白坑村,0,1,147,3,150,236,3,1,3,0,1,0,63.56
澎湖縣,湖西鄉,南寮村,0,1,359,6,365,599,3,1,3,0,1,0,60.93
澎湖縣,湖西鄉,北寮村,0,1,193,2,195,268,3,1,3,0,1,0,72.76
澎湖縣,湖西鄉,紅羅村,0,1,354,6,360,540,3,1,3,0,1,0,66.67
澎湖縣,湖西鄉,西溪村,0,1,271,6,277,441,3,1,3,0,1,0,62.81
澎湖縣,湖西鄉,成功村,0,1,253,3,256,402,3,1,3,0,1,0,63.68
澎湖縣,湖西鄉,東石村,0,1,73,0,73,130,3,1,3,0,1,0,56.15
澎湖縣,湖西鄉,沙港村,0,1,462,4,466,695,3,1,3,0,1,0,67.05
澎湖縣,湖西鄉,中西村,0,1,100,3,103,162,3,1,3,0,1,0,63.58
澎湖縣,湖西鄉,鼎灣村,0,1,185,2,187,277,3,1,3,0,1,0,67.51
澎湖縣,湖西鄉,潭邊村,0,1,165,2,167,217,3,1,3,0,1,0,76.96
澎湖縣,湖西鄉,許家村,0,1,126,1,127,182,3,1,3,0,1,0,69.78
澎湖縣,湖西鄉,城北村,0,1,127,3,130,178,3,1,3,0,1,0,73.03
澎湖縣,湖西鄉,太武村,0,1,70,1,71,120,3,1,3,0,1,0,59.17
澎湖縣,湖西鄉,隘門村,0,1,410,3,413,615,3,1,3,0,1,0,67.15
澎湖縣,湖西鄉,林投村,0,1,490,10,500,814,3,1,3,0,1,0,61.43
澎湖縣,湖西鄉,尖山村,0,1,316,7,323,510,3,1,3,0,1,0,63.33
澎湖縣,湖西鄉,龍門村,0,1,948,10,958,1485,3,1,3,0,1,0,64.51
澎湖縣,湖西鄉,果葉村,0,1,372,4,376,616,3,1,3,0,1,0,61.04
澎湖縣,白沙鄉,中屯村,0,1,287,1,288,435,3,1,3,0,1,0,66.21
澎湖縣,白沙鄉,講美村,0,1,339,2,341,522,3,1,3,0,1,0,65.33
澎湖縣,白沙鄉,城前村,0,1,60,0,60,91,3,1,3,0,1,0,65.93
澎湖縣,白沙鄉,鎮海村,0,1,70,1,71,102,3,1,3,0,1,0,69.61
澎湖縣,白沙鄉,港子村,0,1,144,3,147,249,3,1,3,0,1,0,59.04
澎湖縣,白沙鄉,岐頭村,0,1,109,2,111,207,3,1,3,0,1,0,53.62
澎湖縣,白沙鄉,小赤村,0,1,104,2,106,152,3,1,3,0,1,0,69.74
澎湖縣,白沙鄉,赤崁村,0,1,851,6,857,1339,3,1,3,0,1,0,64.00
澎湖縣,白沙鄉,瓦硐村,0,1,169,0,169,281,3,1,3,0,1,0,60.14
澎湖縣,白沙鄉,後寮村,0,1,376,1,377,637,3,1,3,0,1,0,59.18
澎湖縣,白沙鄉,通梁村,0,1,396,6,402,666,3,1,3,0,1,0,60.36
澎湖縣,白沙鄉,吉貝村,0,1,476,7,483,1142,3,1,3,0,1,0,42.29
澎湖縣,白沙鄉,鳥嶼村,0,1,375,2,377,929,3,1,3,0,1,0,40.58
澎湖縣,白沙鄉,員貝村,0,1,105,1,106,209,3,1,3,0,1,0,50.72
澎湖縣,白沙鄉,大倉村,0,1,73,4,77,158,3,1,3,0,1,0,48.73
澎湖縣,西嶼鄉,橫礁村,0,1,142,7,149,237,3,1,3,0,1,0,62.87
澎湖縣,西嶼鄉,合界村,0,1,256,5,261,404,3,1,3,0,1,0,64.60
澎湖縣,西嶼鄉,竹灣村,0,1,422,19,441,760,3,1,3,0,1,0,58.03
澎湖縣,西嶼鄉,小門村,0,1,139,1,140,251,3,1,3,0,1,0,55.78
澎湖縣,西嶼鄉,大池村,0,1,329,11,340,588,3,1,3,0,1,0,57.82
澎湖縣,西嶼鄉,二崁村,0,1,61,1,62,103,3,1,3,0,1,0,60.19
澎湖縣,西嶼鄉,池東村,0,1,299,12,311,486,3,1,3,0,1,0,63.99
澎湖縣,西嶼鄉,池西村,0,1,112,2,114,195,3,1,3,0,1,0,58.46
澎湖縣,西嶼鄉,赤馬村,0,1,321,8,329,605,3,1,3,0,1,0,54.38
澎湖縣,西嶼鄉,內垵村,0,1,660,14,674,1147,3,1,3,0,1,0,58.76
澎湖縣,西嶼鄉,外垵村,0,1,927,15,942,1730,3,1,3,0,1,0,54.45
澎湖縣,望安鄉,東安村,0,1,215,6,221,492,3,1,3,0,1,0,44.92
澎湖縣,望安鄉,西安村,0,1,166,2,168,322,3,1,3,0,1,0,52.17
澎湖縣,望安鄉,中社村,0,1,82,5,87,234,3,1,3,0,1,0,37.18
澎湖縣,望安鄉,水垵村,0,1,133,2,135,285,3,1,3,0,1,0,47.37
澎湖縣,望安鄉,將軍村,0,1,410,11,421,1328,3,1,3,0,1,0,31.70
澎湖縣,望安鄉,東吉村,0,1,75,2,77,233,3,1,3,0,1,0,33.05
澎湖縣,望安鄉,東坪村,0,1,76,0,76,316,3,1,3,0,1,0,24.05
澎湖縣,望安鄉,西坪村,0,1,29,0,29,170,3,1,3,0,1,0,17.06
澎湖縣,望安鄉,花嶼村,0,1,103,3,106,253,3,1,3,0,1,0,41.90
澎湖縣,七美鄉,東湖村,0,1,83,6,89,218,3,1,3,0,1,0,40.83
澎湖縣,七美鄉,西湖村,0,1,154,4,158,448,3,1,3,0,1,0,35.27
澎湖縣,七美鄉,中和村,0,1,169,16,185,427,3,1,3,0,1,0,43.33
澎湖縣,七美鄉,平和村,0,1,97,6,103,277,3,1,3,0,1,0,37.18
澎湖縣,七美鄉,海豐村,0,1,90,4,94,244,3,1,3,0,1,0,38.52
澎湖縣,七美鄉,南港村,0,1,315,7,322,789,3,1,3,0,1,0,40.81
基隆市,中正區,長潭里,0,1,420,4,424,557,3,1,3,0,1,0,76.12
基隆市,中正區,砂子里,0,1,1408,26,1434,2366,3,1,3,0,1,0,60.61
基隆市,中正區,八斗里,0,1,974,8,982,1546,3,1,3,0,1,0,63.52
基隆市,中正區,碧砂里,0,1,771,8,779,1308,3,1,3,0,1,0,59.56
基隆市,中正區,新豐里,0,1,2799,48,2847,5676,3,1,3,0,1,0,50.16
基隆市,中正區,平寮里,0,1,939,20,959,1524,3,1,3,0,1,0,62.93
基隆市,中正區,社寮里,0,1,1207,19,1226,1928,3,1,3,0,1,0,63.59
基隆市,中正區,和憲里,0,1,561,14,575,918,3,1,3,0,1,0,62.64
基隆市,中正區,海濱里,0,1,576,13,589,995,3,1,3,0,1,0,59.20
基隆市,中正區,正濱里,0,1,744,21,765,1269,3,1,3,0,1,0,60.28
基隆市,中正區,中正里,0,1,1193,29,1222,1971,3,1,3,0,1,0,62.00
基隆市,中正區,中濱里,0,1,875,13,888,1423,3,1,3,0,1,0,62.40
基隆市,中正區,建國里,0,1,1331,14,1345,2106,3,1,3,0,1,0,63.87
基隆市,中正區,砂灣里,0,1,1270,18,1288,2087,3,1,3,0,1,0,61.72
基隆市,中正區,真砂里,0,1,900,12,912,1484,3,1,3,0,1,0,61.46
基隆市,中正區,正砂里,0,1,1487,14,1501,2391,3,1,3,0,1,0,62.78
基隆市,中正區,中砂里,0,1,874,5,879,1367,3,1,3,0,1,0,64.30
基隆市,中正區,入船里,0,1,832,14,846,1316,3,1,3,0,1,0,64.29
基隆市,中正區,正船里,0,1,997,7,1004,1535,3,1,3,0,1,0,65.41
基隆市,中正區,中船里,0,1,849,6,855,1363,3,1,3,0,1,0,62.73
基隆市,中正區,港通里,0,1,755,9,764,1210,3,1,3,0,1,0,63.14
基隆市,中正區,義重里,0,1,773,23,796,1224,3,1,3,0,1,0,65.03
基隆市,中正區,信義里,0,1,707,12,719,1072,3,1,3,0,1,0,67.07
基隆市,中正區,正義里,0,1,953,17,970,1488,3,1,3,0,1,0,65.19
基隆市,中正區,德義里,0,1,575,4,579,837,3,1,3,0,1,0,69.18
基隆市,信義區,仁壽里,0,1,796,13,809,1188,3,1,3,0,1,0,68.10
基隆市,信義區,仁義里,0,1,792,14,806,1202,3,1,3,0,1,0,67.05
基隆市,信義區,義昭里,0,1,670,6,676,1034,3,1,3,0,1,0,65.38
基隆市,信義區,義幸里,0,1,1575,24,1599,2317,3,1,3,0,1,0,69.01
基隆市,信義區,義民里,0,1,610,7,617,861,3,1,3,0,1,0,71.66
基隆市,信義區,義和里,0,1,877,7,884,1312,3,1,3,0,1,0,67.38
基隆市,信義區,智慧里,0,1,495,7,502,707,3,1,3,0,1,0,71.00
基隆市,信義區,智誠里,0,1,1159,11,1170,1745,3,1,3,0,1,0,67.05
基隆市,信義區,禮儀里,0,1,1009,8,1017,1527,3,1,3,0,1,0,66.60
基隆市,信義區,禮東里,0,1,972,10,982,1527,3,1,3,0,1,0,64.31
基隆市,信義區,信綠里,0,1,1509,23,1532,2353,3,1,3,0,1,0,65.11
基隆市,信義區,東信里,0,1,1923,27,1950,3112,3,1,3,0,1,0,62.66
基隆市,信義區,東光里,0,1,1141,15,1156,1833,3,1,3,0,1,0,63.07
基隆市,信義區,東明里,0,1,2052,24,2076,3313,3,1,3,0,1,0,62.66
基隆市,信義區,東安里,0,1,1735,30,1765,2674,3,1,3,0,1,0,66.01
基隆市,信義區,孝賢里,0,1,1934,17,1951,3073,3,1,3,0,1,0,63.49
基隆市,信義區,孝深里,0,1,3332,42,3374,5743,3,1,3,0,1,0,58.75
基隆市,信義區,孝岡里,0,1,538,4,542,887,3,1,3,0,1,0,61.10
基隆市,仁愛區,林泉里,0,1,1137,22,1159,1788,3,1,3,0,1,0,64.82
基隆市,仁愛區,花崗里,0,1,635,5,640,910,3,1,3,0,1,0,70.33
基隆市,仁愛區,虹橋里,0,1,999,16,1015,1526,3,1,3,0,1,0,66.51
基隆市,仁愛區,水錦里,0,1,1125,19,1144,1725,3,1,3,0,1,0,66.32
基隆市,仁愛區,智仁里,0,1,1433,23,1456,2243,3,1,3,0,1,0,64.91
基隆市,仁愛區,和明里,0,1,722,8,730,1112,3,1,3,0,1,0,65.65
基隆市,仁愛區,忠勇里,0,1,623,15,638,1032,3,1,3,0,1,0,61.82
基隆市,仁愛區,玉田里,0,1,778,8,786,1157,3,1,3,0,1,0,67.93
基隆市,仁愛區,仁德里,0,1,653,12,665,1011,3,1,3,0,1,0,65.78
基隆市,仁愛區,博愛里,0,1,1159,11,1170,1691,3,1,3,0,1,0,69.19
基隆市,仁愛區,福仁里,0,1,517,7,524,842,3,1,3,0,1,0,62.23
基隆市,仁愛區,誠仁里,0,1,664,16,680,1061,3,1,3,0,1,0,64.09
基隆市,仁愛區,吉仁里,0,1,1844,38,1882,2944,3,1,3,0,1,0,63.93
基隆市,仁愛區,育仁里,0,1,519,13,532,871,3,1,3,0,1,0,61.08
基隆市,仁愛區,英仁里,0,1,941,10,951,1476,3,1,3,0,1,0,64.43
基隆市,仁愛區,龍門里,0,1,546,11,557,886,3,1,3,0,1,0,62.87
基隆市,仁愛區,德厚里,0,1,866,18,884,1356,3,1,3,0,1,0,65.19
基隆市,仁愛區,曲水里,0,1,626,8,634,981,3,1,3,0,1,0,64.63
基隆市,仁愛區,崇文里,0,1,609,14,623,971,3,1,3,0,1,0,64.16
基隆市,仁愛區,文安里,0,1,700,20,720,1095,3,1,3,0,1,0,65.75
基隆市,仁愛區,兆連里,0,1,405,5,410,655,3,1,3,0,1,0,62.60
基隆市,仁愛區,獅球里,0,1,739,7,746,1164,3,1,3,0,1,0,64.09
基隆市,仁愛區,書院里,0,1,719,20,739,1126,3,1,3,0,1,0,65.63
基隆市,仁愛區,朝棟里,0,1,1881,31,1912,2895,3,1,3,0,1,0,66.04
基隆市,仁愛區,光華里,0,1,1487,16,1503,2293,3,1,3,0,1,0,65.55
基隆市,仁愛區,明德里,0,1,519,4,523,761,3,1,3,0,1,0,68.73
基隆市,仁愛區,同風里,0,1,477,4,481,663,3,1,3,0,1,0,72.55
基隆市,仁愛區,文昌里,0,1,567,6,573,852,3,1,3,0,1,0,67.25
基隆市,仁愛區,新店里,0,1,496,8,504,735,3,1,3,0,1,0,68.57
基隆市,中山區,新建里,0,1,554,13,567,803,3,1,3,0,1,0,70.61
基隆市,中山區,安民里,0,1,742,15,757,1106,3,1,3,0,1,0,68.44
基隆市,中山區,安平里,0,1,686,8,694,994,3,1,3,0,1,0,69.82
基隆市,中山區,中山里,0,1,750,8,758,1124,3,1,3,0,1,0,67.44
基隆市,中山區,民治里,0,1,648,8,656,987,3,1,3,0,1,0,66.46
基隆市,中山區,中興里,0,1,872,16,888,1312,3,1,3,0,1,0,67.68
基隆市,中山區,仁正里,0,1,532,15,547,836,3,1,3,0,1,0,65.43
基隆市,中山區,健民里,0,1,1014,27,1041,1558,3,1,3,0,1,0,66.82
基隆市,中山區,通化里,0,1,801,18,819,1268,3,1,3,0,1,0,64.59
基隆市,中山區,居仁里,0,1,906,14,920,1526,3,1,3,0,1,0,60.29
基隆市,中山區,通明里,0,1,1323,22,1345,2051,3,1,3,0,1,0,65.58
基隆市,中山區,和平里,0,1,440,9,449,707,3,1,3,0,1,0,63.51
基隆市,中山區,仙洞里,0,1,479,6,485,772,3,1,3,0,1,0,62.82
基隆市,中山區,太白里,0,1,612,15,627,973,3,1,3,0,1,0,64.44
基隆市,中山區,協和里,0,1,1034,20,1054,1599,3,1,3,0,1,0,65.92
基隆市,中山區,文化里,0,1,653,17,670,1109,3,1,3,0,1,0,60.41
基隆市,中山區,德安里,0,1,1935,40,1975,3079,3,1,3,0,1,0,64.14
基隆市,中山區,德和里,0,1,2931,34,2965,4489,3,1,3,0,1,0,66.05
基隆市,中山區,中和里,0,1,4738,50,4788,8243,3,1,3,0,1,0,58.09
基隆市,中山區,西康里,0,1,1063,24,1087,1691,3,1,3,0,1,0,64.28
基隆市,中山區,西定里,0,1,637,5,642,988,3,1,3,0,1,0,64.98
基隆市,中山區,西華里,0,1,657,16,673,1014,3,1,3,0,1,0,66.37
基隆市,中山區,西榮里,0,1,538,9,547,863,3,1,3,0,1,0,63.38
基隆市,安樂區,新西里,0,1,925,21,946,1485,3,1,3,0,1,0,63.70
基隆市,安樂區,西川里,0,1,872,16,888,1377,3,1,3,0,1,0,64.49
基隆市,安樂區,定國里,0,1,786,18,804,1273,3,1,3,0,1,0,63.16
基隆市,安樂區,定邦里,0,1,839,20,859,1331,3,1,3,0,1,0,64.54
基隆市,安樂區,干城里,0,1,1483,30,1513,2327,3,1,3,0,1,0,65.02
基隆市,安樂區,永康里,0,1,1221,32,1253,2015,3,1,3,0,1,0,62.18
基隆市,安樂區,慈仁里,0,1,651,11,662,1057,3,1,3,0,1,0,62.63
基隆市,安樂區,安和里,0,1,581,9,590,896,3,1,3,0,1,0,65.85
基隆市,安樂區,樂一里,0,1,467,8,475,704,3,1,3,0,1,0,67.47
基隆市,安樂區,嘉仁里,0,1,2069,26,2095,3282,3,1,3,0,1,0,63.83
基隆市,安樂區,鶯歌里,0,1,2952,34,2986,4834,3,1,3,0,1,0,61.77
基隆市,安樂區,七賢里,0,1,1774,21,1795,2840,3,1,3,0,1,0,63.20
基隆市,安樂區,三民里,0,1,2502,37,2539,4155,3,1,3,0,1,0,61.11
基隆市,安樂區,四維里,0,1,2434,37,2471,3739,3,1,3,0,1,0,66.09
基隆市,安樂區,五福里,0,1,2072,35,2107,3317,3,1,3,0,1,0,63.52
基隆市,安樂區,長樂里,0,1,1420,9,1429,2309,3,1,3,0,1,0,61.89
基隆市,安樂區,六合里,0,1,2184,28,2212,3382,3,1,3,0,1,0,65.41
基隆市,安樂區,外寮里,0,1,3689,51,3740,6324,3,1,3,0,1,0,59.14
基隆市,安樂區,新崙里,0,1,1708,25,1733,2900,3,1,3,0,1,0,59.76
基隆市,安樂區,武崙里,0,1,1658,19,1677,2912,3,1,3,0,1,0,57.59
基隆市,安樂區,中崙里,0,1,725,12,737,1211,3,1,3,0,1,0,60.86
基隆市,安樂區,內寮里,0,1,1823,30,1853,3334,3,1,3,0,1,0,55.58
基隆市,暖暖區,八西里,0,1,733,8,741,1177,3,1,3,0,1,0,62.96
基隆市,暖暖區,八中里,0,1,401,5,406,636,3,1,3,0,1,0,63.84
基隆市,暖暖區,八堵里,0,1,488,6,494,746,3,1,3,0,1,0,66.22
基隆市,暖暖區,八南里,0,1,408,6,414,650,3,1,3,0,1,0,63.69
基隆市,暖暖區,過港里,0,1,1932,23,1955,3158,3,1,3,0,1,0,61.91
基隆市,暖暖區,暖暖里,0,1,1350,21,1371,2126,3,1,3,0,1,0,64.49
基隆市,暖暖區,暖同里,0,1,1323,23,1346,2120,3,1,3,0,1,0,63.49
基隆市,暖暖區,暖東里,0,1,257,8,265,389,3,1,3,0,1,0,68.12
基隆市,暖暖區,暖西里,0,1,2063,39,2102,3499,3,1,3,0,1,0,60.07
基隆市,暖暖區,碇內里,0,1,1346,18,1364,2277,3,1,3,0,1,0,59.90
基隆市,暖暖區,碇和里,0,1,1429,17,1446,2308,3,1,3,0,1,0,62.65
基隆市,暖暖區,碇祥里,0,1,1650,17,1667,3188,3,1,3,0,1,0,52.29
基隆市,暖暖區,碇安里,0,1,2430,47,2477,4209,3,1,3,0,1,0,58.85
基隆市,七堵區,長興里,0,1,2388,49,2437,3688,3,1,3,0,1,0,66.08
基隆市,七堵區,正光里,0,1,1374,27,1401,2040,3,1,3,0,1,0,68.68
基隆市,七堵區,正明里,0,1,1359,18,1377,2000,3,1,3,0,1,0,68.85
基隆市,七堵區,富民里,0,1,2393,22,2415,3581,3,1,3,0,1,0,67.44
基隆市,七堵區,永平里,0,1,1387,19,1406,2071,3,1,3,0,1,0,67.89
基隆市,七堵區,永安里,0,1,1381,31,1412,2034,3,1,3,0,1,0,69.42
基隆市,七堵區,八德里,0,1,1000,19,1019,1520,3,1,3,0,1,0,67.04
基隆市,七堵區,自強里,0,1,595,13,608,932,3,1,3,0,1,0,65.24
基隆市,七堵區,泰安里,0,1,1994,31,2025,3112,3,1,3,0,1,0,65.07
基隆市,七堵區,六堵里,0,1,871,16,887,1396,3,1,3,0,1,0,63.54
基隆市,七堵區,堵南里,0,1,1766,31,1797,3089,3,1,3,0,1,0,58.17
基隆市,七堵區,堵北里,0,1,1794,22,1816,2935,3,1,3,0,1,0,61.87
基隆市,七堵區,百福里,0,1,2636,29,2665,4309,3,1,3,0,1,0,61.85
基隆市,七堵區,實踐里,0,1,1876,30,1906,3211,3,1,3,0,1,0,59.36
基隆市,七堵區,瑪南里,0,1,287,4,291,457,3,1,3,0,1,0,63.68
基隆市,七堵區,瑪東里,0,1,223,6,229,315,3,1,3,0,1,0,72.70
基隆市,七堵區,瑪西里,0,1,235,6,241,360,3,1,3,0,1,0,66.94
基隆市,七堵區,友一里,0,1,746,9,755,1171,3,1,3,0,1,0,64.47
基隆市,七堵區,友二里,0,1,304,11,315,443,3,1,3,0,1,0,71.11
新竹市,東區,育賢里,0,1,592,6,598,1093,3,1,3,0,1,0,54.71
新竹市,東區,親仁里,0,1,1092,10,1102,1786,3,1,3,0,1,0,61.70
新竹市,東區,東門里,0,1,483,6,489,766,3,1,3,0,1,0,63.84
新竹市,東區,成功里,0,1,483,9,492,783,3,1,3,0,1,0,62.84
新竹市,東區,榮光里,0,1,262,5,267,468,3,1,3,0,1,0,57.05
新竹市,東區,中正里,0,1,311,5,316,523,3,1,3,0,1,0,60.42
新竹市,東區,錦華里,0,1,1185,13,1198,1825,3,1,3,0,1,0,65.64
新竹市,東區,文華里,0,1,2095,26,2121,3291,3,1,3,0,1,0,64.45
新竹市,東區,復中里,0,1,2258,29,2287,3617,3,1,3,0,1,0,63.23
新竹市,東區,復興里,0,1,2119,20,2139,3340,3,1,3,0,1,0,64.04
新竹市,東區,三民里,0,1,2412,23,2435,3722,3,1,3,0,1,0,65.42
新竹市,東區,東園里,0,1,1532,24,1556,2452,3,1,3,0,1,0,63.46
新竹市,東區,公園里,0,1,1352,22,1374,2176,3,1,3,0,1,0,63.14
新竹市,東區,建華里,0,1,1299,27,1326,2061,3,1,3,0,1,0,64.34
新竹市,東區,東山里,0,1,1861,12,1873,2895,3,1,3,0,1,0,64.70
新竹市,東區,綠水里,0,1,2543,36,2579,3969,3,1,3,0,1,0,64.98
新竹市,東區,光復里,0,1,1120,18,1138,1786,3,1,3,0,1,0,63.72
新竹市,東區,東勢里,0,1,656,23,679,1037,3,1,3,0,1,0,65.48
新竹市,東區,前溪里,0,1,1462,21,1483,2331,3,1,3,0,1,0,63.62
新竹市,東區,水源里,0,1,1859,26,1885,2942,3,1,3,0,1,0,64.07
新竹市,東區,千甲里,0,1,1156,22,1178,1661,3,1,3,0,1,0,70.92
新竹市,東區,豐功里,0,1,1539,19,1558,2466,3,1,3,0,1,0,63.18
新竹市,東區,偉功里,0,1,174,2,176,335,3,1,3,0,1,0,52.54
新竹市,東區,武功里,0,1,1075,16,1091,1520,3,1,3,0,1,0,71.78
新竹市,東區,軍功里,0,1,2004,28,2032,3102,3,1,3,0,1,0,65.51
新竹市,東區,立功里,0,1,511,8,519,763,3,1,3,0,1,0,68.02
新竹市,東區,建功里,0,1,1986,24,2010,2903,3,1,3,0,1,0,69.24
新竹市,東區,光明里,0,1,1923,20,1943,3055,3,1,3,0,1,0,63.60
新竹市,東區,龍山里,0,1,1822,22,1844,2732,3,1,3,0,1,0,67.50
新竹市,東區,科園里,0,1,3068,40,3108,4681,3,1,3,0,1,0,66.40
新竹市,東區,埔頂里,0,1,1370,21,1391,2162,3,1,3,0,1,0,64.34
新竹市,東區,新莊里,0,1,2485,62,2547,3851,3,1,3,0,1,0,66.14
新竹市,東區,關東里,0,1,2184,43,2227,3530,3,1,3,0,1,0,63.09
新竹市,東區,金山里,0,1,2361,38,2399,3818,3,1,3,0,1,0,62.83
新竹市,東區,仙水里,0,1,1905,16,1921,2968,3,1,3,0,1,0,64.72
新竹市,東區,仙宮里,0,1,500,4,504,808,3,1,3,0,1,0,62.38
新竹市,東區,關帝里,0,1,346,7,353,590,3,1,3,0,1,0,59.83
新竹市,東區,南門里,0,1,426,1,427,654,3,1,3,0,1,0,65.29
新竹市,東區,南市里,0,1,599,4,603,904,3,1,3,0,1,0,66.70
新竹市,東區,福德里,0,1,765,9,774,1223,3,1,3,0,1,0,63.29
新竹市,東區,振興里,0,1,2549,30,2579,4284,3,1,3,0,1,0,60.20
新竹市,東區,新興里,0,1,1956,27,1983,3015,3,1,3,0,1,0,65.77
新竹市,東區,寺前里,0,1,503,13,516,820,3,1,3,0,1,0,62.93
新竹市,東區,竹蓮里,0,1,538,5,543,809,3,1,3,0,1,0,67.12
新竹市,東區,下竹里,0,1,763,19,782,1185,3,1,3,0,1,0,65.99
新竹市,東區,頂竹里,0,1,1835,41,1876,2976,3,1,3,0,1,0,63.04
新竹市,東區,南大里,0,1,943,11,954,1530,3,1,3,0,1,0,62.35
新竹市,東區,新光里,0,1,1943,39,1982,3088,3,1,3,0,1,0,64.18
新竹市,東區,光鎮里,0,1,1745,33,1778,2865,3,1,3,0,1,0,62.06
新竹市,東區,高峰里,0,1,2810,36,2846,4504,3,1,3,0,1,0,63.19
新竹市,東區,湖濱里,0,1,1732,26,1758,2681,3,1,3,0,1,0,65.57
新竹市,東區,柴橋里,0,1,1880,36,1916,3005,3,1,3,0,1,0,63.76
新竹市,東區,明湖里,0,1,1579,23,1602,2885,3,1,3,0,1,0,55.53
新竹市,北區,西門里,0,1,326,1,327,500,3,1,3,0,1,0,65.40
新竹市,北區,潛園里,0,1,563,4,567,838,3,1,3,0,1,0,67.66
新竹市,北區,中央里,0,1,356,4,360,525,3,1,3,0,1,0,68.57
新竹市,北區,石坊里,0,1,327,3,330,537,3,1,3,0,1,0,61.45
新竹市,北區,仁德里,0,1,478,4,482,751,3,1,3,0,1,0,64.18
新竹市,北區,崇禮里,0,1,767,13,780,1130,3,1,3,0,1,0,69.03
新竹市,北區,興南里,0,1,831,10,841,1265,3,1,3,0,1,0,66.48
新竹市,北區,育英里,0,1,2175,27,2202,3455,3,1,3,0,1,0,63.73
新竹市,北區,台溪里,0,1,704,8,712,1163,3,1,3,0,1,0,61.22
新竹市,北區,曲溪里,0,1,2957,74,3031,4657,3,1,3,0,1,0,65.08
新竹市,北區,西雅里,0,1,1606,20,1626,2424,3,1,3,0,1,0,67.08
新竹市,北區,客雅里,0,1,1957,25,1982,3094,3,1,3,0,1,0,64.06
新竹市,北區,南勢里,0,1,2117,35,2152,3187,3,1,3,0,1,0,67.52
新竹市,北區,大鵬里,0,1,1059,20,1079,1513,3,1,3,0,1,0,71.32
新竹市,北區,大同里,0,1,501,4,505,796,3,1,3,0,1,0,63.44
新竹市,北區,中山里,0,1,436,3,439,669,3,1,3,0,1,0,65.62
新竹市,北區,中興里,0,1,345,5,350,598,3,1,3,0,1,0,58.53
新竹市,北區,新民里,0,1,845,19,864,1323,3,1,3,0,1,0,65.31
新竹市,北區,長和里,0,1,767,12,779,1183,3,1,3,0,1,0,65.85
新竹市,北區,北門里,0,1,567,4,571,899,3,1,3,0,1,0,63.52
新竹市,北區,民富里,0,1,2361,34,2395,3884,3,1,3,0,1,0,61.66
新竹市,北區,磐石里,0,1,2423,35,2458,3826,3,1,3,0,1,0,64.24
新竹市,北區,新雅里,0,1,2286,34,2320,3610,3,1,3,0,1,0,64.27
新竹市,北區,文雅里,0,1,2027,30,2057,3130,3,1,3,0,1,0,65.72
新竹市,北區,水田里,0,1,1613,21,1634,2514,3,1,3,0,1,0,65.00
新竹市,北區,光田里,0,1,1290,21,1311,2035,3,1,3,0,1,0,64.42
新竹市,北區,光華里,0,1,1606,28,1634,2777,3,1,3,0,1,0,58.84
新竹市,北區,金華里,0,1,2099,28,2127,3397,3,1,3,0,1,0,62.61
新竹市,北區,湳雅里,0,1,1426,22,1448,2256,3,1,3,0,1,0,64.18
新竹市,北區,金雅里,0,1,846,14,860,1246,3,1,3,0,1,0,69.02
新竹市,北區,湳中里,0,1,2223,22,2245,3538,3,1,3,0,1,0,63.45
新竹市,北區,舊社里,0,1,2589,30,2619,4230,3,1,3,0,1,0,61.91
新竹市,北區,金竹里,0,1,2414,37,2451,3927,3,1,3,0,1,0,62.41
新竹市,北區,武陵里,0,1,822,7,829,1207,3,1,3,0,1,0,68.68
新竹市,北區,福林里,0,1,1828,28,1856,2851,3,1,3,0,1,0,65.10
新竹市,北區,境福里,0,1,2197,35,2232,3506,3,1,3,0,1,0,63.66
新竹市,北區,士林里,0,1,1960,34,1994,2881,3,1,3,0,1,0,69.21
新竹市,北區,古賢里,0,1,506,12,518,855,3,1,3,0,1,0,60.58
新竹市,北區,南寮里,0,1,2084,34,2118,3556,3,1,3,0,1,0,59.56
新竹市,北區,康樂里,0,1,1049,25,1074,1690,3,1,3,0,1,0,63.55
新竹市,北區,中寮里,0,1,826,9,835,1318,3,1,3,0,1,0,63.35
新竹市,北區,海濱里,0,1,843,14,857,1400,3,1,3,0,1,0,61.21
新竹市,北區,港北里,0,1,707,19,726,1122,3,1,3,0,1,0,64.71
新竹市,北區,舊港里,0,1,313,3,316,501,3,1,3,0,1,0,63.07
新竹市,香山區,頂埔里,0,1,1822,21,1843,2933,3,1,3,0,1,0,62.84
新竹市,香山區,頂福里,0,1,1526,22,1548,2486,3,1,3,0,1,0,62.27
新竹市,香山區,中埔里,0,1,1392,20,1412,2216,3,1,3,0,1,0,63.72
新竹市,香山區,牛埔里,0,1,1272,14,1286,2186,3,1,3,0,1,0,58.83
新竹市,香山區,埔前里,0,1,1462,13,1475,2276,3,1,3,0,1,0,64.81
新竹市,香山區,樹下里,0,1,1053,19,1072,1746,3,1,3,0,1,0,61.40
新竹市,香山區,浸水里,0,1,957,22,979,1525,3,1,3,0,1,0,64.20
新竹市,香山區,虎林里,0,1,1266,22,1288,1914,3,1,3,0,1,0,67.29
新竹市,香山區,虎山里,0,1,2611,42,2653,4433,3,1,3,0,1,0,59.85
新竹市,香山區,港南里,0,1,1082,23,1105,1690,3,1,3,0,1,0,65.38
新竹市,香山區,東香里,0,1,1144,19,1163,1867,3,1,3,0,1,0,62.29
新竹市,香山區,香村里,0,1,1174,29,1203,1920,3,1,3,0,1,0,62.66
新竹市,香山區,香山里,0,1,1686,18,1704,2721,3,1,3,0,1,0,62.62
新竹市,香山區,大庄里,0,1,1287,18,1305,1924,3,1,3,0,1,0,67.83
新竹市,香山區,美山里,0,1,585,8,593,960,3,1,3,0,1,0,61.77
新竹市,香山區,朝山里,0,1,1101,18,1119,1687,3,1,3,0,1,0,66.33
新竹市,香山區,海山里,0,1,1130,22,1152,1720,3,1,3,0,1,0,66.98
新竹市,香山區,鹽水里,0,1,740,16,756,1131,3,1,3,0,1,0,66.84
新竹市,香山區,內湖里,0,1,1947,30,1977,3270,3,1,3,0,1,0,60.46
新竹市,香山區,南港里,0,1,478,8,486,755,3,1,3,0,1,0,64.37
新竹市,香山區,中隘里,0,1,761,15,776,1250,3,1,3,0,1,0,62.08
新竹市,香山區,南隘里,0,1,381,8,389,623,3,1,3,0,1,0,62.44
新竹市,香山區,大湖里,0,1,471,8,479,680,3,1,3,0,1,0,70.44
新竹市,香山區,茄苳里,0,1,467,10,477,722,3,1,3,0,1,0,66.07
臺中市,中區,中山里、建國里,0,1,595,12,607,926,3,1,3,0,1,0,65.55
臺中市,中區,南京里,0,1,729,10,739,1051,3,1,3,0,1,0,70.31
臺中市,中區,繼光里,0,1,710,8,718,1116,3,1,3,0,1,0,64.34
臺中市,中區,自由里、繼榮里,0,1,862,15,877,1409,3,1,3,0,1,0,62.24
臺中市,中區,重慶里,0,1,557,8,565,868,3,1,3,0,1,0,65.09
臺中市,中區,錦上里、錦添里,0,1,839,14,853,1271,3,1,3,0,1,0,67.11
臺中市,中區,錦花里,0,1,703,11,714,1137,3,1,3,0,1,0,62.80
臺中市,中區,大墩里,0,1,920,16,936,1406,3,1,3,0,1,0,66.57
臺中市,中區,中墩里、柳堤里,0,1,706,12,718,1119,3,1,3,0,1,0,64.16
臺中市,中區,柳岸里、正音里,0,1,721,14,735,1123,3,1,3,0,1,0,65.45
臺中市,中區,柳原里、東墩里,0,1,643,15,658,1028,3,1,3,0,1,0,64.01
臺中市,中區,光音里、中音里,0,1,774,16,790,1248,3,1,3,0,1,0,63.30
臺中市,中區,博松里、愛松里、青松里,0,1,776,13,789,1163,3,1,3,0,1,0,67.84
臺中市,中區,中政里、中榮里、中功里,0,1,701,10,711,1109,3,1,3,0,1,0,64.11
臺中市,東區,新庄里,0,1,710,15,725,1053,3,1,3,0,1,0,68.85
臺中市,東區,立德里,0,1,405,13,418,651,3,1,3,0,1,0,64.21
臺中市,東區,朱文里,0,1,522,5,527,838,3,1,3,0,1,0,62.89
臺中市,東區,翰第里,0,1,617,7,624,897,3,1,3,0,1,0,69.57
臺中市,東區,振興里、曙峰里,0,1,1601,22,1623,2385,3,1,3,0,1,0,68.05
臺中市,東區,頂峰里,0,1,841,16,857,1286,3,1,3,0,1,0,66.64
臺中市,東區,忠孝里,0,1,634,6,640,972,3,1,3,0,1,0,65.84
臺中市,東區,東橋里,0,1,2535,38,2573,3749,3,1,3,0,1,0,68.63
臺中市,東區,東興里,0,1,1351,18,1369,1939,3,1,3,0,1,0,70.60
臺中市,東區,樂業里,0,1,512,12,524,818,3,1,3,0,1,0,64.06
臺中市,東區,泉源里,0,1,535,6,541,828,3,1,3,0,1,0,65.34
臺中市,東區,文化里,0,1,741,2,743,1102,3,1,3,0,1,0,67.42
臺中市,東區,干城里,0,1,429,7,436,644,3,1,3,0,1,0,67.70
臺中市,東區,祖聖里,0,1,665,10,675,996,3,1,3,0,1,0,67.77
臺中市,東區,旱溪里,0,1,974,9,983,1417,3,1,3,0,1,0,69.37
臺中市,東區,樂成里,0,1,897,23,920,1354,3,1,3,0,1,0,67.95
臺中市,東區,東門里,0,1,3358,60,3418,4950,3,1,3,0,1,0,69.05
臺中市,東區,十甲里,0,1,3862,64,3926,6018,3,1,3,0,1,0,65.24
臺中市,東區,東南里,0,1,2233,36,2269,3400,3,1,3,0,1,0,66.74
臺中市,東區,東勢里,0,1,962,18,980,1519,3,1,3,0,1,0,64.52
臺中市,東區,合作里,0,1,1322,11,1333,1920,3,1,3,0,1,0,69.43
臺中市,東區,東明里,0,1,860,15,875,1335,3,1,3,0,1,0,65.54
臺中市,東區,成功里,0,1,490,7,497,802,3,1,3,0,1,0,61.97
臺中市,東區,尚武里、練武里,0,1,869,22,891,1346,3,1,3,0,1,0,66.20
臺中市,東區,富台里,0,1,988,17,1005,1475,3,1,3,0,1,0,68.14
臺中市,東區,富仁里,0,1,925,19,944,1418,3,1,3,0,1,0,66.57
臺中市,東區,東信里,0,1,3274,52,3326,4842,3,1,3,0,1,0,68.69
臺中市,南區,南興里,0,1,448,2,450,674,3,1,3,0,1,0,66.77
臺中市,南區,正義里,0,1,459,4,463,710,3,1,3,0,1,0,65.21
臺中市,南區,民主里,0,1,555,8,563,790,3,1,3,0,1,0,71.27
臺中市,南區,復興里,0,1,1151,16,1167,1711,3,1,3,0,1,0,68.21
臺中市,南區,萬安里,0,1,634,17,651,968,3,1,3,0,1,0,67.25
臺中市,南區,信義里,0,1,745,13,758,1064,3,1,3,0,1,0,71.24
臺中市,南區,城隍里,0,1,920,17,937,1392,3,1,3,0,1,0,67.31
臺中市,南區,頂南里、中南里,0,1,673,8,681,1026,3,1,3,0,1,0,66.37
臺中市,南區,國光里,0,1,2281,35,2316,3418,3,1,3,0,1,0,67.76
臺中市,南區,南門里,0,1,2056,40,2096,3157,3,1,3,0,1,0,66.39
臺中市,南區,德義里,0,1,1625,23,1648,2442,3,1,3,0,1,0,67.49
臺中市,南區,積善里,0,1,1745,34,1779,2698,3,1,3,0,1,0,65.94
臺中市,南區,江川里,0,1,1241,17,1258,1814,3,1,3,0,1,0,69.35
臺中市,南區,新榮里,0,1,1660,26,1686,2944,3,1,3,0,1,0,57.27
臺中市,南區,福興里,0,1,1826,31,1857,2747,3,1,3,0,1,0,67.60
臺中市,南區,福平里,0,1,4484,83,4567,7161,3,1,3,0,1,0,63.78
臺中市,南區,和平里,0,1,5509,89,5598,8772,3,1,3,0,1,0,63.82
臺中市,南區,永興里,0,1,4519,67,4586,7206,3,1,3,0,1,0,63.64
臺中市,南區,樹義里,0,1,5081,92,5173,8160,3,1,3,0,1,0,63.39
臺中市,南區,樹德里,0,1,2192,42,2234,3646,3,1,3,0,1,0,61.27
臺中市,南區,西川里,0,1,4048,61,4109,6044,3,1,3,0,1,0,67.98
臺中市,西區,福壽里、民生里,0,1,973,13,986,1425,3,1,3,0,1,0,69.19
臺中市,西區,光明里,0,1,439,6,445,627,3,1,3,0,1,0,70.97
臺中市,西區,利民里,0,1,1288,19,1307,2040,3,1,3,0,1,0,64.07
臺中市,西區,平和里,0,1,966,9,975,1542,3,1,3,0,1,0,63.23
臺中市,西區,公民里,0,1,2672,48,2720,4005,3,1,3,0,1,0,67.92
臺中市,西區,中民里,0,1,1352,18,1370,1905,3,1,3,0,1,0,71.92
臺中市,西區,藍興里,0,1,1643,28,1671,2381,3,1,3,0,1,0,70.18
臺中市,西區,公舘里,0,1,2999,52,3051,4536,3,1,3,0,1,0,67.26
臺中市,西區,元龍里、平龍里,0,1,508,11,519,772,3,1,3,0,1,0,67.23
臺中市,西區,和龍里,0,1,1022,12,1034,1606,3,1,3,0,1,0,64.38
臺中市,西區,三民里,0,1,778,8,786,1201,3,1,3,0,1,0,65.45
臺中市,西區,平民里,0,1,752,7,759,1136,3,1,3,0,1,0,66.81
臺中市,西區,東昇里,0,1,883,9,892,1322,3,1,3,0,1,0,67.47
臺中市,西區,廣民里,0,1,742,9,751,1143,3,1,3,0,1,0,65.70
臺中市,西區,民龍里,0,1,1333,27,1360,2052,3,1,3,0,1,0,66.28
臺中市,西區,福龍里、後龍里,0,1,774,13,787,1209,3,1,3,0,1,0,65.10
臺中市,西區,靖龍里,0,1,1155,11,1166,1829,3,1,3,0,1,0,63.75
臺中市,西區,雲龍里,0,1,1259,13,1272,1909,3,1,3,0,1,0,66.63
臺中市,西區,永龍里,0,1,671,6,677,984,3,1,3,0,1,0,68.80
臺中市,西區,安龍里,0,1,1418,28,1446,2182,3,1,3,0,1,0,66.27
臺中市,西區,吉龍里,0,1,3780,51,3831,5546,3,1,3,0,1,0,69.08
臺中市,西區,昇平里,0,1,2485,34,2519,3807,3,1,3,0,1,0,66.17
臺中市,西區,忠明里,0,1,2824,34,2858,4342,3,1,3,0,1,0,65.82
臺中市,西區,忠誠里,0,1,3181,42,3223,4879,3,1,3,0,1,0,66.06
臺中市,西區,公正里,0,1,6975,79,7054,10709,3,1,3,0,1,0,65.87
臺中市,西區,公益里,0,1,1793,31,1824,2581,3,1,3,0,1,0,70.67
臺中市,西區,中興里,0,1,2086,33,2119,3088,3,1,3,0,1,0,68.62
臺中市,西區,土庫里,0,1,4700,75,4775,7148,3,1,3,0,1,0,66.80
臺中市,北區,遠志里、光華里、南靖里,0,1,609,10,619,926,3,1,3,0,1,0,66.85
臺中市,北區,高風里、高平里,0,1,547,9,556,841,3,1,3,0,1,0,66.11
臺中市,北區,文正里、大安里、長安里,0,1,598,9,607,923,3,1,3,0,1,0,65.76
臺中市,北區,光興里、光榮里、光正里,0,1,534,11,545,856,3,1,3,0,1,0,63.67
臺中市,北區,光大里,0,1,1184,22,1206,1827,3,1,3,0,1,0,66.01
臺中市,北區,文莊里,0,1,1311,18,1329,2024,3,1,3,0,1,0,65.66
臺中市,北區,湖北里,0,1,560,7,567,931,3,1,3,0,1,0,60.90
臺中市,北區,中湖里、平等里,0,1,784,8,792,1281,3,1,3,0,1,0,61.83
臺中市,北區,錦和里、湖南里,0,1,789,9,798,1221,3,1,3,0,1,0,65.36
臺中市,北區,五常里,0,1,1062,12,1074,1678,3,1,3,0,1,0,64.00
臺中市,北區,仁和里、香蕉里,0,1,493,6,499,721,3,1,3,0,1,0,69.21
臺中市,北區,新興里,0,1,765,7,772,1187,3,1,3,0,1,0,65.04
臺中市,北區,武順里,0,1,510,5,515,824,3,1,3,0,1,0,62.50
臺中市,北區,新北里,0,1,1388,25,1413,2269,3,1,3,0,1,0,62.27
臺中市,北區,樂英里,0,1,2001,40,2041,2998,3,1,3,0,1,0,68.08
臺中市,北區,錦村里,0,1,1997,30,2027,2955,3,1,3,0,1,0,68.60
臺中市,北區,建成里,0,1,4412,67,4479,6837,3,1,3,0,1,0,65.51
臺中市,北區,錦洲里,0,1,1985,26,2011,2964,3,1,3,0,1,0,67.85
臺中市,北區,錦祥里,0,1,1820,23,1843,3014,3,1,3,0,1,0,61.15
臺中市,北區,金華里,0,1,1023,19,1042,1664,3,1,3,0,1,0,62.62
臺中市,北區,金龍里,0,1,2541,31,2572,4067,3,1,3,0,1,0,63.24
臺中市,北區,邱厝里,0,1,1245,14,1259,2102,3,1,3,0,1,0,59.90
臺中市,北區,建興里,0,1,3125,43,3168,4994,3,1,3,0,1,0,63.44
臺中市,北區,頂厝里,0,1,3744,43,3787,5910,3,1,3,0,1,0,64.08
臺中市,北區,賴厝里,0,1,3101,42,3143,5056,3,1,3,0,1,0,62.16
臺中市,北區,賴明里,0,1,3102,46,3148,5009,3,1,3,0,1,0,62.85
臺中市,北區,賴興里,0,1,3699,37,3736,5985,3,1,3,0,1,0,62.42
臺中市,北區,賴村里,0,1,2429,33,2462,3791,3,1,3,0,1,0,64.94
臺中市,北區,育德里,0,1,2040,27,2067,3161,3,1,3,0,1,0,65.39
臺中市,北區,淡溝里,0,1,2427,40,2467,3620,3,1,3,0,1,0,68.15
臺中市,北區,健行里,0,1,3636,48,3684,5437,3,1,3,0,1,0,67.76
臺中市,北區,明德里,0,1,4195,67,4262,6488,3,1,3,0,1,0,65.69
臺中市,北區,長青里,0,1,4725,79,4804,7499,3,1,3,0,1,0,64.06
臺中市,北區,中達里,0,1,1718,28,1746,2519,3,1,3,0,1,0,69.31
臺中市,西屯區,西安里,0,1,3958,54,4012,6068,3,1,3,0,1,0,66.12
臺中市,西屯區,西平里,0,1,2861,38,2899,4352,3,1,3,0,1,0,66.61
臺中市,西屯區,西墩里,0,1,2331,38,2369,3652,3,1,3,0,1,0,64.87
臺中市,西屯區,潮洋里,0,1,1339,11,1350,1886,3,1,3,0,1,0,71.58
臺中市,西屯區,龍潭里,0,1,734,11,745,1001,3,1,3,0,1,0,74.43
臺中市,西屯區,惠來里,0,1,2912,44,2956,4367,3,1,3,0,1,0,67.69
臺中市,西屯區,上石里,0,1,5345,93,5438,8532,3,1,3,0,1,0,63.74
臺中市,西屯區,逢甲里、鵬程里,0,1,4759,79,4838,7325,3,1,3,0,1,0,66.05
臺中市,西屯區,何厝里,0,1,3486,42,3528,5440,3,1,3,0,1,0,64.85
臺中市,西屯區,何南里,0,1,5193,61,5254,7896,3,1,3,0,1,0,66.54
臺中市,西屯區,何安里,0,1,2378,25,2403,3646,3,1,3,0,1,0,65.91
臺中市,西屯區,何仁里,0,1,2897,42,2939,4654,3,1,3,0,1,0,63.15
臺中市,西屯區,何德里,0,1,3994,55,4049,6087,3,1,3,0,1,0,66.52
臺中市,西屯區,何源里,0,1,2934,47,2981,4477,3,1,3,0,1,0,66.58
臺中市,西屯區,大河里,0,1,2121,44,2165,3120,3,1,3,0,1,0,69.39
臺中市,西屯區,大石里,0,1,698,7,705,983,3,1,3,0,1,0,71.72
臺中市,西屯區,大福里,0,1,1740,29,1769,2669,3,1,3,0,1,0,66.28
臺中市,西屯區,大鵬里,0,1,2491,38,2529,3771,3,1,3,0,1,0,67.06
臺中市,西屯區,港尾里,0,1,3069,45,3114,4481,3,1,3,0,1,0,69.49
臺中市,西屯區,廣福里,0,1,1337,28,1365,1966,3,1,3,0,1,0,69.43
臺中市,西屯區,林厝里,0,1,1492,33,1525,2350,3,1,3,0,1,0,64.89
臺中市,西屯區,永安里,0,1,3216,58,3274,4950,3,1,3,0,1,0,66.14
臺中市,西屯區,福安里,0,1,12147,164,12311,19473,3,1,3,0,1,0,63.22
臺中市,西屯區,協和里,0,1,1886,42,1928,2858,3,1,3,0,1,0,67.46
臺中市,南屯區,南屯里,0,1,3122,57,3179,4758,3,1,3,0,1,0,66.81
臺中市,南屯區,豐樂里,0,1,3469,48,3517,5207,3,1,3,0,1,0,67.54
臺中市,南屯區,楓樹里,0,1,2599,52,2651,3754,3,1,3,0,1,0,70.62
臺中市,南屯區,中和里,0,1,2339,43,2382,3462,3,1,3,0,1,0,68.80
臺中市,南屯區,鎮平里,0,1,1122,30,1152,1562,3,1,3,0,1,0,73.75
臺中市,南屯區,永定里,0,1,1876,35,1911,2888,3,1,3,0,1,0,66.17
臺中市,南屯區,春社里,0,1,3329,71,3400,5011,3,1,3,0,1,0,67.85
臺中市,南屯區,春安里,0,1,1351,20,1371,1828,3,1,3,0,1,0,75.00
臺中市,南屯區,文山里,0,1,4539,71,4610,7139,3,1,3,0,1,0,64.57
臺中市,南屯區,新生里,0,1,830,17,847,1217,3,1,3,0,1,0,69.60
臺中市,南屯區,三厝里,0,1,7208,104,7312,10891,3,1,3,0,1,0,67.14
臺中市,南屯區,黎明里,0,1,939,13,952,1362,3,1,3,0,1,0,69.90
臺中市,南屯區,黎光里,0,1,1736,26,1762,2579,3,1,3,0,1,0,68.32
臺中市,南屯區,田心里,0,1,7672,117,7789,11869,3,1,3,0,1,0,65.62
臺中市,南屯區,大同里,0,1,5456,90,5546,8410,3,1,3,0,1,0,65.95
臺中市,南屯區,溝墘里,0,1,7191,85,7276,10802,3,1,3,0,1,0,67.36
臺中市,北屯區,北屯里,0,1,3784,50,3834,5909,3,1,3,0,1,0,64.88
臺中市,北屯區,北興里,0,1,2118,32,2150,3289,3,1,3,0,1,0,65.37
臺中市,北屯區,三光里,0,1,6576,72,6648,10247,3,1,3,0,1,0,64.88
臺中市,北屯區,平田里,0,1,6610,98,6708,10433,3,1,3,0,1,0,64.30
臺中市,北屯區,平和里,0,1,4144,62,4206,6686,3,1,3,0,1,0,62.91
臺中市,北屯區,平安里,0,1,2769,46,2815,4214,3,1,3,0,1,0,66.80
臺中市,北屯區,平順里,0,1,4723,70,4793,7476,3,1,3,0,1,0,64.11
臺中市,北屯區,平德里,0,1,2743,38,2781,4260,3,1,3,0,1,0,65.28
臺中市,北屯區,東光里,0,1,2282,42,2324,3653,3,1,3,0,1,0,63.62
臺中市,北屯區,舊社里,0,1,3031,47,3078,4665,3,1,3,0,1,0,65.98
臺中市,北屯區,水景里,0,1,3467,57,3524,5140,3,1,3,0,1,0,68.56
臺中市,北屯區,軍功里,0,1,3957,70,4027,5854,3,1,3,0,1,0,68.79
臺中市,北屯區,和平里,0,1,2862,40,2902,4215,3,1,3,0,1,0,68.85
臺中市,北屯區,東山里,0,1,1089,15,1104,1544,3,1,3,0,1,0,71.50
臺中市,北屯區,廍子里,0,1,1037,15,1052,1576,3,1,3,0,1,0,66.75
臺中市,北屯區,民政里,0,1,552,15,567,883,3,1,3,0,1,0,64.21
臺中市,北屯區,民德里,0,1,487,2,489,723,3,1,3,0,1,0,67.63
臺中市,北屯區,大坑里,0,1,1060,12,1072,1512,3,1,3,0,1,0,70.90
臺中市,北屯區,松竹里,0,1,3158,42,3200,4839,3,1,3,0,1,0,66.13
臺中市,北屯區,松安里,0,1,4948,67,5015,7834,3,1,3,0,1,0,64.02
臺中市,北屯區,松茂里,0,1,6685,91,6776,10389,3,1,3,0,1,0,65.22
臺中市,北屯區,仁和里,0,1,4098,77,4175,6007,3,1,3,0,1,0,69.50
臺中市,北屯區,仁美里,0,1,3535,61,3596,5099,3,1,3,0,1,0,70.52
臺中市,北屯區,四民里,0,1,730,9,739,1018,3,1,3,0,1,0,72.59
臺中市,北屯區,同榮里,0,1,3412,58,3470,5090,3,1,3,0,1,0,68.17
臺中市,北屯區,后庄里,0,1,3390,49,3439,5035,3,1,3,0,1,0,68.30
臺中市,北屯區,陳平里,0,1,4543,50,4593,7079,3,1,3,0,1,0,64.88
臺中市,北屯區,大德里,0,1,2651,33,2684,4056,3,1,3,0,1,0,66.17
臺中市,北屯區,新平里,0,1,2823,45,2868,4360,3,1,3,0,1,0,65.78
臺中市,北屯區,仁愛里,0,1,574,4,578,778,3,1,3,0,1,0,74.29
臺中市,北屯區,水湳里,0,1,3888,63,3951,5771,3,1,3,0,1,0,68.46
嘉義市,東區,短竹里,0,1,2451,36,2487,3919,3,1,3,0,1,0,63.46
嘉義市,東區,東川里,0,1,1211,14,1225,1768,3,1,3,0,1,0,69.29
嘉義市,東區,鹿寮里,0,1,391,9,400,608,3,1,3,0,1,0,65.79
嘉義市,東區,盧厝里,0,1,1928,18,1946,3119,3,1,3,0,1,0,62.39
嘉義市,東區,東平里,0,1,568,4,572,877,3,1,3,0,1,0,65.22
嘉義市,東區,太平里,0,1,2397,28,2425,3592,3,1,3,0,1,0,67.51
嘉義市,東區,王田里,0,1,1464,15,1479,2278,3,1,3,0,1,0,64.93
嘉義市,東區,長竹里,0,1,1673,23,1696,2537,3,1,3,0,1,0,66.85
嘉義市,東區,後庄里,0,1,2296,30,2326,3457,3,1,3,0,1,0,67.28
嘉義市,東區,新店里,0,1,1969,29,1998,3092,3,1,3,0,1,0,64.62
嘉義市,東區,圳頭里,0,1,1939,20,1959,3078,3,1,3,0,1,0,63.65
嘉義市,東區,東噴里,0,1,746,11,757,1161,3,1,3,0,1,0,65.20
嘉義市,東區,希康里,0,1,224,1,225,337,3,1,3,0,1,0,66.77
嘉義市,東區,東山里,0,1,301,3,304,455,3,1,3,0,1,0,66.81
嘉義市,東區,東安里,0,1,364,5,369,542,3,1,3,0,1,0,68.08
嘉義市,東區,大街里,0,1,327,4,331,493,3,1,3,0,1,0,67.14
嘉義市,東區,祐民里,0,1,426,6,432,638,3,1,3,0,1,0,67.71
嘉義市,東區,東仁里,0,1,355,1,356,523,3,1,3,0,1,0,68.07
嘉義市,東區,內安里,0,1,305,2,307,441,3,1,3,0,1,0,69.61
嘉義市,東區,雲霄里,0,1,868,8,876,1316,3,1,3,0,1,0,66.57
嘉義市,東區,建國里,0,1,391,4,395,610,3,1,3,0,1,0,64.75
嘉義市,東區,府路里,0,1,634,6,640,1005,3,1,3,0,1,0,63.68
嘉義市,東區,鎮南里,0,1,255,4,259,384,3,1,3,0,1,0,67.45
嘉義市,東區,神農里,0,1,672,10,682,1023,3,1,3,0,1,0,66.67
嘉義市,東區,崇文里,0,1,433,5,438,629,3,1,3,0,1,0,69.63
嘉義市,東區,龍山里,0,1,483,4,487,736,3,1,3,0,1,0,66.17
嘉義市,東區,安平里,0,1,486,5,491,730,3,1,3,0,1,0,67.26
嘉義市,東區,文昌里,0,1,445,5,450,671,3,1,3,0,1,0,67.06
嘉義市,東區,志航里,0,1,811,9,820,1175,3,1,3,0,1,0,69.79
嘉義市,東區,蘭井里,0,1,398,3,401,630,3,1,3,0,1,0,63.65
嘉義市,東區,光復里,0,1,735,2,737,1095,3,1,3,0,1,0,67.31
嘉義市,東區,初陽里,0,1,843,5,848,1268,3,1,3,0,1,0,66.88
嘉義市,東區,震安里,0,1,572,7,579,852,3,1,3,0,1,0,67.96
嘉義市,東區,新開里,0,1,892,11,903,1369,3,1,3,0,1,0,65.96
嘉義市,東區,宣信里,0,1,1172,18,1190,1914,3,1,3,0,1,0,62.17
嘉義市,東區,興南里,0,1,842,10,852,1325,3,1,3,0,1,0,64.30
嘉義市,東區,豐年里,0,1,983,18,1001,1540,3,1,3,0,1,0,65.00
嘉義市,東區,芳草里,0,1,2000,33,2033,3265,3,1,3,0,1,0,62.27
嘉義市,東區,芳安里,0,1,1397,15,1412,2071,3,1,3,0,1,0,68.18
嘉義市,東區,頂寮里,0,1,1259,13,1272,1963,3,1,3,0,1,0,64.80
嘉義市,東區,安寮里,0,1,2780,28,2808,4551,3,1,3,0,1,0,61.70
嘉義市,東區,興村里,0,1,1806,16,1822,2954,3,1,3,0,1,0,61.68
嘉義市,東區,興安里,0,1,1300,18,1318,2094,3,1,3,0,1,0,62.94
嘉義市,東區,興仁里,0,1,1933,22,1955,3003,3,1,3,0,1,0,65.10
嘉義市,東區,北城里,0,1,543,3,546,858,3,1,3,0,1,0,63.64
嘉義市,東區,仁武里,0,1,438,9,447,647,3,1,3,0,1,0,69.09
嘉義市,東區,泰安里,0,1,693,6,699,1093,3,1,3,0,1,0,63.95
嘉義市,東區,檜村里,0,1,916,6,922,1420,3,1,3,0,1,0,64.93
嘉義市,東區,社口里,0,1,591,4,595,884,3,1,3,0,1,0,67.31
嘉義市,東區,仁和里,0,1,312,4,316,505,3,1,3,0,1,0,62.57
嘉義市,東區,中庄里,0,1,1533,25,1558,2567,3,1,3,0,1,0,60.69
嘉義市,東區,仁義里,0,1,1256,17,1273,2043,3,1,3,0,1,0,62.31
嘉義市,東區,後湖里,0,1,1886,24,1910,2947,3,1,3,0,1,0,64.81
嘉義市,東區,荖藤里,0,1,1497,18,1515,2281,3,1,3,0,1,0,66.42
嘉義市,東區,頂庄里,0,1,2879,30,2909,4515,3,1,3,0,1,0,64.43
嘉義市,西區,書院里,0,1,677,8,685,1007,3,1,3,0,1,0,68.02
嘉義市,西區,驛站里,0,1,426,6,432,654,3,1,3,0,1,0,66.06
嘉義市,西區,民安里,0,1,323,3,326,509,3,1,3,0,1,0,64.05
嘉義市,西區,菜園里,0,1,440,5,445,673,3,1,3,0,1,0,66.12
嘉義市,西區,集英里,0,1,350,6,356,543,3,1,3,0,1,0,65.56
嘉義市,西區,福松里,0,1,587,4,591,827,3,1,3,0,1,0,71.46
嘉義市,西區,義昌里,0,1,373,6,379,577,3,1,3,0,1,0,65.68
嘉義市,西區,自治里,0,1,739,5,744,1115,3,1,3,0,1,0,66.73
嘉義市,西區,大業里,0,1,570,2,572,888,3,1,3,0,1,0,64.41
嘉義市,西區,中庸里,0,1,540,4,544,818,3,1,3,0,1,0,66.50
嘉義市,西區,學圃里,0,1,330,3,333,494,3,1,3,0,1,0,67.41
嘉義市,西區,北杏里,0,1,512,7,519,783,3,1,3,0,1,0,66.28
嘉義市,西區,社內里,0,1,358,5,363,518,3,1,3,0,1,0,70.08
嘉義市,西區,民生里,0,1,372,3,375,523,3,1,3,0,1,0,71.70
嘉義市,西區,慶昇里,0,1,266,6,272,420,3,1,3,0,1,0,64.76
嘉義市,西區,通運里,0,1,243,4,247,404,3,1,3,0,1,0,61.14
嘉義市,西區,榮檜里,0,1,391,6,397,618,3,1,3,0,1,0,64.24
嘉義市,西區,功科里,0,1,491,5,496,723,3,1,3,0,1,0,68.60
嘉義市,西區,康莊里,0,1,420,4,424,628,3,1,3,0,1,0,67.52
嘉義市,西區,福全里,0,1,3637,63,3700,5830,3,1,3,0,1,0,63.46
嘉義市,西區,力行里,0,1,616,6,622,949,3,1,3,0,1,0,65.54
嘉義市,西區,劉厝里,0,1,1956,21,1977,3143,3,1,3,0,1,0,62.90
嘉義市,西區,港坪里,0,1,1195,15,1210,1812,3,1,3,0,1,0,66.78
嘉義市,西區,頭港里,0,1,779,10,789,1246,3,1,3,0,1,0,63.32
嘉義市,西區,西平里,0,1,853,10,863,1283,3,1,3,0,1,0,67.26
嘉義市,西區,大溪里,0,1,1095,16,1111,1699,3,1,3,0,1,0,65.39
嘉義市,西區,磚窯里,0,1,1947,32,1979,3094,3,1,3,0,1,0,63.96
嘉義市,西區,新西里,0,1,1304,31,1335,2093,3,1,3,0,1,0,63.78
嘉義市,西區,華明里,0,1,507,5,512,790,3,1,3,0,1,0,64.81
嘉義市,西區,導民里,0,1,816,9,825,1273,3,1,3,0,1,0,64.81
嘉義市,西區,培元里,0,1,718,5,723,1091,3,1,3,0,1,0,66.27
嘉義市,西區,垂楊里,0,1,1126,17,1143,1936,3,1,3,0,1,0,59.04
嘉義市,西區,車店里,0,1,2691,29,2720,4193,3,1,3,0,1,0,64.87
嘉義市,西區,福民里,0,1,2576,25,2601,3925,3,1,3,0,1,0,66.27
嘉義市,西區,湖內里,0,1,4023,46,4069,6474,3,1,3,0,1,0,62.85
嘉義市,西區,美源里,0,1,2014,19,2033,3258,3,1,3,0,1,0,62.40
嘉義市,西區,光路里,0,1,2568,30,2598,3979,3,1,3,0,1,0,65.29
嘉義市,西區,育英里,0,1,1448,17,1465,2253,3,1,3,0,1,0,65.02
嘉義市,西區,自強里,0,1,822,9,831,1253,3,1,3,0,1,0,66.32
嘉義市,西區,長安里,0,1,857,13,870,1267,3,1,3,0,1,0,68.67
嘉義市,西區,北榮里,0,1,1262,13,1275,1884,3,1,3,0,1,0,67.68
嘉義市,西區,重興里,0,1,1235,24,1259,2037,3,1,3,0,1,0,61.81
嘉義市,西區,慶昌里,0,1,350,8,358,525,3,1,3,0,1,0,68.19
嘉義市,西區,小湖里,0,1,419,6,425,655,3,1,3,0,1,0,64.89
嘉義市,西區,竹文里,0,1,873,10,883,1370,3,1,3,0,1,0,64.45
嘉義市,西區,香湖里,0,1,861,18,879,1355,3,1,3,0,1,0,64.87
嘉義市,西區,湖邊里,0,1,1187,21,1208,1805,3,1,3,0,1,0,66.93
嘉義市,西區,竹圍里,0,1,2596,40,2636,4010,3,1,3,0,1,0,65.74
嘉義市,西區,保安里,0,1,5691,81,5772,8706,3,1,3,0,1,0,66.30
嘉義市,西區,新厝里,0,1,2103,29,2132,3263,3,1,3,0,1,0,65.34
嘉義市,西區,北湖里,0,1,1499,15,1514,2226,3,1,3,0,1,0,68.01
嘉義市,西區,下埤里,0,1,846,17,863,1231,3,1,3,0,1,0,70.11
嘉義市,西區,竹村里,0,1,823,11,834,1049,3,1,3,0,1,0,79.50
臺南市,東區,崇學里,0,1,3474,45,3519,5938,3,1,3,0,1,0,59.26
臺南市,東區,崇德里,0,1,2461,54,2515,3888,3,1,3,0,1,0,64.69
臺南市,東區,崇善里,0,1,1970,23,1993,3255,3,1,3,0,1,0,61.23
臺南市,東區,崇成里,0,1,3924,40,3964,6214,3,1,3,0,1,0,63.79
臺南市,東區,東智里,0,1,1273,11,1284,1997,3,1,3,0,1,0,64.30
臺南市,東區,大智里,0,1,2742,23,2765,4420,3,1,3,0,1,0,62.56
臺南市,東區,德高里,0,1,1540,35,1575,2497,3,1,3,0,1,0,63.08
臺南市,東區,仁和里,0,1,2076,25,2101,3630,3,1,3,0,1,0,57.88
臺南市,東區,和平里,0,1,1564,10,1574,2520,3,1,3,0,1,0,62.46
臺南市,東區,虎尾里,0,1,3824,39,3863,6069,3,1,3,0,1,0,63.65
臺南市,東區,自強里,0,1,3714,44,3758,6272,3,1,3,0,1,0,59.92
臺南市,東區,東聖里,0,1,1369,17,1386,2162,3,1,3,0,1,0,64.11
臺南市,東區,關聖里,0,1,2819,33,2852,4391,3,1,3,0,1,0,64.95
臺南市,東區,後甲里,0,1,1775,25,1800,2683,3,1,3,0,1,0,67.09
臺南市,東區,復國里,0,1,1340,24,1364,1931,3,1,3,0,1,0,70.64
臺南市,東區,中興里,0,1,1195,15,1210,1712,3,1,3,0,1,0,70.68
臺南市,東區,東光里,0,1,2511,38,2549,3943,3,1,3,0,1,0,64.65
臺南市,東區,東明里,0,1,1932,15,1947,3135,3,1,3,0,1,0,62.11
臺南市,東區,莊敬里,0,1,1935,19,1954,2983,3,1,3,0,1,0,65.50
臺南市,東區,小東里,0,1,2368,22,2390,3796,3,1,3,0,1,0,62.96
臺南市,東區,大學里,0,1,963,5,968,1466,3,1,3,0,1,0,66.03
臺南市,東區,育樂里,0,1,520,12,532,852,3,1,3,0,1,0,62.44
臺南市,東區,前鋒里,0,1,454,2,456,734,3,1,3,0,1,0,62.13
臺南市,東區,大廟里,0,1,723,8,731,1128,3,1,3,0,1,0,64.80
臺南市,東區,泉北里,0,1,705,6,711,1132,3,1,3,0,1,0,62.81
臺南市,東區,圍上里,0,1,493,13,506,766,3,1,3,0,1,0,66.06
臺南市,東區,圍下里,0,1,1293,11,1304,1945,3,1,3,0,1,0,67.04
臺南市,東區,中西里,0,1,1809,16,1825,2918,3,1,3,0,1,0,62.54
臺南市,東區,東安里,0,1,980,20,1000,1659,3,1,3,0,1,0,60.28
臺南市,東區,新東里,0,1,1559,27,1586,2498,3,1,3,0,1,0,63.49
臺南市,東區,崇誨里,0,1,1730,24,1754,2736,3,1,3,0,1,0,64.11
臺南市,東區,衛國里,0,1,965,16,981,1608,3,1,3,0,1,0,61.01
臺南市,東區,裕農里,0,1,1782,21,1803,2777,3,1,3,0,1,0,64.93
臺南市,東區,富強里,0,1,2549,40,2589,3874,3,1,3,0,1,0,66.83
臺南市,東區,富裕里,0,1,1319,17,1336,2117,3,1,3,0,1,0,63.11
臺南市,東區,崇明里,0,1,1469,10,1479,2348,3,1,3,0,1,0,62.99
臺南市,東區,忠孝里,0,1,2952,59,3011,4802,3,1,3,0,1,0,62.70
臺南市,東區,大福里,0,1,1216,18,1234,1856,3,1,3,0,1,0,66.49
臺南市,東區,大德里,0,1,1028,13,1041,1687,3,1,3,0,1,0,61.71
臺南市,東區,路東里,0,1,828,7,835,1392,3,1,3,0,1,0,59.99
臺南市,東區,大興里,0,1,665,9,674,1028,3,1,3,0,1,0,65.56
臺南市,東區,府宅里,0,1,772,10,782,1177,3,1,3,0,1,0,66.44
臺南市,東區,川東里,0,1,488,8,496,766,3,1,3,0,1,0,64.75
臺南市,東區,泉南里,0,1,2543,27,2570,4084,3,1,3,0,1,0,62.93
臺南市,東區,龍山里,0,1,3590,34,3624,5675,3,1,3,0,1,0,63.86
臺南市,南區,大恩里,0,1,1953,21,1974,3090,3,1,3,0,1,0,63.88
臺南市,南區,大林里,0,1,1248,20,1268,1976,3,1,3,0,1,0,64.17
臺南市,南區,大忠里,0,1,2514,31,2545,4123,3,1,3,0,1,0,61.73
臺南市,南區,新生里,0,1,666,9,675,1006,3,1,3,0,1,0,67.10
臺南市,南區,竹溪里,0,1,840,9,849,1330,3,1,3,0,1,0,63.83
臺南市,南區,明德里,0,1,682,13,695,1033,3,1,3,0,1,0,67.28
臺南市,南區,興中里,0,1,756,7,763,1175,3,1,3,0,1,0,64.94
臺南市,南區,荔宅里,0,1,802,16,818,1322,3,1,3,0,1,0,61.88
臺南市,南區,大成里,0,1,583,7,590,944,3,1,3,0,1,0,62.50
臺南市,南區,田寮里,0,1,2154,19,2173,3305,3,1,3,0,1,0,65.75
臺南市,南區,新興里,0,1,1661,17,1678,2620,3,1,3,0,1,0,64.05
臺南市,南區,再興里,0,1,1422,13,1435,2212,3,1,3,0,1,0,64.87
臺南市,南區,廣州里,0,1,1712,19,1731,2545,3,1,3,0,1,0,68.02
臺南市,南區,新昌里,0,1,1493,13,1506,2353,3,1,3,0,1,0,64.00
臺南市,南區,文華里,0,1,1941,24,1965,3070,3,1,3,0,1,0,64.01
臺南市,南區,文南里,0,1,2272,21,2293,3579,3,1,3,0,1,0,64.07
臺南市,南區,金華里,0,1,2853,35,2888,4623,3,1,3,0,1,0,62.47
臺南市,南區,國宅里,0,1,1881,26,1907,2964,3,1,3,0,1,0,64.34
臺南市,南區,日新里,0,1,1251,23,1274,1996,3,1,3,0,1,0,63.83
臺南市,南區,光明里,0,1,2514,20,2534,4096,3,1,3,0,1,0,61.87
臺南市,南區,白雪里,0,1,1215,16,1231,1917,3,1,3,0,1,0,64.21
臺南市,南區,明亮里,0,1,2037,28,2065,3423,3,1,3,0,1,0,60.33
臺南市,南區,府南里,0,1,2359,32,2391,3900,3,1,3,0,1,0,61.31
臺南市,南區,明興里,0,1,1959,20,1979,3112,3,1,3,0,1,0,63.59
臺南市,南區,郡南里,0,1,2009,36,2045,3263,3,1,3,0,1,0,62.67
臺南市,南區,建南里,0,1,2355,32,2387,3705,3,1,3,0,1,0,64.43
臺南市,南區,南都里,0,1,2486,29,2515,4445,3,1,3,0,1,0,56.58
臺南市,南區,開南里,0,1,2123,29,2152,3854,3,1,3,0,1,0,55.84
臺南市,南區,彰南里,0,1,1120,22,1142,1886,3,1,3,0,1,0,60.55
臺南市,南區,清泉里,0,1,675,14,689,1012,3,1,3,0,1,0,68.08
臺南市,南區,龍崗里,0,1,597,7,604,900,3,1,3,0,1,0,67.11
臺南市,南區,喜北里,0,1,1389,12,1401,2159,3,1,3,0,1,0,64.89
臺南市,南區,喜南里,0,1,907,11,918,1430,3,1,3,0,1,0,64.20
臺南市,南區,喜東里,0,1,947,7,954,1502,3,1,3,0,1,0,63.52
臺南市,南區,省躬里,0,1,1624,19,1643,2631,3,1,3,0,1,0,62.45
臺南市,南區,覺醒里,0,1,450,10,460,650,3,1,3,0,1,0,70.77
臺南市,南區,海豐里,0,1,407,7,414,605,3,1,3,0,1,0,68.43
臺南市,南區,松山里,0,1,606,6,612,962,3,1,3,0,1,0,63.62
臺南市,南區,南山里,0,1,492,3,495,760,3,1,3,0,1,0,65.13
臺南市,南區,佛壇里,0,1,1116,14,1130,1746,3,1,3,0,1,0,64.72
臺南市,南區,同安里,0,1,1189,16,1205,1937,3,1,3,0,1,0,62.21
臺南市,南區,中和里,0,1,504,7,511,740,3,1,3,0,1,0,69.05
臺南市,南區,興農里,0,1,1163,14,1177,1791,3,1,3,0,1,0,65.72
臺南市,西區,西賢里,0,1,1955,20,1975,3089,3,1,3,0,1,0,63.94
臺南市,西區,西湖里,0,1,1727,11,1738,2681,3,1,3,0,1,0,64.83
臺南市,西區,光賢里,0,1,1626,20,1646,2506,3,1,3,0,1,0,65.68
臺南市,西區,文賢里,0,1,793,13,806,1223,3,1,3,0,1,0,65.90
臺南市,西區,協和里,0,1,1314,20,1334,1970,3,1,3,0,1,0,67.72
臺南市,西區,金安里,0,1,377,5,382,589,3,1,3,0,1,0,64.86
臺南市,西區,忠信里,0,1,488,3,491,683,3,1,3,0,1,0,71.89
臺南市,西區,工業里,0,1,494,10,504,735,3,1,3,0,1,0,68.57
臺南市,西區,普濟里,0,1,469,8,477,697,3,1,3,0,1,0,68.44
臺南市,西區,濟同里,0,1,376,9,385,558,3,1,3,0,1,0,69.00
臺南市,西區,水仙里,0,1,614,5,619,959,3,1,3,0,1,0,64.55
臺南市,西區,北勢里,0,1,558,10,568,889,3,1,3,0,1,0,63.89
臺南市,西區,藥王里,0,1,1680,13,1693,2609,3,1,3,0,1,0,64.89
臺南市,西區,協進里,0,1,668,10,678,1045,3,1,3,0,1,0,64.88
臺南市,西區,西羅里,0,1,560,14,574,805,3,1,3,0,1,0,71.30
臺南市,西區,安新里,0,1,327,3,330,473,3,1,3,0,1,0,69.77
臺南市,西區,中正里,0,1,547,9,556,835,3,1,3,0,1,0,66.59
臺南市,西區,正德里,0,1,370,7,377,569,3,1,3,0,1,0,66.26
臺南市,西區,安海里,0,1,640,8,648,1114,3,1,3,0,1,0,58.17
臺南市,西區,大涼里,0,1,1365,21,1386,2216,3,1,3,0,1,0,62.55
臺南市,西區,民主里,0,1,454,6,460,796,3,1,3,0,1,0,57.79
臺南市,西區,運河里,0,1,326,6,332,520,3,1,3,0,1,0,63.85
臺南市,西區,北頭里,0,1,168,1,169,237,3,1,3,0,1,0,71.31
臺南市,西區,保民里,0,1,280,3,283,406,3,1,3,0,1,0,69.70
臺南市,西區,保良里,0,1,285,3,288,420,3,1,3,0,1,0,68.57
臺南市,西區,天池里,0,1,202,0,202,291,3,1,3,0,1,0,69.42
臺南市,西區,中頭里,0,1,605,13,618,937,3,1,3,0,1,0,65.96
臺南市,西區,民生里,0,1,723,8,731,1068,3,1,3,0,1,0,68.45
臺南市,西區,新安里,0,1,547,8,555,771,3,1,3,0,1,0,71.98
臺南市,西區,元安里,0,1,835,12,847,1364,3,1,3,0,1,0,62.10
臺南市,北區,城隍里,0,1,595,6,601,946,3,1,3,0,1,0,63.53
臺南市,北區,元和里,0,1,589,12,601,1090,3,1,3,0,1,0,55.14
臺南市,北區,城朔里,0,1,619,7,626,1084,3,1,3,0,1,0,57.75
臺南市,北區,共和里,0,1,740,6,746,1243,3,1,3,0,1,0,60.02
臺南市,北區,福德里,0,1,581,7,588,922,3,1,3,0,1,0,63.77
臺南市,北區,花園里,0,1,622,6,628,996,3,1,3,0,1,0,63.05
臺南市,北區,西華里,0,1,684,8,692,1129,3,1,3,0,1,0,61.29
臺南市,北區,北門里,0,1,523,9,532,854,3,1,3,0,1,0,62.30
臺南市,北區,東豐里,0,1,748,15,763,1157,3,1,3,0,1,0,65.95
臺南市,北區,水源里,0,1,572,7,579,913,3,1,3,0,1,0,63.42
臺南市,北區,仁愛里,0,1,1088,13,1101,1720,3,1,3,0,1,0,64.01
臺南市,北區,振興里,0,1,1176,8,1184,1886,3,1,3,0,1,0,62.78
臺南市,北區,東興里,0,1,1232,16,1248,1931,3,1,3,0,1,0,64.63
臺南市,北區,重興里,0,1,1806,17,1823,2793,3,1,3,0,1,0,65.27
臺南市,北區,華興里,0,1,1293,11,1304,2031,3,1,3,0,1,0,64.20
臺南市,北區,力行里,0,1,1378,14,1392,2176,3,1,3,0,1,0,63.97
臺南市,北區,國興里,0,1,937,17,954,1400,3,1,3,0,1,0,68.14
臺南市,北區,新勝里,0,1,1105,23,1128,1828,3,1,3,0,1,0,61.71
臺南市,北區,開元里,0,1,2308,32,2340,3987,3,1,3,0,1,0,58.69
臺南市,北區,北垣里,0,1,573,7,580,896,3,1,3,0,1,0,64.73
臺南市,北區,勝安里,0,1,763,9,772,1242,3,1,3,0,1,0,62.16
臺南市,北區,大仁里,0,1,685,6,691,1075,3,1,3,0,1,0,64.28
臺南市,北區,大山里,0,1,829,15,844,1300,3,1,3,0,1,0,64.92
臺南市,北區,大道里,0,1,655,4,659,1086,3,1,3,0,1,0,60.68
臺南市,北區,實踐里,0,1,880,12,892,1467,3,1,3,0,1,0,60.80
臺南市,北區,小康里,0,1,3137,37,3174,4910,3,1,3,0,1,0,64.64
臺南市,北區,正風里,0,1,967,16,983,1533,3,1,3,0,1,0,64.12
臺南市,北區,延平里,0,1,1093,14,1107,1823,3,1,3,0,1,0,60.72
臺南市,北區,興北里,0,1,996,25,1021,1577,3,1,3,0,1,0,64.74
臺南市,北區,興南里,0,1,796,9,805,1353,3,1,3,0,1,0,59.50
臺南市,北區,國姓里,0,1,1001,9,1010,1550,3,1,3,0,1,0,65.16
臺南市,北區,六甲里,0,1,1309,17,1326,2271,3,1,3,0,1,0,58.39
臺南市,北區,正覺里,0,1,2047,27,2074,3235,3,1,3,0,1,0,64.11
臺南市,北區,成功里,0,1,3758,37,3795,6307,3,1,3,0,1,0,60.17
臺南市,北區,和順里,0,1,2827,23,2850,4651,3,1,3,0,1,0,61.28
臺南市,北區,安民里,0,1,817,4,821,1195,3,1,3,0,1,0,68.70
臺南市,北區,裕民里,0,1,913,5,918,1412,3,1,3,0,1,0,65.01
臺南市,北區,文元里,0,1,3409,41,3450,5352,3,1,3,0,1,0,64.46
臺南市,北區,大港里,0,1,4709,62,4771,7208,3,1,3,0,1,0,66.19
臺南市,北區,大豐里,0,1,3699,43,3742,5934,3,1,3,0,1,0,63.06
臺南市,中區,萬壽里,0,1,738,7,745,1153,3,1,3,0,1,0,64.61
臺南市,中區,文昌里,0,1,695,9,704,1020,3,1,3,0,1,0,69.02
臺南市,中區,萬鍾里,0,1,703,15,718,1121,3,1,3,0,1,0,64.05
臺南市,中區,銀同里,0,1,846,10,856,1350,3,1,3,0,1,0,63.41
臺南市,中區,清水里,0,1,470,5,475,699,3,1,3,0,1,0,67.95
臺南市,中區,環翠里,0,1,438,10,448,688,3,1,3,0,1,0,65.12
臺南市,中區,公正里,0,1,229,5,234,363,3,1,3,0,1,0,64.46
臺南市,中區,廣慈里,0,1,274,0,274,424,3,1,3,0,1,0,64.62
臺南市,中區,啟智里,0,1,736,13,749,1162,3,1,3,0,1,0,64.46
臺南市,中區,永慶里,0,1,244,3,247,376,3,1,3,0,1,0,65.69
臺南市,中區,天中里,0,1,312,2,314,475,3,1,3,0,1,0,66.11
臺南市,中區,中山里,0,1,313,6,319,498,3,1,3,0,1,0,64.06
臺南市,中區,白金里,0,1,429,4,433,634,3,1,3,0,1,0,68.30
臺南市,中區,武聖里,0,1,487,7,494,716,3,1,3,0,1,0,68.99
臺南市,中區,蓬壺里,0,1,655,9,664,1019,3,1,3,0,1,0,65.16
臺南市,中區,赤嵌里,0,1,293,3,296,482,3,1,3,0,1,0,61.41
臺南市,中區,觀音里,0,1,416,8,424,688,3,1,3,0,1,0,61.63
臺南市,中區,竹翠里,0,1,330,3,333,477,3,1,3,0,1,0,69.81
臺南市,中區,溫陵里,0,1,371,5,376,591,3,1,3,0,1,0,63.62
臺南市,中區,開仙里,0,1,458,4,462,706,3,1,3,0,1,0,65.44
臺南市,中區,保西里,0,1,449,4,453,731,3,1,3,0,1,0,61.97
臺南市,中區,中南里,0,1,370,1,371,533,3,1,3,0,1,0,69.61
臺南市,中區,福安里,0,1,571,9,580,866,3,1,3,0,1,0,66.97
臺南市,中區,昇平里,0,1,310,0,310,469,3,1,3,0,1,0,66.10
臺南市,中區,聖前里,0,1,272,5,277,429,3,1,3,0,1,0,64.57
臺南市,中區,小西里,0,1,650,5,655,1023,3,1,3,0,1,0,64.03
臺南市,中區,仙草里,0,1,1429,14,1443,2357,3,1,3,0,1,0,61.22
臺南市,中區,五妃里,0,1,709,6,715,1076,3,1,3,0,1,0,66.45
臺南市,中區,大南里,0,1,999,7,1006,1478,3,1,3,0,1,0,68.06
臺南市,中區,進學里,0,1,442,4,446,687,3,1,3,0,1,0,64.92
臺南市,中區,川西里,0,1,485,4,489,734,3,1,3,0,1,0,66.62
臺南市,中區,開山里,0,1,918,9,927,1450,3,1,3,0,1,0,63.93
臺南市,中區,郡王里,0,1,1050,9,1059,1623,3,1,3,0,1,0,65.25
臺南市,中區,法華里,0,1,2080,16,2096,3231,3,1,3,0,1,0,64.87
臺南市,安南區,東和里,0,1,399,7,406,533,3,1,3,0,1,0,76.17
臺南市,安南區,塭南里,0,1,2053,27,2080,3455,3,1,3,0,1,0,60.20
臺南市,安南區,州南里,0,1,2593,24,2617,4136,3,1,3,0,1,0,63.27
臺南市,安南區,安順里,0,1,1575,28,1603,2379,3,1,3,0,1,0,67.38
臺南市,安南區,州北里,0,1,1915,21,1936,2979,3,1,3,0,1,0,64.99
臺南市,安南區,新順里,0,1,1895,32,1927,2923,3,1,3,0,1,0,65.93
臺南市,安南區,頂安里,0,1,1659,22,1681,2526,3,1,3,0,1,0,66.55
臺南市,安南區,安慶里,0,1,2470,31,2501,3881,3,1,3,0,1,0,64.44
臺南市,安南區,溪北里,0,1,1525,14,1539,2428,3,1,3,0,1,0,63.39
臺南市,安南區,安和里,0,1,1201,15,1216,1856,3,1,3,0,1,0,65.52
臺南市,安南區,安西里,0,1,1386,16,1402,2112,3,1,3,0,1,0,66.38
臺南市,安南區,溪頂里,0,1,2241,35,2276,3577,3,1,3,0,1,0,63.63
臺南市,安南區,安東里,0,1,1650,19,1669,2533,3,1,3,0,1,0,65.89
臺南市,安南區,鳳凰里,0,1,1910,28,1938,3324,3,1,3,0,1,0,58.30
臺南市,安南區,梅花里,0,1,1776,22,1798,2987,3,1,3,0,1,0,60.19
臺南市,安南區,理想里,0,1,3747,42,3789,6043,3,1,3,0,1,0,62.70
臺南市,安南區,原佃里,0,1,958,13,971,1359,3,1,3,0,1,0,71.45
臺南市,安南區,長安里,0,1,2007,37,2044,3103,3,1,3,0,1,0,65.87
臺南市,安南區,公親里,0,1,662,5,667,957,3,1,3,0,1,0,69.70
臺南市,安南區,布袋里,0,1,773,6,779,1197,3,1,3,0,1,0,65.08
臺南市,安南區,總頭里,0,1,1197,23,1220,1671,3,1,3,0,1,0,73.01
臺南市,安南區,南興里,0,1,792,7,799,1341,3,1,3,0,1,0,59.58
臺南市,安南區,學東里,0,1,1057,13,1070,1677,3,1,3,0,1,0,63.80
臺南市,安南區,公塭里,0,1,608,6,614,811,3,1,3,0,1,0,75.71
臺南市,安南區,佃東里,0,1,1281,24,1305,2124,3,1,3,0,1,0,61.44
臺南市,安南區,佃西里,0,1,946,9,955,1511,3,1,3,0,1,0,63.20
臺南市,安南區,淵西里,0,1,1442,26,1468,2379,3,1,3,0,1,0,61.71
臺南市,安南區,海西里,0,1,1481,25,1506,2231,3,1,3,0,1,0,67.50
臺南市,安南區,海東里,0,1,1890,33,1923,3097,3,1,3,0,1,0,62.09
臺南市,安南區,溪心里,0,1,2067,17,2084,3423,3,1,3,0,1,0,60.88
臺南市,安南區,淵東里,0,1,1691,24,1715,2706,3,1,3,0,1,0,63.38
臺南市,安南區,淵中里,0,1,1657,26,1683,2708,3,1,3,0,1,0,62.15
臺南市,安南區,溪墘里,0,1,1717,23,1740,2737,3,1,3,0,1,0,63.57
臺南市,安南區,海佃里,0,1,2365,29,2394,3746,3,1,3,0,1,0,63.91
臺南市,安南區,國安里,0,1,1035,19,1054,1572,3,1,3,0,1,0,67.05
臺南市,安南區,溪東里,0,1,1602,21,1623,2561,3,1,3,0,1,0,63.37
臺南市,安南區,安富里,0,1,2367,31,2398,3931,3,1,3,0,1,0,61.00
臺南市,安南區,幸福里,0,1,2114,25,2139,3324,3,1,3,0,1,0,64.35
臺南市,安南區,海南里,0,1,1218,9,1227,1908,3,1,3,0,1,0,64.31
臺南市,安南區,城東里,0,1,882,13,895,1350,3,1,3,0,1,0,66.30
臺南市,安南區,城南里,0,1,1577,24,1601,2310,3,1,3,0,1,0,69.31
臺南市,安南區,青草里,0,1,833,19,852,1170,3,1,3,0,1,0,72.82
臺南市,安南區,城西里,0,1,670,9,679,966,3,1,3,0,1,0,70.29
臺南市,安南區,城北里,0,1,827,9,836,1158,3,1,3,0,1,0,72.19
臺南市,安南區,城中里,0,1,674,7,681,828,3,1,3,0,1,0,82.25
臺南市,安南區,砂崙里,0,1,640,8,648,959,3,1,3,0,1,0,67.57
臺南市,安南區,顯宮里,0,1,685,7,692,1029,3,1,3,0,1,0,67.25
臺南市,安南區,鹿耳里,0,1,413,8,421,617,3,1,3,0,1,0,68.23
臺南市,安南區,四草里,0,1,969,11,980,1402,3,1,3,0,1,0,69.90
臺南市,安南區,鹽田里,0,1,437,5,442,597,3,1,3,0,1,0,74.04
臺南市,安平區,石門里,0,1,3100,31,3131,4941,3,1,3,0,1,0,63.37
臺南市,安平區,校前里,0,1,527,9,536,781,3,1,3,0,1,0,68.63
臺南市,安平區,安中里,0,1,282,5,287,441,3,1,3,0,1,0,65.08
臺南市,安平區,菩薩里,0,1,241,1,242,340,3,1,3,0,1,0,71.18
臺南市,安平區,文朱里,0,1,247,1,248,331,3,1,3,0,1,0,74.92
臺南市,安平區,妙壽里,0,1,244,2,246,373,3,1,3,0,1,0,65.95
臺南市,安平區,海興里,0,1,569,3,572,823,3,1,3,0,1,0,69.50
臺南市,安平區,西門里,0,1,1400,13,1413,2017,3,1,3,0,1,0,70.05
臺南市,安平區,金城里,0,1,913,14,927,1421,3,1,3,0,1,0,65.24
臺南市,安平區,漁光里,0,1,373,9,382,522,3,1,3,0,1,0,73.18
臺南市,安平區,億載里,0,1,703,4,707,1151,3,1,3,0,1,0,61.42
臺南市,安平區,平通里,0,1,1979,24,2003,3516,3,1,3,0,1,0,56.97
臺南市,安平區,育平里,0,1,2256,20,2276,4185,3,1,3,0,1,0,54.38
臺南市,安平區,華平里,0,1,1999,27,2026,3295,3,1,3,0,1,0,61.49
臺南市,安平區,國平里,0,1,1531,8,1539,2798,3,1,3,0,1,0,55.00
臺南市,安平區,怡平里,0,1,1223,12,1235,2096,3,1,3,0,1,0,58.92
臺南市,安平區,建平里,0,1,1511,17,1528,2524,3,1,3,0,1,0,60.54
臺南市,安平區,文平里,0,1,1545,17,1562,2478,3,1,3,0,1,0,63.03
金門縣,金城鎮,東門里,0,1,1234,24,1258,1886,3,1,3,0,1,0,66.70
金門縣,金城鎮,南門里,0,1,1393,36,1429,2166,3,1,3,0,1,0,65.97
金門縣,金城鎮,西門里,0,1,2245,45,2290,3559,3,1,3,0,1,0,64.34
金門縣,金城鎮,北門里,0,1,1010,15,1025,1547,3,1,3,0,1,0,66.26
金門縣,金城鎮,賢庵里,0,1,764,23,787,1221,3,1,3,0,1,0,64.46
金門縣,金城鎮,金水里,0,1,443,11,454,664,3,1,3,0,1,0,68.37
金門縣,金城鎮,古城里,0,1,849,23,872,1290,3,1,3,0,1,0,67.60
金門縣,金城鎮,珠沙里,0,1,436,7,443,721,3,1,3,0,1,0,61.44
金門縣,金寧鄉,古寧村,0,1,797,18,815,1227,3,1,3,0,1,0,66.42
金門縣,金寧鄉,安美村,0,1,944,33,977,1512,3,1,3,0,1,0,64.62
金門縣,金寧鄉,湖埔村,0,1,903,22,925,1350,3,1,3,0,1,0,68.52
金門縣,金寧鄉,榜林村,0,1,946,29,975,1485,3,1,3,0,1,0,65.66
金門縣,金寧鄉,盤山村,0,1,692,19,711,1190,3,1,3,0,1,0,59.75
金門縣,金寧鄉,后盤村,0,1,305,11,316,516,3,1,3,0,1,0,61.24
金門縣,金湖鎮,新市里,0,1,1178,16,1194,1802,3,1,3,0,1,0,66.26
金門縣,金湖鎮,山外里,0,1,852,19,871,1353,3,1,3,0,1,0,64.38
金門縣,金湖鎮,溪湖里,0,1,354,15,369,564,3,1,3,0,1,0,65.43
金門縣,金湖鎮,蓮庵里,0,1,358,7,365,571,3,1,3,0,1,0,63.92
金門縣,金湖鎮,料羅里,0,1,377,12,389,607,3,1,3,0,1,0,64.09
金門縣,金湖鎮,新湖里,0,1,1037,24,1061,1583,3,1,3,0,1,0,67.02
金門縣,金湖鎮,正義里,0,1,585,28,613,863,3,1,3,0,1,0,71.03
金門縣,金湖鎮,瓊林里,0,1,834,18,852,1193,3,1,3,0,1,0,71.42
金門縣,金沙鎮,汶沙里,0,1,1193,34,1227,1950,3,1,3,0,1,0,62.92
金門縣,金沙鎮,何斗里,0,1,486,13,499,772,3,1,3,0,1,0,64.64
金門縣,金沙鎮,浦山里,0,1,555,21,576,862,3,1,3,0,1,0,66.82
金門縣,金沙鎮,西園里,0,1,302,13,315,558,3,1,3,0,1,0,56.45
金門縣,金沙鎮,官嶼里,0,1,438,6,444,723,3,1,3,0,1,0,61.41
金門縣,金沙鎮,三山里,0,1,433,10,443,723,3,1,3,0,1,0,61.27
金門縣,金沙鎮,大洋里,0,1,295,7,302,459,3,1,3,0,1,0,65.80
金門縣,金沙鎮,光前里,0,1,484,13,497,804,3,1,3,0,1,0,61.82
金門縣,烈嶼鄉,林湖村,0,1,707,26,733,1148,3,1,3,0,1,0,63.85
金門縣,烈嶼鄉,黃埔村,0,1,276,6,282,522,3,1,3,0,1,0,54.02
金門縣,烈嶼鄉,西口村,0,1,400,19,419,747,3,1,3,0,1,0,56.09
金門縣,烈嶼鄉,上林村,0,1,284,12,296,515,3,1,3,0,1,0,57.48
金門縣,烈嶼鄉,上歧村,0,1,599,22,621,987,3,1,3,0,1,0,62.92
金門縣,烏坵鄉,大坵村、小坵村,0,1,37,0,37,282,3,1,3,0,1,0,13.12
連江縣,南竿鄉,介壽村,0,1,1026,16,1042,1357,3,1,3,0,1,0,76.79
連江縣,南竿鄉,福沃村、復興村,0,1,467,12,479,578,3,1,3,0,1,0,82.87
連江縣,南竿鄉,仁愛村、馬祖村、津沙村、珠螺村、清水村、四維村,0,1,357,10,367,486,3,1,3,0,1,0,75.51
連江縣,北竿鄉,后沃村、橋仔村、塘岐村,0,1,1021,33,1054,1327,3,1,3,0,1,0,79.43
連江縣,北竿鄉,白沙村、板里村、芹壁村,0,1,598,13,611,846,3,1,3,0,1,0,72.22
連江縣,莒光鄉,青帆村、田沃村、西坵村,0,1,315,9,324,424,3,1,3,0,1,0,76.42
連江縣,莒光鄉,大坪村、福正村,0,1,227,3,230,385,3,1,3,0,1,0,59.74
連江縣,東引鄉,樂華村,0,1,169,6,175,252,3,1,3,0,1,0,69.44
連江縣,東引鄉,中柳村,0,1,372,17,389,554,3,1,3,0,1,0,70.22
臺北市,北投區,建民里,1,1,1184,13,1197,1794,3,1,3,0,1,0,66.72
臺北市,北投區,建民里,2,1,1246,16,1262,1937,3,1,3,0,1,0,65.15
臺北市,北投區,文林里,3,1,1149,11,1160,1731,3,1,3,0,1,0,67.01
臺北市,北投區,文林里,4,1,1088,10,1098,1752,3,1,3,0,1,0,62.67
臺北市,北投區,石牌里,5,1,835,5,840,1327,3,1,3,0,1,0,63.30
臺北市,北投區,石牌里,6,1,939,11,950,1518,3,1,3,0,1,0,62.58
臺北市,北投區,石牌里,7,1,926,4,930,1427,3,1,3,0,1,0,65.17
臺北市,北投區,福興里,8,1,1391,13,1404,2063,3,1,3,0,1,0,68.06
臺北市,北投區,福興里,9,1,1072,15,1087,1554,3,1,3,0,1,0,69.95
臺北市,北投區,福興里,10,1,1027,11,1038,1492,3,1,3,0,1,0,69.57
臺北市,北投區,榮光里,11,1,1089,19,1108,1795,3,1,3,0,1,0,61.73
臺北市,北投區,榮光里,12,1,1199,10,1209,1886,3,1,3,0,1,0,64.10
臺北市,北投區,榮光里,13,1,1109,14,1123,1726,3,1,3,0,1,0,65.06
臺北市,北投區,榮華里,14,1,1204,10,1214,1916,3,1,3,0,1,0,63.36
臺北市,北投區,榮華里,15,1,1287,9,1296,1998,3,1,3,0,1,0,64.86
臺北市,北投區,榮華里,16,1,1181,9,1190,1802,3,1,3,0,1,0,66.04
臺北市,北投區,裕民里,17,1,1184,10,1194,1854,3,1,3,0,1,0,64.40
臺北市,北投區,裕民里,18,1,1146,17,1163,1750,3,1,3,0,1,0,66.46
臺北市,北投區,裕民里,19,1,1069,5,1074,1728,3,1,3,0,1,0,62.15
臺北市,北投區,振華里,20,1,995,9,1004,1496,3,1,3,0,1,0,67.11
臺北市,北投區,振華里,21,1,1073,13,1086,1665,3,1,3,0,1,0,65.23
臺北市,北投區,振華里,22,1,1096,15,1111,1633,3,1,3,0,1,0,68.03
臺北市,北投區,振華里,23,1,898,6,904,1412,3,1,3,0,1,0,64.02
臺北市,北投區,永和里,24,1,940,13,953,1464,3,1,3,0,1,0,65.10
臺北市,北投區,永和里,25,1,1061,12,1073,1637,3,1,3,0,1,0,65.55
臺北市,北投區,永和里,26,1,1008,10,1018,1613,3,1,3,0,1,0,63.11
臺北市,北投區,永和里,27,1,856,6,862,1353,3,1,3,0,1,0,63.71
臺北市,北投區,永欣里,28,1,1070,5,1075,1590,3,1,3,0,1,0,67.61
臺北市,北投區,永欣里,29,1,1082,6,1088,1729,3,1,3,0,1,0,62.93
臺北市,北投區,永欣里,30,1,1094,9,1103,1697,3,1,3,0,1,0,65.00
臺北市,北投區,永明里,31,1,996,7,1003,1543,3,1,3,0,1,0,65.00
臺北市,北投區,永明里,32,1,1328,11,1339,2016,3,1,3,0,1,0,66.42
臺北市,北投區,東華里,33,1,1335,8,1343,1836,3,1,3,0,1,0,73.15
臺北市,北投區,東華里,34,1,1175,11,1186,1792,3,1,3,0,1,0,66.18
臺北市,北投區,吉利里,35,1,1050,17,1067,1682,3,1,3,0,1,0,63.44
臺北市,北投區,吉利里,36,1,1068,10,1078,1680,3,1,3,0,1,0,64.17
臺北市,北投區,吉利里,37,1,1051,16,1067,1575,3,1,3,0,1,0,67.75
臺北市,北投區,吉慶里,38,1,1268,13,1281,1835,3,1,3,0,1,0,69.81
臺北市,北投區,吉慶里,39,1,1390,13,1403,2095,3,1,3,0,1,0,66.97
臺北市,北投區,尊賢里,40,1,1154,16,1170,1783,3,1,3,0,1,0,65.62
臺北市,北投區,尊賢里,41,1,1241,13,1254,2004,3,1,3,0,1,0,62.57
臺北市,北投區,立賢里,42,1,1375,21,1396,2073,3,1,3,0,1,0,67.34
臺北市,北投區,立賢里,43,1,1276,14,1290,2018,3,1,3,0,1,0,63.92
臺北市,北投區,立農里,44,1,1100,12,1112,1763,3,1,3,0,1,0,63.07
臺北市,北投區,立農里,45,1,1017,6,1023,1511,3,1,3,0,1,0,67.70
臺北市,北投區,立農里,46,1,1068,5,1073,1553,3,1,3,0,1,0,69.09
臺北市,北投區,立農里,47,1,1091,12,1103,1600,3,1,3,0,1,0,68.94
臺北市,北投區,八仙里,48,1,1127,13,1140,1792,3,1,3,0,1,0,63.62
臺北市,北投區,八仙里,49,1,1247,11,1258,1966,3,1,3,0,1,0,63.99
臺北市,北投區,洲美里,50,1,957,5,962,1338,3,1,3,0,1,0,71.90
臺北市,北投區,奇岩里,51,1,1101,10,1111,1755,3,1,3,0,1,0,63.30
臺北市,北投區,奇岩里,52,1,1009,10,1019,1599,3,1,3,0,1,0,63.73
臺北市,北投區,奇岩里,53,1,1121,7,1128,1752,3,1,3,0,1,0,64.38
臺北市,北投區,奇岩里,54,1,1365,19,1384,2153,3,1,3,0,1,0,64.28
臺北市,北投區,清江里,55,1,994,10,1004,1455,3,1,3,0,1,0,69.00
臺北市,北投區,清江里,56,1,1218,16,1234,1888,3,1,3,0,1,0,65.36
臺北市,北投區,清江里,57,1,1077,15,1092,1601,3,1,3,0,1,0,68.21
臺北市,北投區,清江里,58,1,1059,21,1080,1802,3,1,3,0,1,0,59.93
臺北市,北投區,中央里,59,1,1173,13,1186,1819,3,1,3,0,1,0,65.20
臺北市,北投區,中央里,60,1,1173,17,1190,1942,3,1,3,0,1,0,61.28
臺北市,北投區,中央里,61,1,1223,43,1266,1999,3,1,3,0,1,0,63.33
臺北市,北投區,長安里,62,1,988,15,1003,1505,3,1,3,0,1,0,66.64
臺北市,北投區,長安里,63,1,875,13,888,1375,3,1,3,0,1,0,64.58
臺北市,北投區,長安里,64,1,889,16,905,1550,3,1,3,0,1,0,58.39
臺北市,北投區,大同里,65,1,967,13,980,1470,3,1,3,0,1,0,66.67
臺北市,北投區,大同里,66,1,1072,9,1081,1639,3,1,3,0,1,0,65.95
臺北市,北投區,大同里,67,1,943,9,952,1507,3,1,3,0,1,0,63.17
臺北市,北投區,溫泉里,68,1,1114,12,1126,1690,3,1,3,0,1,0,66.63
臺北市,北投區,溫泉里,69,1,1009,9,1018,1591,3,1,3,0,1,0,63.98
臺北市,北投區,溫泉里,70,1,1035,6,1041,1672,3,1,3,0,1,0,62.26
臺北市,北投區,林泉里,71,1,772,16,788,1257,3,1,3,0,1,0,62.69
臺北市,北投區,林泉里,72,1,830,3,833,1448,3,1,3,0,1,0,57.53
臺北市,北投區,中心里,73,1,891,2,893,1542,3,1,3,0,1,0,57.91
臺北市,北投區,中心里,74,1,974,6,980,1708,3,1,3,0,1,0,57.38
臺北市,北投區,中心里,75,1,888,9,897,1475,3,1,3,0,1,0,60.81
臺北市,北投區,中庸里,76,1,1002,12,1014,1533,3,1,3,0,1,0,66.14
臺北市,北投區,中庸里,77,1,1223,11,1234,1839,3,1,3,0,1,0,67.10
臺北市,北投區,開明里,78,1,964,11,975,1579,3,1,3,0,1,0,61.75
臺北市,北投區,開明里,79,1,1118,15,1133,1708,3,1,3,0,1,0,66.33
臺北市,北投區,開明里,80,1,1109,14,1123,1876,3,1,3,0,1,0,59.86
臺北市,北投區,中和里,81,1,1639,22,1661,2589,3,1,3,0,1,0,64.16
臺北市,北投區,中和里,82,1,980,7,987,1496,3,1,3,0,1,0,65.98
臺北市,北投區,中和里,83,1,516,6,522,808,3,1,3,0,1,0,64.60
臺北市,北投區,智仁里,84,1,958,7,965,1436,3,1,3,0,1,0,67.20
臺北市,北投區,智仁里,85,1,1037,9,1046,1570,3,1,3,0,1,0,66.62
臺北市,北投區,智仁里,86,1,1112,9,1121,1728,3,1,3,0,1,0,64.87
臺北市,北投區,秀山里,87,1,929,14,943,1413,3,1,3,0,1,0,66.74
臺北市,北投區,秀山里,88,1,981,15,996,1500,3,1,3,0,1,0,66.40
臺北市,北投區,文化里,89,1,1156,8,1164,1640,3,1,3,0,1,0,70.98
臺北市,北投區,文化里,90,1,1099,8,1107,1645,3,1,3,0,1,0,67.29
臺北市,北投區,豐年里,91,1,1055,5,1060,1687,3,1,3,0,1,0,62.83
臺北市,北投區,豐年里,92,1,1013,7,1020,1601,3,1,3,0,1,0,63.71
臺北市,北投區,稻香里,93,1,1167,29,1196,1895,3,1,3,0,1,0,63.11
臺北市,北投區,稻香里,94,1,1117,18,1135,1844,3,1,3,0,1,0,61.55
臺北市,北投區,桃源里,95,1,1297,10,1307,2002,3,1,3,0,1,0,65.28
臺北市,北投區,桃源里,96,1,1293,27,1320,2104,3,1,3,0,1,0,62.74
臺北市,北投區,一德里,97,1,1058,11,1069,1686,3,1,3,0,1,0,63.40
臺北市,北投區,一德里,98,1,954,12,966,1661,3,1,3,0,1,0,58.16
臺北市,北投區,一德里,99,1,840,23,863,1343,3,1,3,0,1,0,64.26
臺北市,北投區,關渡里,100,1,996,9,1005,1555,3,1,3,0,1,0,64.63
臺北市,北投區,關渡里,101,1,922,12,934,1520,3,1,3,0,1,0,61.45
臺北市,北投區,關渡里,102,1,1124,11,1135,1773,3,1,3,0,1,0,64.02
臺北市,北投區,關渡里,103,1,937,15,952,1461,3,1,3,0,1,0,65.16
臺北市,北投區,關渡里,104,1,841,26,867,1293,3,1,3,0,1,0,67.05
臺北市,北投區,泉源里,105,1,268,1,269,405,3,1,3,0,1,0,66.42
臺北市,北投區,泉源里,106,1,995,10,1005,1498,3,1,3,0,1,0,67.09
臺北市,北投區,湖山里,107,1,453,3,456,699,3,1,3,0,1,0,65.24
臺北市,北投區,湖山里,108,1,582,5,587,926,3,1,3,0,1,0,63.39
臺北市,北投區,湖山里,109,1,474,10,484,731,3,1,3,0,1,0,66.21
臺北市,士林區,永福里,110,1,753,15,768,1142,3,1,3,0,1,0,67.25
臺北市,士林區,公舘里,111,1,753,8,761,1180,3,1,3,0,1,0,64.49
臺北市,士林區,新安里,112,1,1095,10,1105,1734,3,1,3,0,1,0,63.73
臺北市,士林區,陽明里,113,1,588,8,596,929,3,1,3,0,1,0,64.16
臺北市,士林區,陽明里,114,1,548,4,552,973,3,1,3,0,1,0,56.73
臺北市,士林區,陽明里,115,1,502,7,509,821,3,1,3,0,1,0,62.00
臺北市,士林區,菁山里,116,1,861,12,873,1348,3,1,3,0,1,0,64.76
臺北市,士林區,平等里,117,1,856,8,864,1196,3,1,3,0,1,0,72.24
臺北市,士林區,溪山里,118,1,815,15,830,1221,3,1,3,0,1,0,67.98
臺北市,士林區,翠山里,119,1,894,10,904,1292,3,1,3,0,1,0,69.97
臺北市,士林區,翠山里,120,1,793,3,796,1249,3,1,3,0,1,0,63.73
臺北市,士林區,翠山里,121,1,627,6,633,1021,3,1,3,0,1,0,62.00
臺北市,士林區,翠山里,122,1,832,15,847,1337,3,1,3,0,1,0,63.35
臺北市,士林區,三玉里,123,1,879,7,886,1365,3,1,3,0,1,0,64.91
臺北市,士林區,三玉里,124,1,975,11,986,1514,3,1,3,0,1,0,65.13
臺北市,士林區,三玉里,125,1,917,6,923,1476,3,1,3,0,1,0,62.53
臺北市,士林區,天福里,126,1,1105,10,1115,1640,3,1,3,0,1,0,67.99
臺北市,士林區,天福里,127,1,1113,9,1122,1705,3,1,3,0,1,0,65.81
臺北市,士林區,天福里,128,1,988,5,993,1521,3,1,3,0,1,0,65.29
臺北市,士林區,天祿里,129,1,786,8,794,1229,3,1,3,0,1,0,64.61
臺北市,士林區,天祿里,130,1,929,7,936,1403,3,1,3,0,1,0,66.71
臺北市,士林區,天祿里,131,1,946,5,951,1468,3,1,3,0,1,0,64.78
臺北市,士林區,天壽里,132,1,1148,15,1163,1753,3,1,3,0,1,0,66.34
臺北市,士林區,天壽里,133,1,1203,3,1206,1849,3,1,3,0,1,0,65.22
臺北市,士林區,天和里,134,1,1276,14,1290,2023,3,1,3,0,1,0,63.77
臺北市,士林區,天和里,135,1,1232,12,1244,1931,3,1,3,0,1,0,64.42
臺北市,士林區,天和里,136,1,1097,4,1101,1854,3,1,3,0,1,0,59.39
臺北市,士林區,天山里,137,1,1129,8,1137,1825,3,1,3,0,1,0,62.30
臺北市,士林區,天山里,138,1,1076,9,1085,1721,3,1,3,0,1,0,63.04
臺北市,士林區,天山里,139,1,1135,10,1145,1920,3,1,3,0,1,0,59.64
臺北市,士林區,天玉里,140,1,928,6,934,1527,3,1,3,0,1,0,61.17
臺北市,士林區,天玉里,141,1,1089,6,1095,1759,3,1,3,0,1,0,62.25
臺北市,士林區,天玉里,142,1,1059,11,1070,1704,3,1,3,0,1,0,62.79
臺北市,士林區,天玉里,143,1,968,8,976,1534,3,1,3,0,1,0,63.62
臺北市,士林區,天母里,144,1,1100,5,1105,1655,3,1,3,0,1,0,66.77
臺北市,士林區,天母里,145,1,1096,6,1102,1675,3,1,3,0,1,0,65.79
臺北市,士林區,天母里,146,1,1128,6,1134,1730,3,1,3,0,1,0,65.55
臺北市,士林區,岩山里,147,1,1077,7,1084,1759,3,1,3,0,1,0,61.63
臺北市,士林區,岩山里,148,1,1132,12,1144,1814,3,1,3,0,1,0,63.07
臺北市,士林區,名山里,149,1,1098,12,1110,1616,3,1,3,0,1,0,68.69
臺北市,士林區,名山里,150,1,1108,16,1124,1790,3,1,3,0,1,0,62.79
臺北市,士林區,名山里,151,1,1057,12,1069,1662,3,1,3,0,1,0,64.32
臺北市,士林區,聖山里,152,1,871,9,880,1394,3,1,3,0,1,0,63.13
臺北市,士林區,聖山里,153,1,925,4,929,1419,3,1,3,0,1,0,65.47
臺北市,士林區,聖山里,154,1,944,6,950,1285,3,1,3,0,1,0,73.93
臺北市,士林區,芝山里,155,1,1205,12,1217,1937,3,1,3,0,1,0,62.83
臺北市,士林區,芝山里,156,1,1162,14,1176,1779,3,1,3,0,1,0,66.10
臺北市,士林區,芝山里,157,1,1116,9,1125,1789,3,1,3,0,1,0,62.88
臺北市,士林區,東山里,158,1,1357,9,1366,1977,3,1,3,0,1,0,69.09
臺北市,士林區,東山里,159,1,1279,12,1291,1905,3,1,3,0,1,0,67.77
臺北市,士林區,德行里,160,1,1016,13,1029,1530,3,1,3,0,1,0,67.25
臺北市,士林區,德行里,161,1,1079,16,1095,1777,3,1,3,0,1,0,61.62
臺北市,士林區,德華里,162,1,1040,7,1047,1561,3,1,3,0,1,0,67.07
臺北市,士林區,德華里,163,1,882,7,889,1474,3,1,3,0,1,0,60.31
臺北市,士林區,德華里,164,1,860,10,870,1452,3,1,3,0,1,0,59.92
臺北市,士林區,忠誠里,165,1,1059,5,1064,1548,3,1,3,0,1,0,68.73
臺北市,士林區,忠誠里,166,1,950,5,955,1417,3,1,3,0,1,0,67.40
臺北市,士林區,忠誠里,167,1,981,11,992,1536,3,1,3,0,1,0,64.58
臺北市,士林區,蘭雅里,168,1,1138,6,1144,1780,3,1,3,0,1,0,64.27
臺北市,士林區,蘭雅里,169,1,1029,10,1039,1743,3,1,3,0,1,0,59.61
臺北市,士林區,蘭雅里,170,1,1006,8,1014,1569,3,1,3,0,1,0,64.63
臺北市,士林區,蘭雅里,171,1,951,8,959,1515,3,1,3,0,1,0,63.30
臺北市,士林區,蘭興里,172,1,1040,12,1052,1612,3,1,3,0,1,0,65.26
臺北市,士林區,蘭興里,173,1,1081,11,1092,1601,3,1,3,0,1,0,68.21
臺北市,士林區,蘭興里,174,1,1000,4,1004,1549,3,1,3,0,1,0,64.82
臺北市,士林區,仁勇里,175,1,1214,11,1225,1854,3,1,3,0,1,0,66.07
臺北市,士林區,仁勇里,176,1,1214,18,1232,1815,3,1,3,0,1,0,67.88
臺北市,士林區,義信里,177,1,752,7,759,1240,3,1,3,0,1,0,61.21
臺北市,士林區,義信里,178,1,655,10,665,1086,3,1,3,0,1,0,61.23
臺北市,士林區,福林里,179,1,688,9,697,1070,3,1,3,0,1,0,65.14
臺北市,士林區,福林里,180,1,367,2,369,588,3,1,3,0,1,0,62.76
臺北市,士林區,福林里,181,1,1001,9,1010,1500,3,1,3,0,1,0,67.33
臺北市,士林區,福德里,182,1,834,9,843,1353,3,1,3,0,1,0,62.31
臺北市,士林區,福德里,183,1,844,10,854,1289,3,1,3,0,1,0,66.25
臺北市,士林區,福德里,184,1,652,2,654,1356,3,1,3,0,1,0,48.23
臺北市,士林區,福志里,185,1,1147,16,1163,1783,3,1,3,0,1,0,65.23
臺北市,士林區,福志里,186,1,1293,7,1300,1938,3,1,3,0,1,0,67.08
臺北市,士林區,福志里,187,1,1172,7,1179,1806,3,1,3,0,1,0,65.28
臺北市,士林區,舊佳里,188,1,1172,11,1183,1732,3,1,3,0,1,0,68.30
臺北市,士林區,舊佳里,189,1,1138,19,1157,1701,3,1,3,0,1,0,68.02
臺北市,士林區,舊佳里,190,1,1169,11,1180,1912,3,1,3,0,1,0,61.72
臺北市,士林區,福佳里,191,1,1236,17,1253,1965,3,1,3,0,1,0,63.77
臺北市,士林區,福佳里,192,1,1230,7,1237,1862,3,1,3,0,1,0,66.43
臺北市,士林區,福佳里,193,1,1315,26,1341,1986,3,1,3,0,1,0,67.52
臺北市,士林區,後港里,194,1,1046,19,1065,1639,3,1,3,0,1,0,64.98
臺北市,士林區,後港里,195,1,1003,10,1013,1614,3,1,3,0,1,0,62.76
臺北市,士林區,後港里,196,1,982,10,992,1606,3,1,3,0,1,0,61.77
臺北市,士林區,後港里,197,1,845,10,855,1402,3,1,3,0,1,0,60.98
臺北市,士林區,福中里,198,1,834,12,846,1368,3,1,3,0,1,0,61.84
臺北市,士林區,福中里,199,1,915,4,919,1422,3,1,3,0,1,0,64.63
臺北市,士林區,福中里,200,1,984,15,999,1499,3,1,3,0,1,0,66.64
臺北市,士林區,前港里,201,1,1084,11,1095,1742,3,1,3,0,1,0,62.86
臺北市,士林區,前港里,202,1,1111,10,1121,1729,3,1,3,0,1,0,64.84
臺北市,士林區,百齡里,203,1,1141,16,1157,1804,3,1,3,0,1,0,64.14
臺北市,士林區,百齡里,204,1,1192,12,1204,1844,3,1,3,0,1,0,65.29
臺北市,士林區,百齡里,205,1,1261,9,1270,1995,3,1,3,0,1,0,63.66
臺北市,士林區,承德里,206,1,805,7,812,1337,3,1,3,0,1,0,60.73
臺北市,士林區,承德里,207,1,889,8,897,1384,3,1,3,0,1,0,64.81
臺北市,士林區,承德里,208,1,962,8,970,1554,3,1,3,0,1,0,62.42
臺北市,士林區,福華里,209,1,1094,10,1104,1914,3,1,3,0,1,0,57.68
臺北市,士林區,福華里,210,1,1156,13,1169,1895,3,1,3,0,1,0,61.69
臺北市,士林區,福華里,211,1,1067,15,1082,1686,3,1,3,0,1,0,64.18
臺北市,士林區,明勝里,212,1,981,13,994,1552,3,1,3,0,1,0,64.05
臺北市,士林區,明勝里,213,1,696,11,707,1192,3,1,3,0,1,0,59.31
臺北市,士林區,明勝里,214,1,782,8,790,1313,3,1,3,0,1,0,60.17
臺北市,士林區,福順里,215,1,866,13,879,1461,3,1,3,0,1,0,60.16
臺北市,士林區,福順里,216,1,906,10,916,1484,3,1,3,0,1,0,61.73
臺北市,士林區,福順里,217,1,861,5,866,1464,3,1,3,0,1,0,59.15
臺北市,士林區,富光里,218,1,936,19,955,1563,3,1,3,0,1,0,61.10
臺北市,士林區,富光里,219,1,958,11,969,1525,3,1,3,0,1,0,63.54
臺北市,士林區,富光里,220,1,1045,8,1053,1645,3,1,3,0,1,0,64.01
臺北市,士林區,葫蘆里,221,1,1333,11,1344,1984,3,1,3,0,1,0,67.74
臺北市,士林區,葫蘆里,222,1,1293,16,1309,2048,3,1,3,0,1,0,63.92
臺北市,士林區,葫蘆里,223,1,1172,10,1182,1715,3,1,3,0,1,0,68.92
臺北市,士林區,葫東里,224,1,995,5,1000,1635,3,1,3,0,1,0,61.16
臺北市,士林區,葫東里,225,1,950,9,959,1440,3,1,3,0,1,0,66.60
臺北市,士林區,社子里,226,1,971,8,979,1576,3,1,3,0,1,0,62.12
臺北市,士林區,社子里,227,1,1055,9,1064,1693,3,1,3,0,1,0,62.85
臺北市,士林區,社子里,228,1,1065,15,1080,1690,3,1,3,0,1,0,63.91
臺北市,士林區,社新里,229,1,1111,16,1127,1730,3,1,3,0,1,0,65.14
臺北市,士林區,社新里,230,1,1049,14,1063,1634,3,1,3,0,1,0,65.06
臺北市,士林區,社新里,231,1,947,12,959,1532,3,1,3,0,1,0,62.60
臺北市,士林區,社新里,232,1,985,11,996,1582,3,1,3,0,1,0,62.96
臺北市,士林區,社園里,233,1,1193,29,1222,1759,3,1,3,0,1,0,69.47
臺北市,士林區,社園里,234,1,1261,25,1286,1892,3,1,3,0,1,0,67.97
臺北市,士林區,社園里,235,1,1124,15,1139,1833,3,1,3,0,1,0,62.14
臺北市,士林區,永倫里,236,1,1285,13,1298,2004,3,1,3,0,1,0,64.77
臺北市,士林區,永倫里,237,1,1208,9,1217,1802,3,1,3,0,1,0,67.54
臺北市,士林區,永倫里,238,1,1261,12,1273,1933,3,1,3,0,1,0,65.86
臺北市,士林區,福安里,239,1,1226,15,1241,1890,3,1,3,0,1,0,65.66
臺北市,士林區,福安里,240,1,1361,12,1373,2066,3,1,3,0,1,0,66.46
臺北市,士林區,富洲里,241,1,864,3,867,1295,3,1,3,0,1,0,66.95
臺北市,士林區,富洲里,242,1,934,5,939,1429,3,1,3,0,1,0,65.71
臺北市,士林區,富洲里,243,1,1118,13,1131,1643,3,1,3,0,1,0,68.84
臺北市,內湖區,西湖里,244,1,928,10,938,1460,3,1,3,0,1,0,64.25
臺北市,內湖區,西湖里,245,1,960,12,972,1479,3,1,3,0,1,0,65.72
臺北市,內湖區,西湖里,246,1,981,8,989,1487,3,1,3,0,1,0,66.51
臺北市,內湖區,西湖里,247,1,971,9,980,1565,3,1,3,0,1,0,62.62
臺北市,內湖區,西康里,248,1,952,14,966,1452,3,1,3,0,1,0,66.53
臺北市,內湖區,西康里,249,1,869,7,876,1375,3,1,3,0,1,0,63.71
臺北市,內湖區,西康里,250,1,765,12,777,1255,3,1,3,0,1,0,61.91
臺北市,內湖區,西康里,251,1,1282,11,1293,1806,3,1,3,0,1,0,71.59
臺北市,內湖區,西安里,252,1,1066,4,1070,1653,3,1,3,0,1,0,64.73
臺北市,內湖區,西安里,253,1,975,10,985,1553,3,1,3,0,1,0,63.43
臺北市,內湖區,西安里,254,1,1000,7,1007,1593,3,1,3,0,1,0,63.21
臺北市,內湖區,港墘里,255,1,979,6,985,1463,3,1,3,0,1,0,67.33
臺北市,內湖區,港墘里,256,1,955,11,966,1450,3,1,3,0,1,0,66.62
臺北市,內湖區,港墘里,257,1,855,6,861,1296,3,1,3,0,1,0,66.44
臺北市,內湖區,港都里,258,1,1090,9,1099,1671,3,1,3,0,1,0,65.77
臺北市,內湖區,港都里,259,1,1046,9,1055,1619,3,1,3,0,1,0,65.16
臺北市,內湖區,港都里,260,1,1055,9,1064,1648,3,1,3,0,1,0,64.56
臺北市,內湖區,港都里,261,1,1043,13,1056,1647,3,1,3,0,1,0,64.12
臺北市,內湖區,港都里,262,1,948,4,952,1446,3,1,3,0,1,0,65.84
臺北市,內湖區,港富里,263,1,1164,10,1174,1786,3,1,3,0,1,0,65.73
臺北市,內湖區,港富里,264,1,1001,13,1014,1630,3,1,3,0,1,0,62.21
臺北市,內湖區,港富里,265,1,1214,12,1226,1862,3,1,3,0,1,0,65.84
臺北市,內湖區,港富里,266,1,1104,3,1107,1706,3,1,3,0,1,0,64.89
臺北市,內湖區,港華里,267,1,953,13,966,1451,3,1,3,0,1,0,66.57
臺北市,內湖區,港華里,268,1,960,9,969,1470,3,1,3,0,1,0,65.92
臺北市,內湖區,港華里,269,1,1087,9,1096,1561,3,1,3,0,1,0,70.21
臺北市,內湖區,港華里,270,1,970,15,985,1531,3,1,3,0,1,0,64.34
臺北市,內湖區,內湖里,271,1,920,4,924,1376,3,1,3,0,1,0,67.15
臺北市,內湖區,內湖里,272,1,893,9,902,1444,3,1,3,0,1,0,62.47
臺北市,內湖區,內湖里,273,1,841,9,850,1362,3,1,3,0,1,0,62.41
臺北市,內湖區,湖濱里,274,1,974,6,980,1525,3,1,3,0,1,0,64.26
臺北市,內湖區,湖濱里,275,1,954,11,965,1361,3,1,3,0,1,0,70.90
臺北市,內湖區,湖濱里,276,1,697,7,704,1092,3,1,3,0,1,0,64.47
臺北市,內湖區,湖濱里,277,1,1027,8,1035,1589,3,1,3,0,1,0,65.14
臺北市,內湖區,紫星里,278,1,1063,13,1076,1604,3,1,3,0,1,0,67.08
臺北市,內湖區,紫星里,279,1,958,7,965,1522,3,1,3,0,1,0,63.40
臺北市,內湖區,紫星里,280,1,949,7,956,1449,3,1,3,0,1,0,65.98
臺北市,內湖區,紫星里,281,1,1043,8,1051,1613,3,1,3,0,1,0,65.16
臺北市,內湖區,大湖里,282,1,1064,5,1069,1727,3,1,3,0,1,0,61.90
臺北市,內湖區,大湖里,283,1,1052,12,1064,1718,3,1,3,0,1,0,61.93
臺北市,內湖區,大湖里,284,1,1123,9,1132,1739,3,1,3,0,1,0,65.09
臺北市,內湖區,大湖里,285,1,986,9,995,1623,3,1,3,0,1,0,61.31
臺北市,內湖區,大湖里,286,1,1038,6,1044,1634,3,1,3,0,1,0,63.89
臺北市,內湖區,金龍里,287,1,925,5,930,1434,3,1,3,0,1,0,64.85
臺北市,內湖區,金龍里,288,1,952,9,961,1512,3,1,3,0,1,0,63.56
臺北市,內湖區,金龍里,289,1,948,10,958,1451,3,1,3,0,1,0,66.02
臺北市,內湖區,金瑞里,290,1,1067,10,1077,1606,3,1,3,0,1,0,67.06
臺北市,內湖區,金瑞里,291,1,1008,6,1014,1529,3,1,3,0,1,0,66.32
臺北市,內湖區,金瑞里,292,1,1070,16,1086,1628,3,1,3,0,1,0,66.71
臺北市,內湖區,碧山里,293,1,263,2,265,402,3,1,3,0,1,0,65.92
臺北市,內湖區,碧山里,294,1,1104,23,1127,1744,3,1,3,0,1,0,64.62
臺北市,內湖區,碧山里,295,1,1026,10,1036,1550,3,1,3,0,1,0,66.84
臺北市,內湖區,碧山里,296,1,899,12,911,1451,3,1,3,0,1,0,62.78
臺北市,內湖區,紫雲里,297,1,991,14,1005,1516,3,1,3,0,1,0,66.29
臺北市,內湖區,紫雲里,298,1,898,9,907,1394,3,1,3,0,1,0,65.06
臺北市,內湖區,紫雲里,299,1,1024,17,1041,1462,3,1,3,0,1,0,71.20
臺北市,內湖區,清白里,300,1,976,11,987,1556,3,1,3,0,1,0,63.43
臺北市,內湖區,清白里,301,1,1009,7,1016,1627,3,1,3,0,1,0,62.45
臺北市,內湖區,清白里,302,1,903,5,908,1533,3,1,3,0,1,0,59.23
臺北市,內湖區,葫洲里,303,1,1206,9,1215,1908,3,1,3,0,1,0,63.68
臺北市,內湖區,葫洲里,304,1,1222,7,1229,1949,3,1,3,0,1,0,63.06
臺北市,內湖區,葫洲里,305,1,1195,10,1205,1824,3,1,3,0,1,0,66.06
臺北市,內湖區,葫洲里,306,1,1185,10,1195,1849,3,1,3,0,1,0,64.63
臺北市,內湖區,葫洲里,307,1,1163,4,1167,1861,3,1,3,0,1,0,62.71
臺北市,內湖區,葫洲里,308,1,1156,8,1164,1820,3,1,3,0,1,0,63.96
臺北市,內湖區,葫洲里,309,1,1160,14,1174,1797,3,1,3,0,1,0,65.33
臺北市,內湖區,葫洲里,310,1,1061,6,1067,1750,3,1,3,0,1,0,60.97
臺北市,內湖區,葫洲里,311,1,1160,15,1175,1890,3,1,3,0,1,0,62.17
臺北市,內湖區,葫洲里,312,1,1176,11,1187,1794,3,1,3,0,1,0,66.16
臺北市,內湖區,葫洲里,313,1,392,8,400,696,3,1,3,0,1,0,57.47
臺北市,內湖區,紫陽里,314,1,1068,9,1077,1716,3,1,3,0,1,0,62.76
臺北市,內湖區,紫陽里,315,1,1206,10,1216,1825,3,1,3,0,1,0,66.63
臺北市,內湖區,紫陽里,316,1,1155,5,1160,1797,3,1,3,0,1,0,64.55
臺北市,內湖區,瑞陽里,317,1,1199,12,1211,1773,3,1,3,0,1,0,68.30
臺北市,內湖區,瑞陽里,318,1,1065,7,1072,1584,3,1,3,0,1,0,67.68
臺北市,內湖區,瑞陽里,319,1,1018,10,1028,1451,3,1,3,0,1,0,70.85
臺北市,內湖區,瑞陽里,320,1,1078,9,1087,1480,3,1,3,0,1,0,73.45
臺北市,內湖區,瑞光里,321,1,1204,7,1211,1852,3,1,3,0,1,0,65.39
臺北市,內湖區,瑞光里,322,1,1273,7,1280,1803,3,1,3,0,1,0,70.99
臺北市,內湖區,五分里,323,1,1011,10,1021,1688,3,1,3,0,1,0,60.49
臺北市,內湖區,五分里,324,1,975,7,982,1617,3,1,3,0,1,0,60.73
臺北市,內湖區,五分里,325,1,954,16,970,1654,3,1,3,0,1,0,58.65
臺北市,內湖區,五分里,326,1,993,18,1011,1659,3,1,3,0,1,0,60.94
臺北市,內湖區,東湖里,327,1,1112,12,1124,1796,3,1,3,0,1,0,62.58
臺北市,內湖區,東湖里,328,1,1114,11,1125,1725,3,1,3,0,1,0,65.22
臺北市,內湖區,東湖里,329,1,1123,15,1138,1792,3,1,3,0,1,0,63.50
臺北市,內湖區,東湖里,330,1,958,14,972,1631,3,1,3,0,1,0,59.60
臺北市,內湖區,東湖里,331,1,1161,12,1173,1868,3,1,3,0,1,0,62.79
臺北市,內湖區,東湖里,332,1,1063,17,1080,1732,3,1,3,0,1,0,62.36
臺北市,內湖區,樂康里,333,1,1101,13,1114,1816,3,1,3,0,1,0,61.34
臺北市,內湖區,樂康里,334,1,1113,10,1123,1830,3,1,3,0,1,0,61.37
臺北市,內湖區,樂康里,335,1,1065,14,1079,1768,3,1,3,0,1,0,61.03
臺北市,內湖區,內溝里,336,1,502,7,509,767,3,1,3,0,1,0,66.36
臺北市,內湖區,內溝里,337,1,773,4,777,1241,3,1,3,0,1,0,62.61
臺北市,內湖區,內溝里,338,1,649,7,656,1044,3,1,3,0,1,0,62.84
臺北市,內湖區,內溝里,339,1,1010,15,1025,1641,3,1,3,0,1,0,62.46
臺北市,內湖區,內溝里,340,1,1138,14,1152,1788,3,1,3,0,1,0,64.43
臺北市,內湖區,週美里,341,1,854,5,859,1314,3,1,3,0,1,0,65.37
臺北市,內湖區,週美里,342,1,741,8,749,1192,3,1,3,0,1,0,62.84
臺北市,內湖區,週美里,343,1,756,16,772,1150,3,1,3,0,1,0,67.13
臺北市,內湖區,行善里,344,1,802,15,817,1206,3,1,3,0,1,0,67.74
臺北市,內湖區,行善里,345,1,710,13,723,1049,3,1,3,0,1,0,68.92
臺北市,內湖區,行善里,346,1,800,7,807,1276,3,1,3,0,1,0,63.24
臺北市,內湖區,行善里,347,1,800,6,806,1306,3,1,3,0,1,0,61.72
臺北市,內湖區,石潭里,348,1,647,7,654,1016,3,1,3,0,1,0,64.37
臺北市,內湖區,石潭里,349,1,620,9,629,1020,3,1,3,0,1,0,61.67
臺北市,內湖區,湖興里,350,1,885,5,890,1395,3,1,3,0,1,0,63.80
臺北市,內湖區,湖興里,351,1,865,13,878,1645,3,1,3,0,1,0,53.37
臺北市,內湖區,湖興里,352,1,1019,10,1029,1709,3,1,3,0,1,0,60.21
臺北市,內湖區,湖興里,353,1,986,11,997,1569,3,1,3,0,1,0,63.54
臺北市,內湖區,湖元里,354,1,1195,11,1206,1850,3,1,3,0,1,0,65.19
臺北市,內湖區,湖元里,355,1,1150,7,1157,1829,3,1,3,0,1,0,63.26
臺北市,南港區,百福里,356,1,1350,17,1367,2104,3,1,3,0,1,0,64.97
臺北市,南港區,百福里,357,1,1236,18,1254,1900,3,1,3,0,1,0,66.00
臺北市,南港區,鴻福里,358,1,1188,19,1207,1883,3,1,3,0,1,0,64.10
臺北市,南港區,鴻福里,359,1,1214,19,1233,1882,3,1,3,0,1,0,65.52
臺北市,南港區,成福里,360,1,880,14,894,1355,3,1,3,0,1,0,65.98
臺北市,南港區,成福里,361,1,1014,11,1025,1542,3,1,3,0,1,0,66.47
臺北市,南港區,成福里,362,1,832,14,846,1350,3,1,3,0,1,0,62.67
臺北市,南港區,成福里,363,1,1082,15,1097,1667,3,1,3,0,1,0,65.81
臺北市,南港區,成福里,364,1,1319,21,1340,2170,3,1,3,0,1,0,61.75
臺北市,南港區,成福里,365,1,1120,16,1136,1805,3,1,3,0,1,0,62.94
臺北市,南港區,萬福里,366,1,1232,11,1243,1749,3,1,3,0,1,0,71.07
臺北市,南港區,萬福里,367,1,1056,11,1067,1588,3,1,3,0,1,0,67.19
臺北市,南港區,聯成里,368,1,1014,10,1024,1459,3,1,3,0,1,0,70.19
臺北市,南港區,聯成里,369,1,934,8,942,1411,3,1,3,0,1,0,66.76
臺北市,南港區,聯成里,370,1,867,7,874,1344,3,1,3,0,1,0,65.03
臺北市,南港區,新光里,371,1,1145,12,1157,1669,3,1,3,0,1,0,69.32
臺北市,南港區,新光里,372,1,1079,5,1084,1671,3,1,3,0,1,0,64.87
臺北市,南港區,合成里,373,1,953,10,963,1494,3,1,3,0,1,0,64.46
臺北市,南港區,合成里,374,1,873,14,887,1369,3,1,3,0,1,0,64.79
臺北市,南港區,合成里,375,1,731,7,738,1076,3,1,3,0,1,0,68.59
臺北市,南港區,合成里,376,1,727,16,743,1083,3,1,3,0,1,0,68.61
臺北市,南港區,玉成里,377,1,1146,9,1155,1911,3,1,3,0,1,0,60.44
臺北市,南港區,玉成里,378,1,1190,15,1205,1757,3,1,3,0,1,0,68.58
臺北市,南港區,西新里,379,1,1016,16,1032,1741,3,1,3,0,1,0,59.28
臺北市,南港區,西新里,380,1,1150,9,1159,1783,3,1,3,0,1,0,65.00
臺北市,南港區,東新里,381,1,1034,15,1049,1746,3,1,3,0,1,0,60.08
臺北市,南港區,東新里,382,1,919,16,935,1580,3,1,3,0,1,0,59.18
臺北市,南港區,東新里,383,1,1270,13,1283,1955,3,1,3,0,1,0,65.63
臺北市,南港區,東明里,384,1,1225,10,1235,1951,3,1,3,0,1,0,63.30
臺北市,南港區,東明里,385,1,973,17,990,1609,3,1,3,0,1,0,61.53
臺北市,南港區,南港里,386,1,944,13,957,1580,3,1,3,0,1,0,60.57
臺北市,南港區,南港里,387,1,903,10,913,1387,3,1,3,0,1,0,65.83
臺北市,南港區,南港里,388,1,910,10,920,1523,3,1,3,0,1,0,60.41
臺北市,南港區,三重里,389,1,669,9,678,1054,3,1,3,0,1,0,64.33
臺北市,南港區,三重里,390,1,911,12,923,1530,3,1,3,0,1,0,60.33
臺北市,南港區,中南里,391,1,948,19,967,1664,3,1,3,0,1,0,58.11
臺北市,南港區,中南里,392,1,996,24,1020,1591,3,1,3,0,1,0,64.11
臺北市,南港區,新富里,393,1,1110,10,1120,1742,3,1,3,0,1,0,64.29
臺北市,南港區,新富里,394,1,921,17,938,1458,3,1,3,0,1,0,64.33
臺北市,南港區,中研里,395,1,867,10,877,1343,3,1,3,0,1,0,65.30
臺北市,南港區,中研里,396,1,1053,3,1056,1583,3,1,3,0,1,0,66.71
臺北市,南港區,中研里,397,1,965,1,966,1442,3,1,3,0,1,0,66.99
臺北市,南港區,中研里,398,1,1028,12,1040,1507,3,1,3,0,1,0,69.01
臺北市,南港區,中研里,399,1,853,7,860,1302,3,1,3,0,1,0,66.05
臺北市,南港區,舊莊里,400,1,709,6,715,1090,3,1,3,0,1,0,65.60
臺北市,南港區,舊莊里,401,1,736,10,746,1250,3,1,3,0,1,0,59.68
臺北市,南港區,舊莊里,402,1,782,8,790,1277,3,1,3,0,1,0,61.86
臺北市,南港區,舊莊里,403,1,854,8,862,1375,3,1,3,0,1,0,62.69
臺北市,南港區,舊莊里,404,1,792,15,807,1418,3,1,3,0,1,0,56.91
臺北市,南港區,九如里,405,1,948,16,964,1440,3,1,3,0,1,0,66.94
臺北市,南港區,九如里,406,1,959,6,965,1431,3,1,3,0,1,0,67.44
臺北市,南港區,九如里,407,1,964,19,983,1575,3,1,3,0,1,0,62.41
臺北市,松山區,莊敬里,408,1,952,9,961,1512,3,1,3,0,1,0,63.56
臺北市,松山區,莊敬里,409,1,1084,7,1091,1602,3,1,3,0,1,0,68.10
臺北市,松山區,莊敬里,410,1,1003,7,1010,1591,3,1,3,0,1,0,63.48
臺北市,松山區,東榮里,411,1,1116,5,1121,1683,3,1,3,0,1,0,66.61
臺北市,松山區,東榮里,412,1,1016,13,1029,1687,3,1,3,0,1,0,61.00
臺北市,松山區,東榮里,413,1,1073,10,1083,1625,3,1,3,0,1,0,66.65
臺北市,松山區,東榮里,414,1,1143,6,1149,1794,3,1,3,0,1,0,64.05
臺北市,松山區,三民里,415,1,1203,9,1212,1842,3,1,3,0,1,0,65.80
臺北市,松山區,三民里,416,1,1160,9,1169,1956,3,1,3,0,1,0,59.76
臺北市,松山區,三民里,417,1,1200,8,1208,1843,3,1,3,0,1,0,65.55
臺北市,松山區,新益里,418,1,1253,9,1262,1902,3,1,3,0,1,0,66.35
臺北市,松山區,新益里,419,1,1096,10,1106,1773,3,1,3,0,1,0,62.38
臺北市,松山區,富錦里,420,1,914,6,920,1502,3,1,3,0,1,0,61.25
臺北市,松山區,富錦里,421,1,703,7,710,1059,3,1,3,0,1,0,67.04
臺北市,松山區,富錦里,422,1,1116,12,1128,1669,3,1,3,0,1,0,67.59
臺北市,松山區,新東里,423,1,1314,10,1324,2025,3,1,3,0,1,0,65.38
臺北市,松山區,新東里,424,1,1262,13,1275,2065,3,1,3,0,1,0,61.74
臺北市,松山區,富泰里,425,1,1094,4,1098,1768,3,1,3,0,1,0,62.10
臺北市,松山區,富泰里,426,1,1244,5,1249,1979,3,1,3,0,1,0,63.11
臺北市,松山區,介壽里,427,1,1118,9,1127,1749,3,1,3,0,1,0,64.44
臺北市,松山區,介壽里,428,1,1181,11,1192,1888,3,1,3,0,1,0,63.14
臺北市,松山區,精忠里,429,1,1153,8,1161,1772,3,1,3,0,1,0,65.52
臺北市,松山區,精忠里,430,1,1088,6,1094,1789,3,1,3,0,1,0,61.15
臺北市,松山區,東光里,431,1,1243,10,1253,2030,3,1,3,0,1,0,61.72
臺北市,松山區,東光里,432,1,1256,10,1266,2024,3,1,3,0,1,0,62.55
臺北市,松山區,東光里,433,1,1310,8,1318,2005,3,1,3,0,1,0,65.74
臺北市,松山區,龍田里,434,1,649,3,652,1026,3,1,3,0,1,0,63.55
臺北市,松山區,龍田里,435,1,1050,9,1059,1574,3,1,3,0,1,0,67.28
臺北市,松山區,龍田里,436,1,1426,11,1437,2095,3,1,3,0,1,0,68.59
臺北市,松山區,東昌里,437,1,1174,13,1187,1854,3,1,3,0,1,0,64.02
臺北市,松山區,東昌里,438,1,1194,4,1198,1865,3,1,3,0,1,0,64.24
臺北市,松山區,東勢里,439,1,867,9,876,1340,3,1,3,0,1,0,65.37
臺北市,松山區,東勢里,440,1,776,4,780,1202,3,1,3,0,1,0,64.89
臺北市,松山區,中華里,441,1,1360,2,1362,2007,3,1,3,0,1,0,67.86
臺北市,松山區,中華里,442,1,1219,8,1227,1886,3,1,3,0,1,0,65.06
臺北市,松山區,民有里,443,1,1037,5,1042,1653,3,1,3,0,1,0,63.04
臺北市,松山區,民有里,444,1,1127,11,1138,1822,3,1,3,0,1,0,62.46
臺北市,松山區,民有里,445,1,1104,6,1110,1777,3,1,3,0,1,0,62.46
臺北市,松山區,民有里,446,1,1051,3,1054,1757,3,1,3,0,1,0,59.99
臺北市,松山區,民福里,447,1,1208,7,1215,1809,3,1,3,0,1,0,67.16
臺北市,松山區,民福里,448,1,1255,15,1270,1883,3,1,3,0,1,0,67.45
臺北市,松山區,民福里,449,1,1014,5,1019,1618,3,1,3,0,1,0,62.98
臺北市,松山區,松基里,450,1,976,9,985,1564,3,1,3,0,1,0,62.98
臺北市,松山區,松基里,451,1,905,7,912,1477,3,1,3,0,1,0,61.75
臺北市,松山區,慈祐里,452,1,1272,10,1282,1996,3,1,3,0,1,0,64.23
臺北市,松山區,慈祐里,453,1,1012,10,1022,1973,3,1,3,0,1,0,51.80
臺北市,松山區,慈祐里,454,1,679,7,686,1118,3,1,3,0,1,0,61.36
臺北市,松山區,安平里,455,1,1149,13,1162,1742,3,1,3,0,1,0,66.70
臺北市,松山區,安平里,456,1,1113,4,1117,1637,3,1,3,0,1,0,68.23
臺北市,松山區,安平里,457,1,1171,15,1186,1811,3,1,3,0,1,0,65.49
臺北市,松山區,安平里,458,1,1096,11,1107,1686,3,1,3,0,1,0,65.66
臺北市,松山區,鵬程里,459,1,1710,9,1719,2611,3,1,3,0,1,0,65.84
臺北市,松山區,鵬程里,460,1,1328,11,1339,1995,3,1,3,0,1,0,67.12
臺北市,松山區,自強里,461,1,1147,11,1158,1805,3,1,3,0,1,0,64.16
臺北市,松山區,自強里,462,1,1402,17,1419,2019,3,1,3,0,1,0,70.28
臺北市,松山區,自強里,463,1,1234,9,1243,1808,3,1,3,0,1,0,68.75
臺北市,松山區,吉祥里,464,1,1295,11,1306,2164,3,1,3,0,1,0,60.35
臺北市,松山區,吉祥里,465,1,1379,9,1388,2191,3,1,3,0,1,0,63.35
臺北市,松山區,吉祥里,466,1,1236,14,1250,1950,3,1,3,0,1,0,64.10
臺北市,松山區,新聚里,467,1,1212,14,1226,1982,3,1,3,0,1,0,61.86
臺北市,松山區,新聚里,468,1,1213,29,1242,1956,3,1,3,0,1,0,63.50
臺北市,松山區,新聚里,469,1,1185,6,1191,1863,3,1,3,0,1,0,63.93
臺北市,松山區,復盛里,470,1,1323,10,1333,2031,3,1,3,0,1,0,65.63
臺北市,松山區,復盛里,471,1,1162,14,1176,1860,3,1,3,0,1,0,63.23
臺北市,松山區,復盛里,472,1,763,4,767,1198,3,1,3,0,1,0,64.02
臺北市,松山區,中正里,473,1,1233,11,1244,1988,3,1,3,0,1,0,62.58
臺北市,松山區,中正里,474,1,1184,13,1197,2005,3,1,3,0,1,0,59.70
臺北市,松山區,中正里,475,1,1258,7,1265,2166,3,1,3,0,1,0,58.40
臺北市,松山區,中崙里,476,1,970,3,973,1626,3,1,3,0,1,0,59.84
臺北市,松山區,中崙里,477,1,941,5,946,1461,3,1,3,0,1,0,64.75
臺北市,松山區,美仁里,478,1,880,2,882,1397,3,1,3,0,1,0,63.14
臺北市,松山區,美仁里,479,1,771,4,775,1186,3,1,3,0,1,0,65.35
臺北市,松山區,吉仁里,480,1,946,7,953,1529,3,1,3,0,1,0,62.33
臺北市,松山區,吉仁里,481,1,984,5,989,1512,3,1,3,0,1,0,65.41
臺北市,松山區,敦化里,482,1,1242,6,1248,1877,3,1,3,0,1,0,66.49
臺北市,松山區,敦化里,483,1,1140,10,1150,1827,3,1,3,0,1,0,62.94
臺北市,松山區,敦化里,484,1,1150,15,1165,1775,3,1,3,0,1,0,65.63
臺北市,松山區,復源里,485,1,695,4,699,1066,3,1,3,0,1,0,65.57
臺北市,松山區,復源里,486,1,880,12,892,1417,3,1,3,0,1,0,62.95
臺北市,松山區,復建里,487,1,926,7,933,1420,3,1,3,0,1,0,65.70
臺北市,松山區,復建里,488,1,975,10,985,1534,3,1,3,0,1,0,64.21
臺北市,松山區,復勢里,489,1,957,20,977,1536,3,1,3,0,1,0,63.61
臺北市,松山區,復勢里,490,1,1111,12,1123,1713,3,1,3,0,1,0,65.56
臺北市,松山區,復勢里,491,1,903,8,911,1519,3,1,3,0,1,0,59.97
臺北市,松山區,福成里,492,1,1320,6,1326,2138,3,1,3,0,1,0,62.02
臺北市,信義區,西村里,493,1,1303,11,1314,2101,3,1,3,0,1,0,62.54
臺北市,信義區,西村里,494,1,1326,7,1333,1977,3,1,3,0,1,0,67.43
臺北市,信義區,正和里,495,1,1341,10,1351,2054,3,1,3,0,1,0,65.77
臺北市,信義區,正和里,496,1,1198,10,1208,1893,3,1,3,0,1,0,63.81
臺北市,信義區,興隆里,497,1,722,9,731,1182,3,1,3,0,1,0,61.84
臺北市,信義區,興隆里,498,1,818,12,830,1394,3,1,3,0,1,0,59.54
臺北市,信義區,中興里,499,1,737,13,750,1252,3,1,3,0,1,0,59.90
臺北市,信義區,中興里,500,1,624,3,627,1049,3,1,3,0,1,0,59.77
臺北市,信義區,新仁里,501,1,987,6,993,1648,3,1,3,0,1,0,60.25
臺北市,信義區,新仁里,502,1,1010,7,1017,1696,3,1,3,0,1,0,59.96
臺北市,信義區,興雅里,503,1,1043,9,1052,1745,3,1,3,0,1,0,60.29
臺北市,信義區,興雅里,504,1,1056,16,1072,1596,3,1,3,0,1,0,67.17
臺北市,信義區,興雅里,505,1,982,11,993,1534,3,1,3,0,1,0,64.73
臺北市,信義區,敦厚里,506,1,1200,11,1211,1943,3,1,3,0,1,0,62.33
臺北市,信義區,敦厚里,507,1,1127,9,1136,1856,3,1,3,0,1,0,61.21
臺北市,信義區,廣居里,508,1,1044,9,1053,1671,3,1,3,0,1,0,63.02
臺北市,信義區,廣居里,509,1,1055,10,1065,1698,3,1,3,0,1,0,62.72
臺北市,信義區,廣居里,510,1,989,7,996,1626,3,1,3,0,1,0,61.25
臺北市,信義區,安康里,511,1,1557,8,1565,2388,3,1,3,0,1,0,65.54
臺北市,信義區,安康里,512,1,1278,7,1285,1961,3,1,3,0,1,0,65.53
臺北市,信義區,安康里,513,1,1341,13,1354,2211,3,1,3,0,1,0,61.24
臺北市,信義區,六藝里,514,1,879,9,888,1430,3,1,3,0,1,0,62.10
臺北市,信義區,六藝里,515,1,927,11,938,1456,3,1,3,0,1,0,64.42
臺北市,信義區,雅祥里,516,1,1188,12,1200,1933,3,1,3,0,1,0,62.08
臺北市,信義區,雅祥里,517,1,1147,8,1155,1836,3,1,3,0,1,0,62.91
臺北市,信義區,五常里,518,1,951,14,965,1529,3,1,3,0,1,0,63.11
臺北市,信義區,五常里,519,1,958,8,966,1584,3,1,3,0,1,0,60.98
臺北市,信義區,五全里,520,1,1304,12,1316,2037,3,1,3,0,1,0,64.60
臺北市,信義區,五全里,521,1,1444,7,1451,2215,3,1,3,0,1,0,65.51
臺北市,信義區,永吉里,522,1,941,7,948,1629,3,1,3,0,1,0,58.20
臺北市,信義區,永吉里,523,1,1302,19,1321,2131,3,1,3,0,1,0,61.99
臺北市,信義區,長春里,524,1,1151,11,1162,1786,3,1,3,0,1,0,65.06
臺北市,信義區,長春里,525,1,1169,16,1185,1819,3,1,3,0,1,0,65.15
臺北市,信義區,四育里,526,1,1480,17,1497,2232,3,1,3,0,1,0,67.07
臺北市,信義區,四育里,527,1,1539,17,1556,2334,3,1,3,0,1,0,66.67
臺北市,信義區,四維里,528,1,1493,10,1503,2363,3,1,3,0,1,0,63.61
臺北市,信義區,四維里,529,1,1362,11,1373,2240,3,1,3,0,1,0,61.29
臺北市,信義區,永春里,530,1,1414,14,1428,2256,3,1,3,0,1,0,63.30
臺北市,信義區,永春里,531,1,1345,12,1357,2176,3,1,3,0,1,0,62.36
臺北市,信義區,富台里,532,1,858,8,866,1342,3,1,3,0,1,0,64.53
臺北市,信義區,富台里,533,1,1137,8,1145,1732,3,1,3,0,1,0,66.11
臺北市,信義區,國業里,534,1,1181,18,1199,1879,3,1,3,0,1,0,63.81
臺北市,信義區,國業里,535,1,1136,6,1142,1711,3,1,3,0,1,0,66.74
臺北市,信義區,國業里,536,1,1181,7,1188,1799,3,1,3,0,1,0,66.04
臺北市,信義區,松隆里,537,1,754,5,759,1234,3,1,3,0,1,0,61.51
臺北市,信義區,松隆里,538,1,661,14,675,1095,3,1,3,0,1,0,61.64
臺北市,信義區,松友里,539,1,1181,22,1203,1977,3,1,3,0,1,0,60.85
臺北市,信義區,松友里,540,1,1010,8,1018,1628,3,1,3,0,1,0,62.53
臺北市,信義區,松友里,541,1,967,8,975,1573,3,1,3,0,1,0,61.98
臺北市,信義區,松光里,542,1,941,12,953,1484,3,1,3,0,1,0,64.22
臺北市,信義區,松光里,543,1,1048,9,1057,1569,3,1,3,0,1,0,67.37
臺北市,信義區,松光里,544,1,1010,9,1019,1498,3,1,3,0,1,0,68.02
臺北市,信義區,中坡里,545,1,1219,17,1236,1862,3,1,3,0,1,0,66.38
臺北市,信義區,中坡里,546,1,1243,18,1261,1964,3,1,3,0,1,0,64.21
臺北市,信義區,中行里,547,1,1373,14,1387,2214,3,1,3,0,1,0,62.65
臺北市,信義區,中行里,548,1,1280,13,1293,2060,3,1,3,0,1,0,62.77
臺北市,信義區,中行里,549,1,1462,15,1477,2210,3,1,3,0,1,0,66.83
臺北市,信義區,大道里,550,1,1157,13,1170,1830,3,1,3,0,1,0,63.93
臺北市,信義區,大道里,551,1,1107,9,1116,1712,3,1,3,0,1,0,65.19
臺北市,信義區,大道里,552,1,1064,7,1071,1671,3,1,3,0,1,0,64.09
臺北市,信義區,大仁里,553,1,995,11,1006,1493,3,1,3,0,1,0,67.38
臺北市,信義區,大仁里,554,1,1048,27,1075,1727,3,1,3,0,1,0,62.25
臺北市,信義區,大仁里,555,1,986,15,1001,1499,3,1,3,0,1,0,66.78
臺北市,信義區,景新里,556,1,1234,10,1244,1963,3,1,3,0,1,0,63.37
臺北市,信義區,景新里,557,1,1242,10,1252,1930,3,1,3,0,1,0,64.87
臺北市,信義區,惠安里,558,1,1281,17,1298,2023,3,1,3,0,1,0,64.16
臺北市,信義區,惠安里,559,1,1100,9,1109,1720,3,1,3,0,1,0,64.48
臺北市,信義區,惠安里,560,1,1184,14,1198,1810,3,1,3,0,1,0,66.19
臺北市,信義區,三張里,561,1,1140,18,1158,1756,3,1,3,0,1,0,65.95
臺北市,信義區,三張里,562,1,1278,5,1283,1914,3,1,3,0,1,0,67.03
臺北市,信義區,三張里,563,1,1077,12,1089,1723,3,1,3,0,1,0,63.20
臺北市,信義區,三張里,564,1,1462,9,1471,2197,3,1,3,0,1,0,66.95
臺北市,信義區,三犁里,565,1,1186,12,1198,1882,3,1,3,0,1,0,63.66
臺北市,信義區,三犁里,566,1,1309,10,1319,2133,3,1,3,0,1,0,61.84
臺北市,信義區,六合里,567,1,1319,10,1329,2031,3,1,3,0,1,0,65.44
臺北市,信義區,六合里,568,1,1179,16,1195,2011,3,1,3,0,1,0,59.42
臺北市,信義區,六合里,569,1,767,2,769,1274,3,1,3,0,1,0,60.36
臺北市,信義區,泰和里,570,1,1166,13,1179,1957,3,1,3,0,1,0,60.25
臺北市,信義區,泰和里,571,1,1436,21,1457,2237,3,1,3,0,1,0,65.13
臺北市,信義區,泰和里,572,1,1510,22,1532,2368,3,1,3,0,1,0,64.70
臺北市,信義區,景聯里,573,1,796,5,801,1325,3,1,3,0,1,0,60.45
臺北市,信義區,景聯里,574,1,809,7,816,1295,3,1,3,0,1,0,63.01
臺北市,信義區,景聯里,575,1,894,8,902,1312,3,1,3,0,1,0,68.75
臺北市,信義區,景勤里,576,1,1234,13,1247,1970,3,1,3,0,1,0,63.30
臺北市,信義區,景勤里,577,1,1190,14,1204,1844,3,1,3,0,1,0,65.29
臺北市,信義區,雙和里,578,1,1311,15,1326,2030,3,1,3,0,1,0,65.32
臺北市,信義區,雙和里,579,1,1273,14,1287,1935,3,1,3,0,1,0,66.51
臺北市,信義區,雙和里,580,1,998,7,1005,1526,3,1,3,0,1,0,65.86
臺北市,信義區,嘉興里,581,1,950,9,959,1446,3,1,3,0,1,0,66.32
臺北市,信義區,嘉興里,582,1,794,9,803,1293,3,1,3,0,1,0,62.10
臺北市,信義區,黎順里,583,1,1078,14,1092,1766,3,1,3,0,1,0,61.83
臺北市,信義區,黎順里,584,1,1124,13,1137,1727,3,1,3,0,1,0,65.84
臺北市,信義區,黎平里,585,1,1351,23,1374,2068,3,1,3,0,1,0,66.44
臺北市,信義區,黎平里,586,1,1111,8,1119,1671,3,1,3,0,1,0,66.97
臺北市,信義區,黎平里,587,1,1190,13,1203,1871,3,1,3,0,1,0,64.30
臺北市,信義區,黎忠里,588,1,1220,13,1233,1930,3,1,3,0,1,0,63.89
臺北市,信義區,黎忠里,589,1,1310,10,1320,2023,3,1,3,0,1,0,65.25
臺北市,信義區,黎安里,590,1,742,9,751,1149,3,1,3,0,1,0,65.36
臺北市,信義區,黎安里,591,1,797,18,815,1147,3,1,3,0,1,0,71.05
臺北市,中山區,正守里,592,2,815,11,826,1393,3,1,3,0,1,0,59.30
臺北市,中山區,正守里,593,2,668,12,680,1012,3,1,3,0,1,0,67.19
臺北市,中山區,正義里,594,2,1028,15,1043,1930,3,1,3,0,1,0,54.04
臺北市,中山區,正義里,595,2,921,15,936,1657,3,1,3,0,1,0,56.49
臺北市,中山區,正得里,596,2,594,4,598,961,3,1,3,0,1,0,62.23
臺北市,中山區,正得里,597,2,897,9,906,1612,3,1,3,0,1,0,56.20
臺北市,中山區,民安里,598,2,1107,11,1118,1808,3,1,3,0,1,0,61.84
臺北市,中山區,民安里,599,2,629,12,641,1069,3,1,3,0,1,0,59.96
臺北市,中山區,民安里,600,2,690,12,702,1184,3,1,3,0,1,0,59.29
臺北市,中山區,康樂里,601,2,956,12,968,1848,3,1,3,0,1,0,52.38
臺北市,中山區,中山里,602,2,822,16,838,1464,3,1,3,0,1,0,57.24
臺北市,中山區,中山里,603,2,825,11,836,1458,3,1,3,0,1,0,57.34
臺北市,中山區,中山里,604,2,776,4,780,1365,3,1,3,0,1,0,57.14
臺北市,中山區,聚盛里,605,2,754,15,769,1417,3,1,3,0,1,0,54.27
臺北市,中山區,聚盛里,606,2,738,3,741,1427,3,1,3,0,1,0,51.93
臺北市,中山區,集英里,607,2,854,10,864,1320,3,1,3,0,1,0,65.45
臺北市,中山區,集英里,608,2,1255,14,1269,1988,3,1,3,0,1,0,63.83
臺北市,中山區,集英里,609,2,766,9,775,1299,3,1,3,0,1,0,59.66
臺北市,中山區,聚葉里,610,2,809,17,826,1454,3,1,3,0,1,0,56.81
臺北市,中山區,聚葉里,611,2,928,13,941,1534,3,1,3,0,1,0,61.34
臺北市,中山區,恆安里,612,2,797,16,813,1347,3,1,3,0,1,0,60.36
臺北市,中山區,恆安里,613,2,678,11,689,1228,3,1,3,0,1,0,56.11
臺北市,中山區,晴光里,614,2,805,8,813,1560,3,1,3,0,1,0,52.12
臺北市,中山區,晴光里,615,2,918,12,930,1669,3,1,3,0,1,0,55.72
臺北市,中山區,圓山里,616,2,1073,6,1079,1838,3,1,3,0,1,0,58.71
臺北市,中山區,圓山里,617,2,711,12,723,1235,3,1,3,0,1,0,58.54
臺北市,中山區,新庄里,618,2,807,13,820,1439,3,1,3,0,1,0,56.98
臺北市,中山區,新庄里,619,2,824,2,826,1351,3,1,3,0,1,0,61.14
臺北市,中山區,新庄里,620,2,694,7,701,1102,3,1,3,0,1,0,63.61
臺北市,中山區,劍潭里,621,2,1002,8,1010,1516,3,1,3,0,1,0,66.62
臺北市,中山區,劍潭里,622,2,1095,3,1098,1482,3,1,3,0,1,0,74.09
臺北市,中山區,大直里,623,2,1197,10,1207,1894,3,1,3,0,1,0,63.73
臺北市,中山區,大直里,624,2,1249,9,1258,1923,3,1,3,0,1,0,65.42
臺北市,中山區,大直里,625,2,1365,11,1376,1967,3,1,3,0,1,0,69.95
臺北市,中山區,大直里,626,2,1320,14,1334,2056,3,1,3,0,1,0,64.88
臺北市,中山區,成功里,627,2,998,6,1004,1400,3,1,3,0,1,0,71.71
臺北市,中山區,成功里,628,2,605,9,614,898,3,1,3,0,1,0,68.37
臺北市,中山區,成功里,629,2,748,4,752,1103,3,1,3,0,1,0,68.18
臺北市,中山區,成功里,630,2,768,5,773,1103,3,1,3,0,1,0,70.08
臺北市,中山區,成功里,631,2,1360,12,1372,2088,3,1,3,0,1,0,65.71
臺北市,中山區,永安里,632,2,1142,12,1154,1744,3,1,3,0,1,0,66.17
臺北市,中山區,永安里,633,2,896,10,906,1396,3,1,3,0,1,0,64.90
臺北市,中山區,永安里,634,2,843,9,852,1306,3,1,3,0,1,0,65.24
臺北市,中山區,永安里,635,2,1268,12,1280,1829,3,1,3,0,1,0,69.98
臺北市,中山區,大佳里,636,2,583,3,586,913,3,1,3,0,1,0,64.18
臺北市,中山區,新喜里,637,2,1252,14,1266,1898,3,1,3,0,1,0,66.70
臺北市,中山區,新喜里,638,2,1270,14,1284,2075,3,1,3,0,1,0,61.88
臺北市,中山區,新福里,639,2,914,8,922,1439,3,1,3,0,1,0,64.07
臺北市,中山區,新福里,640,2,796,6,802,1303,3,1,3,0,1,0,61.55
臺北市,中山區,新福里,641,2,729,14,743,1267,3,1,3,0,1,0,58.64
臺北市,中山區,松江里,642,2,1130,7,1137,1714,3,1,3,0,1,0,66.34
臺北市,中山區,松江里,643,2,1010,6,1016,1562,3,1,3,0,1,0,65.04
臺北市,中山區,松江里,644,2,1080,17,1097,1749,3,1,3,0,1,0,62.72
臺北市,中山區,新生里,645,2,812,8,820,1300,3,1,3,0,1,0,63.08
臺北市,中山區,新生里,646,2,791,13,804,1303,3,1,3,0,1,0,61.70
臺北市,中山區,新生里,647,2,849,16,865,1334,3,1,3,0,1,0,64.84
臺北市,中山區,中庄里,648,2,1188,13,1201,1999,3,1,3,0,1,0,60.08
臺北市,中山區,中庄里,649,2,1504,17,1521,2455,3,1,3,0,1,0,61.96
臺北市,中山區,行政里,650,2,867,10,877,1893,3,1,3,0,1,0,46.33
臺北市,中山區,行政里,651,2,943,10,953,1464,3,1,3,0,1,0,65.10
臺北市,中山區,行政里,652,2,745,7,752,1241,3,1,3,0,1,0,60.60
臺北市,中山區,行仁里,653,2,1013,9,1022,1623,3,1,3,0,1,0,62.97
臺北市,中山區,行仁里,654,2,942,16,958,1602,3,1,3,0,1,0,59.80
臺北市,中山區,行仁里,655,2,1016,16,1032,1686,3,1,3,0,1,0,61.21
臺北市,中山區,行仁里,656,2,1053,17,1070,1707,3,1,3,0,1,0,62.68
臺北市,中山區,行孝里,657,2,1143,17,1160,1768,3,1,3,0,1,0,65.61
臺北市,中山區,行孝里,658,2,898,8,906,1485,3,1,3,0,1,0,61.01
臺北市,中山區,下埤里,659,2,1171,5,1176,1864,3,1,3,0,1,0,63.09
臺北市,中山區,下埤里,660,2,1238,14,1252,1977,3,1,3,0,1,0,63.33
臺北市,中山區,下埤里,661,2,1160,11,1171,1920,3,1,3,0,1,0,60.99
臺北市,中山區,江寧里,662,2,1047,11,1058,1680,3,1,3,0,1,0,62.98
臺北市,中山區,江寧里,663,2,1057,9,1066,1680,3,1,3,0,1,0,63.45
臺北市,中山區,江寧里,664,2,1149,5,1154,1946,3,1,3,0,1,0,59.30
臺北市,中山區,江山里,665,2,1270,10,1280,2019,3,1,3,0,1,0,63.40
臺北市,中山區,江山里,666,2,1202,9,1211,1901,3,1,3,0,1,0,63.70
臺北市,中山區,江山里,667,2,1350,17,1367,2140,3,1,3,0,1,0,63.88
臺北市,中山區,中吉里,668,2,1360,15,1375,2183,3,1,3,0,1,0,62.99
臺北市,中山區,中吉里,669,2,1235,10,1245,1983,3,1,3,0,1,0,62.78
臺北市,中山區,中原里,670,2,1165,11,1176,1872,3,1,3,0,1,0,62.82
臺北市,中山區,中原里,671,2,1141,14,1155,1904,3,1,3,0,1,0,60.66
臺北市,中山區,興亞里,672,2,1071,12,1083,1778,3,1,3,0,1,0,60.91
臺北市,中山區,興亞里,673,2,1470,7,1477,2349,3,1,3,0,1,0,62.88
臺北市,中山區,中央里,674,2,845,6,851,1358,3,1,3,0,1,0,62.67
臺北市,中山區,中央里,675,2,975,7,982,1477,3,1,3,0,1,0,66.49
臺北市,中山區,朱馥里,676,2,985,12,997,1641,3,1,3,0,1,0,60.76
臺北市,中山區,朱馥里,677,2,1041,11,1052,1636,3,1,3,0,1,0,64.30
臺北市,中山區,朱馥里,678,2,1010,12,1022,1652,3,1,3,0,1,0,61.86
臺北市,中山區,龍洲里,679,2,939,13,952,1413,3,1,3,0,1,0,67.37
臺北市,中山區,龍洲里,680,2,886,7,893,1297,3,1,3,0,1,0,68.85
臺北市,中山區,龍洲里,681,2,1121,6,1127,1539,3,1,3,0,1,0,73.23
臺北市,中山區,朱園里,682,2,1054,13,1067,1679,3,1,3,0,1,0,63.55
臺北市,中山區,朱園里,683,2,1166,10,1176,1833,3,1,3,0,1,0,64.16
臺北市,中山區,埤頭里,684,2,1026,5,1031,1616,3,1,3,0,1,0,63.80
臺北市,中山區,埤頭里,685,2,1135,4,1139,1753,3,1,3,0,1,0,64.97
臺北市,中山區,朱崙里,686,2,848,6,854,1366,3,1,3,0,1,0,62.52
臺北市,中山區,朱崙里,687,2,735,14,749,1164,3,1,3,0,1,0,64.35
臺北市,中山區,力行里,688,2,1141,21,1162,1839,3,1,3,0,1,0,63.19
臺北市,中山區,力行里,689,2,884,6,890,1537,3,1,3,0,1,0,57.91
臺北市,中山區,力行里,690,2,1025,8,1033,1623,3,1,3,0,1,0,63.65
臺北市,中山區,復華里,691,2,1055,11,1066,1682,3,1,3,0,1,0,63.38
臺北市,中山區,復華里,692,2,912,8,920,1491,3,1,3,0,1,0,61.70
臺北市,大同區,玉泉里,693,2,1020,12,1032,1627,3,1,3,0,1,0,63.43
臺北市,大同區,玉泉里,694,2,832,17,849,1494,3,1,3,0,1,0,56.83
臺北市,大同區,建明里,695,2,1013,7,1020,1644,3,1,3,0,1,0,62.04
臺北市,大同區,建明里,696,2,935,9,944,1479,3,1,3,0,1,0,63.83
臺北市,大同區,建功里,697,2,1002,20,1022,1597,3,1,3,0,1,0,63.99
臺北市,大同區,建功里,698,2,992,10,1002,1708,3,1,3,0,1,0,58.67
臺北市,大同區,建泰里,699,2,1049,9,1058,1689,3,1,3,0,1,0,62.64
臺北市,大同區,建泰里,700,2,813,4,817,1254,3,1,3,0,1,0,65.15
臺北市,大同區,永樂里,701,2,913,9,922,1463,3,1,3,0,1,0,63.02
臺北市,大同區,永樂里,702,2,861,11,872,1352,3,1,3,0,1,0,64.50
臺北市,大同區,永樂里,703,2,858,9,867,1364,3,1,3,0,1,0,63.56
臺北市,大同區,朝陽里,704,2,975,15,990,1546,3,1,3,0,1,0,64.04
臺北市,大同區,朝陽里,705,2,976,7,983,1594,3,1,3,0,1,0,61.67
臺北市,大同區,星明里,706,2,1118,10,1128,1910,3,1,3,0,1,0,59.06
臺北市,大同區,星明里,707,2,1086,8,1094,1724,3,1,3,0,1,0,63.46
臺北市,大同區,光能里,708,2,983,4,987,1423,3,1,3,0,1,0,69.36
臺北市,大同區,光能里,709,2,861,7,868,1247,3,1,3,0,1,0,69.61
臺北市,大同區,光能里,710,2,1010,9,1019,1560,3,1,3,0,1,0,65.32
臺北市,大同區,大有里,711,2,783,10,793,1223,3,1,3,0,1,0,64.84
臺北市,大同區,大有里,712,2,866,9,875,1391,3,1,3,0,1,0,62.90
臺北市,大同區,大有里,713,2,930,7,937,1417,3,1,3,0,1,0,66.13
臺北市,大同區,延平里,714,2,1000,8,1008,1647,3,1,3,0,1,0,61.20
臺北市,大同區,延平里,715,2,880,3,883,1490,3,1,3,0,1,0,59.26
臺北市,大同區,雙連里,716,2,957,11,968,1502,3,1,3,0,1,0,64.45
臺北市,大同區,雙連里,717,2,1010,8,1018,1614,3,1,3,0,1,0,63.07
臺北市,大同區,雙連里,718,2,1363,12,1375,2237,3,1,3,0,1,0,61.47
臺北市,大同區,雙連里,719,2,1256,14,1270,2118,3,1,3,0,1,0,59.96
臺北市,大同區,南芳里,720,2,919,7,926,1568,3,1,3,0,1,0,59.06
臺北市,大同區,南芳里,721,2,980,15,995,1597,3,1,3,0,1,0,62.30
臺北市,大同區,民權里,722,2,1178,56,1234,1951,3,1,3,0,1,0,63.25
臺北市,大同區,民權里,723,2,1016,18,1034,1656,3,1,3,0,1,0,62.44
臺北市,大同區,民權里,724,2,997,8,1005,1620,3,1,3,0,1,0,62.04
臺北市,大同區,景星里,725,2,843,16,859,1321,3,1,3,0,1,0,65.03
臺北市,大同區,景星里,726,2,676,6,682,1087,3,1,3,0,1,0,62.74
臺北市,大同區,隆和里,727,2,831,6,837,1330,3,1,3,0,1,0,62.93
臺北市,大同區,隆和里,728,2,911,7,918,1367,3,1,3,0,1,0,67.15
臺北市,大同區,蓬萊里,729,2,1133,7,1140,1925,3,1,3,0,1,0,59.22
臺北市,大同區,蓬萊里,730,2,1191,15,1206,1943,3,1,3,0,1,0,62.07
臺北市,大同區,國順里,731,2,1257,16,1273,1942,3,1,3,0,1,0,65.55
臺北市,大同區,國順里,732,2,1053,13,1066,1653,3,1,3,0,1,0,64.49
臺北市,大同區,國慶里,733,2,1301,9,1310,2001,3,1,3,0,1,0,65.47
臺北市,大同區,揚雅里,734,2,820,6,826,1263,3,1,3,0,1,0,65.40
臺北市,大同區,揚雅里,735,2,804,12,816,1478,3,1,3,0,1,0,55.21
臺北市,大同區,斯文里,736,2,854,20,874,1437,3,1,3,0,1,0,60.82
臺北市,大同區,斯文里,737,2,1012,12,1024,1626,3,1,3,0,1,0,62.98
臺北市,大同區,斯文里,738,2,914,13,927,1396,3,1,3,0,1,0,66.40
臺北市,大同區,鄰江里,739,2,1088,8,1096,1703,3,1,3,0,1,0,64.36
臺北市,大同區,鄰江里,740,2,1038,12,1050,1666,3,1,3,0,1,0,63.03
臺北市,大同區,鄰江里,741,2,1146,16,1162,1827,3,1,3,0,1,0,63.60
臺北市,大同區,至聖里,742,2,1100,6,1106,1716,3,1,3,0,1,0,64.45
臺北市,大同區,至聖里,743,2,1041,17,1058,1615,3,1,3,0,1,0,65.51
臺北市,大同區,至聖里,744,2,1040,5,1045,1599,3,1,3,0,1,0,65.35
臺北市,大同區,至聖里,745,2,949,8,957,1501,3,1,3,0,1,0,63.76
臺北市,大同區,文昌里,746,2,674,6,680,1079,3,1,3,0,1,0,63.02
臺北市,大同區,老師里,747,2,1103,7,1110,1850,3,1,3,0,1,0,60.00
臺北市,大同區,老師里,748,2,1168,7,1175,1793,3,1,3,0,1,0,65.53
臺北市,大同區,重慶里,749,2,1185,13,1198,1847,3,1,3,0,1,0,64.86
臺北市,大同區,重慶里,750,2,1250,15,1265,1924,3,1,3,0,1,0,65.75
臺北市,大同區,保安里,751,2,1030,11,1041,1587,3,1,3,0,1,0,65.60
臺北市,大同區,保安里,752,2,1130,7,1137,1728,3,1,3,0,1,0,65.80
臺北市,大同區,保安里,753,2,863,8,871,1394,3,1,3,0,1,0,62.48
臺北市,中正區,水源里,754,2,852,8,860,1321,3,1,3,0,1,0,65.10
臺北市,中正區,水源里,755,2,776,6,782,1241,3,1,3,0,1,0,63.01
臺北市,中正區,富水里,756,2,724,3,727,1188,3,1,3,0,1,0,61.20
臺北市,中正區,富水里,757,2,814,19,833,1247,3,1,3,0,1,0,66.80
臺北市,中正區,文盛里,758,2,783,3,786,1132,3,1,3,0,1,0,69.43
臺北市,中正區,文盛里,759,2,707,3,710,1155,3,1,3,0,1,0,61.47
臺北市,中正區,林興里,760,2,1132,4,1136,1778,3,1,3,0,1,0,63.89
臺北市,中正區,林興里,761,2,1323,11,1334,2008,3,1,3,0,1,0,66.43
臺北市,中正區,河堤里,762,2,806,7,813,1224,3,1,3,0,1,0,66.42
臺北市,中正區,河堤里,763,2,863,10,873,1357,3,1,3,0,1,0,64.33
臺北市,中正區,河堤里,764,2,820,7,827,1298,3,1,3,0,1,0,63.71
臺北市,中正區,頂東里,765,2,970,7,977,1392,3,1,3,0,1,0,70.19
臺北市,中正區,頂東里,766,2,1115,6,1121,1577,3,1,3,0,1,0,71.08
臺北市,中正區,頂東里,767,2,1040,9,1049,1611,3,1,3,0,1,0,65.11
臺北市,中正區,網溪里,768,2,1030,2,1032,1592,3,1,3,0,1,0,64.82
臺北市,中正區,網溪里,769,2,896,3,899,1372,3,1,3,0,1,0,65.52
臺北市,中正區,網溪里,770,2,995,9,1004,1487,3,1,3,0,1,0,67.52
臺北市,中正區,板溪里,771,2,990,17,1007,1521,3,1,3,0,1,0,66.21
臺北市,中正區,板溪里,772,2,791,13,804,1223,3,1,3,0,1,0,65.74
臺北市,中正區,螢圃里,773,2,967,3,970,1435,3,1,3,0,1,0,67.60
臺北市,中正區,螢圃里,774,2,1033,6,1039,1515,3,1,3,0,1,0,68.58
臺北市,中正區,螢圃里,775,2,898,7,905,1364,3,1,3,0,1,0,66.35
臺北市,中正區,螢雪里,776,2,1085,12,1097,1677,3,1,3,0,1,0,65.41
臺北市,中正區,螢雪里,777,2,1264,9,1273,1935,3,1,3,0,1,0,65.79
臺北市,中正區,永功里,778,2,1106,7,1113,1748,3,1,3,0,1,0,63.67
臺北市,中正區,永功里,779,2,1137,11,1148,1768,3,1,3,0,1,0,64.93
臺北市,中正區,永功里,780,2,970,5,975,1556,3,1,3,0,1,0,62.66
臺北市,中正區,永昌里,781,2,942,11,953,1497,3,1,3,0,1,0,63.66
臺北市,中正區,永昌里,782,2,968,16,984,1523,3,1,3,0,1,0,64.61
臺北市,中正區,永昌里,783,2,886,14,900,1394,3,1,3,0,1,0,64.56
臺北市,中正區,龍興里,784,2,1074,5,1079,1704,3,1,3,0,1,0,63.32
臺北市,中正區,龍興里,785,2,955,8,963,1470,3,1,3,0,1,0,65.51
臺北市,中正區,忠勤里,786,2,949,19,968,1572,3,1,3,0,1,0,61.58
臺北市,中正區,忠勤里,787,2,901,18,919,1473,3,1,3,0,1,0,62.39
臺北市,中正區,忠勤里,788,2,832,18,850,1391,3,1,3,0,1,0,61.11
臺北市,中正區,忠勤里,789,2,862,11,873,1344,3,1,3,0,1,0,64.96
臺北市,中正區,廈安里,790,2,1175,12,1187,1764,3,1,3,0,1,0,67.29
臺北市,中正區,廈安里,791,2,816,3,819,1270,3,1,3,0,1,0,64.49
臺北市,中正區,愛國里,792,2,852,4,856,1289,3,1,3,0,1,0,66.41
臺北市,中正區,愛國里,793,2,856,5,861,1300,3,1,3,0,1,0,66.23
臺北市,中正區,南門里,794,2,897,5,902,1323,3,1,3,0,1,0,68.18
臺北市,中正區,南門里,795,2,867,8,875,1364,3,1,3,0,1,0,64.15
臺北市,中正區,龍光里,796,2,877,9,886,1425,3,1,3,0,1,0,62.18
臺北市,中正區,龍光里,797,2,1034,7,1041,1561,3,1,3,0,1,0,66.69
臺北市,中正區,南福里,798,2,1358,13,1371,2037,3,1,3,0,1,0,67.30
臺北市,中正區,南福里,799,2,1283,15,1298,1989,3,1,3,0,1,0,65.26
臺北市,中正區,南福里,800,2,1242,4,1246,1867,3,1,3,0,1,0,66.74
臺北市,中正區,龍福里,801,2,1014,4,1018,1765,3,1,3,0,1,0,57.68
臺北市,中正區,龍福里,802,2,1001,11,1012,1539,3,1,3,0,1,0,65.76
臺北市,中正區,龍福里,803,2,1122,10,1132,1710,3,1,3,0,1,0,66.20
臺北市,中正區,新營里,804,2,1076,9,1085,1557,3,1,3,0,1,0,69.69
臺北市,中正區,新營里,805,2,988,6,994,1476,3,1,3,0,1,0,67.34
臺北市,中正區,新營里,806,2,1041,13,1054,1570,3,1,3,0,1,0,67.13
臺北市,中正區,新營里,807,2,1007,6,1013,1478,3,1,3,0,1,0,68.54
臺北市,中正區,建國里,808,2,675,8,683,1138,3,1,3,0,1,0,60.02
臺北市,中正區,光復里,809,2,787,9,796,1309,3,1,3,0,1,0,60.81
臺北市,中正區,光復里,810,2,893,5,898,1566,3,1,3,0,1,0,57.34
臺北市,中正區,黎明里,811,2,591,5,596,1078,3,1,3,0,1,0,55.29
臺北市,中正區,黎明里,812,2,653,9,662,1157,3,1,3,0,1,0,57.22
臺北市,中正區,梅花里,813,2,891,6,897,1462,3,1,3,0,1,0,61.35
臺北市,中正區,梅花里,814,2,888,2,890,1373,3,1,3,0,1,0,64.82
臺北市,中正區,幸福里,815,2,1072,6,1078,1720,3,1,3,0,1,0,62.67
臺北市,中正區,幸福里,816,2,1033,6,1039,1668,3,1,3,0,1,0,62.29
臺北市,中正區,幸市里,817,2,1189,4,1193,1874,3,1,3,0,1,0,63.66
臺北市,中正區,幸市里,818,2,999,8,1007,1661,3,1,3,0,1,0,60.63
臺北市,中正區,東門里,819,2,728,6,734,1111,3,1,3,0,1,0,66.07
臺北市,中正區,東門里,820,2,858,3,861,1349,3,1,3,0,1,0,63.83
臺北市,中正區,東門里,821,2,644,9,653,1056,3,1,3,0,1,0,61.84
臺北市,中正區,文北里,822,2,849,3,852,1320,3,1,3,0,1,0,64.55
臺北市,中正區,文北里,823,2,962,8,970,1507,3,1,3,0,1,0,64.37
臺北市,中正區,文北里,824,2,760,4,764,1225,3,1,3,0,1,0,62.37
臺北市,中正區,文祥里,825,2,885,5,890,1397,3,1,3,0,1,0,63.71
臺北市,中正區,文祥里,826,2,795,11,806,1159,3,1,3,0,1,0,69.54
臺北市,中正區,文祥里,827,2,896,8,904,1368,3,1,3,0,1,0,66.08
臺北市,中正區,文祥里,828,2,903,11,914,1346,3,1,3,0,1,0,67.90
臺北市,中正區,三愛里,829,2,1067,11,1078,1621,3,1,3,0,1,0,66.50
臺北市,中正區,三愛里,830,2,1025,7,1032,1596,3,1,3,0,1,0,64.66
臺北市,中正區,三愛里,831,2,889,6,895,1350,3,1,3,0,1,0,66.30
臺北市,中正區,三愛里,832,2,901,10,911,1423,3,1,3,0,1,0,64.02
臺北市,萬華區,福星里,833,2,853,13,866,1374,3,1,3,0,1,0,63.03
臺北市,萬華區,福星里,834,2,673,15,688,1111,3,1,3,0,1,0,61.93
臺北市,萬華區,福星里,835,2,919,10,929,1548,3,1,3,0,1,0,60.01
臺北市,萬華區,萬壽里,836,2,693,8,701,1266,3,1,3,0,1,0,55.37
臺北市,萬華區,萬壽里,837,2,822,12,834,1416,3,1,3,0,1,0,58.90
臺北市,萬華區,西門里,838,2,934,11,945,1664,3,1,3,0,1,0,56.79
臺北市,萬華區,西門里,839,2,658,7,665,1202,3,1,3,0,1,0,55.32
臺北市,萬華區,新起里,840,2,1137,14,1151,1865,3,1,3,0,1,0,61.72
臺北市,萬華區,新起里,841,2,1196,16,1212,2027,3,1,3,0,1,0,59.79
臺北市,萬華區,新起里,842,2,1197,9,1206,1784,3,1,3,0,1,0,67.60
臺北市,萬華區,菜園里,843,2,916,10,926,1509,3,1,3,0,1,0,61.37
臺北市,萬華區,菜園里,844,2,1079,10,1089,1807,3,1,3,0,1,0,60.27
臺北市,萬華區,菜園里,845,2,1091,7,1098,1725,3,1,3,0,1,0,63.65
臺北市,萬華區,青山里,846,2,934,14,948,1476,3,1,3,0,1,0,64.23
臺北市,萬華區,青山里,847,2,935,7,942,1526,3,1,3,0,1,0,61.73
臺北市,萬華區,青山里,848,2,847,11,858,1402,3,1,3,0,1,0,61.20
臺北市,萬華區,富民里,849,2,1126,6,1132,1690,3,1,3,0,1,0,66.98
臺北市,萬華區,富民里,850,2,774,8,782,1229,3,1,3,0,1,0,63.63
臺北市,萬華區,富民里,851,2,885,12,897,1342,3,1,3,0,1,0,66.84
臺北市,萬華區,福音里,852,2,1060,16,1076,1573,3,1,3,0,1,0,68.40
臺北市,萬華區,福音里,853,2,1000,9,1009,1520,3,1,3,0,1,0,66.38
臺北市,萬華區,仁德里,854,2,1273,11,1284,1902,3,1,3,0,1,0,67.51
臺北市,萬華區,仁德里,855,2,1114,11,1125,1673,3,1,3,0,1,0,67.24
臺北市,萬華區,富福里,856,2,916,7,923,1315,3,1,3,0,1,0,70.19
臺北市,萬華區,富福里,857,2,775,2,777,1179,3,1,3,0,1,0,65.90
臺北市,萬華區,富福里,858,2,936,7,943,1374,3,1,3,0,1,0,68.63
臺北市,萬華區,糖廍里,859,2,1059,6,1065,1686,3,1,3,0,1,0,63.17
臺北市,萬華區,糖廍里,860,2,1200,10,1210,1995,3,1,3,0,1,0,60.65
臺北市,萬華區,綠堤里,861,2,1061,7,1068,1660,3,1,3,0,1,0,64.34
臺北市,萬華區,綠堤里,862,2,868,14,882,1525,3,1,3,0,1,0,57.84
臺北市,萬華區,綠堤里,863,2,1021,13,1034,1677,3,1,3,0,1,0,61.66
臺北市,萬華區,華江里,864,2,1080,19,1099,1618,3,1,3,0,1,0,67.92
臺北市,萬華區,華江里,865,2,989,12,1001,1573,3,1,3,0,1,0,63.64
臺北市,萬華區,華江里,866,2,1169,11,1180,1792,3,1,3,0,1,0,65.85
臺北市,萬華區,華江里,867,2,1203,15,1218,1967,3,1,3,0,1,0,61.92
臺北市,萬華區,柳鄉里,868,2,1140,15,1155,1891,3,1,3,0,1,0,61.08
臺北市,萬華區,柳鄉里,869,2,826,14,840,1252,3,1,3,0,1,0,67.09
臺北市,萬華區,柳鄉里,870,2,840,18,858,1366,3,1,3,0,1,0,62.81
臺北市,萬華區,壽德里,871,2,1000,6,1006,1513,3,1,3,0,1,0,66.49
臺北市,萬華區,壽德里,872,2,898,8,906,1330,3,1,3,0,1,0,68.12
臺北市,萬華區,壽德里,873,2,795,8,803,1195,3,1,3,0,1,0,67.20
臺北市,萬華區,興德里,874,2,854,8,862,1289,3,1,3,0,1,0,66.87
臺北市,萬華區,興德里,875,2,891,14,905,1376,3,1,3,0,1,0,65.77
臺北市,萬華區,興德里,876,2,796,8,804,1340,3,1,3,0,1,0,60.00
臺北市,萬華區,華中里,877,2,1177,13,1190,1807,3,1,3,0,1,0,65.86
臺北市,萬華區,華中里,878,2,1130,15,1145,1746,3,1,3,0,1,0,65.58
臺北市,萬華區,華中里,879,2,1018,17,1035,1590,3,1,3,0,1,0,65.09
臺北市,萬華區,日祥里,880,2,1053,13,1066,1646,3,1,3,0,1,0,64.76
臺北市,萬華區,日祥里,881,2,887,11,898,1385,3,1,3,0,1,0,64.84
臺北市,萬華區,日祥里,882,2,1270,11,1281,1818,3,1,3,0,1,0,70.46
臺北市,萬華區,忠貞里,883,2,936,15,951,1296,3,1,3,0,1,0,73.38
臺北市,萬華區,忠貞里,884,2,1073,7,1080,1538,3,1,3,0,1,0,70.22
臺北市,萬華區,忠貞里,885,2,957,10,967,1458,3,1,3,0,1,0,66.32
臺北市,萬華區,凌霄里,886,2,1007,21,1028,1579,3,1,3,0,1,0,65.10
臺北市,萬華區,凌霄里,887,2,1294,12,1306,1939,3,1,3,0,1,0,67.35
臺北市,萬華區,騰雲里,888,2,867,3,870,1347,3,1,3,0,1,0,64.59
臺北市,萬華區,騰雲里,889,2,852,12,864,1222,3,1,3,0,1,0,70.70
臺北市,萬華區,忠德里,890,2,1159,16,1175,1763,3,1,3,0,1,0,66.65
臺北市,萬華區,忠德里,891,2,1297,14,1311,1958,3,1,3,0,1,0,66.96
臺北市,萬華區,孝德里,892,2,942,9,951,1476,3,1,3,0,1,0,64.43
臺北市,萬華區,孝德里,893,2,814,15,829,1216,3,1,3,0,1,0,68.17
臺北市,萬華區,和德里,894,2,1360,16,1376,2199,3,1,3,0,1,0,62.57
臺北市,萬華區,和德里,895,2,1081,22,1103,1955,3,1,3,0,1,0,56.42
臺北市,萬華區,和德里,896,2,1079,7,1086,1691,3,1,3,0,1,0,64.22
臺北市,萬華區,錦德里,897,2,975,14,989,1520,3,1,3,0,1,0,65.07
臺北市,萬華區,錦德里,898,2,971,10,981,1527,3,1,3,0,1,0,64.24
臺北市,萬華區,錦德里,899,2,825,6,831,1249,3,1,3,0,1,0,66.53
臺北市,萬華區,全德里,900,2,1086,14,1100,1673,3,1,3,0,1,0,65.75
臺北市,萬華區,全德里,901,2,1105,14,1119,1707,3,1,3,0,1,0,65.55
臺北市,萬華區,保德里,902,2,856,9,865,1267,3,1,3,0,1,0,68.27
臺北市,萬華區,保德里,903,2,808,9,817,1195,3,1,3,0,1,0,68.37
臺北市,萬華區,銘德里,904,2,930,7,937,1370,3,1,3,0,1,0,68.39
臺北市,萬華區,銘德里,905,2,942,8,950,1424,3,1,3,0,1,0,66.71
臺北市,萬華區,銘德里,906,2,686,9,695,1094,3,1,3,0,1,0,63.53
臺北市,萬華區,榮德里,907,2,1078,16,1094,1565,3,1,3,0,1,0,69.90
臺北市,萬華區,榮德里,908,2,1172,21,1193,1741,3,1,3,0,1,0,68.52
臺北市,萬華區,和平里,909,2,1033,16,1049,1639,3,1,3,0,1,0,64.00
臺北市,萬華區,和平里,910,2,846,5,851,1309,3,1,3,0,1,0,65.01
臺北市,萬華區,和平里,911,2,794,9,803,1260,3,1,3,0,1,0,63.73
臺北市,萬華區,和平里,912,2,1172,27,1199,1823,3,1,3,0,1,0,65.77
臺北市,萬華區,日善里,913,2,1146,15,1161,1780,3,1,3,0,1,0,65.22
臺北市,萬華區,日善里,914,2,923,8,931,1365,3,1,3,0,1,0,68.21
臺北市,萬華區,新安里,915,2,937,17,954,1519,3,1,3,0,1,0,62.80
臺北市,萬華區,新安里,916,2,935,17,952,1444,3,1,3,0,1,0,65.93
臺北市,萬華區,新安里,917,2,781,10,791,1199,3,1,3,0,1,0,65.97
臺北市,萬華區,新安里,918,2,943,9,952,1321,3,1,3,0,1,0,72.07
臺北市,萬華區,頂碩里,919,2,1243,14,1257,2009,3,1,3,0,1,0,62.57
臺北市,萬華區,頂碩里,920,2,1101,9,1110,1641,3,1,3,0,1,0,67.64
臺北市,萬華區,頂碩里,921,2,929,9,938,1410,3,1,3,0,1,0,66.52
臺北市,萬華區,頂碩里,922,2,999,13,1012,1505,3,1,3,0,1,0,67.24
臺北市,萬華區,雙園里,923,2,795,9,804,1253,3,1,3,0,1,0,64.17
臺北市,萬華區,雙園里,924,2,988,10,998,1520,3,1,3,0,1,0,65.66
臺北市,萬華區,雙園里,925,2,951,8,959,1494,3,1,3,0,1,0,64.19
臺北市,萬華區,新忠里,926,2,969,5,974,1541,3,1,3,0,1,0,63.21
臺北市,萬華區,新忠里,927,2,1283,3,1286,1774,3,1,3,0,1,0,72.49
臺北市,萬華區,新和里,928,2,1065,10,1075,1484,3,1,3,0,1,0,72.44
臺北市,萬華區,新和里,929,2,996,8,1004,1390,3,1,3,0,1,0,72.23
臺北市,萬華區,新和里,930,2,992,10,1002,1459,3,1,3,0,1,0,68.68
臺北市,萬華區,新和里,931,2,959,11,970,1455,3,1,3,0,1,0,66.67
臺北市,萬華區,新和里,932,2,968,7,975,1357,3,1,3,0,1,0,71.85
臺北市,大安區,德安里,933,2,1002,4,1006,1496,3,1,3,0,1,0,67.25
臺北市,大安區,德安里,934,2,951,7,958,1505,3,1,3,0,1,0,63.65
臺北市,大安區,德安里,935,2,890,11,901,1473,3,1,3,0,1,0,61.17
臺北市,大安區,仁慈里,936,2,1228,8,1236,1961,3,1,3,0,1,0,63.03
臺北市,大安區,仁慈里,937,2,1232,11,1243,1909,3,1,3,0,1,0,65.11
臺北市,大安區,和安里,938,2,1000,7,1007,1542,3,1,3,0,1,0,65.30
臺北市,大安區,和安里,939,2,1214,7,1221,1856,3,1,3,0,1,0,65.79
臺北市,大安區,和安里,940,2,971,8,979,1511,3,1,3,0,1,0,64.79
臺北市,大安區,民炤里,941,2,976,4,980,1548,3,1,3,0,1,0,63.31
臺北市,大安區,民炤里,942,2,992,6,998,1642,3,1,3,0,1,0,60.78
臺北市,大安區,民炤里,943,2,916,6,922,1441,3,1,3,0,1,0,63.98
臺北市,大安區,民炤里,944,2,1080,5,1085,1701,3,1,3,0,1,0,63.79
臺北市,大安區,仁愛里,945,2,938,7,945,1621,3,1,3,0,1,0,58.30
臺北市,大安區,仁愛里,946,2,863,6,869,1540,3,1,3,0,1,0,56.43
臺北市,大安區,仁愛里,947,2,838,7,845,1466,3,1,3,0,1,0,57.64
臺北市,大安區,義村里,948,2,1341,18,1359,1992,3,1,3,0,1,0,68.22
臺北市,大安區,義村里,949,2,1232,11,1243,1904,3,1,3,0,1,0,65.28
臺北市,大安區,義村里,950,2,1070,0,1070,1632,3,1,3,0,1,0,65.56
臺北市,大安區,民輝里,951,2,1060,6,1066,1609,3,1,3,0,1,0,66.25
臺北市,大安區,民輝里,952,2,1068,8,1076,1728,3,1,3,0,1,0,62.27
臺北市,大安區,民輝里,953,2,1118,10,1128,1826,3,1,3,0,1,0,61.77
臺北市,大安區,昌隆里,954,2,915,11,926,1417,3,1,3,0,1,0,65.35
臺北市,大安區,昌隆里,955,2,963,8,971,1507,3,1,3,0,1,0,64.43
臺北市,大安區,誠安里,956,2,1103,7,1110,1735,3,1,3,0,1,0,63.98
臺北市,大安區,誠安里,957,2,1172,7,1179,1848,3,1,3,0,1,0,63.80
臺北市,大安區,光武里,958,2,1117,11,1128,1997,3,1,3,0,1,0,56.48
臺北市,大安區,光武里,959,2,1311,14,1325,2143,3,1,3,0,1,0,61.83
臺北市,大安區,光武里,960,2,1324,7,1331,2140,3,1,3,0,1,0,62.20
臺北市,大安區,龍坡里,961,2,1046,4,1050,1591,3,1,3,0,1,0,66.00
臺北市,大安區,龍坡里,962,2,932,3,935,1386,3,1,3,0,1,0,67.46
臺北市,大安區,龍坡里,963,2,1007,6,1013,1454,3,1,3,0,1,0,69.67
臺北市,大安區,龍泉里,964,2,1160,6,1166,1821,3,1,3,0,1,0,64.03
臺北市,大安區,龍泉里,965,2,1079,5,1084,1736,3,1,3,0,1,0,62.44
臺北市,大安區,古風里,966,2,1034,3,1037,1577,3,1,3,0,1,0,65.76
臺北市,大安區,古風里,967,2,1115,5,1120,1716,3,1,3,0,1,0,65.27
臺北市,大安區,古莊里,968,2,1021,5,1026,1563,3,1,3,0,1,0,65.64
臺北市,大安區,古莊里,969,2,1099,9,1108,1673,3,1,3,0,1,0,66.23
臺北市,大安區,古莊里,970,2,1133,8,1141,1785,3,1,3,0,1,0,63.92
臺北市,大安區,龍安里,971,2,692,2,694,1574,3,1,3,0,1,0,44.09
臺北市,大安區,龍安里,972,2,1020,8,1028,1516,3,1,3,0,1,0,67.81
臺北市,大安區,龍安里,973,2,1136,6,1142,1752,3,1,3,0,1,0,65.18
臺北市,大安區,錦安里,974,2,1230,8,1238,1975,3,1,3,0,1,0,62.68
臺北市,大安區,錦安里,975,2,1361,4,1365,1968,3,1,3,0,1,0,69.36
臺北市,大安區,福住里,976,2,1417,12,1429,2209,3,1,3,0,1,0,64.69
臺北市,大安區,福住里,977,2,1327,8,1335,2031,3,1,3,0,1,0,65.73
臺北市,大安區,永康里,978,2,862,9,871,1340,3,1,3,0,1,0,65.00
臺北市,大安區,永康里,979,2,809,7,816,1204,3,1,3,0,1,0,67.77
臺北市,大安區,光明里,980,2,968,5,973,1417,3,1,3,0,1,0,68.67
臺北市,大安區,光明里,981,2,937,6,943,1402,3,1,3,0,1,0,67.26
臺北市,大安區,錦泰里,982,2,978,14,992,1387,3,1,3,0,1,0,71.52
臺北市,大安區,錦泰里,983,2,879,5,884,1216,3,1,3,0,1,0,72.70
臺北市,大安區,錦泰里,984,2,914,10,924,1384,3,1,3,0,1,0,66.76
臺北市,大安區,錦華里,985,2,867,5,872,1338,3,1,3,0,1,0,65.17
臺北市,大安區,錦華里,986,2,909,5,914,1331,3,1,3,0,1,0,68.67
臺北市,大安區,錦華里,987,2,899,5,904,1396,3,1,3,0,1,0,64.76
臺北市,大安區,龍圖里,988,2,913,1,914,1519,3,1,3,0,1,0,60.17
臺北市,大安區,龍圖里,989,2,1167,14,1181,1805,3,1,3,0,1,0,65.43
臺北市,大安區,龍圖里,990,2,1194,5,1199,1900,3,1,3,0,1,0,63.11
臺北市,大安區,新龍里,991,2,1012,8,1020,1565,3,1,3,0,1,0,65.18
臺北市,大安區,新龍里,992,2,1142,10,1152,1646,3,1,3,0,1,0,69.99
臺北市,大安區,新龍里,993,2,1278,9,1287,1873,3,1,3,0,1,0,68.71
臺北市,大安區,龍陣里,994,2,879,10,889,1389,3,1,3,0,1,0,64.00
臺北市,大安區,龍陣里,995,2,1016,5,1021,1583,3,1,3,0,1,0,64.50
臺北市,大安區,龍雲里,996,2,845,8,853,1231,3,1,3,0,1,0,69.29
臺北市,大安區,龍雲里,997,2,910,8,918,1423,3,1,3,0,1,0,64.51
臺北市,大安區,龍雲里,998,2,866,8,874,1409,3,1,3,0,1,0,62.03
臺北市,大安區,龍生里,999,2,1095,9,1104,1576,3,1,3,0,1,0,70.05
臺北市,大安區,龍生里,1000,2,1083,6,1089,1649,3,1,3,0,1,0,66.04
臺北市,大安區,龍生里,1001,2,1022,7,1029,1552,3,1,3,0,1,0,66.30
臺北市,大安區,住安里,1002,2,1020,8,1028,1582,3,1,3,0,1,0,64.98
臺北市,大安區,住安里,1003,2,785,10,795,1277,3,1,3,0,1,0,62.26
臺北市,大安區,住安里,1004,2,951,12,963,1508,3,1,3,0,1,0,63.86
臺北市,大安區,義安里,1005,2,923,10,933,1555,3,1,3,0,1,0,60.00
臺北市,大安區,義安里,1006,2,963,7,970,1478,3,1,3,0,1,0,65.63
臺北市,大安區,義安里,1007,2,833,3,836,1396,3,1,3,0,1,0,59.89
臺北市,大安區,通化里,1008,2,912,12,924,1435,3,1,3,0,1,0,64.39
臺北市,大安區,通化里,1009,2,1092,14,1106,1665,3,1,3,0,1,0,66.43
臺北市,大安區,通化里,1010,2,1124,7,1131,1742,3,1,3,0,1,0,64.93
臺北市,大安區,通安里,1011,2,883,5,888,1409,3,1,3,0,1,0,63.02
臺北市,大安區,通安里,1012,2,1084,10,1094,1654,3,1,3,0,1,0,66.14
臺北市,大安區,通安里,1013,2,957,6,963,1493,3,1,3,0,1,0,64.50
臺北市,大安區,臨江里,1014,2,1098,13,1111,1689,3,1,3,0,1,0,65.78
臺北市,大安區,臨江里,1015,2,1178,11,1189,1806,3,1,3,0,1,0,65.84
臺北市,大安區,法治里,1016,2,1186,8,1194,1776,3,1,3,0,1,0,67.23
臺北市,大安區,法治里,1017,2,1137,10,1147,1737,3,1,3,0,1,0,66.03
臺北市,大安區,全安里,1018,2,1143,10,1153,1791,3,1,3,0,1,0,64.38
臺北市,大安區,全安里,1019,2,1083,2,1085,1717,3,1,3,0,1,0,63.19
臺北市,大安區,群賢里,1020,2,1193,4,1197,1798,3,1,3,0,1,0,66.57
臺北市,大安區,群賢里,1021,2,965,6,971,1491,3,1,3,0,1,0,65.12
臺北市,大安區,群賢里,1022,2,1063,5,1068,1725,3,1,3,0,1,0,61.91
臺北市,大安區,群英里,1023,2,1032,5,1037,1463,3,1,3,0,1,0,70.88
臺北市,大安區,群英里,1024,2,1030,6,1036,1553,3,1,3,0,1,0,66.71
臺北市,大安區,群英里,1025,2,935,2,937,1332,3,1,3,0,1,0,70.35
臺北市,大安區,群英里,1026,2,998,4,1002,1497,3,1,3,0,1,0,66.93
臺北市,大安區,虎嘯里,1027,2,745,5,750,1106,3,1,3,0,1,0,67.81
臺北市,大安區,虎嘯里,1028,2,953,8,961,1487,3,1,3,0,1,0,64.63
臺北市,大安區,臥龍里,1029,2,757,2,759,1151,3,1,3,0,1,0,65.94
臺北市,大安區,臥龍里,1030,2,815,7,822,1270,3,1,3,0,1,0,64.72
臺北市,大安區,龍淵里,1031,2,1056,3,1059,1644,3,1,3,0,1,0,64.42
臺北市,大安區,龍淵里,1032,2,1188,9,1197,1818,3,1,3,0,1,0,65.84
臺北市,大安區,龍淵里,1033,2,1105,5,1110,1669,3,1,3,0,1,0,66.51
臺北市,大安區,龍淵里,1034,2,1173,12,1185,1731,3,1,3,0,1,0,68.46
臺北市,大安區,龍門里,1035,2,1025,5,1030,1635,3,1,3,0,1,0,63.00
臺北市,大安區,龍門里,1036,2,1072,5,1077,1589,3,1,3,0,1,0,67.78
臺北市,大安區,農場里,1037,2,1039,10,1049,1672,3,1,3,0,1,0,62.74
臺北市,大安區,大學里,1038,2,1012,7,1019,1539,3,1,3,0,1,0,66.21
臺北市,大安區,大學里,1039,2,1039,12,1051,1633,3,1,3,0,1,0,64.36
臺北市,大安區,大學里,1040,2,1049,6,1055,1668,3,1,3,0,1,0,63.25
臺北市,大安區,大學里,1041,2,990,15,1005,1593,3,1,3,0,1,0,63.09
臺北市,大安區,芳和里,1042,2,1097,4,1101,1623,3,1,3,0,1,0,67.84
臺北市,大安區,芳和里,1043,2,1191,14,1205,1789,3,1,3,0,1,0,67.36
臺北市,大安區,芳和里,1044,2,1000,9,1009,1558,3,1,3,0,1,0,64.76
臺北市,大安區,青峰里,1045,2,535,7,542,801,3,1,3,0,1,0,67.67
臺北市,大安區,青峰里,1046,2,559,5,564,858,3,1,3,0,1,0,65.73
臺北市,大安區,黎元里,1047,2,864,10,874,1411,3,1,3,0,1,0,61.94
臺北市,大安區,黎元里,1048,2,1083,10,1093,1617,3,1,3,0,1,0,67.59
臺北市,大安區,黎元里,1049,2,969,15,984,1455,3,1,3,0,1,0,67.63
臺北市,大安區,黎孝里,1050,2,1002,9,1011,1470,3,1,3,0,1,0,68.78
臺北市,大安區,黎孝里,1051,2,997,6,1003,1441,3,1,3,0,1,0,69.60
臺北市,大安區,黎孝里,1052,2,999,12,1011,1515,3,1,3,0,1,0,66.73
臺北市,大安區,黎孝里,1053,2,1086,3,1089,1608,3,1,3,0,1,0,67.72
臺北市,大安區,黎和里,1054,2,991,12,1003,1544,3,1,3,0,1,0,64.96
臺北市,大安區,黎和里,1055,2,1166,16,1182,1820,3,1,3,0,1,0,64.95
臺北市,大安區,建安里,1056,2,1211,15,1226,1990,3,1,3,0,1,0,61.61
臺北市,大安區,建安里,1057,2,1231,7,1238,2097,3,1,3,0,1,0,59.04
臺北市,大安區,建倫里,1058,2,952,7,959,1629,3,1,3,0,1,0,58.87
臺北市,大安區,建倫里,1059,2,993,3,996,1603,3,1,3,0,1,0,62.13
臺北市,大安區,建倫里,1060,2,989,7,996,1647,3,1,3,0,1,0,60.47
臺北市,大安區,敦安里,1061,2,868,7,875,1415,3,1,3,0,1,0,61.84
臺北市,大安區,敦安里,1062,2,1010,8,1018,1629,3,1,3,0,1,0,62.49
臺北市,大安區,敦安里,1063,2,1133,7,1140,1817,3,1,3,0,1,0,62.74
臺北市,大安區,正聲里,1064,2,1148,6,1154,1835,3,1,3,0,1,0,62.89
臺北市,大安區,正聲里,1065,2,1165,7,1172,1939,3,1,3,0,1,0,60.44
臺北市,大安區,敦煌里,1066,2,1083,4,1087,1629,3,1,3,0,1,0,66.73
臺北市,大安區,敦煌里,1067,2,994,6,1000,1582,3,1,3,0,1,0,63.21
臺北市,大安區,敦煌里,1068,2,929,1,930,1519,3,1,3,0,1,0,61.22
臺北市,大安區,華聲里,1069,2,1041,8,1049,1733,3,1,3,0,1,0,60.53
臺北市,大安區,華聲里,1070,2,1053,9,1062,1665,3,1,3,0,1,0,63.78
臺北市,大安區,車層里,1071,2,842,9,851,1282,3,1,3,0,1,0,66.38
臺北市,大安區,車層里,1072,2,1321,8,1329,2050,3,1,3,0,1,0,64.83
臺北市,大安區,車層里,1073,2,1227,4,1231,1947,3,1,3,0,1,0,63.23
臺北市,大安區,光信里,1074,2,983,8,991,1568,3,1,3,0,1,0,63.20
臺北市,大安區,光信里,1075,2,1023,6,1029,1606,3,1,3,0,1,0,64.07
臺北市,大安區,光信里,1076,2,976,5,981,1542,3,1,3,0,1,0,63.62
臺北市,大安區,光信里,1077,2,917,4,921,1383,3,1,3,0,1,0,66.59
臺北市,文山區,景行里,1078,2,1350,19,1369,2092,3,1,3,0,1,0,65.44
臺北市,文山區,景行里,1079,2,1298,11,1309,1997,3,1,3,0,1,0,65.55
臺北市,文山區,景東里,1080,2,1138,14,1152,1764,3,1,3,0,1,0,65.31
臺北市,文山區,景東里,1081,2,1037,18,1055,1657,3,1,3,0,1,0,63.67
臺北市,文山區,景東里,1082,2,1054,4,1058,1652,3,1,3,0,1,0,64.04
臺北市,文山區,景美里,1083,2,1116,5,1121,1647,3,1,3,0,1,0,68.06
臺北市,文山區,景美里,1084,2,1143,11,1154,1730,3,1,3,0,1,0,66.71
臺北市,文山區,景慶里,1085,2,1016,12,1028,1577,3,1,3,0,1,0,65.19
臺北市,文山區,景慶里,1086,2,1093,12,1105,1666,3,1,3,0,1,0,66.33
臺北市,文山區,景慶里,1087,2,1139,9,1148,1664,3,1,3,0,1,0,68.99
臺北市,文山區,景仁里,1088,2,1263,13,1276,1876,3,1,3,0,1,0,68.02
臺北市,文山區,景仁里,1089,2,1230,10,1240,1860,3,1,3,0,1,0,66.67
臺北市,文山區,景華里,1090,2,941,3,944,1477,3,1,3,0,1,0,63.91
臺北市,文山區,景華里,1091,2,947,8,955,1484,3,1,3,0,1,0,64.35
臺北市,文山區,景華里,1092,2,898,6,904,1381,3,1,3,0,1,0,65.46
臺北市,文山區,萬有里,1093,2,1178,8,1186,1737,3,1,3,0,1,0,68.28
臺北市,文山區,萬有里,1094,2,1286,7,1293,1889,3,1,3,0,1,0,68.45
臺北市,文山區,萬祥里,1095,2,1104,7,1111,1675,3,1,3,0,1,0,66.33
臺北市,文山區,萬祥里,1096,2,1192,9,1201,1782,3,1,3,0,1,0,67.40
臺北市,文山區,萬隆里,1097,2,1109,6,1115,1736,3,1,3,0,1,0,64.23
臺北市,文山區,萬隆里,1098,2,1060,1,1061,1583,3,1,3,0,1,0,67.02
臺北市,文山區,萬隆里,1099,2,1337,8,1345,1989,3,1,3,0,1,0,67.62
臺北市,文山區,萬年里,1100,2,1404,14,1418,2190,3,1,3,0,1,0,64.75
臺北市,文山區,萬年里,1101,2,1288,10,1298,1954,3,1,3,0,1,0,66.43
臺北市,文山區,萬和里,1102,2,1015,6,1021,1476,3,1,3,0,1,0,69.17
臺北市,文山區,萬和里,1103,2,966,15,981,1348,3,1,3,0,1,0,72.77
臺北市,文山區,萬盛里,1104,2,1217,10,1227,1908,3,1,3,0,1,0,64.31
臺北市,文山區,萬盛里,1105,2,1293,2,1295,1877,3,1,3,0,1,0,68.99
臺北市,文山區,興豐里,1106,2,1304,22,1326,2005,3,1,3,0,1,0,66.13
臺北市,文山區,興豐里,1107,2,1466,7,1473,2174,3,1,3,0,1,0,67.76
臺北市,文山區,興豐里,1108,2,1716,20,1736,2522,3,1,3,0,1,0,68.83
臺北市,文山區,興光里,1109,2,1257,18,1275,2030,3,1,3,0,1,0,62.81
臺北市,文山區,興光里,1110,2,1196,7,1203,1814,3,1,3,0,1,0,66.32
臺北市,文山區,興家里,1111,2,851,9,860,1307,3,1,3,0,1,0,65.80
臺北市,文山區,興家里,1112,2,942,5,947,1368,3,1,3,0,1,0,69.23
臺北市,文山區,興家里,1113,2,1079,3,1082,1727,3,1,3,0,1,0,62.65
臺北市,文山區,興得里,1114,2,988,6,994,1535,3,1,3,0,1,0,64.76
臺北市,文山區,興得里,1115,2,1007,11,1018,1624,3,1,3,0,1,0,62.68
臺北市,文山區,興得里,1116,2,1101,10,1111,1716,3,1,3,0,1,0,64.74
臺北市,文山區,興業里,1117,2,991,10,1001,1602,3,1,3,0,1,0,62.48
臺北市,文山區,興業里,1118,2,971,6,977,1392,3,1,3,0,1,0,70.19
臺北市,文山區,興業里,1119,2,860,6,866,1346,3,1,3,0,1,0,64.34
臺北市,文山區,興安里,1120,2,1174,12,1186,1696,3,1,3,0,1,0,69.93
臺北市,文山區,興安里,1121,2,1045,9,1054,1544,3,1,3,0,1,0,68.26
臺北市,文山區,興安里,1122,2,992,5,997,1513,3,1,3,0,1,0,65.90
臺北市,文山區,興福里,1123,2,987,4,991,1435,3,1,3,0,1,0,69.06
臺北市,文山區,興福里,1124,2,991,6,997,1473,3,1,3,0,1,0,67.68
臺北市,文山區,興福里,1125,2,1054,8,1062,1557,3,1,3,0,1,0,68.21
臺北市,文山區,興旺里,1126,2,948,11,959,1510,3,1,3,0,1,0,63.51
臺北市,文山區,興旺里,1127,2,1014,11,1025,1637,3,1,3,0,1,0,62.61
臺北市,文山區,興旺里,1128,2,1305,10,1315,1869,3,1,3,0,1,0,70.36
臺北市,文山區,興泰里,1129,2,948,8,956,1509,3,1,3,0,1,0,63.35
臺北市,文山區,興泰里,1130,2,959,10,969,1450,3,1,3,0,1,0,66.83
臺北市,文山區,興昌里,1131,2,1056,13,1069,1629,3,1,3,0,1,0,65.62
臺北市,文山區,興昌里,1132,2,1158,8,1166,1663,3,1,3,0,1,0,70.11
臺北市,文山區,興昌里,1133,2,941,2,943,1406,3,1,3,0,1,0,67.07
臺北市,文山區,試院里,1134,2,981,10,991,1438,3,1,3,0,1,0,68.92
臺北市,文山區,試院里,1135,2,1152,5,1157,1727,3,1,3,0,1,0,66.99
臺北市,文山區,試院里,1136,2,1117,12,1129,1604,3,1,3,0,1,0,70.39
臺北市,文山區,華興里,1137,2,1272,6,1278,1935,3,1,3,0,1,0,66.05
臺北市,文山區,華興里,1138,2,1223,12,1235,1802,3,1,3,0,1,0,68.53
臺北市,文山區,華興里,1139,2,1271,10,1281,1971,3,1,3,0,1,0,64.99
臺北市,文山區,明義里,1140,2,981,29,1010,1740,3,1,3,0,1,0,58.05
臺北市,文山區,明義里,1141,2,1061,19,1080,1765,3,1,3,0,1,0,61.19
臺北市,文山區,明興里,1142,2,1224,13,1237,1969,3,1,3,0,1,0,62.82
臺北市,文山區,明興里,1143,2,1009,9,1018,1636,3,1,3,0,1,0,62.22
臺北市,文山區,明興里,1144,2,1255,10,1265,1873,3,1,3,0,1,0,67.54
臺北市,文山區,木柵里,1145,2,1358,7,1365,1920,3,1,3,0,1,0,71.09
臺北市,文山區,木柵里,1146,2,1236,14,1250,1848,3,1,3,0,1,0,67.64
臺北市,文山區,木柵里,1147,2,1324,20,1344,2029,3,1,3,0,1,0,66.24
臺北市,文山區,木新里,1148,2,1197,21,1218,1873,3,1,3,0,1,0,65.03
臺北市,文山區,木新里,1149,2,1045,17,1062,1604,3,1,3,0,1,0,66.21
臺北市,文山區,木新里,1150,2,1163,7,1170,1744,3,1,3,0,1,0,67.09
臺北市,文山區,木新里,1151,2,998,6,1004,1580,3,1,3,0,1,0,63.54
臺北市,文山區,順興里,1152,2,1279,11,1290,1899,3,1,3,0,1,0,67.93
臺北市,文山區,順興里,1153,2,1542,14,1556,2222,3,1,3,0,1,0,70.03
臺北市,文山區,順興里,1154,2,1496,13,1509,2216,3,1,3,0,1,0,68.10
臺北市,文山區,順興里,1155,2,1102,15,1117,1710,3,1,3,0,1,0,65.32
臺北市,文山區,樟林里,1156,2,1076,9,1085,1689,3,1,3,0,1,0,64.24
臺北市,文山區,樟林里,1157,2,1041,14,1055,1583,3,1,3,0,1,0,66.65
臺北市,文山區,樟林里,1158,2,1028,7,1035,1633,3,1,3,0,1,0,63.38
臺北市,文山區,樟林里,1159,2,1055,9,1064,1603,3,1,3,0,1,0,66.38
臺北市,文山區,樟新里,1160,2,1389,5,1394,2093,3,1,3,0,1,0,66.60
臺北市,文山區,樟新里,1161,2,1426,15,1441,2225,3,1,3,0,1,0,64.76
臺北市,文山區,樟新里,1162,2,1294,8,1302,1978,3,1,3,0,1,0,65.82
臺北市,文山區,樟新里,1163,2,1553,4,1557,2216,3,1,3,0,1,0,70.26
臺北市,文山區,樟腳里,1164,2,1245,67,1312,1962,3,1,3,0,1,0,66.87
臺北市,文山區,樟腳里,1165,2,1206,18,1224,1833,3,1,3,0,1,0,66.78
臺北市,文山區,樟腳里,1166,2,1065,13,1078,1644,3,1,3,0,1,0,65.57
臺北市,文山區,樟腳里,1167,2,1216,20,1236,1800,3,1,3,0,1,0,68.67
臺北市,文山區,萬芳里,1168,2,1099,9,1108,1669,3,1,3,0,1,0,66.39
臺北市,文山區,萬芳里,1169,2,1316,10,1326,1979,3,1,3,0,1,0,67.00
臺北市,文山區,萬芳里,1170,2,1234,15,1249,1812,3,1,3,0,1,0,68.93
臺北市,文山區,萬芳里,1171,2,1122,8,1130,1742,3,1,3,0,1,0,64.87
臺北市,文山區,萬芳里,1172,2,1131,6,1137,1731,3,1,3,0,1,0,65.68
臺北市,文山區,萬芳里,1173,2,1077,10,1087,1642,3,1,3,0,1,0,66.20
臺北市,文山區,博嘉里,1174,2,861,11,872,1361,3,1,3,0,1,0,64.07
臺北市,文山區,博嘉里,1175,2,1128,13,1141,1750,3,1,3,0,1,0,65.20
臺北市,文山區,萬興里,1176,2,1267,8,1275,1966,3,1,3,0,1,0,64.85
臺北市,文山區,萬興里,1177,2,1282,19,1301,1942,3,1,3,0,1,0,66.99
臺北市,文山區,萬興里,1178,2,1369,14,1383,2147,3,1,3,0,1,0,64.42
臺北市,文山區,萬興里,1179,2,1076,2,1078,1555,3,1,3,0,1,0,69.32
臺北市,文山區,指南里,1180,2,1017,15,1032,1559,3,1,3,0,1,0,66.20
臺北市,文山區,指南里,1181,2,447,8,455,719,3,1,3,0,1,0,63.28
臺北市,文山區,老泉里,1182,2,437,6,443,674,3,1,3,0,1,0,65.73
高雄市,鹽埕區,藍橋里,1,1,817,7,824,1229,3,1,3,0,1,0,67.05
高雄市,鹽埕區,慈愛里,2,1,409,2,411,577,3,1,3,0,1,0,71.23
高雄市,鹽埕區,博愛里,3,1,555,11,566,771,3,1,3,0,1,0,73.41
高雄市,鹽埕區,壽星里,4,1,873,5,878,1284,3,1,3,0,1,0,68.38
高雄市,鹽埕區,中山里,5,1,783,3,786,1182,3,1,3,0,1,0,66.50
高雄市,鹽埕區,教仁里,6,1,1502,11,1513,2214,3,1,3,0,1,0,68.34
高雄市,鹽埕區,新樂里,7,1,607,5,612,876,3,1,3,0,1,0,69.86
高雄市,鹽埕區,中原里,8,1,488,4,492,687,3,1,3,0,1,0,71.62
高雄市,鹽埕區,光明里,9,1,738,9,747,1174,3,1,3,0,1,0,63.63
高雄市,鹽埕區,育仁里,10,1,516,3,519,810,3,1,3,0,1,0,64.07
高雄市,鹽埕區,河濱里,11,1,1196,17,1213,1899,3,1,3,0,1,0,63.88
高雄市,鹽埕區,沙地里,12,1,682,6,688,1074,3,1,3,0,1,0,64.06
高雄市,鹽埕區,南端里,13,1,735,7,742,1151,3,1,3,0,1,0,64.47
高雄市,鹽埕區,港都里,14,1,749,5,754,1144,3,1,3,0,1,0,65.91
高雄市,鹽埕區,江西里,15,1,824,8,832,1225,3,1,3,0,1,0,67.92
高雄市,鹽埕區,新豐里,16,1,462,5,467,651,3,1,3,0,1,0,71.74
高雄市,鹽埕區,府北里,17,1,1140,17,1157,1757,3,1,3,0,1,0,65.85
高雄市,鹽埕區,陸橋里,18,1,862,16,878,1297,3,1,3,0,1,0,67.69
高雄市,鹽埕區,瀨南里,19,1,491,4,495,705,3,1,3,0,1,0,70.21
高雄市,鹽埕區,新化里,20,1,524,8,532,773,3,1,3,0,1,0,68.82
高雄市,鹽埕區,江南里,21,1,616,11,627,938,3,1,3,0,1,0,66.84
高雄市,鼓山區,鼓峰里,22,1,1371,16,1387,2040,3,1,3,0,1,0,67.99
高雄市,鼓山區,雄峰里,23,1,1402,19,1421,2065,3,1,3,0,1,0,68.81
高雄市,鼓山區,前峰里,24,1,1497,18,1515,2138,3,1,3,0,1,0,70.86
高雄市,鼓山區,前峰里,25,1,1441,11,1452,2051,3,1,3,0,1,0,70.79
高雄市,鼓山區,光榮里,26,1,1250,11,1261,1877,3,1,3,0,1,0,67.18
高雄市,鼓山區,光榮里,27,1,1402,8,1410,2059,3,1,3,0,1,0,68.48
高雄市,鼓山區,民族里,28,1,1004,13,1017,1450,3,1,3,0,1,0,70.14
高雄市,鼓山區,內惟里,29,1,825,7,832,1185,3,1,3,0,1,0,70.21
高雄市,鼓山區,建國里,30,1,1437,12,1449,2044,3,1,3,0,1,0,70.89
高雄市,鼓山區,忠正里,31,1,1374,12,1386,2086,3,1,3,0,1,0,66.44
高雄市,鼓山區,忠正里,32,1,1236,14,1250,1826,3,1,3,0,1,0,68.46
高雄市,鼓山區,自強里,33,1,593,6,599,849,3,1,3,0,1,0,70.55
高雄市,鼓山區,龍井里,34,1,1075,14,1089,1556,3,1,3,0,1,0,69.99
高雄市,鼓山區,正德里,35,1,1107,16,1123,1669,3,1,3,0,1,0,67.29
高雄市,鼓山區,平和里,36,1,1002,4,1006,1470,3,1,3,0,1,0,68.44
高雄市,鼓山區,平和里,37,1,1088,8,1096,1551,3,1,3,0,1,0,70.66
高雄市,鼓山區,民強里,38,1,1013,5,1018,1442,3,1,3,0,1,0,70.60
高雄市,鼓山區,民強里,39,1,927,13,940,1399,3,1,3,0,1,0,67.19
高雄市,鼓山區,厚生里,40,1,1476,12,1488,2085,3,1,3,0,1,0,71.37
高雄市,鼓山區,龍子里,41,1,1188,14,1202,1822,3,1,3,0,1,0,65.97
高雄市,鼓山區,龍子里,42,1,949,10,959,1703,3,1,3,0,1,0,56.31
高雄市,鼓山區,龍子里,43,1,921,9,930,1485,3,1,3,0,1,0,62.63
高雄市,鼓山區,龍水里,44,1,610,4,614,972,3,1,3,0,1,0,63.17
高雄市,鼓山區,明誠里,45,1,1166,18,1184,1789,3,1,3,0,1,0,66.18
高雄市,鼓山區,明誠里,46,1,1128,8,1136,1710,3,1,3,0,1,0,66.43
高雄市,鼓山區,明誠里,47,1,1147,9,1156,1793,3,1,3,0,1,0,64.47
高雄市,鼓山區,明誠里,48,1,1083,11,1094,1723,3,1,3,0,1,0,63.49
高雄市,鼓山區,明誠里,49,1,1299,7,1306,2152,3,1,3,0,1,0,60.69
高雄市,鼓山區,華豐里,50,1,972,12,984,1385,3,1,3,0,1,0,71.05
高雄市,鼓山區,華豐里,51,1,1145,10,1155,1731,3,1,3,0,1,0,66.72
高雄市,鼓山區,裕興里,52,1,952,9,961,1496,3,1,3,0,1,0,64.24
高雄市,鼓山區,裕興里,53,1,895,10,905,1342,3,1,3,0,1,0,67.44
高雄市,鼓山區,裕豐里,54,1,628,1,629,942,3,1,3,0,1,0,66.77
高雄市,鼓山區,裕豐里,55,1,847,3,850,1327,3,1,3,0,1,0,64.05
高雄市,鼓山區,鼓岩里,56,1,1058,17,1075,1606,3,1,3,0,1,0,66.94
高雄市,鼓山區,樹德里,57,1,664,6,670,963,3,1,3,0,1,0,69.57
高雄市,鼓山區,寶樹里,58,1,645,8,653,992,3,1,3,0,1,0,65.83
高雄市,鼓山區,興宗里,59,1,1041,14,1055,1547,3,1,3,0,1,0,68.20
高雄市,鼓山區,光化里,60,1,1018,13,1031,1580,3,1,3,0,1,0,65.25
高雄市,鼓山區,山下里,61,1,1019,9,1028,1500,3,1,3,0,1,0,68.53
高雄市,鼓山區,河邊里,62,1,1045,14,1059,1545,3,1,3,0,1,0,68.54
高雄市,鼓山區,綠川里,63,1,1093,18,1111,1674,3,1,3,0,1,0,66.37
高雄市,鼓山區,登山里,64,1,563,4,567,839,3,1,3,0,1,0,67.58
高雄市,鼓山區,峰南里,65,1,683,10,693,1083,3,1,3,0,1,0,63.99
高雄市,鼓山區,麗興里,66,1,729,6,735,1165,3,1,3,0,1,0,63.09
高雄市,鼓山區,新民里,67,1,765,13,778,1162,3,1,3,0,1,0,66.95
高雄市,鼓山區,延平里,68,1,613,5,618,934,3,1,3,0,1,0,66.17
高雄市,鼓山區,維生里,69,1,973,17,990,1542,3,1,3,0,1,0,64.20
高雄市,鼓山區,惠安里,70,1,843,6,849,1343,3,1,3,0,1,0,63.22
高雄市,鼓山區,壽山里,71,1,955,15,970,1589,3,1,3,0,1,0,61.04
高雄市,鼓山區,哨船頭里,72,1,803,8,811,1213,3,1,3,0,1,0,66.86
高雄市,鼓山區,桃源里,73,1,427,4,431,638,3,1,3,0,1,0,67.55
高雄市,左營區,進學里,74,1,1098,13,1111,1676,3,1,3,0,1,0,66.29
高雄市,左營區,尾西里,75,1,900,9,909,1271,3,1,3,0,1,0,71.52
高雄市,左營區,頂北里,76,1,425,7,432,636,3,1,3,0,1,0,67.92
高雄市,左營區,中北里,77,1,503,2,505,707,3,1,3,0,1,0,71.43
高雄市,左營區,中南里,78,1,400,9,409,558,3,1,3,0,1,0,73.30
高雄市,左營區,廟東里,79,1,680,9,689,939,3,1,3,0,1,0,73.38
高雄市,左營區,廟北里,80,1,746,13,759,1048,3,1,3,0,1,0,72.42
高雄市,左營區,尾南里,81,1,574,8,582,834,3,1,3,0,1,0,69.78
高雄市,左營區,尾北里,82,1,777,10,787,1108,3,1,3,0,1,0,71.03
高雄市,左營區,尾北里,83,1,1035,11,1046,1481,3,1,3,0,1,0,70.63
高雄市,左營區,海光里,84,1,219,4,223,392,3,1,3,0,1,0,56.89
高雄市,左營區,屏山里,85,1,1020,10,1030,1480,3,1,3,0,1,0,69.59
高雄市,左營區,祥和里,86,1,494,6,500,677,3,1,3,0,1,0,73.86
高雄市,左營區,永清里,87,1,754,13,767,1043,3,1,3,0,1,0,73.54
高雄市,左營區,永清里,88,1,613,7,620,907,3,1,3,0,1,0,68.36
高雄市,左營區,復興里,89,1,898,9,907,1273,3,1,3,0,1,0,71.25
高雄市,左營區,莒光里,90,1,1159,10,1169,1680,3,1,3,0,1,0,69.58
高雄市,左營區,光輝里,91,1,817,13,830,1219,3,1,3,0,1,0,68.09
高雄市,左營區,光輝里,92,1,896,8,904,1346,3,1,3,0,1,0,67.16
高雄市,左營區,合群里,93,1,926,3,929,1327,3,1,3,0,1,0,70.01
高雄市,左營區,自治里,94,1,627,4,631,881,3,1,3,0,1,0,71.62
高雄市,左營區,自治里,95,1,679,5,684,946,3,1,3,0,1,0,72.30
高雄市,左營區,明建里,96,1,1036,14,1050,1471,3,1,3,0,1,0,71.38
高雄市,左營區,自立里,97,1,676,3,679,942,3,1,3,0,1,0,72.08
高雄市,左營區,頂西里,98,1,869,7,876,1196,3,1,3,0,1,0,73.24
高雄市,左營區,聖后里,99,1,667,8,675,980,3,1,3,0,1,0,68.88
高雄市,左營區,聖西里,100,1,308,6,314,428,3,1,3,0,1,0,73.36
高雄市,左營區,聖南里,101,1,401,5,406,580,3,1,3,0,1,0,70.00
高雄市,左營區,城南里,102,1,400,0,400,588,3,1,3,0,1,0,68.03
高雄市,左營區,路東里,103,1,555,1,556,803,3,1,3,0,1,0,69.24
高雄市,左營區,廍北里,104,1,393,5,398,550,3,1,3,0,1,0,72.36
高雄市,左營區,廍南里,105,1,569,2,571,789,3,1,3,0,1,0,72.37
高雄市,左營區,埤西里,106,1,798,8,806,1129,3,1,3,0,1,0,71.39
高雄市,左營區,埤北里,107,1,961,9,970,1457,3,1,3,0,1,0,66.58
高雄市,左營區,埤東里,108,1,879,12,891,1271,3,1,3,0,1,0,70.10
高雄市,左營區,海勝里,109,1,1032,10,1042,1474,3,1,3,0,1,0,70.69
高雄市,左營區,海勝里,110,1,1391,14,1405,1832,3,1,3,0,1,0,76.69
高雄市,左營區,自勉里,111,1,1247,19,1266,1723,3,1,3,0,1,0,73.48
高雄市,左營區,崇實里,112,1,831,8,839,1116,3,1,3,0,1,0,75.18
高雄市,左營區,自助里,113,1,1023,8,1031,1423,3,1,3,0,1,0,72.45
高雄市,左營區,自助里,114,1,657,8,665,933,3,1,3,0,1,0,71.28
高雄市,左營區,果貿里,115,1,1415,13,1428,1948,3,1,3,0,1,0,73.31
高雄市,左營區,果惠里,116,1,1079,12,1091,1597,3,1,3,0,1,0,68.32
高雄市,左營區,果峰里,117,1,1268,14,1282,1786,3,1,3,0,1,0,71.78
高雄市,左營區,新下里,118,1,1123,5,1128,1704,3,1,3,0,1,0,66.20
高雄市,左營區,新下里,119,1,1092,7,1099,1748,3,1,3,0,1,0,62.87
高雄市,左營區,新下里,120,1,938,7,945,1482,3,1,3,0,1,0,63.77
高雄市,左營區,新下里,121,1,1013,7,1020,1653,3,1,3,0,1,0,61.71
高雄市,左營區,新下里,122,1,1401,14,1415,2151,3,1,3,0,1,0,65.78
高雄市,左營區,新上里,123,1,817,5,822,1246,3,1,3,0,1,0,65.97
高雄市,左營區,新上里,124,1,922,16,938,1394,3,1,3,0,1,0,67.29
高雄市,左營區,新上里,125,1,1156,10,1166,1849,3,1,3,0,1,0,63.06
高雄市,左營區,新上里,126,1,1107,11,1118,1751,3,1,3,0,1,0,63.85
高雄市,左營區,新上里,127,1,902,10,912,1651,3,1,3,0,1,0,55.24
高雄市,左營區,新上里,128,1,970,3,973,1608,3,1,3,0,1,0,60.51
高雄市,左營區,新上里,129,1,1111,8,1119,1789,3,1,3,0,1,0,62.55
高雄市,左營區,新上里,130,1,1032,13,1045,1781,3,1,3,0,1,0,58.67
高雄市,左營區,新上里,131,1,1017,9,1026,1709,3,1,3,0,1,0,60.04
高雄市,左營區,新上里,132,1,1095,7,1102,1849,3,1,3,0,1,0,59.60
高雄市,左營區,新中里,133,1,1085,8,1093,1625,3,1,3,0,1,0,67.26
高雄市,左營區,新中里,134,1,846,8,854,1277,3,1,3,0,1,0,66.88
高雄市,左營區,新中里,135,1,932,11,943,1448,3,1,3,0,1,0,65.12
高雄市,左營區,新光里,136,1,1212,9,1221,1857,3,1,3,0,1,0,65.75
高雄市,左營區,新光里,137,1,1188,10,1198,1961,3,1,3,0,1,0,61.09
高雄市,左營區,新光里,138,1,1248,15,1263,1981,3,1,3,0,1,0,63.76
高雄市,左營區,新光里,139,1,1258,6,1264,1950,3,1,3,0,1,0,64.82
高雄市,左營區,菜公里,140,1,1056,7,1063,1793,3,1,3,0,1,0,59.29
高雄市,左營區,菜公里,141,1,989,6,995,1715,3,1,3,0,1,0,58.02
高雄市,左營區,菜公里,142,1,1114,9,1123,1824,3,1,3,0,1,0,61.57
高雄市,左營區,菜公里,143,1,1120,10,1130,1800,3,1,3,0,1,0,62.78
高雄市,左營區,菜公里,144,1,1137,13,1150,1856,3,1,3,0,1,0,61.96
高雄市,左營區,菜公里,145,1,1073,8,1081,1677,3,1,3,0,1,0,64.46
高雄市,左營區,菜公里,146,1,1174,9,1183,1901,3,1,3,0,1,0,62.23
高雄市,左營區,菜公里,147,1,1112,3,1115,1780,3,1,3,0,1,0,62.64
高雄市,左營區,福山里,148,1,803,4,807,1324,3,1,3,0,1,0,60.95
高雄市,左營區,福山里,149,1,886,16,902,1559,3,1,3,0,1,0,57.86
高雄市,左營區,福山里,150,1,956,10,966,1622,3,1,3,0,1,0,59.56
高雄市,左營區,福山里,151,1,1105,10,1115,1848,3,1,3,0,1,0,60.34
高雄市,左營區,福山里,152,1,1079,7,1086,1824,3,1,3,0,1,0,59.54
高雄市,左營區,福山里,153,1,1198,7,1205,2076,3,1,3,0,1,0,58.04
高雄市,左營區,福山里,154,1,1031,13,1044,1776,3,1,3,0,1,0,58.78
高雄市,左營區,福山里,155,1,1038,9,1047,1718,3,1,3,0,1,0,60.94
高雄市,左營區,福山里,156,1,1308,15,1323,2283,3,1,3,0,1,0,57.95
高雄市,左營區,福山里,157,1,580,4,584,930,3,1,3,0,1,0,62.80
高雄市,楠梓區,清豐里,158,1,1115,15,1130,1698,3,1,3,0,1,0,66.55
高雄市,楠梓區,清豐里,159,1,983,14,997,1632,3,1,3,0,1,0,61.09
高雄市,楠梓區,清豐里,160,1,872,12,884,1501,3,1,3,0,1,0,58.89
高雄市,楠梓區,清豐里,161,1,808,4,812,1374,3,1,3,0,1,0,59.10
高雄市,楠梓區,清豐里,162,1,923,8,931,1484,3,1,3,0,1,0,62.74
高雄市,楠梓區,東寧里,163,1,705,5,710,1130,3,1,3,0,1,0,62.83
高雄市,楠梓區,東寧里,164,1,645,7,652,992,3,1,3,0,1,0,65.73
高雄市,楠梓區,五常里,165,1,776,3,779,1240,3,1,3,0,1,0,62.82
高雄市,楠梓區,五常里,166,1,752,14,766,1163,3,1,3,0,1,0,65.86
高雄市,楠梓區,五常里,167,1,956,16,972,1642,3,1,3,0,1,0,59.20
高雄市,楠梓區,享平里,168,1,856,9,865,1266,3,1,3,0,1,0,68.33
高雄市,楠梓區,享平里,169,1,772,5,777,1349,3,1,3,0,1,0,57.60
高雄市,楠梓區,中陽里,170,1,893,11,904,1377,3,1,3,0,1,0,65.65
高雄市,楠梓區,中陽里,171,1,762,6,768,1201,3,1,3,0,1,0,63.95
高雄市,楠梓區,惠楠里,172,1,684,11,695,1152,3,1,3,0,1,0,60.33
高雄市,楠梓區,惠楠里,173,1,742,11,753,1192,3,1,3,0,1,0,63.17
高雄市,楠梓區,惠民里,174,1,1026,14,1040,1545,3,1,3,0,1,0,67.31
高雄市,楠梓區,惠民里,175,1,1110,9,1119,1586,3,1,3,0,1,0,70.55
高雄市,楠梓區,惠豐里,176,1,641,8,649,1044,3,1,3,0,1,0,62.16
高雄市,楠梓區,惠豐里,177,1,866,11,877,1370,3,1,3,0,1,0,64.01
高雄市,楠梓區,錦屏里,178,1,1135,6,1141,1645,3,1,3,0,1,0,69.36
高雄市,楠梓區,錦屏里,179,1,1203,6,1209,1712,3,1,3,0,1,0,70.62
高雄市,楠梓區,玉屏里,180,1,1575,22,1597,2273,3,1,3,0,1,0,70.26
高雄市,楠梓區,金田里,181,1,1078,11,1089,1600,3,1,3,0,1,0,68.06
高雄市,楠梓區,金田里,182,1,1051,9,1060,1523,3,1,3,0,1,0,69.60
高雄市,楠梓區,稔田里,183,1,1068,13,1081,1623,3,1,3,0,1,0,66.61
高雄市,楠梓區,瑞屏里,184,1,980,15,995,1503,3,1,3,0,1,0,66.20
高雄市,楠梓區,瑞屏里,185,1,1016,17,1033,1573,3,1,3,0,1,0,65.67
高雄市,楠梓區,翠屏里,186,1,1131,15,1146,1791,3,1,3,0,1,0,63.99
高雄市,楠梓區,翠屏里,187,1,1054,7,1061,1647,3,1,3,0,1,0,64.42
高雄市,楠梓區,翠屏里,188,1,994,9,1003,1600,3,1,3,0,1,0,62.69
高雄市,楠梓區,翠屏里,189,1,1078,10,1088,1802,3,1,3,0,1,0,60.38
高雄市,楠梓區,翠屏里,190,1,1112,10,1122,1748,3,1,3,0,1,0,64.19
高雄市,楠梓區,翠屏里,191,1,1301,9,1310,2050,3,1,3,0,1,0,63.90
高雄市,楠梓區,宏南里,192,1,1171,9,1180,1673,3,1,3,0,1,0,70.53
高雄市,楠梓區,宏毅里,193,1,1039,10,1049,1473,3,1,3,0,1,0,71.22
高雄市,楠梓區,宏毅里,194,1,1044,11,1055,1414,3,1,3,0,1,0,74.61
高雄市,楠梓區,宏榮里,195,1,1384,13,1397,1833,3,1,3,0,1,0,76.21
高雄市,楠梓區,廣昌里,196,1,983,12,995,1391,3,1,3,0,1,0,71.53
高雄市,楠梓區,廣昌里,197,1,1095,12,1107,1592,3,1,3,0,1,0,69.54
高雄市,楠梓區,久昌里,198,1,1326,19,1345,2148,3,1,3,0,1,0,62.62
高雄市,楠梓區,大昌里,199,1,1376,15,1391,2034,3,1,3,0,1,0,68.39
高雄市,楠梓區,福昌里,200,1,1286,12,1298,1795,3,1,3,0,1,0,72.31
高雄市,楠梓區,盛昌里,201,1,1043,4,1047,1461,3,1,3,0,1,0,71.66
高雄市,楠梓區,盛昌里,202,1,1320,6,1326,1961,3,1,3,0,1,0,67.62
高雄市,楠梓區,泰昌里,203,1,1018,9,1027,1526,3,1,3,0,1,0,67.30
高雄市,楠梓區,興昌里,204,1,878,4,882,1263,3,1,3,0,1,0,69.83
高雄市,楠梓區,興昌里,205,1,889,8,897,1387,3,1,3,0,1,0,64.67
高雄市,楠梓區,建昌里,206,1,1515,16,1531,2256,3,1,3,0,1,0,67.86
高雄市,楠梓區,宏昌里,207,1,1355,10,1365,2125,3,1,3,0,1,0,64.24
高雄市,楠梓區,和昌里,208,1,1483,12,1495,2097,3,1,3,0,1,0,71.29
高雄市,楠梓區,慶昌里,209,1,1127,3,1130,1576,3,1,3,0,1,0,71.70
高雄市,楠梓區,慶昌里,210,1,974,7,981,1444,3,1,3,0,1,0,67.94
高雄市,楠梓區,隆昌里,211,1,1108,13,1121,1628,3,1,3,0,1,0,68.86
高雄市,楠梓區,隆昌里,212,1,1088,16,1104,1578,3,1,3,0,1,0,69.96
高雄市,楠梓區,秀昌里,213,1,1267,19,1286,1945,3,1,3,0,1,0,66.12
高雄市,楠梓區,裕昌里,214,1,1637,17,1654,2454,3,1,3,0,1,0,67.40
高雄市,楠梓區,國昌里,215,1,925,17,942,1429,3,1,3,0,1,0,65.92
高雄市,楠梓區,國昌里,216,1,856,5,861,1357,3,1,3,0,1,0,63.45
高雄市,楠梓區,加昌里,217,1,1243,13,1256,1800,3,1,3,0,1,0,69.78
高雄市,楠梓區,加昌里,218,1,1177,11,1188,1794,3,1,3,0,1,0,66.22
高雄市,楠梓區,加昌里,219,1,1135,7,1142,1728,3,1,3,0,1,0,66.09
高雄市,楠梓區,仁昌里,220,1,852,6,858,1329,3,1,3,0,1,0,64.56
高雄市,楠梓區,仁昌里,221,1,1136,9,1145,1810,3,1,3,0,1,0,63.26
高雄市,楠梓區,藍田里,222,1,643,1,644,896,3,1,3,0,1,0,71.88
高雄市,楠梓區,中興里,223,1,550,3,553,834,3,1,3,0,1,0,66.31
高雄市,楠梓區,中和里,224,1,1023,4,1027,1460,3,1,3,0,1,0,70.34
高雄市,三民區,鼎金里,225,1,898,13,911,1457,3,1,3,0,1,0,62.53
高雄市,三民區,鼎金里,226,1,863,8,871,1463,3,1,3,0,1,0,59.54
高雄市,三民區,鼎盛里,227,1,809,4,813,1285,3,1,3,0,1,0,63.27
高雄市,三民區,鼎盛里,228,1,825,9,834,1235,3,1,3,0,1,0,67.53
高雄市,三民區,鼎盛里,229,1,861,6,867,1358,3,1,3,0,1,0,63.84
高雄市,三民區,鼎盛里,230,1,867,7,874,1359,3,1,3,0,1,0,64.31
高雄市,三民區,鼎強里,231,1,1172,9,1181,1795,3,1,3,0,1,0,65.79
高雄市,三民區,鼎強里,232,1,1004,8,1012,1554,3,1,3,0,1,0,65.12
高雄市,三民區,鼎力里,233,1,1019,4,1023,1551,3,1,3,0,1,0,65.96
高雄市,三民區,鼎力里,234,1,1102,10,1112,1714,3,1,3,0,1,0,64.88
高雄市,三民區,鼎西里,235,1,921,13,934,1491,3,1,3,0,1,0,62.64
高雄市,三民區,鼎西里,236,1,1020,8,1028,1589,3,1,3,0,1,0,64.69
高雄市,三民區,鼎西里,237,1,992,8,1000,1656,3,1,3,0,1,0,60.39
高雄市,三民區,鼎中里,238,1,1036,35,1071,1493,3,1,3,0,1,0,71.73
高雄市,三民區,鼎中里,239,1,1058,7,1065,1474,3,1,3,0,1,0,72.25
高雄市,三民區,鼎泰里,240,1,1018,14,1032,1653,3,1,3,0,1,0,62.43
高雄市,三民區,鼎泰里,241,1,925,11,936,1581,3,1,3,0,1,0,59.20
高雄市,三民區,鼎泰里,242,1,1077,7,1084,1618,3,1,3,0,1,0,67.00
高雄市,三民區,鼎泰里,243,1,977,10,987,1613,3,1,3,0,1,0,61.19
高雄市,三民區,鼎泰里,244,1,1189,6,1195,1924,3,1,3,0,1,0,62.11
高雄市,三民區,鼎泰里,245,1,984,6,990,1812,3,1,3,0,1,0,54.64
高雄市,三民區,鼎泰里,246,1,1039,4,1043,1621,3,1,3,0,1,0,64.34
高雄市,三民區,鼎泰里,247,1,1028,5,1033,1761,3,1,3,0,1,0,58.66
高雄市,三民區,鼎泰里,248,1,965,5,970,1682,3,1,3,0,1,0,57.67
高雄市,三民區,本舘里,249,1,1144,13,1157,1820,3,1,3,0,1,0,63.57
高雄市,三民區,本舘里,250,1,1166,15,1181,1772,3,1,3,0,1,0,66.65
高雄市,三民區,本舘里,251,1,1113,10,1123,1732,3,1,3,0,1,0,64.84
高雄市,三民區,本舘里,252,1,1141,9,1150,1751,3,1,3,0,1,0,65.68
高雄市,三民區,本和里,253,1,1208,14,1222,1749,3,1,3,0,1,0,69.87
高雄市,三民區,本和里,254,1,1163,11,1174,1758,3,1,3,0,1,0,66.78
高雄市,三民區,本和里,255,1,1086,8,1094,1790,3,1,3,0,1,0,61.12
高雄市,三民區,本文里,256,1,710,9,719,1079,3,1,3,0,1,0,66.64
高雄市,三民區,本文里,257,1,624,9,633,923,3,1,3,0,1,0,68.58
高雄市,三民區,本武里,258,1,999,11,1010,1469,3,1,3,0,1,0,68.75
高雄市,三民區,本元里,259,1,897,6,903,1364,3,1,3,0,1,0,66.20
高雄市,三民區,本元里,260,1,910,9,919,1384,3,1,3,0,1,0,66.40
高雄市,三民區,本元里,261,1,897,9,906,1337,3,1,3,0,1,0,67.76
高雄市,三民區,本安里,262,1,690,3,693,1054,3,1,3,0,1,0,65.75
高雄市,三民區,本安里,263,1,770,6,776,1154,3,1,3,0,1,0,67.24
高雄市,三民區,本安里,264,1,818,12,830,1214,3,1,3,0,1,0,68.37
高雄市,三民區,本上里,265,1,833,8,841,1180,3,1,3,0,1,0,71.27
高雄市,三民區,本上里,266,1,812,9,821,1246,3,1,3,0,1,0,65.89
高雄市,三民區,本上里,267,1,908,8,916,1348,3,1,3,0,1,0,67.95
高雄市,三民區,本揚里,268,1,988,5,993,1530,3,1,3,0,1,0,64.90
高雄市,三民區,本揚里,269,1,876,15,891,1438,3,1,3,0,1,0,61.96
高雄市,三民區,本揚里,270,1,1014,10,1024,1583,3,1,3,0,1,0,64.69
高雄市,三民區,本揚里,271,1,861,6,867,1412,3,1,3,0,1,0,61.40
高雄市,三民區,寶獅里,272,1,1071,10,1081,1736,3,1,3,0,1,0,62.27
高雄市,三民區,寶獅里,273,1,1003,12,1015,1620,3,1,3,0,1,0,62.65
高雄市,三民區,寶德里,274,1,804,7,811,1281,3,1,3,0,1,0,63.31
高雄市,三民區,寶德里,275,1,951,9,960,1548,3,1,3,0,1,0,62.02
高雄市,三民區,寶德里,276,1,967,12,979,1508,3,1,3,0,1,0,64.92
高雄市,三民區,寶泰里,277,1,826,8,834,1303,3,1,3,0,1,0,64.01
高雄市,三民區,寶泰里,278,1,734,9,743,1293,3,1,3,0,1,0,57.46
高雄市,三民區,寶興里,279,1,801,3,804,1264,3,1,3,0,1,0,63.61
高雄市,三民區,寶興里,280,1,818,9,827,1279,3,1,3,0,1,0,64.66
高雄市,三民區,寶興里,281,1,810,8,818,1249,3,1,3,0,1,0,65.49
高雄市,三民區,寶興里,282,1,766,7,773,1213,3,1,3,0,1,0,63.73
高雄市,三民區,寶中里,283,1,859,3,862,1270,3,1,3,0,1,0,67.87
高雄市,三民區,寶中里,284,1,937,6,943,1298,3,1,3,0,1,0,72.65
高雄市,三民區,寶華里,285,1,857,10,867,1279,3,1,3,0,1,0,67.79
高雄市,三民區,寶華里,286,1,875,5,880,1308,3,1,3,0,1,0,67.28
高雄市,三民區,寶國里,287,1,912,5,917,1525,3,1,3,0,1,0,60.13
高雄市,三民區,寶國里,288,1,890,6,896,1396,3,1,3,0,1,0,64.18
高雄市,三民區,寶國里,289,1,881,8,889,1326,3,1,3,0,1,0,67.04
高雄市,三民區,寶國里,290,1,878,13,891,1348,3,1,3,0,1,0,66.10
高雄市,三民區,寶民里,291,1,846,11,857,1232,3,1,3,0,1,0,69.56
高雄市,三民區,寶民里,292,1,796,4,800,1236,3,1,3,0,1,0,64.72
高雄市,三民區,寶慶里,293,1,749,8,757,1151,3,1,3,0,1,0,65.77
高雄市,三民區,寶慶里,294,1,727,6,733,1151,3,1,3,0,1,0,63.68
高雄市,三民區,寶業里,295,1,691,7,698,1137,3,1,3,0,1,0,61.39
高雄市,三民區,寶業里,296,1,772,6,778,1302,3,1,3,0,1,0,59.75
高雄市,三民區,寶業里,297,1,795,6,801,1248,3,1,3,0,1,0,64.18
高雄市,三民區,寶盛里,298,1,774,7,781,1180,3,1,3,0,1,0,66.19
高雄市,三民區,寶盛里,299,1,826,7,833,1206,3,1,3,0,1,0,69.07
高雄市,三民區,寶盛里,300,1,875,3,878,1356,3,1,3,0,1,0,64.75
高雄市,三民區,寶安里,301,1,1219,14,1233,1882,3,1,3,0,1,0,65.52
高雄市,三民區,寶安里,302,1,1061,9,1070,1773,3,1,3,0,1,0,60.35
高雄市,三民區,寶安里,303,1,1066,8,1074,1761,3,1,3,0,1,0,60.99
高雄市,三民區,寶龍里,304,1,931,15,946,1390,3,1,3,0,1,0,68.06
高雄市,三民區,寶龍里,305,1,830,17,847,1213,3,1,3,0,1,0,69.83
高雄市,三民區,寶龍里,306,1,747,10,757,1183,3,1,3,0,1,0,63.99
高雄市,三民區,寶珠里,307,1,868,9,877,1490,3,1,3,0,1,0,58.86
高雄市,三民區,寶珠里,308,1,878,9,887,1450,3,1,3,0,1,0,61.17
高雄市,三民區,寶珠里,309,1,971,16,987,1510,3,1,3,0,1,0,65.36
高雄市,三民區,寶玉里,310,1,896,6,902,1430,3,1,3,0,1,0,63.08
高雄市,三民區,寶玉里,311,1,921,5,926,1520,3,1,3,0,1,0,60.92
高雄市,三民區,寶玉里,312,1,958,11,969,1579,3,1,3,0,1,0,61.37
高雄市,三民區,寶玉里,313,1,913,6,919,1540,3,1,3,0,1,0,59.68
高雄市,三民區,灣子里,314,1,865,6,871,1403,3,1,3,0,1,0,62.08
高雄市,三民區,灣子里,315,1,827,3,830,1353,3,1,3,0,1,0,61.35
高雄市,三民區,灣愛里,316,1,830,10,840,1357,3,1,3,0,1,0,61.90
高雄市,三民區,灣愛里,317,1,824,10,834,1383,3,1,3,0,1,0,60.30
高雄市,三民區,灣中里,318,1,900,7,907,1466,3,1,3,0,1,0,61.87
高雄市,三民區,灣中里,319,1,780,13,793,1320,3,1,3,0,1,0,60.08
高雄市,三民區,灣中里,320,1,786,9,795,1249,3,1,3,0,1,0,63.65
高雄市,三民區,灣華里,321,1,691,2,693,1121,3,1,3,0,1,0,61.82
高雄市,三民區,灣華里,322,1,827,8,835,1235,3,1,3,0,1,0,67.61
高雄市,三民區,灣勝里,323,1,653,12,665,965,3,1,3,0,1,0,68.91
高雄市,三民區,灣勝里,324,1,663,6,669,1041,3,1,3,0,1,0,64.27
高雄市,三民區,灣利里,325,1,1052,12,1064,1681,3,1,3,0,1,0,63.30
高雄市,三民區,灣利里,326,1,1071,10,1081,1602,3,1,3,0,1,0,67.48
高雄市,三民區,灣復里,327,1,947,1,948,1421,3,1,3,0,1,0,66.71
高雄市,三民區,灣復里,328,1,804,5,809,1420,3,1,3,0,1,0,56.97
高雄市,三民區,正興里,329,1,1071,12,1083,1742,3,1,3,0,1,0,62.17
高雄市,三民區,正興里,330,1,1171,12,1183,1820,3,1,3,0,1,0,65.00
高雄市,三民區,正興里,331,1,952,7,959,1636,3,1,3,0,1,0,58.62
高雄市,三民區,正興里,332,1,885,5,890,1483,3,1,3,0,1,0,60.01
高雄市,三民區,正興里,333,1,804,6,810,1366,3,1,3,0,1,0,59.30
高雄市,三民區,正順里,334,1,961,1,962,1550,3,1,3,0,1,0,62.06
高雄市,三民區,正順里,335,1,1066,7,1073,1600,3,1,3,0,1,0,67.06
高雄市,三民區,灣興里,336,1,1013,12,1025,1545,3,1,3,0,1,0,66.34
高雄市,三民區,灣成里,337,1,1048,8,1056,1597,3,1,3,0,1,0,66.12
高雄市,三民區,安康里,338,1,947,12,959,1492,3,1,3,0,1,0,64.28
高雄市,三民區,安康里,339,1,977,8,985,1538,3,1,3,0,1,0,64.04
高雄市,三民區,安寧里,340,1,615,13,628,994,3,1,3,0,1,0,63.18
高雄市,三民區,安寧里,341,1,657,12,669,1052,3,1,3,0,1,0,63.59
高雄市,三民區,安吉里,342,1,714,4,718,1293,3,1,3,0,1,0,55.53
高雄市,三民區,安吉里,343,1,694,5,699,1206,3,1,3,0,1,0,57.96
高雄市,三民區,安吉里,344,1,854,7,861,1341,3,1,3,0,1,0,64.21
高雄市,三民區,安發里,345,1,834,5,839,1313,3,1,3,0,1,0,63.90
高雄市,三民區,安發里,346,1,821,8,829,1317,3,1,3,0,1,0,62.95
高雄市,三民區,安發里,347,1,801,7,808,1271,3,1,3,0,1,0,63.57
高雄市,三民區,安東里,348,1,1130,5,1135,1567,3,1,3,0,1,0,72.43
高雄市,三民區,安東里,349,1,1063,13,1076,1619,3,1,3,0,1,0,66.46
高雄市,三民區,安和里,350,1,922,7,929,1303,3,1,3,0,1,0,71.30
高雄市,三民區,安和里,351,1,908,7,915,1327,3,1,3,0,1,0,68.95
高雄市,三民區,達德里,352,1,1072,4,1076,1502,3,1,3,0,1,0,71.64
高雄市,三民區,達明里,353,1,1145,16,1161,1667,3,1,3,0,1,0,69.65
高雄市,三民區,達仁里,354,1,994,6,1000,1436,3,1,3,0,1,0,69.64
高雄市,三民區,達勇里,355,1,746,8,754,1065,3,1,3,0,1,0,70.80
高雄市,三民區,同德里,356,1,893,7,900,1423,3,1,3,0,1,0,63.25
高雄市,三民區,同德里,357,1,873,12,885,1386,3,1,3,0,1,0,63.85
高雄市,三民區,德智里,358,1,801,10,811,1198,3,1,3,0,1,0,67.70
高雄市,三民區,德智里,359,1,782,1,783,1231,3,1,3,0,1,0,63.61
高雄市,三民區,德仁里,360,1,546,1,547,935,3,1,3,0,1,0,58.50
高雄市,三民區,德仁里,361,1,599,6,605,972,3,1,3,0,1,0,62.24
高雄市,三民區,安生里,362,1,1170,12,1182,1716,3,1,3,0,1,0,68.88
高雄市,三民區,德東里,363,1,607,10,617,885,3,1,3,0,1,0,69.72
高雄市,三民區,德行里,364,1,761,7,768,1090,3,1,3,0,1,0,70.46
高雄市,三民區,精華里,365,1,554,7,561,783,3,1,3,0,1,0,71.65
高雄市,三民區,精華里,366,1,581,9,590,845,3,1,3,0,1,0,69.82
高雄市,三民區,民享里,367,1,707,7,714,1009,3,1,3,0,1,0,70.76
高雄市,三民區,民享里,368,1,746,4,750,1051,3,1,3,0,1,0,71.36
高雄市,三民區,安宜里,369,1,1111,11,1122,1638,3,1,3,0,1,0,68.50
高雄市,三民區,安宜里,370,1,1077,11,1088,1569,3,1,3,0,1,0,69.34
高雄市,三民區,安泰里,371,1,877,16,893,1346,3,1,3,0,1,0,66.34
高雄市,三民區,安泰里,372,1,774,7,781,1165,3,1,3,0,1,0,67.04
高雄市,三民區,安泰里,373,1,893,9,902,1478,3,1,3,0,1,0,61.03
高雄市,三民區,安邦里,374,1,681,7,688,1229,3,1,3,0,1,0,55.98
高雄市,三民區,安邦里,375,1,903,5,908,1270,3,1,3,0,1,0,71.50
高雄市,三民區,安邦里,376,1,745,4,749,1152,3,1,3,0,1,0,65.02
高雄市,三民區,十全里,377,1,1070,14,1084,1562,3,1,3,0,1,0,69.40
高雄市,三民區,十美里,378,1,552,4,556,819,3,1,3,0,1,0,67.89
高雄市,三民區,十美里,379,1,627,8,635,899,3,1,3,0,1,0,70.63
高雄市,三民區,德北里,380,1,617,4,621,963,3,1,3,0,1,0,64.49
高雄市,三民區,德北里,381,1,759,10,769,1117,3,1,3,0,1,0,68.85
高雄市,三民區,立誠里,382,1,683,8,691,957,3,1,3,0,1,0,72.20
高雄市,三民區,立業里,383,1,735,21,756,1100,3,1,3,0,1,0,68.73
高雄市,三民區,港東里,384,1,811,4,815,1341,3,1,3,0,1,0,60.78
高雄市,三民區,港新里,385,1,892,9,901,1459,3,1,3,0,1,0,61.75
高雄市,三民區,港西里,386,1,526,14,540,850,3,1,3,0,1,0,63.53
高雄市,三民區,港北里,387,1,355,3,358,477,3,1,3,0,1,0,75.05
高雄市,三民區,博愛里,388,1,760,8,768,1186,3,1,3,0,1,0,64.76
高雄市,三民區,博惠里,389,1,849,7,856,1332,3,1,3,0,1,0,64.26
高雄市,三民區,博惠里,390,1,844,14,858,1349,3,1,3,0,1,0,63.60
高雄市,三民區,博惠里,391,1,801,4,805,1287,3,1,3,0,1,0,62.55
高雄市,三民區,長明里,392,1,812,7,819,1219,3,1,3,0,1,0,67.19
高雄市,三民區,建東里,393,1,600,6,606,1075,3,1,3,0,1,0,56.37
高雄市,三民區,興德里,394,1,1072,2,1074,1616,3,1,3,0,1,0,66.46
高雄市,三民區,鳳南里,395,1,818,6,824,1146,3,1,3,0,1,0,71.90
高雄市,三民區,鳳北里,396,1,691,6,697,983,3,1,3,0,1,0,70.91
高雄市,三民區,鳳北里,397,1,676,8,684,993,3,1,3,0,1,0,68.88
高雄市,三民區,德西里,398,1,836,18,854,1251,3,1,3,0,1,0,68.27
高雄市,三民區,九如里,399,1,297,4,301,443,3,1,3,0,1,0,67.95
高雄市,三民區,豐裕里,400,1,972,7,979,1409,3,1,3,0,1,0,69.48
高雄市,三民區,豐裕里,401,1,864,17,881,1273,3,1,3,0,1,0,69.21
高雄市,三民區,川東里,402,1,628,6,634,935,3,1,3,0,1,0,67.81
高雄市,三民區,川東里,403,1,630,11,641,922,3,1,3,0,1,0,69.52
高雄市,三民區,裕民里,404,1,539,10,549,769,3,1,3,0,1,0,71.39
高雄市,三民區,力行里,405,1,884,2,886,1179,3,1,3,0,1,0,75.15
高雄市,三民區,千歲里,406,1,817,9,826,1196,3,1,3,0,1,0,69.06
高雄市,三民區,立德里,407,1,879,9,888,1354,3,1,3,0,1,0,65.58
高雄市,三民區,千北里,408,1,871,6,877,1302,3,1,3,0,1,0,67.36
高雄市,三民區,千秋里,409,1,789,10,799,1235,3,1,3,0,1,0,64.70
高雄市,三民區,千秋里,410,1,790,6,796,1182,3,1,3,0,1,0,67.34
高雄市,旗津區,旗下里,411,1,848,5,853,1258,3,1,3,0,1,0,67.81
高雄市,旗津區,永安里,412,1,691,12,703,1101,3,1,3,0,1,0,63.85
高雄市,旗津區,振興里,413,1,1047,12,1059,1654,3,1,3,0,1,0,64.03
高雄市,旗津區,慈愛里,414,1,695,13,708,1100,3,1,3,0,1,0,64.36
高雄市,旗津區,慈愛里,415,1,588,13,601,952,3,1,3,0,1,0,63.13
高雄市,旗津區,復興里,416,1,941,19,960,1428,3,1,3,0,1,0,67.23
高雄市,旗津區,復興里,417,1,890,15,905,1388,3,1,3,0,1,0,65.20
高雄市,旗津區,中華里,418,1,857,13,870,1221,3,1,3,0,1,0,71.25
高雄市,旗津區,實踐里,419,1,846,9,855,1370,3,1,3,0,1,0,62.41
高雄市,旗津區,北汕里,420,1,698,22,720,1124,3,1,3,0,1,0,64.06
高雄市,旗津區,北汕里,421,1,742,7,749,1162,3,1,3,0,1,0,64.46
高雄市,旗津區,南汕里,422,1,1073,15,1088,1685,3,1,3,0,1,0,64.57
高雄市,旗津區,上竹里,423,1,489,2,491,878,3,1,3,0,1,0,55.92
高雄市,旗津區,上竹里,424,1,909,10,919,1658,3,1,3,0,1,0,55.43
高雄市,旗津區,中洲里,425,1,1029,16,1045,1634,3,1,3,0,1,0,63.95
高雄市,旗津區,安順里,426,1,554,7,561,1019,3,1,3,0,1,0,55.05
高雄市,旗津區,中興里,427,1,680,5,685,1045,3,1,3,0,1,0,65.55
高雄市,旗津區,中興里,428,1,690,4,694,1063,3,1,3,0,1,0,65.29
高雄市,新興區,浩然里,429,2,727,8,735,1066,3,1,3,0,1,0,68.95
高雄市,新興區,浩然里,430,2,594,7,601,853,3,1,3,0,1,0,70.46
高雄市,新興區,振成里,431,2,805,10,815,1295,3,1,3,0,1,0,62.93
高雄市,新興區,德生里,432,2,862,5,867,1407,3,1,3,0,1,0,61.62
高雄市,新興區,德生里,433,2,493,5,498,803,3,1,3,0,1,0,62.02
高雄市,新興區,振華里,434,2,819,7,826,1239,3,1,3,0,1,0,66.67
高雄市,新興區,正氣里,435,2,1083,12,1095,1575,3,1,3,0,1,0,69.52
高雄市,新興區,德政里,436,2,503,8,511,747,3,1,3,0,1,0,68.41
高雄市,新興區,仁聲里,437,2,507,6,513,802,3,1,3,0,1,0,63.97
高雄市,新興區,德望里,438,2,1217,13,1230,1931,3,1,3,0,1,0,63.70
高雄市,新興區,華聲里,439,2,716,4,720,1069,3,1,3,0,1,0,67.35
高雄市,新興區,蕉園里,440,2,503,4,507,746,3,1,3,0,1,0,67.96
高雄市,新興區,永寧里,441,2,918,9,927,1449,3,1,3,0,1,0,63.98
高雄市,新興區,玉衡里,442,2,713,7,720,1076,3,1,3,0,1,0,66.91
高雄市,新興區,順昌里,443,2,792,13,805,1180,3,1,3,0,1,0,68.22
高雄市,新興區,順昌里,444,2,610,10,620,952,3,1,3,0,1,0,65.13
高雄市,新興區,文昌里,445,2,827,6,833,1281,3,1,3,0,1,0,65.03
高雄市,新興區,文昌里,446,2,737,5,742,1112,3,1,3,0,1,0,66.73
高雄市,新興區,光耀里,447,2,763,2,765,1201,3,1,3,0,1,0,63.70
高雄市,新興區,光耀里,448,2,824,4,828,1261,3,1,3,0,1,0,65.66
高雄市,新興區,興昌里,449,2,1202,16,1218,1794,3,1,3,0,1,0,67.89
高雄市,新興區,開平里,450,2,925,10,935,1432,3,1,3,0,1,0,65.29
高雄市,新興區,開平里,451,2,1000,10,1010,1465,3,1,3,0,1,0,68.94
高雄市,新興區,成功里,452,2,773,9,782,1180,3,1,3,0,1,0,66.27
高雄市,新興區,新江里,453,2,714,3,717,1157,3,1,3,0,1,0,61.97
高雄市,新興區,黎明里,454,2,577,6,583,952,3,1,3,0,1,0,61.24
高雄市,新興區,愛平里,455,2,598,6,604,918,3,1,3,0,1,0,65.80
高雄市,新興區,南港里,456,2,691,10,701,1013,3,1,3,0,1,0,69.20
高雄市,新興區,南港里,457,2,781,7,788,1199,3,1,3,0,1,0,65.72
高雄市,新興區,中東里,458,2,626,11,637,1135,3,1,3,0,1,0,56.12
高雄市,新興區,中東里,459,2,808,6,814,1413,3,1,3,0,1,0,57.61
高雄市,新興區,明莊里,460,2,572,7,579,868,3,1,3,0,1,0,66.71
高雄市,新興區,大明里,461,2,762,5,767,1173,3,1,3,0,1,0,65.39
高雄市,新興區,秋山里,462,2,675,5,680,1018,3,1,3,0,1,0,66.80
高雄市,新興區,長驛里,463,2,530,2,532,823,3,1,3,0,1,0,64.64
高雄市,新興區,建興里,464,2,577,10,587,873,3,1,3,0,1,0,67.24
高雄市,新興區,建華里,465,2,591,3,594,950,3,1,3,0,1,0,62.53
高雄市,新興區,漢民里,466,2,598,4,602,884,3,1,3,0,1,0,68.10
高雄市,新興區,榮治里,467,2,532,7,539,743,3,1,3,0,1,0,72.54
高雄市,新興區,東坡里,468,2,983,11,994,1412,3,1,3,0,1,0,70.40
高雄市,前金區,三川里,469,2,565,3,568,835,3,1,3,0,1,0,68.02
高雄市,前金區,草江里,470,2,778,8,786,1194,3,1,3,0,1,0,65.83
高雄市,前金區,長城里,471,2,958,9,967,1478,3,1,3,0,1,0,65.43
高雄市,前金區,北金里,472,2,560,5,565,867,3,1,3,0,1,0,65.17
高雄市,前金區,東金里,473,2,567,7,574,930,3,1,3,0,1,0,61.72
高雄市,前金區,新生里,474,2,1161,15,1176,1730,3,1,3,0,1,0,67.98
高雄市,前金區,新生里,475,2,886,9,895,1422,3,1,3,0,1,0,62.94
高雄市,前金區,後金里,476,2,660,9,669,983,3,1,3,0,1,0,68.06
高雄市,前金區,長興里,477,2,683,4,687,1110,3,1,3,0,1,0,61.89
高雄市,前金區,青山里,478,2,876,7,883,1411,3,1,3,0,1,0,62.58
高雄市,前金區,民生里,479,2,456,3,459,741,3,1,3,0,1,0,61.94
高雄市,前金區,復元里,480,2,683,4,687,1031,3,1,3,0,1,0,66.63
高雄市,前金區,林投里,481,2,820,8,828,1217,3,1,3,0,1,0,68.04
高雄市,前金區,國民里,482,2,714,5,719,1091,3,1,3,0,1,0,65.90
高雄市,前金區,社東里,483,2,1161,10,1171,1693,3,1,3,0,1,0,69.17
高雄市,前金區,社西里,484,2,709,3,712,1051,3,1,3,0,1,0,67.75
高雄市,前金區,博孝里,485,2,594,4,598,977,3,1,3,0,1,0,61.21
高雄市,前金區,長生里,486,2,993,11,1004,1614,3,1,3,0,1,0,62.21
高雄市,前金區,榮復里,487,2,850,11,861,1292,3,1,3,0,1,0,66.64
高雄市,前金區,文西里,488,2,720,14,734,1101,3,1,3,0,1,0,66.67
高雄市,前金區,文東里,489,2,893,12,905,1370,3,1,3,0,1,0,66.06
高雄市,苓雅區,博仁里,490,2,418,9,427,638,3,1,3,0,1,0,66.93
高雄市,苓雅區,苓洲里,491,2,929,8,937,1413,3,1,3,0,1,0,66.31
高雄市,苓雅區,苓昇里,492,2,948,14,962,1414,3,1,3,0,1,0,68.03
高雄市,苓雅區,苓中里,493,2,1113,11,1124,1630,3,1,3,0,1,0,68.96
高雄市,苓雅區,苓雅里,494,2,924,9,933,1409,3,1,3,0,1,0,66.22
高雄市,苓雅區,苓東里,495,2,975,13,988,1510,3,1,3,0,1,0,65.43
高雄市,苓雅區,城北里,496,2,938,5,943,1474,3,1,3,0,1,0,63.98
高雄市,苓雅區,城西里,497,2,473,5,478,678,3,1,3,0,1,0,70.50
高雄市,苓雅區,城東里,498,2,1037,8,1045,1636,3,1,3,0,1,0,63.88
高雄市,苓雅區,意誠里,499,2,1346,11,1357,2318,3,1,3,0,1,0,58.54
高雄市,苓雅區,鼓中里,500,2,812,9,821,1215,3,1,3,0,1,0,67.57
高雄市,苓雅區,田西里,501,2,1041,14,1055,1477,3,1,3,0,1,0,71.43
高雄市,苓雅區,人和里,502,2,647,12,659,1023,3,1,3,0,1,0,64.42
高雄市,苓雅區,人和里,503,2,537,4,541,897,3,1,3,0,1,0,60.31
高雄市,苓雅區,仁政里,504,2,1117,12,1129,1753,3,1,3,0,1,0,64.40
高雄市,苓雅區,廣澤里,505,2,1321,21,1342,1939,3,1,3,0,1,0,69.21
高雄市,苓雅區,美田里,506,2,800,7,807,1283,3,1,3,0,1,0,62.90
高雄市,苓雅區,華堂里,507,2,950,11,961,1530,3,1,3,0,1,0,62.81
高雄市,苓雅區,華堂里,508,2,868,8,876,1403,3,1,3,0,1,0,62.44
高雄市,苓雅區,日中里,509,2,772,11,783,1179,3,1,3,0,1,0,66.41
高雄市,苓雅區,日中里,510,2,751,9,760,1155,3,1,3,0,1,0,65.80
高雄市,苓雅區,普照里,511,2,888,9,897,1299,3,1,3,0,1,0,69.05
高雄市,苓雅區,普照里,512,2,833,7,840,1311,3,1,3,0,1,0,64.07
高雄市,苓雅區,和煦里,513,2,1448,10,1458,2174,3,1,3,0,1,0,67.07
高雄市,苓雅區,晴朗里,514,2,670,7,677,1202,3,1,3,0,1,0,56.32
高雄市,苓雅區,普天里,515,2,893,5,898,1392,3,1,3,0,1,0,64.51
高雄市,苓雅區,普天里,516,2,884,12,896,1380,3,1,3,0,1,0,64.93
高雄市,苓雅區,林富里,517,2,1045,12,1057,1715,3,1,3,0,1,0,61.63
高雄市,苓雅區,林圍里,518,2,730,7,737,1144,3,1,3,0,1,0,64.42
高雄市,苓雅區,林圍里,519,2,564,6,570,866,3,1,3,0,1,0,65.82
高雄市,苓雅區,林安里,520,2,1023,7,1030,1528,3,1,3,0,1,0,67.41
高雄市,苓雅區,光華里,521,2,545,7,552,805,3,1,3,0,1,0,68.57
高雄市,苓雅區,林興里,522,2,929,18,947,1457,3,1,3,0,1,0,65.00
高雄市,苓雅區,林華里,523,2,1015,11,1026,1561,3,1,3,0,1,0,65.73
高雄市,苓雅區,林華里,524,2,911,7,918,1442,3,1,3,0,1,0,63.66
高雄市,苓雅區,林西里,525,2,1193,6,1199,1864,3,1,3,0,1,0,64.32
高雄市,苓雅區,林中里,526,2,1227,20,1247,1882,3,1,3,0,1,0,66.26
高雄市,苓雅區,林中里,527,2,920,11,931,1370,3,1,3,0,1,0,67.96
高雄市,苓雅區,林泉里,528,2,1150,17,1167,1785,3,1,3,0,1,0,65.38
高雄市,苓雅區,林南里,529,2,930,10,940,1499,3,1,3,0,1,0,62.71
高雄市,苓雅區,林南里,530,2,801,5,806,1285,3,1,3,0,1,0,62.72
高雄市,苓雅區,中正里,531,2,743,6,749,1203,3,1,3,0,1,0,62.26
高雄市,苓雅區,中正里,532,2,832,4,836,1299,3,1,3,0,1,0,64.36
高雄市,苓雅區,尚義里,533,2,869,9,878,1388,3,1,3,0,1,0,63.26
高雄市,苓雅區,同慶里,534,2,1075,7,1082,1603,3,1,3,0,1,0,67.50
高雄市,苓雅區,凱旋里,535,2,1380,13,1393,1953,3,1,3,0,1,0,71.33
高雄市,苓雅區,安祥里,536,2,560,6,566,880,3,1,3,0,1,0,64.32
高雄市,苓雅區,安祥里,537,2,887,10,897,1375,3,1,3,0,1,0,65.24
高雄市,苓雅區,奏捷里,538,2,565,6,571,807,3,1,3,0,1,0,70.76
高雄市,苓雅區,奏捷里,539,2,607,6,613,859,3,1,3,0,1,0,71.36
高雄市,苓雅區,福壽里,540,2,1057,15,1072,1536,3,1,3,0,1,0,69.79
高雄市,苓雅區,福南里,541,2,762,11,773,1112,3,1,3,0,1,0,69.51
高雄市,苓雅區,福南里,542,2,814,9,823,1167,3,1,3,0,1,0,70.52
高雄市,苓雅區,五權里,543,2,557,5,562,857,3,1,3,0,1,0,65.58
高雄市,苓雅區,五權里,544,2,697,15,712,1066,3,1,3,0,1,0,66.79
高雄市,苓雅區,民主里,545,2,1131,8,1139,1811,3,1,3,0,1,0,62.89
高雄市,苓雅區,民主里,546,2,1248,11,1259,1938,3,1,3,0,1,0,64.96
高雄市,苓雅區,林德里,547,2,601,23,624,941,3,1,3,0,1,0,66.31
高雄市,苓雅區,林德里,548,2,524,5,529,829,3,1,3,0,1,0,63.81
高雄市,苓雅區,林貴里,549,2,925,8,933,1328,3,1,3,0,1,0,70.26
高雄市,苓雅區,林榮里,550,2,1249,9,1258,1883,3,1,3,0,1,0,66.81
高雄市,苓雅區,林榮里,551,2,1241,17,1258,1984,3,1,3,0,1,0,63.41
高雄市,苓雅區,英明里,552,2,600,5,605,974,3,1,3,0,1,0,62.11
高雄市,苓雅區,英明里,553,2,695,7,702,1042,3,1,3,0,1,0,67.37
高雄市,苓雅區,林靖里,554,2,1173,8,1181,1735,3,1,3,0,1,0,68.07
高雄市,苓雅區,朝陽里,555,2,970,13,983,1514,3,1,3,0,1,0,64.93
高雄市,苓雅區,福隆里,556,2,966,12,978,1481,3,1,3,0,1,0,66.04
高雄市,苓雅區,福隆里,557,2,869,10,879,1270,3,1,3,0,1,0,69.21
高雄市,苓雅區,福祥里,558,2,907,8,915,1328,3,1,3,0,1,0,68.90
高雄市,苓雅區,福海里,559,2,683,5,688,1031,3,1,3,0,1,0,66.73
高雄市,苓雅區,福康里,560,2,1316,12,1328,1964,3,1,3,0,1,0,67.62
高雄市,苓雅區,福人里,561,2,663,25,688,966,3,1,3,0,1,0,71.22
高雄市,苓雅區,福人里,562,2,855,16,871,1202,3,1,3,0,1,0,72.46
高雄市,苓雅區,福地里,563,2,1040,17,1057,1390,3,1,3,0,1,0,76.04
高雄市,苓雅區,福地里,564,2,1000,12,1012,1510,3,1,3,0,1,0,67.02
高雄市,苓雅區,福居里,565,2,1022,14,1036,1387,3,1,3,0,1,0,74.69
高雄市,苓雅區,福居里,566,2,1000,14,1014,1462,3,1,3,0,1,0,69.36
高雄市,苓雅區,福東里,567,2,847,15,862,1162,3,1,3,0,1,0,74.18
高雄市,苓雅區,福東里,568,2,810,7,817,1336,3,1,3,0,1,0,61.15
高雄市,苓雅區,福西里,569,2,795,12,807,1184,3,1,3,0,1,0,68.16
高雄市,苓雅區,福西里,570,2,691,17,708,1051,3,1,3,0,1,0,67.36
高雄市,苓雅區,永康里,571,2,747,10,757,1108,3,1,3,0,1,0,68.32
高雄市,苓雅區,永康里,572,2,775,12,787,1255,3,1,3,0,1,0,62.71
高雄市,苓雅區,正文里,573,2,1096,13,1109,1697,3,1,3,0,1,0,65.35
高雄市,苓雅區,正言里,574,2,924,11,935,1422,3,1,3,0,1,0,65.75
高雄市,苓雅區,正言里,575,2,700,8,708,1076,3,1,3,0,1,0,65.80
高雄市,苓雅區,正大里,576,2,1213,16,1229,1972,3,1,3,0,1,0,62.32
高雄市,苓雅區,正大里,577,2,1322,16,1338,2253,3,1,3,0,1,0,59.39
高雄市,苓雅區,五福里,578,2,851,9,860,1268,3,1,3,0,1,0,67.82
高雄市,苓雅區,五福里,579,2,797,8,805,1282,3,1,3,0,1,0,62.79
高雄市,苓雅區,五福里,580,2,799,8,807,1289,3,1,3,0,1,0,62.61
高雄市,苓雅區,正心里,581,2,1108,16,1124,1721,3,1,3,0,1,0,65.31
高雄市,苓雅區,正心里,582,2,1144,9,1153,1750,3,1,3,0,1,0,65.89
高雄市,苓雅區,正道里,583,2,1337,13,1350,2007,3,1,3,0,1,0,67.26
高雄市,苓雅區,正道里,584,2,1247,22,1269,1939,3,1,3,0,1,0,65.45
高雄市,苓雅區,正義里,585,2,716,11,727,1104,3,1,3,0,1,0,65.85
高雄市,苓雅區,正義里,586,2,718,10,728,1064,3,1,3,0,1,0,68.42
高雄市,苓雅區,正仁里,587,2,831,13,844,1286,3,1,3,0,1,0,65.63
高雄市,苓雅區,正仁里,588,2,707,8,715,1049,3,1,3,0,1,0,68.16
高雄市,苓雅區,文昌里,589,2,834,16,850,1181,3,1,3,0,1,0,71.97
高雄市,苓雅區,文昌里,590,2,814,7,821,1240,3,1,3,0,1,0,66.21
高雄市,苓雅區,文昌里,591,2,915,9,924,1379,3,1,3,0,1,0,67.01
高雄市,苓雅區,建軍里,592,2,1311,28,1339,1956,3,1,3,0,1,0,68.46
高雄市,苓雅區,衛武里,593,2,726,8,734,1068,3,1,3,0,1,0,68.73
高雄市,苓雅區,衛武里,594,2,684,6,690,1037,3,1,3,0,1,0,66.54
高雄市,前鎮區,草衙里,595,2,871,9,880,1275,3,1,3,0,1,0,69.02
高雄市,前鎮區,草衙里,596,2,816,15,831,1197,3,1,3,0,1,0,69.42
高雄市,前鎮區,草衙里,597,2,1201,9,1210,1886,3,1,3,0,1,0,64.16
高雄市,前鎮區,草衙里,598,2,1005,6,1011,1692,3,1,3,0,1,0,59.75
高雄市,前鎮區,草衙里,599,2,1081,8,1089,1792,3,1,3,0,1,0,60.77
高雄市,前鎮區,明孝里,600,2,940,14,954,1461,3,1,3,0,1,0,65.30
高雄市,前鎮區,明孝里,601,2,567,6,573,899,3,1,3,0,1,0,63.74
高雄市,前鎮區,明正里,602,2,1064,13,1077,1611,3,1,3,0,1,0,66.85
高雄市,前鎮區,明正里,603,2,1043,11,1054,1588,3,1,3,0,1,0,66.37
高雄市,前鎮區,明義里,604,2,737,10,747,999,3,1,3,0,1,0,74.77
高雄市,前鎮區,明義里,605,2,535,7,542,766,3,1,3,0,1,0,70.76
高雄市,前鎮區,仁愛里,606,2,994,16,1010,1462,3,1,3,0,1,0,69.08
高雄市,前鎮區,德昌里,607,2,1249,16,1265,1925,3,1,3,0,1,0,65.71
高雄市,前鎮區,平等里,608,2,1104,8,1112,1837,3,1,3,0,1,0,60.53
高雄市,前鎮區,平昌里,609,2,491,8,499,767,3,1,3,0,1,0,65.06
高雄市,前鎮區,明禮里,610,2,1196,15,1211,1787,3,1,3,0,1,0,67.77
高雄市,前鎮區,信義里,611,2,1164,18,1182,1628,3,1,3,0,1,0,72.60
高雄市,前鎮區,信德里,612,2,730,10,740,1074,3,1,3,0,1,0,68.90
高雄市,前鎮區,信德里,613,2,936,5,941,1395,3,1,3,0,1,0,67.46
高雄市,前鎮區,明道里,614,2,904,10,914,1323,3,1,3,0,1,0,69.09
高雄市,前鎮區,興化里,615,2,522,3,525,716,3,1,3,0,1,0,73.32
高雄市,前鎮區,興仁里,616,2,613,9,622,943,3,1,3,0,1,0,65.96
高雄市,前鎮區,前鎮里,617,2,1099,17,1116,1561,3,1,3,0,1,0,71.49
高雄市,前鎮區,鎮東里,618,2,1390,21,1411,1884,3,1,3,0,1,0,74.89
高雄市,前鎮區,鎮榮里,619,2,892,15,907,1311,3,1,3,0,1,0,69.18
高雄市,前鎮區,鎮榮里,620,2,696,12,708,1093,3,1,3,0,1,0,64.78
高雄市,前鎮區,鎮昌里,621,2,833,13,846,1207,3,1,3,0,1,0,70.09
高雄市,前鎮區,鎮昌里,622,2,615,8,623,833,3,1,3,0,1,0,74.79
高雄市,前鎮區,鎮海里,623,2,769,13,782,1158,3,1,3,0,1,0,67.53
高雄市,前鎮區,鎮海里,624,2,790,5,795,1231,3,1,3,0,1,0,64.58
高雄市,前鎮區,鎮海里,625,2,870,8,878,1352,3,1,3,0,1,0,64.94
高雄市,前鎮區,鎮陽里,626,2,797,13,810,1165,3,1,3,0,1,0,69.53
高雄市,前鎮區,興邦里,627,2,1230,25,1255,1861,3,1,3,0,1,0,67.44
高雄市,前鎮區,鎮中里,628,2,585,5,590,844,3,1,3,0,1,0,69.91
高雄市,前鎮區,鎮北里,629,2,757,6,763,1028,3,1,3,0,1,0,74.22
高雄市,前鎮區,忠純里,630,2,911,16,927,1205,3,1,3,0,1,0,76.93
高雄市,前鎮區,忠純里,631,2,1073,12,1085,1426,3,1,3,0,1,0,76.09
高雄市,前鎮區,忠誠里,632,2,927,10,937,1218,3,1,3,0,1,0,76.93
高雄市,前鎮區,忠誠里,633,2,617,6,623,820,3,1,3,0,1,0,75.98
高雄市,前鎮區,西山里,634,2,1078,17,1095,1643,3,1,3,0,1,0,66.65
高雄市,前鎮區,西山里,635,2,1095,4,1099,1600,3,1,3,0,1,0,68.69
高雄市,前鎮區,民權里,636,2,1247,6,1253,1648,3,1,3,0,1,0,76.03
高雄市,前鎮區,民權里,637,2,1233,13,1246,1948,3,1,3,0,1,0,63.96
高雄市,前鎮區,建隆里,638,2,597,9,606,855,3,1,3,0,1,0,70.88
高雄市,前鎮區,振興里,639,2,1554,18,1572,2130,3,1,3,0,1,0,73.80
高雄市,前鎮區,良和里,640,2,803,5,808,1213,3,1,3,0,1,0,66.61
高雄市,前鎮區,良和里,641,2,816,8,824,1334,3,1,3,0,1,0,61.77
高雄市,前鎮區,西甲里,642,2,1386,10,1396,2053,3,1,3,0,1,0,68.00
高雄市,前鎮區,盛興里,643,2,715,6,721,1252,3,1,3,0,1,0,57.59
高雄市,前鎮區,盛興里,644,2,660,7,667,1152,3,1,3,0,1,0,57.90
高雄市,前鎮區,盛豐里,645,2,937,5,942,1518,3,1,3,0,1,0,62.06
高雄市,前鎮區,盛豐里,646,2,820,10,830,1332,3,1,3,0,1,0,62.31
高雄市,前鎮區,興中里,647,2,978,9,987,1501,3,1,3,0,1,0,65.76
高雄市,前鎮區,興中里,648,2,883,9,892,1558,3,1,3,0,1,0,57.25
高雄市,前鎮區,興東里,649,2,817,15,832,1160,3,1,3,0,1,0,71.72
高雄市,前鎮區,興東里,650,2,969,7,976,1444,3,1,3,0,1,0,67.59
高雄市,前鎮區,興東里,651,2,1016,8,1024,1555,3,1,3,0,1,0,65.85
高雄市,前鎮區,忠孝里,652,2,723,6,729,1094,3,1,3,0,1,0,66.64
高雄市,前鎮區,忠孝里,653,2,811,4,815,1121,3,1,3,0,1,0,72.70
高雄市,前鎮區,復國里,654,2,891,2,893,1325,3,1,3,0,1,0,67.40
高雄市,前鎮區,復國里,655,2,981,4,985,1435,3,1,3,0,1,0,68.64
高雄市,前鎮區,竹內里,656,2,814,11,825,1246,3,1,3,0,1,0,66.21
高雄市,前鎮區,竹內里,657,2,889,8,897,1369,3,1,3,0,1,0,65.52
高雄市,前鎮區,竹東里,658,2,615,7,622,1036,3,1,3,0,1,0,60.04
高雄市,前鎮區,竹東里,659,2,636,6,642,1012,3,1,3,0,1,0,63.44
高雄市,前鎮區,竹南里,660,2,827,7,834,1295,3,1,3,0,1,0,64.40
高雄市,前鎮區,竹南里,661,2,825,9,834,1307,3,1,3,0,1,0,63.81
高雄市,前鎮區,竹北里,662,2,685,7,692,1064,3,1,3,0,1,0,65.04
高雄市,前鎮區,竹北里,663,2,550,4,554,863,3,1,3,0,1,0,64.19
高雄市,前鎮區,竹西里,664,2,1214,11,1225,1805,3,1,3,0,1,0,67.87
高雄市,前鎮區,竹西里,665,2,1070,8,1078,1609,3,1,3,0,1,0,67.00
高雄市,前鎮區,竹中里,666,2,832,6,838,1341,3,1,3,0,1,0,62.49
高雄市,前鎮區,竹中里,667,2,892,8,900,1358,3,1,3,0,1,0,66.27
高雄市,前鎮區,瑞竹里,668,2,856,15,871,1296,3,1,3,0,1,0,67.21
高雄市,前鎮區,瑞南里,669,2,897,11,908,1359,3,1,3,0,1,0,66.81
高雄市,前鎮區,瑞南里,670,2,1103,8,1111,1577,3,1,3,0,1,0,70.45
高雄市,前鎮區,瑞南里,671,2,989,11,1000,1498,3,1,3,0,1,0,66.76
高雄市,前鎮區,瑞豐里,672,2,886,16,902,1267,3,1,3,0,1,0,71.19
高雄市,前鎮區,瑞豐里,673,2,735,8,743,1039,3,1,3,0,1,0,71.51
高雄市,前鎮區,瑞祥里,674,2,1105,13,1118,1688,3,1,3,0,1,0,66.23
高雄市,前鎮區,瑞祥里,675,2,1073,9,1082,1550,3,1,3,0,1,0,69.81
高雄市,前鎮區,瑞祥里,676,2,903,8,911,1321,3,1,3,0,1,0,68.96
高雄市,前鎮區,瑞東里,677,2,733,6,739,1110,3,1,3,0,1,0,66.58
高雄市,前鎮區,瑞東里,678,2,783,11,794,1197,3,1,3,0,1,0,66.33
高雄市,前鎮區,瑞和里,679,2,655,5,660,949,3,1,3,0,1,0,69.55
高雄市,前鎮區,瑞和里,680,2,674,11,685,1044,3,1,3,0,1,0,65.61
高雄市,前鎮區,瑞平里,681,2,1210,16,1226,1789,3,1,3,0,1,0,68.53
高雄市,前鎮區,瑞平里,682,2,1118,14,1132,1663,3,1,3,0,1,0,68.07
高雄市,前鎮區,瑞隆里,683,2,924,8,932,1453,3,1,3,0,1,0,64.14
高雄市,前鎮區,瑞隆里,684,2,1222,17,1239,1964,3,1,3,0,1,0,63.09
高雄市,前鎮區,瑞北里,685,2,1033,10,1043,1496,3,1,3,0,1,0,69.72
高雄市,前鎮區,瑞北里,686,2,923,9,932,1419,3,1,3,0,1,0,65.68
高雄市,前鎮區,瑞西里,687,2,976,12,988,1385,3,1,3,0,1,0,71.34
高雄市,前鎮區,瑞西里,688,2,913,15,928,1251,3,1,3,0,1,0,74.18
高雄市,前鎮區,瑞崗里,689,2,976,12,988,1429,3,1,3,0,1,0,69.14
高雄市,前鎮區,瑞崗里,690,2,708,9,717,1093,3,1,3,0,1,0,65.60
高雄市,前鎮區,瑞興里,691,2,897,14,911,1315,3,1,3,0,1,0,69.28
高雄市,前鎮區,瑞興里,692,2,764,9,773,1246,3,1,3,0,1,0,62.04
高雄市,前鎮區,瑞誠里,693,2,786,6,792,1205,3,1,3,0,1,0,65.73
高雄市,前鎮區,瑞誠里,694,2,648,13,661,1033,3,1,3,0,1,0,63.99
高雄市,前鎮區,瑞文里,695,2,610,6,616,914,3,1,3,0,1,0,67.40
高雄市,前鎮區,瑞文里,696,2,922,11,933,1428,3,1,3,0,1,0,65.34
高雄市,前鎮區,瑞華里,697,2,1225,12,1237,1998,3,1,3,0,1,0,61.91
高雄市,前鎮區,瑞華里,698,2,1310,10,1320,2076,3,1,3,0,1,0,63.58
高雄市,前鎮區,瑞昌里,699,2,594,10,604,959,3,1,3,0,1,0,62.98
高雄市,前鎮區,瑞昌里,700,2,1070,16,1086,1730,3,1,3,0,1,0,62.77
高雄市,小港區,小港里,701,2,1154,10,1164,1679,3,1,3,0,1,0,69.33
高雄市,小港區,港口里,702,2,1039,5,1044,1485,3,1,3,0,1,0,70.30
高雄市,小港區,港口里,703,2,960,14,974,1460,3,1,3,0,1,0,66.71
高雄市,小港區,港正里,704,2,812,7,819,1196,3,1,3,0,1,0,68.48
高雄市,小港區,港正里,705,2,739,11,750,1089,3,1,3,0,1,0,68.87
高雄市,小港區,港墘里,706,2,1021,13,1034,1443,3,1,3,0,1,0,71.66
高雄市,小港區,港明里,707,2,907,4,911,1332,3,1,3,0,1,0,68.39
高雄市,小港區,港明里,708,2,910,10,920,1322,3,1,3,0,1,0,69.59
高雄市,小港區,港后里,709,2,1188,10,1198,1693,3,1,3,0,1,0,70.76
高雄市,小港區,港南里,710,2,856,14,870,1287,3,1,3,0,1,0,67.60
高雄市,小港區,港興里,711,2,1265,13,1278,1850,3,1,3,0,1,0,69.08
高雄市,小港區,鳳宮里,712,2,1070,10,1080,1675,3,1,3,0,1,0,64.48
高雄市,小港區,店鎮里,713,2,838,8,846,1241,3,1,3,0,1,0,68.17
高雄市,小港區,店鎮里,714,2,961,10,971,1445,3,1,3,0,1,0,67.20
高雄市,小港區,店鎮里,715,2,870,9,879,1378,3,1,3,0,1,0,63.79
高雄市,小港區,大苓里,716,2,691,4,695,961,3,1,3,0,1,0,72.32
高雄市,小港區,大苓里,717,2,730,5,735,1064,3,1,3,0,1,0,69.08
高雄市,小港區,二苓里,718,2,918,17,935,1363,3,1,3,0,1,0,68.60
高雄市,小港區,二苓里,719,2,921,3,924,1377,3,1,3,0,1,0,67.10
高雄市,小港區,三苓里,720,2,823,8,831,1288,3,1,3,0,1,0,64.52
高雄市,小港區,三苓里,721,2,738,4,742,1051,3,1,3,0,1,0,70.60
高雄市,小港區,正苓里,722,2,1018,7,1025,1585,3,1,3,0,1,0,64.67
高雄市,小港區,正苓里,723,2,1019,10,1029,1551,3,1,3,0,1,0,66.34
高雄市,小港區,順苓里,724,2,1077,12,1089,1793,3,1,3,0,1,0,60.74
高雄市,小港區,順苓里,725,2,1001,12,1013,1520,3,1,3,0,1,0,66.64
高雄市,小港區,六苓里,726,2,860,16,876,1258,3,1,3,0,1,0,69.63
高雄市,小港區,宏亮里,727,2,658,9,667,988,3,1,3,0,1,0,67.51
高雄市,小港區,宏亮里,728,2,814,10,824,1243,3,1,3,0,1,0,66.29
高雄市,小港區,山東里,729,2,833,7,840,1218,3,1,3,0,1,0,68.97
高雄市,小港區,山東里,730,2,776,11,787,1141,3,1,3,0,1,0,68.97
高雄市,小港區,青島里,731,2,1058,11,1069,1560,3,1,3,0,1,0,68.53
高雄市,小港區,濟南里,732,2,862,19,881,1309,3,1,3,0,1,0,67.30
高雄市,小港區,濟南里,733,2,999,6,1005,1403,3,1,3,0,1,0,71.63
高雄市,小港區,泰山里,734,2,1394,20,1414,1979,3,1,3,0,1,0,71.45
高雄市,小港區,山明里,735,2,1033,12,1045,1595,3,1,3,0,1,0,65.52
高雄市,小港區,山明里,736,2,1010,11,1021,1496,3,1,3,0,1,0,68.25
高雄市,小港區,山明里,737,2,875,6,881,1341,3,1,3,0,1,0,65.70
高雄市,小港區,高松里,738,2,902,13,915,1437,3,1,3,0,1,0,63.67
高雄市,小港區,高松里,739,2,1067,13,1080,1559,3,1,3,0,1,0,69.28
高雄市,小港區,松金里,740,2,1245,15,1260,1805,3,1,3,0,1,0,69.81
高雄市,小港區,松山里,741,2,1105,10,1115,1621,3,1,3,0,1,0,68.78
高雄市,小港區,大坪里,742,2,706,7,713,976,3,1,3,0,1,0,73.05
高雄市,小港區,坪頂里,743,2,764,10,774,1130,3,1,3,0,1,0,68.50
高雄市,小港區,孔宅里,744,2,712,9,721,992,3,1,3,0,1,0,72.68
高雄市,小港區,孔宅里,745,2,1215,18,1233,1944,3,1,3,0,1,0,63.43
高雄市,小港區,廈莊里,746,2,1110,13,1123,1662,3,1,3,0,1,0,67.57
高雄市,小港區,合作里,747,2,1450,32,1482,2100,3,1,3,0,1,0,70.57
高雄市,小港區,桂林里,748,2,1155,13,1168,1683,3,1,3,0,1,0,69.40
高雄市,小港區,桂林里,749,2,1260,13,1273,1874,3,1,3,0,1,0,67.93
高雄市,小港區,桂林里,750,2,1087,14,1101,1792,3,1,3,0,1,0,61.44
高雄市,小港區,中厝里,751,2,771,16,787,1183,3,1,3,0,1,0,66.53
高雄市,小港區,中厝里,752,2,936,13,949,1465,3,1,3,0,1,0,64.78
高雄市,小港區,鳳鳴里,753,2,1550,22,1572,2129,3,1,3,0,1,0,73.84
高雄市,小港區,龍鳳里,754,2,1485,16,1501,2015,3,1,3,0,1,0,74.49
高雄市,小港區,鳳森里,755,2,1095,12,1107,1522,3,1,3,0,1,0,72.73
高雄市,小港區,鳳林里,756,2,1402,12,1414,2082,3,1,3,0,1,0,67.92
高雄市,小港區,鳳興里,757,2,1152,11,1163,1585,3,1,3,0,1,0,73.38
高雄市,小港區,鳳源里,758,2,854,4,858,1111,3,1,3,0,1,0,77.23
高雄市,小港區,鳳源里,759,2,870,18,888,1294,3,1,3,0,1,0,68.62
高雄市,小港區,海澄里,760,2,909,12,921,1462,3,1,3,0,1,0,63.00
高雄市,小港區,海澄里,761,2,815,3,818,1400,3,1,3,0,1,0,58.43
高雄市,小港區,海澄里,762,2,1012,18,1030,1665,3,1,3,0,1,0,61.86
高雄市,小港區,海昌里,763,2,691,7,698,1149,3,1,3,0,1,0,60.75
高雄市,小港區,海昌里,764,2,676,8,684,1163,3,1,3,0,1,0,58.81
高雄市,小港區,海豐里,765,2,831,15,846,1371,3,1,3,0,1,0,61.71
高雄市,小港區,海豐里,766,2,659,1,660,1091,3,1,3,0,1,0,60.49
高雄市,小港區,海原里,767,2,750,27,777,1345,3,1,3,0,1,0,57.77
高雄市,小港區,海原里,768,2,903,13,916,1464,3,1,3,0,1,0,62.57
高雄市,小港區,海城里,769,2,859,11,870,1444,3,1,3,0,1,0,60.25
高雄市,小港區,海城里,770,2,841,11,852,1453,3,1,3,0,1,0,58.64
臺北縣,板橋市,留侯里,1,1,771,7,778,1119,3,1,3,0,1,0,69.53
臺北縣,板橋市,流芳里,2,1,802,8,810,1249,3,1,3,0,1,0,64.85
臺北縣,板橋市,赤松里,3,1,457,4,461,654,3,1,3,0,1,0,70.49
臺北縣,板橋市,黃石里,4,1,709,11,720,1053,3,1,3,0,1,0,68.38
臺北縣,板橋市,挹秀里,5,1,523,4,527,797,3,1,3,0,1,0,66.12
臺北縣,板橋市,挹秀里,6,1,434,1,435,784,3,1,3,0,1,0,55.48
臺北縣,板橋市,湳興里,7,1,647,7,654,925,3,1,3,0,1,0,70.70
臺北縣,板橋市,湳興里,8,1,617,11,628,928,3,1,3,0,1,0,67.67
臺北縣,板橋市,湳興里,9,1,530,13,543,801,3,1,3,0,1,0,67.79
臺北縣,板橋市,湳興里,10,1,766,8,774,1085,3,1,3,0,1,0,71.34
臺北縣,板橋市,新興里,11,1,816,14,830,1195,3,1,3,0,1,0,69.46
臺北縣,板橋市,新興里,12,1,868,13,881,1329,3,1,3,0,1,0,66.29
臺北縣,板橋市,社後里,13,1,742,10,752,1079,3,1,3,0,1,0,69.69
臺北縣,板橋市,社後里,14,1,979,17,996,1414,3,1,3,0,1,0,70.44
臺北縣,板橋市,社後里,15,1,740,10,750,1073,3,1,3,0,1,0,69.90
臺北縣,板橋市,社後里,16,1,705,5,710,1039,3,1,3,0,1,0,68.33
臺北縣,板橋市,香社里,17,1,776,17,793,1190,3,1,3,0,1,0,66.64
臺北縣,板橋市,香社里,18,1,761,8,769,1156,3,1,3,0,1,0,66.52
臺北縣,板橋市,香社里,19,1,743,7,750,1034,3,1,3,0,1,0,72.53
臺北縣,板橋市,香雅里,20,1,695,11,706,1031,3,1,3,0,1,0,68.48
臺北縣,板橋市,香雅里,21,1,760,12,772,1116,3,1,3,0,1,0,69.18
臺北縣,板橋市,中正里,22,1,754,16,770,1138,3,1,3,0,1,0,67.66
臺北縣,板橋市,中正里,23,1,772,7,779,1139,3,1,3,0,1,0,68.39
臺北縣,板橋市,中正里,24,1,823,13,836,1178,3,1,3,0,1,0,70.97
臺北縣,板橋市,自強里,25,1,776,10,786,1109,3,1,3,0,1,0,70.87
臺北縣,板橋市,自強里,26,1,753,11,764,1031,3,1,3,0,1,0,74.10
臺北縣,板橋市,自強里,27,1,826,12,838,1179,3,1,3,0,1,0,71.08
臺北縣,板橋市,自強里,28,1,786,11,797,1081,3,1,3,0,1,0,73.73
臺北縣,板橋市,自立里,29,1,931,17,948,1272,3,1,3,0,1,0,74.53
臺北縣,板橋市,自立里,30,1,763,8,771,1079,3,1,3,0,1,0,71.46
臺北縣,板橋市,光華里,31,1,752,10,762,1159,3,1,3,0,1,0,65.75
臺北縣,板橋市,光華里,32,1,741,17,758,1021,3,1,3,0,1,0,74.24
臺北縣,板橋市,光榮里,33,1,735,10,745,1050,3,1,3,0,1,0,70.95
臺北縣,板橋市,光榮里,34,1,739,20,759,1038,3,1,3,0,1,0,73.12
臺北縣,板橋市,國光里,35,1,905,12,917,1212,3,1,3,0,1,0,75.66
臺北縣,板橋市,國光里,36,1,809,10,819,1042,3,1,3,0,1,0,78.60
臺北縣,板橋市,國光里,37,1,720,8,728,1016,3,1,3,0,1,0,71.65
臺北縣,板橋市,港尾里,38,1,612,15,627,877,3,1,3,0,1,0,71.49
臺北縣,板橋市,港尾里,39,1,726,7,733,998,3,1,3,0,1,0,73.45
臺北縣,板橋市,新生里,40,1,775,13,788,1204,3,1,3,0,1,0,65.45
臺北縣,板橋市,新生里,41,1,883,5,888,1251,3,1,3,0,1,0,70.98
臺北縣,板橋市,新生里,42,1,731,5,736,1037,3,1,3,0,1,0,70.97
臺北縣,板橋市,金華里,43,1,720,11,731,1087,3,1,3,0,1,0,67.25
臺北縣,板橋市,金華里,44,1,706,17,723,1085,3,1,3,0,1,0,66.64
臺北縣,板橋市,金華里,45,1,741,17,758,1097,3,1,3,0,1,0,69.10
臺北縣,板橋市,港德里,46,1,704,10,714,1126,3,1,3,0,1,0,63.41
臺北縣,板橋市,港德里,47,1,679,15,694,1057,3,1,3,0,1,0,65.66
臺北縣,板橋市,港德里,48,1,564,8,572,876,3,1,3,0,1,0,65.30
臺北縣,板橋市,港德里,49,1,754,34,788,1111,3,1,3,0,1,0,70.93
臺北縣,板橋市,民權里,50,1,825,7,832,1170,3,1,3,0,1,0,71.11
臺北縣,板橋市,民權里,51,1,863,10,873,1238,3,1,3,0,1,0,70.52
臺北縣,板橋市,民安里,52,1,571,5,576,797,3,1,3,0,1,0,72.27
臺北縣,板橋市,民安里,53,1,688,8,696,940,3,1,3,0,1,0,74.04
臺北縣,板橋市,建國里,54,1,682,11,693,1011,3,1,3,0,1,0,68.55
臺北縣,板橋市,建國里,55,1,785,18,803,1119,3,1,3,0,1,0,71.76
臺北縣,板橋市,建國里,56,1,690,5,695,967,3,1,3,0,1,0,71.87
臺北縣,板橋市,漢生里,57,1,714,11,725,1010,3,1,3,0,1,0,71.78
臺北縣,板橋市,漢生里,58,1,976,9,985,1341,3,1,3,0,1,0,73.45
臺北縣,板橋市,漢生里,59,1,905,4,909,1284,3,1,3,0,1,0,70.79
臺北縣,板橋市,新民里,60,1,703,9,712,1053,3,1,3,0,1,0,67.62
臺北縣,板橋市,新民里,61,1,789,8,797,1125,3,1,3,0,1,0,70.84
臺北縣,板橋市,新民里,62,1,856,17,873,1302,3,1,3,0,1,0,67.05
臺北縣,板橋市,公舘里,63,1,812,7,819,1166,3,1,3,0,1,0,70.24
臺北縣,板橋市,公舘里,64,1,684,15,699,1000,3,1,3,0,1,0,69.90
臺北縣,板橋市,公舘里,65,1,643,14,657,958,3,1,3,0,1,0,68.58
臺北縣,板橋市,幸福里,66,1,707,18,725,1119,3,1,3,0,1,0,64.79
臺北縣,板橋市,幸福里,67,1,778,8,786,1144,3,1,3,0,1,0,68.71
臺北縣,板橋市,幸福里,68,1,661,11,672,1004,3,1,3,0,1,0,66.93
臺北縣,板橋市,文德里,69,1,790,9,799,1187,3,1,3,0,1,0,67.31
臺北縣,板橋市,文德里,70,1,739,15,754,1130,3,1,3,0,1,0,66.73
臺北縣,板橋市,忠誠里,71,1,904,7,911,1229,3,1,3,0,1,0,74.13
臺北縣,板橋市,忠誠里,72,1,745,10,755,1019,3,1,3,0,1,0,74.09
臺北縣,板橋市,陽明里,73,1,822,6,828,1202,3,1,3,0,1,0,68.89
臺北縣,板橋市,陽明里,74,1,757,11,768,1150,3,1,3,0,1,0,66.78
臺北縣,板橋市,百壽里,75,1,765,11,776,1100,3,1,3,0,1,0,70.55
臺北縣,板橋市,百壽里,76,1,628,13,641,908,3,1,3,0,1,0,70.59
臺北縣,板橋市,介壽里,77,1,839,16,855,1236,3,1,3,0,1,0,69.17
臺北縣,板橋市,介壽里,78,1,851,15,866,1241,3,1,3,0,1,0,69.78
臺北縣,板橋市,新埔里,79,1,631,12,643,916,3,1,3,0,1,0,70.20
臺北縣,板橋市,新埔里,80,1,737,6,743,1092,3,1,3,0,1,0,68.04
臺北縣,板橋市,華江里,81,1,862,18,880,1272,3,1,3,0,1,0,69.18
臺北縣,板橋市,華江里,82,1,713,15,728,989,3,1,3,0,1,0,73.61
臺北縣,板橋市,華江里,83,1,998,18,1016,1473,3,1,3,0,1,0,68.97
臺北縣,板橋市,江翠里,84,1,932,14,946,1378,3,1,3,0,1,0,68.65
臺北縣,板橋市,江翠里,85,1,842,17,859,1271,3,1,3,0,1,0,67.58
臺北縣,板橋市,江翠里,86,1,833,9,842,1263,3,1,3,0,1,0,66.67
臺北縣,板橋市,純翠里,87,1,695,7,702,1047,3,1,3,0,1,0,67.05
臺北縣,板橋市,純翠里,88,1,829,10,839,1296,3,1,3,0,1,0,64.74
臺北縣,板橋市,純翠里,89,1,1087,17,1104,1663,3,1,3,0,1,0,66.39
臺北縣,板橋市,溪頭里,90,1,722,11,733,1176,3,1,3,0,1,0,62.33
臺北縣,板橋市,溪頭里,91,1,787,8,795,1238,3,1,3,0,1,0,64.22
臺北縣,板橋市,溪頭里,92,1,716,8,724,1090,3,1,3,0,1,0,66.42
臺北縣,板橋市,溪頭里,93,1,797,10,807,1131,3,1,3,0,1,0,71.35
臺北縣,板橋市,聯翠里,94,1,1052,17,1069,1579,3,1,3,0,1,0,67.70
臺北縣,板橋市,聯翠里,95,1,852,12,864,1248,3,1,3,0,1,0,69.23
臺北縣,板橋市,文化里,96,1,826,15,841,1206,3,1,3,0,1,0,69.73
臺北縣,板橋市,文化里,97,1,817,8,825,1242,3,1,3,0,1,0,66.43
臺北縣,板橋市,宏翠里,98,1,820,12,832,1175,3,1,3,0,1,0,70.81
臺北縣,板橋市,宏翠里,99,1,906,24,930,1342,3,1,3,0,1,0,69.30
臺北縣,板橋市,仁翠里,100,1,913,13,926,1388,3,1,3,0,1,0,66.71
臺北縣,板橋市,仁翠里,101,1,833,18,851,1231,3,1,3,0,1,0,69.13
臺北縣,板橋市,新翠里,102,1,1075,20,1095,1602,3,1,3,0,1,0,68.35
臺北縣,板橋市,新翠里,103,1,1281,24,1305,1897,3,1,3,0,1,0,68.79
臺北縣,板橋市,新翠里,104,1,1224,31,1255,1786,3,1,3,0,1,0,70.27
臺北縣,板橋市,朝陽里,105,1,543,8,551,770,3,1,3,0,1,0,71.56
臺北縣,板橋市,朝陽里,106,1,565,5,570,849,3,1,3,0,1,0,67.14
臺北縣,板橋市,朝陽里,107,1,764,13,777,1166,3,1,3,0,1,0,66.64
臺北縣,板橋市,吉翠里,108,1,705,18,723,1031,3,1,3,0,1,0,70.13
臺北縣,板橋市,吉翠里,109,1,631,12,643,901,3,1,3,0,1,0,71.37
臺北縣,板橋市,吉翠里,110,1,695,6,701,989,3,1,3,0,1,0,70.88
臺北縣,板橋市,德翠里,111,1,953,9,962,1391,3,1,3,0,1,0,69.16
臺北縣,板橋市,德翠里,112,1,659,15,674,948,3,1,3,0,1,0,71.10
臺北縣,板橋市,德翠里,113,1,999,11,1010,1497,3,1,3,0,1,0,67.47
臺北縣,板橋市,新海里,114,1,613,11,624,984,3,1,3,0,1,0,63.41
臺北縣,板橋市,新海里,115,1,606,9,615,896,3,1,3,0,1,0,68.64
臺北縣,板橋市,新海里,116,1,612,6,618,894,3,1,3,0,1,0,69.13
臺北縣,板橋市,滿翠里,117,1,533,5,538,793,3,1,3,0,1,0,67.84
臺北縣,板橋市,滿翠里,118,1,580,6,586,865,3,1,3,0,1,0,67.75
臺北縣,板橋市,滿翠里,119,1,688,14,702,996,3,1,3,0,1,0,70.48
臺北縣,板橋市,明翠里,120,1,528,11,539,824,3,1,3,0,1,0,65.41
臺北縣,板橋市,明翠里,121,1,638,12,650,994,3,1,3,0,1,0,65.39
臺北縣,板橋市,明翠里,122,1,727,5,732,1104,3,1,3,0,1,0,66.30
臺北縣,板橋市,明翠里,123,1,775,14,789,1129,3,1,3,0,1,0,69.88
臺北縣,板橋市,松翠里,124,1,877,16,893,1406,3,1,3,0,1,0,63.51
臺北縣,板橋市,松翠里,125,1,978,12,990,1528,3,1,3,0,1,0,64.79
臺北縣,板橋市,柏翠里,126,1,984,15,999,1402,3,1,3,0,1,0,71.26
臺北縣,板橋市,柏翠里,127,1,910,9,919,1348,3,1,3,0,1,0,68.18
臺北縣,板橋市,龍翠里,128,1,640,7,647,994,3,1,3,0,1,0,65.09
臺北縣,板橋市,龍翠里,129,1,783,18,801,1185,3,1,3,0,1,0,67.59
臺北縣,板橋市,龍翠里,130,1,760,9,769,1075,3,1,3,0,1,0,71.53
臺北縣,板橋市,松柏里,131,1,695,6,701,1025,3,1,3,0,1,0,68.39
臺北縣,板橋市,松柏里,132,1,499,7,506,763,3,1,3,0,1,0,66.32
臺北縣,板橋市,華翠里,133,1,867,16,883,1257,3,1,3,0,1,0,70.25
臺北縣,板橋市,華翠里,134,1,957,11,968,1386,3,1,3,0,1,0,69.84
臺北縣,板橋市,莒光里,135,1,891,13,904,1313,3,1,3,0,1,0,68.85
臺北縣,板橋市,莒光里,136,1,768,12,780,1147,3,1,3,0,1,0,68.00
臺北縣,板橋市,忠翠里,137,1,1018,14,1032,1455,3,1,3,0,1,0,70.93
臺北縣,板橋市,忠翠里,138,1,719,8,727,1020,3,1,3,0,1,0,71.27
臺北縣,板橋市,忠翠里,139,1,943,17,960,1407,3,1,3,0,1,0,68.23
臺北縣,板橋市,忠翠里,140,1,1446,15,1461,2102,3,1,3,0,1,0,69.51
臺北縣,板橋市,嵐翠里,141,1,702,20,722,1090,3,1,3,0,1,0,66.24
臺北縣,板橋市,嵐翠里,142,1,739,8,747,1094,3,1,3,0,1,0,68.28
臺北縣,板橋市,文聖里,143,1,827,17,844,1189,3,1,3,0,1,0,70.98
臺北縣,板橋市,文聖里,144,1,845,22,867,1230,3,1,3,0,1,0,70.49
臺北縣,板橋市,文翠里,145,1,823,13,836,1201,3,1,3,0,1,0,69.61
臺北縣,板橋市,文翠里,146,1,702,13,715,1016,3,1,3,0,1,0,70.37
臺北縣,板橋市,文翠里,147,1,782,15,797,1138,3,1,3,0,1,0,70.04
臺北縣,板橋市,青翠里,148,1,801,19,820,1254,3,1,3,0,1,0,65.39
臺北縣,板橋市,青翠里,149,1,853,10,863,1280,3,1,3,0,1,0,67.42
臺北縣,板橋市,懷翠里,150,1,869,18,887,1329,3,1,3,0,1,0,66.74
臺北縣,板橋市,懷翠里,151,1,954,12,966,1445,3,1,3,0,1,0,66.85
臺北縣,板橋市,懷翠里,152,1,1099,14,1113,1635,3,1,3,0,1,0,68.07
臺北縣,板橋市,福翠里,153,1,427,7,434,640,3,1,3,0,1,0,67.81
臺北縣,板橋市,福翠里,154,1,577,19,596,858,3,1,3,0,1,0,69.46
臺北縣,板橋市,港嘴里,155,1,851,13,864,1258,3,1,3,0,1,0,68.68
臺北縣,板橋市,港嘴里,156,1,832,24,856,1283,3,1,3,0,1,0,66.72
臺北縣,板橋市,港嘴里,157,1,635,5,640,938,3,1,3,0,1,0,68.23
臺北縣,板橋市,港嘴里,158,1,582,6,588,826,3,1,3,0,1,0,71.19
臺北縣,板橋市,振興里,159,1,848,6,854,1237,3,1,3,0,1,0,69.04
臺北縣,板橋市,振興里,160,1,902,12,914,1244,3,1,3,0,1,0,73.47
臺北縣,板橋市,振興里,161,1,657,10,667,870,3,1,3,0,1,0,76.67
臺北縣,板橋市,振義里,162,1,935,10,945,1353,3,1,3,0,1,0,69.84
臺北縣,板橋市,振義里,163,1,747,16,763,1088,3,1,3,0,1,0,70.13
臺北縣,板橋市,振義里,164,1,604,5,609,883,3,1,3,0,1,0,68.97
臺北縣,板橋市,光復里,165,1,862,11,873,1225,3,1,3,0,1,0,71.27
臺北縣,板橋市,光復里,166,1,824,11,835,1239,3,1,3,0,1,0,67.39
臺北縣,板橋市,埔墘里,167,1,958,13,971,1420,3,1,3,0,1,0,68.38
臺北縣,板橋市,埔墘里,168,1,913,19,932,1319,3,1,3,0,1,0,70.66
臺北縣,板橋市,埔墘里,169,1,839,36,875,1285,3,1,3,0,1,0,68.09
臺北縣,板橋市,富貴里,170,1,583,9,592,866,3,1,3,0,1,0,68.36
臺北縣,板橋市,富貴里,171,1,647,3,650,929,3,1,3,0,1,0,69.97
臺北縣,板橋市,長壽里,172,1,865,15,880,1179,3,1,3,0,1,0,74.64
臺北縣,板橋市,長壽里,173,1,778,16,794,1120,3,1,3,0,1,0,70.89
臺北縣,板橋市,福壽里,174,1,693,7,700,983,3,1,3,0,1,0,71.21
臺北縣,板橋市,福壽里,175,1,784,19,803,1093,3,1,3,0,1,0,73.47
臺北縣,板橋市,居仁里,176,1,843,16,859,1207,3,1,3,0,1,0,71.17
臺北縣,板橋市,居仁里,177,1,809,17,826,1165,3,1,3,0,1,0,70.90
臺北縣,板橋市,海山里,178,1,824,14,838,1155,3,1,3,0,1,0,72.55
臺北縣,板橋市,海山里,179,1,734,13,747,1061,3,1,3,0,1,0,70.41
臺北縣,板橋市,海山里,180,1,858,26,884,1246,3,1,3,0,1,0,70.95
臺北縣,板橋市,海山里,181,1,852,21,873,1253,3,1,3,0,1,0,69.67
臺北縣,板橋市,九如里,182,1,827,13,840,1221,3,1,3,0,1,0,68.80
臺北縣,板橋市,九如里,183,1,739,10,749,1073,3,1,3,0,1,0,69.80
臺北縣,板橋市,正泰里,184,1,871,14,885,1249,3,1,3,0,1,0,70.86
臺北縣,板橋市,正泰里,185,1,776,15,791,1056,3,1,3,0,1,0,74.91
臺北縣,板橋市,玉光里,186,1,1029,16,1045,1583,3,1,3,0,1,0,66.01
臺北縣,板橋市,玉光里,187,1,823,12,835,1215,3,1,3,0,1,0,68.72
臺北縣,板橋市,玉光里,188,1,751,18,769,1104,3,1,3,0,1,0,69.66
臺北縣,板橋市,光仁里,189,1,851,13,864,1219,3,1,3,0,1,0,70.88
臺北縣,板橋市,光仁里,190,1,762,18,780,1083,3,1,3,0,1,0,72.02
臺北縣,板橋市,埤墘里,191,1,1136,14,1150,1643,3,1,3,0,1,0,69.99
臺北縣,板橋市,埤墘里,192,1,799,16,815,1259,3,1,3,0,1,0,64.73
臺北縣,板橋市,莊敬里,193,1,985,20,1005,1380,3,1,3,0,1,0,72.83
臺北縣,板橋市,莊敬里,194,1,782,9,791,1116,3,1,3,0,1,0,70.88
臺北縣,板橋市,永安里,195,1,943,20,963,1371,3,1,3,0,1,0,70.24
臺北縣,板橋市,永安里,196,1,810,11,821,1169,3,1,3,0,1,0,70.23
臺北縣,板橋市,雙玉里,197,1,1159,19,1178,1671,3,1,3,0,1,0,70.50
臺北縣,板橋市,雙玉里,198,1,810,19,829,1172,3,1,3,0,1,0,70.73
臺北縣,板橋市,廣新里,199,1,507,12,519,857,3,1,3,0,1,0,60.56
臺北縣,板橋市,廣新里,200,1,630,17,647,989,3,1,3,0,1,0,65.42
臺北縣,板橋市,廣新里,201,1,737,5,742,1023,3,1,3,0,1,0,72.53
臺北縣,板橋市,深丘里,202,1,768,6,774,1117,3,1,3,0,1,0,69.29
臺北縣,板橋市,深丘里,203,1,913,9,922,1310,3,1,3,0,1,0,70.38
臺北縣,板橋市,深丘里,204,1,628,10,638,956,3,1,3,0,1,0,66.74
臺北縣,板橋市,深丘里,205,1,575,7,582,806,3,1,3,0,1,0,72.21
臺北縣,板橋市,香丘里,206,1,643,15,658,963,3,1,3,0,1,0,68.33
臺北縣,板橋市,香丘里,207,1,560,21,581,804,3,1,3,0,1,0,72.26
臺北縣,板橋市,香丘里,208,1,703,12,715,1043,3,1,3,0,1,0,68.55
臺北縣,板橋市,西安里,209,1,783,18,801,1120,3,1,3,0,1,0,71.52
臺北縣,板橋市,西安里,210,1,673,12,685,963,3,1,3,0,1,0,71.13
臺北縣,板橋市,東丘里,211,1,727,9,736,1088,3,1,3,0,1,0,67.65
臺北縣,板橋市,東丘里,212,1,796,17,813,1178,3,1,3,0,1,0,69.02
臺北縣,板橋市,東丘里,213,1,766,14,780,1116,3,1,3,0,1,0,69.89
臺北縣,板橋市,民生里,214,1,490,11,501,729,3,1,3,0,1,0,68.72
臺北縣,板橋市,民生里,215,1,583,17,600,841,3,1,3,0,1,0,71.34
臺北縣,板橋市,長安里,216,1,1051,16,1067,1518,3,1,3,0,1,0,70.29
臺北縣,板橋市,長安里,217,1,872,11,883,1313,3,1,3,0,1,0,67.25
臺北縣,板橋市,東安里,218,1,638,10,648,943,3,1,3,0,1,0,68.72
臺北縣,板橋市,東安里,219,1,689,8,697,1162,3,1,3,0,1,0,59.98
臺北縣,板橋市,福丘里,220,1,680,10,690,993,3,1,3,0,1,0,69.49
臺北縣,板橋市,福丘里,221,1,410,2,412,600,3,1,3,0,1,0,68.67
臺北縣,板橋市,福祿里,222,1,943,13,956,1447,3,1,3,0,1,0,66.07
臺北縣,板橋市,福祿里,223,1,916,25,941,1328,3,1,3,0,1,0,70.86
臺北縣,板橋市,民族里,224,1,730,10,740,1053,3,1,3,0,1,0,70.28
臺北縣,板橋市,民族里,225,1,716,7,723,1020,3,1,3,0,1,0,70.88
臺北縣,板橋市,民族里,226,1,590,7,597,859,3,1,3,0,1,0,69.50
臺北縣,板橋市,國泰里,227,1,753,8,761,1111,3,1,3,0,1,0,68.50
臺北縣,板橋市,國泰里,228,1,875,18,893,1247,3,1,3,0,1,0,71.61
臺北縣,板橋市,後埔里,229,1,877,12,889,1296,3,1,3,0,1,0,68.60
臺北縣,板橋市,後埔里,230,1,952,9,961,1373,3,1,3,0,1,0,69.99
臺北縣,板橋市,福德里,231,1,853,12,865,1207,3,1,3,0,1,0,71.67
臺北縣,板橋市,福德里,232,1,888,13,901,1257,3,1,3,0,1,0,71.68
臺北縣,板橋市,福德里,233,1,1033,18,1051,1471,3,1,3,0,1,0,71.45
臺北縣,板橋市,景星里,234,1,815,17,832,1149,3,1,3,0,1,0,72.41
臺北縣,板橋市,景星里,235,1,940,18,958,1403,3,1,3,0,1,0,68.28
臺北縣,板橋市,福星里,236,1,954,20,974,1361,3,1,3,0,1,0,71.57
臺北縣,板橋市,福星里,237,1,792,16,808,1118,3,1,3,0,1,0,72.27
臺北縣,板橋市,鄉雲里,238,1,997,19,1016,1375,3,1,3,0,1,0,73.89
臺北縣,板橋市,鄉雲里,239,1,835,10,845,1161,3,1,3,0,1,0,72.78
臺北縣,板橋市,廣德里,240,1,811,21,832,1196,3,1,3,0,1,0,69.57
臺北縣,板橋市,廣德里,241,1,579,10,589,885,3,1,3,0,1,0,66.55
臺北縣,板橋市,廣德里,242,1,811,13,824,1149,3,1,3,0,1,0,71.71
臺北縣,板橋市,廣德里,243,1,923,13,936,1307,3,1,3,0,1,0,71.61
臺北縣,板橋市,大豐里,244,1,980,19,999,1408,3,1,3,0,1,0,70.95
臺北縣,板橋市,大豐里,245,1,748,10,758,1113,3,1,3,0,1,0,68.10
臺北縣,板橋市,大豐里,246,1,807,8,815,1187,3,1,3,0,1,0,68.66
臺北縣,板橋市,重慶里,247,1,969,10,979,1460,3,1,3,0,1,0,67.05
臺北縣,板橋市,重慶里,248,1,1062,26,1088,1555,3,1,3,0,1,0,69.97
臺北縣,板橋市,重慶里,249,1,1071,14,1085,1605,3,1,3,0,1,0,67.60
臺北縣,板橋市,重慶里,250,1,890,11,901,1334,3,1,3,0,1,0,67.54
臺北縣,板橋市,仁愛里,251,1,673,5,678,917,3,1,3,0,1,0,73.94
臺北縣,板橋市,仁愛里,252,1,619,6,625,863,3,1,3,0,1,0,72.42
臺北縣,板橋市,仁愛里,253,1,616,9,625,896,3,1,3,0,1,0,69.75
臺北縣,板橋市,和平里,254,1,555,12,567,874,3,1,3,0,1,0,64.87
臺北縣,板橋市,廣福里,255,1,765,14,779,1113,3,1,3,0,1,0,69.99
臺北縣,板橋市,廣福里,256,1,853,10,863,1315,3,1,3,0,1,0,65.63
臺北縣,板橋市,五權里,257,1,750,9,759,1067,3,1,3,0,1,0,71.13
臺北縣,板橋市,五權里,258,1,865,5,870,1232,3,1,3,0,1,0,70.62
臺北縣,板橋市,五權里,259,1,841,13,854,1267,3,1,3,0,1,0,67.40
臺北縣,板橋市,華興里,260,1,952,15,967,1430,3,1,3,0,1,0,67.62
臺北縣,板橋市,華興里,261,1,1079,26,1105,1571,3,1,3,0,1,0,70.34
臺北縣,板橋市,華貴里,262,1,766,18,784,1077,3,1,3,0,1,0,72.79
臺北縣,板橋市,華貴里,263,1,828,14,842,1163,3,1,3,0,1,0,72.40
臺北縣,板橋市,華福里,264,1,649,11,660,936,3,1,3,0,1,0,70.51
臺北縣,板橋市,華福里,265,1,536,10,546,769,3,1,3,0,1,0,71.00
臺北縣,板橋市,華德里,266,1,1089,22,1111,1710,3,1,3,0,1,0,64.97
臺北縣,板橋市,華德里,267,1,1054,11,1065,1591,3,1,3,0,1,0,66.94
臺北縣,板橋市,華德里,268,1,1115,24,1139,1634,3,1,3,0,1,0,69.71
臺北縣,板橋市,華東里,269,1,882,12,894,1240,3,1,3,0,1,0,72.10
臺北縣,板橋市,華東里,270,1,1094,8,1102,1570,3,1,3,0,1,0,70.19
臺北縣,板橋市,華東里,271,1,976,17,993,1401,3,1,3,0,1,0,70.88
臺北縣,板橋市,信義里,272,1,805,10,815,1215,3,1,3,0,1,0,67.08
臺北縣,板橋市,信義里,273,1,674,13,687,951,3,1,3,0,1,0,72.24
臺北縣,板橋市,信義里,274,1,754,13,767,1108,3,1,3,0,1,0,69.22
臺北縣,板橋市,浮洲里,275,1,787,5,792,1238,3,1,3,0,1,0,63.97
臺北縣,板橋市,浮洲里,276,1,665,20,685,1034,3,1,3,0,1,0,66.25
臺北縣,板橋市,浮洲里,277,1,609,9,618,1204,3,1,3,0,1,0,51.33
臺北縣,板橋市,華中里,278,1,795,6,801,1172,3,1,3,0,1,0,68.34
臺北縣,板橋市,華中里,279,1,954,21,975,1427,3,1,3,0,1,0,68.33
臺北縣,板橋市,華中里,280,1,968,16,984,1425,3,1,3,0,1,0,69.05
臺北縣,板橋市,僑中里,281,1,807,17,824,1182,3,1,3,0,1,0,69.71
臺北縣,板橋市,僑中里,282,1,524,12,536,779,3,1,3,0,1,0,68.81
臺北縣,板橋市,僑中里,283,1,614,12,626,835,3,1,3,0,1,0,74.97
臺北縣,板橋市,大觀里,284,1,860,16,876,1212,3,1,3,0,1,0,72.28
臺北縣,板橋市,大觀里,285,1,961,8,969,1371,3,1,3,0,1,0,70.68
臺北縣,板橋市,歡園里,286,1,697,11,708,975,3,1,3,0,1,0,72.62
臺北縣,板橋市,中山里,287,1,667,7,674,1034,3,1,3,0,1,0,65.18
臺北縣,板橋市,中山里,288,1,533,13,546,870,3,1,3,0,1,0,62.76
臺北縣,板橋市,中山里,289,1,744,10,754,1130,3,1,3,0,1,0,66.73
臺北縣,板橋市,中山里,290,1,616,8,624,873,3,1,3,0,1,0,71.48
臺北縣,板橋市,復興里,291,1,407,29,436,691,3,1,3,0,1,0,63.10
臺北縣,板橋市,復興里,292,1,465,22,487,728,3,1,3,0,1,0,66.90
臺北縣,板橋市,復興里,293,1,454,24,478,697,3,1,3,0,1,0,68.58
臺北縣,板橋市,大安里,294,1,752,16,768,1167,3,1,3,0,1,0,65.81
臺北縣,板橋市,大安里,295,1,875,19,894,1283,3,1,3,0,1,0,69.68
臺北縣,板橋市,大安里,296,1,637,15,652,919,3,1,3,0,1,0,70.95
臺北縣,板橋市,福安里,297,1,828,19,847,1161,3,1,3,0,1,0,72.95
臺北縣,板橋市,福安里,298,1,611,12,623,1020,3,1,3,0,1,0,61.08
臺北縣,板橋市,聚安里,299,1,547,12,559,866,3,1,3,0,1,0,64.55
臺北縣,板橋市,聚安里,300,1,672,10,682,998,3,1,3,0,1,0,68.34
臺北縣,板橋市,聚安里,301,1,558,11,569,893,3,1,3,0,1,0,63.72
臺北縣,板橋市,聚安里,302,1,759,15,774,1157,3,1,3,0,1,0,66.90
臺北縣,板橋市,龍安里,303,1,776,13,789,1148,3,1,3,0,1,0,68.73
臺北縣,板橋市,龍安里,304,1,792,22,814,1232,3,1,3,0,1,0,66.07
臺北縣,板橋市,崑崙里,305,1,806,15,821,1224,3,1,3,0,1,0,67.08
臺北縣,板橋市,崑崙里,306,1,772,19,791,1288,3,1,3,0,1,0,61.41
臺北縣,板橋市,崑崙里,307,1,797,11,808,1217,3,1,3,0,1,0,66.39
臺北縣,板橋市,崑崙里,308,1,1053,10,1063,1586,3,1,3,0,1,0,67.02
臺北縣,板橋市,成和里,309,1,1166,28,1194,1828,3,1,3,0,1,0,65.32
臺北縣,板橋市,成和里,310,1,838,12,850,1284,3,1,3,0,1,0,66.20
臺北縣,板橋市,溪洲里,311,1,892,14,906,1284,3,1,3,0,1,0,70.56
臺北縣,板橋市,溪洲里,312,1,999,12,1011,1536,3,1,3,0,1,0,65.82
臺北縣,板橋市,溪洲里,313,1,810,16,826,1319,3,1,3,0,1,0,62.62
臺北縣,板橋市,溪福里,314,1,1130,25,1155,1761,3,1,3,0,1,0,65.59
臺北縣,板橋市,溪福里,315,1,1253,22,1275,1919,3,1,3,0,1,0,66.44
臺北縣,板橋市,溪福里,316,1,1162,16,1178,1815,3,1,3,0,1,0,64.90
臺北縣,板橋市,溪福里,317,1,1167,26,1193,1816,3,1,3,0,1,0,65.69
臺北縣,板橋市,溪北里,318,1,797,13,810,1187,3,1,3,0,1,0,68.24
臺北縣,板橋市,溪北里,319,1,911,12,923,1336,3,1,3,0,1,0,69.09
臺北縣,板橋市,堂春里,320,1,884,13,897,1327,3,1,3,0,1,0,67.60
臺北縣,板橋市,堂春里,321,1,968,10,978,1446,3,1,3,0,1,0,67.63
臺北縣,土城市,祖田里,322,1,877,12,889,1204,3,1,3,0,1,0,73.84
臺北縣,土城市,頂新里,323,1,872,20,892,1205,3,1,3,0,1,0,74.02
臺北縣,土城市,頂福里,324,1,738,16,754,1081,3,1,3,0,1,0,69.75
臺北縣,土城市,頂福里,325,1,645,9,654,959,3,1,3,0,1,0,68.20
臺北縣,土城市,頂埔里,326,1,879,11,890,1264,3,1,3,0,1,0,70.41
臺北縣,土城市,頂埔里,327,1,709,16,725,1120,3,1,3,0,1,0,64.73
臺北縣,土城市,頂埔里,328,1,804,18,822,1255,3,1,3,0,1,0,65.50
臺北縣,土城市,頂埔里,329,1,707,13,720,1021,3,1,3,0,1,0,70.52
臺北縣,土城市,沛陂里,330,1,803,19,822,1181,3,1,3,0,1,0,69.60
臺北縣,土城市,沛陂里,331,1,792,17,809,1197,3,1,3,0,1,0,67.59
臺北縣,土城市,永寧里,332,1,811,11,822,1255,3,1,3,0,1,0,65.50
臺北縣,土城市,永寧里,333,1,725,7,732,1108,3,1,3,0,1,0,66.06
臺北縣,土城市,永寧里,334,1,794,16,810,1206,3,1,3,0,1,0,67.16
臺北縣,土城市,永寧里,335,1,1075,17,1092,1596,3,1,3,0,1,0,68.42
臺北縣,土城市,大安里,336,1,447,6,453,640,3,1,3,0,1,0,70.78
臺北縣,土城市,大安里,337,1,1008,19,1027,1497,3,1,3,0,1,0,68.60
臺北縣,土城市,大安里,338,1,820,9,829,1293,3,1,3,0,1,0,64.11
臺北縣,土城市,員仁里,339,1,895,25,920,1390,3,1,3,0,1,0,66.19
臺北縣,土城市,員仁里,340,1,718,16,734,1100,3,1,3,0,1,0,66.73
臺北縣,土城市,員仁里,341,1,934,9,943,1438,3,1,3,0,1,0,65.58
臺北縣,土城市,埤塘里,342,1,614,14,628,1155,3,1,3,0,1,0,54.37
臺北縣,土城市,埤塘里,343,1,772,13,785,1134,3,1,3,0,1,0,69.22
臺北縣,土城市,土城里,344,1,1067,16,1083,1620,3,1,3,0,1,0,66.85
臺北縣,土城市,長風里,345,1,957,16,973,1273,3,1,3,0,1,0,76.43
臺北縣,土城市,員信里,346,1,1135,15,1150,1642,3,1,3,0,1,0,70.04
臺北縣,土城市,員信里,347,1,976,8,984,1409,3,1,3,0,1,0,69.84
臺北縣,土城市,員林里,348,1,815,12,827,1216,3,1,3,0,1,0,68.01
臺北縣,土城市,員林里,349,1,1021,13,1034,1485,3,1,3,0,1,0,69.63
臺北縣,土城市,員林里,350,1,945,19,964,1350,3,1,3,0,1,0,71.41
臺北縣,土城市,員福里,351,1,761,13,774,1040,3,1,3,0,1,0,74.42
臺北縣,土城市,員福里,352,1,995,13,1008,1445,3,1,3,0,1,0,69.76
臺北縣,土城市,員福里,353,1,1045,19,1064,1523,3,1,3,0,1,0,69.86
臺北縣,土城市,日和里,354,1,808,9,817,1199,3,1,3,0,1,0,68.14
臺北縣,土城市,日和里,355,1,993,14,1007,1507,3,1,3,0,1,0,66.82
臺北縣,土城市,日和里,356,1,782,6,788,1176,3,1,3,0,1,0,67.01
臺北縣,土城市,日新里,357,1,907,12,919,1344,3,1,3,0,1,0,68.38
臺北縣,土城市,日新里,358,1,789,13,802,1115,3,1,3,0,1,0,71.93
臺北縣,土城市,日新里,359,1,788,14,802,1136,3,1,3,0,1,0,70.60
臺北縣,土城市,裕生里,360,1,971,14,985,1420,3,1,3,0,1,0,69.37
臺北縣,土城市,裕生里,361,1,900,19,919,1412,3,1,3,0,1,0,65.08
臺北縣,土城市,裕生里,362,1,926,15,941,1409,3,1,3,0,1,0,66.78
臺北縣,土城市,貨饒里,363,1,1013,14,1027,1468,3,1,3,0,1,0,69.96
臺北縣,土城市,貨饒里,364,1,1026,13,1039,1498,3,1,3,0,1,0,69.36
臺北縣,土城市,瑞興里,365,1,972,10,982,1319,3,1,3,0,1,0,74.45
臺北縣,土城市,瑞興里,366,1,856,15,871,1242,3,1,3,0,1,0,70.13
臺北縣,土城市,復興里,367,1,990,16,1006,1520,3,1,3,0,1,0,66.18
臺北縣,土城市,復興里,368,1,1183,16,1199,1696,3,1,3,0,1,0,70.70
臺北縣,土城市,廣福里,369,1,888,9,897,1284,3,1,3,0,1,0,69.86
臺北縣,土城市,廣福里,370,1,812,10,822,1182,3,1,3,0,1,0,69.54
臺北縣,土城市,廣福里,371,1,911,9,920,1281,3,1,3,0,1,0,71.82
臺北縣,土城市,學成里,372,1,908,18,926,1280,3,1,3,0,1,0,72.34
臺北縣,土城市,學成里,373,1,759,11,770,1094,3,1,3,0,1,0,70.38
臺北縣,土城市,埤林里,374,1,875,13,888,1284,3,1,3,0,1,0,69.16
臺北縣,土城市,埤林里,375,1,706,7,713,1075,3,1,3,0,1,0,66.33
臺北縣,土城市,埤林里,376,1,731,5,736,1053,3,1,3,0,1,0,69.90
臺北縣,土城市,埤林里,377,1,796,9,805,1155,3,1,3,0,1,0,69.70
臺北縣,土城市,埤林里,378,1,652,4,656,920,3,1,3,0,1,0,71.30
臺北縣,土城市,廣興里,379,1,649,9,658,1020,3,1,3,0,1,0,64.51
臺北縣,土城市,廣興里,380,1,914,17,931,1375,3,1,3,0,1,0,67.71
臺北縣,土城市,樂利里,381,1,885,18,903,1348,3,1,3,0,1,0,66.99
臺北縣,土城市,樂利里,382,1,920,16,936,1402,3,1,3,0,1,0,66.76
臺北縣,土城市,樂利里,383,1,762,10,772,1277,3,1,3,0,1,0,60.45
臺北縣,土城市,學府里,384,1,898,18,916,1369,3,1,3,0,1,0,66.91
臺北縣,土城市,學府里,385,1,742,16,758,1109,3,1,3,0,1,0,68.35
臺北縣,土城市,明德里,386,1,644,14,658,965,3,1,3,0,1,0,68.19
臺北縣,土城市,明德里,387,1,631,5,636,952,3,1,3,0,1,0,66.81
臺北縣,土城市,明德里,388,1,766,13,779,1123,3,1,3,0,1,0,69.37
臺北縣,土城市,學士里,389,1,1112,14,1126,1600,3,1,3,0,1,0,70.38
臺北縣,土城市,學士里,390,1,1039,11,1050,1486,3,1,3,0,1,0,70.66
臺北縣,土城市,柑林里,391,1,659,6,665,964,3,1,3,0,1,0,68.98
臺北縣,土城市,柑林里,392,1,622,7,629,866,3,1,3,0,1,0,72.63
臺北縣,土城市,中正里,393,1,711,9,720,1068,3,1,3,0,1,0,67.42
臺北縣,土城市,中正里,394,1,696,12,708,1032,3,1,3,0,1,0,68.60
臺北縣,土城市,青雲里,395,1,824,17,841,1195,3,1,3,0,1,0,70.38
臺北縣,土城市,青雲里,396,1,620,5,625,862,3,1,3,0,1,0,72.51
臺北縣,土城市,清和里,397,1,969,18,987,1409,3,1,3,0,1,0,70.05
臺北縣,土城市,清和里,398,1,1106,19,1125,1694,3,1,3,0,1,0,66.41
臺北縣,土城市,清和里,399,1,971,11,982,1430,3,1,3,0,1,0,68.67
臺北縣,土城市,清化里,400,1,875,12,887,1269,3,1,3,0,1,0,69.90
臺北縣,土城市,清溪里,401,1,730,15,745,1062,3,1,3,0,1,0,70.15
臺北縣,土城市,清溪里,402,1,678,12,690,968,3,1,3,0,1,0,71.28
臺北縣,土城市,清溪里,403,1,992,21,1013,1439,3,1,3,0,1,0,70.40
臺北縣,土城市,清溪里,404,1,1044,18,1062,1516,3,1,3,0,1,0,70.05
臺北縣,土城市,青山里,405,1,766,9,775,1090,3,1,3,0,1,0,71.10
臺北縣,土城市,青山里,406,1,772,15,787,1130,3,1,3,0,1,0,69.65
臺北縣,土城市,清水里,407,1,873,14,887,1298,3,1,3,0,1,0,68.34
臺北縣,土城市,清水里,408,1,946,10,956,1338,3,1,3,0,1,0,71.45
臺北縣,土城市,清水里,409,1,801,11,812,1238,3,1,3,0,1,0,65.59
臺北縣,土城市,清水里,410,1,891,7,898,1330,3,1,3,0,1,0,67.52
臺北縣,土城市,永豐里,411,1,799,12,811,1149,3,1,3,0,1,0,70.58
臺北縣,土城市,永豐里,412,1,711,16,727,1073,3,1,3,0,1,0,67.75
臺北縣,土城市,永富里,413,1,738,11,749,1151,3,1,3,0,1,0,65.07
臺北縣,土城市,永富里,414,1,868,21,889,1321,3,1,3,0,1,0,67.30
臺北縣,土城市,永富里,415,1,832,13,845,1328,3,1,3,0,1,0,63.63
臺北縣,土城市,廷寮里,416,1,734,12,746,1106,3,1,3,0,1,0,67.45
臺北縣,土城市,廷寮里,417,1,642,7,649,955,3,1,3,0,1,0,67.96
臺北縣,土城市,廷寮里,418,1,762,8,770,1127,3,1,3,0,1,0,68.32
臺北縣,土城市,金城里,419,1,867,12,879,1364,3,1,3,0,1,0,64.44
臺北縣,土城市,金城里,420,1,721,11,732,1040,3,1,3,0,1,0,70.38
臺北縣,土城市,金城里,421,1,954,9,963,1392,3,1,3,0,1,0,69.18
臺北縣,土城市,峰廷里,422,1,721,12,733,1072,3,1,3,0,1,0,68.38
臺北縣,土城市,峰廷里,423,1,892,15,907,1367,3,1,3,0,1,0,66.35
臺北縣,土城市,峰廷里,424,1,854,11,865,1334,3,1,3,0,1,0,64.84
臺北縣,土城市,峰廷里,425,1,924,7,931,1444,3,1,3,0,1,0,64.47
臺北縣,土城市,延吉里,426,1,954,22,976,1430,3,1,3,0,1,0,68.25
臺北縣,土城市,延吉里,427,1,1173,16,1189,1707,3,1,3,0,1,0,69.65
臺北縣,土城市,延壽里,428,1,1200,20,1220,1800,3,1,3,0,1,0,67.78
臺北縣,土城市,延壽里,429,1,953,9,962,1400,3,1,3,0,1,0,68.71
臺北縣,土城市,延祿里,430,1,920,11,931,1366,3,1,3,0,1,0,68.16
臺北縣,土城市,延祿里,431,1,1130,9,1139,1665,3,1,3,0,1,0,68.41
臺北縣,土城市,平和里,432,1,853,17,870,1212,3,1,3,0,1,0,71.78
臺北縣,土城市,平和里,433,1,958,14,972,1373,3,1,3,0,1,0,70.79
臺北縣,土城市,平和里,434,1,651,6,657,984,3,1,3,0,1,0,66.77
臺北縣,土城市,平和里,435,1,826,22,848,1234,3,1,3,0,1,0,68.72
臺北縣,土城市,安和里,436,1,911,15,926,1359,3,1,3,0,1,0,68.14
臺北縣,土城市,安和里,437,1,696,8,704,1030,3,1,3,0,1,0,68.35
臺北縣,土城市,安和里,438,1,845,11,856,1244,3,1,3,0,1,0,68.81
臺北縣,土城市,延和里,439,1,766,14,780,1152,3,1,3,0,1,0,67.71
臺北縣,土城市,延和里,440,1,916,20,936,1416,3,1,3,0,1,0,66.10
臺北縣,土城市,延和里,441,1,1112,19,1131,1753,3,1,3,0,1,0,64.52
臺北縣,樹林鎮,保安里,442,1,767,12,779,1152,3,1,3,0,1,0,67.62
臺北縣,樹林鎮,保安里,443,1,833,17,850,1201,3,1,3,0,1,0,70.77
臺北縣,樹林鎮,保安里,444,1,694,16,710,985,3,1,3,0,1,0,72.08
臺北縣,樹林鎮,保安里,445,1,705,8,713,1024,3,1,3,0,1,0,69.63
臺北縣,樹林鎮,圳福里,446,1,664,10,674,1029,3,1,3,0,1,0,65.50
臺北縣,樹林鎮,圳福里,447,1,650,16,666,956,3,1,3,0,1,0,69.67
臺北縣,樹林鎮,圳福里,448,1,608,13,621,934,3,1,3,0,1,0,66.49
臺北縣,樹林鎮,圳安里,449,1,671,12,683,971,3,1,3,0,1,0,70.34
臺北縣,樹林鎮,圳安里,450,1,866,15,881,1413,3,1,3,0,1,0,62.35
臺北縣,樹林鎮,圳民里,451,1,594,5,599,910,3,1,3,0,1,0,65.82
臺北縣,樹林鎮,圳民里,452,1,603,5,608,954,3,1,3,0,1,0,63.73
臺北縣,樹林鎮,圳生里,453,1,789,12,801,1128,3,1,3,0,1,0,71.01
臺北縣,樹林鎮,三龍里,454,1,1002,20,1022,1466,3,1,3,0,1,0,69.71
臺北縣,樹林鎮,三多里,455,1,798,23,821,1288,3,1,3,0,1,0,63.74
臺北縣,樹林鎮,三多里,456,1,988,24,1012,1420,3,1,3,0,1,0,71.27
臺北縣,樹林鎮,三福里,457,1,725,10,735,1092,3,1,3,0,1,0,67.31
臺北縣,樹林鎮,三福里,458,1,743,11,754,1102,3,1,3,0,1,0,68.42
臺北縣,樹林鎮,三福里,459,1,639,11,650,967,3,1,3,0,1,0,67.22
臺北縣,樹林鎮,三興里,460,1,633,11,644,996,3,1,3,0,1,0,64.66
臺北縣,樹林鎮,三興里,461,1,774,13,787,1233,3,1,3,0,1,0,63.83
臺北縣,樹林鎮,三興里,462,1,809,7,816,1318,3,1,3,0,1,0,61.91
臺北縣,樹林鎮,羌寮里,463,1,724,8,732,1047,3,1,3,0,1,0,69.91
臺北縣,樹林鎮,羌寮里,464,1,750,14,764,1171,3,1,3,0,1,0,65.24
臺北縣,樹林鎮,羌寮里,465,1,636,9,645,1021,3,1,3,0,1,0,63.17
臺北縣,樹林鎮,光興里,466,1,827,20,847,1251,3,1,3,0,1,0,67.71
臺北縣,樹林鎮,光興里,467,1,764,11,775,1277,3,1,3,0,1,0,60.69
臺北縣,樹林鎮,金寮里,468,1,873,20,893,1310,3,1,3,0,1,0,68.17
臺北縣,樹林鎮,金寮里,469,1,838,14,852,1382,3,1,3,0,1,0,61.65
臺北縣,樹林鎮,潭底里,470,1,653,4,657,1059,3,1,3,0,1,0,62.04
臺北縣,樹林鎮,潭底里,471,1,647,11,658,942,3,1,3,0,1,0,69.85
臺北縣,樹林鎮,潭底里,472,1,831,16,847,1259,3,1,3,0,1,0,67.28
臺北縣,樹林鎮,文林里,473,1,802,24,826,1209,3,1,3,0,1,0,68.32
臺北縣,樹林鎮,文林里,474,1,683,4,687,1065,3,1,3,0,1,0,64.51
臺北縣,樹林鎮,文林里,475,1,611,10,621,1002,3,1,3,0,1,0,61.98
臺北縣,樹林鎮,樹東里,476,1,716,10,726,993,3,1,3,0,1,0,73.11
臺北縣,樹林鎮,樹北里,477,1,755,11,766,1042,3,1,3,0,1,0,73.51
臺北縣,樹林鎮,樹福里,478,1,756,16,772,1076,3,1,3,0,1,0,71.75
臺北縣,樹林鎮,樹福里,479,1,589,13,602,816,3,1,3,0,1,0,73.77
臺北縣,樹林鎮,樹德里,480,1,864,4,868,1250,3,1,3,0,1,0,69.44
臺北縣,樹林鎮,樹德里,481,1,1109,13,1122,1598,3,1,3,0,1,0,70.21
臺北縣,樹林鎮,樹西里,482,1,716,12,728,1020,3,1,3,0,1,0,71.37
臺北縣,樹林鎮,樹西里,483,1,948,12,960,1343,3,1,3,0,1,0,71.48
臺北縣,樹林鎮,樹西里,484,1,1022,13,1035,1444,3,1,3,0,1,0,71.68
臺北縣,樹林鎮,育英里,485,1,714,19,733,1006,3,1,3,0,1,0,72.86
臺北縣,樹林鎮,育英里,486,1,807,15,822,1144,3,1,3,0,1,0,71.85
臺北縣,樹林鎮,樹南里,487,1,1063,14,1077,1574,3,1,3,0,1,0,68.42
臺北縣,樹林鎮,樹南里,488,1,1002,12,1014,1466,3,1,3,0,1,0,69.17
臺北縣,樹林鎮,樹人里,489,1,841,17,858,1212,3,1,3,0,1,0,70.79
臺北縣,樹林鎮,樹人里,490,1,851,15,866,1232,3,1,3,0,1,0,70.29
臺北縣,樹林鎮,樹興里,491,1,795,13,808,1155,3,1,3,0,1,0,69.96
臺北縣,樹林鎮,樹興里,492,1,1071,12,1083,1568,3,1,3,0,1,0,69.07
臺北縣,樹林鎮,坡內里,493,1,843,10,853,1197,3,1,3,0,1,0,71.26
臺北縣,樹林鎮,大同里,494,1,874,12,886,1208,3,1,3,0,1,0,73.34
臺北縣,樹林鎮,大同里,495,1,610,12,622,957,3,1,3,0,1,0,64.99
臺北縣,樹林鎮,中華里,496,1,677,13,690,1075,3,1,3,0,1,0,64.19
臺北縣,樹林鎮,中華里,497,1,615,2,617,995,3,1,3,0,1,0,62.01
臺北縣,樹林鎮,太順里,498,1,548,8,556,895,3,1,3,0,1,0,62.12
臺北縣,樹林鎮,太順里,499,1,618,8,626,959,3,1,3,0,1,0,65.28
臺北縣,樹林鎮,和平里,500,1,1087,20,1107,1544,3,1,3,0,1,0,71.70
臺北縣,樹林鎮,和平里,501,1,951,20,971,1497,3,1,3,0,1,0,64.86
臺北縣,樹林鎮,彭興里,502,1,787,12,799,1259,3,1,3,0,1,0,63.46
臺北縣,樹林鎮,彭興里,503,1,814,23,837,1317,3,1,3,0,1,0,63.55
臺北縣,樹林鎮,彭興里,504,1,782,9,791,1256,3,1,3,0,1,0,62.98
臺北縣,樹林鎮,彭厝里,505,1,1024,20,1044,1597,3,1,3,0,1,0,65.37
臺北縣,樹林鎮,彭厝里,506,1,983,17,1000,1548,3,1,3,0,1,0,64.60
臺北縣,樹林鎮,彭福里,507,1,771,6,777,1190,3,1,3,0,1,0,65.29
臺北縣,樹林鎮,彭福里,508,1,751,14,765,1130,3,1,3,0,1,0,67.70
臺北縣,樹林鎮,彭福里,509,1,668,8,676,998,3,1,3,0,1,0,67.74
臺北縣,樹林鎮,東昇里,510,1,638,12,650,914,3,1,3,0,1,0,71.12
臺北縣,樹林鎮,東昇里,511,1,777,6,783,1084,3,1,3,0,1,0,72.23
臺北縣,樹林鎮,東昇里,512,1,574,9,583,819,3,1,3,0,1,0,71.18
臺北縣,樹林鎮,東陽里,513,1,862,20,882,1306,3,1,3,0,1,0,67.53
臺北縣,樹林鎮,東陽里,514,1,886,10,896,1300,3,1,3,0,1,0,68.92
臺北縣,樹林鎮,東陽里,515,1,971,12,983,1430,3,1,3,0,1,0,68.74
臺北縣,樹林鎮,東山里,516,1,958,9,967,1424,3,1,3,0,1,0,67.91
臺北縣,樹林鎮,東山里,517,1,691,13,704,1036,3,1,3,0,1,0,67.95
臺北縣,樹林鎮,山佳里,518,1,606,11,617,913,3,1,3,0,1,0,67.58
臺北縣,樹林鎮,山佳里,519,1,689,8,697,1001,3,1,3,0,1,0,69.63
臺北縣,樹林鎮,山佳里,520,1,501,6,507,713,3,1,3,0,1,0,71.11
臺北縣,樹林鎮,中山里,521,1,901,17,918,1300,3,1,3,0,1,0,70.62
臺北縣,樹林鎮,中山里,522,1,866,16,882,1279,3,1,3,0,1,0,68.96
臺北縣,樹林鎮,樂山里,523,1,747,7,754,1176,3,1,3,0,1,0,64.12
臺北縣,樹林鎮,東園里,524,1,880,17,897,1260,3,1,3,0,1,0,71.19
臺北縣,樹林鎮,北園里,525,1,895,12,907,1297,3,1,3,0,1,0,69.93
臺北縣,樹林鎮,柑園里,526,1,860,7,867,1204,3,1,3,0,1,0,72.01
臺北縣,樹林鎮,南園里,527,1,467,7,474,639,3,1,3,0,1,0,74.18
臺北縣,樹林鎮,西園里,528,1,806,18,824,1201,3,1,3,0,1,0,68.61
臺北縣,鶯歌鎮,建德里,529,1,312,2,314,449,3,1,3,0,1,0,69.93
臺北縣,鶯歌鎮,東鶯里,530,1,670,5,675,899,3,1,3,0,1,0,75.08
臺北縣,鶯歌鎮,北鶯里,531,1,910,9,919,1240,3,1,3,0,1,0,74.11
臺北縣,鶯歌鎮,西鶯里,532,1,705,3,708,1008,3,1,3,0,1,0,70.24
臺北縣,鶯歌鎮,西鶯里,533,1,584,10,594,814,3,1,3,0,1,0,72.97
臺北縣,鶯歌鎮,中鶯里,534,1,588,4,592,794,3,1,3,0,1,0,74.56
臺北縣,鶯歌鎮,南鶯里,535,1,979,12,991,1360,3,1,3,0,1,0,72.87
臺北縣,鶯歌鎮,南鶯里,536,1,892,13,905,1279,3,1,3,0,1,0,70.76
臺北縣,鶯歌鎮,南鶯里,537,1,862,5,867,1236,3,1,3,0,1,0,70.15
臺北縣,鶯歌鎮,建國里,538,1,952,21,973,1389,3,1,3,0,1,0,70.05
臺北縣,鶯歌鎮,建國里,539,1,845,10,855,1322,3,1,3,0,1,0,64.67
臺北縣,鶯歌鎮,建國里,540,1,796,8,804,1221,3,1,3,0,1,0,65.85
臺北縣,鶯歌鎮,南靖里,541,1,996,13,1009,1393,3,1,3,0,1,0,72.43
臺北縣,鶯歌鎮,南靖里,542,1,808,9,817,1196,3,1,3,0,1,0,68.31
臺北縣,鶯歌鎮,尖山里,543,1,877,15,892,1243,3,1,3,0,1,0,71.76
臺北縣,鶯歌鎮,尖山里,544,1,946,4,950,1338,3,1,3,0,1,0,71.00
臺北縣,鶯歌鎮,尖山里,545,1,954,16,970,1417,3,1,3,0,1,0,68.45
臺北縣,鶯歌鎮,二橋里,546,1,1079,13,1092,1592,3,1,3,0,1,0,68.59
臺北縣,鶯歌鎮,二橋里,547,1,1083,14,1097,1511,3,1,3,0,1,0,72.60
臺北縣,鶯歌鎮,二橋里,548,1,1168,16,1184,1647,3,1,3,0,1,0,71.89
臺北縣,鶯歌鎮,二甲里,549,1,531,9,540,745,3,1,3,0,1,0,72.48
臺北縣,鶯歌鎮,同慶里,550,1,889,7,896,1208,3,1,3,0,1,0,74.17
臺北縣,鶯歌鎮,永昌里,551,1,849,22,871,1357,3,1,3,0,1,0,64.19
臺北縣,鶯歌鎮,永昌里,552,1,1075,11,1086,1614,3,1,3,0,1,0,67.29
臺北縣,鶯歌鎮,永昌里,553,1,997,10,1007,1515,3,1,3,0,1,0,66.47
臺北縣,鶯歌鎮,永昌里,554,1,992,14,1006,1388,3,1,3,0,1,0,72.48
臺北縣,鶯歌鎮,永吉里,555,1,857,15,872,1226,3,1,3,0,1,0,71.13
臺北縣,鶯歌鎮,永吉里,556,1,792,11,803,1137,3,1,3,0,1,0,70.62
臺北縣,鶯歌鎮,永吉里,557,1,680,7,687,1002,3,1,3,0,1,0,68.56
臺北縣,鶯歌鎮,鳳鳴里,558,1,1040,19,1059,1566,3,1,3,0,1,0,67.62
臺北縣,鶯歌鎮,鳳鳴里,559,1,1122,14,1136,1714,3,1,3,0,1,0,66.28
臺北縣,鶯歌鎮,鳳祥里,560,1,832,15,847,1207,3,1,3,0,1,0,70.17
臺北縣,鶯歌鎮,鳳祥里,561,1,655,6,661,1024,3,1,3,0,1,0,64.55
臺北縣,鶯歌鎮,鳳祥里,562,1,601,6,607,1013,3,1,3,0,1,0,59.92
臺北縣,鶯歌鎮,鳳福里,563,1,625,8,633,960,3,1,3,0,1,0,65.94
臺北縣,鶯歌鎮,鳳福里,564,1,684,12,696,1030,3,1,3,0,1,0,67.57
臺北縣,鶯歌鎮,鳳福里,565,1,819,14,833,1222,3,1,3,0,1,0,68.17
臺北縣,鶯歌鎮,大湖里,566,1,852,12,864,1258,3,1,3,0,1,0,68.68
臺北縣,鶯歌鎮,大湖里,567,1,1002,15,1017,1436,3,1,3,0,1,0,70.82
臺北縣,鶯歌鎮,大湖里,568,1,804,11,815,1179,3,1,3,0,1,0,69.13
臺北縣,鶯歌鎮,中湖里,569,1,974,14,988,1535,3,1,3,0,1,0,64.36
臺北縣,鶯歌鎮,中湖里,570,1,850,13,863,1226,3,1,3,0,1,0,70.39
臺北縣,鶯歌鎮,中湖里,571,1,948,11,959,1359,3,1,3,0,1,0,70.57
臺北縣,鶯歌鎮,東湖里,572,1,168,2,170,230,3,1,3,0,1,0,73.91
臺北縣,三峽鎮,三峽里,573,1,235,4,239,322,3,1,3,0,1,0,74.22
臺北縣,三峽鎮,秀川里,574,1,316,3,319,410,3,1,3,0,1,0,77.80
臺北縣,三峽鎮,八張里,575,1,885,12,897,1219,3,1,3,0,1,0,73.58
臺北縣,三峽鎮,八張里,576,1,858,20,878,1246,3,1,3,0,1,0,70.47
臺北縣,三峽鎮,中埔里,577,1,933,15,948,1365,3,1,3,0,1,0,69.45
臺北縣,三峽鎮,弘道里,578,1,587,4,591,812,3,1,3,0,1,0,72.78
臺北縣,三峽鎮,永舘里,579,1,1016,8,1024,1487,3,1,3,0,1,0,68.86
臺北縣,三峽鎮,永舘里,580,1,1053,8,1061,1521,3,1,3,0,1,0,69.76
臺北縣,三峽鎮,永舘里,581,1,1023,10,1033,1511,3,1,3,0,1,0,68.37
臺北縣,三峽鎮,中正里,582,1,700,5,705,1061,3,1,3,0,1,0,66.45
臺北縣,三峽鎮,中正里,583,1,764,4,768,1125,3,1,3,0,1,0,68.27
臺北縣,三峽鎮,中正里,584,1,766,10,776,1094,3,1,3,0,1,0,70.93
臺北縣,三峽鎮,礁溪里,585,1,727,12,739,1091,3,1,3,0,1,0,67.74
臺北縣,三峽鎮,礁溪里,586,1,590,4,594,825,3,1,3,0,1,0,72.00
臺北縣,三峽鎮,礁溪里,587,1,657,10,667,1014,3,1,3,0,1,0,65.78
臺北縣,三峽鎮,介壽里,588,1,731,11,742,1052,3,1,3,0,1,0,70.53
臺北縣,三峽鎮,介壽里,589,1,707,9,716,1086,3,1,3,0,1,0,65.93
臺北縣,三峽鎮,介壽里,590,1,729,7,736,1128,3,1,3,0,1,0,65.25
臺北縣,三峽鎮,安溪里,591,1,874,14,888,1268,3,1,3,0,1,0,70.03
臺北縣,三峽鎮,安溪里,592,1,867,14,881,1330,3,1,3,0,1,0,66.24
臺北縣,三峽鎮,安溪里,593,1,821,12,833,1147,3,1,3,0,1,0,72.62
臺北縣,三峽鎮,安溪里,594,1,761,9,770,1102,3,1,3,0,1,0,69.87
臺北縣,三峽鎮,龍埔里,595,1,643,12,655,1016,3,1,3,0,1,0,64.47
臺北縣,三峽鎮,龍埔里,596,1,796,14,810,1151,3,1,3,0,1,0,70.37
臺北縣,三峽鎮,龍埔里,597,1,941,14,955,1412,3,1,3,0,1,0,67.63
臺北縣,三峽鎮,龍埔里,598,1,872,12,884,1335,3,1,3,0,1,0,66.22
臺北縣,三峽鎮,鳶山里,599,1,1021,16,1037,1450,3,1,3,0,1,0,71.52
臺北縣,三峽鎮,鳶山里,600,1,815,3,818,1192,3,1,3,0,1,0,68.62
臺北縣,三峽鎮,鳶山里,601,1,866,11,877,1328,3,1,3,0,1,0,66.04
臺北縣,三峽鎮,鳶山里,602,1,892,15,907,1389,3,1,3,0,1,0,65.30
臺北縣,三峽鎮,大埔里,603,1,1101,15,1116,1642,3,1,3,0,1,0,67.97
臺北縣,三峽鎮,大埔里,604,1,1049,9,1058,1486,3,1,3,0,1,0,71.20
臺北縣,三峽鎮,二鬮里,605,1,675,11,686,1083,3,1,3,0,1,0,63.34
臺北縣,三峽鎮,二鬮里,606,1,728,9,737,1154,3,1,3,0,1,0,63.86
臺北縣,三峽鎮,嘉添里,607,1,825,35,860,1181,3,1,3,0,1,0,72.82
臺北縣,三峽鎮,嘉添里,608,1,932,29,961,1400,3,1,3,0,1,0,68.64
臺北縣,三峽鎮,添福里,609,1,662,12,674,944,3,1,3,0,1,0,71.40
臺北縣,三峽鎮,五寮里,610,1,602,7,609,891,3,1,3,0,1,0,68.35
臺北縣,三峽鎮,金圳里,611,1,298,7,305,458,3,1,3,0,1,0,66.59
臺北縣,三峽鎮,插角里,612,1,559,6,565,827,3,1,3,0,1,0,68.32
臺北縣,三峽鎮,有木里,613,1,566,6,572,799,3,1,3,0,1,0,71.59
臺北縣,三峽鎮,溪南里,614,1,847,11,858,1167,3,1,3,0,1,0,73.52
臺北縣,三峽鎮,溪北里,615,1,392,13,405,565,3,1,3,0,1,0,71.68
臺北縣,三峽鎮,溪北里,616,1,870,16,886,1220,3,1,3,0,1,0,72.62
臺北縣,三峽鎮,溪東里,617,1,670,14,684,981,3,1,3,0,1,0,69.72
臺北縣,三峽鎮,溪東里,618,1,834,10,844,1232,3,1,3,0,1,0,68.51
臺北縣,三峽鎮,成福里,619,1,640,5,645,822,3,1,3,0,1,0,78.47
臺北縣,三峽鎮,安坑里,620,1,815,17,832,1264,3,1,3,0,1,0,65.82
臺北縣,三峽鎮,竹崙里,621,1,545,56,601,843,3,1,3,0,1,0,71.29
臺北縣,三峽鎮,竹崙里,622,1,587,9,596,892,3,1,3,0,1,0,66.82
臺北縣,三重市,大有里,623,2,956,18,974,1414,3,1,3,0,1,0,68.88
臺北縣,三重市,大有里,624,2,833,13,846,1197,3,1,3,0,1,0,70.68
臺北縣,三重市,大有里,625,2,509,4,513,746,3,1,3,0,1,0,68.77
臺北縣,三重市,博愛里,626,2,788,12,800,1166,3,1,3,0,1,0,68.61
臺北縣,三重市,中興里,627,2,920,21,941,1325,3,1,3,0,1,0,71.02
臺北縣,三重市,博愛里,628,2,572,8,580,919,3,1,3,0,1,0,63.11
臺北縣,三重市,二重里,629,2,503,15,518,804,3,1,3,0,1,0,64.43
臺北縣,三重市,二重里,630,2,523,11,534,825,3,1,3,0,1,0,64.73
臺北縣,三重市,頂崁里,631,2,562,13,575,862,3,1,3,0,1,0,66.71
臺北縣,三重市,頂崁里,632,2,781,9,790,1127,3,1,3,0,1,0,70.10
臺北縣,三重市,谷王里,633,2,685,10,695,959,3,1,3,0,1,0,72.47
臺北縣,三重市,五谷里,634,2,584,5,589,881,3,1,3,0,1,0,66.86
臺北縣,三重市,五谷里,635,2,1056,31,1087,1576,3,1,3,0,1,0,68.97
臺北縣,三重市,中興里,636,2,947,13,960,1370,3,1,3,0,1,0,70.07
臺北縣,三重市,德厚里,638,2,270,2,272,374,3,1,3,0,1,0,72.73
臺北縣,三重市,成功里,639,2,1256,21,1277,1903,3,1,3,0,1,0,67.10
臺北縣,三重市,成功里,640,2,1094,13,1107,1652,3,1,3,0,1,0,67.01
臺北縣,三重市,福祉里,641,2,952,10,962,1357,3,1,3,0,1,0,70.89
臺北縣,三重市,福祉里,642,2,967,18,985,1446,3,1,3,0,1,0,68.12
臺北縣,三重市,福德里,643,2,920,14,934,1404,3,1,3,0,1,0,66.52
臺北縣,三重市,福德里,644,2,1078,16,1094,1639,3,1,3,0,1,0,66.75
臺北縣,三重市,福民里,645,2,853,11,864,1269,3,1,3,0,1,0,68.09
臺北縣,三重市,福民里,646,2,881,16,897,1317,3,1,3,0,1,0,68.11
臺北縣,三重市,過田里,647,2,924,10,934,1541,3,1,3,0,1,0,60.61
臺北縣,三重市,過田里,648,2,817,10,827,1209,3,1,3,0,1,0,68.40
臺北縣,三重市,過田里,649,2,1055,22,1077,1567,3,1,3,0,1,0,68.73
臺北縣,三重市,錦田里,650,2,505,7,512,769,3,1,3,0,1,0,66.58
臺北縣,三重市,錦田里,651,2,641,7,648,943,3,1,3,0,1,0,68.72
臺北縣,三重市,重明里,652,2,891,11,902,1295,3,1,3,0,1,0,69.65
臺北縣,三重市,重明里,653,2,658,6,664,926,3,1,3,0,1,0,71.71
臺北縣,三重市,光田里,654,2,676,13,689,1047,3,1,3,0,1,0,65.81
臺北縣,三重市,光田里,655,2,881,18,899,1244,3,1,3,0,1,0,72.27
臺北縣,三重市,光田里,656,2,788,11,799,1164,3,1,3,0,1,0,68.64
臺北縣,三重市,光陽里,657,2,1131,23,1154,1724,3,1,3,0,1,0,66.94
臺北縣,三重市,光陽里,658,2,1123,18,1141,1627,3,1,3,0,1,0,70.13
臺北縣,三重市,光陽里,659,2,917,13,930,1332,3,1,3,0,1,0,69.82
臺北縣,三重市,田心里,660,2,738,20,758,1122,3,1,3,0,1,0,67.56
臺北縣,三重市,田心里,661,2,891,20,911,1317,3,1,3,0,1,0,69.17
臺北縣,三重市,田心里,662,2,587,10,597,934,3,1,3,0,1,0,63.92
臺北縣,三重市,福田里,663,2,890,12,902,1281,3,1,3,0,1,0,70.41
臺北縣,三重市,福田里,664,2,914,15,929,1327,3,1,3,0,1,0,70.01
臺北縣,三重市,田中里,665,2,832,14,846,1236,3,1,3,0,1,0,68.45
臺北縣,三重市,田中里,666,2,1065,19,1084,1579,3,1,3,0,1,0,68.65
臺北縣,三重市,田中里,667,2,1049,15,1064,1629,3,1,3,0,1,0,65.32
臺北縣,三重市,田安里,668,2,1085,12,1097,1571,3,1,3,0,1,0,69.83
臺北縣,三重市,田安里,669,2,1049,20,1069,1587,3,1,3,0,1,0,67.36
臺北縣,三重市,田安里,670,2,1108,21,1129,1582,3,1,3,0,1,0,71.37
臺北縣,三重市,三民里,671,2,982,12,994,1426,3,1,3,0,1,0,69.71
臺北縣,三重市,三民里,672,2,707,7,714,989,3,1,3,0,1,0,72.19
臺北縣,三重市,光明里,673,2,885,17,902,1366,3,1,3,0,1,0,66.03
臺北縣,三重市,光明里,674,2,1091,11,1102,1679,3,1,3,0,1,0,65.63
臺北縣,三重市,光明里,675,2,1108,11,1119,1718,3,1,3,0,1,0,65.13
臺北縣,三重市,光正里,676,2,864,17,881,1374,3,1,3,0,1,0,64.12
臺北縣,三重市,同安里,677,2,888,18,906,1466,3,1,3,0,1,0,61.80
臺北縣,三重市,同慶里,678,2,940,16,956,1424,3,1,3,0,1,0,67.13
臺北縣,三重市,菜寮里,679,2,577,8,585,828,3,1,3,0,1,0,70.65
臺北縣,三重市,菜寮里,680,2,557,9,566,814,3,1,3,0,1,0,69.53
臺北縣,三重市,永春里,681,2,920,18,938,1339,3,1,3,0,1,0,70.05
臺北縣,三重市,中正里,682,2,818,17,835,1174,3,1,3,0,1,0,71.12
臺北縣,三重市,吉利里,683,2,814,17,831,1221,3,1,3,0,1,0,68.06
臺北縣,三重市,大同里,684,2,984,9,993,1507,3,1,3,0,1,0,65.89
臺北縣,三重市,中民里,685,2,774,25,799,1164,3,1,3,0,1,0,68.64
臺北縣,三重市,平和里,686,2,448,11,459,680,3,1,3,0,1,0,67.50
臺北縣,三重市,平和里,687,2,482,10,492,750,3,1,3,0,1,0,65.60
臺北縣,三重市,大安里,688,2,904,20,924,1393,3,1,3,0,1,0,66.33
臺北縣,三重市,仁德里,689,2,574,16,590,858,3,1,3,0,1,0,68.76
臺北縣,三重市,仁德里,690,2,682,9,691,1018,3,1,3,0,1,0,67.88
臺北縣,三重市,忠孝里,691,2,999,12,1011,1581,3,1,3,0,1,0,63.95
臺北縣,三重市,仁義里,692,2,758,17,775,1132,3,1,3,0,1,0,68.46
臺北縣,三重市,光榮里,693,2,714,6,720,1081,3,1,3,0,1,0,66.60
臺北縣,三重市,光輝里,694,2,605,9,614,881,3,1,3,0,1,0,69.69
臺北縣,三重市,光輝里,695,2,457,8,465,667,3,1,3,0,1,0,69.72
臺北縣,三重市,福星里,696,2,580,8,588,833,3,1,3,0,1,0,70.59
臺北縣,三重市,福利里,697,2,957,13,970,1496,3,1,3,0,1,0,64.84
臺北縣,三重市,清和里,698,2,852,6,858,1320,3,1,3,0,1,0,65.00
臺北縣,三重市,清和里,699,2,706,9,715,1034,3,1,3,0,1,0,69.15
臺北縣,三重市,永興里,700,2,700,9,709,1121,3,1,3,0,1,0,63.25
臺北縣,三重市,中山里,701,2,678,5,683,988,3,1,3,0,1,0,69.13
臺北縣,三重市,中山里,702,2,702,8,710,1079,3,1,3,0,1,0,65.80
臺北縣,三重市,大園里,703,2,657,10,667,1021,3,1,3,0,1,0,65.33
臺北縣,三重市,大園里,704,2,716,9,725,1150,3,1,3,0,1,0,63.04
臺北縣,三重市,國隆里,705,2,571,14,585,773,3,1,3,0,1,0,75.68
臺北縣,三重市,國隆里,706,2,907,20,927,1314,3,1,3,0,1,0,70.55
臺北縣,三重市,重陽里,707,2,903,19,922,1427,3,1,3,0,1,0,64.61
臺北縣,三重市,重陽里,708,2,930,11,941,1387,3,1,3,0,1,0,67.84
臺北縣,三重市,民生里,709,2,994,12,1006,1444,3,1,3,0,1,0,69.67
臺北縣,三重市,民生里,710,2,650,9,659,979,3,1,3,0,1,0,67.31
臺北縣,三重市,民生里,711,2,777,10,787,1155,3,1,3,0,1,0,68.14
臺北縣,三重市,重新里,712,2,944,20,964,1344,3,1,3,0,1,0,71.73
臺北縣,三重市,正德里,713,2,713,15,728,1025,3,1,3,0,1,0,71.02
臺北縣,三重市,正義里,714,2,1022,15,1037,1524,3,1,3,0,1,0,68.04
臺北縣,三重市,正安里,715,2,1065,27,1092,1544,3,1,3,0,1,0,70.73
臺北縣,三重市,自強里,716,2,1117,12,1129,1567,3,1,3,0,1,0,72.05
臺北縣,三重市,文化里,717,2,731,16,747,1091,3,1,3,0,1,0,68.47
臺北縣,三重市,文化里,718,2,686,7,693,1009,3,1,3,0,1,0,68.68
臺北縣,三重市,中央里,719,2,1019,20,1039,1495,3,1,3,0,1,0,69.50
臺北縣,三重市,雙園里,720,2,580,7,587,882,3,1,3,0,1,0,66.55
臺北縣,三重市,錦通里,721,2,964,16,980,1459,3,1,3,0,1,0,67.17
臺北縣,三重市,錦安里,722,2,607,18,625,902,3,1,3,0,1,0,69.29
臺北縣,三重市,錦安里,723,2,550,18,568,794,3,1,3,0,1,0,71.54
臺北縣,三重市,長安里,724,2,626,11,637,1007,3,1,3,0,1,0,63.26
臺北縣,三重市,長安里,725,2,642,10,652,975,3,1,3,0,1,0,66.87
臺北縣,三重市,光華里,726,2,1026,22,1048,1596,3,1,3,0,1,0,65.66
臺北縣,三重市,長生里,727,2,499,5,504,742,3,1,3,0,1,0,67.92
臺北縣,三重市,開元里,728,2,900,10,910,1309,3,1,3,0,1,0,69.52
臺北縣,三重市,大德里,729,2,406,5,411,579,3,1,3,0,1,0,70.98
臺北縣,三重市,長元里,730,2,637,23,660,997,3,1,3,0,1,0,66.20
臺北縣,三重市,長元里,731,2,769,20,789,1153,3,1,3,0,1,0,68.43
臺北縣,三重市,長江里,732,2,1143,26,1169,1668,3,1,3,0,1,0,70.08
臺北縣,三重市,長泰里,733,2,756,17,773,1130,3,1,3,0,1,0,68.41
臺北縣,三重市,長泰里,734,2,605,13,618,918,3,1,3,0,1,0,67.32
臺北縣,三重市,長福里,735,2,898,12,910,1408,3,1,3,0,1,0,64.63
臺北縣,三重市,介壽里,736,2,732,9,741,1060,3,1,3,0,1,0,69.91
臺北縣,三重市,萬壽里,737,2,1140,20,1160,1663,3,1,3,0,1,0,69.75
臺北縣,三重市,錦江里,738,2,687,20,707,1073,3,1,3,0,1,0,65.89
臺北縣,三重市,錦江里,739,2,639,17,656,942,3,1,3,0,1,0,69.64
臺北縣,三重市,龍濱里,740,2,913,23,936,1329,3,1,3,0,1,0,70.43
臺北縣,三重市,龍濱里,741,2,788,19,807,1198,3,1,3,0,1,0,67.36
臺北縣,三重市,龍門里,742,2,1070,14,1084,1610,3,1,3,0,1,0,67.33
臺北縣,三重市,秀江里,743,2,804,8,812,1166,3,1,3,0,1,0,69.64
臺北縣,三重市,奕壽里,744,2,904,13,917,1315,3,1,3,0,1,0,69.73
臺北縣,三重市,三安里,745,2,756,13,769,1144,3,1,3,0,1,0,67.22
臺北縣,三重市,三安里,746,2,729,12,741,1092,3,1,3,0,1,0,67.86
臺北縣,三重市,福安里,747,2,750,18,768,1181,3,1,3,0,1,0,65.03
臺北縣,三重市,福安里,748,2,798,14,812,1236,3,1,3,0,1,0,65.70
臺北縣,三重市,信安里,749,2,998,19,1017,1461,3,1,3,0,1,0,69.61
臺北縣,三重市,安慶里,750,2,581,15,596,871,3,1,3,0,1,0,68.43
臺北縣,三重市,安慶里,751,2,661,13,674,979,3,1,3,0,1,0,68.85
臺北縣,三重市,幸福里,752,2,781,11,792,1179,3,1,3,0,1,0,67.18
臺北縣,三重市,幸福里,753,2,888,15,903,1365,3,1,3,0,1,0,66.15
臺北縣,三重市,幸福里,754,2,785,21,806,1225,3,1,3,0,1,0,65.80
臺北縣,三重市,六合里,755,2,1136,18,1154,1674,3,1,3,0,1,0,68.94
臺北縣,三重市,六合里,756,2,995,18,1013,1468,3,1,3,0,1,0,69.01
臺北縣,三重市,六福里,757,2,621,8,629,992,3,1,3,0,1,0,63.41
臺北縣,三重市,六福里,758,2,988,16,1004,1478,3,1,3,0,1,0,67.93
臺北縣,三重市,六福里,759,2,1044,16,1060,1518,3,1,3,0,1,0,69.83
臺北縣,三重市,順德里,760,2,673,12,685,1001,3,1,3,0,1,0,68.43
臺北縣,三重市,順德里,761,2,587,8,595,877,3,1,3,0,1,0,67.84
臺北縣,三重市,承德里,762,2,559,13,572,813,3,1,3,0,1,0,70.36
臺北縣,三重市,承德里,763,2,579,6,585,818,3,1,3,0,1,0,71.52
臺北縣,三重市,瑞德里,764,2,666,9,675,961,3,1,3,0,1,0,70.24
臺北縣,三重市,瑞德里,765,2,787,16,803,1118,3,1,3,0,1,0,71.82
臺北縣,三重市,崇德里,766,2,698,4,702,1107,3,1,3,0,1,0,63.41
臺北縣,三重市,崇德里,767,2,780,18,798,1166,3,1,3,0,1,0,68.44
臺北縣,三重市,崇德里,768,2,776,14,790,1122,3,1,3,0,1,0,70.41
臺北縣,三重市,厚德里,769,2,813,10,823,1131,3,1,3,0,1,0,72.77
臺北縣,三重市,厚德里,770,2,990,10,1000,1360,3,1,3,0,1,0,73.53
臺北縣,三重市,維德里,771,2,804,15,819,1198,3,1,3,0,1,0,68.36
臺北縣,三重市,維德里,772,2,761,15,776,1120,3,1,3,0,1,0,69.29
臺北縣,三重市,尚德里,773,2,962,23,985,1476,3,1,3,0,1,0,66.73
臺北縣,三重市,尚德里,774,2,788,8,796,1172,3,1,3,0,1,0,67.92
臺北縣,三重市,培德里,775,2,892,6,898,1371,3,1,3,0,1,0,65.50
臺北縣,三重市,培德里,776,2,922,9,931,1330,3,1,3,0,1,0,70.00
臺北縣,三重市,立德里,777,2,899,15,914,1346,3,1,3,0,1,0,67.90
臺北縣,三重市,立德里,778,2,837,17,854,1269,3,1,3,0,1,0,67.30
臺北縣,三重市,永德里,779,2,1053,19,1072,1528,3,1,3,0,1,0,70.16
臺北縣,三重市,永德里,780,2,731,12,743,1141,3,1,3,0,1,0,65.12
臺北縣,三重市,永德里,781,2,884,18,902,1345,3,1,3,0,1,0,67.06
臺北縣,三重市,永煇里,782,2,796,10,806,1117,3,1,3,0,1,0,72.16
臺北縣,三重市,永煇里,783,2,623,10,633,949,3,1,3,0,1,0,66.70
臺北縣,三重市,永發里,784,2,641,8,649,916,3,1,3,0,1,0,70.85
臺北縣,三重市,永發里,785,2,841,13,854,1226,3,1,3,0,1,0,69.66
臺北縣,三重市,永發里,786,2,861,8,869,1247,3,1,3,0,1,0,69.69
臺北縣,三重市,永盛里,787,2,915,12,927,1368,3,1,3,0,1,0,67.76
臺北縣,三重市,永盛里,788,2,927,19,946,1420,3,1,3,0,1,0,66.62
臺北縣,三重市,永吉里,789,2,757,17,774,1177,3,1,3,0,1,0,65.76
臺北縣,三重市,永吉里,790,2,744,9,753,1162,3,1,3,0,1,0,64.80
臺北縣,三重市,永安里,791,2,931,13,944,1419,3,1,3,0,1,0,66.53
臺北縣,三重市,永安里,792,2,768,12,780,1174,3,1,3,0,1,0,66.44
臺北縣,三重市,永豐里,793,2,851,11,862,1238,3,1,3,0,1,0,69.63
臺北縣,三重市,永豐里,794,2,647,11,658,983,3,1,3,0,1,0,66.94
臺北縣,三重市,永豐里,795,2,902,14,916,1360,3,1,3,0,1,0,67.35
臺北縣,三重市,永福里,796,2,815,13,828,1223,3,1,3,0,1,0,67.70
臺北縣,三重市,永福里,797,2,733,12,745,1146,3,1,3,0,1,0,65.01
臺北縣,三重市,永福里,798,2,976,23,999,1566,3,1,3,0,1,0,63.79
臺北縣,三重市,永清里,799,2,995,21,1016,1585,3,1,3,0,1,0,64.10
臺北縣,三重市,永清里,800,2,921,11,932,1439,3,1,3,0,1,0,64.77
臺北縣,三重市,永清里,801,2,752,11,763,1132,3,1,3,0,1,0,67.40
臺北縣,三重市,永順里,802,2,1013,12,1025,1570,3,1,3,0,1,0,65.29
臺北縣,三重市,永順里,803,2,647,2,649,1020,3,1,3,0,1,0,63.63
臺北縣,三重市,永順里,804,2,602,11,613,956,3,1,3,0,1,0,64.12
臺北縣,三重市,溪美里,805,2,1059,20,1079,1520,3,1,3,0,1,0,70.99
臺北縣,三重市,溪美里,806,2,1054,13,1067,1600,3,1,3,0,1,0,66.69
臺北縣,三重市,溪美里,807,2,1259,20,1279,1936,3,1,3,0,1,0,66.06
臺北縣,三重市,福隆里,808,2,714,14,728,1109,3,1,3,0,1,0,65.64
臺北縣,三重市,福隆里,809,2,1123,23,1146,1728,3,1,3,0,1,0,66.32
臺北縣,三重市,五常里,810,2,976,19,995,1435,3,1,3,0,1,0,69.34
臺北縣,三重市,五常里,811,2,1155,23,1178,1730,3,1,3,0,1,0,68.09
臺北縣,三重市,五福里,812,2,714,16,730,1062,3,1,3,0,1,0,68.74
臺北縣,三重市,五福里,813,2,712,7,719,1140,3,1,3,0,1,0,63.07
臺北縣,三重市,仁忠里,814,2,866,16,882,1454,3,1,3,0,1,0,60.66
臺北縣,三重市,仁忠里,815,2,782,12,794,1190,3,1,3,0,1,0,66.72
臺北縣,三重市,慈福里,816,2,430,13,443,695,3,1,3,0,1,0,63.74
臺北縣,三重市,慈福里,817,2,836,15,851,1274,3,1,3,0,1,0,66.80
臺北縣,三重市,慈生里,818,2,595,11,606,897,3,1,3,0,1,0,67.56
臺北縣,三重市,慈生里,819,2,721,13,734,1103,3,1,3,0,1,0,66.55
臺北縣,三重市,慈惠里,820,2,733,12,745,1058,3,1,3,0,1,0,70.42
臺北縣,三重市,慈惠里,821,2,584,6,590,898,3,1,3,0,1,0,65.70
臺北縣,三重市,慈愛里,822,2,1133,13,1146,1598,3,1,3,0,1,0,71.71
臺北縣,三重市,慈愛里,823,2,985,12,997,1515,3,1,3,0,1,0,65.81
臺北縣,三重市,慈化里,824,2,611,11,622,872,3,1,3,0,1,0,71.33
臺北縣,三重市,慈化里,825,2,742,22,764,1122,3,1,3,0,1,0,68.09
臺北縣,三重市,慈祐里,826,2,777,15,792,1165,3,1,3,0,1,0,67.98
臺北縣,三重市,慈祐里,827,2,742,12,754,1163,3,1,3,0,1,0,64.83
臺北縣,三重市,慈祐里,828,2,775,13,788,1146,3,1,3,0,1,0,68.76
臺北縣,三重市,富華里,829,2,660,11,671,1037,3,1,3,0,1,0,64.71
臺北縣,三重市,富華里,830,2,722,7,729,1118,3,1,3,0,1,0,65.21
臺北縣,三重市,富貴里,831,2,863,23,886,1383,3,1,3,0,1,0,64.06
臺北縣,三重市,富貴里,832,2,769,7,776,1164,3,1,3,0,1,0,66.67
臺北縣,三重市,富福里,833,2,492,6,498,728,3,1,3,0,1,0,68.41
臺北縣,三重市,富福里,834,2,652,11,663,982,3,1,3,0,1,0,67.52
臺北縣,三重市,五華里,835,2,1007,22,1029,1530,3,1,3,0,1,0,67.25
臺北縣,三重市,五華里,836,2,827,16,843,1193,3,1,3,0,1,0,70.66
臺北縣,三重市,碧華里,837,2,584,14,598,881,3,1,3,0,1,0,67.88
臺北縣,三重市,碧華里,838,2,718,6,724,1136,3,1,3,0,1,0,63.73
臺北縣,三重市,福樂里,839,2,979,20,999,1481,3,1,3,0,1,0,67.45
臺北縣,三重市,福樂里,840,2,946,12,958,1393,3,1,3,0,1,0,68.77
臺北縣,三重市,仁華里,841,2,1083,20,1103,1663,3,1,3,0,1,0,66.33
臺北縣,三重市,仁華里,842,2,858,12,870,1305,3,1,3,0,1,0,66.67
臺北縣,三重市,五順里,843,2,992,18,1010,1584,3,1,3,0,1,0,63.76
臺北縣,三重市,五順里,844,2,949,10,959,1423,3,1,3,0,1,0,67.39
臺北縣,蘆洲市,光華里,845,2,954,14,968,1376,3,1,3,0,1,0,70.35
臺北縣,蘆洲市,光華里,846,2,832,12,844,1290,3,1,3,0,1,0,65.43
臺北縣,蘆洲市,光華里,847,2,733,8,741,1111,3,1,3,0,1,0,66.70
臺北縣,蘆洲市,光明里,848,2,882,7,889,1412,3,1,3,0,1,0,62.96
臺北縣,蘆洲市,光明里,849,2,1023,19,1042,1624,3,1,3,0,1,0,64.16
臺北縣,蘆洲市,中路里,850,2,893,19,912,1288,3,1,3,0,1,0,70.81
臺北縣,蘆洲市,中路里,851,2,892,17,909,1363,3,1,3,0,1,0,66.69
臺北縣,蘆洲市,中華里,852,2,892,8,900,1277,3,1,3,0,1,0,70.48
臺北縣,蘆洲市,中華里,853,2,671,12,683,1000,3,1,3,0,1,0,68.30
臺北縣,蘆洲市,九芎里,854,2,693,12,705,1194,3,1,3,0,1,0,59.05
臺北縣,蘆洲市,九芎里,855,2,640,10,650,1072,3,1,3,0,1,0,60.63
臺北縣,蘆洲市,九芎里,856,2,672,10,682,1110,3,1,3,0,1,0,61.44
臺北縣,蘆洲市,永安里,857,2,799,18,817,1243,3,1,3,0,1,0,65.73
臺北縣,蘆洲市,永安里,858,2,984,17,1001,1444,3,1,3,0,1,0,69.32
臺北縣,蘆洲市,延平里,859,2,813,16,829,1233,3,1,3,0,1,0,67.23
臺北縣,蘆洲市,延平里,860,2,743,10,753,1117,3,1,3,0,1,0,67.41
臺北縣,蘆洲市,長安里,861,2,954,25,979,1578,3,1,3,0,1,0,62.04
臺北縣,蘆洲市,長安里,862,2,1050,16,1066,1695,3,1,3,0,1,0,62.89
臺北縣,蘆洲市,忠義里,863,2,1040,22,1062,1632,3,1,3,0,1,0,65.07
臺北縣,蘆洲市,中原里,864,2,886,14,900,1337,3,1,3,0,1,0,67.31
臺北縣,蘆洲市,中原里,865,2,867,16,883,1371,3,1,3,0,1,0,64.41
臺北縣,蘆洲市,永康里,866,2,734,9,743,1155,3,1,3,0,1,0,64.33
臺北縣,蘆洲市,永康里,867,2,732,6,738,1114,3,1,3,0,1,0,66.25
臺北縣,蘆洲市,永康里,868,2,767,12,779,1248,3,1,3,0,1,0,62.42
臺北縣,蘆洲市,永德里,869,2,796,16,812,1349,3,1,3,0,1,0,60.19
臺北縣,蘆洲市,永德里,870,2,875,17,892,1389,3,1,3,0,1,0,64.22
臺北縣,蘆洲市,成功里,871,2,768,12,780,1272,3,1,3,0,1,0,61.32
臺北縣,蘆洲市,成功里,872,2,886,7,893,1415,3,1,3,0,1,0,63.11
臺北縣,蘆洲市,成功里,873,2,973,17,990,1538,3,1,3,0,1,0,64.37
臺北縣,蘆洲市,永樂里,874,2,803,9,812,1226,3,1,3,0,1,0,66.23
臺北縣,蘆洲市,永樂里,875,2,711,8,719,1155,3,1,3,0,1,0,62.25
臺北縣,蘆洲市,永樂里,876,2,836,14,850,1284,3,1,3,0,1,0,66.20
臺北縣,蘆洲市,南港里,877,2,793,6,799,1266,3,1,3,0,1,0,63.11
臺北縣,蘆洲市,南港里,878,2,709,9,718,1067,3,1,3,0,1,0,67.29
臺北縣,蘆洲市,南港里,879,2,738,14,752,1121,3,1,3,0,1,0,67.08
臺北縣,蘆洲市,正義里,880,2,108,4,112,207,3,1,3,0,1,0,54.11
臺北縣,蘆洲市,樓厝里,881,2,1108,13,1121,1656,3,1,3,0,1,0,67.69
臺北縣,蘆洲市,樓厝里,882,2,731,9,740,1092,3,1,3,0,1,0,67.77
臺北縣,蘆洲市,樓厝里,883,2,715,15,730,1079,3,1,3,0,1,0,67.66
臺北縣,蘆洲市,信義里,884,2,1019,29,1048,1487,3,1,3,0,1,0,70.48
臺北縣,蘆洲市,信義里,885,2,967,24,991,1459,3,1,3,0,1,0,67.92
臺北縣,蘆洲市,玉清里,886,2,1018,20,1038,1578,3,1,3,0,1,0,65.78
臺北縣,蘆洲市,玉清里,887,2,956,10,966,1473,3,1,3,0,1,0,65.58
臺北縣,蘆洲市,復興里,888,2,757,10,767,1199,3,1,3,0,1,0,63.97
臺北縣,蘆洲市,復興里,889,2,811,11,822,1283,3,1,3,0,1,0,64.07
臺北縣,蘆洲市,福安里,890,2,770,12,782,1137,3,1,3,0,1,0,68.78
臺北縣,蘆洲市,福安里,891,2,722,8,730,1065,3,1,3,0,1,0,68.54
臺北縣,蘆洲市,鷺江里,892,2,986,10,996,1517,3,1,3,0,1,0,65.66
臺北縣,蘆洲市,鷺江里,893,2,610,15,625,984,3,1,3,0,1,0,63.52
臺北縣,蘆洲市,鷺江里,894,2,736,7,743,1112,3,1,3,0,1,0,66.82
臺北縣,蘆洲市,恆德里,895,2,1201,18,1219,1895,3,1,3,0,1,0,64.33
臺北縣,蘆洲市,恆德里,896,2,811,11,822,1246,3,1,3,0,1,0,65.97
臺北縣,蘆洲市,恆德里,897,2,779,11,790,1236,3,1,3,0,1,0,63.92
臺北縣,蘆洲市,溪墘里,898,2,762,8,770,1181,3,1,3,0,1,0,65.20
臺北縣,蘆洲市,溪墘里,899,2,890,10,900,1368,3,1,3,0,1,0,65.79
臺北縣,蘆洲市,樹德里,900,2,919,14,933,1318,3,1,3,0,1,0,70.79
臺北縣,蘆洲市,樹德里,901,2,736,7,743,1149,3,1,3,0,1,0,64.66
臺北縣,蘆洲市,民和里,902,2,881,8,889,1270,3,1,3,0,1,0,70.00
臺北縣,蘆洲市,民和里,903,2,750,13,763,1079,3,1,3,0,1,0,70.71
臺北縣,蘆洲市,得仁里,904,2,687,21,708,1046,3,1,3,0,1,0,67.69
臺北縣,蘆洲市,得仁里,905,2,666,11,677,1011,3,1,3,0,1,0,66.96
臺北縣,蘆洲市,得勝里,906,2,865,11,876,1264,3,1,3,0,1,0,69.30
臺北縣,蘆洲市,得勝里,907,2,982,17,999,1449,3,1,3,0,1,0,68.94
臺北縣,蘆洲市,仁復里,908,2,1015,17,1032,1551,3,1,3,0,1,0,66.54
臺北縣,蘆洲市,仁德里,909,2,772,15,787,1264,3,1,3,0,1,0,62.26
臺北縣,蘆洲市,仁德里,910,2,805,10,815,1209,3,1,3,0,1,0,67.41
臺北縣,蘆洲市,仁德里,911,2,759,8,767,1211,3,1,3,0,1,0,63.34
臺北縣,蘆洲市,仁義里,912,2,615,6,621,987,3,1,3,0,1,0,62.92
臺北縣,蘆洲市,仁義里,913,2,700,16,716,1071,3,1,3,0,1,0,66.85
臺北縣,蘆洲市,保和里,914,2,683,7,690,1068,3,1,3,0,1,0,64.61
臺北縣,蘆洲市,保和里,915,2,701,11,712,1020,3,1,3,0,1,0,69.80
臺北縣,蘆洲市,水湳里,916,2,821,8,829,1305,3,1,3,0,1,0,63.52
臺北縣,蘆洲市,水湳里,917,2,697,14,711,1155,3,1,3,0,1,0,61.56
臺北縣,蘆洲市,水湳里,918,2,964,15,979,1435,3,1,3,0,1,0,68.22
臺北縣,蘆洲市,水湳里,919,2,846,8,854,1375,3,1,3,0,1,0,62.11
臺北縣,蘆洲市,水河里,920,2,923,6,929,1435,3,1,3,0,1,0,64.74
臺北縣,蘆洲市,水河里,921,2,872,16,888,1416,3,1,3,0,1,0,62.71
臺北縣,蘆洲市,水河里,922,2,719,10,729,1220,3,1,3,0,1,0,59.75
臺北縣,蘆洲市,水河里,923,2,794,10,804,1217,3,1,3,0,1,0,66.06
臺北縣,蘆洲市,仁愛里,924,2,868,10,878,1306,3,1,3,0,1,0,67.23
臺北縣,蘆洲市,仁愛里,925,2,769,11,780,1198,3,1,3,0,1,0,65.11
臺北縣,蘆洲市,仁愛里,926,2,719,5,724,1152,3,1,3,0,1,0,62.85
臺北縣,蘆洲市,忠孝里,927,2,420,6,426,618,3,1,3,0,1,0,68.93
臺北縣,蘆洲市,忠孝里,928,2,605,11,616,1003,3,1,3,0,1,0,61.42
臺北縣,蘆洲市,保佑里,929,2,890,9,899,1384,3,1,3,0,1,0,64.96
臺北縣,蘆洲市,保佑里,930,2,819,10,829,1281,3,1,3,0,1,0,64.72
臺北縣,蘆洲市,保新里,931,2,611,3,614,975,3,1,3,0,1,0,62.97
臺北縣,蘆洲市,保新里,932,2,809,13,822,1227,3,1,3,0,1,0,66.99
臺北縣,新莊市,全安里,933,2,833,16,849,1175,3,1,3,0,1,0,72.26
臺北縣,新莊市,全安里,934,2,873,8,881,1273,3,1,3,0,1,0,69.21
臺北縣,新莊市,全安里,935,2,654,12,666,921,3,1,3,0,1,0,72.31
臺北縣,新莊市,海山里,936,2,787,15,802,1168,3,1,3,0,1,0,68.66
臺北縣,新莊市,海山里,937,2,961,9,970,1473,3,1,3,0,1,0,65.85
臺北縣,新莊市,海山里,938,2,1138,20,1158,1628,3,1,3,0,1,0,71.13
臺北縣,新莊市,豐年里,939,2,944,18,962,1474,3,1,3,0,1,0,65.26
臺北縣,新莊市,豐年里,940,2,932,20,952,1389,3,1,3,0,1,0,68.54
臺北縣,新莊市,國泰里,941,2,996,11,1007,1405,3,1,3,0,1,0,71.67
臺北縣,新莊市,文聖里,942,2,1141,16,1157,1632,3,1,3,0,1,0,70.89
臺北縣,新莊市,文聖里,943,2,957,13,970,1382,3,1,3,0,1,0,70.19
臺北縣,新莊市,文衡里,944,2,1185,9,1194,1627,3,1,3,0,1,0,73.39
臺北縣,新莊市,忠孝里,945,2,726,16,742,1144,3,1,3,0,1,0,64.86
臺北縣,新莊市,忠孝里,946,2,820,12,832,1192,3,1,3,0,1,0,69.80
臺北縣,新莊市,忠孝里,947,2,850,14,864,1280,3,1,3,0,1,0,67.50
臺北縣,新莊市,立言里,948,2,749,12,761,1113,3,1,3,0,1,0,68.37
臺北縣,新莊市,立言里,949,2,882,16,898,1296,3,1,3,0,1,0,69.29
臺北縣,新莊市,立言里,950,2,894,13,907,1366,3,1,3,0,1,0,66.40
臺北縣,新莊市,興漢里,951,2,718,9,727,1016,3,1,3,0,1,0,71.56
臺北縣,新莊市,興漢里,952,2,832,8,840,1141,3,1,3,0,1,0,73.62
臺北縣,新莊市,興漢里,953,2,605,11,616,864,3,1,3,0,1,0,71.30
臺北縣,新莊市,榮和里,954,2,762,11,773,1151,3,1,3,0,1,0,67.16
臺北縣,新莊市,榮和里,955,2,962,17,979,1689,3,1,3,0,1,0,57.96
臺北縣,新莊市,文德里,956,2,951,9,960,1344,3,1,3,0,1,0,71.43
臺北縣,新莊市,文明里,957,2,1101,15,1116,1558,3,1,3,0,1,0,71.63
臺北縣,新莊市,全泰里,958,2,1035,20,1055,1533,3,1,3,0,1,0,68.82
臺北縣,新莊市,全泰里,959,2,845,12,857,1228,3,1,3,0,1,0,69.79
臺北縣,新莊市,全泰里,960,2,871,10,881,1195,3,1,3,0,1,0,73.72
臺北縣,新莊市,頭前里,961,2,1112,21,1133,1656,3,1,3,0,1,0,68.42
臺北縣,新莊市,頭前里,962,2,977,21,998,1491,3,1,3,0,1,0,66.93
臺北縣,新莊市,福基里,963,2,771,10,781,1147,3,1,3,0,1,0,68.09
臺北縣,新莊市,福基里,964,2,596,13,609,876,3,1,3,0,1,0,69.52
臺北縣,新莊市,幸福里,965,2,688,11,699,1119,3,1,3,0,1,0,62.47
臺北縣,新莊市,幸福里,966,2,732,11,743,1180,3,1,3,0,1,0,62.97
臺北縣,新莊市,幸福里,967,2,794,12,806,1268,3,1,3,0,1,0,63.56
臺北縣,新莊市,昌平里,968,2,747,10,757,1217,3,1,3,0,1,0,62.20
臺北縣,新莊市,昌平里,969,2,914,13,927,1407,3,1,3,0,1,0,65.88
臺北縣,新莊市,和平里,970,2,645,13,658,1067,3,1,3,0,1,0,61.67
臺北縣,新莊市,和平里,971,2,719,8,727,1093,3,1,3,0,1,0,66.51
臺北縣,新莊市,和平里,972,2,967,14,981,1439,3,1,3,0,1,0,68.17
臺北縣,新莊市,昌明里,973,2,874,14,888,1261,3,1,3,0,1,0,70.42
臺北縣,新莊市,昌明里,974,2,867,12,879,1244,3,1,3,0,1,0,70.66
臺北縣,新莊市,昌信里,975,2,1136,14,1150,1735,3,1,3,0,1,0,66.28
臺北縣,新莊市,昌隆里,976,2,841,18,859,1278,3,1,3,0,1,0,67.21
臺北縣,新莊市,昌隆里,977,2,696,4,700,1098,3,1,3,0,1,0,63.75
臺北縣,新莊市,信義里,978,2,853,9,862,1334,3,1,3,0,1,0,64.62
臺北縣,新莊市,信義里,979,2,840,18,858,1282,3,1,3,0,1,0,66.93
臺北縣,新莊市,信義里,980,2,657,6,663,1104,3,1,3,0,1,0,60.05
臺北縣,新莊市,化成里,981,2,743,19,762,1099,3,1,3,0,1,0,69.34
臺北縣,新莊市,化成里,982,2,680,5,685,989,3,1,3,0,1,0,69.26
臺北縣,新莊市,思賢里,983,2,946,13,959,1354,3,1,3,0,1,0,70.83
臺北縣,新莊市,思賢里,984,2,953,9,962,1372,3,1,3,0,1,0,70.12
臺北縣,新莊市,自信里,985,2,651,12,663,1020,3,1,3,0,1,0,65.00
臺北縣,新莊市,自信里,986,2,588,10,598,910,3,1,3,0,1,0,65.71
臺北縣,新莊市,仁義里,987,2,1008,20,1028,1514,3,1,3,0,1,0,67.90
臺北縣,新莊市,仁義里,988,2,786,13,799,1240,3,1,3,0,1,0,64.44
臺北縣,新莊市,思源里,989,2,934,11,945,1370,3,1,3,0,1,0,68.98
臺北縣,新莊市,思源里,990,2,887,16,903,1400,3,1,3,0,1,0,64.50
臺北縣,新莊市,思源里,991,2,846,15,861,1299,3,1,3,0,1,0,66.28
臺北縣,新莊市,仁愛里,992,2,755,13,768,1186,3,1,3,0,1,0,64.76
臺北縣,新莊市,仁愛里,993,2,795,13,808,1190,3,1,3,0,1,0,67.90
臺北縣,新莊市,自強里,994,2,780,14,794,1242,3,1,3,0,1,0,63.93
臺北縣,新莊市,自強里,995,2,816,10,826,1187,3,1,3,0,1,0,69.59
臺北縣,新莊市,自立里,996,2,915,12,927,1334,3,1,3,0,1,0,69.49
臺北縣,新莊市,自立里,997,2,777,8,785,1222,3,1,3,0,1,0,64.24
臺北縣,新莊市,自立里,998,2,827,21,848,1279,3,1,3,0,1,0,66.30
臺北縣,新莊市,福興里,999,2,912,15,927,1449,3,1,3,0,1,0,63.98
臺北縣,新莊市,福興里,1000,2,835,8,843,1280,3,1,3,0,1,0,65.86
臺北縣,新莊市,中信里,1001,2,796,13,809,1181,3,1,3,0,1,0,68.50
臺北縣,新莊市,中信里,1002,2,766,19,785,1143,3,1,3,0,1,0,68.68
臺北縣,新莊市,中信里,1003,2,826,9,835,1263,3,1,3,0,1,0,66.11
臺北縣,新莊市,中信里,1004,2,779,8,787,1237,3,1,3,0,1,0,63.62
臺北縣,新莊市,中平里,1005,2,1070,25,1095,1612,3,1,3,0,1,0,67.93
臺北縣,新莊市,中平里,1006,2,1039,17,1056,1585,3,1,3,0,1,0,66.62
臺北縣,新莊市,中平里,1007,2,1028,15,1043,1585,3,1,3,0,1,0,65.80
臺北縣,新莊市,中港里,1008,2,949,11,960,1486,3,1,3,0,1,0,64.60
臺北縣,新莊市,中港里,1009,2,973,7,980,1486,3,1,3,0,1,0,65.95
臺北縣,新莊市,中港里,1010,2,908,11,919,1405,3,1,3,0,1,0,65.41
臺北縣,新莊市,立人里,1011,2,1179,19,1198,1662,3,1,3,0,1,0,72.08
臺北縣,新莊市,恆安里,1012,2,774,9,783,1138,3,1,3,0,1,0,68.80
臺北縣,新莊市,恆安里,1013,2,732,9,741,1124,3,1,3,0,1,0,65.93
臺北縣,新莊市,恆安里,1014,2,957,12,969,1394,3,1,3,0,1,0,69.51
臺北縣,新莊市,立泰里,1015,2,783,13,796,1212,3,1,3,0,1,0,65.68
臺北縣,新莊市,立泰里,1016,2,755,5,760,1127,3,1,3,0,1,0,67.44
臺北縣,新莊市,立泰里,1017,2,727,19,746,1131,3,1,3,0,1,0,65.96
臺北縣,新莊市,立功里,1018,2,989,12,1001,1569,3,1,3,0,1,0,63.80
臺北縣,新莊市,立功里,1019,2,971,15,986,1515,3,1,3,0,1,0,65.08
臺北縣,新莊市,立德里,1020,2,766,10,776,1075,3,1,3,0,1,0,72.19
臺北縣,新莊市,立德里,1021,2,705,8,713,1047,3,1,3,0,1,0,68.10
臺北縣,新莊市,中原里,1022,2,1079,12,1091,1663,3,1,3,0,1,0,65.60
臺北縣,新莊市,中原里,1023,2,1235,21,1256,1841,3,1,3,0,1,0,68.22
臺北縣,新莊市,中原里,1024,2,1016,15,1031,1485,3,1,3,0,1,0,69.43
臺北縣,新莊市,中隆里,1025,2,931,18,949,1352,3,1,3,0,1,0,70.19
臺北縣,新莊市,中隆里,1026,2,747,15,762,1157,3,1,3,0,1,0,65.86
臺北縣,新莊市,中華里,1027,2,924,12,936,1331,3,1,3,0,1,0,70.32
臺北縣,新莊市,中誠里,1028,2,1169,23,1192,1734,3,1,3,0,1,0,68.74
臺北縣,新莊市,中美里,1029,2,1014,17,1031,1491,3,1,3,0,1,0,69.15
臺北縣,新莊市,中美里,1030,2,1005,18,1023,1548,3,1,3,0,1,0,66.09
臺北縣,新莊市,中美里,1031,2,1000,13,1013,1510,3,1,3,0,1,0,67.09
臺北縣,新莊市,中和里,1032,2,848,10,858,1332,3,1,3,0,1,0,64.41
臺北縣,新莊市,中和里,1033,2,742,16,758,1106,3,1,3,0,1,0,68.54
臺北縣,新莊市,中和里,1034,2,828,15,843,1235,3,1,3,0,1,0,68.26
臺北縣,新莊市,立廷里,1035,2,655,11,666,996,3,1,3,0,1,0,66.87
臺北縣,新莊市,立廷里,1036,2,726,9,735,1152,3,1,3,0,1,0,63.80
臺北縣,新莊市,立志里,1037,2,908,11,919,1401,3,1,3,0,1,0,65.60
臺北縣,新莊市,立志里,1038,2,1073,14,1087,1614,3,1,3,0,1,0,67.35
臺北縣,新莊市,中泰里,1039,2,842,16,858,1281,3,1,3,0,1,0,66.98
臺北縣,新莊市,中泰里,1040,2,854,9,863,1266,3,1,3,0,1,0,68.17
臺北縣,新莊市,中泰里,1041,2,832,16,848,1290,3,1,3,0,1,0,65.74
臺北縣,新莊市,中宏里,1042,2,826,13,839,1269,3,1,3,0,1,0,66.12
臺北縣,新莊市,中宏里,1043,2,962,10,972,1424,3,1,3,0,1,0,68.26
臺北縣,新莊市,立基里,1044,2,1006,15,1021,1521,3,1,3,0,1,0,67.13
臺北縣,新莊市,立基里,1045,2,852,19,871,1308,3,1,3,0,1,0,66.59
臺北縣,新莊市,立基里,1046,2,877,11,888,1329,3,1,3,0,1,0,66.82
臺北縣,新莊市,中全里,1047,2,784,7,791,1234,3,1,3,0,1,0,64.10
臺北縣,新莊市,中全里,1048,2,925,15,940,1478,3,1,3,0,1,0,63.60
臺北縣,新莊市,營盤里,1049,2,658,9,667,957,3,1,3,0,1,0,69.70
臺北縣,新莊市,營盤里,1050,2,713,9,722,999,3,1,3,0,1,0,72.27
臺北縣,新莊市,瓊林里,1051,2,1143,18,1161,1676,3,1,3,0,1,0,69.27
臺北縣,新莊市,瓊林里,1052,2,856,15,871,1314,3,1,3,0,1,0,66.29
臺北縣,新莊市,瓊林里,1053,2,918,22,940,1421,3,1,3,0,1,0,66.15
臺北縣,新莊市,泰豐里,1054,2,720,15,735,1073,3,1,3,0,1,0,68.50
臺北縣,新莊市,泰豐里,1055,2,559,9,568,843,3,1,3,0,1,0,67.38
臺北縣,新莊市,丹鳳里,1056,2,1021,9,1030,1482,3,1,3,0,1,0,69.50
臺北縣,新莊市,丹鳳里,1057,2,1043,12,1055,1639,3,1,3,0,1,0,64.37
臺北縣,新莊市,丹鳳里,1058,2,1065,17,1082,1780,3,1,3,0,1,0,60.79
臺北縣,新莊市,合鳳里,1059,2,659,12,671,1039,3,1,3,0,1,0,64.58
臺北縣,新莊市,合鳳里,1060,2,726,16,742,1115,3,1,3,0,1,0,66.55
臺北縣,新莊市,合鳳里,1061,2,820,25,845,1224,3,1,3,0,1,0,69.04
臺北縣,新莊市,祥鳳里,1062,2,1084,11,1095,1641,3,1,3,0,1,0,66.73
臺北縣,新莊市,雙鳳里,1063,2,1006,14,1020,1532,3,1,3,0,1,0,66.58
臺北縣,新莊市,雙鳳里,1064,2,1074,15,1089,1695,3,1,3,0,1,0,64.25
臺北縣,新莊市,雙鳳里,1065,2,335,3,338,481,3,1,3,0,1,0,70.27
臺北縣,新莊市,龍鳳里,1066,2,883,9,892,1359,3,1,3,0,1,0,65.64
臺北縣,新莊市,龍鳳里,1067,2,757,11,768,1252,3,1,3,0,1,0,61.34
臺北縣,新莊市,龍鳳里,1068,2,902,9,911,1395,3,1,3,0,1,0,65.30
臺北縣,新莊市,富國里,1069,2,593,5,598,923,3,1,3,0,1,0,64.79
臺北縣,新莊市,富國里,1070,2,674,9,683,995,3,1,3,0,1,0,68.64
臺北縣,新莊市,後德里,1071,2,616,4,620,967,3,1,3,0,1,0,64.12
臺北縣,新莊市,後德里,1072,2,690,10,700,1074,3,1,3,0,1,0,65.18
臺北縣,新莊市,萬安里,1073,2,860,17,877,1292,3,1,3,0,1,0,67.88
臺北縣,新莊市,萬安里,1074,2,789,14,803,1233,3,1,3,0,1,0,65.13
臺北縣,新莊市,富民里,1075,2,730,14,744,1121,3,1,3,0,1,0,66.37
臺北縣,新莊市,富民里,1076,2,926,12,938,1440,3,1,3,0,1,0,65.14
臺北縣,新莊市,福營里,1077,2,726,12,738,1031,3,1,3,0,1,0,71.58
臺北縣,新莊市,福營里,1078,2,693,9,702,952,3,1,3,0,1,0,73.74
臺北縣,新莊市,龍福里,1079,2,905,17,922,1389,3,1,3,0,1,0,66.38
臺北縣,新莊市,民有里,1080,2,753,21,774,1178,3,1,3,0,1,0,65.70
臺北縣,新莊市,民有里,1081,2,860,11,871,1324,3,1,3,0,1,0,65.79
臺北縣,新莊市,民本里,1082,2,765,3,768,1181,3,1,3,0,1,0,65.03
臺北縣,新莊市,民本里,1083,2,743,12,755,1189,3,1,3,0,1,0,63.50
臺北縣,新莊市,八德里,1084,2,654,12,666,1007,3,1,3,0,1,0,66.14
臺北縣,新莊市,八德里,1085,2,832,11,843,1323,3,1,3,0,1,0,63.72
臺北縣,新莊市,民全里,1086,2,833,8,841,1225,3,1,3,0,1,0,68.65
臺北縣,新莊市,民全里,1087,2,666,17,683,1001,3,1,3,0,1,0,68.23
臺北縣,新莊市,建安里,1088,2,869,12,881,1375,3,1,3,0,1,0,64.07
臺北縣,新莊市,建安里,1089,2,884,10,894,1425,3,1,3,0,1,0,62.74
臺北縣,新莊市,建安里,1090,2,805,15,820,1301,3,1,3,0,1,0,63.03
臺北縣,新莊市,民安里,1091,2,791,9,800,1261,3,1,3,0,1,0,63.44
臺北縣,新莊市,民安里,1092,2,804,18,822,1218,3,1,3,0,1,0,67.49
臺北縣,新莊市,民安里,1093,2,662,18,680,1039,3,1,3,0,1,0,65.45
臺北縣,新莊市,成德里,1094,2,854,14,868,1458,3,1,3,0,1,0,59.53
臺北縣,新莊市,成德里,1095,2,1046,16,1062,1684,3,1,3,0,1,0,63.06
臺北縣,新莊市,光明里,1096,2,869,14,883,1397,3,1,3,0,1,0,63.21
臺北縣,新莊市,光明里,1097,2,802,20,822,1340,3,1,3,0,1,0,61.34
臺北縣,新莊市,光華里,1098,2,817,18,835,1397,3,1,3,0,1,0,59.77
臺北縣,新莊市,光華里,1099,2,799,18,817,1399,3,1,3,0,1,0,58.40
臺北縣,新莊市,光華里,1100,2,891,16,907,1461,3,1,3,0,1,0,62.08
臺北縣,新莊市,龍安里,1101,2,546,10,556,859,3,1,3,0,1,0,64.73
臺北縣,新莊市,龍安里,1102,2,575,9,584,925,3,1,3,0,1,0,63.14
臺北縣,新莊市,裕民里,1103,2,740,15,755,1165,3,1,3,0,1,0,64.81
臺北縣,新莊市,裕民里,1104,2,749,10,759,1204,3,1,3,0,1,0,63.04
臺北縣,新莊市,裕民里,1105,2,826,13,839,1287,3,1,3,0,1,0,65.19
臺北縣,新莊市,裕民里,1106,2,635,13,648,998,3,1,3,0,1,0,64.93
臺北縣,新莊市,四維里,1107,2,702,14,716,1175,3,1,3,0,1,0,60.94
臺北縣,新莊市,四維里,1108,2,806,11,817,1257,3,1,3,0,1,0,65.00
臺北縣,新莊市,四維里,1109,2,726,17,743,1128,3,1,3,0,1,0,65.87
臺北縣,新莊市,南港里,1110,2,783,10,793,1239,3,1,3,0,1,0,64.00
臺北縣,新莊市,南港里,1111,2,1024,15,1039,1638,3,1,3,0,1,0,63.43
臺北縣,新莊市,南港里,1112,2,475,7,482,732,3,1,3,0,1,0,65.85
臺北縣,新莊市,光榮里,1113,2,820,19,839,1264,3,1,3,0,1,0,66.38
臺北縣,新莊市,光榮里,1114,2,839,14,853,1341,3,1,3,0,1,0,63.61
臺北縣,新莊市,光正里,1115,2,756,6,762,1179,3,1,3,0,1,0,64.63
臺北縣,新莊市,光正里,1116,2,795,9,804,1180,3,1,3,0,1,0,68.14
臺北縣,新莊市,光和里,1117,2,596,5,601,918,3,1,3,0,1,0,65.47
臺北縣,新莊市,光和里,1118,2,524,10,534,866,3,1,3,0,1,0,61.66
臺北縣,新莊市,建福里,1119,2,605,5,610,868,3,1,3,0,1,0,70.28
臺北縣,新莊市,建福里,1120,2,652,10,662,1006,3,1,3,0,1,0,65.81
臺北縣,新莊市,後港里,1121,2,773,11,784,1198,3,1,3,0,1,0,65.44
臺北縣,新莊市,後港里,1122,2,802,16,818,1228,3,1,3,0,1,0,66.61
臺北縣,新莊市,後港里,1123,2,792,24,816,1230,3,1,3,0,1,0,66.34
臺北縣,新莊市,後港里,1124,2,737,8,745,1112,3,1,3,0,1,0,67.00
臺北縣,新莊市,西盛里,1125,2,787,4,791,1184,3,1,3,0,1,0,66.81
臺北縣,新莊市,西盛里,1126,2,980,19,999,1605,3,1,3,0,1,0,62.24
臺北縣,新莊市,西盛里,1127,2,816,21,837,1274,3,1,3,0,1,0,65.70
臺北縣,五股鄉,興珍村,1128,2,789,13,802,1212,3,1,3,0,1,0,66.17
臺北縣,五股鄉,興珍村,1129,2,837,11,848,1304,3,1,3,0,1,0,65.03
臺北縣,五股鄉,興珍村,1130,2,820,15,835,1149,3,1,3,0,1,0,72.67
臺北縣,五股鄉,更寮村,1131,2,759,14,773,1108,3,1,3,0,1,0,69.77
臺北縣,五股鄉,集福村,1132,2,981,18,999,1551,3,1,3,0,1,0,64.41
臺北縣,五股鄉,集福村,1133,2,465,5,470,695,3,1,3,0,1,0,67.63
臺北縣,五股鄉,集賢村,1134,2,841,21,862,1313,3,1,3,0,1,0,65.65
臺北縣,五股鄉,集賢村,1135,2,754,11,765,1178,3,1,3,0,1,0,64.94
臺北縣,五股鄉,觀音村,1136,2,844,9,853,1246,3,1,3,0,1,0,68.46
臺北縣,五股鄉,成德村,1137,2,685,22,707,1088,3,1,3,0,1,0,64.98
臺北縣,五股鄉,成德村,1138,2,701,13,714,1071,3,1,3,0,1,0,66.67
臺北縣,五股鄉,成州村,1139,2,868,12,880,1245,3,1,3,0,1,0,70.68
臺北縣,五股鄉,成州村,1140,2,742,12,754,1152,3,1,3,0,1,0,65.45
臺北縣,五股鄉,成州村,1141,2,850,7,857,1355,3,1,3,0,1,0,63.25
臺北縣,五股鄉,成功村,1142,2,895,23,918,1448,3,1,3,0,1,0,63.40
臺北縣,五股鄉,成功村,1143,2,901,13,914,1459,3,1,3,0,1,0,62.65
臺北縣,五股鄉,成泰村,1144,2,752,16,768,1130,3,1,3,0,1,0,67.96
臺北縣,五股鄉,成泰村,1145,2,737,12,749,1126,3,1,3,0,1,0,66.52
臺北縣,五股鄉,五福村,1146,2,801,13,814,1168,3,1,3,0,1,0,69.69
臺北縣,五股鄉,五福村,1147,2,884,10,894,1334,3,1,3,0,1,0,67.02
臺北縣,五股鄉,六福村,1148,2,710,10,720,1035,3,1,3,0,1,0,69.57
臺北縣,五股鄉,六福村,1149,2,788,18,806,1176,3,1,3,0,1,0,68.54
臺北縣,五股鄉,五龍村,1150,2,793,11,804,1158,3,1,3,0,1,0,69.43
臺北縣,五股鄉,五股村,1151,2,901,23,924,1368,3,1,3,0,1,0,67.54
臺北縣,五股鄉,五股村,1152,2,991,12,1003,1481,3,1,3,0,1,0,67.72
臺北縣,五股鄉,民義村,1153,2,757,7,764,1094,3,1,3,0,1,0,69.84
臺北縣,五股鄉,民義村,1154,2,719,8,727,1038,3,1,3,0,1,0,70.04
臺北縣,五股鄉,德音村,1155,2,832,12,844,1261,3,1,3,0,1,0,66.93
臺北縣,五股鄉,德音村,1156,2,739,6,745,1072,3,1,3,0,1,0,69.50
臺北縣,五股鄉,德音村,1157,2,654,7,661,945,3,1,3,0,1,0,69.95
臺北縣,五股鄉,水碓村,1158,2,669,6,675,992,3,1,3,0,1,0,68.04
臺北縣,五股鄉,水碓村,1159,2,702,11,713,1064,3,1,3,0,1,0,67.01
臺北縣,五股鄉,水碓村,1160,2,838,15,853,1266,3,1,3,0,1,0,67.38
臺北縣,五股鄉,水碓村,1161,2,1000,11,1011,1563,3,1,3,0,1,0,64.68
臺北縣,五股鄉,德泰村,1162,2,1002,15,1017,1507,3,1,3,0,1,0,67.49
臺北縣,五股鄉,德泰村,1163,2,774,11,785,1159,3,1,3,0,1,0,67.73
臺北縣,五股鄉,德泰村,1164,2,809,10,819,1221,3,1,3,0,1,0,67.08
臺北縣,五股鄉,陸一村,1165,2,719,6,725,976,3,1,3,0,1,0,74.28
臺北縣,五股鄉,陸一村,1166,2,650,9,659,888,3,1,3,0,1,0,74.21
臺北縣,五股鄉,貿商村,1167,2,389,7,396,545,3,1,3,0,1,0,72.66
臺北縣,泰山鄉,大科村,1168,2,454,3,457,603,3,1,3,0,1,0,75.79
臺北縣,泰山鄉,大科村,1169,2,178,4,182,250,3,1,3,0,1,0,72.80
臺北縣,泰山鄉,黎明村,1170,2,572,16,588,787,3,1,3,0,1,0,74.71
臺北縣,泰山鄉,黎明村,1171,2,616,12,628,898,3,1,3,0,1,0,69.93
臺北縣,泰山鄉,黎明村,1172,2,356,5,361,467,3,1,3,0,1,0,77.30
臺北縣,泰山鄉,山腳村,1173,2,928,11,939,1383,3,1,3,0,1,0,67.90
臺北縣,泰山鄉,山腳村,1174,2,794,12,806,1204,3,1,3,0,1,0,66.94
臺北縣,泰山鄉,山腳村,1175,2,619,4,623,927,3,1,3,0,1,0,67.21
臺北縣,泰山鄉,山腳村,1176,2,653,14,667,968,3,1,3,0,1,0,68.90
臺北縣,泰山鄉,福泰村,1177,2,666,10,676,1003,3,1,3,0,1,0,67.40
臺北縣,泰山鄉,福泰村,1178,2,640,10,650,952,3,1,3,0,1,0,68.28
臺北縣,泰山鄉,福泰村,1179,2,650,24,674,916,3,1,3,0,1,0,73.58
臺北縣,泰山鄉,福泰村,1180,2,704,15,719,1019,3,1,3,0,1,0,70.56
臺北縣,泰山鄉,楓樹村,1181,2,567,11,578,833,3,1,3,0,1,0,69.39
臺北縣,泰山鄉,楓樹村,1182,2,538,12,550,802,3,1,3,0,1,0,68.58
臺北縣,泰山鄉,楓樹村,1183,2,628,8,636,872,3,1,3,0,1,0,72.94
臺北縣,泰山鄉,同榮村,1184,2,657,7,664,939,3,1,3,0,1,0,70.71
臺北縣,泰山鄉,同榮村,1185,2,662,10,672,969,3,1,3,0,1,0,69.35
臺北縣,泰山鄉,同榮村,1186,2,556,8,564,801,3,1,3,0,1,0,70.41
臺北縣,泰山鄉,同興村,1187,2,768,7,775,992,3,1,3,0,1,0,78.13
臺北縣,泰山鄉,同興村,1188,2,649,7,656,895,3,1,3,0,1,0,73.30
臺北縣,泰山鄉,義學村,1189,2,675,10,685,1000,3,1,3,0,1,0,68.50
臺北縣,泰山鄉,義學村,1190,2,555,9,564,825,3,1,3,0,1,0,68.36
臺北縣,泰山鄉,義學村,1191,2,834,11,845,1184,3,1,3,0,1,0,71.37
臺北縣,泰山鄉,義仁村,1192,2,783,15,798,1190,3,1,3,0,1,0,67.06
臺北縣,泰山鄉,義仁村,1193,2,1080,23,1103,1620,3,1,3,0,1,0,68.09
臺北縣,泰山鄉,義仁村,1194,2,771,16,787,1135,3,1,3,0,1,0,69.34
臺北縣,泰山鄉,明志村,1195,2,656,12,668,1004,3,1,3,0,1,0,66.53
臺北縣,泰山鄉,明志村,1196,2,602,8,610,879,3,1,3,0,1,0,69.40
臺北縣,泰山鄉,明志村,1197,2,685,6,691,926,3,1,3,0,1,0,74.62
臺北縣,泰山鄉,泰友村,1198,2,638,9,647,933,3,1,3,0,1,0,69.35
臺北縣,泰山鄉,泰友村,1199,2,559,6,565,840,3,1,3,0,1,0,67.26
臺北縣,泰山鄉,新明村,1200,2,858,12,870,1212,3,1,3,0,1,0,71.78
臺北縣,泰山鄉,新明村,1201,2,957,24,981,1404,3,1,3,0,1,0,69.87
臺北縣,泰山鄉,貴子村,1202,2,860,14,874,1273,3,1,3,0,1,0,68.66
臺北縣,泰山鄉,貴子村,1203,2,587,5,592,878,3,1,3,0,1,0,67.43
臺北縣,泰山鄉,貴子村,1204,2,500,8,508,734,3,1,3,0,1,0,69.21
臺北縣,泰山鄉,貴賢村,1205,2,927,14,941,1264,3,1,3,0,1,0,74.45
臺北縣,泰山鄉,貴賢村,1206,2,1044,19,1063,1479,3,1,3,0,1,0,71.87
臺北縣,泰山鄉,貴和村,1207,2,847,14,861,1195,3,1,3,0,1,0,72.05
臺北縣,泰山鄉,貴和村,1208,2,935,9,944,1450,3,1,3,0,1,0,65.10
臺北縣,泰山鄉,貴和村,1209,2,735,8,743,1190,3,1,3,0,1,0,62.44
臺北縣,林口鄉,東林村,1210,2,750,9,759,1123,3,1,3,0,1,0,67.59
臺北縣,林口鄉,東林村,1211,2,703,9,712,1013,3,1,3,0,1,0,70.29
臺北縣,林口鄉,東林村,1212,2,825,10,835,1237,3,1,3,0,1,0,67.50
臺北縣,林口鄉,林口村,1213,2,631,7,638,1115,3,1,3,0,1,0,57.22
臺北縣,林口鄉,林口村,1214,2,841,19,860,1243,3,1,3,0,1,0,69.19
臺北縣,林口鄉,林口村,1215,2,769,12,781,1094,3,1,3,0,1,0,71.39
臺北縣,林口鄉,西林村,1216,2,792,12,804,1107,3,1,3,0,1,0,72.63
臺北縣,林口鄉,西林村,1217,2,853,12,865,1224,3,1,3,0,1,0,70.67
臺北縣,林口鄉,西林村,1218,2,526,10,536,813,3,1,3,0,1,0,65.93
臺北縣,林口鄉,菁湖村,1219,2,1103,18,1121,1586,3,1,3,0,1,0,70.68
臺北縣,林口鄉,菁湖村,1220,2,1045,13,1058,1520,3,1,3,0,1,0,69.61
臺北縣,林口鄉,中湖村,1221,2,914,17,931,1291,3,1,3,0,1,0,72.11
臺北縣,林口鄉,中湖村,1222,2,698,6,704,1000,3,1,3,0,1,0,70.40
臺北縣,林口鄉,湖北村,1223,2,806,17,823,1057,3,1,3,0,1,0,77.86
臺北縣,林口鄉,湖南村,1224,2,851,10,861,1227,3,1,3,0,1,0,70.17
臺北縣,林口鄉,南勢村,1225,2,574,8,582,851,3,1,3,0,1,0,68.39
臺北縣,林口鄉,南勢村,1226,2,657,7,664,1039,3,1,3,0,1,0,63.91
臺北縣,林口鄉,南勢村,1227,2,739,15,754,1162,3,1,3,0,1,0,64.89
臺北縣,林口鄉,南勢村,1228,2,677,3,680,1005,3,1,3,0,1,0,67.66
臺北縣,林口鄉,南勢村,1229,2,585,9,594,909,3,1,3,0,1,0,65.35
臺北縣,林口鄉,南勢村,1230,2,610,6,616,933,3,1,3,0,1,0,66.02
臺北縣,林口鄉,南勢村,1231,2,607,8,615,891,3,1,3,0,1,0,69.02
臺北縣,林口鄉,東勢村,1232,2,683,11,694,1072,3,1,3,0,1,0,64.74
臺北縣,林口鄉,東勢村,1233,2,717,10,727,1121,3,1,3,0,1,0,64.85
臺北縣,林口鄉,東勢村,1234,2,900,12,912,1338,3,1,3,0,1,0,68.16
臺北縣,林口鄉,東勢村,1235,2,947,11,958,1382,3,1,3,0,1,0,69.32
臺北縣,林口鄉,東勢村,1236,2,754,8,762,1147,3,1,3,0,1,0,66.43
臺北縣,林口鄉,頂福村,1237,2,605,13,618,943,3,1,3,0,1,0,65.54
臺北縣,林口鄉,下福村,1238,2,626,16,642,897,3,1,3,0,1,0,71.57
臺北縣,林口鄉,嘉寶村,1239,2,475,8,483,644,3,1,3,0,1,0,75.00
臺北縣,林口鄉,瑞平村,1240,2,280,4,284,428,3,1,3,0,1,0,66.36
臺北縣,林口鄉,太平村,1241,2,518,6,524,750,3,1,3,0,1,0,69.87
臺北縣,淡水鎮,中和里,1242,2,426,4,430,571,3,1,3,0,1,0,75.31
臺北縣,淡水鎮,屯山里,1243,2,677,16,693,968,3,1,3,0,1,0,71.59
臺北縣,淡水鎮,賢孝里,1244,2,859,19,878,1288,3,1,3,0,1,0,68.17
臺北縣,淡水鎮,興仁里,1245,2,916,9,925,1368,3,1,3,0,1,0,67.62
臺北縣,淡水鎮,蕃薯里,1246,2,459,1,460,760,3,1,3,0,1,0,60.53
臺北縣,淡水鎮,義山里,1247,2,712,10,722,1145,3,1,3,0,1,0,63.06
臺北縣,淡水鎮,義山里,1248,2,597,11,608,995,3,1,3,0,1,0,61.11
臺北縣,淡水鎮,忠山里,1249,2,539,13,552,788,3,1,3,0,1,0,70.05
臺北縣,淡水鎮,水源里,1250,2,574,10,584,888,3,1,3,0,1,0,65.77
臺北縣,淡水鎮,水源里,1251,2,584,18,602,893,3,1,3,0,1,0,67.41
臺北縣,淡水鎮,忠寮里,1252,2,662,15,677,966,3,1,3,0,1,0,70.08
臺北縣,淡水鎮,樹興里,1253,2,487,16,503,742,3,1,3,0,1,0,67.79
臺北縣,淡水鎮,坪頂里,1254,2,608,13,621,976,3,1,3,0,1,0,63.63
臺北縣,淡水鎮,福德里,1255,2,1036,10,1046,1622,3,1,3,0,1,0,64.49
臺北縣,淡水鎮,福德里,1256,2,1023,7,1030,1566,3,1,3,0,1,0,65.77
臺北縣,淡水鎮,福德里,1257,2,947,16,963,1496,3,1,3,0,1,0,64.37
臺北縣,淡水鎮,竹圍里,1258,2,834,12,846,1273,3,1,3,0,1,0,66.46
臺北縣,淡水鎮,竹圍里,1259,2,1073,15,1088,1710,3,1,3,0,1,0,63.63
臺北縣,淡水鎮,竹圍里,1260,2,1216,26,1242,1878,3,1,3,0,1,0,66.13
臺北縣,淡水鎮,竹圍里,1261,2,874,7,881,1433,3,1,3,0,1,0,61.48
臺北縣,淡水鎮,民生里,1262,2,858,25,883,1383,3,1,3,0,1,0,63.85
臺北縣,淡水鎮,民生里,1263,2,882,17,899,1354,3,1,3,0,1,0,66.40
臺北縣,淡水鎮,民生里,1264,2,836,12,848,1276,3,1,3,0,1,0,66.46
臺北縣,淡水鎮,八勢里,1265,2,866,13,879,1330,3,1,3,0,1,0,66.09
臺北縣,淡水鎮,竿蓁里,1266,2,871,14,885,1518,3,1,3,0,1,0,58.30
臺北縣,淡水鎮,竿蓁里,1267,2,740,13,753,1128,3,1,3,0,1,0,66.76
臺北縣,淡水鎮,崁頂里,1268,2,628,6,634,923,3,1,3,0,1,0,68.69
臺北縣,淡水鎮,埤島里,1269,2,725,12,737,1067,3,1,3,0,1,0,69.07
臺北縣,淡水鎮,新興里,1270,2,1031,14,1045,1562,3,1,3,0,1,0,66.90
臺北縣,淡水鎮,新興里,1271,2,1043,18,1061,1594,3,1,3,0,1,0,66.56
臺北縣,淡水鎮,新興里,1272,2,1044,24,1068,1665,3,1,3,0,1,0,64.14
臺北縣,淡水鎮,新興里,1273,2,791,16,807,1338,3,1,3,0,1,0,60.31
臺北縣,淡水鎮,新興里,1274,2,1072,20,1092,1704,3,1,3,0,1,0,64.08
臺北縣,淡水鎮,新興里,1275,2,881,13,894,1392,3,1,3,0,1,0,64.22
臺北縣,淡水鎮,新興里,1276,2,952,12,964,1605,3,1,3,0,1,0,60.06
臺北縣,淡水鎮,新興里,1277,2,1054,21,1075,1622,3,1,3,0,1,0,66.28
臺北縣,淡水鎮,水碓里,1278,2,953,21,974,1409,3,1,3,0,1,0,69.13
臺北縣,淡水鎮,水碓里,1279,2,934,21,955,1457,3,1,3,0,1,0,65.55
臺北縣,淡水鎮,水碓里,1280,2,772,11,783,1215,3,1,3,0,1,0,64.44
臺北縣,淡水鎮,水碓里,1281,2,797,13,810,1250,3,1,3,0,1,0,64.80
臺北縣,淡水鎮,水碓里,1282,2,996,17,1013,1587,3,1,3,0,1,0,63.83
臺北縣,淡水鎮,水碓里,1283,2,841,16,857,1357,3,1,3,0,1,0,63.15
臺北縣,淡水鎮,北投里,1284,2,1048,21,1069,1578,3,1,3,0,1,0,67.74
臺北縣,淡水鎮,鄧公里,1285,2,940,18,958,1470,3,1,3,0,1,0,65.17
臺北縣,淡水鎮,鄧公里,1286,2,930,18,948,1475,3,1,3,0,1,0,64.27
臺北縣,淡水鎮,鄧公里,1287,2,1019,26,1045,1584,3,1,3,0,1,0,65.97
臺北縣,淡水鎮,鄧公里,1288,2,975,16,991,1626,3,1,3,0,1,0,60.95
臺北縣,淡水鎮,鄧公里,1289,2,1023,27,1050,1552,3,1,3,0,1,0,67.65
臺北縣,淡水鎮,鄧公里,1290,2,1077,21,1098,1652,3,1,3,0,1,0,66.46
臺北縣,淡水鎮,中興里,1291,2,734,15,749,1095,3,1,3,0,1,0,68.40
臺北縣,淡水鎮,中興里,1292,2,900,17,917,1311,3,1,3,0,1,0,69.95
臺北縣,淡水鎮,中興里,1293,2,790,15,805,1151,3,1,3,0,1,0,69.94
臺北縣,淡水鎮,長庚里,1294,2,1015,19,1034,1543,3,1,3,0,1,0,67.01
臺北縣,淡水鎮,清文里,1295,2,685,14,699,1017,3,1,3,0,1,0,68.73
臺北縣,淡水鎮,草東里,1296,2,604,8,612,846,3,1,3,0,1,0,72.34
臺北縣,淡水鎮,協元里,1297,2,861,10,871,1350,3,1,3,0,1,0,64.52
臺北縣,淡水鎮,永吉里,1298,2,504,14,518,723,3,1,3,0,1,0,71.65
臺北縣,淡水鎮,民安里,1299,2,511,5,516,727,3,1,3,0,1,0,70.98
臺北縣,淡水鎮,新生里,1300,2,317,3,320,476,3,1,3,0,1,0,67.23
臺北縣,淡水鎮,文化里,1301,2,835,9,844,1281,3,1,3,0,1,0,65.89
臺北縣,淡水鎮,油車里,1302,2,809,14,823,1180,3,1,3,0,1,0,69.75
臺北縣,淡水鎮,油車里,1303,2,674,23,697,1110,3,1,3,0,1,0,62.79
臺北縣,淡水鎮,油車里,1304,2,788,11,799,1127,3,1,3,0,1,0,70.90
臺北縣,淡水鎮,沙崙里,1305,2,918,14,932,1464,3,1,3,0,1,0,63.66
臺北縣,淡水鎮,沙崙里,1306,2,1007,23,1030,1552,3,1,3,0,1,0,66.37
臺北縣,淡水鎮,沙崙里,1307,2,950,20,970,1426,3,1,3,0,1,0,68.02
臺北縣,八里鄉,龍源村,1308,2,1082,24,1106,1656,3,1,3,0,1,0,66.79
臺北縣,八里鄉,龍源村,1309,2,768,10,778,1132,3,1,3,0,1,0,68.73
臺北縣,八里鄉,龍源村,1310,2,789,17,806,1159,3,1,3,0,1,0,69.54
臺北縣,八里鄉,米倉村,1311,2,724,12,736,1158,3,1,3,0,1,0,63.56
臺北縣,八里鄉,米倉村,1312,2,707,11,718,1012,3,1,3,0,1,0,70.95
臺北縣,八里鄉,大崁村,1313,2,992,21,1013,1374,3,1,3,0,1,0,73.73
臺北縣,八里鄉,埤頭村,1314,2,621,13,634,991,3,1,3,0,1,0,63.98
臺北縣,八里鄉,埤頭村,1315,2,809,15,824,1206,3,1,3,0,1,0,68.33
臺北縣,八里鄉,頂罟村,1316,2,708,18,726,1034,3,1,3,0,1,0,70.21
臺北縣,八里鄉,舊城村,1317,2,751,16,767,1147,3,1,3,0,1,0,66.87
臺北縣,八里鄉,舊城村,1318,2,753,12,765,1214,3,1,3,0,1,0,63.01
臺北縣,八里鄉,舊城村,1319,2,883,9,892,1456,3,1,3,0,1,0,61.26
臺北縣,八里鄉,訊塘村,1320,2,847,16,863,1243,3,1,3,0,1,0,69.43
臺北縣,八里鄉,訊塘村,1321,2,729,15,744,1091,3,1,3,0,1,0,68.19
臺北縣,八里鄉,荖阡村,1322,2,852,13,865,1222,3,1,3,0,1,0,70.79
臺北縣,八里鄉,下罟村,1323,2,777,11,788,997,3,1,3,0,1,0,79.04
臺北縣,八里鄉,長坑村,1324,2,814,15,829,1059,3,1,3,0,1,0,78.28
臺北縣,三芝鄉,八賢村,1325,2,270,6,276,369,3,1,3,0,1,0,74.80
臺北縣,三芝鄉,埔頭村,1326,2,783,7,790,1149,3,1,3,0,1,0,68.76
臺北縣,三芝鄉,埔頭村,1327,2,797,18,815,1178,3,1,3,0,1,0,69.19
臺北縣,三芝鄉,埔頭村,1328,2,730,18,748,1113,3,1,3,0,1,0,67.21
臺北縣,三芝鄉,古庄村,1329,2,603,10,613,882,3,1,3,0,1,0,69.50
臺北縣,三芝鄉,新庄村,1330,2,521,12,533,804,3,1,3,0,1,0,66.29
臺北縣,三芝鄉,埔坪村,1331,2,1031,17,1048,1619,3,1,3,0,1,0,64.73
臺北縣,三芝鄉,埔坪村,1332,2,940,9,949,1526,3,1,3,0,1,0,62.19
臺北縣,三芝鄉,埔坪村,1333,2,965,17,982,1527,3,1,3,0,1,0,64.31
臺北縣,三芝鄉,茂長村,1334,2,288,4,292,428,3,1,3,0,1,0,68.22
臺北縣,三芝鄉,橫山村,1335,2,370,8,378,552,3,1,3,0,1,0,68.48
臺北縣,三芝鄉,錫板村,1336,2,506,7,513,760,3,1,3,0,1,0,67.50
臺北縣,三芝鄉,後厝村,1337,2,908,16,924,1463,3,1,3,0,1,0,63.16
臺北縣,三芝鄉,福德村,1338,2,424,10,434,627,3,1,3,0,1,0,69.22
臺北縣,三芝鄉,圓山村,1339,2,308,7,315,492,3,1,3,0,1,0,64.02
臺北縣,三芝鄉,店子村,1340,2,443,6,449,628,3,1,3,0,1,0,71.50
臺北縣,三芝鄉,興華村,1341,2,688,9,697,1108,3,1,3,0,1,0,62.91
臺北縣,石門鄉,德茂村,1342,2,574,6,580,836,3,1,3,0,1,0,69.38
臺北縣,石門鄉,富基村,1343,2,719,7,726,1021,3,1,3,0,1,0,71.11
臺北縣,石門鄉,老梅村,1344,2,1123,16,1139,1717,3,1,3,0,1,0,66.34
臺北縣,石門鄉,山溪村,1345,2,479,5,484,700,3,1,3,0,1,0,69.14
臺北縣,石門鄉,石門村,1346,2,780,5,785,1162,3,1,3,0,1,0,67.56
臺北縣,石門鄉,尖鹿村,1347,2,780,10,790,1206,3,1,3,0,1,0,65.51
臺北縣,石門鄉,乾華村,1348,2,206,0,206,324,3,1,3,0,1,0,63.58
臺北縣,石門鄉,茂林村,1349,2,331,4,335,489,3,1,3,0,1,0,68.51
臺北縣,石門鄉,草里村,1350,2,458,1,459,727,3,1,3,0,1,0,63.14
臺北縣,金山鄉,和平村,1351,2,287,6,293,418,3,1,3,0,1,0,70.10
臺北縣,金山鄉,大同村,1352,2,432,6,438,626,3,1,3,0,1,0,69.97
臺北縣,金山鄉,豐漁村,1353,2,315,4,319,459,3,1,3,0,1,0,69.50
臺北縣,金山鄉,磺港村,1354,2,917,18,935,1525,3,1,3,0,1,0,61.31
臺北縣,金山鄉,美田村,1355,2,1060,10,1070,1579,3,1,3,0,1,0,67.76
臺北縣,金山鄉,美田村,1356,2,1082,10,1092,1615,3,1,3,0,1,0,67.62
臺北縣,金山鄉,美田村,1357,2,1040,14,1054,1671,3,1,3,0,1,0,63.08
臺北縣,金山鄉,美田村,1358,2,928,7,935,1491,3,1,3,0,1,0,62.71
臺北縣,金山鄉,五湖村,1359,2,455,10,465,667,3,1,3,0,1,0,69.72
臺北縣,金山鄉,五湖村,1360,2,502,7,509,759,3,1,3,0,1,0,67.06
臺北縣,金山鄉,重和村,1361,2,569,4,573,882,3,1,3,0,1,0,64.97
臺北縣,金山鄉,兩湖村,1362,2,243,6,249,385,3,1,3,0,1,0,64.68
臺北縣,金山鄉,六股村,1363,2,377,1,378,533,3,1,3,0,1,0,70.92
臺北縣,金山鄉,三界村,1364,2,398,13,411,587,3,1,3,0,1,0,70.02
臺北縣,金山鄉,清泉村,1365,2,501,6,507,798,3,1,3,0,1,0,63.53
臺北縣,金山鄉,西湖村,1366,2,162,0,162,234,3,1,3,0,1,0,69.23
臺北縣,金山鄉,萬壽村,1367,2,310,4,314,451,3,1,3,0,1,0,69.62
臺北縣,金山鄉,永興村,1368,2,308,3,311,553,3,1,3,0,1,0,56.24
臺北縣,萬里鄉,萬里村,1369,2,1032,18,1050,1544,3,1,3,0,1,0,68.01
臺北縣,萬里鄉,萬里村,1370,2,970,10,980,1422,3,1,3,0,1,0,68.92
臺北縣,萬里鄉,北基村,1371,2,586,14,600,1009,3,1,3,0,1,0,59.46
臺北縣,萬里鄉,北基村,1372,2,512,12,524,906,3,1,3,0,1,0,57.84
臺北縣,萬里鄉,龜吼村,1373,2,294,19,313,547,3,1,3,0,1,0,57.22
臺北縣,萬里鄉,龜吼村,1374,2,621,12,633,1062,3,1,3,0,1,0,59.60
臺北縣,萬里鄉,野柳村,1375,2,730,11,741,1173,3,1,3,0,1,0,63.17
臺北縣,萬里鄉,野柳村,1376,2,647,8,655,1073,3,1,3,0,1,0,61.04
臺北縣,萬里鄉,大鵬村,1377,2,419,5,424,676,3,1,3,0,1,0,62.72
臺北縣,萬里鄉,大鵬村,1378,2,973,13,986,1444,3,1,3,0,1,0,68.28
臺北縣,萬里鄉,磺潭村,1379,2,313,1,314,465,3,1,3,0,1,0,67.53
臺北縣,萬里鄉,雙興村,1380,2,488,8,496,774,3,1,3,0,1,0,64.08
臺北縣,萬里鄉,溪底村,1381,2,335,6,341,527,3,1,3,0,1,0,64.71
臺北縣,萬里鄉,崁腳村,1382,2,365,7,372,560,3,1,3,0,1,0,66.43
臺北縣,萬里鄉,中幅村,1383,2,517,4,521,782,3,1,3,0,1,0,66.62
臺北縣,中和市,中原里,1384,3,1036,25,1061,1567,3,1,3,0,1,0,67.71
臺北縣,中和市,中原里,1385,3,494,10,504,736,3,1,3,0,1,0,68.48
臺北縣,中和市,中原里,1386,3,873,15,888,1415,3,1,3,0,1,0,62.76
臺北縣,中和市,連和里,1387,3,446,6,452,630,3,1,3,0,1,0,71.75
臺北縣,中和市,連和里,1388,3,413,5,418,576,3,1,3,0,1,0,72.57
臺北縣,中和市,連城里,1389,3,841,13,854,1234,3,1,3,0,1,0,69.21
臺北縣,中和市,連城里,1390,3,1006,8,1014,1350,3,1,3,0,1,0,75.11
臺北縣,中和市,連城里,1391,3,1434,15,1449,2090,3,1,3,0,1,0,69.33
臺北縣,中和市,力行里,1392,3,1410,30,1440,2003,3,1,3,0,1,0,71.89
臺北縣,中和市,力行里,1393,3,1162,18,1180,1665,3,1,3,0,1,0,70.87
臺北縣,中和市,正行里,1394,3,635,12,647,921,3,1,3,0,1,0,70.25
臺北縣,中和市,正行里,1395,3,807,9,816,1204,3,1,3,0,1,0,67.77
臺北縣,中和市,德行里,1396,3,1297,14,1311,1832,3,1,3,0,1,0,71.56
臺北縣,中和市,德行里,1397,3,1134,14,1148,1650,3,1,3,0,1,0,69.58
臺北縣,中和市,枋寮里,1398,3,916,10,926,1383,3,1,3,0,1,0,66.96
臺北縣,中和市,枋寮里,1399,3,977,15,992,1403,3,1,3,0,1,0,70.71
臺北縣,中和市,漳和里,1400,3,967,16,983,1572,3,1,3,0,1,0,62.53
臺北縣,中和市,漳和里,1401,3,950,13,963,1344,3,1,3,0,1,0,71.65
臺北縣,中和市,廟美里,1402,3,794,10,804,1157,3,1,3,0,1,0,69.49
臺北縣,中和市,廟美里,1403,3,843,10,853,1196,3,1,3,0,1,0,71.32
臺北縣,中和市,廟美里,1404,3,918,10,928,1371,3,1,3,0,1,0,67.69
臺北縣,中和市,福真里,1405,3,1061,18,1079,1620,3,1,3,0,1,0,66.60
臺北縣,中和市,福真里,1406,3,1189,19,1208,1713,3,1,3,0,1,0,70.52
臺北縣,中和市,福善里,1407,3,664,17,681,984,3,1,3,0,1,0,69.21
臺北縣,中和市,福善里,1408,3,1073,23,1096,1540,3,1,3,0,1,0,71.17
臺北縣,中和市,福善里,1409,3,638,14,652,878,3,1,3,0,1,0,74.26
臺北縣,中和市,福美里,1410,3,1140,15,1155,1524,3,1,3,0,1,0,75.79
臺北縣,中和市,福美里,1411,3,836,11,847,1200,3,1,3,0,1,0,70.58
臺北縣,中和市,福美里,1412,3,746,7,753,1053,3,1,3,0,1,0,71.51
臺北縣,中和市,福祥里,1413,3,1146,12,1158,1652,3,1,3,0,1,0,70.10
臺北縣,中和市,福祥里,1414,3,1415,12,1427,2023,3,1,3,0,1,0,70.54
臺北縣,中和市,瓦窯里,1415,3,617,11,628,957,3,1,3,0,1,0,65.62
臺北縣,中和市,瓦窯里,1416,3,992,14,1006,1436,3,1,3,0,1,0,70.06
臺北縣,中和市,瓦窯里,1417,3,942,15,957,1374,3,1,3,0,1,0,69.65
臺北縣,中和市,福和里,1418,3,1003,7,1010,1448,3,1,3,0,1,0,69.75
臺北縣,中和市,福和里,1419,3,1186,20,1206,1721,3,1,3,0,1,0,70.08
臺北縣,中和市,佳和里,1420,3,1064,16,1080,1572,3,1,3,0,1,0,68.70
臺北縣,中和市,佳和里,1421,3,972,7,979,1349,3,1,3,0,1,0,72.57
臺北縣,中和市,佳和里,1422,3,747,9,756,1042,3,1,3,0,1,0,72.55
臺北縣,中和市,新南里,1423,3,1564,17,1581,2272,3,1,3,0,1,0,69.59
臺北縣,中和市,新南里,1424,3,1188,12,1200,1760,3,1,3,0,1,0,68.18
臺北縣,中和市,新南里,1425,3,1206,17,1223,1693,3,1,3,0,1,0,72.24
臺北縣,中和市,南山里,1426,3,1227,13,1240,1754,3,1,3,0,1,0,70.70
臺北縣,中和市,南山里,1427,3,1149,8,1157,1637,3,1,3,0,1,0,70.68
臺北縣,中和市,平河里,1428,3,1655,23,1678,2591,3,1,3,0,1,0,64.76
臺北縣,中和市,平河里,1429,3,1881,19,1900,2783,3,1,3,0,1,0,68.27
臺北縣,中和市,信和里,1430,3,686,11,697,1046,3,1,3,0,1,0,66.63
臺北縣,中和市,信和里,1431,3,854,16,870,1281,3,1,3,0,1,0,67.92
臺北縣,中和市,信和里,1432,3,862,6,868,1229,3,1,3,0,1,0,70.63
臺北縣,中和市,仁和里,1433,3,878,21,899,1299,3,1,3,0,1,0,69.21
臺北縣,中和市,仁和里,1434,3,657,11,668,954,3,1,3,0,1,0,70.02
臺北縣,中和市,仁和里,1435,3,838,12,850,1185,3,1,3,0,1,0,71.73
臺北縣,中和市,中正里,1436,3,1066,25,1091,1581,3,1,3,0,1,0,69.01
臺北縣,中和市,中正里,1437,3,1158,30,1188,1694,3,1,3,0,1,0,70.13
臺北縣,中和市,中山里,1438,3,691,14,705,966,3,1,3,0,1,0,72.98
臺北縣,中和市,中山里,1439,3,621,13,634,905,3,1,3,0,1,0,70.06
臺北縣,中和市,建和里,1440,3,1058,4,1062,1414,3,1,3,0,1,0,75.11
臺北縣,中和市,建和里,1441,3,1283,23,1306,1820,3,1,3,0,1,0,71.76
臺北縣,中和市,碧河里,1442,3,743,12,755,1142,3,1,3,0,1,0,66.11
臺北縣,中和市,碧河里,1443,3,911,11,922,1317,3,1,3,0,1,0,70.01
臺北縣,中和市,宜安里,1444,3,1194,11,1205,1615,3,1,3,0,1,0,74.61
臺北縣,中和市,安樂里,1445,3,1129,17,1146,1534,3,1,3,0,1,0,74.71
臺北縣,中和市,安樂里,1446,3,982,12,994,1365,3,1,3,0,1,0,72.82
臺北縣,中和市,安和里,1447,3,959,14,973,1298,3,1,3,0,1,0,74.96
臺北縣,中和市,安和里,1448,3,835,13,848,1171,3,1,3,0,1,0,72.42
臺北縣,中和市,安順里,1449,3,1088,14,1102,1581,3,1,3,0,1,0,69.70
臺北縣,中和市,安順里,1450,3,1337,10,1347,1848,3,1,3,0,1,0,72.89
臺北縣,中和市,安平里,1451,3,839,11,850,1140,3,1,3,0,1,0,74.56
臺北縣,中和市,安平里,1452,3,876,14,890,1219,3,1,3,0,1,0,73.01
臺北縣,中和市,安平里,1453,3,1154,11,1165,1645,3,1,3,0,1,0,70.82
臺北縣,中和市,中安里,1454,3,1171,16,1187,1605,3,1,3,0,1,0,73.96
臺北縣,中和市,中安里,1455,3,1288,9,1297,1784,3,1,3,0,1,0,72.70
臺北縣,中和市,泰安里,1456,3,788,8,796,1117,3,1,3,0,1,0,71.26
臺北縣,中和市,泰安里,1457,3,669,12,681,970,3,1,3,0,1,0,70.21
臺北縣,中和市,泰安里,1458,3,845,8,853,1227,3,1,3,0,1,0,69.52
臺北縣,中和市,秀山里,1459,3,1266,23,1289,1880,3,1,3,0,1,0,68.56
臺北縣,中和市,秀山里,1460,3,1151,17,1168,1654,3,1,3,0,1,0,70.62
臺北縣,中和市,秀成里,1461,3,983,12,995,1389,3,1,3,0,1,0,71.63
臺北縣,中和市,秀成里,1462,3,989,12,1001,1441,3,1,3,0,1,0,69.47
臺北縣,中和市,秀義里,1463,3,818,13,831,1201,3,1,3,0,1,0,69.19
臺北縣,中和市,秀義里,1464,3,740,13,753,1035,3,1,3,0,1,0,72.75
臺北縣,中和市,秀福里,1465,3,1228,14,1242,1711,3,1,3,0,1,0,72.59
臺北縣,中和市,秀福里,1466,3,688,10,698,977,3,1,3,0,1,0,71.44
臺北縣,中和市,秀福里,1467,3,933,5,938,1248,3,1,3,0,1,0,75.16
臺北縣,中和市,秀景里,1468,3,793,11,804,1171,3,1,3,0,1,0,68.66
臺北縣,中和市,秀景里,1469,3,938,10,948,1374,3,1,3,0,1,0,69.00
臺北縣,中和市,秀景里,1470,3,950,13,963,1365,3,1,3,0,1,0,70.55
臺北縣,中和市,秀景里,1471,3,796,7,803,1083,3,1,3,0,1,0,74.15
臺北縣,中和市,秀明里,1472,3,984,10,994,1377,3,1,3,0,1,0,72.19
臺北縣,中和市,秀明里,1473,3,1521,13,1534,2267,3,1,3,0,1,0,67.67
臺北縣,中和市,秀峰里,1474,3,1515,18,1533,2132,3,1,3,0,1,0,71.90
臺北縣,中和市,秀峰里,1475,3,740,6,746,1092,3,1,3,0,1,0,68.32
臺北縣,中和市,秀士里,1476,3,839,13,852,1238,3,1,3,0,1,0,68.82
臺北縣,中和市,秀士里,1477,3,681,5,686,965,3,1,3,0,1,0,71.09
臺北縣,中和市,秀水里,1478,3,714,9,723,1074,3,1,3,0,1,0,67.32
臺北縣,中和市,秀水里,1479,3,765,12,777,1131,3,1,3,0,1,0,68.70
臺北縣,中和市,秀水里,1480,3,848,15,863,1168,3,1,3,0,1,0,73.89
臺北縣,中和市,秀仁里,1481,3,836,13,849,1192,3,1,3,0,1,0,71.22
臺北縣,中和市,秀仁里,1482,3,768,10,778,1121,3,1,3,0,1,0,69.40
臺北縣,中和市,正南里,1483,3,764,19,783,1153,3,1,3,0,1,0,67.91
臺北縣,中和市,正南里,1484,3,618,14,632,884,3,1,3,0,1,0,71.49
臺北縣,中和市,正南里,1485,3,726,16,742,1100,3,1,3,0,1,0,67.45
臺北縣,中和市,頂南里,1486,3,841,11,852,1185,3,1,3,0,1,0,71.90
臺北縣,中和市,頂南里,1487,3,929,9,938,1303,3,1,3,0,1,0,71.99
臺北縣,中和市,華新里,1488,3,1077,9,1086,1593,3,1,3,0,1,0,68.17
臺北縣,中和市,華新里,1489,3,1226,20,1246,1873,3,1,3,0,1,0,66.52
臺北縣,中和市,華新里,1490,3,902,9,911,1420,3,1,3,0,1,0,64.15
臺北縣,中和市,東南里,1491,3,770,10,780,1062,3,1,3,0,1,0,73.45
臺北縣,中和市,東南里,1492,3,990,20,1010,1403,3,1,3,0,1,0,71.99
臺北縣,中和市,東南里,1493,3,1062,16,1078,1446,3,1,3,0,1,0,74.55
臺北縣,中和市,華南里,1494,3,1122,15,1137,1591,3,1,3,0,1,0,71.46
臺北縣,中和市,華南里,1495,3,1062,23,1085,1545,3,1,3,0,1,0,70.23
臺北縣,中和市,忠孝里,1496,3,577,9,586,887,3,1,3,0,1,0,66.07
臺北縣,中和市,忠孝里,1497,3,589,10,599,875,3,1,3,0,1,0,68.46
臺北縣,中和市,忠孝里,1498,3,853,12,865,1238,3,1,3,0,1,0,69.87
臺北縣,中和市,忠孝里,1499,3,872,18,890,1330,3,1,3,0,1,0,66.92
臺北縣,中和市,崇南里,1500,3,1359,13,1372,1907,3,1,3,0,1,0,71.95
臺北縣,中和市,崇南里,1501,3,786,12,798,1124,3,1,3,0,1,0,71.00
臺北縣,中和市,興南里,1502,3,1019,22,1041,1470,3,1,3,0,1,0,70.82
臺北縣,中和市,興南里,1503,3,1017,16,1033,1468,3,1,3,0,1,0,70.37
臺北縣,中和市,景南里,1504,3,823,16,839,1132,3,1,3,0,1,0,74.12
臺北縣,中和市,景南里,1505,3,1100,16,1116,1573,3,1,3,0,1,0,70.95
臺北縣,中和市,景本里,1506,3,594,9,603,845,3,1,3,0,1,0,71.36
臺北縣,中和市,景本里,1507,3,746,22,768,1085,3,1,3,0,1,0,70.78
臺北縣,中和市,橫路里,1508,3,225,5,230,303,3,1,3,0,1,0,75.91
臺北縣,中和市,內南里,1509,3,935,19,954,1357,3,1,3,0,1,0,70.30
臺北縣,中和市,內南里,1510,3,958,20,978,1339,3,1,3,0,1,0,73.04
臺北縣,中和市,內南里,1511,3,1024,9,1033,1462,3,1,3,0,1,0,70.66
臺北縣,中和市,壽南里,1512,3,1036,11,1047,1431,3,1,3,0,1,0,73.17
臺北縣,中和市,壽南里,1513,3,558,12,570,822,3,1,3,0,1,0,69.34
臺北縣,中和市,福南里,1514,3,1070,19,1089,1579,3,1,3,0,1,0,68.97
臺北縣,中和市,福南里,1515,3,1052,18,1070,1575,3,1,3,0,1,0,67.94
臺北縣,中和市,外南里,1516,3,1134,9,1143,1604,3,1,3,0,1,0,71.26
臺北縣,中和市,外南里,1517,3,1064,10,1074,1553,3,1,3,0,1,0,69.16
臺北縣,中和市,中興里,1518,3,1004,15,1019,1386,3,1,3,0,1,0,73.52
臺北縣,中和市,中興里,1519,3,857,8,865,1240,3,1,3,0,1,0,69.76
臺北縣,中和市,中興里,1520,3,812,9,821,1128,3,1,3,0,1,0,72.78
臺北縣,中和市,吉興里,1521,3,729,12,741,1038,3,1,3,0,1,0,71.39
臺北縣,中和市,吉興里,1522,3,644,8,652,948,3,1,3,0,1,0,68.78
臺北縣,中和市,復興里,1523,3,1091,15,1106,1534,3,1,3,0,1,0,72.10
臺北縣,中和市,復興里,1524,3,733,8,741,1125,3,1,3,0,1,0,65.87
臺北縣,中和市,復興里,1525,3,1312,20,1332,1907,3,1,3,0,1,0,69.85
臺北縣,中和市,和興里,1526,3,1065,18,1083,1570,3,1,3,0,1,0,68.98
臺北縣,中和市,和興里,1527,3,1178,18,1196,1715,3,1,3,0,1,0,69.74
臺北縣,中和市,景平里,1528,3,1074,21,1095,1645,3,1,3,0,1,0,66.57
臺北縣,中和市,景平里,1529,3,1289,18,1307,1848,3,1,3,0,1,0,70.73
臺北縣,中和市,景新里,1530,3,1090,15,1105,1580,3,1,3,0,1,0,69.94
臺北縣,中和市,景新里,1531,3,1010,17,1027,1438,3,1,3,0,1,0,71.42
臺北縣,中和市,景福里,1532,3,1063,16,1079,1574,3,1,3,0,1,0,68.55
臺北縣,中和市,景福里,1533,3,796,6,802,1164,3,1,3,0,1,0,68.90
臺北縣,中和市,景福里,1534,3,1007,20,1027,1507,3,1,3,0,1,0,68.15
臺北縣,中和市,景安里,1535,3,537,7,544,721,3,1,3,0,1,0,75.45
臺北縣,中和市,景安里,1536,3,874,5,879,1212,3,1,3,0,1,0,72.52
臺北縣,中和市,景安里,1537,3,954,14,968,1331,3,1,3,0,1,0,72.73
臺北縣,中和市,景安里,1538,3,597,5,602,855,3,1,3,0,1,0,70.41
臺北縣,中和市,景文里,1539,3,1065,15,1080,1477,3,1,3,0,1,0,73.12
臺北縣,中和市,景文里,1540,3,738,12,750,1052,3,1,3,0,1,0,71.29
臺北縣,中和市,錦和里,1541,3,1163,10,1173,1629,3,1,3,0,1,0,72.01
臺北縣,中和市,錦和里,1542,3,1093,17,1110,1602,3,1,3,0,1,0,69.29
臺北縣,中和市,錦中里,1543,3,1169,12,1181,1682,3,1,3,0,1,0,70.21
臺北縣,中和市,錦中里,1544,3,815,17,832,1200,3,1,3,0,1,0,69.33
臺北縣,中和市,錦昌里,1545,3,965,9,974,1393,3,1,3,0,1,0,69.92
臺北縣,中和市,錦盛里,1546,3,1195,22,1217,1700,3,1,3,0,1,0,71.59
臺北縣,中和市,錦盛里,1547,3,867,17,884,1282,3,1,3,0,1,0,68.95
臺北縣,中和市,灰窯里,1548,3,325,5,330,500,3,1,3,0,1,0,66.00
臺北縣,中和市,積穗里,1549,3,1314,25,1339,1966,3,1,3,0,1,0,68.11
臺北縣,中和市,積穗里,1550,3,1284,20,1304,1810,3,1,3,0,1,0,72.04
臺北縣,中和市,積穗里,1551,3,407,5,412,578,3,1,3,0,1,0,71.28
臺北縣,中和市,民享里,1552,3,769,13,782,1020,3,1,3,0,1,0,76.67
臺北縣,中和市,民享里,1553,3,812,15,827,1121,3,1,3,0,1,0,73.77
臺北縣,中和市,民有里,1554,3,959,14,973,1391,3,1,3,0,1,0,69.95
臺北縣,中和市,民有里,1555,3,785,21,806,1174,3,1,3,0,1,0,68.65
臺北縣,中和市,員山里,1556,3,859,15,874,1266,3,1,3,0,1,0,69.04
臺北縣,中和市,員山里,1557,3,999,24,1023,1490,3,1,3,0,1,0,68.66
臺北縣,中和市,員山里,1558,3,451,10,461,715,3,1,3,0,1,0,64.48
臺北縣,中和市,員富里,1559,3,428,11,439,776,3,1,3,0,1,0,56.57
臺北縣,中和市,員富里,1560,3,840,13,853,1352,3,1,3,0,1,0,63.09
臺北縣,中和市,嘉穗里,1561,3,860,13,873,1171,3,1,3,0,1,0,74.55
臺北縣,中和市,嘉穗里,1562,3,625,10,635,978,3,1,3,0,1,0,64.93
臺北縣,中和市,嘉慶里,1563,3,995,24,1019,1553,3,1,3,0,1,0,65.61
臺北縣,中和市,嘉慶里,1564,3,935,8,943,1495,3,1,3,0,1,0,63.08
臺北縣,中和市,文元里,1565,3,788,12,800,1212,3,1,3,0,1,0,66.01
臺北縣,中和市,文元里,1566,3,1066,17,1083,1553,3,1,3,0,1,0,69.74
臺北縣,中和市,文元里,1567,3,1153,11,1164,1647,3,1,3,0,1,0,70.67
臺北縣,中和市,嘉新里,1568,3,950,11,961,1444,3,1,3,0,1,0,66.55
臺北縣,中和市,嘉新里,1569,3,1068,23,1091,1578,3,1,3,0,1,0,69.14
臺北縣,中和市,民安里,1570,3,896,10,906,1272,3,1,3,0,1,0,71.23
臺北縣,中和市,民安里,1571,3,762,8,770,1156,3,1,3,0,1,0,66.61
臺北縣,中和市,民安里,1572,3,811,16,827,1206,3,1,3,0,1,0,68.57
臺北縣,中和市,安穗里,1573,3,1005,16,1021,1467,3,1,3,0,1,0,69.60
臺北縣,中和市,安穗里,1574,3,962,19,981,1479,3,1,3,0,1,0,66.33
臺北縣,中和市,瑞穗里,1575,3,647,7,654,908,3,1,3,0,1,0,72.03
臺北縣,中和市,瑞穗里,1576,3,655,10,665,922,3,1,3,0,1,0,72.13
臺北縣,中和市,冠穗里,1577,3,1059,16,1075,1576,3,1,3,0,1,0,68.21
臺北縣,中和市,冠穗里,1578,3,916,12,928,1262,3,1,3,0,1,0,73.53
臺北縣,中和市,明穗里,1579,3,1133,18,1151,1568,3,1,3,0,1,0,73.41
臺北縣,中和市,明穗里,1580,3,1178,13,1191,1686,3,1,3,0,1,0,70.64
臺北縣,中和市,清穗里,1581,3,939,26,965,1371,3,1,3,0,1,0,70.39
臺北縣,中和市,清穗里,1582,3,934,19,953,1365,3,1,3,0,1,0,69.82
臺北縣,中和市,自強里,1583,3,718,10,728,1122,3,1,3,0,1,0,64.88
臺北縣,中和市,自強里,1584,3,985,14,999,1431,3,1,3,0,1,0,69.81
臺北縣,中和市,自強里,1585,3,847,8,855,1301,3,1,3,0,1,0,65.72
臺北縣,中和市,德穗里,1586,3,908,8,916,1357,3,1,3,0,1,0,67.50
臺北縣,中和市,德穗里,1587,3,754,8,762,1182,3,1,3,0,1,0,64.47
臺北縣,中和市,德穗里,1588,3,927,8,935,1297,3,1,3,0,1,0,72.09
臺北縣,中和市,民生里,1589,3,960,13,973,1363,3,1,3,0,1,0,71.39
臺北縣,中和市,民生里,1590,3,1355,26,1381,1990,3,1,3,0,1,0,69.40
臺北縣,中和市,國光里,1591,3,730,12,742,1107,3,1,3,0,1,0,67.03
臺北縣,中和市,國光里,1592,3,1311,16,1327,1907,3,1,3,0,1,0,69.59
臺北縣,中和市,國華里,1593,3,675,27,702,1044,3,1,3,0,1,0,67.24
臺北縣,中和市,國華里,1594,3,938,17,955,1452,3,1,3,0,1,0,65.77
臺北縣,中和市,壽德里,1595,3,570,4,574,813,3,1,3,0,1,0,70.60
臺北縣,中和市,壽德里,1596,3,925,18,943,1278,3,1,3,0,1,0,73.79
臺北縣,中和市,明德里,1597,3,1197,18,1215,1797,3,1,3,0,1,0,67.61
臺北縣,中和市,明德里,1598,3,1002,21,1023,1462,3,1,3,0,1,0,69.97
臺北縣,永和市,光復里,1599,3,1064,20,1084,1533,3,1,3,0,1,0,70.71
臺北縣,永和市,網溪里,1600,3,705,9,714,1053,3,1,3,0,1,0,67.81
臺北縣,永和市,復興里,1601,3,625,11,636,917,3,1,3,0,1,0,69.36
臺北縣,永和市,復興里,1602,3,845,9,854,1267,3,1,3,0,1,0,67.40
臺北縣,永和市,竹林里,1603,3,1168,18,1186,1712,3,1,3,0,1,0,69.28
臺北縣,永和市,竹林里,1604,3,1162,9,1171,1678,3,1,3,0,1,0,69.79
臺北縣,永和市,桂林里,1605,3,1142,24,1166,1636,3,1,3,0,1,0,71.27
臺北縣,永和市,桂林里,1606,3,1009,18,1027,1525,3,1,3,0,1,0,67.34
臺北縣,永和市,上林里,1607,3,1127,10,1137,1576,3,1,3,0,1,0,72.14
臺北縣,永和市,上林里,1608,3,1087,7,1094,1540,3,1,3,0,1,0,71.04
臺北縣,永和市,福林里,1609,3,1047,16,1063,1575,3,1,3,0,1,0,67.49
臺北縣,永和市,福林里,1610,3,1028,10,1038,1530,3,1,3,0,1,0,67.84
臺北縣,永和市,勵行里,1611,3,773,17,790,1106,3,1,3,0,1,0,71.43
臺北縣,永和市,中興里,1612,3,786,7,793,1151,3,1,3,0,1,0,68.90
臺北縣,永和市,中興里,1613,3,1023,18,1041,1524,3,1,3,0,1,0,68.31
臺北縣,永和市,永興里,1614,3,998,14,1012,1498,3,1,3,0,1,0,67.56
臺北縣,永和市,永興里,1615,3,956,10,966,1419,3,1,3,0,1,0,68.08
臺北縣,永和市,正興里,1616,3,742,11,753,1111,3,1,3,0,1,0,67.78
臺北縣,永和市,正興里,1617,3,633,3,636,937,3,1,3,0,1,0,67.88
臺北縣,永和市,豫溪里,1618,3,1124,11,1135,1615,3,1,3,0,1,0,70.28
臺北縣,永和市,豫溪里,1619,3,972,14,986,1593,3,1,3,0,1,0,61.90
臺北縣,永和市,光明里,1620,3,883,17,900,1252,3,1,3,0,1,0,71.88
臺北縣,永和市,光明里,1621,3,914,11,925,1412,3,1,3,0,1,0,65.51
臺北縣,永和市,福和里,1622,3,797,8,805,1204,3,1,3,0,1,0,66.86
臺北縣,永和市,福和里,1623,3,1077,10,1087,1621,3,1,3,0,1,0,67.06
臺北縣,永和市,福和里,1624,3,765,6,771,1104,3,1,3,0,1,0,69.84
臺北縣,永和市,得和里,1625,3,978,9,987,1357,3,1,3,0,1,0,72.73
臺北縣,永和市,得和里,1626,3,851,14,865,1209,3,1,3,0,1,0,71.55
臺北縣,永和市,得和里,1627,3,776,13,789,1091,3,1,3,0,1,0,72.32
臺北縣,永和市,永貞里,1628,3,1128,15,1143,1613,3,1,3,0,1,0,70.86
臺北縣,永和市,永貞里,1629,3,1004,15,1019,1501,3,1,3,0,1,0,67.89
臺北縣,永和市,永福里,1630,3,905,2,907,1301,3,1,3,0,1,0,69.72
臺北縣,永和市,永福里,1631,3,852,8,860,1232,3,1,3,0,1,0,69.81
臺北縣,永和市,河濱里,1632,3,829,14,843,1192,3,1,3,0,1,0,70.72
臺北縣,永和市,河濱里,1633,3,832,10,842,1178,3,1,3,0,1,0,71.48
臺北縣,永和市,秀和里,1634,3,1260,14,1274,1766,3,1,3,0,1,0,72.14
臺北縣,永和市,秀和里,1635,3,1316,16,1332,1893,3,1,3,0,1,0,70.36
臺北縣,永和市,永元里,1636,3,890,13,903,1307,3,1,3,0,1,0,69.09
臺北縣,永和市,永元里,1637,3,862,9,871,1246,3,1,3,0,1,0,69.90
臺北縣,永和市,永元里,1638,3,998,9,1007,1386,3,1,3,0,1,0,72.66
臺北縣,永和市,民權里,1639,3,879,12,891,1285,3,1,3,0,1,0,69.34
臺北縣,永和市,民權里,1640,3,948,9,957,1339,3,1,3,0,1,0,71.47
臺北縣,永和市,民權里,1641,3,763,19,782,1094,3,1,3,0,1,0,71.48
臺北縣,永和市,民族里,1642,3,813,8,821,1213,3,1,3,0,1,0,67.68
臺北縣,永和市,民族里,1643,3,990,4,994,1357,3,1,3,0,1,0,73.25
臺北縣,永和市,民族里,1644,3,844,10,854,1142,3,1,3,0,1,0,74.78
臺北縣,永和市,秀朗里,1645,3,1126,14,1140,1673,3,1,3,0,1,0,68.14
臺北縣,永和市,秀朗里,1646,3,1103,13,1116,1607,3,1,3,0,1,0,69.45
臺北縣,永和市,秀成里,1647,3,685,10,695,1010,3,1,3,0,1,0,68.81
臺北縣,永和市,秀成里,1648,3,1000,11,1011,1413,3,1,3,0,1,0,71.55
臺北縣,永和市,秀林里,1649,3,1145,11,1156,1632,3,1,3,0,1,0,70.83
臺北縣,永和市,秀林里,1650,3,882,8,890,1274,3,1,3,0,1,0,69.86
臺北縣,永和市,秀得里,1651,3,752,8,760,1044,3,1,3,0,1,0,72.80
臺北縣,永和市,秀得里,1652,3,769,9,778,1114,3,1,3,0,1,0,69.84
臺北縣,永和市,秀元里,1653,3,972,11,983,1362,3,1,3,0,1,0,72.17
臺北縣,永和市,秀元里,1654,3,888,3,891,1288,3,1,3,0,1,0,69.18
臺北縣,永和市,民生里,1655,3,726,7,733,1079,3,1,3,0,1,0,67.93
臺北縣,永和市,民生里,1656,3,951,8,959,1297,3,1,3,0,1,0,73.94
臺北縣,永和市,民生里,1657,3,710,13,723,998,3,1,3,0,1,0,72.44
臺北縣,永和市,民本里,1658,3,837,11,848,1186,3,1,3,0,1,0,71.50
臺北縣,永和市,民本里,1659,3,871,14,885,1258,3,1,3,0,1,0,70.35
臺北縣,永和市,民富里,1660,3,937,16,953,1375,3,1,3,0,1,0,69.31
臺北縣,永和市,民富里,1661,3,678,15,693,1000,3,1,3,0,1,0,69.30
臺北縣,永和市,民樂里,1662,3,1081,17,1098,1523,3,1,3,0,1,0,72.09
臺北縣,永和市,民樂里,1663,3,1271,15,1286,1839,3,1,3,0,1,0,69.93
臺北縣,永和市,民治里,1664,3,895,7,902,1304,3,1,3,0,1,0,69.17
臺北縣,永和市,民治里,1665,3,897,11,908,1306,3,1,3,0,1,0,69.53
臺北縣,永和市,智光里,1666,3,997,9,1006,1476,3,1,3,0,1,0,68.16
臺北縣,永和市,智光里,1667,3,1026,12,1038,1517,3,1,3,0,1,0,68.42
臺北縣,永和市,潭安里,1668,3,913,7,920,1318,3,1,3,0,1,0,69.80
臺北縣,永和市,潭安里,1669,3,807,6,813,1139,3,1,3,0,1,0,71.38
臺北縣,永和市,潭安里,1670,3,762,5,767,1117,3,1,3,0,1,0,68.67
臺北縣,永和市,潭墘里,1671,3,626,3,629,906,3,1,3,0,1,0,69.43
臺北縣,永和市,潭墘里,1672,3,835,13,848,1197,3,1,3,0,1,0,70.84
臺北縣,永和市,潭墘里,1673,3,907,14,921,1307,3,1,3,0,1,0,70.47
臺北縣,永和市,店街里,1674,3,1024,11,1035,1532,3,1,3,0,1,0,67.56
臺北縣,永和市,店街里,1675,3,1092,8,1100,1704,3,1,3,0,1,0,64.55
臺北縣,永和市,大新里,1676,3,736,12,748,1058,3,1,3,0,1,0,70.70
臺北縣,永和市,大新里,1677,3,717,10,727,1031,3,1,3,0,1,0,70.51
臺北縣,永和市,永安里,1678,3,1090,8,1098,1550,3,1,3,0,1,0,70.84
臺北縣,永和市,永安里,1679,3,1248,14,1262,1783,3,1,3,0,1,0,70.78
臺北縣,永和市,永樂里,1680,3,676,7,683,997,3,1,3,0,1,0,68.51
臺北縣,永和市,永樂里,1681,3,664,12,676,972,3,1,3,0,1,0,69.55
臺北縣,永和市,水源里,1682,3,1230,18,1248,1773,3,1,3,0,1,0,70.39
臺北縣,永和市,水源里,1683,3,1147,9,1156,1630,3,1,3,0,1,0,70.92
臺北縣,永和市,協和里,1684,3,872,13,885,1310,3,1,3,0,1,0,67.56
臺北縣,永和市,協和里,1685,3,923,14,937,1336,3,1,3,0,1,0,70.13
臺北縣,永和市,雙和里,1686,3,1236,14,1250,1729,3,1,3,0,1,0,72.30
臺北縣,永和市,雙和里,1687,3,1007,17,1024,1372,3,1,3,0,1,0,74.64
臺北縣,永和市,安和里,1688,3,1108,13,1121,1558,3,1,3,0,1,0,71.95
臺北縣,永和市,安和里,1689,3,1082,13,1095,1492,3,1,3,0,1,0,73.39
臺北縣,永和市,前溪里,1690,3,1136,8,1144,1677,3,1,3,0,1,0,68.22
臺北縣,永和市,和平里,1691,3,1122,15,1137,1614,3,1,3,0,1,0,70.45
臺北縣,永和市,和平里,1692,3,1300,15,1315,1851,3,1,3,0,1,0,71.04
臺北縣,永和市,保平里,1693,3,1323,17,1340,1863,3,1,3,0,1,0,71.93
臺北縣,永和市,保平里,1694,3,1093,17,1110,1516,3,1,3,0,1,0,73.22
臺北縣,永和市,中溪里,1695,3,856,7,863,1231,3,1,3,0,1,0,70.11
臺北縣,永和市,中溪里,1696,3,845,5,850,1200,3,1,3,0,1,0,70.83
臺北縣,永和市,中溪里,1697,3,980,13,993,1389,3,1,3,0,1,0,71.49
臺北縣,永和市,保安里,1698,3,1171,15,1186,1786,3,1,3,0,1,0,66.41
臺北縣,永和市,保安里,1699,3,903,5,908,1221,3,1,3,0,1,0,74.37
臺北縣,永和市,保安里,1700,3,1177,12,1189,1685,3,1,3,0,1,0,70.56
臺北縣,永和市,保順里,1701,3,728,9,737,1112,3,1,3,0,1,0,66.28
臺北縣,永和市,保順里,1702,3,1927,13,1940,2778,3,1,3,0,1,0,69.83
臺北縣,永和市,下溪里,1703,3,1139,20,1159,1554,3,1,3,0,1,0,74.58
臺北縣,永和市,下溪里,1704,3,1189,18,1207,1698,3,1,3,0,1,0,71.08
臺北縣,永和市,大同里,1705,3,702,14,716,956,3,1,3,0,1,0,74.90
臺北縣,永和市,新生里,1706,3,564,12,576,784,3,1,3,0,1,0,73.47
臺北縣,永和市,永成里,1707,3,659,5,664,922,3,1,3,0,1,0,72.02
臺北縣,永和市,忠義里,1708,3,547,9,556,719,3,1,3,0,1,0,77.33
臺北縣,永和市,文化里,1709,3,806,14,820,1105,3,1,3,0,1,0,74.21
臺北縣,永和市,文化里,1710,3,983,12,995,1364,3,1,3,0,1,0,72.95
臺北縣,永和市,仁愛里,1711,3,660,9,669,943,3,1,3,0,1,0,70.94
臺北縣,永和市,仁愛里,1712,3,807,17,824,1182,3,1,3,0,1,0,69.71
臺北縣,永和市,信義里,1713,3,778,9,787,1145,3,1,3,0,1,0,68.73
臺北縣,永和市,信義里,1714,3,720,12,732,1018,3,1,3,0,1,0,71.91
臺北縣,永和市,後溪里,1715,3,1089,16,1105,1573,3,1,3,0,1,0,70.25
臺北縣,永和市,上溪里,1716,3,506,8,514,754,3,1,3,0,1,0,68.17
臺北縣,永和市,上溪里,1717,3,733,10,743,1049,3,1,3,0,1,0,70.83
臺北縣,永和市,頂溪里,1718,3,856,13,869,1184,3,1,3,0,1,0,73.40
臺北縣,永和市,頂溪里,1719,3,743,10,753,1010,3,1,3,0,1,0,74.55
臺北縣,永和市,河堤里,1720,3,644,14,658,917,3,1,3,0,1,0,71.76
臺北縣,永和市,河堤里,1721,3,656,6,662,921,3,1,3,0,1,0,71.88
臺北縣,永和市,新廍里,1722,3,654,12,666,937,3,1,3,0,1,0,71.08
臺北縣,永和市,新廍里,1723,3,848,6,854,1157,3,1,3,0,1,0,73.81
臺北縣,新店市,新店里,1724,3,988,18,1006,1456,3,1,3,0,1,0,69.09
臺北縣,新店市,張南里,1725,3,785,11,796,1155,3,1,3,0,1,0,68.92
臺北縣,新店市,國校里,1726,3,711,6,717,1084,3,1,3,0,1,0,66.14
臺北縣,新店市,國校里,1727,3,587,6,593,890,3,1,3,0,1,0,66.63
臺北縣,新店市,文中里,1728,3,859,5,864,1306,3,1,3,0,1,0,66.16
臺北縣,新店市,廣明里,1729,3,537,6,543,735,3,1,3,0,1,0,73.88
臺北縣,新店市,文明里,1730,3,793,15,808,1047,3,1,3,0,1,0,77.17
臺北縣,新店市,文明里,1731,3,750,5,755,1031,3,1,3,0,1,0,73.23
臺北縣,新店市,中興里,1732,3,936,6,942,1321,3,1,3,0,1,0,71.31
臺北縣,新店市,中興里,1733,3,1094,11,1105,1816,3,1,3,0,1,0,60.85
臺北縣,新店市,中興里,1734,3,878,15,893,1279,3,1,3,0,1,0,69.82
臺北縣,新店市,新生里,1735,3,1064,10,1074,1536,3,1,3,0,1,0,69.92
臺北縣,新店市,新生里,1736,3,923,8,931,1282,3,1,3,0,1,0,72.62
臺北縣,新店市,新生里,1737,3,901,11,912,1278,3,1,3,0,1,0,71.36
臺北縣,新店市,新德里,1738,3,804,11,815,1187,3,1,3,0,1,0,68.66
臺北縣,新店市,新德里,1739,3,766,9,775,1124,3,1,3,0,1,0,68.95
臺北縣,新店市,張北里,1740,3,950,12,962,1447,3,1,3,0,1,0,66.48
臺北縣,新店市,張北里,1741,3,818,16,834,1259,3,1,3,0,1,0,66.24
臺北縣,新店市,張北里,1742,3,867,7,874,1261,3,1,3,0,1,0,69.31
臺北縣,新店市,張北里,1743,3,798,13,811,1171,3,1,3,0,1,0,69.26
臺北縣,新店市,五峰里,1744,3,850,13,863,1207,3,1,3,0,1,0,71.50
臺北縣,新店市,五峰里,1745,3,904,8,912,1344,3,1,3,0,1,0,67.86
臺北縣,新店市,五峰里,1746,3,1273,16,1289,1779,3,1,3,0,1,0,72.46
臺北縣,新店市,五峰里,1747,3,871,10,881,1327,3,1,3,0,1,0,66.39
臺北縣,新店市,長春里,1748,3,734,8,742,997,3,1,3,0,1,0,74.42
臺北縣,新店市,長春里,1749,3,610,6,616,876,3,1,3,0,1,0,70.32
臺北縣,新店市,新安里,1750,3,766,7,773,1099,3,1,3,0,1,0,70.34
臺北縣,新店市,新安里,1751,3,657,7,664,941,3,1,3,0,1,0,70.56
臺北縣,新店市,新安里,1752,3,586,4,590,875,3,1,3,0,1,0,67.43
臺北縣,新店市,忠誠里,1753,3,831,9,840,1147,3,1,3,0,1,0,73.23
臺北縣,新店市,忠誠里,1754,3,775,10,785,1063,3,1,3,0,1,0,73.85
臺北縣,新店市,中正里,1755,3,865,14,879,1198,3,1,3,0,1,0,73.37
臺北縣,新店市,中正里,1756,3,980,5,985,1410,3,1,3,0,1,0,69.86
臺北縣,新店市,中正里,1757,3,1097,16,1113,1676,3,1,3,0,1,0,66.41
臺北縣,新店市,中正里,1758,3,883,8,891,1283,3,1,3,0,1,0,69.45
臺北縣,新店市,中華里,1759,3,723,3,726,1043,3,1,3,0,1,0,69.61
臺北縣,新店市,中華里,1760,3,809,7,816,1146,3,1,3,0,1,0,71.20
臺北縣,新店市,中華里,1761,3,671,12,683,988,3,1,3,0,1,0,69.13
臺北縣,新店市,仁愛里,1762,3,799,5,804,1129,3,1,3,0,1,0,71.21
臺北縣,新店市,仁愛里,1763,3,696,10,706,994,3,1,3,0,1,0,71.03
臺北縣,新店市,建國里,1764,3,722,9,731,1040,3,1,3,0,1,0,70.29
臺北縣,新店市,建國里,1765,3,1002,18,1020,1494,3,1,3,0,1,0,68.27
臺北縣,新店市,百忍里,1766,3,658,10,668,947,3,1,3,0,1,0,70.54
臺北縣,新店市,百忍里,1767,3,818,5,823,1106,3,1,3,0,1,0,74.41
臺北縣,新店市,百忍里,1768,3,881,21,902,1337,3,1,3,0,1,0,67.46
臺北縣,新店市,百和里,1769,3,889,4,893,1254,3,1,3,0,1,0,71.21
臺北縣,新店市,百和里,1770,3,960,8,968,1365,3,1,3,0,1,0,70.92
臺北縣,新店市,福德里,1771,3,919,11,930,1298,3,1,3,0,1,0,71.65
臺北縣,新店市,福德里,1772,3,602,7,609,913,3,1,3,0,1,0,66.70
臺北縣,新店市,福德里,1773,3,704,6,710,999,3,1,3,0,1,0,71.07
臺北縣,新店市,百福里,1774,3,865,9,874,1189,3,1,3,0,1,0,73.51
臺北縣,新店市,百福里,1775,3,946,12,958,1308,3,1,3,0,1,0,73.24
臺北縣,新店市,福民里,1776,3,1056,11,1067,1469,3,1,3,0,1,0,72.63
臺北縣,新店市,福民里,1777,3,1201,14,1215,1743,3,1,3,0,1,0,69.71
臺北縣,新店市,中山里,1778,3,375,3,378,548,3,1,3,0,1,0,68.98
臺北縣,新店市,中山里,1779,3,620,7,627,945,3,1,3,0,1,0,66.35
臺北縣,新店市,和平里,1780,3,566,14,580,804,3,1,3,0,1,0,72.14
臺北縣,新店市,中央里,1781,3,1179,9,1188,1676,3,1,3,0,1,0,70.88
臺北縣,新店市,中央里,1782,3,1032,4,1036,1474,3,1,3,0,1,0,70.28
臺北縣,新店市,國豐里,1784,3,631,8,639,931,3,1,3,0,1,0,68.64
臺北縣,新店市,國豐里,1785,3,724,13,737,1047,3,1,3,0,1,0,70.39
臺北縣,新店市,明德里,1786,3,849,12,861,1205,3,1,3,0,1,0,71.45
臺北縣,新店市,明德里,1787,3,763,6,769,1084,3,1,3,0,1,0,70.94
臺北縣,新店市,明德里,1788,3,852,10,862,1228,3,1,3,0,1,0,70.20
臺北縣,新店市,大豐里,1789,3,1092,8,1100,1567,3,1,3,0,1,0,70.20
臺北縣,新店市,大豐里,1790,3,1066,4,1070,1488,3,1,3,0,1,0,71.91
臺北縣,新店市,大同里,1791,3,1134,15,1149,1568,3,1,3,0,1,0,73.28
臺北縣,新店市,大同里,1792,3,1116,11,1127,1548,3,1,3,0,1,0,72.80
臺北縣,新店市,江陵里,1793,3,740,2,742,1092,3,1,3,0,1,0,67.95
臺北縣,新店市,江陵里,1794,3,865,8,873,1233,3,1,3,0,1,0,70.80
臺北縣,新店市,江陵里,1795,3,767,9,776,1153,3,1,3,0,1,0,67.30
臺北縣,新店市,復興里,1796,3,706,9,715,1092,3,1,3,0,1,0,65.48
臺北縣,新店市,復興里,1797,3,1194,10,1204,1840,3,1,3,0,1,0,65.43
臺北縣,新店市,寶興里,1798,3,771,9,780,1089,3,1,3,0,1,0,71.63
臺北縣,新店市,寶興里,1799,3,862,6,868,1264,3,1,3,0,1,0,68.67
臺北縣,新店市,寶興里,1800,3,770,13,783,1166,3,1,3,0,1,0,67.15
臺北縣,新店市,寶福里,1801,3,763,15,778,1156,3,1,3,0,1,0,67.30
臺北縣,新店市,寶福里,1802,3,861,6,867,1268,3,1,3,0,1,0,68.38
臺北縣,新店市,寶福里,1803,3,973,16,989,1377,3,1,3,0,1,0,71.82
臺北縣,新店市,寶安里,1804,3,1123,12,1135,1663,3,1,3,0,1,0,68.25
臺北縣,新店市,寶安里,1805,3,1127,16,1143,1666,3,1,3,0,1,0,68.61
臺北縣,新店市,寶安里,1806,3,792,6,798,1168,3,1,3,0,1,0,68.32
臺北縣,新店市,信義里,1807,3,1469,18,1487,2141,3,1,3,0,1,0,69.45
臺北縣,新店市,信義里,1808,3,966,11,977,1380,3,1,3,0,1,0,70.80
臺北縣,新店市,信義里,1809,3,954,14,968,1473,3,1,3,0,1,0,65.72
臺北縣,新店市,忠孝里,1810,3,1168,19,1187,1684,3,1,3,0,1,0,70.49
臺北縣,新店市,忠孝里,1811,3,575,5,580,858,3,1,3,0,1,0,67.60
臺北縣,新店市,大鵬里,1812,3,1093,10,1103,1389,3,1,3,0,1,0,79.41
臺北縣,新店市,太平里,1813,3,885,29,914,1328,3,1,3,0,1,0,68.83
臺北縣,新店市,太平里,1814,3,696,11,707,1004,3,1,3,0,1,0,70.42
臺北縣,新店市,美城里,1815,3,631,6,637,888,3,1,3,0,1,0,71.73
臺北縣,新店市,美城里,1816,3,804,17,821,1187,3,1,3,0,1,0,69.17
臺北縣,新店市,頂城里,1817,3,859,13,872,1327,3,1,3,0,1,0,65.71
臺北縣,新店市,下城里,1818,3,1182,29,1211,1710,3,1,3,0,1,0,70.82
臺北縣,新店市,柴埕里,1819,3,898,9,907,1275,3,1,3,0,1,0,71.14
臺北縣,新店市,柴埕里,1820,3,909,19,928,1348,3,1,3,0,1,0,68.84
臺北縣,新店市,柴埕里,1821,3,803,14,817,1252,3,1,3,0,1,0,65.26
臺北縣,新店市,柴埕里,1822,3,1256,17,1273,1836,3,1,3,0,1,0,69.34
臺北縣,新店市,安和里,1823,3,867,10,877,1280,3,1,3,0,1,0,68.52
臺北縣,新店市,安和里,1824,3,859,6,865,1232,3,1,3,0,1,0,70.21
臺北縣,新店市,安和里,1825,3,987,12,999,1473,3,1,3,0,1,0,67.82
臺北縣,新店市,永安里,1826,3,925,17,942,1324,3,1,3,0,1,0,71.15
臺北縣,新店市,永安里,1827,3,876,13,889,1350,3,1,3,0,1,0,65.85
臺北縣,新店市,永安里,1828,3,810,21,831,1183,3,1,3,0,1,0,70.25
臺北縣,新店市,新和里,1829,3,1115,8,1123,1554,3,1,3,0,1,0,72.27
臺北縣,新店市,新和里,1830,3,1058,14,1072,1523,3,1,3,0,1,0,70.39
臺北縣,新店市,永平里,1831,3,660,3,663,1017,3,1,3,0,1,0,65.19
臺北縣,新店市,永平里,1832,3,892,6,898,1263,3,1,3,0,1,0,71.10
臺北縣,新店市,永平里,1833,3,989,15,1004,1440,3,1,3,0,1,0,69.72
臺北縣,新店市,公崙里,1834,3,1143,17,1160,1683,3,1,3,0,1,0,68.92
臺北縣,新店市,公崙里,1835,3,956,13,969,1363,3,1,3,0,1,0,71.09
臺北縣,新店市,公崙里,1836,3,933,13,946,1438,3,1,3,0,1,0,65.79
臺北縣,新店市,公崙里,1837,3,1011,10,1021,1449,3,1,3,0,1,0,70.46
臺北縣,新店市,安昌里,1838,3,1024,9,1033,1485,3,1,3,0,1,0,69.56
臺北縣,新店市,安昌里,1839,3,1072,11,1083,1522,3,1,3,0,1,0,71.16
臺北縣,新店市,德安里,1840,3,977,10,987,1391,3,1,3,0,1,0,70.96
臺北縣,新店市,德安里,1841,3,788,14,802,1142,3,1,3,0,1,0,70.23
臺北縣,新店市,德安里,1842,3,253,4,257,328,3,1,3,0,1,0,78.35
臺北縣,新店市,德安里,1843,3,592,6,598,903,3,1,3,0,1,0,66.22
臺北縣,新店市,德安里,1844,3,1010,6,1016,1506,3,1,3,0,1,0,67.46
臺北縣,新店市,德安里,1845,3,844,16,860,1276,3,1,3,0,1,0,67.40
臺北縣,新店市,明城里,1846,3,897,4,901,1276,3,1,3,0,1,0,70.61
臺北縣,新店市,明城里,1847,3,738,5,743,1067,3,1,3,0,1,0,69.63
臺北縣,新店市,小城里,1848,3,878,7,885,1148,3,1,3,0,1,0,77.09
臺北縣,新店市,小城里,1849,3,1130,10,1140,1592,3,1,3,0,1,0,71.61
臺北縣,新店市,雙城里,1850,3,636,9,645,973,3,1,3,0,1,0,66.29
臺北縣,新店市,雙城里,1851,3,577,8,585,819,3,1,3,0,1,0,71.43
臺北縣,新店市,雙城里,1852,3,839,4,843,1245,3,1,3,0,1,0,67.71
臺北縣,新店市,雙城里,1853,3,978,19,997,1451,3,1,3,0,1,0,68.71
臺北縣,新店市,香坡里,1854,3,1113,11,1124,1678,3,1,3,0,1,0,66.98
臺北縣,新店市,香坡里,1855,3,808,9,817,1303,3,1,3,0,1,0,62.70
臺北縣,新店市,香坡里,1856,3,850,13,863,1355,3,1,3,0,1,0,63.69
臺北縣,新店市,日興里,1857,3,1058,12,1070,1585,3,1,3,0,1,0,67.51
臺北縣,新店市,日興里,1858,3,827,11,838,1239,3,1,3,0,1,0,67.64
臺北縣,新店市,日興里,1859,3,889,9,898,1291,3,1,3,0,1,0,69.56
臺北縣,新店市,玫瑰里,1860,3,1080,8,1088,1507,3,1,3,0,1,0,72.20
臺北縣,新店市,玫瑰里,1861,3,971,13,984,1355,3,1,3,0,1,0,72.62
臺北縣,新店市,玫瑰里,1862,3,887,12,899,1267,3,1,3,0,1,0,70.96
臺北縣,新店市,吉祥里,1863,3,635,7,642,942,3,1,3,0,1,0,68.15
臺北縣,新店市,吉祥里,1864,3,725,8,733,1067,3,1,3,0,1,0,68.70
臺北縣,新店市,吉祥里,1865,3,868,11,879,1233,3,1,3,0,1,0,71.29
臺北縣,新店市,塗潭里,1866,3,448,5,453,688,3,1,3,0,1,0,65.84
臺北縣,新店市,塗潭里,1867,3,673,5,678,1013,3,1,3,0,1,0,66.93
臺北縣,新店市,青潭里,1868,3,1165,16,1181,1718,3,1,3,0,1,0,68.74
臺北縣,新店市,青潭里,1869,3,1091,13,1104,1609,3,1,3,0,1,0,68.61
臺北縣,新店市,美潭里,1870,3,900,13,913,1321,3,1,3,0,1,0,69.11
臺北縣,新店市,美潭里,1871,3,1076,14,1090,1580,3,1,3,0,1,0,68.99
臺北縣,新店市,美潭里,1872,3,692,2,694,967,3,1,3,0,1,0,71.77
臺北縣,新店市,國豐里,1873,3,730,7,737,1036,3,1,3,0,1,0,71.14
臺北縣,新店市,員潭里,1874,3,887,21,908,1405,3,1,3,0,1,0,64.63
臺北縣,新店市,雙坑里,1875,3,482,5,487,787,3,1,3,0,1,0,61.88
臺北縣,新店市,粗坑里,1876,3,269,4,273,371,3,1,3,0,1,0,73.58
臺北縣,新店市,粗坑里,1877,3,1103,14,1117,1696,3,1,3,0,1,0,65.86
臺北縣,新店市,屈尺里,1878,3,678,10,688,992,3,1,3,0,1,0,69.35
臺北縣,新店市,屈尺里,1879,3,796,22,818,1221,3,1,3,0,1,0,66.99
臺北縣,新店市,龜山里,1880,3,845,8,853,1346,3,1,3,0,1,0,63.37
臺北縣,新店市,廣興里,1881,3,721,16,737,1054,3,1,3,0,1,0,69.92
臺北縣,新店市,直潭里,1882,3,273,4,277,418,3,1,3,0,1,0,66.27
臺北縣,新店市,直潭里,1883,3,200,2,202,291,3,1,3,0,1,0,69.42
臺北縣,深坑鄉,萬順村,1884,3,572,13,585,917,3,1,3,0,1,0,63.79
臺北縣,深坑鄉,萬福村,1885,3,593,13,606,899,3,1,3,0,1,0,67.41
臺北縣,深坑鄉,萬福村,1886,3,663,13,676,1021,3,1,3,0,1,0,66.21
臺北縣,深坑鄉,萬福村,1887,3,492,12,504,809,3,1,3,0,1,0,62.30
臺北縣,深坑鄉,土庫村,1888,3,660,8,668,955,3,1,3,0,1,0,69.95
臺北縣,深坑鄉,土庫村,1889,3,600,12,612,913,3,1,3,0,1,0,67.03
臺北縣,深坑鄉,賴仲村,1890,3,930,14,944,1422,3,1,3,0,1,0,66.39
臺北縣,深坑鄉,深坑村,1891,3,782,5,787,1177,3,1,3,0,1,0,66.86
臺北縣,深坑鄉,深坑村,1892,3,732,13,745,1132,3,1,3,0,1,0,65.81
臺北縣,深坑鄉,埔新村,1893,3,740,9,749,1143,3,1,3,0,1,0,65.53
臺北縣,深坑鄉,埔新村,1894,3,757,7,764,1156,3,1,3,0,1,0,66.09
臺北縣,深坑鄉,埔新村,1895,3,791,13,804,1183,3,1,3,0,1,0,67.96
臺北縣,深坑鄉,昇高村,1896,3,979,13,992,1454,3,1,3,0,1,0,68.23
臺北縣,深坑鄉,阿柔村,1897,3,299,6,305,455,3,1,3,0,1,0,67.03
臺北縣,石碇鄉,石碇村,1898,3,292,3,295,398,3,1,3,0,1,0,74.12
臺北縣,石碇鄉,潭邊村,1899,3,425,9,434,663,3,1,3,0,1,0,65.46
臺北縣,石碇鄉,烏塗村,1900,3,413,6,419,591,3,1,3,0,1,0,70.90
臺北縣,石碇鄉,彭山村,1901,3,173,1,174,274,3,1,3,0,1,0,63.50
臺北縣,石碇鄉,豐田村,1902,3,191,4,195,288,3,1,3,0,1,0,67.71
臺北縣,石碇鄉,豐田村,1903,3,94,1,95,123,3,1,3,0,1,0,77.24
臺北縣,石碇鄉,隆盛村,1904,3,456,6,462,713,3,1,3,0,1,0,64.80
臺北縣,石碇鄉,豐林村,1905,3,146,1,147,223,3,1,3,0,1,0,65.92
臺北縣,石碇鄉,中民村,1906,3,517,8,525,759,3,1,3,0,1,0,69.17
臺北縣,石碇鄉,永定村,1907,3,388,6,394,597,3,1,3,0,1,0,66.00
臺北縣,石碇鄉,光明村,1908,3,160,3,163,238,3,1,3,0,1,0,68.49
臺北縣,石碇鄉,永安村,1909,3,259,4,263,416,3,1,3,0,1,0,63.22
臺北縣,石碇鄉,格頭村,1910,3,432,12,444,621,3,1,3,0,1,0,71.50
臺北縣,坪林鄉,坪林村,1911,3,673,12,685,997,3,1,3,0,1,0,68.71
臺北縣,坪林鄉,石曹村,1912,3,232,5,237,357,3,1,3,0,1,0,66.39
臺北縣,坪林鄉,水德村,1913,3,344,8,352,557,3,1,3,0,1,0,63.20
臺北縣,坪林鄉,大林村,1914,3,520,3,523,886,3,1,3,0,1,0,59.03
臺北縣,坪林鄉,粗窟村,1915,3,334,2,336,520,3,1,3,0,1,0,64.62
臺北縣,坪林鄉,粗窟村,1916,3,124,2,126,207,3,1,3,0,1,0,60.87
臺北縣,坪林鄉,上德村,1917,3,202,5,207,296,3,1,3,0,1,0,69.93
臺北縣,坪林鄉,上德村,1918,3,276,4,280,389,3,1,3,0,1,0,71.98
臺北縣,坪林鄉,漁光村,1919,3,193,3,196,321,3,1,3,0,1,0,61.06
臺北縣,坪林鄉,漁光村,1920,3,229,0,229,355,3,1,3,0,1,0,64.51
臺北縣,烏來鄉,忠治村,1921,3,360,4,364,530,3,1,3,0,1,0,68.68
臺北縣,烏來鄉,烏來村,1922,3,697,6,703,1024,3,1,3,0,1,0,68.65
臺北縣,烏來鄉,孝義村,1923,3,89,1,90,110,3,1,3,0,1,0,81.82
臺北縣,烏來鄉,信賢村,1924,3,123,0,123,184,3,1,3,0,1,0,66.85
臺北縣,烏來鄉,福山村,1925,3,49,0,49,65,3,1,3,0,1,0,75.38
臺北縣,汐止鎮,仁德里,1926,3,1070,7,1077,1523,3,1,3,0,1,0,70.72
臺北縣,汐止鎮,義民里,1927,3,799,10,809,1352,3,1,3,0,1,0,59.84
臺北縣,汐止鎮,禮門里,1928,3,603,5,608,949,3,1,3,0,1,0,64.07
臺北縣,汐止鎮,智慧里,1929,3,855,13,868,1393,3,1,3,0,1,0,62.31
臺北縣,汐止鎮,智慧里,1930,3,916,7,923,1395,3,1,3,0,1,0,66.16
臺北縣,汐止鎮,大同里,1932,3,603,9,612,932,3,1,3,0,1,0,65.67
臺北縣,汐止鎮,信望里,1933,3,318,4,322,483,3,1,3,0,1,0,66.67
臺北縣,汐止鎮,新昌里,1934,3,840,16,856,1319,3,1,3,0,1,0,64.90
臺北縣,汐止鎮,新昌里,1935,3,929,14,943,1409,3,1,3,0,1,0,66.93
臺北縣,汐止鎮,新昌里,1936,3,925,5,930,1449,3,1,3,0,1,0,64.18
臺北縣,汐止鎮,福安里,1937,3,1324,14,1338,1990,3,1,3,0,1,0,67.24
臺北縣,汐止鎮,秀峰里,1938,3,546,4,550,821,3,1,3,0,1,0,66.99
臺北縣,汐止鎮,秀峰里,1939,3,593,9,602,955,3,1,3,0,1,0,63.04
臺北縣,汐止鎮,秀峰里,1940,3,635,8,643,953,3,1,3,0,1,0,67.47
臺北縣,汐止鎮,秀山里,1941,3,883,9,892,1263,3,1,3,0,1,0,70.63
臺北縣,汐止鎮,秀山里,1942,3,856,7,863,1298,3,1,3,0,1,0,66.49
臺北縣,汐止鎮,復興里,1943,3,1019,9,1028,1500,3,1,3,0,1,0,68.53
臺北縣,汐止鎮,復興里,1944,3,943,6,949,1385,3,1,3,0,1,0,68.52
臺北縣,汐止鎮,復興里,1945,3,885,6,891,1319,3,1,3,0,1,0,67.55
臺北縣,汐止鎮,自強里,1946,3,1050,13,1063,1594,3,1,3,0,1,0,66.69
臺北縣,汐止鎮,自強里,1947,3,968,19,987,1563,3,1,3,0,1,0,63.15
臺北縣,汐止鎮,文化里,1948,3,832,4,836,1314,3,1,3,0,1,0,63.62
臺北縣,汐止鎮,文化里,1949,3,857,8,865,1276,3,1,3,0,1,0,67.79
臺北縣,汐止鎮,白雲里,1950,3,950,8,958,1516,3,1,3,0,1,0,63.19
臺北縣,汐止鎮,白雲里,1951,3,961,16,977,1458,3,1,3,0,1,0,67.01
臺北縣,汐止鎮,茄苳里,1952,3,841,15,856,1385,3,1,3,0,1,0,61.81
臺北縣,汐止鎮,茄苳里,1953,3,857,20,877,1413,3,1,3,0,1,0,62.07
臺北縣,汐止鎮,崇德里,1954,3,908,9,917,1426,3,1,3,0,1,0,64.31
臺北縣,汐止鎮,崇德里,1955,3,820,19,839,1370,3,1,3,0,1,0,61.24
臺北縣,汐止鎮,橋東里,1956,3,791,6,797,1193,3,1,3,0,1,0,66.81
臺北縣,汐止鎮,橋東里,1957,3,623,6,629,923,3,1,3,0,1,0,68.15
臺北縣,汐止鎮,橋東里,1958,3,926,7,933,1470,3,1,3,0,1,0,63.47
臺北縣,汐止鎮,橋東里,1959,3,827,11,838,1238,3,1,3,0,1,0,67.69
臺北縣,汐止鎮,橋東里,1960,3,933,8,941,1382,3,1,3,0,1,0,68.09
臺北縣,汐止鎮,橋東里,1961,3,788,14,802,1233,3,1,3,0,1,0,65.04
臺北縣,汐止鎮,長安里,1962,3,958,9,967,1442,3,1,3,0,1,0,67.06
臺北縣,汐止鎮,保安里,1963,3,807,8,815,1233,3,1,3,0,1,0,66.10
臺北縣,汐止鎮,東山里,1964,3,308,6,314,461,3,1,3,0,1,0,68.11
臺北縣,汐止鎮,保長里,1965,3,779,12,791,1184,3,1,3,0,1,0,66.81
臺北縣,汐止鎮,保長里,1966,3,691,13,704,1107,3,1,3,0,1,0,63.60
臺北縣,汐止鎮,保長里,1967,3,739,7,746,1185,3,1,3,0,1,0,62.95
臺北縣,汐止鎮,鄉長里,1968,3,1161,19,1180,1678,3,1,3,0,1,0,70.32
臺北縣,汐止鎮,江北里,1969,3,882,10,892,1307,3,1,3,0,1,0,68.25
臺北縣,汐止鎮,江北里,1970,3,743,7,750,1189,3,1,3,0,1,0,63.08
臺北縣,汐止鎮,江北里,1971,3,912,3,915,1465,3,1,3,0,1,0,62.46
臺北縣,汐止鎮,拱北里,1972,3,739,14,753,1264,3,1,3,0,1,0,59.57
臺北縣,汐止鎮,拱北里,1973,3,670,5,675,1139,3,1,3,0,1,0,59.26
臺北縣,汐止鎮,拱北里,1974,3,702,11,713,1142,3,1,3,0,1,0,62.43
臺北縣,汐止鎮,烘內里,1975,3,725,5,730,1148,3,1,3,0,1,0,63.59
臺北縣,汐止鎮,八連里,1976,3,506,14,520,768,3,1,3,0,1,0,67.71
臺北縣,汐止鎮,長青里,1977,3,628,10,638,902,3,1,3,0,1,0,70.73
臺北縣,汐止鎮,北峰里,1978,3,999,19,1018,1502,3,1,3,0,1,0,67.78
臺北縣,汐止鎮,北峰里,1979,3,899,9,908,1433,3,1,3,0,1,0,63.36
臺北縣,汐止鎮,金龍里,1980,3,1031,19,1050,1723,3,1,3,0,1,0,60.94
臺北縣,汐止鎮,金龍里,1981,3,1042,27,1069,1668,3,1,3,0,1,0,64.09
臺北縣,汐止鎮,樟樹里,1982,3,1057,26,1083,1604,3,1,3,0,1,0,67.52
臺北縣,汐止鎮,忠孝里,1983,3,804,19,823,1258,3,1,3,0,1,0,65.42
臺北縣,汐止鎮,忠孝里,1984,3,1098,14,1112,1671,3,1,3,0,1,0,66.55
臺北縣,汐止鎮,忠孝里,1985,3,1061,10,1071,1766,3,1,3,0,1,0,60.65
臺北縣,汐止鎮,厚德里,1986,3,767,9,776,1225,3,1,3,0,1,0,63.35
臺北縣,汐止鎮,厚德里,1987,3,736,15,751,1232,3,1,3,0,1,0,60.96
臺北縣,汐止鎮,厚德里,1988,3,723,5,728,1114,3,1,3,0,1,0,65.35
臺北縣,汐止鎮,山光里,1989,3,864,7,871,1400,3,1,3,0,1,0,62.21
臺北縣,汐止鎮,中興里,1990,3,947,16,963,1652,3,1,3,0,1,0,58.29
臺北縣,汐止鎮,中興里,1991,3,940,13,953,1582,3,1,3,0,1,0,60.24
臺北縣,汐止鎮,中興里,1992,3,912,11,923,1442,3,1,3,0,1,0,64.01
臺北縣,汐止鎮,福德里,1993,3,708,12,720,1091,3,1,3,0,1,0,65.99
臺北縣,汐止鎮,福德里,1994,3,651,13,664,1097,3,1,3,0,1,0,60.53
臺北縣,汐止鎮,興福里,1995,3,649,6,655,1021,3,1,3,0,1,0,64.15
臺北縣,汐止鎮,興福里,1996,3,622,4,626,1013,3,1,3,0,1,0,61.80
臺北縣,汐止鎮,康福里,1997,3,1087,17,1104,1757,3,1,3,0,1,0,62.83
臺北縣,汐止鎮,湖光里,1998,3,1138,14,1152,1754,3,1,3,0,1,0,65.68
臺北縣,汐止鎮,湖光里,1999,3,1037,5,1042,1722,3,1,3,0,1,0,60.51
臺北縣,汐止鎮,湖興里,2000,3,1069,8,1077,1683,3,1,3,0,1,0,63.99
臺北縣,汐止鎮,湖興里,2001,3,1142,12,1154,1710,3,1,3,0,1,0,67.49
臺北縣,汐止鎮,北山里,2002,3,605,4,609,945,3,1,3,0,1,0,64.44
臺北縣,汐止鎮,北山里,2003,3,737,13,750,1189,3,1,3,0,1,0,63.08
臺北縣,汐止鎮,北山里,2004,3,1197,13,1210,1795,3,1,3,0,1,0,67.41
臺北縣,汐止鎮,忠山里,2005,3,850,6,856,1277,3,1,3,0,1,0,67.03
臺北縣,汐止鎮,忠山里,2006,3,747,3,750,1096,3,1,3,0,1,0,68.43
臺北縣,汐止鎮,環河里,2007,3,619,7,626,939,3,1,3,0,1,0,66.67
臺北縣,汐止鎮,橫科里,2008,3,985,16,1001,1429,3,1,3,0,1,0,70.05
臺北縣,汐止鎮,橫科里,2009,3,867,8,875,1296,3,1,3,0,1,0,67.52
臺北縣,汐止鎮,橫科里,2010,3,840,20,860,1280,3,1,3,0,1,0,67.19
臺北縣,汐止鎮,福山里,2011,3,916,11,927,1394,3,1,3,0,1,0,66.50
臺北縣,汐止鎮,福山里,2012,3,915,10,925,1408,3,1,3,0,1,0,65.70
臺北縣,汐止鎮,宜興里,2013,3,841,17,858,1286,3,1,3,0,1,0,66.72
臺北縣,汐止鎮,宜興里,2014,3,703,11,714,1042,3,1,3,0,1,0,68.52
臺北縣,汐止鎮,東勢里,2015,3,672,11,683,1005,3,1,3,0,1,0,67.96
臺北縣,汐止鎮,東勢里,2016,3,899,4,903,1286,3,1,3,0,1,0,70.22
臺北縣,瑞芳鎮,龍潭里,2017,3,554,7,561,775,3,1,3,0,1,0,72.39
臺北縣,瑞芳鎮,龍興里,2018,3,648,8,656,914,3,1,3,0,1,0,71.77
臺北縣,瑞芳鎮,龍興里,2019,3,581,7,588,780,3,1,3,0,1,0,75.38
臺北縣,瑞芳鎮,龍鎮里,2020,3,921,11,932,1298,3,1,3,0,1,0,71.80
臺北縣,瑞芳鎮,龍安里,2021,3,410,9,419,585,3,1,3,0,1,0,71.62
臺北縣,瑞芳鎮,龍川里,2022,3,542,10,552,805,3,1,3,0,1,0,68.57
臺北縣,瑞芳鎮,龍川里,2023,3,463,5,468,726,3,1,3,0,1,0,64.46
臺北縣,瑞芳鎮,龍山里,2024,3,851,15,866,1296,3,1,3,0,1,0,66.82
臺北縣,瑞芳鎮,爪峰里,2025,3,1047,15,1062,1548,3,1,3,0,1,0,68.60
臺北縣,瑞芳鎮,爪峰里,2026,3,739,9,748,1125,3,1,3,0,1,0,66.49
臺北縣,瑞芳鎮,爪峰里,2027,3,728,2,730,1039,3,1,3,0,1,0,70.26
臺北縣,瑞芳鎮,新峰里,2028,3,739,5,744,1036,3,1,3,0,1,0,71.81
臺北縣,瑞芳鎮,新峰里,2029,3,813,12,825,1291,3,1,3,0,1,0,63.90
臺北縣,瑞芳鎮,東和里,2030,3,789,8,797,1164,3,1,3,0,1,0,68.47
臺北縣,瑞芳鎮,東和里,2031,3,516,6,522,765,3,1,3,0,1,0,68.24
臺北縣,瑞芳鎮,柑坪里,2032,3,755,28,783,1126,3,1,3,0,1,0,69.54
臺北縣,瑞芳鎮,弓橋里,2033,3,186,2,188,285,3,1,3,0,1,0,65.96
臺北縣,瑞芳鎮,侯硐里,2034,3,365,4,369,508,3,1,3,0,1,0,72.64
臺北縣,瑞芳鎮,光復里,2035,3,243,4,247,362,3,1,3,0,1,0,68.23
臺北縣,瑞芳鎮,碩仁里,2036,3,108,0,108,155,3,1,3,0,1,0,69.68
臺北縣,瑞芳鎮,吉慶里,2037,3,584,11,595,836,3,1,3,0,1,0,71.17
臺北縣,瑞芳鎮,吉慶里,2038,3,512,4,516,773,3,1,3,0,1,0,66.75
臺北縣,瑞芳鎮,吉安里,2039,3,593,20,613,953,3,1,3,0,1,0,64.32
臺北縣,瑞芳鎮,吉安里,2040,3,489,11,500,815,3,1,3,0,1,0,61.35
臺北縣,瑞芳鎮,吉安里,2041,3,644,20,664,1047,3,1,3,0,1,0,63.42
臺北縣,瑞芳鎮,上天里,2042,3,458,7,465,654,3,1,3,0,1,0,71.10
臺北縣,瑞芳鎮,上天里,2043,3,379,7,386,610,3,1,3,0,1,0,63.28
臺北縣,瑞芳鎮,傑魚里,2044,3,615,10,625,975,3,1,3,0,1,0,64.10
臺北縣,瑞芳鎮,傑魚里,2045,3,576,9,585,835,3,1,3,0,1,0,70.06
臺北縣,瑞芳鎮,基山里,2046,3,365,7,372,586,3,1,3,0,1,0,63.48
臺北縣,瑞芳鎮,永慶里,2047,3,351,4,355,594,3,1,3,0,1,0,59.76
臺北縣,瑞芳鎮,崇文里,2048,3,238,2,240,417,3,1,3,0,1,0,57.55
臺北縣,瑞芳鎮,福住里,2049,3,166,2,168,265,3,1,3,0,1,0,63.40
臺北縣,瑞芳鎮,頌德里,2050,3,246,2,248,409,3,1,3,0,1,0,60.64
臺北縣,瑞芳鎮,瓜山里,2051,3,185,7,192,284,3,1,3,0,1,0,67.61
臺北縣,瑞芳鎮,銅山里,2052,3,189,2,191,272,3,1,3,0,1,0,70.22
臺北縣,瑞芳鎮,新山里,2053,3,298,5,303,426,3,1,3,0,1,0,71.13
臺北縣,瑞芳鎮,石山里,2054,3,276,4,280,431,3,1,3,0,1,0,64.97
臺北縣,瑞芳鎮,濂洞里,2055,3,423,9,432,607,3,1,3,0,1,0,71.17
臺北縣,瑞芳鎮,濂新里,2056,3,197,1,198,319,3,1,3,0,1,0,62.07
臺北縣,瑞芳鎮,南雅里,2057,3,126,1,127,200,3,1,3,0,1,0,63.50
臺北縣,瑞芳鎮,鼻頭里,2058,3,322,7,329,509,3,1,3,0,1,0,64.64
臺北縣,瑞芳鎮,海濱里,2059,3,572,12,584,866,3,1,3,0,1,0,67.44
臺北縣,瑞芳鎮,瑞濱里,2060,3,495,9,504,751,3,1,3,0,1,0,67.11
臺北縣,瑞芳鎮,瑞濱里,2061,3,546,8,554,789,3,1,3,0,1,0,70.22
臺北縣,瑞芳鎮,深澳里,2062,3,622,10,632,967,3,1,3,0,1,0,65.36
臺北縣,平溪鄉,薯榔村,2063,3,293,4,297,438,3,1,3,0,1,0,67.81
臺北縣,平溪鄉,菁桐村,2064,3,222,4,226,320,3,1,3,0,1,0,70.63
臺北縣,平溪鄉,白石村,2065,3,219,6,225,311,3,1,3,0,1,0,72.35
臺北縣,平溪鄉,石底村,2066,3,373,4,377,562,3,1,3,0,1,0,67.08
臺北縣,平溪鄉,平溪村,2067,3,175,3,178,282,3,1,3,0,1,0,63.12
臺北縣,平溪鄉,嶺腳村,2068,3,469,11,480,703,3,1,3,0,1,0,68.28
臺北縣,平溪鄉,東勢村,2069,3,244,3,247,390,3,1,3,0,1,0,63.33
臺北縣,平溪鄉,十分村,2070,3,655,11,666,1027,3,1,3,0,1,0,64.85
臺北縣,平溪鄉,望古村,2071,3,73,3,76,149,3,1,3,0,1,0,51.01
臺北縣,平溪鄉,南山村,2072,3,310,4,314,506,3,1,3,0,1,0,62.06
臺北縣,平溪鄉,新寮村,2073,3,118,3,121,185,3,1,3,0,1,0,65.41
臺北縣,平溪鄉,平湖村,2074,3,99,3,102,164,3,1,3,0,1,0,62.20
臺北縣,雙溪鄉,雙溪村,2075,3,373,4,377,574,3,1,3,0,1,0,65.68
臺北縣,雙溪鄉,新基村,2076,3,193,1,194,298,3,1,3,0,1,0,65.10
臺北縣,雙溪鄉,新基村,2077,3,448,4,452,633,3,1,3,0,1,0,71.41
臺北縣,雙溪鄉,三港村,2078,3,293,2,295,454,3,1,3,0,1,0,64.98
臺北縣,雙溪鄉,牡丹村,2079,3,720,13,733,1091,3,1,3,0,1,0,67.19
臺北縣,雙溪鄉,牡丹村,2080,3,547,8,555,767,3,1,3,0,1,0,72.36
臺北縣,雙溪鄉,三貂村,2081,3,251,2,253,357,3,1,3,0,1,0,70.87
臺北縣,雙溪鄉,平林村,2082,3,420,6,426,647,3,1,3,0,1,0,65.84
臺北縣,雙溪鄉,平林村,2083,3,161,1,162,277,3,1,3,0,1,0,58.48
臺北縣,雙溪鄉,上林村,2084,3,464,7,471,721,3,1,3,0,1,0,65.33
臺北縣,雙溪鄉,外柑村,2085,3,332,0,332,511,3,1,3,0,1,0,64.97
臺北縣,雙溪鄉,長源村,2086,3,270,2,272,407,3,1,3,0,1,0,66.83
臺北縣,雙溪鄉,共和村,2087,3,107,1,108,147,3,1,3,0,1,0,73.47
臺北縣,雙溪鄉,共和村,2088,3,216,2,218,323,3,1,3,0,1,0,67.49
臺北縣,雙溪鄉,魚行村,2089,3,242,3,245,339,3,1,3,0,1,0,72.27
臺北縣,雙溪鄉,魚行村,2090,3,246,0,246,363,3,1,3,0,1,0,67.77
臺北縣,雙溪鄉,泰平村,2091,3,184,0,184,339,3,1,3,0,1,0,54.28
臺北縣,雙溪鄉,泰平村,2092,3,76,0,76,136,3,1,3,0,1,0,55.88
臺北縣,貢寮鄉,貢寮村,2093,3,575,9,584,919,3,1,3,0,1,0,63.55
臺北縣,貢寮鄉,龍崗村,2094,3,263,1,264,428,3,1,3,0,1,0,61.68
臺北縣,貢寮鄉,吉林村,2095,3,312,7,319,477,3,1,3,0,1,0,66.88
臺北縣,貢寮鄉,雙玉村,2096,3,273,3,276,442,3,1,3,0,1,0,62.44
臺北縣,貢寮鄉,雙玉村,2097,3,213,5,218,350,3,1,3,0,1,0,62.29
臺北縣,貢寮鄉,福隆村,2098,3,611,15,626,962,3,1,3,0,1,0,65.07
臺北縣,貢寮鄉,福隆村,2099,3,380,5,385,600,3,1,3,0,1,0,64.17
臺北縣,貢寮鄉,福連村,2100,3,443,9,452,788,3,1,3,0,1,0,57.36
臺北縣,貢寮鄉,龍門村,2101,3,415,1,416,644,3,1,3,0,1,0,64.60
臺北縣,貢寮鄉,仁里村,2102,3,1016,13,1029,1549,3,1,3,0,1,0,66.43
臺北縣,貢寮鄉,真理村,2103,3,678,5,683,1084,3,1,3,0,1,0,63.01
臺北縣,貢寮鄉,真理村,2104,3,444,6,450,762,3,1,3,0,1,0,59.06
臺北縣,貢寮鄉,美豐村,2105,3,231,2,233,375,3,1,3,0,1,0,62.13
臺北縣,貢寮鄉,美豐村,2106,3,258,4,262,408,3,1,3,0,1,0,64.22
臺北縣,貢寮鄉,和美村,2107,3,294,8,302,449,3,1,3,0,1,0,67.26
臺北縣,貢寮鄉,和美村,2108,3,283,5,288,445,3,1,3,0,1,0,64.72
宜蘭縣,宜蘭市,南門里,1,1,378,3,381,632,3,1,3,0,1,0,60.28
宜蘭縣,宜蘭市,負郭里,2,1,503,7,510,728,3,1,3,0,1,0,70.05
宜蘭縣,宜蘭市,負郭里,3,1,899,12,911,1379,3,1,3,0,1,0,66.06
宜蘭縣,宜蘭市,民族里,4,1,727,11,738,1136,3,1,3,0,1,0,64.96
宜蘭縣,宜蘭市,民族里,5,1,717,12,729,1102,3,1,3,0,1,0,66.15
宜蘭縣,宜蘭市,建軍里,6,1,725,7,732,1172,3,1,3,0,1,0,62.46
宜蘭縣,宜蘭市,建軍里,7,1,702,11,713,1181,3,1,3,0,1,0,60.37
宜蘭縣,宜蘭市,復興里,8,1,653,16,669,996,3,1,3,0,1,0,67.17
宜蘭縣,宜蘭市,復興里,9,1,506,5,511,755,3,1,3,0,1,0,67.68
宜蘭縣,宜蘭市,復興里,10,1,643,5,648,1027,3,1,3,0,1,0,63.10
宜蘭縣,宜蘭市,思源里,11,1,947,9,956,1537,3,1,3,0,1,0,62.20
宜蘭縣,宜蘭市,思源里,12,1,945,3,948,1487,3,1,3,0,1,0,63.75
宜蘭縣,宜蘭市,思源里,13,1,689,9,698,1044,3,1,3,0,1,0,66.86
宜蘭縣,宜蘭市,文化里,14,1,746,11,757,1136,3,1,3,0,1,0,66.64
宜蘭縣,宜蘭市,文化里,15,1,924,3,927,1470,3,1,3,0,1,0,63.06
宜蘭縣,宜蘭市,神農里,16,1,439,4,443,675,3,1,3,0,1,0,65.63
宜蘭縣,宜蘭市,民生里,17,1,290,4,294,457,3,1,3,0,1,0,64.33
宜蘭縣,宜蘭市,昇平里,18,1,476,3,479,693,3,1,3,0,1,0,69.12
宜蘭縣,宜蘭市,大東里,19,1,355,6,361,577,3,1,3,0,1,0,62.56
宜蘭縣,宜蘭市,新興里,20,1,375,2,377,598,3,1,3,0,1,0,63.04
宜蘭縣,宜蘭市,和睦里,21,1,486,8,494,762,3,1,3,0,1,0,64.83
宜蘭縣,宜蘭市,和睦里,22,1,814,8,822,1278,3,1,3,0,1,0,64.32
宜蘭縣,宜蘭市,民權里,23,1,390,5,395,608,3,1,3,0,1,0,64.97
宜蘭縣,宜蘭市,民權里,24,1,530,14,544,878,3,1,3,0,1,0,61.96
宜蘭縣,宜蘭市,進士里,25,1,790,2,792,1197,3,1,3,0,1,0,66.17
宜蘭縣,宜蘭市,進士里,26,1,835,6,841,1345,3,1,3,0,1,0,62.53
宜蘭縣,宜蘭市,進士里,27,1,410,7,417,632,3,1,3,0,1,0,65.98
宜蘭縣,宜蘭市,進士里,28,1,847,4,851,1268,3,1,3,0,1,0,67.11
宜蘭縣,宜蘭市,南橋里,29,1,438,2,440,630,3,1,3,0,1,0,69.84
宜蘭縣,宜蘭市,建業里,30,1,579,8,587,992,3,1,3,0,1,0,59.17
宜蘭縣,宜蘭市,南津里,31,1,473,3,476,771,3,1,3,0,1,0,61.74
宜蘭縣,宜蘭市,凱旋里,32,1,674,4,678,1108,3,1,3,0,1,0,61.19
宜蘭縣,宜蘭市,黎明里,33,1,794,5,799,1243,3,1,3,0,1,0,64.28
宜蘭縣,宜蘭市,東村里,34,1,595,2,597,956,3,1,3,0,1,0,62.45
宜蘭縣,宜蘭市,東村里,35,1,748,3,751,1159,3,1,3,0,1,0,64.80
宜蘭縣,宜蘭市,東村里,36,1,842,13,855,1320,3,1,3,0,1,0,64.77
宜蘭縣,宜蘭市,延平里,37,1,630,9,639,969,3,1,3,0,1,0,65.94
宜蘭縣,宜蘭市,延平里,38,1,843,21,864,1389,3,1,3,0,1,0,62.20
宜蘭縣,宜蘭市,延平里,39,1,696,13,709,1112,3,1,3,0,1,0,63.76
宜蘭縣,宜蘭市,七張里,40,1,734,5,739,1157,3,1,3,0,1,0,63.87
宜蘭縣,宜蘭市,慈安里,41,1,753,9,762,1210,3,1,3,0,1,0,62.98
宜蘭縣,宜蘭市,慈安里,42,1,808,14,822,1300,3,1,3,0,1,0,63.23
宜蘭縣,宜蘭市,慈安里,43,1,847,11,858,1395,3,1,3,0,1,0,61.51
宜蘭縣,宜蘭市,新民里,44,1,415,8,423,641,3,1,3,0,1,0,65.99
宜蘭縣,宜蘭市,東門里,45,1,363,1,364,558,3,1,3,0,1,0,65.23
宜蘭縣,宜蘭市,中正里,46,1,392,7,399,631,3,1,3,0,1,0,63.23
宜蘭縣,宜蘭市,小東里,47,1,815,1,816,1273,3,1,3,0,1,0,64.10
宜蘭縣,宜蘭市,菜園里,48,1,847,6,853,1316,3,1,3,0,1,0,64.82
宜蘭縣,宜蘭市,孝廉里,49,1,656,5,661,1054,3,1,3,0,1,0,62.71
宜蘭縣,宜蘭市,新生里,50,1,813,2,815,1305,3,1,3,0,1,0,62.45
宜蘭縣,宜蘭市,新生里,51,1,534,9,543,819,3,1,3,0,1,0,66.30
宜蘭縣,宜蘭市,茭白里,52,1,1058,4,1062,1732,3,1,3,0,1,0,61.32
宜蘭縣,宜蘭市,北津里,53,1,909,4,913,1436,3,1,3,0,1,0,63.58
宜蘭縣,宜蘭市,梅洲里,54,1,900,8,908,1365,3,1,3,0,1,0,66.52
宜蘭縣,宜蘭市,梅洲里,55,1,668,9,677,1122,3,1,3,0,1,0,60.34
宜蘭縣,宜蘭市,北門里,56,1,572,4,576,898,3,1,3,0,1,0,64.14
宜蘭縣,宜蘭市,慶和里,57,1,483,11,494,744,3,1,3,0,1,0,66.40
宜蘭縣,宜蘭市,鄂王里,58,1,488,4,492,802,3,1,3,0,1,0,61.35
宜蘭縣,宜蘭市,西門里,59,1,827,16,843,1284,3,1,3,0,1,0,65.65
宜蘭縣,宜蘭市,中山里,60,1,508,9,517,803,3,1,3,0,1,0,64.38
宜蘭縣,宜蘭市,大道里,61,1,819,8,827,1301,3,1,3,0,1,0,63.57
宜蘭縣,羅東鎮,開羅里,62,1,316,4,320,515,3,1,3,0,1,0,62.14
宜蘭縣,羅東鎮,開元里,63,1,351,5,356,521,3,1,3,0,1,0,68.33
宜蘭縣,羅東鎮,東明里,64,1,307,3,310,498,3,1,3,0,1,0,62.25
宜蘭縣,羅東鎮,大新里,65,1,782,3,785,1227,3,1,3,0,1,0,63.98
宜蘭縣,羅東鎮,東安里,66,1,525,6,531,793,3,1,3,0,1,0,66.96
宜蘭縣,羅東鎮,東安里,67,1,765,9,774,1322,3,1,3,0,1,0,58.55
宜蘭縣,羅東鎮,新群里,68,1,700,6,706,1033,3,1,3,0,1,0,68.34
宜蘭縣,羅東鎮,新群里,69,1,548,6,554,915,3,1,3,0,1,0,60.55
宜蘭縣,羅東鎮,羅莊里,70,1,592,10,602,972,3,1,3,0,1,0,61.93
宜蘭縣,羅東鎮,羅莊里,71,1,566,8,574,941,3,1,3,0,1,0,61.00
宜蘭縣,羅東鎮,南昌里,72,1,788,12,800,1283,3,1,3,0,1,0,62.35
宜蘭縣,羅東鎮,南昌里,73,1,555,7,562,892,3,1,3,0,1,0,63.00
宜蘭縣,羅東鎮,南豪里,74,1,902,7,909,1339,3,1,3,0,1,0,67.89
宜蘭縣,羅東鎮,成功里,75,1,778,12,790,1177,3,1,3,0,1,0,67.12
宜蘭縣,羅東鎮,仁德里,76,1,547,3,550,876,3,1,3,0,1,0,62.79
宜蘭縣,羅東鎮,居仁里,77,1,439,4,443,715,3,1,3,0,1,0,61.96
宜蘭縣,羅東鎮,義和里,78,1,545,5,550,878,3,1,3,0,1,0,62.64
宜蘭縣,羅東鎮,羅東里,79,1,411,4,415,613,3,1,3,0,1,0,67.70
宜蘭縣,羅東鎮,浮崙里,80,1,454,2,456,723,3,1,3,0,1,0,63.07
宜蘭縣,羅東鎮,漢民里,81,1,720,5,725,1085,3,1,3,0,1,0,66.82
宜蘭縣,羅東鎮,漢民里,82,1,877,5,882,1417,3,1,3,0,1,0,62.24
宜蘭縣,羅東鎮,漢民里,83,1,680,5,685,1038,3,1,3,0,1,0,65.99
宜蘭縣,羅東鎮,西安里,84,1,596,5,601,974,3,1,3,0,1,0,61.70
宜蘭縣,羅東鎮,西安里,85,1,889,5,894,1359,3,1,3,0,1,0,65.78
宜蘭縣,羅東鎮,西安里,86,1,628,10,638,1021,3,1,3,0,1,0,62.49
宜蘭縣,羅東鎮,西安里,87,1,801,13,814,1292,3,1,3,0,1,0,63.00
宜蘭縣,羅東鎮,北成里,88,1,810,7,817,1267,3,1,3,0,1,0,64.48
宜蘭縣,羅東鎮,北成里,89,1,730,8,738,1174,3,1,3,0,1,0,62.86
宜蘭縣,羅東鎮,北成里,90,1,872,8,880,1355,3,1,3,0,1,0,64.94
宜蘭縣,羅東鎮,北成里,91,1,797,9,806,1265,3,1,3,0,1,0,63.72
宜蘭縣,羅東鎮,賢文里,92,1,826,5,831,1353,3,1,3,0,1,0,61.42
宜蘭縣,羅東鎮,賢文里,93,1,623,8,631,1022,3,1,3,0,1,0,61.74
宜蘭縣,羅東鎮,賢文里,94,1,632,3,635,974,3,1,3,0,1,0,65.20
宜蘭縣,羅東鎮,公正里,95,1,606,6,612,970,3,1,3,0,1,0,63.09
宜蘭縣,羅東鎮,公正里,96,1,521,7,528,833,3,1,3,0,1,0,63.39
宜蘭縣,羅東鎮,集祥里,97,1,607,6,613,1001,3,1,3,0,1,0,61.24
宜蘭縣,羅東鎮,信義里,98,1,863,6,869,1438,3,1,3,0,1,0,60.43
宜蘭縣,羅東鎮,信義里,99,1,880,5,885,1427,3,1,3,0,1,0,62.02
宜蘭縣,羅東鎮,樹林里,100,1,688,4,692,1069,3,1,3,0,1,0,64.73
宜蘭縣,羅東鎮,樹林里,101,1,692,7,699,1102,3,1,3,0,1,0,63.43
宜蘭縣,羅東鎮,樹林里,102,1,692,6,698,1119,3,1,3,0,1,0,62.38
宜蘭縣,羅東鎮,竹林里,103,1,853,9,862,1356,3,1,3,0,1,0,63.57
宜蘭縣,羅東鎮,竹林里,104,1,726,10,736,1183,3,1,3,0,1,0,62.21
宜蘭縣,羅東鎮,仁愛里,105,1,762,9,771,1268,3,1,3,0,1,0,60.80
宜蘭縣,羅東鎮,仁愛里,106,1,741,7,748,1099,3,1,3,0,1,0,68.06
宜蘭縣,蘇澳鎮,龍德里,107,1,432,4,436,670,3,1,3,0,1,0,65.07
宜蘭縣,蘇澳鎮,龍德里,108,1,708,6,714,1190,3,1,3,0,1,0,60.00
宜蘭縣,蘇澳鎮,龍德里,109,1,707,3,710,1105,3,1,3,0,1,0,64.25
宜蘭縣,蘇澳鎮,頂寮里,110,1,512,2,514,757,3,1,3,0,1,0,67.90
宜蘭縣,蘇澳鎮,永榮里,111,1,619,7,626,1017,3,1,3,0,1,0,61.55
宜蘭縣,蘇澳鎮,永榮里,112,1,652,7,659,1003,3,1,3,0,1,0,65.70
宜蘭縣,蘇澳鎮,永榮里,113,1,604,6,610,905,3,1,3,0,1,0,67.40
宜蘭縣,蘇澳鎮,存仁里,114,1,421,1,422,627,3,1,3,0,1,0,67.30
宜蘭縣,蘇澳鎮,存仁里,115,1,273,1,274,383,3,1,3,0,1,0,71.54
宜蘭縣,蘇澳鎮,港邊里,116,1,506,3,509,791,3,1,3,0,1,0,64.35
宜蘭縣,蘇澳鎮,港邊里,117,1,277,2,279,446,3,1,3,0,1,0,62.56
宜蘭縣,蘇澳鎮,岳明里,118,1,173,5,178,305,3,1,3,0,1,0,58.36
宜蘭縣,蘇澳鎮,隘丁里,119,1,663,5,668,1024,3,1,3,0,1,0,65.23
宜蘭縣,蘇澳鎮,隘丁里,120,1,626,5,631,1046,3,1,3,0,1,0,60.33
宜蘭縣,蘇澳鎮,新城里,121,1,689,6,695,1102,3,1,3,0,1,0,63.07
宜蘭縣,蘇澳鎮,聖湖里,122,1,804,12,816,1346,3,1,3,0,1,0,60.62
宜蘭縣,蘇澳鎮,聖湖里,123,1,777,11,788,1268,3,1,3,0,1,0,62.15
宜蘭縣,蘇澳鎮,聖湖里,124,1,572,5,577,968,3,1,3,0,1,0,59.61
宜蘭縣,蘇澳鎮,聖湖里,125,1,741,5,746,1281,3,1,3,0,1,0,58.24
宜蘭縣,蘇澳鎮,蘇西里,126,1,707,3,710,1134,3,1,3,0,1,0,62.61
宜蘭縣,蘇澳鎮,蘇西里,127,1,710,7,717,1096,3,1,3,0,1,0,65.42
宜蘭縣,蘇澳鎮,蘇北里,128,1,776,12,788,1229,3,1,3,0,1,0,64.12
宜蘭縣,蘇澳鎮,蘇南里,129,1,376,4,380,552,3,1,3,0,1,0,68.84
宜蘭縣,蘇澳鎮,蘇東里,130,1,297,2,299,511,3,1,3,0,1,0,58.51
宜蘭縣,蘇澳鎮,長安里,131,1,395,2,397,603,3,1,3,0,1,0,65.84
宜蘭縣,蘇澳鎮,永光里,132,1,373,3,376,570,3,1,3,0,1,0,65.96
宜蘭縣,蘇澳鎮,永春里,133,1,377,4,381,632,3,1,3,0,1,0,60.28
宜蘭縣,蘇澳鎮,永樂里,134,1,372,3,375,536,3,1,3,0,1,0,69.96
宜蘭縣,蘇澳鎮,南安里,135,1,715,10,725,1112,3,1,3,0,1,0,65.20
宜蘭縣,蘇澳鎮,南正里,136,1,626,6,632,1035,3,1,3,0,1,0,61.06
宜蘭縣,蘇澳鎮,南成里,137,1,745,5,750,1250,3,1,3,0,1,0,60.00
宜蘭縣,蘇澳鎮,南興里,138,1,483,2,485,860,3,1,3,0,1,0,56.40
宜蘭縣,蘇澳鎮,南興里,139,1,432,8,440,814,3,1,3,0,1,0,54.05
宜蘭縣,蘇澳鎮,南寧里,140,1,674,10,684,1160,3,1,3,0,1,0,58.97
宜蘭縣,蘇澳鎮,南建里,141,1,770,8,778,1335,3,1,3,0,1,0,58.28
宜蘭縣,蘇澳鎮,東澳里,142,1,187,2,189,333,3,1,3,0,1,0,56.76
宜蘭縣,蘇澳鎮,南強里,143,1,448,9,457,816,3,1,3,0,1,0,56.00
宜蘭縣,蘇澳鎮,朝陽里,144,1,262,6,268,481,3,1,3,0,1,0,55.72
宜蘭縣,蘇澳鎮,朝陽里,145,1,165,1,166,267,3,1,3,0,1,0,62.17
宜蘭縣,頭城鎮,石城里,146,1,212,2,214,382,3,1,3,0,1,0,56.02
宜蘭縣,頭城鎮,大里里,147,1,384,7,391,709,3,1,3,0,1,0,55.15
宜蘭縣,頭城鎮,龜山里,148,1,343,9,352,622,3,1,3,0,1,0,56.59
宜蘭縣,頭城鎮,大溪里,149,1,520,4,524,930,3,1,3,0,1,0,56.34
宜蘭縣,頭城鎮,合興里,150,1,230,3,233,401,3,1,3,0,1,0,58.10
宜蘭縣,頭城鎮,更新里,151,1,939,9,948,1374,3,1,3,0,1,0,69.00
宜蘭縣,頭城鎮,外澳里,152,1,531,12,543,874,3,1,3,0,1,0,62.13
宜蘭縣,頭城鎮,港口里,153,1,427,3,430,628,3,1,3,0,1,0,68.47
宜蘭縣,頭城鎮,武營里,154,1,931,11,942,1411,3,1,3,0,1,0,66.76
宜蘭縣,頭城鎮,大坑里,155,1,753,12,765,1148,3,1,3,0,1,0,66.64
宜蘭縣,頭城鎮,城東里,156,1,522,7,529,759,3,1,3,0,1,0,69.70
宜蘭縣,頭城鎮,城北里,157,1,375,5,380,558,3,1,3,0,1,0,68.10
宜蘭縣,頭城鎮,城西里,158,1,462,4,466,652,3,1,3,0,1,0,71.47
宜蘭縣,頭城鎮,城南里,159,1,403,1,404,607,3,1,3,0,1,0,66.56
宜蘭縣,頭城鎮,竹安里,160,1,565,5,570,950,3,1,3,0,1,0,60.00
宜蘭縣,頭城鎮,竹安里,161,1,595,7,602,969,3,1,3,0,1,0,62.13
宜蘭縣,頭城鎮,新建里,162,1,494,16,510,796,3,1,3,0,1,0,64.07
宜蘭縣,頭城鎮,新建里,163,1,630,0,630,983,3,1,3,0,1,0,64.09
宜蘭縣,頭城鎮,拔雅里,164,1,859,7,866,1362,3,1,3,0,1,0,63.58
宜蘭縣,頭城鎮,福成里,165,1,633,9,642,962,3,1,3,0,1,0,66.74
宜蘭縣,頭城鎮,金面里,166,1,1002,9,1011,1625,3,1,3,0,1,0,62.22
宜蘭縣,頭城鎮,金盈里,167,1,405,5,410,685,3,1,3,0,1,0,59.85
宜蘭縣,頭城鎮,頂埔里,168,1,861,10,871,1270,3,1,3,0,1,0,68.58
宜蘭縣,頭城鎮,下埔里,169,1,642,4,646,940,3,1,3,0,1,0,68.72
宜蘭縣,頭城鎮,中崙里,170,1,639,5,644,962,3,1,3,0,1,0,66.94
宜蘭縣,頭城鎮,二城里,171,1,661,11,672,1053,3,1,3,0,1,0,63.82
宜蘭縣,礁溪鄉,白雲村,172,1,849,12,861,1410,3,1,3,0,1,0,61.06
宜蘭縣,礁溪鄉,玉石村,173,1,1049,10,1059,1664,3,1,3,0,1,0,63.64
宜蘭縣,礁溪鄉,德陽村,174,1,1051,7,1058,1674,3,1,3,0,1,0,63.20
宜蘭縣,礁溪鄉,德陽村,175,1,1070,9,1079,1740,3,1,3,0,1,0,62.01
宜蘭縣,礁溪鄉,大忠村,176,1,838,5,843,1326,3,1,3,0,1,0,63.57
宜蘭縣,礁溪鄉,大忠村,177,1,553,1,554,792,3,1,3,0,1,0,69.95
宜蘭縣,礁溪鄉,大義村,178,1,464,6,470,674,3,1,3,0,1,0,69.73
宜蘭縣,礁溪鄉,六結村,179,1,930,4,934,1383,3,1,3,0,1,0,67.53
宜蘭縣,礁溪鄉,二龍村,180,1,710,8,718,1094,3,1,3,0,1,0,65.63
宜蘭縣,礁溪鄉,時潮村,181,1,865,10,875,1337,3,1,3,0,1,0,65.45
宜蘭縣,礁溪鄉,玉田村,182,1,519,5,524,848,3,1,3,0,1,0,61.79
宜蘭縣,礁溪鄉,玉田村,183,1,665,11,676,1032,3,1,3,0,1,0,65.50
宜蘭縣,礁溪鄉,三民村,184,1,900,7,907,1393,3,1,3,0,1,0,65.11
宜蘭縣,礁溪鄉,三民村,185,1,536,8,544,882,3,1,3,0,1,0,61.68
宜蘭縣,礁溪鄉,林美村,186,1,695,8,703,1050,3,1,3,0,1,0,66.95
宜蘭縣,礁溪鄉,白鵝村,187,1,477,3,480,730,3,1,3,0,1,0,65.75
宜蘭縣,礁溪鄉,玉光村,188,1,606,10,616,921,3,1,3,0,1,0,66.88
宜蘭縣,礁溪鄉,光武村,189,1,718,8,726,1103,3,1,3,0,1,0,65.82
宜蘭縣,礁溪鄉,吳沙村,190,1,697,3,700,1021,3,1,3,0,1,0,68.56
宜蘭縣,礁溪鄉,吳沙村,191,1,767,6,773,1147,3,1,3,0,1,0,67.39
宜蘭縣,礁溪鄉,龍潭村,192,1,864,10,874,1409,3,1,3,0,1,0,62.03
宜蘭縣,礁溪鄉,龍潭村,193,1,819,13,832,1322,3,1,3,0,1,0,62.93
宜蘭縣,礁溪鄉,匏崙村,194,1,595,7,602,920,3,1,3,0,1,0,65.43
宜蘭縣,礁溪鄉,二結村,195,1,249,3,252,406,3,1,3,0,1,0,62.07
宜蘭縣,壯圍鄉,吉祥村,196,1,633,5,638,951,3,1,3,0,1,0,67.09
宜蘭縣,壯圍鄉,吉祥村,197,1,564,6,570,875,3,1,3,0,1,0,65.14
宜蘭縣,壯圍鄉,古結村,198,1,561,5,566,934,3,1,3,0,1,0,60.60
宜蘭縣,壯圍鄉,美福村,199,1,507,4,511,835,3,1,3,0,1,0,61.20
宜蘭縣,壯圍鄉,美福村,200,1,488,5,493,803,3,1,3,0,1,0,61.39
宜蘭縣,壯圍鄉,新南村,201,1,612,8,620,900,3,1,3,0,1,0,68.89
宜蘭縣,壯圍鄉,東港村,202,1,606,5,611,985,3,1,3,0,1,0,62.03
宜蘭縣,壯圍鄉,復興村,203,1,495,9,504,778,3,1,3,0,1,0,64.78
宜蘭縣,壯圍鄉,復興村,204,1,483,8,491,804,3,1,3,0,1,0,61.07
宜蘭縣,壯圍鄉,過嶺村,205,1,524,2,526,854,3,1,3,0,1,0,61.59
宜蘭縣,壯圍鄉,過嶺村,206,1,419,8,427,730,3,1,3,0,1,0,58.49
宜蘭縣,壯圍鄉,永鎮村,207,1,501,3,504,835,3,1,3,0,1,0,60.36
宜蘭縣,壯圍鄉,忠孝村,208,1,511,5,516,800,3,1,3,0,1,0,64.50
宜蘭縣,壯圍鄉,忠孝村,209,1,828,9,837,1266,3,1,3,0,1,0,66.11
宜蘭縣,壯圍鄉,古亭村,210,1,825,10,835,1277,3,1,3,0,1,0,65.39
宜蘭縣,壯圍鄉,功勞村,211,1,651,3,654,994,3,1,3,0,1,0,65.79
宜蘭縣,壯圍鄉,美城村,212,1,627,3,630,956,3,1,3,0,1,0,65.90
宜蘭縣,壯圍鄉,美城村,213,1,660,5,665,974,3,1,3,0,1,0,68.28
宜蘭縣,壯圍鄉,新社村,214,1,656,7,663,1026,3,1,3,0,1,0,64.62
宜蘭縣,壯圍鄉,大福村,215,1,541,7,548,874,3,1,3,0,1,0,62.70
宜蘭縣,壯圍鄉,大福村,216,1,625,5,630,959,3,1,3,0,1,0,65.69
宜蘭縣,員山鄉,員山村,217,1,891,9,900,1463,3,1,3,0,1,0,61.52
宜蘭縣,員山鄉,員山村,218,1,855,7,862,1392,3,1,3,0,1,0,61.93
宜蘭縣,員山鄉,員山村,219,1,858,11,869,1420,3,1,3,0,1,0,61.20
宜蘭縣,員山鄉,尚德村,220,1,563,10,573,969,3,1,3,0,1,0,59.13
宜蘭縣,員山鄉,尚德村,221,1,517,7,524,883,3,1,3,0,1,0,59.34
宜蘭縣,員山鄉,惠好村,222,1,796,6,802,1198,3,1,3,0,1,0,66.94
宜蘭縣,員山鄉,七賢村,223,1,644,9,653,978,3,1,3,0,1,0,66.77
宜蘭縣,員山鄉,深溝村,224,1,800,8,808,1389,3,1,3,0,1,0,58.17
宜蘭縣,員山鄉,蓁巷村,225,1,658,9,667,1139,3,1,3,0,1,0,58.56
宜蘭縣,員山鄉,內城村,226,1,630,11,641,997,3,1,3,0,1,0,64.29
宜蘭縣,員山鄉,內城村,227,1,292,8,300,489,3,1,3,0,1,0,61.35
宜蘭縣,員山鄉,中華村,228,1,268,3,271,458,3,1,3,0,1,0,59.17
宜蘭縣,員山鄉,中華村,229,1,158,1,159,282,3,1,3,0,1,0,56.38
宜蘭縣,員山鄉,永和村,230,1,964,11,975,1580,3,1,3,0,1,0,61.71
宜蘭縣,員山鄉,頭分村,231,1,661,10,671,1054,3,1,3,0,1,0,63.66
宜蘭縣,員山鄉,枕山村,232,1,1021,12,1033,1576,3,1,3,0,1,0,65.55
宜蘭縣,員山鄉,枕山村,233,1,324,8,332,524,3,1,3,0,1,0,63.36
宜蘭縣,員山鄉,同樂村,234,1,769,6,775,1189,3,1,3,0,1,0,65.18
宜蘭縣,員山鄉,同樂村,235,1,749,8,757,1205,3,1,3,0,1,0,62.82
宜蘭縣,員山鄉,湖東村,236,1,505,12,517,861,3,1,3,0,1,0,60.05
宜蘭縣,員山鄉,逸仙村,237,1,495,4,499,824,3,1,3,0,1,0,60.56
宜蘭縣,員山鄉,湖北村,238,1,700,6,706,1092,3,1,3,0,1,0,64.65
宜蘭縣,員山鄉,湖西村,239,1,863,4,867,1495,3,1,3,0,1,0,57.99
宜蘭縣,冬山鄉,武淵村,240,1,758,9,767,1101,3,1,3,0,1,0,69.66
宜蘭縣,冬山鄉,珍珠村,241,1,809,8,817,1229,3,1,3,0,1,0,66.48
宜蘭縣,冬山鄉,補城村,242,1,674,6,680,980,3,1,3,0,1,0,69.39
宜蘭縣,冬山鄉,三奇村,243,1,565,4,569,839,3,1,3,0,1,0,67.82
宜蘭縣,冬山鄉,大興村,244,1,664,8,672,935,3,1,3,0,1,0,71.87
宜蘭縣,冬山鄉,東城村,245,1,756,7,763,1145,3,1,3,0,1,0,66.64
宜蘭縣,冬山鄉,香和村,246,1,623,6,629,927,3,1,3,0,1,0,67.85
宜蘭縣,冬山鄉,香和村,247,1,679,9,688,1026,3,1,3,0,1,0,67.06
宜蘭縣,冬山鄉,南興村,248,1,577,5,582,824,3,1,3,0,1,0,70.63
宜蘭縣,冬山鄉,南興村,249,1,680,13,693,1027,3,1,3,0,1,0,67.48
宜蘭縣,冬山鄉,冬山村,250,1,578,5,583,811,3,1,3,0,1,0,71.89
宜蘭縣,冬山鄉,安平村,251,1,479,7,486,711,3,1,3,0,1,0,68.35
宜蘭縣,冬山鄉,太和村,252,1,944,4,948,1265,3,1,3,0,1,0,74.94
宜蘭縣,冬山鄉,八寶村,253,1,538,5,543,796,3,1,3,0,1,0,68.22
宜蘭縣,冬山鄉,丸山村,254,1,830,10,840,1234,3,1,3,0,1,0,68.07
宜蘭縣,冬山鄉,中山村,255,1,293,2,295,428,3,1,3,0,1,0,68.93
宜蘭縣,冬山鄉,順安村,256,1,713,10,723,1165,3,1,3,0,1,0,62.06
宜蘭縣,冬山鄉,順安村,257,1,908,9,917,1505,3,1,3,0,1,0,60.93
宜蘭縣,冬山鄉,順安村,258,1,888,4,892,1476,3,1,3,0,1,0,60.43
宜蘭縣,冬山鄉,永美村,259,1,566,4,570,870,3,1,3,0,1,0,65.52
宜蘭縣,冬山鄉,永美村,260,1,706,2,708,1101,3,1,3,0,1,0,64.31
宜蘭縣,冬山鄉,群英村,261,1,763,10,773,1175,3,1,3,0,1,0,65.79
宜蘭縣,冬山鄉,群英村,262,1,658,16,674,1069,3,1,3,0,1,0,63.05
宜蘭縣,冬山鄉,群英村,263,1,769,17,786,1242,3,1,3,0,1,0,63.29
宜蘭縣,冬山鄉,群英村,264,1,605,4,609,954,3,1,3,0,1,0,63.84
宜蘭縣,冬山鄉,清溝村,265,1,845,6,851,1301,3,1,3,0,1,0,65.41
宜蘭縣,冬山鄉,清溝村,266,1,828,6,834,1366,3,1,3,0,1,0,61.05
宜蘭縣,冬山鄉,鹿埔村,267,1,717,12,729,1128,3,1,3,0,1,0,64.63
宜蘭縣,冬山鄉,鹿埔村,268,1,674,8,682,1070,3,1,3,0,1,0,63.74
宜蘭縣,冬山鄉,得安村,269,1,685,10,695,998,3,1,3,0,1,0,69.64
宜蘭縣,冬山鄉,廣興村,270,1,673,6,679,1059,3,1,3,0,1,0,64.12
宜蘭縣,冬山鄉,廣興村,271,1,660,8,668,1053,3,1,3,0,1,0,63.44
宜蘭縣,冬山鄉,廣安村,272,1,812,4,816,1247,3,1,3,0,1,0,65.44
宜蘭縣,冬山鄉,柯林村,273,1,631,8,639,1018,3,1,3,0,1,0,62.77
宜蘭縣,冬山鄉,大進村,274,1,521,2,523,835,3,1,3,0,1,0,62.63
宜蘭縣,五結鄉,三興村,275,1,1043,10,1053,1588,3,1,3,0,1,0,66.31
宜蘭縣,五結鄉,二結村,276,1,945,11,956,1437,3,1,3,0,1,0,66.53
宜蘭縣,五結鄉,鎮安村,277,1,654,4,658,972,3,1,3,0,1,0,67.70
宜蘭縣,五結鄉,鎮安村,278,1,685,4,689,1019,3,1,3,0,1,0,67.62
宜蘭縣,五結鄉,上四村,279,1,906,12,918,1436,3,1,3,0,1,0,63.93
宜蘭縣,五結鄉,中興村,280,1,675,6,681,1071,3,1,3,0,1,0,63.59
宜蘭縣,五結鄉,四結村,281,1,553,7,560,878,3,1,3,0,1,0,63.78
宜蘭縣,五結鄉,四結村,282,1,762,4,766,1178,3,1,3,0,1,0,65.03
宜蘭縣,五結鄉,福興村,283,1,933,13,946,1457,3,1,3,0,1,0,64.93
宜蘭縣,五結鄉,五結村,284,1,921,1,922,1352,3,1,3,0,1,0,68.20
宜蘭縣,五結鄉,五結村,285,1,758,12,770,1312,3,1,3,0,1,0,58.69
宜蘭縣,五結鄉,大吉村,286,1,996,15,1011,1553,3,1,3,0,1,0,65.10
宜蘭縣,五結鄉,大吉村,287,1,744,2,746,1120,3,1,3,0,1,0,66.61
宜蘭縣,五結鄉,協和村,288,1,930,7,937,1410,3,1,3,0,1,0,66.45
宜蘭縣,五結鄉,協和村,289,1,538,7,545,868,3,1,3,0,1,0,62.79
宜蘭縣,五結鄉,孝威村,290,1,861,15,876,1330,3,1,3,0,1,0,65.86
宜蘭縣,五結鄉,錦眾村,291,1,944,11,955,1464,3,1,3,0,1,0,65.23
宜蘭縣,五結鄉,利澤村,292,1,615,27,642,1019,3,1,3,0,1,0,63.00
宜蘭縣,五結鄉,利澤村,293,1,570,5,575,972,3,1,3,0,1,0,59.16
宜蘭縣,五結鄉,成興村,294,1,1030,11,1041,1599,3,1,3,0,1,0,65.10
宜蘭縣,五結鄉,成興村,295,1,453,1,454,746,3,1,3,0,1,0,60.86
宜蘭縣,五結鄉,季新村,296,1,988,10,998,1713,3,1,3,0,1,0,58.26
宜蘭縣,五結鄉,季新村,297,1,489,7,496,748,3,1,3,0,1,0,66.31
宜蘭縣,三星鄉,員山村,298,1,157,1,158,239,3,1,3,0,1,0,66.11
宜蘭縣,三星鄉,天山村,299,1,374,3,377,599,3,1,3,0,1,0,62.94
宜蘭縣,三星鄉,天福村,300,1,462,6,468,781,3,1,3,0,1,0,59.92
宜蘭縣,三星鄉,雙賢村,301,1,411,8,419,675,3,1,3,0,1,0,62.07
宜蘭縣,三星鄉,人和村,302,1,288,6,294,453,3,1,3,0,1,0,64.90
宜蘭縣,三星鄉,義德村,303,1,711,8,719,1098,3,1,3,0,1,0,65.48
宜蘭縣,三星鄉,集慶村,304,1,724,5,729,1152,3,1,3,0,1,0,63.28
宜蘭縣,三星鄉,月眉村,305,1,547,7,554,820,3,1,3,0,1,0,67.56
宜蘭縣,三星鄉,拱照村,306,1,592,2,594,1024,3,1,3,0,1,0,58.01
宜蘭縣,三星鄉,大隱村,307,1,962,6,968,1588,3,1,3,0,1,0,60.96
宜蘭縣,三星鄉,大隱村,308,1,867,13,880,1463,3,1,3,0,1,0,60.15
宜蘭縣,三星鄉,行健村,309,1,424,6,430,687,3,1,3,0,1,0,62.59
宜蘭縣,三星鄉,萬德村,310,1,347,3,350,555,3,1,3,0,1,0,63.06
宜蘭縣,三星鄉,貴林村,311,1,285,6,291,497,3,1,3,0,1,0,58.55
宜蘭縣,三星鄉,萬富村,312,1,412,3,415,665,3,1,3,0,1,0,62.41
宜蘭縣,三星鄉,大義村,313,1,628,12,640,1088,3,1,3,0,1,0,58.82
宜蘭縣,三星鄉,尚武村,314,1,511,9,520,807,3,1,3,0,1,0,64.44
宜蘭縣,三星鄉,大洲村,315,1,868,6,874,1237,3,1,3,0,1,0,70.65
宜蘭縣,三星鄉,尾塹村,316,1,725,13,738,1120,3,1,3,0,1,0,65.89
宜蘭縣,大同鄉,寒溪村,317,1,59,0,59,105,3,1,3,0,1,0,56.19
宜蘭縣,大同鄉,崙埤村,318,1,57,1,58,94,3,1,3,0,1,0,61.70
宜蘭縣,大同鄉,松羅村,319,1,152,3,155,226,3,1,3,0,1,0,68.58
宜蘭縣,大同鄉,復興村,320,1,137,1,138,241,3,1,3,0,1,0,57.26
宜蘭縣,大同鄉,英士村,321,1,43,0,43,80,3,1,3,0,1,0,53.75
宜蘭縣,大同鄉,樂水村,322,1,29,3,32,57,3,1,3,0,1,0,56.14
宜蘭縣,大同鄉,太平村,323,1,37,0,37,53,3,1,3,0,1,0,69.81
宜蘭縣,大同鄉,茂安村,324,1,18,0,18,23,3,1,3,0,1,0,78.26
宜蘭縣,大同鄉,四季村,325,1,27,0,27,55,3,1,3,0,1,0,49.09
宜蘭縣,大同鄉,南山村,326,1,49,1,50,79,3,1,3,0,1,0,63.29
宜蘭縣,南澳鄉,東岳村,327,1,47,1,48,81,3,1,3,0,1,0,59.26
宜蘭縣,南澳鄉,南澳村,328,1,132,3,135,236,3,1,3,0,1,0,57.20
宜蘭縣,南澳鄉,碧候村,329,1,43,1,44,92,3,1,3,0,1,0,47.83
宜蘭縣,南澳鄉,金岳村,330,1,30,1,31,53,3,1,3,0,1,0,58.49
宜蘭縣,南澳鄉,武塔村,331,1,51,1,52,125,3,1,3,0,1,0,41.60
宜蘭縣,南澳鄉,金洋村,332,1,11,0,11,26,3,1,3,0,1,0,42.31
宜蘭縣,南澳鄉,澳花村,333,1,74,4,78,150,3,1,3,0,1,0,52.00
桃園縣,桃園市,大林里,1,1,781,9,790,1109,3,1,3,0,1,0,71.24
桃園縣,桃園市,大林里,2,1,905,4,909,1297,3,1,3,0,1,0,70.08
桃園縣,桃園市,大林里,3,1,787,12,799,1295,3,1,3,0,1,0,61.70
桃園縣,桃園市,大林里,4,1,769,15,784,1147,3,1,3,0,1,0,68.35
桃園縣,桃園市,雲林里,5,1,807,8,815,1215,3,1,3,0,1,0,67.08
桃園縣,桃園市,雲林里,6,1,758,7,765,1146,3,1,3,0,1,0,66.75
桃園縣,桃園市,雲林里,7,1,873,14,887,1271,3,1,3,0,1,0,69.79
桃園縣,桃園市,大豐里,8,1,858,13,871,1236,3,1,3,0,1,0,70.47
桃園縣,桃園市,大豐里,9,1,923,14,937,1378,3,1,3,0,1,0,68.00
桃園縣,桃園市,大豐里,10,1,817,11,828,1222,3,1,3,0,1,0,67.76
桃園縣,桃園市,福林里,11,1,924,10,934,1300,3,1,3,0,1,0,71.85
桃園縣,桃園市,福林里,12,1,1134,11,1145,1669,3,1,3,0,1,0,68.60
桃園縣,桃園市,福林里,13,1,926,10,936,1353,3,1,3,0,1,0,69.18
桃園縣,桃園市,福安里,14,1,966,5,971,1451,3,1,3,0,1,0,66.92
桃園縣,桃園市,福安里,15,1,1073,16,1089,1510,3,1,3,0,1,0,72.12
桃園縣,桃園市,豐林里,16,1,979,13,992,1451,3,1,3,0,1,0,68.37
桃園縣,桃園市,豐林里,17,1,1028,19,1047,1443,3,1,3,0,1,0,72.56
桃園縣,桃園市,豐林里,18,1,1335,18,1353,1963,3,1,3,0,1,0,68.93
桃園縣,桃園市,建國里,19,1,959,6,965,1415,3,1,3,0,1,0,68.20
桃園縣,桃園市,建國里,20,1,942,12,954,1440,3,1,3,0,1,0,66.25
桃園縣,桃園市,建國里,21,1,775,8,783,1185,3,1,3,0,1,0,66.08
桃園縣,桃園市,東門里,22,1,794,9,803,1201,3,1,3,0,1,0,66.86
桃園縣,桃園市,東門里,23,1,838,9,847,1278,3,1,3,0,1,0,66.28
桃園縣,桃園市,東山里,24,1,673,6,679,935,3,1,3,0,1,0,72.62
桃園縣,桃園市,東山里,25,1,564,4,568,875,3,1,3,0,1,0,64.91
桃園縣,桃園市,萬壽里,26,1,558,9,567,900,3,1,3,0,1,0,63.00
桃園縣,桃園市,武陵里,27,1,976,4,980,1524,3,1,3,0,1,0,64.30
桃園縣,桃園市,民生里,28,1,986,16,1002,1402,3,1,3,0,1,0,71.47
桃園縣,桃園市,文化里,29,1,535,3,538,814,3,1,3,0,1,0,66.09
桃園縣,桃園市,文明里,30,1,971,12,983,1441,3,1,3,0,1,0,68.22
桃園縣,桃園市,文昌里,31,1,657,9,666,943,3,1,3,0,1,0,70.63
桃園縣,桃園市,南門里,32,1,762,6,768,1132,3,1,3,0,1,0,67.84
桃園縣,桃園市,南門里,33,1,872,14,886,1381,3,1,3,0,1,0,64.16
桃園縣,桃園市,南門里,34,1,755,6,761,1046,3,1,3,0,1,0,72.75
桃園縣,桃園市,南門里,35,1,658,7,665,1031,3,1,3,0,1,0,64.50
桃園縣,桃園市,南華里,36,1,976,6,982,1360,3,1,3,0,1,0,72.21
桃園縣,桃園市,西門里,37,1,881,9,890,1334,3,1,3,0,1,0,66.72
桃園縣,桃園市,西湖里,38,1,853,9,862,1239,3,1,3,0,1,0,69.57
桃園縣,桃園市,長美里,39,1,642,3,645,936,3,1,3,0,1,0,68.91
桃園縣,桃園市,永興里,40,1,554,8,562,779,3,1,3,0,1,0,72.14
桃園縣,桃園市,永興里,41,1,677,3,680,956,3,1,3,0,1,0,71.13
桃園縣,桃園市,中興里,42,1,1077,17,1094,1529,3,1,3,0,1,0,71.55
桃園縣,桃園市,中興里,43,1,952,8,960,1333,3,1,3,0,1,0,72.02
桃園縣,桃園市,中興里,44,1,1096,10,1106,1599,3,1,3,0,1,0,69.17
桃園縣,桃園市,光興里,45,1,953,12,965,1381,3,1,3,0,1,0,69.88
桃園縣,桃園市,光興里,46,1,1016,15,1031,1476,3,1,3,0,1,0,69.85
桃園縣,桃園市,光興里,47,1,937,11,948,1615,3,1,3,0,1,0,58.70
桃園縣,桃園市,中路里,48,1,869,4,873,1244,3,1,3,0,1,0,70.18
桃園縣,桃園市,中路里,49,1,1044,13,1057,1620,3,1,3,0,1,0,65.25
桃園縣,桃園市,中信里,50,1,1018,6,1024,1486,3,1,3,0,1,0,68.91
桃園縣,桃園市,中信里,51,1,573,11,584,858,3,1,3,0,1,0,68.07
桃園縣,桃園市,中信里,52,1,712,10,722,1109,3,1,3,0,1,0,65.10
桃園縣,桃園市,中山里,53,1,919,12,931,1372,3,1,3,0,1,0,67.86
桃園縣,桃園市,中山里,54,1,831,14,845,1319,3,1,3,0,1,0,64.06
桃園縣,桃園市,中山里,55,1,853,10,863,1311,3,1,3,0,1,0,65.83
桃園縣,桃園市,中平里,56,1,1021,10,1031,1670,3,1,3,0,1,0,61.74
桃園縣,桃園市,中平里,57,1,1076,16,1092,1567,3,1,3,0,1,0,69.69
桃園縣,桃園市,中原里,58,1,922,10,932,1361,3,1,3,0,1,0,68.48
桃園縣,桃園市,中原里,59,1,778,7,785,1143,3,1,3,0,1,0,68.68
桃園縣,桃園市,中泰里,60,1,772,8,780,1267,3,1,3,0,1,0,61.56
桃園縣,桃園市,中泰里,61,1,859,7,866,1264,3,1,3,0,1,0,68.51
桃園縣,桃園市,中泰里,62,1,863,10,873,1345,3,1,3,0,1,0,64.91
桃園縣,桃園市,中泰里,63,1,758,11,769,1251,3,1,3,0,1,0,61.47
桃園縣,桃園市,中德里,64,1,961,11,972,1464,3,1,3,0,1,0,66.39
桃園縣,桃園市,中德里,65,1,768,12,780,1158,3,1,3,0,1,0,67.36
桃園縣,桃園市,中德里,66,1,968,10,978,1388,3,1,3,0,1,0,70.46
桃園縣,桃園市,中正里,67,1,894,10,904,1281,3,1,3,0,1,0,70.57
桃園縣,桃園市,中正里,68,1,804,6,810,1183,3,1,3,0,1,0,68.47
桃園縣,桃園市,中正里,69,1,968,11,979,1418,3,1,3,0,1,0,69.04
桃園縣,桃園市,文中里,70,1,836,11,847,1274,3,1,3,0,1,0,66.48
桃園縣,桃園市,文中里,71,1,880,12,892,1228,3,1,3,0,1,0,72.64
桃園縣,桃園市,中成里,72,1,656,8,664,959,3,1,3,0,1,0,69.24
桃園縣,桃園市,中成里,73,1,958,10,968,1438,3,1,3,0,1,0,67.32
桃園縣,桃園市,中成里,74,1,615,5,620,976,3,1,3,0,1,0,63.52
桃園縣,桃園市,玉山里,75,1,836,13,849,1245,3,1,3,0,1,0,68.19
桃園縣,桃園市,玉山里,76,1,947,16,963,1399,3,1,3,0,1,0,68.83
桃園縣,桃園市,玉山里,77,1,918,10,928,1483,3,1,3,0,1,0,62.58
桃園縣,桃園市,泰山里,78,1,846,14,860,1238,3,1,3,0,1,0,69.47
桃園縣,桃園市,泰山里,79,1,1125,13,1138,1623,3,1,3,0,1,0,70.12
桃園縣,桃園市,龍岡里,80,1,1047,12,1059,1486,3,1,3,0,1,0,71.27
桃園縣,桃園市,龍岡里,81,1,1131,14,1145,1691,3,1,3,0,1,0,67.71
桃園縣,桃園市,龍安里,82,1,682,9,691,1102,3,1,3,0,1,0,62.70
桃園縣,桃園市,龍安里,83,1,703,7,710,1018,3,1,3,0,1,0,69.74
桃園縣,桃園市,龍鳳里,84,1,899,5,904,1332,3,1,3,0,1,0,67.87
桃園縣,桃園市,龍鳳里,85,1,729,13,742,1145,3,1,3,0,1,0,64.80
桃園縣,桃園市,龍鳳里,86,1,838,13,851,1344,3,1,3,0,1,0,63.32
桃園縣,桃園市,龍祥里,87,1,834,7,841,1249,3,1,3,0,1,0,67.33
桃園縣,桃園市,龍祥里,88,1,805,16,821,1164,3,1,3,0,1,0,70.53
桃園縣,桃園市,龍祥里,89,1,804,8,812,1442,3,1,3,0,1,0,56.31
桃園縣,桃園市,龍祥里,90,1,824,15,839,1225,3,1,3,0,1,0,68.49
桃園縣,桃園市,龍山里,91,1,624,8,632,917,3,1,3,0,1,0,68.92
桃園縣,桃園市,龍山里,92,1,579,5,584,913,3,1,3,0,1,0,63.96
桃園縣,桃園市,龍山里,93,1,1061,5,1066,1515,3,1,3,0,1,0,70.36
桃園縣,桃園市,東埔里,94,1,906,19,925,1366,3,1,3,0,1,0,67.72
桃園縣,桃園市,東埔里,95,1,826,14,840,1265,3,1,3,0,1,0,66.40
桃園縣,桃園市,東埔里,96,1,867,11,878,1283,3,1,3,0,1,0,68.43
桃園縣,桃園市,信光里,97,1,803,9,812,1210,3,1,3,0,1,0,67.11
桃園縣,桃園市,信光里,98,1,721,9,730,1085,3,1,3,0,1,0,67.28
桃園縣,桃園市,信光里,99,1,1068,13,1081,1668,3,1,3,0,1,0,64.81
桃園縣,桃園市,永安里,100,1,784,11,795,1153,3,1,3,0,1,0,68.95
桃園縣,桃園市,永安里,101,1,786,9,795,1222,3,1,3,0,1,0,65.06
桃園縣,桃園市,永安里,102,1,946,12,958,1389,3,1,3,0,1,0,68.97
桃園縣,桃園市,中寧里,103,1,971,12,983,1517,3,1,3,0,1,0,64.80
桃園縣,桃園市,中寧里,104,1,892,14,906,1369,3,1,3,0,1,0,66.18
桃園縣,桃園市,中寧里,105,1,958,7,965,1489,3,1,3,0,1,0,64.81
桃園縣,桃園市,中寧里,106,1,873,17,890,1336,3,1,3,0,1,0,66.62
桃園縣,桃園市,中埔里,107,1,716,11,727,1023,3,1,3,0,1,0,71.07
桃園縣,桃園市,中埔里,108,1,669,8,677,905,3,1,3,0,1,0,74.81
桃園縣,桃園市,南埔里,109,1,887,10,897,1415,3,1,3,0,1,0,63.39
桃園縣,桃園市,南埔里,110,1,796,13,809,1190,3,1,3,0,1,0,67.98
桃園縣,桃園市,寶慶里,111,1,1050,7,1057,1560,3,1,3,0,1,0,67.76
桃園縣,桃園市,寶慶里,112,1,1135,15,1150,1819,3,1,3,0,1,0,63.22
桃園縣,桃園市,寶慶里,113,1,634,9,643,1026,3,1,3,0,1,0,62.67
桃園縣,桃園市,北埔里,114,1,1117,12,1129,1856,3,1,3,0,1,0,60.83
桃園縣,桃園市,北埔里,115,1,679,8,687,1067,3,1,3,0,1,0,64.39
桃園縣,桃園市,北埔里,116,1,1508,14,1522,2429,3,1,3,0,1,0,62.66
桃園縣,桃園市,西埔里,117,1,913,16,929,1264,3,1,3,0,1,0,73.50
桃園縣,桃園市,西埔里,118,1,787,8,795,1011,3,1,3,0,1,0,78.64
桃園縣,桃園市,慈文里,119,1,811,9,820,1244,3,1,3,0,1,0,65.92
桃園縣,桃園市,慈文里,120,1,887,7,894,1326,3,1,3,0,1,0,67.42
桃園縣,桃園市,慈文里,121,1,1001,8,1009,1584,3,1,3,0,1,0,63.70
桃園縣,桃園市,新埔里,122,1,806,3,809,1136,3,1,3,0,1,0,71.21
桃園縣,桃園市,新埔里,123,1,1171,19,1190,1887,3,1,3,0,1,0,63.06
桃園縣,桃園市,新埔里,124,1,1282,19,1301,1740,3,1,3,0,1,0,74.77
桃園縣,桃園市,同安里,125,1,851,5,856,1274,3,1,3,0,1,0,67.19
桃園縣,桃園市,同安里,126,1,856,12,868,1178,3,1,3,0,1,0,73.68
桃園縣,桃園市,同安里,127,1,912,11,923,1432,3,1,3,0,1,0,64.46
桃園縣,桃園市,莊敬里,128,1,873,16,889,1387,3,1,3,0,1,0,64.10
桃園縣,桃園市,莊敬里,129,1,812,8,820,1157,3,1,3,0,1,0,70.87
桃園縣,桃園市,莊敬里,130,1,832,6,838,1377,3,1,3,0,1,0,60.86
桃園縣,桃園市,自強里,131,1,1014,16,1030,1593,3,1,3,0,1,0,64.66
桃園縣,桃園市,自強里,132,1,1021,9,1030,1517,3,1,3,0,1,0,67.90
桃園縣,桃園市,自強里,133,1,724,7,731,1053,3,1,3,0,1,0,69.42
桃園縣,桃園市,長安里,134,1,865,10,875,1330,3,1,3,0,1,0,65.79
桃園縣,桃園市,長安里,135,1,887,12,899,1357,3,1,3,0,1,0,66.25
桃園縣,桃園市,長德里,136,1,1014,12,1026,1558,3,1,3,0,1,0,65.85
桃園縣,桃園市,長德里,137,1,1004,8,1012,1456,3,1,3,0,1,0,69.51
桃園縣,桃園市,中和里,138,1,992,10,1002,1367,3,1,3,0,1,0,73.30
桃園縣,桃園市,北門里,139,1,1066,15,1081,1614,3,1,3,0,1,0,66.98
桃園縣,桃園市,朝陽里,140,1,1151,15,1166,1738,3,1,3,0,1,0,67.09
桃園縣,桃園市,青溪里,141,1,982,15,997,1453,3,1,3,0,1,0,68.62
桃園縣,桃園市,青溪里,142,1,836,10,846,1194,3,1,3,0,1,0,70.85
桃園縣,桃園市,青溪里,143,1,1032,11,1043,1540,3,1,3,0,1,0,67.73
桃園縣,桃園市,成功里,144,1,1097,16,1113,1547,3,1,3,0,1,0,71.95
桃園縣,桃園市,成功里,145,1,1140,9,1149,1670,3,1,3,0,1,0,68.80
桃園縣,桃園市,三民里,146,1,1145,10,1155,1654,3,1,3,0,1,0,69.83
桃園縣,桃園市,三民里,147,1,1191,15,1206,1763,3,1,3,0,1,0,68.41
桃園縣,桃園市,忠義里,148,1,766,10,776,1206,3,1,3,0,1,0,64.34
桃園縣,桃園市,忠義里,149,1,962,19,981,1508,3,1,3,0,1,0,65.05
桃園縣,桃園市,忠義里,150,1,928,12,940,1436,3,1,3,0,1,0,65.46
桃園縣,桃園市,忠義里,151,1,970,9,979,1484,3,1,3,0,1,0,65.97
桃園縣,桃園市,大興里,152,1,813,8,821,1217,3,1,3,0,1,0,67.46
桃園縣,桃園市,大興里,153,1,754,12,766,1183,3,1,3,0,1,0,64.75
桃園縣,桃園市,大興里,154,1,955,3,958,1531,3,1,3,0,1,0,62.57
桃園縣,桃園市,大興里,155,1,655,13,668,1043,3,1,3,0,1,0,64.05
桃園縣,桃園市,會稽里,156,1,925,12,937,1603,3,1,3,0,1,0,58.45
桃園縣,桃園市,會稽里,157,1,952,13,965,1546,3,1,3,0,1,0,62.42
桃園縣,桃園市,會稽里,158,1,839,9,848,1403,3,1,3,0,1,0,60.44
桃園縣,桃園市,大有里,159,1,846,6,852,1333,3,1,3,0,1,0,63.92
桃園縣,桃園市,大有里,160,1,449,4,453,888,3,1,3,0,1,0,51.01
桃園縣,桃園市,寶山里,161,1,1126,18,1144,1743,3,1,3,0,1,0,65.63
桃園縣,桃園市,寶山里,162,1,1017,12,1029,1694,3,1,3,0,1,0,60.74
桃園縣,桃園市,春日里,163,1,834,8,842,1208,3,1,3,0,1,0,69.70
桃園縣,桃園市,春日里,164,1,759,12,771,1203,3,1,3,0,1,0,64.09
桃園縣,桃園市,春日里,165,1,648,6,654,1142,3,1,3,0,1,0,57.27
桃園縣,桃園市,汴洲里,166,1,999,9,1008,1385,3,1,3,0,1,0,72.78
桃園縣,桃園市,汴洲里,167,1,1200,27,1227,1753,3,1,3,0,1,0,69.99
桃園縣,龜山鄉,龜山村,168,1,942,19,961,1340,3,1,3,0,1,0,71.72
桃園縣,龜山鄉,龜山村,169,1,1128,17,1145,1649,3,1,3,0,1,0,69.44
桃園縣,龜山鄉,龜山村,170,1,1106,22,1128,1685,3,1,3,0,1,0,66.94
桃園縣,龜山鄉,新路村,171,1,1078,19,1097,1471,3,1,3,0,1,0,74.58
桃園縣,龜山鄉,新路村,172,1,792,9,801,1099,3,1,3,0,1,0,72.88
桃園縣,龜山鄉,新路村,173,1,855,6,861,1313,3,1,3,0,1,0,65.58
桃園縣,龜山鄉,新路村,174,1,882,12,894,1266,3,1,3,0,1,0,70.62
桃園縣,龜山鄉,大同村,175,1,957,18,975,1453,3,1,3,0,1,0,67.10
桃園縣,龜山鄉,大同村,176,1,889,20,909,1359,3,1,3,0,1,0,66.89
桃園縣,龜山鄉,大同村,177,1,869,12,881,1243,3,1,3,0,1,0,70.88
桃園縣,龜山鄉,中興村,178,1,981,19,1000,1489,3,1,3,0,1,0,67.16
桃園縣,龜山鄉,中興村,179,1,863,13,876,1256,3,1,3,0,1,0,69.75
桃園縣,龜山鄉,中興村,180,1,747,19,766,1109,3,1,3,0,1,0,69.07
桃園縣,龜山鄉,中興村,181,1,653,10,663,1134,3,1,3,0,1,0,58.47
桃園縣,龜山鄉,陸光村,182,1,547,8,555,812,3,1,3,0,1,0,68.35
桃園縣,龜山鄉,精忠村,183,1,817,6,823,1115,3,1,3,0,1,0,73.81
桃園縣,龜山鄉,精忠村,184,1,473,3,476,629,3,1,3,0,1,0,75.68
桃園縣,龜山鄉,福源村,185,1,1088,20,1108,1705,3,1,3,0,1,0,64.99
桃園縣,龜山鄉,兔坑村,186,1,624,9,633,1086,3,1,3,0,1,0,58.29
桃園縣,龜山鄉,兔坑村,187,1,487,7,494,926,3,1,3,0,1,0,53.35
桃園縣,龜山鄉,迴龍村,188,1,865,12,877,1436,3,1,3,0,1,0,61.07
桃園縣,龜山鄉,迴龍村,189,1,667,8,675,1117,3,1,3,0,1,0,60.43
桃園縣,龜山鄉,迴龍村,190,1,659,15,674,1249,3,1,3,0,1,0,53.96
桃園縣,龜山鄉,龍華村,191,1,688,15,703,1144,3,1,3,0,1,0,61.45
桃園縣,龜山鄉,龍華村,192,1,752,14,766,1262,3,1,3,0,1,0,60.70
桃園縣,龜山鄉,龍壽村,193,1,312,9,321,548,3,1,3,0,1,0,58.58
桃園縣,龜山鄉,龍壽村,194,1,612,6,618,911,3,1,3,0,1,0,67.84
桃園縣,龜山鄉,嶺頂村,195,1,906,14,920,1502,3,1,3,0,1,0,61.25
桃園縣,龜山鄉,嶺頂村,196,1,854,14,868,1475,3,1,3,0,1,0,58.85
桃園縣,龜山鄉,新嶺村,197,1,718,14,732,1255,3,1,3,0,1,0,58.33
桃園縣,龜山鄉,新嶺村,198,1,876,25,901,1541,3,1,3,0,1,0,58.47
桃園縣,龜山鄉,舊路村,199,1,641,15,656,971,3,1,3,0,1,0,67.56
桃園縣,龜山鄉,舊路村,200,1,566,3,569,866,3,1,3,0,1,0,65.70
桃園縣,龜山鄉,山德村,201,1,973,13,986,1548,3,1,3,0,1,0,63.70
桃園縣,龜山鄉,山德村,202,1,980,9,989,1463,3,1,3,0,1,0,67.60
桃園縣,龜山鄉,山德村,203,1,1093,14,1107,1677,3,1,3,0,1,0,66.01
桃園縣,龜山鄉,山頂村,204,1,1104,18,1122,1648,3,1,3,0,1,0,68.08
桃園縣,龜山鄉,山頂村,205,1,1139,11,1150,2187,3,1,3,0,1,0,52.58
桃園縣,龜山鄉,山福村,206,1,914,18,932,1408,3,1,3,0,1,0,66.19
桃園縣,龜山鄉,山福村,207,1,843,14,857,1334,3,1,3,0,1,0,64.24
桃園縣,龜山鄉,幸福村,208,1,833,19,852,1356,3,1,3,0,1,0,62.83
桃園縣,龜山鄉,幸福村,209,1,870,19,889,1388,3,1,3,0,1,0,64.05
桃園縣,龜山鄉,幸福村,210,1,779,13,792,1263,3,1,3,0,1,0,62.71
桃園縣,龜山鄉,大崗村,211,1,472,3,475,898,3,1,3,0,1,0,52.90
桃園縣,龜山鄉,大崗村,212,1,927,9,936,1624,3,1,3,0,1,0,57.64
桃園縣,龜山鄉,大崗村,213,1,550,4,554,981,3,1,3,0,1,0,56.47
桃園縣,龜山鄉,大崗村,214,1,903,8,911,1444,3,1,3,0,1,0,63.09
桃園縣,龜山鄉,大崗村,215,1,945,15,960,1400,3,1,3,0,1,0,68.57
桃園縣,龜山鄉,公西村,216,1,634,16,650,881,3,1,3,0,1,0,73.78
桃園縣,龜山鄉,公西村,217,1,774,16,790,1394,3,1,3,0,1,0,56.67
桃園縣,龜山鄉,文化村,218,1,662,8,670,1185,3,1,3,0,1,0,56.54
桃園縣,龜山鄉,文化村,219,1,652,12,664,1173,3,1,3,0,1,0,56.61
桃園縣,龜山鄉,樂善村,220,1,819,12,831,1408,3,1,3,0,1,0,59.02
桃園縣,龜山鄉,樂善村,221,1,656,10,666,1192,3,1,3,0,1,0,55.87
桃園縣,龜山鄉,樂善村,222,1,524,8,532,872,3,1,3,0,1,0,61.01
桃園縣,龜山鄉,樂善村,223,1,762,30,792,1195,3,1,3,0,1,0,66.28
桃園縣,龜山鄉,大坑村,224,1,832,8,840,1289,3,1,3,0,1,0,65.17
桃園縣,龜山鄉,南上村,225,1,822,12,834,1248,3,1,3,0,1,0,66.83
桃園縣,龜山鄉,南美村,226,1,786,10,796,1226,3,1,3,0,1,0,64.93
桃園縣,龜山鄉,楓樹村,227,1,941,12,953,1414,3,1,3,0,1,0,67.40
桃園縣,龜山鄉,楓樹村,228,1,881,19,900,1335,3,1,3,0,1,0,67.42
桃園縣,八德市,興仁里,229,1,989,25,1014,1515,3,1,3,0,1,0,66.93
桃園縣,八德市,興仁里,230,1,1086,10,1096,1723,3,1,3,0,1,0,63.61
桃園縣,八德市,福興里,231,1,1021,25,1046,1468,3,1,3,0,1,0,71.25
桃園縣,八德市,福興里,232,1,887,31,918,1271,3,1,3,0,1,0,72.23
桃園縣,八德市,瑞豐里,233,1,1136,26,1162,1736,3,1,3,0,1,0,66.94
桃園縣,八德市,瑞豐里,234,1,1044,33,1077,1454,3,1,3,0,1,0,74.07
桃園縣,八德市,瑞泰里,235,1,927,12,939,1413,3,1,3,0,1,0,66.45
桃園縣,八德市,瑞泰里,236,1,903,18,921,1366,3,1,3,0,1,0,67.42
桃園縣,八德市,瑞發里,237,1,1001,24,1025,1454,3,1,3,0,1,0,70.50
桃園縣,八德市,瑞發里,238,1,1096,22,1118,1622,3,1,3,0,1,0,68.93
桃園縣,八德市,瑞德里,239,1,1119,14,1133,1533,3,1,3,0,1,0,73.91
桃園縣,八德市,瑞德里,240,1,1038,22,1060,1427,3,1,3,0,1,0,74.28
桃園縣,八德市,瑞祥里,241,1,918,13,931,1346,3,1,3,0,1,0,69.17
桃園縣,八德市,瑞祥里,242,1,1031,25,1056,1457,3,1,3,0,1,0,72.48
桃園縣,八德市,廣興里,243,1,1184,26,1210,1823,3,1,3,0,1,0,66.37
桃園縣,八德市,廣興里,244,1,1135,26,1161,1665,3,1,3,0,1,0,69.73
桃園縣,八德市,廣興里,245,1,777,15,792,1093,3,1,3,0,1,0,72.46
桃園縣,八德市,廣隆里,246,1,1359,31,1390,1898,3,1,3,0,1,0,73.23
桃園縣,八德市,廣隆里,247,1,640,9,649,912,3,1,3,0,1,0,71.16
桃園縣,八德市,竹園里,248,1,911,19,930,1392,3,1,3,0,1,0,66.81
桃園縣,八德市,竹園里,249,1,871,21,892,1299,3,1,3,0,1,0,68.67
桃園縣,八德市,霄裡里,250,1,1140,25,1165,1679,3,1,3,0,1,0,69.39
桃園縣,八德市,霄裡里,251,1,633,18,651,887,3,1,3,0,1,0,73.39
桃園縣,八德市,霄裡里,252,1,883,16,899,1167,3,1,3,0,1,0,77.04
桃園縣,八德市,茄明里,253,1,1008,16,1024,1524,3,1,3,0,1,0,67.19
桃園縣,八德市,茄明里,254,1,725,8,733,1225,3,1,3,0,1,0,59.84
桃園縣,八德市,茄苳里,255,1,1416,15,1431,2045,3,1,3,0,1,0,69.98
桃園縣,八德市,茄苳里,256,1,1239,29,1268,1944,3,1,3,0,1,0,65.23
桃園縣,八德市,高明里,257,1,1082,21,1103,1686,3,1,3,0,1,0,65.42
桃園縣,八德市,高明里,258,1,805,18,823,1234,3,1,3,0,1,0,66.69
桃園縣,八德市,高城里,259,1,1306,23,1329,1919,3,1,3,0,1,0,69.25
桃園縣,八德市,白鷺里,260,1,1535,24,1559,2285,3,1,3,0,1,0,68.23
桃園縣,八德市,大湳里,261,1,731,9,740,1116,3,1,3,0,1,0,66.31
桃園縣,八德市,大湳里,262,1,823,19,842,1391,3,1,3,0,1,0,60.53
桃園縣,八德市,大發里,263,1,1047,35,1082,1584,3,1,3,0,1,0,68.31
桃園縣,八德市,大仁里,264,1,1139,24,1163,1709,3,1,3,0,1,0,68.05
桃園縣,八德市,大仁里,265,1,899,18,917,1312,3,1,3,0,1,0,69.89
桃園縣,八德市,大明里,266,1,1105,23,1128,1660,3,1,3,0,1,0,67.95
桃園縣,八德市,大明里,267,1,208,3,211,326,3,1,3,0,1,0,64.72
桃園縣,八德市,大安里,268,1,709,11,720,1076,3,1,3,0,1,0,66.91
桃園縣,八德市,大安里,269,1,805,10,815,1197,3,1,3,0,1,0,68.09
桃園縣,八德市,大竹里,270,1,969,14,983,1424,3,1,3,0,1,0,69.03
桃園縣,八德市,大興里,271,1,965,30,995,1471,3,1,3,0,1,0,67.64
桃園縣,八德市,大興里,272,1,754,7,761,1115,3,1,3,0,1,0,68.25
桃園縣,八德市,大興里,273,1,968,18,986,1363,3,1,3,0,1,0,72.34
桃園縣,八德市,大華里,274,1,886,13,899,1324,3,1,3,0,1,0,67.90
桃園縣,八德市,大華里,275,1,683,14,697,1012,3,1,3,0,1,0,68.87
桃園縣,八德市,大華里,276,1,936,14,950,1378,3,1,3,0,1,0,68.94
桃園縣,八德市,大和里,277,1,1180,18,1198,1800,3,1,3,0,1,0,66.56
桃園縣,八德市,大和里,278,1,510,4,514,727,3,1,3,0,1,0,70.70
桃園縣,八德市,大昌里,279,1,646,9,655,890,3,1,3,0,1,0,73.60
桃園縣,八德市,大昌里,280,1,1129,16,1145,1684,3,1,3,0,1,0,67.99
桃園縣,八德市,大同里,281,1,780,10,790,954,3,1,3,0,1,0,82.81
桃園縣,八德市,大同里,282,1,1011,19,1030,1461,3,1,3,0,1,0,70.50
桃園縣,八德市,大慶里,283,1,919,11,930,1336,3,1,3,0,1,0,69.61
桃園縣,八德市,大成里,284,1,1167,23,1190,1656,3,1,3,0,1,0,71.86
桃園縣,八德市,大成里,285,1,1184,22,1206,1687,3,1,3,0,1,0,71.49
桃園縣,八德市,大義里,286,1,997,21,1018,1516,3,1,3,0,1,0,67.15
桃園縣,八德市,大義里,287,1,1022,17,1039,1500,3,1,3,0,1,0,69.27
桃園縣,八德市,大忠里,288,1,675,7,682,976,3,1,3,0,1,0,69.88
桃園縣,八德市,大忠里,289,1,535,16,551,829,3,1,3,0,1,0,66.47
桃園縣,八德市,大智里,290,1,1133,24,1157,1659,3,1,3,0,1,0,69.74
桃園縣,八德市,大智里,291,1,708,10,718,988,3,1,3,0,1,0,72.67
桃園縣,八德市,大智里,292,1,1133,11,1144,1620,3,1,3,0,1,0,70.62
桃園縣,八德市,大正里,293,1,678,7,685,961,3,1,3,0,1,0,71.28
桃園縣,八德市,大正里,294,1,1098,11,1109,1570,3,1,3,0,1,0,70.64
桃園縣,八德市,大福里,295,1,914,10,924,1383,3,1,3,0,1,0,66.81
桃園縣,八德市,大福里,296,1,650,9,659,956,3,1,3,0,1,0,68.93
桃園縣,八德市,大福里,297,1,654,3,657,908,3,1,3,0,1,0,72.36
桃園縣,八德市,大強里,298,1,956,22,978,1456,3,1,3,0,1,0,67.17
桃園縣,八德市,大強里,299,1,664,19,683,987,3,1,3,0,1,0,69.20
桃園縣,八德市,大勇里,300,1,776,14,790,1137,3,1,3,0,1,0,69.48
桃園縣,八德市,大勇里,301,1,659,7,666,1030,3,1,3,0,1,0,64.66
桃園縣,八德市,大榮里,302,1,967,17,984,1472,3,1,3,0,1,0,66.85
桃園縣,八德市,大千里,303,1,1029,22,1051,1512,3,1,3,0,1,0,69.51
桃園縣,八德市,大千里,304,1,703,20,723,1111,3,1,3,0,1,0,65.08
桃園縣,八德市,大千里,305,1,833,16,849,1243,3,1,3,0,1,0,68.30
桃園縣,八德市,大信里,306,1,697,9,706,1095,3,1,3,0,1,0,64.47
桃園縣,八德市,大信里,307,1,1137,22,1159,1669,3,1,3,0,1,0,69.44
桃園縣,八德市,大信里,308,1,443,32,475,1291,3,1,3,0,1,0,36.79
桃園縣,八德市,大信里,309,1,658,58,716,1295,3,1,3,0,1,0,55.29
桃園縣,蘆竹鄉,新興村,310,1,758,20,778,1097,3,1,3,0,1,0,70.92
桃園縣,蘆竹鄉,新興村,311,1,716,11,727,1019,3,1,3,0,1,0,71.34
桃園縣,蘆竹鄉,新興村,312,1,656,10,666,1010,3,1,3,0,1,0,65.94
桃園縣,蘆竹鄉,中福村,313,1,1026,10,1036,1582,3,1,3,0,1,0,65.49
桃園縣,蘆竹鄉,中福村,314,1,1135,22,1157,1577,3,1,3,0,1,0,73.37
桃園縣,蘆竹鄉,新莊村,315,1,1169,19,1188,1674,3,1,3,0,1,0,70.97
桃園縣,蘆竹鄉,新莊村,316,1,842,14,856,1165,3,1,3,0,1,0,73.48
桃園縣,蘆竹鄉,上竹村,317,1,747,13,760,1122,3,1,3,0,1,0,67.74
桃園縣,蘆竹鄉,上竹村,318,1,645,10,655,929,3,1,3,0,1,0,70.51
桃園縣,蘆竹鄉,宏竹村,319,1,750,16,766,1052,3,1,3,0,1,0,72.81
桃園縣,蘆竹鄉,宏竹村,320,1,703,14,717,1047,3,1,3,0,1,0,68.48
桃園縣,蘆竹鄉,大竹村,321,1,958,13,971,1407,3,1,3,0,1,0,69.01
桃園縣,蘆竹鄉,大竹村,322,1,793,9,802,1135,3,1,3,0,1,0,70.66
桃園縣,蘆竹鄉,富竹村,323,1,744,7,751,1036,3,1,3,0,1,0,72.49
桃園縣,蘆竹鄉,大華村,324,1,546,15,561,763,3,1,3,0,1,0,73.53
桃園縣,蘆竹鄉,大華村,325,1,684,7,691,892,3,1,3,0,1,0,77.47
桃園縣,蘆竹鄉,蘆竹村,326,1,686,5,691,981,3,1,3,0,1,0,70.44
桃園縣,蘆竹鄉,蘆竹村,327,1,709,14,723,937,3,1,3,0,1,0,77.16
桃園縣,蘆竹鄉,蘆竹村,328,1,696,9,705,923,3,1,3,0,1,0,76.38
桃園縣,蘆竹鄉,南興村,329,1,804,15,819,1156,3,1,3,0,1,0,70.85
桃園縣,蘆竹鄉,南興村,330,1,1470,16,1486,2483,3,1,3,0,1,0,59.85
桃園縣,蘆竹鄉,南興村,331,1,1992,31,2023,3353,3,1,3,0,1,0,60.33
桃園縣,蘆竹鄉,南榮村,332,1,541,8,549,948,3,1,3,0,1,0,57.91
桃園縣,蘆竹鄉,南榮村,333,1,845,15,860,1304,3,1,3,0,1,0,65.95
桃園縣,蘆竹鄉,南崁村,334,1,748,19,767,1113,3,1,3,0,1,0,68.91
桃園縣,蘆竹鄉,南崁村,335,1,804,13,817,1319,3,1,3,0,1,0,61.94
桃園縣,蘆竹鄉,錦興村,336,1,889,13,902,1323,3,1,3,0,1,0,68.18
桃園縣,蘆竹鄉,錦興村,337,1,884,11,895,1346,3,1,3,0,1,0,66.49
桃園縣,蘆竹鄉,錦中村,338,1,558,9,567,837,3,1,3,0,1,0,67.74
桃園縣,蘆竹鄉,錦中村,339,1,585,6,591,913,3,1,3,0,1,0,64.73
桃園縣,蘆竹鄉,長興村,340,1,1009,21,1030,1608,3,1,3,0,1,0,64.05
桃園縣,蘆竹鄉,五福村,341,1,921,9,930,1507,3,1,3,0,1,0,61.71
桃園縣,蘆竹鄉,五福村,342,1,949,8,957,1534,3,1,3,0,1,0,62.39
桃園縣,蘆竹鄉,羊稠村,343,1,972,11,983,1544,3,1,3,0,1,0,63.67
桃園縣,蘆竹鄉,羊稠村,344,1,867,10,877,1328,3,1,3,0,1,0,66.04
桃園縣,蘆竹鄉,羊稠村,345,1,897,1,898,1450,3,1,3,0,1,0,61.93
桃園縣,蘆竹鄉,營盤村,346,1,908,12,920,1528,3,1,3,0,1,0,60.21
桃園縣,蘆竹鄉,營盤村,347,1,949,14,963,1468,3,1,3,0,1,0,65.60
桃園縣,蘆竹鄉,瓦窯村,348,1,794,10,804,1458,3,1,3,0,1,0,55.14
桃園縣,蘆竹鄉,內厝村,349,1,570,10,580,859,3,1,3,0,1,0,67.52
桃園縣,蘆竹鄉,內厝村,350,1,690,18,708,963,3,1,3,0,1,0,73.52
桃園縣,蘆竹鄉,山鼻村,351,1,954,16,970,1388,3,1,3,0,1,0,69.88
桃園縣,蘆竹鄉,山腳村,352,1,718,17,735,1084,3,1,3,0,1,0,67.80
桃園縣,蘆竹鄉,山腳村,353,1,699,14,713,1078,3,1,3,0,1,0,66.14
桃園縣,蘆竹鄉,山腳村,354,1,707,15,722,950,3,1,3,0,1,0,76.00
桃園縣,蘆竹鄉,外社村,355,1,889,16,905,1241,3,1,3,0,1,0,72.93
桃園縣,蘆竹鄉,坑子村,356,1,1109,23,1132,1568,3,1,3,0,1,0,72.19
桃園縣,蘆竹鄉,坑口村,357,1,690,11,701,1008,3,1,3,0,1,0,69.54
桃園縣,蘆竹鄉,坑口村,358,1,747,12,759,1077,3,1,3,0,1,0,70.47
桃園縣,蘆竹鄉,海湖村,359,1,763,9,772,1287,3,1,3,0,1,0,59.98
桃園縣,蘆竹鄉,海湖村,360,1,757,10,767,1189,3,1,3,0,1,0,64.51
桃園縣,蘆竹鄉,海湖村,361,1,681,12,693,1122,3,1,3,0,1,0,61.76
桃園縣,大園鄉,大園村,362,1,1266,22,1288,1739,3,1,3,0,1,0,74.07
桃園縣,大園鄉,大園村,363,1,1124,13,1137,1522,3,1,3,0,1,0,74.70
桃園縣,大園鄉,大園村,364,1,1180,20,1200,1650,3,1,3,0,1,0,72.73
桃園縣,大園鄉,田心村,365,1,883,7,890,1236,3,1,3,0,1,0,72.01
桃園縣,大園鄉,田心村,366,1,881,21,902,1332,3,1,3,0,1,0,67.72
桃園縣,大園鄉,田心村,367,1,1017,16,1033,1481,3,1,3,0,1,0,69.75
桃園縣,大園鄉,溪海村,368,1,1057,22,1079,1550,3,1,3,0,1,0,69.61
桃園縣,大園鄉,溪海村,369,1,1031,13,1044,1508,3,1,3,0,1,0,69.23
桃園縣,大園鄉,和平村,370,1,987,9,996,1383,3,1,3,0,1,0,72.02
桃園縣,大園鄉,橫峰村,371,1,1144,15,1159,1716,3,1,3,0,1,0,67.54
桃園縣,大園鄉,橫峰村,372,1,1151,15,1166,1749,3,1,3,0,1,0,66.67
桃園縣,大園鄉,橫峰村,373,1,923,8,931,1292,3,1,3,0,1,0,72.06
桃園縣,大園鄉,五權村,374,1,737,17,754,1070,3,1,3,0,1,0,70.47
桃園縣,大園鄉,五權村,375,1,891,11,902,1284,3,1,3,0,1,0,70.25
桃園縣,大園鄉,五權村,376,1,882,18,900,1274,3,1,3,0,1,0,70.64
桃園縣,大園鄉,埔心村,377,1,892,10,902,1192,3,1,3,0,1,0,75.67
桃園縣,大園鄉,埔心村,378,1,877,18,895,1353,3,1,3,0,1,0,66.15
桃園縣,大園鄉,埔心村,379,1,1108,13,1121,1622,3,1,3,0,1,0,69.11
桃園縣,大園鄉,大海村,380,1,934,19,953,1258,3,1,3,0,1,0,75.76
桃園縣,大園鄉,建華村,381,1,681,14,695,939,3,1,3,0,1,0,74.01
桃園縣,大園鄉,三石村,382,1,700,14,714,1022,3,1,3,0,1,0,69.86
桃園縣,大園鄉,三石村,383,1,1042,16,1058,1407,3,1,3,0,1,0,75.20
桃園縣,大園鄉,菓林村,384,1,1156,25,1181,1676,3,1,3,0,1,0,70.47
桃園縣,大園鄉,菓林村,385,1,768,11,779,1186,3,1,3,0,1,0,65.68
桃園縣,大園鄉,菓林村,386,1,808,21,829,1295,3,1,3,0,1,0,64.02
桃園縣,大園鄉,竹圍村,387,1,597,7,604,822,3,1,3,0,1,0,73.48
桃園縣,大園鄉,竹圍村,388,1,896,5,901,1384,3,1,3,0,1,0,65.10
桃園縣,大園鄉,海口村,389,1,864,15,879,1333,3,1,3,0,1,0,65.94
桃園縣,大園鄉,沙崙村,390,1,770,13,783,1192,3,1,3,0,1,0,65.69
桃園縣,大園鄉,沙崙村,391,1,872,9,881,1300,3,1,3,0,1,0,67.77
桃園縣,大園鄉,后厝村,392,1,1156,12,1168,1627,3,1,3,0,1,0,71.79
桃園縣,大園鄉,圳頭村,393,1,581,13,594,832,3,1,3,0,1,0,71.39
桃園縣,大園鄉,圳頭村,394,1,732,7,739,1049,3,1,3,0,1,0,70.45
桃園縣,大園鄉,內海村,395,1,1218,17,1235,1714,3,1,3,0,1,0,72.05
桃園縣,大園鄉,北港村,396,1,818,5,823,1172,3,1,3,0,1,0,70.22
桃園縣,大園鄉,北港村,397,1,649,8,657,1027,3,1,3,0,1,0,63.97
桃園縣,大園鄉,南港村,398,1,761,9,770,1277,3,1,3,0,1,0,60.30
桃園縣,大園鄉,南港村,399,1,673,11,684,1192,3,1,3,0,1,0,57.38
桃園縣,大溪鎮,興和里,400,1,619,11,630,836,3,1,3,0,1,0,75.36
桃園縣,大溪鎮,興和里,401,1,565,4,569,795,3,1,3,0,1,0,71.57
桃園縣,大溪鎮,福仁里,402,1,750,4,754,1111,3,1,3,0,1,0,67.87
桃園縣,大溪鎮,田心里,403,1,866,14,880,1277,3,1,3,0,1,0,68.91
桃園縣,大溪鎮,田心里,404,1,733,7,740,1103,3,1,3,0,1,0,67.09
桃園縣,大溪鎮,田心里,405,1,760,10,770,1144,3,1,3,0,1,0,67.31
桃園縣,大溪鎮,一心里,406,1,688,7,695,1064,3,1,3,0,1,0,65.32
桃園縣,大溪鎮,一心里,407,1,736,8,744,1053,3,1,3,0,1,0,70.66
桃園縣,大溪鎮,一心里,408,1,725,7,732,1016,3,1,3,0,1,0,72.05
桃園縣,大溪鎮,一德里,409,1,918,13,931,1410,3,1,3,0,1,0,66.03
桃園縣,大溪鎮,一德里,410,1,838,6,844,1165,3,1,3,0,1,0,72.45
桃園縣,大溪鎮,一德里,411,1,798,13,811,1222,3,1,3,0,1,0,66.37
桃園縣,大溪鎮,月眉里,412,1,733,12,745,1012,3,1,3,0,1,0,73.62
桃園縣,大溪鎮,永福里,413,1,574,19,593,898,3,1,3,0,1,0,66.04
桃園縣,大溪鎮,康安里,414,1,708,11,719,995,3,1,3,0,1,0,72.26
桃園縣,大溪鎮,義和里,415,1,696,8,704,971,3,1,3,0,1,0,72.50
桃園縣,大溪鎮,義和里,416,1,394,8,402,574,3,1,3,0,1,0,70.03
桃園縣,大溪鎮,美華里,417,1,657,6,663,958,3,1,3,0,1,0,69.21
桃園縣,大溪鎮,美華里,418,1,650,7,657,945,3,1,3,0,1,0,69.52
桃園縣,大溪鎮,美華里,419,1,508,1,509,730,3,1,3,0,1,0,69.73
桃園縣,大溪鎮,福安里,420,1,730,13,743,1152,3,1,3,0,1,0,64.50
桃園縣,大溪鎮,福安里,421,1,681,16,697,958,3,1,3,0,1,0,72.76
桃園縣,大溪鎮,復興里,422,1,604,12,616,916,3,1,3,0,1,0,67.25
桃園縣,大溪鎮,新峰里,423,1,434,9,443,655,3,1,3,0,1,0,67.63
桃園縣,大溪鎮,新峰里,424,1,173,3,176,285,3,1,3,0,1,0,61.75
桃園縣,大溪鎮,中新里,425,1,593,10,603,794,3,1,3,0,1,0,75.94
桃園縣,大溪鎮,中新里,426,1,512,13,525,748,3,1,3,0,1,0,70.19
桃園縣,大溪鎮,瑞興里,427,1,966,15,981,1388,3,1,3,0,1,0,70.68
桃園縣,大溪鎮,瑞興里,428,1,454,10,464,653,3,1,3,0,1,0,71.06
桃園縣,大溪鎮,仁善里,429,1,984,16,1000,1492,3,1,3,0,1,0,67.02
桃園縣,大溪鎮,仁善里,430,1,592,10,602,860,3,1,3,0,1,0,70.00
桃園縣,大溪鎮,僑愛里,431,1,580,7,587,821,3,1,3,0,1,0,71.50
桃園縣,大溪鎮,仁義里,432,1,681,8,689,951,3,1,3,0,1,0,72.45
桃園縣,大溪鎮,仁義里,433,1,602,17,619,832,3,1,3,0,1,0,74.40
桃園縣,大溪鎮,仁義里,434,1,634,14,648,858,3,1,3,0,1,0,75.52
桃園縣,大溪鎮,仁和里,435,1,488,6,494,805,3,1,3,0,1,0,61.37
桃園縣,大溪鎮,仁和里,436,1,737,16,753,1123,3,1,3,0,1,0,67.05
桃園縣,大溪鎮,仁愛里,437,1,778,11,789,1065,3,1,3,0,1,0,74.08
桃園縣,大溪鎮,仁愛里,438,1,440,3,443,705,3,1,3,0,1,0,62.84
桃園縣,大溪鎮,仁武里,439,1,997,11,1008,1347,3,1,3,0,1,0,74.83
桃園縣,大溪鎮,仁武里,440,1,826,10,836,1188,3,1,3,0,1,0,70.37
桃園縣,大溪鎮,仁文里,441,1,819,15,834,1191,3,1,3,0,1,0,70.03
桃園縣,大溪鎮,仁文里,442,1,629,9,638,951,3,1,3,0,1,0,67.09
桃園縣,大溪鎮,仁文里,443,1,466,10,476,677,3,1,3,0,1,0,70.31
桃園縣,大溪鎮,南興里,444,1,805,11,816,1175,3,1,3,0,1,0,69.45
桃園縣,大溪鎮,南興里,445,1,958,17,975,1399,3,1,3,0,1,0,69.69
桃園縣,大溪鎮,南興里,446,1,831,14,845,1191,3,1,3,0,1,0,70.95
桃園縣,大溪鎮,員林里,447,1,770,11,781,1127,3,1,3,0,1,0,69.30
桃園縣,大溪鎮,光明里,448,1,492,9,501,799,3,1,3,0,1,0,62.70
桃園縣,大溪鎮,光明里,449,1,635,13,648,941,3,1,3,0,1,0,68.86
桃園縣,大溪鎮,瑞源里,450,1,1028,22,1050,1514,3,1,3,0,1,0,69.35
桃園縣,大溪鎮,瑞源里,451,1,932,10,942,1349,3,1,3,0,1,0,69.83
桃園縣,大溪鎮,三元里,452,1,683,7,690,1010,3,1,3,0,1,0,68.32
桃園縣,大溪鎮,三元里,453,1,638,10,648,942,3,1,3,0,1,0,68.79
桃園縣,大溪鎮,三元里,454,1,683,7,690,970,3,1,3,0,1,0,71.13
桃園縣,復興鄉,三民村,455,1,779,18,797,1168,3,1,3,0,1,0,68.24
桃園縣,復興鄉,澤仁村,456,1,451,5,456,638,3,1,3,0,1,0,71.47
桃園縣,復興鄉,霞雲村,457,1,30,2,32,45,3,1,3,0,1,0,71.11
桃園縣,復興鄉,義盛村,458,1,29,1,30,45,3,1,3,0,1,0,66.67
桃園縣,復興鄉,羅浮村,459,1,191,3,194,310,3,1,3,0,1,0,62.58
桃園縣,復興鄉,奎輝村,460,1,19,0,19,43,3,1,3,0,1,0,44.19
桃園縣,復興鄉,長興村,461,1,62,2,64,95,3,1,3,0,1,0,67.37
桃園縣,復興鄉,高義村,462,1,27,1,28,50,3,1,3,0,1,0,56.00
桃園縣,復興鄉,三光村,463,1,22,0,22,46,3,1,3,0,1,0,47.83
桃園縣,復興鄉,華陵村,464,1,158,2,160,301,3,1,3,0,1,0,53.16
桃園縣,中壢市,後寮里,465,1,952,11,963,1510,3,1,3,0,1,0,63.77
桃園縣,中壢市,後寮里,466,1,963,12,975,1480,3,1,3,0,1,0,65.88
桃園縣,中壢市,明德里,467,1,1089,18,1107,1613,3,1,3,0,1,0,68.63
桃園縣,中壢市,明德里,468,1,1067,7,1074,1532,3,1,3,0,1,0,70.10
桃園縣,中壢市,至善里,469,1,724,10,734,1084,3,1,3,0,1,0,67.71
桃園縣,中壢市,至善里,470,1,1050,15,1065,1537,3,1,3,0,1,0,69.29
桃園縣,中壢市,至善里,471,1,874,14,888,1426,3,1,3,0,1,0,62.27
桃園縣,中壢市,龍興里,472,1,813,14,827,1151,3,1,3,0,1,0,71.85
桃園縣,中壢市,龍興里,473,1,732,8,740,1082,3,1,3,0,1,0,68.39
桃園縣,中壢市,龍興里,474,1,793,11,804,1140,3,1,3,0,1,0,70.53
桃園縣,中壢市,龍德里,475,1,1025,15,1040,1419,3,1,3,0,1,0,73.29
桃園縣,中壢市,龍德里,476,1,925,16,941,1325,3,1,3,0,1,0,71.02
桃園縣,中壢市,龍岡里,477,1,902,14,916,1289,3,1,3,0,1,0,71.06
桃園縣,中壢市,龍岡里,478,1,799,11,810,1137,3,1,3,0,1,0,71.24
桃園縣,中壢市,龍岡里,479,1,871,15,886,1269,3,1,3,0,1,0,69.82
桃園縣,中壢市,龍東里,480,1,924,8,932,1330,3,1,3,0,1,0,70.08
桃園縣,中壢市,龍東里,481,1,982,29,1011,1387,3,1,3,0,1,0,72.89
桃園縣,中壢市,龍東里,482,1,955,19,974,1334,3,1,3,0,1,0,73.01
桃園縣,中壢市,龍昌里,483,1,937,14,951,1382,3,1,3,0,1,0,68.81
桃園縣,中壢市,龍昌里,484,1,995,24,1019,1398,3,1,3,0,1,0,72.89
桃園縣,中壢市,龍昌里,485,1,1074,33,1107,1555,3,1,3,0,1,0,71.19
桃園縣,中壢市,龍平里,486,1,989,12,1001,1357,3,1,3,0,1,0,73.77
桃園縣,中壢市,龍平里,487,1,1062,24,1086,1489,3,1,3,0,1,0,72.93
桃園縣,中壢市,龍安里,488,1,798,12,810,1065,3,1,3,0,1,0,76.06
桃園縣,中壢市,龍安里,489,1,953,17,970,1331,3,1,3,0,1,0,72.88
桃園縣,中壢市,仁美里,490,1,814,10,824,1168,3,1,3,0,1,0,70.55
桃園縣,中壢市,仁美里,491,1,888,17,905,1271,3,1,3,0,1,0,71.20
桃園縣,中壢市,仁美里,492,1,597,10,607,820,3,1,3,0,1,0,74.02
桃園縣,中壢市,仁福里,493,1,747,8,755,1089,3,1,3,0,1,0,69.33
桃園縣,中壢市,仁福里,494,1,817,14,831,1130,3,1,3,0,1,0,73.54
桃園縣,中壢市,仁福里,495,1,846,17,863,1313,3,1,3,0,1,0,65.73
桃園縣,中壢市,仁愛里,496,1,775,10,785,1109,3,1,3,0,1,0,70.78
桃園縣,中壢市,仁愛里,497,1,865,12,877,1234,3,1,3,0,1,0,71.07
桃園縣,中壢市,仁愛里,498,1,974,22,996,1411,3,1,3,0,1,0,70.59
桃園縣,中壢市,仁德里,499,1,924,17,941,1305,3,1,3,0,1,0,72.11
桃園縣,中壢市,仁德里,500,1,1232,20,1252,1852,3,1,3,0,1,0,67.60
桃園縣,中壢市,仁德里,501,1,884,13,897,1293,3,1,3,0,1,0,69.37
桃園縣,中壢市,仁祥里,502,1,864,16,880,1268,3,1,3,0,1,0,69.40
桃園縣,中壢市,仁祥里,503,1,895,11,906,1306,3,1,3,0,1,0,69.37
桃園縣,中壢市,華勛里,504,1,1060,14,1074,1458,3,1,3,0,1,0,73.66
桃園縣,中壢市,華勛里,505,1,917,17,934,1295,3,1,3,0,1,0,72.12
桃園縣,中壢市,中堅里,506,1,856,22,878,1196,3,1,3,0,1,0,73.41
桃園縣,中壢市,中堅里,507,1,718,17,735,1085,3,1,3,0,1,0,67.74
桃園縣,中壢市,中堅里,508,1,599,16,615,846,3,1,3,0,1,0,72.70
桃園縣,中壢市,中堅里,509,1,617,12,629,898,3,1,3,0,1,0,70.04
桃園縣,中壢市,普仁里,510,1,706,12,718,1056,3,1,3,0,1,0,67.99
桃園縣,中壢市,普仁里,511,1,678,10,688,1033,3,1,3,0,1,0,66.60
桃園縣,中壢市,普仁里,512,1,654,14,668,1016,3,1,3,0,1,0,65.75
桃園縣,中壢市,普忠里,513,1,788,9,797,1211,3,1,3,0,1,0,65.81
桃園縣,中壢市,普忠里,514,1,692,7,699,1117,3,1,3,0,1,0,62.58
桃園縣,中壢市,普強里,515,1,1083,10,1093,1472,3,1,3,0,1,0,74.25
桃園縣,中壢市,普強里,516,1,898,13,911,1251,3,1,3,0,1,0,72.82
桃園縣,中壢市,信義里,517,1,930,9,939,1267,3,1,3,0,1,0,74.11
桃園縣,中壢市,信義里,518,1,1132,13,1145,1643,3,1,3,0,1,0,69.69
桃園縣,中壢市,正義里,519,1,1185,15,1200,1724,3,1,3,0,1,0,69.61
桃園縣,中壢市,正義里,520,1,1012,18,1030,1458,3,1,3,0,1,0,70.64
桃園縣,中壢市,普慶里,521,1,813,11,824,1145,3,1,3,0,1,0,71.97
桃園縣,中壢市,普慶里,522,1,818,10,828,1106,3,1,3,0,1,0,74.86
桃園縣,中壢市,普義里,523,1,662,10,672,936,3,1,3,0,1,0,71.79
桃園縣,中壢市,普義里,524,1,556,11,567,847,3,1,3,0,1,0,66.94
桃園縣,中壢市,德義里,525,1,686,10,696,971,3,1,3,0,1,0,71.68
桃園縣,中壢市,德義里,526,1,821,8,829,1214,3,1,3,0,1,0,68.29
桃園縣,中壢市,仁義里,527,1,919,12,931,1370,3,1,3,0,1,0,67.96
桃園縣,中壢市,仁義里,528,1,632,15,647,955,3,1,3,0,1,0,67.75
桃園縣,中壢市,忠義里,529,1,1013,15,1028,1476,3,1,3,0,1,0,69.65
桃園縣,中壢市,興仁里,530,1,910,10,920,1255,3,1,3,0,1,0,73.31
桃園縣,中壢市,興仁里,531,1,768,12,780,1180,3,1,3,0,1,0,66.10
桃園縣,中壢市,興仁里,532,1,865,10,875,1209,3,1,3,0,1,0,72.37
桃園縣,中壢市,中正里,533,1,1101,17,1118,1675,3,1,3,0,1,0,66.75
桃園縣,中壢市,中正里,534,1,1148,14,1162,1673,3,1,3,0,1,0,69.46
桃園縣,中壢市,中山里,535,1,829,10,839,1250,3,1,3,0,1,0,67.12
桃園縣,中壢市,中山里,536,1,970,17,987,1503,3,1,3,0,1,0,65.67
桃園縣,中壢市,中山里,537,1,1065,15,1080,1642,3,1,3,0,1,0,65.77
桃園縣,中壢市,篤行里,538,1,1067,14,1081,1572,3,1,3,0,1,0,68.77
桃園縣,中壢市,自立里,539,1,893,10,903,1293,3,1,3,0,1,0,69.84
桃園縣,中壢市,自立里,540,1,762,8,770,1181,3,1,3,0,1,0,65.20
桃園縣,中壢市,自強里,541,1,931,14,945,1340,3,1,3,0,1,0,70.52
桃園縣,中壢市,自強里,542,1,960,11,971,1371,3,1,3,0,1,0,70.82
桃園縣,中壢市,自強里,543,1,1182,18,1200,1843,3,1,3,0,1,0,65.11
桃園縣,中壢市,內壢里,544,1,825,13,838,1222,3,1,3,0,1,0,68.58
桃園縣,中壢市,內壢里,545,1,793,14,807,1184,3,1,3,0,1,0,68.16
桃園縣,中壢市,成功里,546,1,843,12,855,1206,3,1,3,0,1,0,70.90
桃園縣,中壢市,成功里,547,1,1031,9,1040,1555,3,1,3,0,1,0,66.88
桃園縣,中壢市,福德里,548,1,890,7,897,1223,3,1,3,0,1,0,73.34
桃園縣,中壢市,福德里,549,1,849,14,863,1238,3,1,3,0,1,0,69.71
桃園縣,中壢市,中原里,550,1,749,14,763,1016,3,1,3,0,1,0,75.10
桃園縣,中壢市,中原里,551,1,745,9,754,1050,3,1,3,0,1,0,71.81
桃園縣,中壢市,中原里,552,1,1040,21,1061,1531,3,1,3,0,1,0,69.30
桃園縣,中壢市,忠孝里,553,1,679,9,688,950,3,1,3,0,1,0,72.42
桃園縣,中壢市,忠孝里,554,1,658,16,674,995,3,1,3,0,1,0,67.74
桃園縣,中壢市,復興里,555,1,768,11,779,1131,3,1,3,0,1,0,68.88
桃園縣,中壢市,復興里,556,1,718,8,726,1103,3,1,3,0,1,0,65.82
桃園縣,中壢市,復興里,557,1,1130,17,1147,1806,3,1,3,0,1,0,63.51
桃園縣,中壢市,復華里,558,1,1169,16,1185,1661,3,1,3,0,1,0,71.34
桃園縣,中壢市,復華里,559,1,1185,16,1201,1647,3,1,3,0,1,0,72.92
桃園縣,中壢市,文化里,560,1,1035,13,1048,1483,3,1,3,0,1,0,70.67
桃園縣,中壢市,文化里,561,1,1180,16,1196,1709,3,1,3,0,1,0,69.98
桃園縣,中壢市,文化里,562,1,843,18,861,1285,3,1,3,0,1,0,67.00
桃園縣,中壢市,和平里,563,1,631,13,644,921,3,1,3,0,1,0,69.92
桃園縣,中壢市,和平里,564,1,671,11,682,963,3,1,3,0,1,0,70.82
桃園縣,中壢市,內定里,565,1,1175,18,1193,1652,3,1,3,0,1,0,72.22
桃園縣,中壢市,內定里,566,1,988,7,995,1425,3,1,3,0,1,0,69.82
桃園縣,中壢市,石頭里,567,1,644,7,651,1022,3,1,3,0,1,0,63.70
桃園縣,中壢市,石頭里,568,1,502,7,509,1001,3,1,3,0,1,0,50.85
桃園縣,中壢市,中央里,569,1,890,11,901,1314,3,1,3,0,1,0,68.57
桃園縣,中壢市,中央里,570,1,602,9,611,930,3,1,3,0,1,0,65.70
桃園縣,中壢市,中央里,571,1,784,7,791,1068,3,1,3,0,1,0,74.06
桃園縣,中壢市,新興里,572,1,977,19,996,1463,3,1,3,0,1,0,68.08
桃園縣,中壢市,新興里,573,1,798,10,808,1177,3,1,3,0,1,0,68.65
桃園縣,中壢市,新興里,574,1,1054,16,1070,1587,3,1,3,0,1,0,67.42
桃園縣,中壢市,新興里,575,1,918,12,930,1389,3,1,3,0,1,0,66.95
桃園縣,中壢市,振興里,576,1,972,20,992,1496,3,1,3,0,1,0,66.31
桃園縣,中壢市,振興里,577,1,978,7,985,1346,3,1,3,0,1,0,73.18
桃園縣,中壢市,振興里,578,1,696,8,704,949,3,1,3,0,1,0,74.18
桃園縣,中壢市,東興里,579,1,921,14,935,1358,3,1,3,0,1,0,68.85
桃園縣,中壢市,東興里,580,1,984,12,996,1471,3,1,3,0,1,0,67.71
桃園縣,中壢市,東興里,581,1,886,13,899,1279,3,1,3,0,1,0,70.29
桃園縣,中壢市,東興里,582,1,803,14,817,1119,3,1,3,0,1,0,73.01
桃園縣,中壢市,水尾里,583,1,913,11,924,1289,3,1,3,0,1,0,71.68
桃園縣,中壢市,水尾里,584,1,892,14,906,1306,3,1,3,0,1,0,69.37
桃園縣,中壢市,水尾里,585,1,1585,17,1602,2273,3,1,3,0,1,0,70.48
桃園縣,中壢市,忠福里,586,1,805,15,820,1146,3,1,3,0,1,0,71.55
桃園縣,中壢市,忠福里,587,1,811,14,825,1057,3,1,3,0,1,0,78.05
桃園縣,中壢市,忠福里,588,1,936,17,953,1339,3,1,3,0,1,0,71.17
桃園縣,中壢市,忠福里,589,1,958,15,973,1476,3,1,3,0,1,0,65.92
桃園縣,中壢市,幸福里,590,1,860,8,868,1264,3,1,3,0,1,0,68.67
桃園縣,中壢市,幸福里,591,1,821,6,827,1269,3,1,3,0,1,0,65.17
桃園縣,中壢市,幸福里,592,1,885,10,895,1373,3,1,3,0,1,0,65.19
桃園縣,中壢市,永福里,593,1,575,9,584,844,3,1,3,0,1,0,69.19
桃園縣,中壢市,永福里,594,1,1017,10,1027,1481,3,1,3,0,1,0,69.35
桃園縣,中壢市,永福里,595,1,1115,11,1126,1667,3,1,3,0,1,0,67.55
桃園縣,中壢市,青埔里,596,1,762,9,771,1088,3,1,3,0,1,0,70.86
桃園縣,中壢市,新街里,597,1,1251,6,1257,1858,3,1,3,0,1,0,67.65
桃園縣,中壢市,興南里,598,1,1091,8,1099,1640,3,1,3,0,1,0,67.01
桃園縣,中壢市,興國里,599,1,883,6,889,1338,3,1,3,0,1,0,66.44
桃園縣,中壢市,興國里,600,1,1091,19,1110,1519,3,1,3,0,1,0,73.07
桃園縣,中壢市,興國里,601,1,1113,11,1124,1642,3,1,3,0,1,0,68.45
桃園縣,中壢市,興和里,602,1,768,6,774,1067,3,1,3,0,1,0,72.54
桃園縣,中壢市,興和里,603,1,979,10,989,1389,3,1,3,0,1,0,71.20
桃園縣,中壢市,永興里,604,1,707,16,723,1014,3,1,3,0,1,0,71.30
桃園縣,中壢市,中壢里,605,1,590,6,596,838,3,1,3,0,1,0,71.12
桃園縣,中壢市,中榮里,606,1,654,5,659,996,3,1,3,0,1,0,66.16
桃園縣,中壢市,中建里,607,1,715,6,721,1100,3,1,3,0,1,0,65.55
桃園縣,中壢市,舊明里,608,1,839,8,847,1161,3,1,3,0,1,0,72.95
桃園縣,中壢市,舊明里,609,1,681,10,691,966,3,1,3,0,1,0,71.53
桃園縣,中壢市,新明里,610,1,699,12,711,1001,3,1,3,0,1,0,71.03
桃園縣,中壢市,新明里,611,1,777,12,789,1100,3,1,3,0,1,0,71.73
桃園縣,中壢市,新明里,612,1,995,13,1008,1429,3,1,3,0,1,0,70.54
桃園縣,中壢市,光明里,613,1,843,16,859,1302,3,1,3,0,1,0,65.98
桃園縣,中壢市,光明里,614,1,1024,9,1033,1471,3,1,3,0,1,0,70.22
桃園縣,中壢市,光明里,615,1,1070,12,1082,1546,3,1,3,0,1,0,69.99
桃園縣,中壢市,永光里,616,1,927,13,940,1323,3,1,3,0,1,0,71.05
桃園縣,中壢市,永光里,617,1,1272,13,1285,1860,3,1,3,0,1,0,69.09
桃園縣,中壢市,三民里,618,1,878,16,894,1247,3,1,3,0,1,0,71.69
桃園縣,中壢市,三民里,619,1,869,18,887,1254,3,1,3,0,1,0,70.73
桃園縣,中壢市,五權里,620,1,705,17,722,1132,3,1,3,0,1,0,63.78
桃園縣,中壢市,五權里,621,1,939,13,952,1376,3,1,3,0,1,0,69.19
桃園縣,中壢市,五權里,622,1,960,14,974,1422,3,1,3,0,1,0,68.50
桃園縣,中壢市,五福里,623,1,1178,15,1193,1731,3,1,3,0,1,0,68.92
桃園縣,中壢市,五福里,624,1,1004,10,1014,1482,3,1,3,0,1,0,68.42
桃園縣,中壢市,芝芭里,625,1,597,8,605,812,3,1,3,0,1,0,74.51
桃園縣,中壢市,芝芭里,626,1,808,13,821,1149,3,1,3,0,1,0,71.45
桃園縣,中壢市,洽溪里,627,1,818,12,830,1216,3,1,3,0,1,0,68.26
桃園縣,中壢市,內厝里,628,1,1185,13,1198,1771,3,1,3,0,1,0,67.65
桃園縣,中壢市,內厝里,629,1,1156,9,1165,1624,3,1,3,0,1,0,71.74
桃園縣,中壢市,月眉里,630,1,1166,13,1179,1567,3,1,3,0,1,0,75.24
桃園縣,中壢市,月眉里,631,1,1006,16,1022,1420,3,1,3,0,1,0,71.97
桃園縣,中壢市,山東里,632,1,918,22,940,1309,3,1,3,0,1,0,71.81
桃園縣,中壢市,山東里,633,1,1038,16,1054,1428,3,1,3,0,1,0,73.81
桃園縣,中壢市,過嶺里,634,1,882,13,895,1179,3,1,3,0,1,0,75.91
桃園縣,中壢市,過嶺里,635,1,829,7,836,1143,3,1,3,0,1,0,73.14
桃園縣,平鎮市,新勢里,636,1,1056,19,1075,1590,3,1,3,0,1,0,67.61
桃園縣,平鎮市,新勢里,637,1,1244,20,1264,1782,3,1,3,0,1,0,70.93
桃園縣,平鎮市,新榮里,638,1,853,12,865,1230,3,1,3,0,1,0,70.33
桃園縣,平鎮市,新榮里,639,1,954,13,967,1445,3,1,3,0,1,0,66.92
桃園縣,平鎮市,新榮里,640,1,680,13,693,1074,3,1,3,0,1,0,64.53
桃園縣,平鎮市,新富里,641,1,789,12,801,1185,3,1,3,0,1,0,67.59
桃園縣,平鎮市,新富里,642,1,1247,14,1261,1908,3,1,3,0,1,0,66.09
桃園縣,平鎮市,新富里,643,1,1108,8,1116,1631,3,1,3,0,1,0,68.42
桃園縣,平鎮市,新貴里,644,1,926,16,942,1365,3,1,3,0,1,0,69.01
桃園縣,平鎮市,新貴里,645,1,858,10,868,1158,3,1,3,0,1,0,74.96
桃園縣,平鎮市,北安里,646,1,1116,13,1129,1574,3,1,3,0,1,0,71.73
桃園縣,平鎮市,北勢里,647,1,821,15,836,1206,3,1,3,0,1,0,69.32
桃園縣,平鎮市,北勢里,648,1,743,14,757,1079,3,1,3,0,1,0,70.16
桃園縣,平鎮市,北華里,649,1,870,12,882,1280,3,1,3,0,1,0,68.91
桃園縣,平鎮市,北華里,650,1,668,13,681,937,3,1,3,0,1,0,72.68
桃園縣,平鎮市,金陵里,651,1,1166,17,1183,1597,3,1,3,0,1,0,74.08
桃園縣,平鎮市,北興里,652,1,655,7,662,899,3,1,3,0,1,0,73.64
桃園縣,平鎮市,北興里,653,1,792,10,802,1136,3,1,3,0,1,0,70.60
桃園縣,平鎮市,北興里,654,1,971,19,990,1427,3,1,3,0,1,0,69.38
桃園縣,平鎮市,北貴里,655,1,940,16,956,1335,3,1,3,0,1,0,71.61
桃園縣,平鎮市,北貴里,656,1,1077,21,1098,1543,3,1,3,0,1,0,71.16
桃園縣,平鎮市,北富里,657,1,1142,17,1159,1679,3,1,3,0,1,0,69.03
桃園縣,平鎮市,北富里,658,1,912,13,925,1263,3,1,3,0,1,0,73.24
桃園縣,平鎮市,龍恩里,659,1,692,12,704,1049,3,1,3,0,1,0,67.11
桃園縣,平鎮市,龍恩里,660,1,1001,20,1021,1471,3,1,3,0,1,0,69.41
桃園縣,平鎮市,東社里,661,1,1066,15,1081,1506,3,1,3,0,1,0,71.78
桃園縣,平鎮市,東社里,662,1,1081,9,1090,1537,3,1,3,0,1,0,70.92
桃園縣,平鎮市,龍興里,663,1,730,13,743,1066,3,1,3,0,1,0,69.70
桃園縣,平鎮市,龍興里,664,1,767,19,786,1091,3,1,3,0,1,0,72.04
桃園縣,平鎮市,忠貞里,665,1,893,26,919,1282,3,1,3,0,1,0,71.68
桃園縣,平鎮市,中正里,666,1,899,16,915,1264,3,1,3,0,1,0,72.39
桃園縣,平鎮市,貿易里,667,1,972,7,979,1285,3,1,3,0,1,0,76.19
桃園縣,平鎮市,貿易里,668,1,683,8,691,938,3,1,3,0,1,0,73.67
桃園縣,平鎮市,建安里,669,1,826,19,845,1212,3,1,3,0,1,0,69.72
桃園縣,平鎮市,建安里,670,1,740,13,753,1085,3,1,3,0,1,0,69.40
桃園縣,平鎮市,建安里,671,1,706,13,719,980,3,1,3,0,1,0,73.37
桃園縣,平鎮市,華安里,672,1,1124,16,1140,1625,3,1,3,0,1,0,70.15
桃園縣,平鎮市,華安里,673,1,1033,11,1044,1428,3,1,3,0,1,0,73.11
桃園縣,平鎮市,新安里,674,1,927,17,944,1418,3,1,3,0,1,0,66.57
桃園縣,平鎮市,新安里,675,1,960,13,973,1391,3,1,3,0,1,0,69.95
桃園縣,平鎮市,東安里,676,1,783,18,801,1073,3,1,3,0,1,0,74.65
桃園縣,平鎮市,東安里,677,1,724,13,737,1072,3,1,3,0,1,0,68.75
桃園縣,平鎮市,東勢里,678,1,909,15,924,1296,3,1,3,0,1,0,71.30
桃園縣,平鎮市,東勢里,679,1,883,16,899,1214,3,1,3,0,1,0,74.05
桃園縣,平鎮市,東勢里,680,1,764,16,780,1173,3,1,3,0,1,0,66.50
桃園縣,平鎮市,莊敬里,681,1,941,20,961,1326,3,1,3,0,1,0,72.47
桃園縣,平鎮市,莊敬里,682,1,892,15,907,1248,3,1,3,0,1,0,72.68
桃園縣,平鎮市,莊敬里,683,1,862,14,876,1301,3,1,3,0,1,0,67.33
桃園縣,平鎮市,福林里,684,1,568,12,580,799,3,1,3,0,1,0,72.59
桃園縣,平鎮市,福林里,685,1,805,8,813,1143,3,1,3,0,1,0,71.13
桃園縣,平鎮市,山峰里,686,1,755,10,765,1084,3,1,3,0,1,0,70.57
桃園縣,平鎮市,山峰里,687,1,818,18,836,1125,3,1,3,0,1,0,74.31
桃園縣,平鎮市,湧豐里,688,1,936,16,952,1365,3,1,3,0,1,0,69.74
桃園縣,平鎮市,湧光里,689,1,1026,10,1036,1435,3,1,3,0,1,0,72.20
桃園縣,平鎮市,湧光里,690,1,979,15,994,1477,3,1,3,0,1,0,67.30
桃園縣,平鎮市,湧光里,691,1,1030,12,1042,1457,3,1,3,0,1,0,71.52
桃園縣,平鎮市,湧安里,692,1,832,22,854,1277,3,1,3,0,1,0,66.88
桃園縣,平鎮市,湧安里,693,1,953,26,979,1452,3,1,3,0,1,0,67.42
桃園縣,平鎮市,廣興里,694,1,811,13,824,1166,3,1,3,0,1,0,70.67
桃園縣,平鎮市,廣興里,695,1,915,13,928,1352,3,1,3,0,1,0,68.64
桃園縣,平鎮市,廣興里,696,1,777,9,786,1177,3,1,3,0,1,0,66.78
桃園縣,平鎮市,廣達里,697,1,934,14,948,1414,3,1,3,0,1,0,67.04
桃園縣,平鎮市,廣達里,698,1,1082,15,1097,1538,3,1,3,0,1,0,71.33
桃園縣,平鎮市,復旦里,699,1,1087,9,1096,1559,3,1,3,0,1,0,70.30
桃園縣,平鎮市,復旦里,700,1,1132,15,1147,1671,3,1,3,0,1,0,68.64
桃園縣,平鎮市,復旦里,701,1,1009,10,1019,1530,3,1,3,0,1,0,66.60
桃園縣,平鎮市,復旦里,702,1,854,13,867,1209,3,1,3,0,1,0,71.71
桃園縣,平鎮市,義興里,703,1,1201,14,1215,1690,3,1,3,0,1,0,71.89
桃園縣,平鎮市,義興里,704,1,1112,19,1131,1602,3,1,3,0,1,0,70.60
桃園縣,平鎮市,義興里,705,1,991,16,1007,1394,3,1,3,0,1,0,72.24
桃園縣,平鎮市,義民里,706,1,1032,19,1051,1531,3,1,3,0,1,0,68.65
桃園縣,平鎮市,義民里,707,1,1055,7,1062,1652,3,1,3,0,1,0,64.29
桃園縣,平鎮市,宋屋里,708,1,902,15,917,1385,3,1,3,0,1,0,66.21
桃園縣,平鎮市,宋屋里,709,1,1076,18,1094,1692,3,1,3,0,1,0,64.66
桃園縣,平鎮市,宋屋里,710,1,1186,28,1214,2007,3,1,3,0,1,0,60.49
桃園縣,平鎮市,廣仁里,711,1,734,14,748,1113,3,1,3,0,1,0,67.21
桃園縣,平鎮市,廣仁里,712,1,693,16,709,1076,3,1,3,0,1,0,65.89
桃園縣,平鎮市,廣仁里,713,1,774,14,788,1222,3,1,3,0,1,0,64.48
桃園縣,平鎮市,雙連里,714,1,972,15,987,1338,3,1,3,0,1,0,73.77
桃園縣,平鎮市,雙連里,715,1,819,8,827,1187,3,1,3,0,1,0,69.67
桃園縣,平鎮市,雙連里,716,1,699,26,725,1076,3,1,3,0,1,0,67.38
桃園縣,平鎮市,高雙里,717,1,821,19,840,1153,3,1,3,0,1,0,72.85
桃園縣,平鎮市,高雙里,718,1,1026,11,1037,1480,3,1,3,0,1,0,70.07
桃園縣,平鎮市,平鎮里,719,1,617,14,631,950,3,1,3,0,1,0,66.42
桃園縣,平鎮市,平鎮里,720,1,838,18,856,1197,3,1,3,0,1,0,71.51
桃園縣,平鎮市,平鎮里,721,1,697,12,709,978,3,1,3,0,1,0,72.49
桃園縣,平鎮市,鎮興里,722,1,817,12,829,1164,3,1,3,0,1,0,71.22
桃園縣,平鎮市,鎮興里,723,1,722,21,743,1042,3,1,3,0,1,0,71.31
桃園縣,平鎮市,金星里,724,1,871,16,887,1390,3,1,3,0,1,0,63.81
桃園縣,平鎮市,金星里,725,1,846,20,866,1282,3,1,3,0,1,0,67.55
桃園縣,平鎮市,金星里,726,1,694,20,714,1063,3,1,3,0,1,0,67.17
桃園縣,平鎮市,金星里,727,1,966,21,987,1438,3,1,3,0,1,0,68.64
桃園縣,平鎮市,金星里,728,1,943,15,958,1377,3,1,3,0,1,0,69.57
桃園縣,平鎮市,金星里,729,1,975,13,988,1424,3,1,3,0,1,0,69.38
桃園縣,平鎮市,南勢里,730,1,738,10,748,1080,3,1,3,0,1,0,69.26
桃園縣,平鎮市,南勢里,731,1,871,15,886,1260,3,1,3,0,1,0,70.32
桃園縣,平鎮市,南勢里,732,1,675,13,688,1031,3,1,3,0,1,0,66.73
桃園縣,楊梅鎮,仁美里,733,1,729,14,743,1129,3,1,3,0,1,0,65.81
桃園縣,楊梅鎮,仁美里,734,1,1069,24,1093,1544,3,1,3,0,1,0,70.79
桃園縣,楊梅鎮,仁美里,735,1,804,15,819,1109,3,1,3,0,1,0,73.85
桃園縣,楊梅鎮,埔心里,736,1,1049,13,1062,1479,3,1,3,0,1,0,71.81
桃園縣,楊梅鎮,光華里,737,1,803,16,819,1107,3,1,3,0,1,0,73.98
桃園縣,楊梅鎮,光華里,738,1,1044,12,1056,1460,3,1,3,0,1,0,72.33
桃園縣,楊梅鎮,金龍里,739,1,997,11,1008,1317,3,1,3,0,1,0,76.54
桃園縣,楊梅鎮,四維里,740,1,604,6,610,839,3,1,3,0,1,0,72.71
桃園縣,楊梅鎮,四維里,741,1,735,13,748,1030,3,1,3,0,1,0,72.62
桃園縣,楊梅鎮,永平里,742,1,815,23,838,1330,3,1,3,0,1,0,63.01
桃園縣,楊梅鎮,瑞塘里,743,1,830,11,841,1228,3,1,3,0,1,0,68.49
桃園縣,楊梅鎮,瑞塘里,744,1,658,12,670,1079,3,1,3,0,1,0,62.09
桃園縣,楊梅鎮,瑞塘里,745,1,822,15,837,1261,3,1,3,0,1,0,66.38
桃園縣,楊梅鎮,瑞坪里,746,1,714,11,725,1076,3,1,3,0,1,0,67.38
桃園縣,楊梅鎮,瑞坪里,747,1,742,14,756,1234,3,1,3,0,1,0,61.26
桃園縣,楊梅鎮,梅溪里,748,1,888,12,900,1305,3,1,3,0,1,0,68.97
桃園縣,楊梅鎮,梅溪里,749,1,768,17,785,1322,3,1,3,0,1,0,59.38
桃園縣,楊梅鎮,金溪里,750,1,718,7,725,1148,3,1,3,0,1,0,63.15
桃園縣,楊梅鎮,金溪里,751,1,568,7,575,997,3,1,3,0,1,0,57.67
桃園縣,楊梅鎮,金溪里,752,1,773,9,782,1199,3,1,3,0,1,0,65.22
桃園縣,楊梅鎮,楊明里,753,1,724,11,735,1049,3,1,3,0,1,0,70.07
桃園縣,楊梅鎮,楊明里,754,1,1003,15,1018,1521,3,1,3,0,1,0,66.93
桃園縣,楊梅鎮,裕成里,755,1,1165,15,1180,1788,3,1,3,0,1,0,66.00
桃園縣,楊梅鎮,裕成里,756,1,640,6,646,1237,3,1,3,0,1,0,52.22
桃園縣,楊梅鎮,大同里,757,1,901,12,913,1317,3,1,3,0,1,0,69.32
桃園縣,楊梅鎮,大同里,758,1,1010,19,1029,1498,3,1,3,0,1,0,68.69
桃園縣,楊梅鎮,中山里,759,1,653,4,657,967,3,1,3,0,1,0,67.94
桃園縣,楊梅鎮,中山里,760,1,667,7,674,1031,3,1,3,0,1,0,65.37
桃園縣,楊梅鎮,楊梅里,761,1,1108,16,1124,1516,3,1,3,0,1,0,74.14
桃園縣,楊梅鎮,楊梅里,762,1,918,9,927,1286,3,1,3,0,1,0,72.08
桃園縣,楊梅鎮,楊江里,763,1,807,7,814,1206,3,1,3,0,1,0,67.50
桃園縣,楊梅鎮,梅新里,764,1,1073,21,1094,1561,3,1,3,0,1,0,70.08
桃園縣,楊梅鎮,紅梅里,765,1,652,13,665,966,3,1,3,0,1,0,68.84
桃園縣,楊梅鎮,紅梅里,766,1,801,8,809,1149,3,1,3,0,1,0,70.41
桃園縣,楊梅鎮,永寧里,767,1,1159,18,1177,1653,3,1,3,0,1,0,71.20
桃園縣,楊梅鎮,永寧里,768,1,1168,39,1207,1755,3,1,3,0,1,0,68.77
桃園縣,楊梅鎮,大平里,769,1,1010,21,1031,1471,3,1,3,0,1,0,70.09
桃園縣,楊梅鎮,大平里,770,1,945,12,957,1412,3,1,3,0,1,0,67.78
桃園縣,楊梅鎮,秀才里,771,1,936,18,954,1338,3,1,3,0,1,0,71.30
桃園縣,楊梅鎮,秀才里,772,1,877,20,897,1339,3,1,3,0,1,0,66.99
桃園縣,楊梅鎮,東流里,773,1,965,23,988,1441,3,1,3,0,1,0,68.56
桃園縣,楊梅鎮,東流里,774,1,473,10,483,735,3,1,3,0,1,0,65.71
桃園縣,楊梅鎮,豐野里,775,1,1124,19,1143,1617,3,1,3,0,1,0,70.69
桃園縣,楊梅鎮,豐野里,776,1,902,20,922,1294,3,1,3,0,1,0,71.25
桃園縣,楊梅鎮,富岡里,777,1,980,11,991,1336,3,1,3,0,1,0,74.18
桃園縣,楊梅鎮,富岡里,778,1,895,15,910,1254,3,1,3,0,1,0,72.57
桃園縣,楊梅鎮,富岡里,779,1,940,14,954,1432,3,1,3,0,1,0,66.62
桃園縣,楊梅鎮,員本里,780,1,620,12,632,907,3,1,3,0,1,0,69.68
桃園縣,楊梅鎮,員本里,781,1,590,11,601,829,3,1,3,0,1,0,72.50
桃園縣,楊梅鎮,三湖里,782,1,908,15,923,1663,3,1,3,0,1,0,55.50
桃園縣,楊梅鎮,三湖里,783,1,910,17,927,1303,3,1,3,0,1,0,71.14
桃園縣,楊梅鎮,上湖里,784,1,1045,24,1069,1578,3,1,3,0,1,0,67.74
桃園縣,楊梅鎮,上湖里,785,1,931,17,948,1483,3,1,3,0,1,0,63.92
桃園縣,楊梅鎮,上田里,786,1,755,8,763,1065,3,1,3,0,1,0,71.64
桃園縣,楊梅鎮,上田里,787,1,752,10,762,1114,3,1,3,0,1,0,68.40
桃園縣,楊梅鎮,高山里,788,1,761,9,770,1124,3,1,3,0,1,0,68.51
桃園縣,楊梅鎮,高山里,789,1,745,18,763,1213,3,1,3,0,1,0,62.90
桃園縣,楊梅鎮,高山里,790,1,834,15,849,1206,3,1,3,0,1,0,70.40
桃園縣,楊梅鎮,青山里,791,1,915,26,941,1622,3,1,3,0,1,0,58.01
桃園縣,楊梅鎮,高榮里,792,1,860,19,879,1257,3,1,3,0,1,0,69.93
桃園縣,楊梅鎮,高榮里,793,1,533,3,536,788,3,1,3,0,1,0,68.02
桃園縣,楊梅鎮,雙榮里,794,1,1044,15,1059,1449,3,1,3,0,1,0,73.08
桃園縣,楊梅鎮,新榮里,795,1,772,13,785,1091,3,1,3,0,1,0,71.95
桃園縣,楊梅鎮,新榮里,796,1,651,9,660,1006,3,1,3,0,1,0,65.61
桃園縣,楊梅鎮,水美里,797,1,1072,16,1088,1539,3,1,3,0,1,0,70.70
桃園縣,楊梅鎮,水美里,798,1,984,18,1002,1492,3,1,3,0,1,0,67.16
桃園縣,楊梅鎮,瑞原里,799,1,970,19,989,1329,3,1,3,0,1,0,74.42
桃園縣,楊梅鎮,瑞原里,800,1,983,19,1002,1580,3,1,3,0,1,0,63.42
桃園縣,龍潭鄉,黃唐村,801,1,1218,25,1243,1899,3,1,3,0,1,0,65.46
桃園縣,龍潭鄉,黃唐村,802,1,1373,24,1397,2108,3,1,3,0,1,0,66.27
桃園縣,龍潭鄉,黃唐村,803,1,1073,27,1100,1650,3,1,3,0,1,0,66.67
桃園縣,龍潭鄉,中山村,804,1,800,9,809,1113,3,1,3,0,1,0,72.69
桃園縣,龍潭鄉,中山村,805,1,1046,16,1062,1500,3,1,3,0,1,0,70.80
桃園縣,龍潭鄉,中山村,806,1,781,13,794,1074,3,1,3,0,1,0,73.93
桃園縣,龍潭鄉,烏林村,807,1,1085,20,1105,1634,3,1,3,0,1,0,67.63
桃園縣,龍潭鄉,烏林村,808,1,1268,9,1277,2074,3,1,3,0,1,0,61.57
桃園縣,龍潭鄉,烏林村,809,1,911,15,926,1368,3,1,3,0,1,0,67.69
桃園縣,龍潭鄉,烏林村,810,1,1029,19,1048,1549,3,1,3,0,1,0,67.66
桃園縣,龍潭鄉,干城村,811,1,460,15,475,628,3,1,3,0,1,0,75.64
桃園縣,龍潭鄉,凌雲村,812,1,1275,20,1295,1826,3,1,3,0,1,0,70.92
桃園縣,龍潭鄉,凌雲村,813,1,1122,18,1140,1742,3,1,3,0,1,0,65.44
桃園縣,龍潭鄉,凌雲村,814,1,978,15,993,1475,3,1,3,0,1,0,67.32
桃園縣,龍潭鄉,八德村,815,1,860,12,872,1315,3,1,3,0,1,0,66.31
桃園縣,龍潭鄉,八德村,816,1,670,8,678,1022,3,1,3,0,1,0,66.34
桃園縣,龍潭鄉,八德村,817,1,844,12,856,1287,3,1,3,0,1,0,66.51
桃園縣,龍潭鄉,八德村,818,1,1019,17,1036,1470,3,1,3,0,1,0,70.48
桃園縣,龍潭鄉,上林村,819,1,707,18,725,1098,3,1,3,0,1,0,66.03
桃園縣,龍潭鄉,上林村,820,1,1034,16,1050,1582,3,1,3,0,1,0,66.37
桃園縣,龍潭鄉,龍潭村,821,1,804,11,815,1087,3,1,3,0,1,0,74.98
桃園縣,龍潭鄉,龍潭村,822,1,646,7,653,908,3,1,3,0,1,0,71.92
桃園縣,龍潭鄉,中正村,823,1,1294,24,1318,1843,3,1,3,0,1,0,71.51
桃園縣,龍潭鄉,中正村,824,1,1229,23,1252,1790,3,1,3,0,1,0,69.94
桃園縣,龍潭鄉,中正村,825,1,1179,16,1195,1755,3,1,3,0,1,0,68.09
桃園縣,龍潭鄉,中正村,826,1,1302,23,1325,1885,3,1,3,0,1,0,70.29
桃園縣,龍潭鄉,九龍村,827,1,677,12,689,1091,3,1,3,0,1,0,63.15
桃園縣,龍潭鄉,九龍村,828,1,797,15,812,1191,3,1,3,0,1,0,68.18
桃園縣,龍潭鄉,九龍村,829,1,751,14,765,1193,3,1,3,0,1,0,64.12
桃園縣,龍潭鄉,九龍村,830,1,607,7,614,1044,3,1,3,0,1,0,58.81
桃園縣,龍潭鄉,中興村,831,1,961,11,972,1461,3,1,3,0,1,0,66.53
桃園縣,龍潭鄉,中興村,832,1,963,14,977,1392,3,1,3,0,1,0,70.19
桃園縣,龍潭鄉,中興村,833,1,992,24,1016,1473,3,1,3,0,1,0,68.97
桃園縣,龍潭鄉,中興村,834,1,1258,33,1291,1889,3,1,3,0,1,0,68.34
桃園縣,龍潭鄉,中興村,835,1,1135,28,1163,1769,3,1,3,0,1,0,65.74
桃園縣,龍潭鄉,佳安村,836,1,721,10,731,1058,3,1,3,0,1,0,69.09
桃園縣,龍潭鄉,佳安村,837,1,775,11,786,1105,3,1,3,0,1,0,71.13
桃園縣,龍潭鄉,佳安村,838,1,705,10,715,934,3,1,3,0,1,0,76.55
桃園縣,龍潭鄉,三坑村,839,1,879,12,891,1293,3,1,3,0,1,0,68.91
桃園縣,龍潭鄉,大平村,840,1,665,3,668,964,3,1,3,0,1,0,69.29
桃園縣,龍潭鄉,三林村,841,1,1054,9,1063,1482,3,1,3,0,1,0,71.73
桃園縣,龍潭鄉,三林村,842,1,964,12,976,1374,3,1,3,0,1,0,71.03
桃園縣,龍潭鄉,三林村,843,1,1042,3,1045,1509,3,1,3,0,1,0,69.25
桃園縣,龍潭鄉,三林村,844,1,1145,12,1157,1654,3,1,3,0,1,0,69.95
桃園縣,龍潭鄉,三林村,845,1,987,22,1009,1444,3,1,3,0,1,0,69.88
桃園縣,龍潭鄉,高平村,846,1,808,18,826,1199,3,1,3,0,1,0,68.89
桃園縣,龍潭鄉,高平村,847,1,766,16,782,1199,3,1,3,0,1,0,65.22
桃園縣,龍潭鄉,高原村,848,1,742,8,750,1155,3,1,3,0,1,0,64.94
桃園縣,龍潭鄉,高原村,849,1,953,14,967,1516,3,1,3,0,1,0,63.79
桃園縣,龍潭鄉,三和村,850,1,710,8,718,1035,3,1,3,0,1,0,69.37
桃園縣,龍潭鄉,三水村,851,1,488,12,500,659,3,1,3,0,1,0,75.87
桃園縣,新屋鄉,新屋村,852,1,876,7,883,1173,3,1,3,0,1,0,75.28
桃園縣,新屋鄉,新屋村,853,1,821,12,833,1130,3,1,3,0,1,0,73.72
桃園縣,新屋鄉,新生村,854,1,1019,16,1035,1345,3,1,3,0,1,0,76.95
桃園縣,新屋鄉,新生村,855,1,1181,6,1187,1565,3,1,3,0,1,0,75.85
桃園縣,新屋鄉,後湖村,856,1,887,8,895,1194,3,1,3,0,1,0,74.96
桃園縣,新屋鄉,清華村,857,1,1061,14,1075,1466,3,1,3,0,1,0,73.33
桃園縣,新屋鄉,清華村,858,1,961,17,978,1394,3,1,3,0,1,0,70.16
桃園縣,新屋鄉,石磊村,859,1,1221,12,1233,1644,3,1,3,0,1,0,75.00
桃園縣,新屋鄉,東明村,860,1,831,14,845,1120,3,1,3,0,1,0,75.45
桃園縣,新屋鄉,社子村,861,1,1023,12,1035,1341,3,1,3,0,1,0,77.18
桃園縣,新屋鄉,埔頂村,862,1,1454,26,1480,1990,3,1,3,0,1,0,74.37
桃園縣,新屋鄉,九斗村,863,1,1202,21,1223,1744,3,1,3,0,1,0,70.13
桃園縣,新屋鄉,頭洲村,864,1,1227,15,1242,1665,3,1,3,0,1,0,74.59
桃園縣,新屋鄉,頭洲村,865,1,749,11,760,1061,3,1,3,0,1,0,71.63
桃園縣,新屋鄉,大坡村,866,1,964,12,976,1329,3,1,3,0,1,0,73.44
桃園縣,新屋鄉,望間村,867,1,1110,8,1118,1452,3,1,3,0,1,0,77.00
桃園縣,新屋鄉,後庄村,868,1,758,14,772,1126,3,1,3,0,1,0,68.56
桃園縣,新屋鄉,蚵間村,869,1,549,2,551,835,3,1,3,0,1,0,65.99
桃園縣,新屋鄉,深圳村,870,1,467,6,473,667,3,1,3,0,1,0,70.91
桃園縣,新屋鄉,康榔村,871,1,795,13,808,1070,3,1,3,0,1,0,75.51
桃園縣,新屋鄉,笨港村,872,1,768,16,784,1032,3,1,3,0,1,0,75.97
桃園縣,新屋鄉,永安村,873,1,678,12,690,889,3,1,3,0,1,0,77.62
桃園縣,新屋鄉,永安村,874,1,970,10,980,1295,3,1,3,0,1,0,75.68
桃園縣,新屋鄉,永興村,875,1,653,6,659,910,3,1,3,0,1,0,72.42
桃園縣,新屋鄉,下埔村,876,1,538,8,546,697,3,1,3,0,1,0,78.34
桃園縣,新屋鄉,石牌村,877,1,626,6,632,811,3,1,3,0,1,0,77.93
桃園縣,新屋鄉,下田村,878,1,1124,11,1135,1512,3,1,3,0,1,0,75.07
桃園縣,新屋鄉,赤欄村,879,1,775,11,786,1036,3,1,3,0,1,0,75.87
桃園縣,觀音鄉,觀音村,880,1,826,9,835,1175,3,1,3,0,1,0,71.06
桃園縣,觀音鄉,觀音村,881,1,905,16,921,1227,3,1,3,0,1,0,75.06
桃園縣,觀音鄉,白玉村,882,1,860,11,871,1140,3,1,3,0,1,0,76.40
桃園縣,觀音鄉,廣興村,883,1,897,22,919,1291,3,1,3,0,1,0,71.19
桃園縣,觀音鄉,大潭村,884,1,794,9,803,1073,3,1,3,0,1,0,74.84
桃園縣,觀音鄉,保生村,885,1,1036,9,1045,1401,3,1,3,0,1,0,74.59
桃園縣,觀音鄉,武威村,886,1,469,10,479,643,3,1,3,0,1,0,74.49
桃園縣,觀音鄉,三和村,887,1,562,4,566,745,3,1,3,0,1,0,75.97
桃園縣,觀音鄉,新興村,888,1,502,11,513,670,3,1,3,0,1,0,76.57
桃園縣,觀音鄉,坑尾村,889,1,836,25,861,1181,3,1,3,0,1,0,72.90
桃園縣,觀音鄉,金湖村,890,1,1263,31,1294,1842,3,1,3,0,1,0,70.25
桃園縣,觀音鄉,藍埔村,891,1,1350,14,1364,1869,3,1,3,0,1,0,72.98
桃園縣,觀音鄉,大同村,892,1,1204,17,1221,1663,3,1,3,0,1,0,73.42
桃園縣,觀音鄉,大堀村,893,1,687,5,692,979,3,1,3,0,1,0,70.68
桃園縣,觀音鄉,崙坪村,894,1,1150,23,1173,1636,3,1,3,0,1,0,71.70
桃園縣,觀音鄉,崙坪村,895,1,1192,19,1211,1760,3,1,3,0,1,0,68.81
桃園縣,觀音鄉,富源村,896,1,1232,13,1245,1771,3,1,3,0,1,0,70.30
桃園縣,觀音鄉,上大村,897,1,1131,14,1145,1663,3,1,3,0,1,0,68.85
桃園縣,觀音鄉,新坡村,898,1,963,9,972,1270,3,1,3,0,1,0,76.54
桃園縣,觀音鄉,新坡村,899,1,886,8,894,1264,3,1,3,0,1,0,70.73
桃園縣,觀音鄉,廣福村,900,1,1343,14,1357,1758,3,1,3,0,1,0,77.19
桃園縣,觀音鄉,塔腳村,901,1,686,9,695,949,3,1,3,0,1,0,73.23
桃園縣,觀音鄉,保障村,902,1,1216,21,1237,1752,3,1,3,0,1,0,70.61
桃園縣,觀音鄉,草漯村,903,1,1073,16,1089,1435,3,1,3,0,1,0,75.89
桃園縣,觀音鄉,草漯村,904,1,1112,19,1131,1644,3,1,3,0,1,0,68.80
桃園縣,觀音鄉,樹林村,905,1,1063,12,1075,1555,3,1,3,0,1,0,69.13
桃園縣,觀音鄉,富林村,906,1,947,14,961,1332,3,1,3,0,1,0,72.15
新竹縣,竹北市,鹿場里,1,1,653,14,667,890,3,1,3,0,1,0,74.94
新竹縣,竹北市,東平里,2,1,249,10,259,310,3,1,3,0,1,0,83.55
新竹縣,竹北市,中興里,3,1,775,22,797,1174,3,1,3,0,1,0,67.89
新竹縣,竹北市,隘口里,4,1,414,6,420,560,3,1,3,0,1,0,75.00
新竹縣,竹北市,東海里,5,1,866,21,887,1217,3,1,3,0,1,0,72.88
新竹縣,竹北市,東海里,6,1,860,10,870,1189,3,1,3,0,1,0,73.17
新竹縣,竹北市,十興里,7,1,731,13,744,1068,3,1,3,0,1,0,69.66
新竹縣,竹北市,十興里,8,1,848,13,861,1229,3,1,3,0,1,0,70.06
新竹縣,竹北市,十興里,9,1,550,10,560,848,3,1,3,0,1,0,66.04
新竹縣,竹北市,十興里,10,1,833,19,852,1190,3,1,3,0,1,0,71.60
新竹縣,竹北市,斗崙里,11,1,820,13,833,1237,3,1,3,0,1,0,67.34
新竹縣,竹北市,斗崙里,12,1,894,12,906,1347,3,1,3,0,1,0,67.26
新竹縣,竹北市,斗崙里,13,1,826,18,844,1215,3,1,3,0,1,0,69.47
新竹縣,竹北市,北崙里,14,1,660,12,672,964,3,1,3,0,1,0,69.71
新竹縣,竹北市,北崙里,15,1,771,12,783,1152,3,1,3,0,1,0,67.97
新竹縣,竹北市,新崙里,16,1,1037,14,1051,1687,3,1,3,0,1,0,62.30
新竹縣,竹北市,新崙里,17,1,1161,18,1179,1658,3,1,3,0,1,0,71.11
新竹縣,竹北市,竹北里,18,1,678,12,690,1027,3,1,3,0,1,0,67.19
新竹縣,竹北市,竹北里,19,1,740,8,748,1072,3,1,3,0,1,0,69.78
新竹縣,竹北市,竹北里,20,1,598,7,605,911,3,1,3,0,1,0,66.41
新竹縣,竹北市,竹仁里,21,1,947,19,966,1495,3,1,3,0,1,0,64.62
新竹縣,竹北市,竹仁里,22,1,774,18,792,1182,3,1,3,0,1,0,67.01
新竹縣,竹北市,竹仁里,23,1,775,19,794,1161,3,1,3,0,1,0,68.39
新竹縣,竹北市,竹仁里,24,1,728,10,738,1169,3,1,3,0,1,0,63.13
新竹縣,竹北市,竹仁里,25,1,784,15,799,1100,3,1,3,0,1,0,72.64
新竹縣,竹北市,福德里,26,1,520,9,529,764,3,1,3,0,1,0,69.24
新竹縣,竹北市,福德里,27,1,693,13,706,1006,3,1,3,0,1,0,70.18
新竹縣,竹北市,福德里,28,1,640,22,662,1036,3,1,3,0,1,0,63.90
新竹縣,竹北市,竹義里,29,1,486,5,491,752,3,1,3,0,1,0,65.29
新竹縣,竹北市,竹義里,30,1,452,5,457,683,3,1,3,0,1,0,66.91
新竹縣,竹北市,竹義里,31,1,718,13,731,1115,3,1,3,0,1,0,65.56
新竹縣,竹北市,竹義里,32,1,751,11,762,1142,3,1,3,0,1,0,66.73
新竹縣,竹北市,泰和里,33,1,888,17,905,1285,3,1,3,0,1,0,70.43
新竹縣,竹北市,泰和里,34,1,700,13,713,1102,3,1,3,0,1,0,64.70
新竹縣,竹北市,泰和里,35,1,625,5,630,964,3,1,3,0,1,0,65.35
新竹縣,竹北市,新社里,36,1,769,12,781,1205,3,1,3,0,1,0,64.81
新竹縣,竹北市,新社里,37,1,761,14,775,1292,3,1,3,0,1,0,59.98
新竹縣,竹北市,新社里,38,1,839,21,860,1318,3,1,3,0,1,0,65.25
新竹縣,竹北市,新社里,39,1,701,9,710,1171,3,1,3,0,1,0,60.63
新竹縣,竹北市,新國里,40,1,684,12,696,1100,3,1,3,0,1,0,63.27
新竹縣,竹北市,新國里,41,1,737,16,753,1258,3,1,3,0,1,0,59.86
新竹縣,竹北市,新國里,42,1,588,14,602,930,3,1,3,0,1,0,64.73
新竹縣,竹北市,聯興里,43,1,706,13,719,1080,3,1,3,0,1,0,66.57
新竹縣,竹北市,聯興里,44,1,606,10,616,909,3,1,3,0,1,0,67.77
新竹縣,竹北市,聯興里,45,1,641,18,659,969,3,1,3,0,1,0,68.01
新竹縣,竹北市,麻園里,46,1,757,12,769,1144,3,1,3,0,1,0,67.22
新竹縣,竹北市,溪州里,47,1,532,9,541,758,3,1,3,0,1,0,71.37
新竹縣,竹北市,溪州里,48,1,567,15,582,878,3,1,3,0,1,0,66.29
新竹縣,竹北市,新庄里,49,1,559,5,564,898,3,1,3,0,1,0,62.81
新竹縣,竹北市,白地里,50,1,483,12,495,701,3,1,3,0,1,0,70.61
新竹縣,竹北市,白地里,51,1,588,13,601,924,3,1,3,0,1,0,65.04
新竹縣,竹北市,新港里,52,1,682,23,705,1030,3,1,3,0,1,0,68.45
新竹縣,竹北市,大眉里,53,1,779,15,794,1243,3,1,3,0,1,0,63.88
新竹縣,竹北市,大義里,54,1,541,13,554,790,3,1,3,0,1,0,70.13
新竹縣,竹北市,大義里,55,1,376,6,382,533,3,1,3,0,1,0,71.67
新竹縣,竹北市,尚義里,56,1,485,9,494,676,3,1,3,0,1,0,73.08
新竹縣,竹北市,尚義里,57,1,483,5,488,652,3,1,3,0,1,0,74.85
新竹縣,竹北市,崇義里,58,1,578,10,588,844,3,1,3,0,1,0,69.67
新竹縣,竹北市,崇義里,59,1,549,6,555,787,3,1,3,0,1,0,70.52
新竹縣,竹東鎮,上坪里,60,1,285,6,291,405,3,1,3,0,1,0,71.85
新竹縣,竹東鎮,瑞峰里,61,1,228,2,230,330,3,1,3,0,1,0,69.70
新竹縣,竹東鎮,軟橋里,62,1,265,8,273,362,3,1,3,0,1,0,75.41
新竹縣,竹東鎮,員崠里,63,1,561,15,576,766,3,1,3,0,1,0,75.20
新竹縣,竹東鎮,員崠里,64,1,666,6,672,992,3,1,3,0,1,0,67.74
新竹縣,竹東鎮,上舘里,65,1,855,17,872,1250,3,1,3,0,1,0,69.76
新竹縣,竹東鎮,上舘里,66,1,890,21,911,1356,3,1,3,0,1,0,67.18
新竹縣,竹東鎮,上舘里,67,1,802,15,817,1253,3,1,3,0,1,0,65.20
新竹縣,竹東鎮,上舘里,68,1,877,12,889,1180,3,1,3,0,1,0,75.34
新竹縣,竹東鎮,上舘里,69,1,756,16,772,1043,3,1,3,0,1,0,74.02
新竹縣,竹東鎮,東寧里,70,1,630,16,646,908,3,1,3,0,1,0,71.15
新竹縣,竹東鎮,東寧里,71,1,599,8,607,863,3,1,3,0,1,0,70.34
新竹縣,竹東鎮,東寧里,72,1,666,12,678,925,3,1,3,0,1,0,73.30
新竹縣,竹東鎮,中正里,73,1,468,8,476,680,3,1,3,0,1,0,70.00
新竹縣,竹東鎮,中正里,74,1,576,6,582,782,3,1,3,0,1,0,74.42
新竹縣,竹東鎮,大鄉里,75,1,674,10,684,992,3,1,3,0,1,0,68.95
新竹縣,竹東鎮,大鄉里,76,1,793,12,805,1076,3,1,3,0,1,0,74.81
新竹縣,竹東鎮,大鄉里,77,1,847,16,863,1206,3,1,3,0,1,0,71.56
新竹縣,竹東鎮,中山里,78,1,650,10,660,906,3,1,3,0,1,0,72.85
新竹縣,竹東鎮,中山里,79,1,645,8,653,857,3,1,3,0,1,0,76.20
新竹縣,竹東鎮,南華里,80,1,857,18,875,1171,3,1,3,0,1,0,74.72
新竹縣,竹東鎮,東華里,81,1,589,9,598,778,3,1,3,0,1,0,76.86
新竹縣,竹東鎮,商華里,82,1,766,12,778,1134,3,1,3,0,1,0,68.61
新竹縣,竹東鎮,商華里,83,1,743,14,757,1037,3,1,3,0,1,0,73.00
新竹縣,竹東鎮,鷄林里,84,1,659,13,672,965,3,1,3,0,1,0,69.64
新竹縣,竹東鎮,鷄林里,85,1,906,15,921,1288,3,1,3,0,1,0,71.51
新竹縣,竹東鎮,鷄林里,86,1,744,12,756,1035,3,1,3,0,1,0,73.04
新竹縣,竹東鎮,仁愛里,87,1,1073,14,1087,1516,3,1,3,0,1,0,71.70
新竹縣,竹東鎮,仁愛里,88,1,874,15,889,1161,3,1,3,0,1,0,76.57
新竹縣,竹東鎮,竹東里,89,1,493,4,497,640,3,1,3,0,1,0,77.66
新竹縣,竹東鎮,竹東里,90,1,583,7,590,806,3,1,3,0,1,0,73.20
新竹縣,竹東鎮,忠孝里,91,1,920,10,930,1360,3,1,3,0,1,0,68.38
新竹縣,竹東鎮,榮樂里,92,1,546,7,553,728,3,1,3,0,1,0,75.96
新竹縣,竹東鎮,榮樂里,93,1,536,7,543,724,3,1,3,0,1,0,75.00
新竹縣,竹東鎮,榮華里,94,1,811,7,818,1090,3,1,3,0,1,0,75.05
新竹縣,竹東鎮,榮華里,95,1,755,17,772,1008,3,1,3,0,1,0,76.59
新竹縣,竹東鎮,榮華里,96,1,626,15,641,850,3,1,3,0,1,0,75.41
新竹縣,竹東鎮,榮華里,97,1,908,10,918,1223,3,1,3,0,1,0,75.06
新竹縣,竹東鎮,榮華里,98,1,691,13,704,977,3,1,3,0,1,0,72.06
新竹縣,竹東鎮,五豐里,99,1,1036,19,1055,1643,3,1,3,0,1,0,64.21
新竹縣,竹東鎮,五豐里,100,1,659,10,669,942,3,1,3,0,1,0,71.02
新竹縣,竹東鎮,五豐里,101,1,527,9,536,718,3,1,3,0,1,0,74.65
新竹縣,竹東鎮,五豐里,102,1,714,8,722,1059,3,1,3,0,1,0,68.18
新竹縣,竹東鎮,五豐里,103,1,529,8,537,754,3,1,3,0,1,0,71.22
新竹縣,竹東鎮,陸豐里,104,1,347,5,352,484,3,1,3,0,1,0,72.73
新竹縣,竹東鎮,三重里,105,1,815,14,829,1301,3,1,3,0,1,0,63.72
新竹縣,竹東鎮,三重里,106,1,555,7,562,835,3,1,3,0,1,0,67.31
新竹縣,竹東鎮,三重里,107,1,632,12,644,934,3,1,3,0,1,0,68.95
新竹縣,竹東鎮,三重里,108,1,492,14,506,701,3,1,3,0,1,0,72.18
新竹縣,竹東鎮,三重里,109,1,605,9,614,919,3,1,3,0,1,0,66.81
新竹縣,竹東鎮,二重里,110,1,766,14,780,1031,3,1,3,0,1,0,75.65
新竹縣,竹東鎮,二重里,111,1,719,6,725,1005,3,1,3,0,1,0,72.14
新竹縣,竹東鎮,二重里,112,1,1024,17,1041,1539,3,1,3,0,1,0,67.64
新竹縣,竹東鎮,二重里,113,1,861,19,880,1297,3,1,3,0,1,0,67.85
新竹縣,竹東鎮,二重里,114,1,671,16,687,962,3,1,3,0,1,0,71.41
新竹縣,竹東鎮,頭重里,115,1,711,16,727,1104,3,1,3,0,1,0,65.85
新竹縣,竹東鎮,頭重里,116,1,723,14,737,1026,3,1,3,0,1,0,71.83
新竹縣,竹東鎮,頭重里,117,1,887,10,897,1233,3,1,3,0,1,0,72.75
新竹縣,竹東鎮,員山里,118,1,1032,15,1047,1410,3,1,3,0,1,0,74.26
新竹縣,竹東鎮,柯湖里,119,1,460,3,463,645,3,1,3,0,1,0,71.78
新竹縣,新埔鎮,新埔里,120,1,762,8,770,1012,3,1,3,0,1,0,76.09
新竹縣,新埔鎮,新生里,121,1,500,9,509,681,3,1,3,0,1,0,74.74
新竹縣,新埔鎮,新民里,122,1,776,18,794,1043,3,1,3,0,1,0,76.13
新竹縣,新埔鎮,田新里,123,1,601,6,607,812,3,1,3,0,1,0,74.75
新竹縣,新埔鎮,田新里,124,1,512,14,526,723,3,1,3,0,1,0,72.75
新竹縣,新埔鎮,田新里,125,1,541,7,548,755,3,1,3,0,1,0,72.58
新竹縣,新埔鎮,旱坑里,126,1,602,13,615,904,3,1,3,0,1,0,68.03
新竹縣,新埔鎮,旱坑里,127,1,531,6,537,786,3,1,3,0,1,0,68.32
新竹縣,新埔鎮,五埔里,128,1,644,18,662,895,3,1,3,0,1,0,73.97
新竹縣,新埔鎮,五埔里,129,1,672,13,685,926,3,1,3,0,1,0,73.97
新竹縣,新埔鎮,四座里,130,1,667,13,680,912,3,1,3,0,1,0,74.56
新竹縣,新埔鎮,四座里,131,1,612,17,629,884,3,1,3,0,1,0,71.15
新竹縣,新埔鎮,四座里,132,1,699,19,718,976,3,1,3,0,1,0,73.57
新竹縣,新埔鎮,照門里,133,1,991,21,1012,1356,3,1,3,0,1,0,74.63
新竹縣,新埔鎮,清水里,134,1,330,4,334,438,3,1,3,0,1,0,76.26
新竹縣,新埔鎮,鹿鳴里,135,1,540,7,547,713,3,1,3,0,1,0,76.72
新竹縣,新埔鎮,新北里,136,1,451,7,458,604,3,1,3,0,1,0,75.83
新竹縣,新埔鎮,巨埔里,137,1,820,10,830,1066,3,1,3,0,1,0,77.86
新竹縣,新埔鎮,內立里,138,1,787,19,806,1080,3,1,3,0,1,0,74.63
新竹縣,新埔鎮,寶石里,139,1,608,11,619,799,3,1,3,0,1,0,77.47
新竹縣,新埔鎮,文山里,140,1,899,19,918,1338,3,1,3,0,1,0,68.61
新竹縣,新埔鎮,文山里,141,1,808,11,819,1129,3,1,3,0,1,0,72.54
新竹縣,新埔鎮,文山里,142,1,887,12,899,1332,3,1,3,0,1,0,67.49
新竹縣,新埔鎮,上寮里,143,1,1157,13,1170,1658,3,1,3,0,1,0,70.57
新竹縣,新埔鎮,下寮里,144,1,673,12,685,895,3,1,3,0,1,0,76.54
新竹縣,新埔鎮,下寮里,145,1,564,14,578,833,3,1,3,0,1,0,69.39
新竹縣,新埔鎮,南平里,146,1,723,19,742,974,3,1,3,0,1,0,76.18
新竹縣,新埔鎮,北平里,147,1,496,2,498,665,3,1,3,0,1,0,74.89
新竹縣,關西鎮,東興里,148,1,420,5,425,550,3,1,3,0,1,0,77.27
新竹縣,關西鎮,西安里,149,1,519,10,529,698,3,1,3,0,1,0,75.79
新竹縣,關西鎮,西安里,150,1,685,8,693,971,3,1,3,0,1,0,71.37
新竹縣,關西鎮,南雄里,151,1,530,10,540,747,3,1,3,0,1,0,72.29
新竹縣,關西鎮,北斗里,152,1,760,13,773,1100,3,1,3,0,1,0,70.27
新竹縣,關西鎮,北斗里,153,1,807,13,820,1119,3,1,3,0,1,0,73.28
新竹縣,關西鎮,北斗里,154,1,897,10,907,1271,3,1,3,0,1,0,71.36
新竹縣,關西鎮,北山里,155,1,543,12,555,725,3,1,3,0,1,0,76.55
新竹縣,關西鎮,仁安里,156,1,761,8,769,1067,3,1,3,0,1,0,72.07
新竹縣,關西鎮,南山里,157,1,674,14,688,1016,3,1,3,0,1,0,67.72
新竹縣,關西鎮,東安里,158,1,952,16,968,1383,3,1,3,0,1,0,69.99
新竹縣,關西鎮,東安里,159,1,968,11,979,1416,3,1,3,0,1,0,69.14
新竹縣,關西鎮,東山里,160,1,559,11,570,760,3,1,3,0,1,0,75.00
新竹縣,關西鎮,東光里,161,1,823,15,838,1118,3,1,3,0,1,0,74.96
新竹縣,關西鎮,南新里,162,1,701,5,706,975,3,1,3,0,1,0,72.41
新竹縣,關西鎮,新富里,163,1,414,12,426,591,3,1,3,0,1,0,72.08
新竹縣,關西鎮,玉山里,164,1,372,10,382,522,3,1,3,0,1,0,73.18
新竹縣,關西鎮,金山里,165,1,417,4,421,637,3,1,3,0,1,0,66.09
新竹縣,關西鎮,錦山里,166,1,596,12,608,879,3,1,3,0,1,0,69.17
新竹縣,關西鎮,大同里,167,1,535,11,546,713,3,1,3,0,1,0,76.58
新竹縣,關西鎮,石光里,168,1,669,15,684,871,3,1,3,0,1,0,78.53
新竹縣,關西鎮,石光里,169,1,682,17,699,914,3,1,3,0,1,0,76.48
新竹縣,關西鎮,東平里,170,1,675,9,684,934,3,1,3,0,1,0,73.23
新竹縣,關西鎮,上林里,171,1,632,4,636,812,3,1,3,0,1,0,78.33
新竹縣,關西鎮,新力里,172,1,488,7,495,620,3,1,3,0,1,0,79.84
新竹縣,關西鎮,南和里,173,1,612,9,621,775,3,1,3,0,1,0,80.13
新竹縣,湖口鄉,和興村,174,1,873,13,886,1204,3,1,3,0,1,0,73.59
新竹縣,湖口鄉,和興村,175,1,838,13,851,1134,3,1,3,0,1,0,75.04
新竹縣,湖口鄉,東興村,176,1,815,9,824,1218,3,1,3,0,1,0,67.65
新竹縣,湖口鄉,東興村,177,1,816,9,825,1141,3,1,3,0,1,0,72.30
新竹縣,湖口鄉,德盛村,178,1,791,15,806,1076,3,1,3,0,1,0,74.91
新竹縣,湖口鄉,德盛村,179,1,779,14,793,1137,3,1,3,0,1,0,69.74
新竹縣,湖口鄉,德盛村,180,1,748,14,762,1116,3,1,3,0,1,0,68.28
新竹縣,湖口鄉,愛勢村,181,1,796,12,808,1119,3,1,3,0,1,0,72.21
新竹縣,湖口鄉,愛勢村,182,1,878,12,890,1270,3,1,3,0,1,0,70.08
新竹縣,湖口鄉,愛勢村,183,1,896,18,914,1326,3,1,3,0,1,0,68.93
新竹縣,湖口鄉,仁勢村,184,1,580,10,590,850,3,1,3,0,1,0,69.41
新竹縣,湖口鄉,孝勢村,185,1,838,20,858,1222,3,1,3,0,1,0,70.21
新竹縣,湖口鄉,中勢村,186,1,715,13,728,1017,3,1,3,0,1,0,71.58
新竹縣,湖口鄉,中勢村,187,1,898,13,911,1257,3,1,3,0,1,0,72.47
新竹縣,湖口鄉,中正村,188,1,804,9,813,1121,3,1,3,0,1,0,72.52
新竹縣,湖口鄉,中正村,189,1,682,12,694,937,3,1,3,0,1,0,74.07
新竹縣,湖口鄉,信勢村,190,1,730,8,738,969,3,1,3,0,1,0,76.16
新竹縣,湖口鄉,信勢村,191,1,693,7,700,1006,3,1,3,0,1,0,69.58
新竹縣,湖口鄉,信勢村,192,1,858,15,873,1277,3,1,3,0,1,0,68.36
新竹縣,湖口鄉,信義村,193,1,769,9,778,1101,3,1,3,0,1,0,70.66
新竹縣,湖口鄉,信義村,194,1,711,9,720,1004,3,1,3,0,1,0,71.71
新竹縣,湖口鄉,波羅村,195,1,1023,14,1037,1677,3,1,3,0,1,0,61.84
新竹縣,湖口鄉,長嶺村,196,1,690,21,711,1004,3,1,3,0,1,0,70.82
新竹縣,湖口鄉,長嶺村,197,1,1005,20,1025,1439,3,1,3,0,1,0,71.23
新竹縣,湖口鄉,長安村,198,1,724,5,729,995,3,1,3,0,1,0,73.27
新竹縣,湖口鄉,湖口村,199,1,828,12,840,1218,3,1,3,0,1,0,68.97
新竹縣,湖口鄉,湖口村,200,1,676,13,689,1005,3,1,3,0,1,0,68.56
新竹縣,湖口鄉,湖鏡村,201,1,817,11,828,1155,3,1,3,0,1,0,71.69
新竹縣,湖口鄉,湖鏡村,202,1,649,8,657,930,3,1,3,0,1,0,70.65
新竹縣,湖口鄉,湖南村,203,1,845,25,870,1280,3,1,3,0,1,0,67.97
新竹縣,湖口鄉,中興村,204,1,712,15,727,1028,3,1,3,0,1,0,70.72
新竹縣,湖口鄉,中興村,205,1,733,15,748,1073,3,1,3,0,1,0,69.71
新竹縣,湖口鄉,中興村,206,1,782,17,799,1329,3,1,3,0,1,0,60.12
新竹縣,湖口鄉,鳳凰村,207,1,605,9,614,940,3,1,3,0,1,0,65.32
新竹縣,湖口鄉,鳳凰村,208,1,753,13,766,1195,3,1,3,0,1,0,64.10
新竹縣,湖口鄉,鳳凰村,209,1,570,18,588,934,3,1,3,0,1,0,62.96
新竹縣,湖口鄉,勝利村,210,1,663,20,683,1092,3,1,3,0,1,0,62.55
新竹縣,湖口鄉,勝利村,211,1,781,20,801,1072,3,1,3,0,1,0,74.72
新竹縣,湖口鄉,鳳山村,212,1,847,25,872,1376,3,1,3,0,1,0,63.37
新竹縣,湖口鄉,鳳山村,213,1,781,13,794,1140,3,1,3,0,1,0,69.65
新竹縣,新豐鄉,福興村,214,1,635,16,651,865,3,1,3,0,1,0,75.26
新竹縣,新豐鄉,後湖村,215,1,572,16,588,788,3,1,3,0,1,0,74.62
新竹縣,新豐鄉,後湖村,216,1,575,21,596,851,3,1,3,0,1,0,70.04
新竹縣,新豐鄉,青埔村,217,1,959,12,971,1338,3,1,3,0,1,0,72.57
新竹縣,新豐鄉,埔和村,218,1,862,16,878,1249,3,1,3,0,1,0,70.30
新竹縣,新豐鄉,埔和村,219,1,604,10,614,904,3,1,3,0,1,0,67.92
新竹縣,新豐鄉,坡頭村,220,1,547,18,565,771,3,1,3,0,1,0,73.28
新竹縣,新豐鄉,新豐村,221,1,707,9,716,1033,3,1,3,0,1,0,69.31
新竹縣,新豐鄉,新豐村,222,1,706,13,719,1003,3,1,3,0,1,0,71.68
新竹縣,新豐鄉,瑞興村,223,1,908,10,918,1316,3,1,3,0,1,0,69.76
新竹縣,新豐鄉,中崙村,224,1,1416,22,1438,2116,3,1,3,0,1,0,67.96
新竹縣,新豐鄉,重興村,225,1,984,18,1002,1432,3,1,3,0,1,0,69.97
新竹縣,新豐鄉,重興村,226,1,915,10,925,1384,3,1,3,0,1,0,66.84
新竹縣,新豐鄉,重興村,227,1,1087,11,1098,1708,3,1,3,0,1,0,64.29
新竹縣,新豐鄉,重興村,228,1,717,19,736,1086,3,1,3,0,1,0,67.77
新竹縣,新豐鄉,上坑村,229,1,814,10,824,1226,3,1,3,0,1,0,67.21
新竹縣,新豐鄉,鳳坑村,230,1,623,17,640,902,3,1,3,0,1,0,70.95
新竹縣,新豐鄉,員山村,231,1,967,12,979,1468,3,1,3,0,1,0,66.69
新竹縣,新豐鄉,員山村,232,1,1356,13,1369,2022,3,1,3,0,1,0,67.71
新竹縣,新豐鄉,員山村,233,1,969,14,983,1433,3,1,3,0,1,0,68.60
新竹縣,新豐鄉,員山村,234,1,1066,18,1084,1686,3,1,3,0,1,0,64.29
新竹縣,新豐鄉,松林村,235,1,843,16,859,1243,3,1,3,0,1,0,69.11
新竹縣,新豐鄉,松林村,236,1,794,16,810,1350,3,1,3,0,1,0,60.00
新竹縣,新豐鄉,松林村,237,1,929,15,944,1496,3,1,3,0,1,0,63.10
新竹縣,芎林鄉,華龍村,238,1,350,5,355,435,3,1,3,0,1,0,81.61
新竹縣,芎林鄉,五龍村,239,1,368,7,375,494,3,1,3,0,1,0,75.91
新竹縣,芎林鄉,秀湖村,240,1,602,12,614,829,3,1,3,0,1,0,74.07
新竹縣,芎林鄉,永興村,241,1,315,1,316,397,3,1,3,0,1,0,79.60
新竹縣,芎林鄉,石潭村,242,1,673,14,687,911,3,1,3,0,1,0,75.41
新竹縣,芎林鄉,石潭村,243,1,1016,12,1028,1399,3,1,3,0,1,0,73.48
新竹縣,芎林鄉,新鳳村,244,1,1019,29,1048,1370,3,1,3,0,1,0,76.50
新竹縣,芎林鄉,中坑村,245,1,408,8,416,542,3,1,3,0,1,0,76.75
新竹縣,芎林鄉,水坑村,246,1,457,4,461,618,3,1,3,0,1,0,74.60
新竹縣,芎林鄉,文林村,247,1,869,11,880,1227,3,1,3,0,1,0,71.72
新竹縣,芎林鄉,文林村,248,1,605,10,615,800,3,1,3,0,1,0,76.88
新竹縣,芎林鄉,芎林村,249,1,1092,26,1118,1458,3,1,3,0,1,0,76.68
新竹縣,芎林鄉,上山村,250,1,1121,13,1134,1599,3,1,3,0,1,0,70.92
新竹縣,芎林鄉,上山村,251,1,877,13,890,1339,3,1,3,0,1,0,66.47
新竹縣,芎林鄉,下山村,252,1,782,7,789,1041,3,1,3,0,1,0,75.79
新竹縣,橫山鄉,橫山村,253,1,833,7,840,1161,3,1,3,0,1,0,72.35
新竹縣,橫山鄉,橫山村,254,1,670,9,679,951,3,1,3,0,1,0,71.40
新竹縣,橫山鄉,橫山村,255,1,743,12,755,1085,3,1,3,0,1,0,69.59
新竹縣,橫山鄉,田寮村,256,1,626,9,635,832,3,1,3,0,1,0,76.32
新竹縣,橫山鄉,南昌村,257,1,124,3,127,156,3,1,3,0,1,0,81.41
新竹縣,橫山鄉,豐鄉村,258,1,107,2,109,144,3,1,3,0,1,0,75.69
新竹縣,橫山鄉,豐田村,259,1,259,3,262,334,3,1,3,0,1,0,78.44
新竹縣,橫山鄉,內灣村,260,1,752,15,767,1041,3,1,3,0,1,0,73.68
新竹縣,橫山鄉,力行村,261,1,425,7,432,578,3,1,3,0,1,0,74.74
新竹縣,橫山鄉,力行村,262,1,188,8,196,259,3,1,3,0,1,0,75.68
新竹縣,橫山鄉,福興村,263,1,345,4,349,456,3,1,3,0,1,0,76.54
新竹縣,橫山鄉,沙坑村,264,1,572,13,585,757,3,1,3,0,1,0,77.28
新竹縣,橫山鄉,沙坑村,265,1,275,3,278,358,3,1,3,0,1,0,77.65
新竹縣,橫山鄉,新興村,266,1,551,10,561,720,3,1,3,0,1,0,77.92
新竹縣,橫山鄉,新興村,267,1,587,4,591,772,3,1,3,0,1,0,76.55
新竹縣,橫山鄉,大肚村,268,1,994,22,1016,1335,3,1,3,0,1,0,76.10
新竹縣,北埔鄉,北埔村,269,1,775,12,787,1111,3,1,3,0,1,0,70.84
新竹縣,北埔鄉,南興村,270,1,948,22,970,1297,3,1,3,0,1,0,74.79
新竹縣,北埔鄉,大湖村,271,1,356,5,361,485,3,1,3,0,1,0,74.43
新竹縣,北埔鄉,埔尾村,272,1,679,11,690,901,3,1,3,0,1,0,76.58
新竹縣,北埔鄉,埔尾村,273,1,1051,17,1068,1435,3,1,3,0,1,0,74.43
新竹縣,北埔鄉,水際村,274,1,527,11,538,744,3,1,3,0,1,0,72.31
新竹縣,北埔鄉,南埔村,275,1,260,2,262,339,3,1,3,0,1,0,77.29
新竹縣,北埔鄉,大林村,276,1,447,8,455,623,3,1,3,0,1,0,73.03
新竹縣,北埔鄉,南坑村,277,1,227,4,231,328,3,1,3,0,1,0,70.43
新竹縣,北埔鄉,外坪村,278,1,226,5,231,330,3,1,3,0,1,0,70.00
新竹縣,寶山鄉,雙溪村,279,1,1263,17,1280,1843,3,1,3,0,1,0,69.45
新竹縣,寶山鄉,雙溪村,280,1,1008,20,1028,1674,3,1,3,0,1,0,61.41
新竹縣,寶山鄉,大崎村,281,1,576,13,589,839,3,1,3,0,1,0,70.20
新竹縣,寶山鄉,三峰村,282,1,544,9,553,731,3,1,3,0,1,0,75.65
新竹縣,寶山鄉,新城村,283,1,770,12,782,1057,3,1,3,0,1,0,73.98
新竹縣,寶山鄉,寶斗村,284,1,479,8,487,625,3,1,3,0,1,0,77.92
新竹縣,寶山鄉,深井村,285,1,519,5,524,693,3,1,3,0,1,0,75.61
新竹縣,寶山鄉,寶山村,286,1,460,5,465,613,3,1,3,0,1,0,75.86
新竹縣,寶山鄉,油田村,287,1,408,4,412,539,3,1,3,0,1,0,76.44
新竹縣,寶山鄉,山湖村,288,1,354,5,359,505,3,1,3,0,1,0,71.09
新竹縣,峨眉鄉,峨眉村,289,1,665,7,672,889,3,1,3,0,1,0,75.59
新竹縣,峨眉鄉,中盛村,290,1,550,4,554,717,3,1,3,0,1,0,77.27
新竹縣,峨眉鄉,石井村,291,1,454,6,460,602,3,1,3,0,1,0,76.41
新竹縣,峨眉鄉,七星村,292,1,258,0,258,334,3,1,3,0,1,0,77.25
新竹縣,峨眉鄉,七星村,293,1,200,7,207,277,3,1,3,0,1,0,74.73
新竹縣,峨眉鄉,富興村,294,1,859,19,878,1220,3,1,3,0,1,0,71.97
新竹縣,峨眉鄉,湖光村,295,1,358,4,362,489,3,1,3,0,1,0,74.03
新竹縣,峨眉鄉,湖光村,296,1,289,6,295,385,3,1,3,0,1,0,76.62
新竹縣,尖石鄉,嘉樂村,297,1,288,4,292,413,3,1,3,0,1,0,70.70
新竹縣,尖石鄉,義興村,298,1,24,0,24,34,3,1,3,0,1,0,70.59
新竹縣,尖石鄉,嘉樂村,299,1,78,2,80,119,3,1,3,0,1,0,67.23
新竹縣,尖石鄉,新樂村,300,1,113,3,116,179,3,1,3,0,1,0,64.80
新竹縣,尖石鄉,錦屏村,301,1,26,0,26,50,3,1,3,0,1,0,52.00
新竹縣,尖石鄉,錦屏村,302,1,39,0,39,66,3,1,3,0,1,0,59.09
新竹縣,尖石鄉,梅花村,303,1,23,3,26,39,3,1,3,0,1,0,66.67
新竹縣,尖石鄉,玉峰村,304,1,14,0,14,24,3,1,3,0,1,0,58.33
新竹縣,尖石鄉,玉峰村,305,1,2,0,2,7,3,1,3,0,1,0,28.57
新竹縣,尖石鄉,秀巒村,306,1,10,1,11,16,3,1,3,0,1,0,68.75
新竹縣,尖石鄉,秀巒村,307,1,16,2,18,33,3,1,3,0,1,0,54.55
新竹縣,尖石鄉,秀巒村,308,1,5,0,5,9,3,1,3,0,1,0,55.56
新竹縣,五峰鄉,大隘村,309,1,78,1,79,112,3,1,3,0,1,0,70.54
新竹縣,五峰鄉,大隘村,310,1,12,0,12,34,3,1,3,0,1,0,35.29
新竹縣,五峰鄉,花園村,311,1,43,0,43,82,3,1,3,0,1,0,52.44
新竹縣,五峰鄉,竹林村,312,1,12,0,12,17,3,1,3,0,1,0,70.59
新竹縣,五峰鄉,桃山村,313,1,28,1,29,51,3,1,3,0,1,0,56.86
新竹縣,五峰鄉,桃山村,314,1,76,0,76,139,3,1,3,0,1,0,54.68
苗栗縣,苗栗市,中苗里,1,1,620,8,628,915,3,1,3,0,1,0,68.63
苗栗縣,苗栗市,青苗里,2,1,647,8,655,1014,3,1,3,0,1,0,64.60
苗栗縣,苗栗市,維祥里,3,1,989,16,1005,1534,3,1,3,0,1,0,65.51
苗栗縣,苗栗市,維祥里,4,1,984,20,1004,1466,3,1,3,0,1,0,68.49
苗栗縣,苗栗市,維新里,5,1,773,19,792,1196,3,1,3,0,1,0,66.22
苗栗縣,苗栗市,維新里,6,1,853,11,864,1242,3,1,3,0,1,0,69.57
苗栗縣,苗栗市,維新里,7,1,760,11,771,1229,3,1,3,0,1,0,62.73
苗栗縣,苗栗市,玉清里,8,1,758,14,772,1137,3,1,3,0,1,0,67.90
苗栗縣,苗栗市,玉清里,9,1,722,8,730,1135,3,1,3,0,1,0,64.32
苗栗縣,苗栗市,玉華里,10,1,732,13,745,1132,3,1,3,0,1,0,65.81
苗栗縣,苗栗市,玉華里,11,1,674,7,681,1044,3,1,3,0,1,0,65.23
苗栗縣,苗栗市,玉華里,12,1,740,19,759,1089,3,1,3,0,1,0,69.70
苗栗縣,苗栗市,綠苗里,13,1,583,16,599,905,3,1,3,0,1,0,66.19
苗栗縣,苗栗市,高苗里,14,1,783,10,793,1203,3,1,3,0,1,0,65.92
苗栗縣,苗栗市,高苗里,15,1,820,14,834,1343,3,1,3,0,1,0,62.10
苗栗縣,苗栗市,新苗里,16,1,653,16,669,962,3,1,3,0,1,0,69.54
苗栗縣,苗栗市,玉苗里,17,1,696,13,709,1064,3,1,3,0,1,0,66.64
苗栗縣,苗栗市,大同里,18,1,391,6,397,647,3,1,3,0,1,0,61.36
苗栗縣,苗栗市,恭敬里,19,1,1089,16,1105,1556,3,1,3,0,1,0,71.02
苗栗縣,苗栗市,水源里,20,1,898,16,914,1413,3,1,3,0,1,0,64.69
苗栗縣,苗栗市,水源里,21,1,651,5,656,902,3,1,3,0,1,0,72.73
苗栗縣,苗栗市,勝利里,22,1,851,15,866,1263,3,1,3,0,1,0,68.57
苗栗縣,苗栗市,勝利里,23,1,922,15,937,1368,3,1,3,0,1,0,68.49
苗栗縣,苗栗市,勝利里,24,1,538,6,544,808,3,1,3,0,1,0,67.33
苗栗縣,苗栗市,清華里,25,1,581,5,586,872,3,1,3,0,1,0,67.20
苗栗縣,苗栗市,清華里,26,1,814,11,825,1201,3,1,3,0,1,0,68.69
苗栗縣,苗栗市,清華里,27,1,636,7,643,910,3,1,3,0,1,0,70.66
苗栗縣,苗栗市,上苗里,28,1,556,9,565,787,3,1,3,0,1,0,71.79
苗栗縣,苗栗市,上苗里,29,1,664,10,674,948,3,1,3,0,1,0,71.10
苗栗縣,苗栗市,北苗里,30,1,842,15,857,1207,3,1,3,0,1,0,71.00
苗栗縣,苗栗市,北苗里,31,1,1044,16,1060,1581,3,1,3,0,1,0,67.05
苗栗縣,苗栗市,北苗里,32,1,916,10,926,1364,3,1,3,0,1,0,67.89
苗栗縣,苗栗市,嘉盛里,33,1,1106,12,1118,1614,3,1,3,0,1,0,69.27
苗栗縣,苗栗市,嘉盛里,34,1,810,12,822,1181,3,1,3,0,1,0,69.60
苗栗縣,苗栗市,嘉盛里,35,1,884,12,896,1265,3,1,3,0,1,0,70.83
苗栗縣,苗栗市,嘉盛里,36,1,965,11,976,1350,3,1,3,0,1,0,72.30
苗栗縣,苗栗市,福星里,37,1,783,12,795,1229,3,1,3,0,1,0,64.69
苗栗縣,苗栗市,福星里,38,1,883,15,898,1392,3,1,3,0,1,0,64.51
苗栗縣,苗栗市,福星里,39,1,951,10,961,1405,3,1,3,0,1,0,68.40
苗栗縣,苗栗市,福星里,40,1,1000,17,1017,1546,3,1,3,0,1,0,65.78
苗栗縣,苗栗市,建功里,41,1,556,4,560,806,3,1,3,0,1,0,69.48
苗栗縣,苗栗市,建功里,42,1,899,13,912,1259,3,1,3,0,1,0,72.44
苗栗縣,苗栗市,建功里,43,1,912,16,928,1402,3,1,3,0,1,0,66.19
苗栗縣,苗栗市,福麗里,44,1,824,17,841,1299,3,1,3,0,1,0,64.74
苗栗縣,苗栗市,福麗里,45,1,942,13,955,1455,3,1,3,0,1,0,65.64
苗栗縣,苗栗市,福麗里,46,1,826,17,843,1301,3,1,3,0,1,0,64.80
苗栗縣,苗栗市,文山里,47,1,1041,22,1063,1571,3,1,3,0,1,0,67.66
苗栗縣,苗栗市,文山里,48,1,891,14,905,1401,3,1,3,0,1,0,64.60
苗栗縣,苗栗市,文山里,49,1,1060,27,1087,1632,3,1,3,0,1,0,66.61
苗栗縣,苗栗市,新川里,50,1,703,7,710,1098,3,1,3,0,1,0,64.66
苗栗縣,苗栗市,新英里,51,1,871,26,897,1420,3,1,3,0,1,0,63.17
苗栗縣,苗栗市,新英里,52,1,497,13,510,792,3,1,3,0,1,0,64.39
苗栗縣,苗栗市,新英里,53,1,606,12,618,944,3,1,3,0,1,0,65.47
苗栗縣,苑裡鎮,苑東里,54,1,465,6,471,696,3,1,3,0,1,0,67.67
苗栗縣,苑裡鎮,苑東里,55,1,672,4,676,1060,3,1,3,0,1,0,63.77
苗栗縣,苑裡鎮,苑南里,56,1,626,6,632,908,3,1,3,0,1,0,69.60
苗栗縣,苑裡鎮,苑南里,57,1,441,6,447,694,3,1,3,0,1,0,64.41
苗栗縣,苑裡鎮,苑北里,58,1,611,9,620,892,3,1,3,0,1,0,69.51
苗栗縣,苑裡鎮,西平里,59,1,804,13,817,1268,3,1,3,0,1,0,64.43
苗栗縣,苑裡鎮,苑港里,60,1,752,9,761,1120,3,1,3,0,1,0,67.95
苗栗縣,苑裡鎮,西勢里,61,1,564,5,569,874,3,1,3,0,1,0,65.10
苗栗縣,苑裡鎮,西勢里,62,1,511,3,514,760,3,1,3,0,1,0,67.63
苗栗縣,苑裡鎮,海岸里,63,1,651,12,663,991,3,1,3,0,1,0,66.90
苗栗縣,苑裡鎮,房裡里,64,1,659,10,669,995,3,1,3,0,1,0,67.24
苗栗縣,苑裡鎮,房裡里,65,1,675,13,688,1099,3,1,3,0,1,0,62.60
苗栗縣,苑裡鎮,客庄里,66,1,693,6,699,1051,3,1,3,0,1,0,66.51
苗栗縣,苑裡鎮,客庄里,67,1,707,9,716,1061,3,1,3,0,1,0,67.48
苗栗縣,苑裡鎮,客庄里,68,1,692,6,698,1043,3,1,3,0,1,0,66.92
苗栗縣,苑裡鎮,中正里,69,1,593,7,600,897,3,1,3,0,1,0,66.89
苗栗縣,苑裡鎮,中正里,70,1,578,5,583,869,3,1,3,0,1,0,67.09
苗栗縣,苑裡鎮,苑坑里,71,1,618,9,627,997,3,1,3,0,1,0,62.89
苗栗縣,苑裡鎮,水坡里,72,1,374,4,378,597,3,1,3,0,1,0,63.32
苗栗縣,苑裡鎮,新復里,73,1,747,4,751,1107,3,1,3,0,1,0,67.84
苗栗縣,苑裡鎮,山腳里,74,1,519,6,525,814,3,1,3,0,1,0,64.50
苗栗縣,苑裡鎮,山腳里,75,1,474,3,477,714,3,1,3,0,1,0,66.81
苗栗縣,苑裡鎮,舊社里,76,1,586,8,594,899,3,1,3,0,1,0,66.07
苗栗縣,苑裡鎮,舊社里,77,1,463,4,467,725,3,1,3,0,1,0,64.41
苗栗縣,苑裡鎮,福田里,78,1,772,13,785,1224,3,1,3,0,1,0,64.13
苗栗縣,苑裡鎮,石鎮里,79,1,444,4,448,616,3,1,3,0,1,0,72.73
苗栗縣,苑裡鎮,蕉埔里,80,1,617,14,631,896,3,1,3,0,1,0,70.42
苗栗縣,苑裡鎮,南勢里,81,1,464,12,476,718,3,1,3,0,1,0,66.30
苗栗縣,苑裡鎮,泰田里,82,1,933,7,940,1447,3,1,3,0,1,0,64.96
苗栗縣,苑裡鎮,上館里,83,1,960,23,983,1501,3,1,3,0,1,0,65.49
苗栗縣,苑裡鎮,玉田里,84,1,986,15,1001,1548,3,1,3,0,1,0,64.66
苗栗縣,苑裡鎮,社苓里,85,1,606,11,617,975,3,1,3,0,1,0,63.28
苗栗縣,苑裡鎮,社苓里,86,1,613,4,617,986,3,1,3,0,1,0,62.58
苗栗縣,苑裡鎮,山柑里,87,1,771,6,777,1157,3,1,3,0,1,0,67.16
苗栗縣,苑裡鎮,田心里,88,1,858,7,865,1313,3,1,3,0,1,0,65.88
苗栗縣,通霄鎮,通東里,89,1,873,10,883,1262,3,1,3,0,1,0,69.97
苗栗縣,通霄鎮,通西里,90,1,848,6,854,1193,3,1,3,0,1,0,71.58
苗栗縣,通霄鎮,通西里,91,1,697,2,699,958,3,1,3,0,1,0,72.96
苗栗縣,通霄鎮,平元里,92,1,897,5,902,1321,3,1,3,0,1,0,68.28
苗栗縣,通霄鎮,平元里,93,1,823,5,828,1154,3,1,3,0,1,0,71.75
苗栗縣,通霄鎮,平元里,94,1,699,10,709,1116,3,1,3,0,1,0,63.53
苗栗縣,通霄鎮,五南里,95,1,926,7,933,1296,3,1,3,0,1,0,71.99
苗栗縣,通霄鎮,五北里,96,1,462,4,466,661,3,1,3,0,1,0,70.50
苗栗縣,通霄鎮,五北里,97,1,551,1,552,774,3,1,3,0,1,0,71.32
苗栗縣,通霄鎮,梅南里,98,1,561,4,565,816,3,1,3,0,1,0,69.24
苗栗縣,通霄鎮,梅南里,99,1,462,5,467,663,3,1,3,0,1,0,70.44
苗栗縣,通霄鎮,通南里,100,1,804,4,808,1187,3,1,3,0,1,0,68.07
苗栗縣,通霄鎮,通南里,101,1,821,8,829,1315,3,1,3,0,1,0,63.04
苗栗縣,通霄鎮,坪頂里,102,1,824,5,829,1184,3,1,3,0,1,0,70.02
苗栗縣,通霄鎮,福興里,103,1,440,9,449,647,3,1,3,0,1,0,69.40
苗栗縣,通霄鎮,南和里,104,1,612,5,617,827,3,1,3,0,1,0,74.61
苗栗縣,通霄鎮,城南里,105,1,665,11,676,1016,3,1,3,0,1,0,66.54
苗栗縣,通霄鎮,城北里,106,1,446,10,456,695,3,1,3,0,1,0,65.61
苗栗縣,通霄鎮,圳頭里,107,1,543,1,544,753,3,1,3,0,1,0,72.24
苗栗縣,通霄鎮,內湖里,108,1,715,7,722,1013,3,1,3,0,1,0,71.27
苗栗縣,通霄鎮,內湖里,109,1,516,4,520,736,3,1,3,0,1,0,70.65
苗栗縣,通霄鎮,楓樹里,110,1,386,5,391,560,3,1,3,0,1,0,69.82
苗栗縣,通霄鎮,烏眉里,111,1,645,11,656,937,3,1,3,0,1,0,70.01
苗栗縣,通霄鎮,福龍里,112,1,342,1,343,509,3,1,3,0,1,0,67.39
苗栗縣,通霄鎮,福源里,113,1,514,5,519,779,3,1,3,0,1,0,66.62
苗栗縣,通霄鎮,通灣里,114,1,744,11,755,1113,3,1,3,0,1,0,67.83
苗栗縣,通霄鎮,通灣里,115,1,670,5,675,1015,3,1,3,0,1,0,66.50
苗栗縣,通霄鎮,新埔里,116,1,872,19,891,1254,3,1,3,0,1,0,71.05
苗栗縣,通霄鎮,內島里,117,1,495,9,504,759,3,1,3,0,1,0,66.40
苗栗縣,通霄鎮,白東里,118,1,400,8,408,649,3,1,3,0,1,0,62.87
苗栗縣,通霄鎮,白東里,119,1,405,4,409,666,3,1,3,0,1,0,61.41
苗栗縣,通霄鎮,白西里,120,1,529,5,534,813,3,1,3,0,1,0,65.68
苗栗縣,竹南鎮,竹南里,121,1,718,8,726,1070,3,1,3,0,1,0,67.85
苗栗縣,竹南鎮,竹南里,122,1,531,7,538,788,3,1,3,0,1,0,68.27
苗栗縣,竹南鎮,照南里,123,1,842,5,847,1238,3,1,3,0,1,0,68.42
苗栗縣,竹南鎮,照南里,124,1,744,6,750,1080,3,1,3,0,1,0,69.44
苗栗縣,竹南鎮,正南里,125,1,624,8,632,921,3,1,3,0,1,0,68.62
苗栗縣,竹南鎮,正南里,126,1,807,12,819,1297,3,1,3,0,1,0,63.15
苗栗縣,竹南鎮,新南里,127,1,511,6,517,825,3,1,3,0,1,0,62.67
苗栗縣,竹南鎮,新南里,128,1,542,2,544,799,3,1,3,0,1,0,68.09
苗栗縣,竹南鎮,新南里,129,1,732,9,741,1077,3,1,3,0,1,0,68.80
苗栗縣,竹南鎮,大厝里,130,1,818,10,828,1184,3,1,3,0,1,0,69.93
苗栗縣,竹南鎮,大厝里,131,1,654,19,673,1014,3,1,3,0,1,0,66.37
苗栗縣,竹南鎮,大厝里,132,1,591,4,595,868,3,1,3,0,1,0,68.55
苗栗縣,竹南鎮,營盤里,133,1,814,13,827,1213,3,1,3,0,1,0,68.18
苗栗縣,竹南鎮,營盤里,134,1,834,4,838,1256,3,1,3,0,1,0,66.72
苗栗縣,竹南鎮,聖福里,135,1,657,7,664,986,3,1,3,0,1,0,67.34
苗栗縣,竹南鎮,聖福里,136,1,734,8,742,1189,3,1,3,0,1,0,62.41
苗栗縣,竹南鎮,竹興里,137,1,530,13,543,849,3,1,3,0,1,0,63.96
苗栗縣,竹南鎮,竹興里,138,1,574,12,586,910,3,1,3,0,1,0,64.40
苗栗縣,竹南鎮,竹興里,139,1,614,21,635,949,3,1,3,0,1,0,66.91
苗栗縣,竹南鎮,龍鳳里,140,1,576,6,582,831,3,1,3,0,1,0,70.04
苗栗縣,竹南鎮,龍鳳里,141,1,495,9,504,774,3,1,3,0,1,0,65.12
苗栗縣,竹南鎮,龍鳳里,142,1,883,5,888,1337,3,1,3,0,1,0,66.42
苗栗縣,竹南鎮,龍鳳里,143,1,833,8,841,1218,3,1,3,0,1,0,69.05
苗栗縣,竹南鎮,山佳里,144,1,775,10,785,1167,3,1,3,0,1,0,67.27
苗栗縣,竹南鎮,山佳里,145,1,902,9,911,1600,3,1,3,0,1,0,56.94
苗栗縣,竹南鎮,山佳里,146,1,683,7,690,1052,3,1,3,0,1,0,65.59
苗栗縣,竹南鎮,山佳里,147,1,670,0,670,1041,3,1,3,0,1,0,64.36
苗栗縣,竹南鎮,中港里,148,1,598,10,608,883,3,1,3,0,1,0,68.86
苗栗縣,竹南鎮,中華里,149,1,568,13,581,809,3,1,3,0,1,0,71.82
苗栗縣,竹南鎮,中華里,150,1,882,10,892,1385,3,1,3,0,1,0,64.40
苗栗縣,竹南鎮,中英里,151,1,796,12,808,1150,3,1,3,0,1,0,70.26
苗栗縣,竹南鎮,中美里,152,1,1002,17,1019,1547,3,1,3,0,1,0,65.87
苗栗縣,竹南鎮,開元里,153,1,366,6,372,526,3,1,3,0,1,0,70.72
苗栗縣,竹南鎮,海口里,154,1,672,5,677,1095,3,1,3,0,1,0,61.83
苗栗縣,竹南鎮,海口里,155,1,585,11,596,951,3,1,3,0,1,0,62.67
苗栗縣,竹南鎮,港墘里,156,1,987,11,998,1382,3,1,3,0,1,0,72.21
苗栗縣,竹南鎮,公館里,157,1,687,13,700,1087,3,1,3,0,1,0,64.40
苗栗縣,竹南鎮,大埔里,158,1,557,14,571,794,3,1,3,0,1,0,71.91
苗栗縣,竹南鎮,大埔里,159,1,756,17,773,1236,3,1,3,0,1,0,62.54
苗栗縣,竹南鎮,大埔里,160,1,591,15,606,943,3,1,3,0,1,0,64.26
苗栗縣,竹南鎮,頂埔里,161,1,733,10,743,1126,3,1,3,0,1,0,65.99
苗栗縣,竹南鎮,頂埔里,162,1,633,14,647,990,3,1,3,0,1,0,65.35
苗栗縣,竹南鎮,崎頂里,163,1,827,16,843,1365,3,1,3,0,1,0,61.76
苗栗縣,竹南鎮,崎頂里,164,1,733,5,738,1093,3,1,3,0,1,0,67.52
苗栗縣,竹南鎮,公義里,165,1,552,7,559,896,3,1,3,0,1,0,62.39
苗栗縣,頭份鎮,流東里,166,1,549,6,555,740,3,1,3,0,1,0,75.00
苗栗縣,頭份鎮,流東里,167,1,807,18,825,1263,3,1,3,0,1,0,65.32
苗栗縣,頭份鎮,珊湖里,168,1,621,7,628,895,3,1,3,0,1,0,70.17
苗栗縣,頭份鎮,珊湖里,169,1,614,7,621,876,3,1,3,0,1,0,70.89
苗栗縣,頭份鎮,斗煥里,170,1,671,6,677,976,3,1,3,0,1,0,69.36
苗栗縣,頭份鎮,斗煥里,171,1,585,4,589,836,3,1,3,0,1,0,70.45
苗栗縣,頭份鎮,斗煥里,172,1,607,6,613,923,3,1,3,0,1,0,66.41
苗栗縣,頭份鎮,新華里,173,1,724,7,731,1022,3,1,3,0,1,0,71.53
苗栗縣,頭份鎮,新華里,174,1,728,8,736,1140,3,1,3,0,1,0,64.56
苗栗縣,頭份鎮,新華里,175,1,811,11,822,1253,3,1,3,0,1,0,65.60
苗栗縣,頭份鎮,興隆里,176,1,1017,10,1027,1600,3,1,3,0,1,0,64.19
苗栗縣,頭份鎮,興隆里,177,1,768,9,777,1209,3,1,3,0,1,0,64.27
苗栗縣,頭份鎮,上埔里,178,1,883,12,895,1324,3,1,3,0,1,0,67.60
苗栗縣,頭份鎮,上埔里,179,1,677,10,687,981,3,1,3,0,1,0,70.03
苗栗縣,頭份鎮,土牛里,180,1,524,5,529,780,3,1,3,0,1,0,67.82
苗栗縣,頭份鎮,頭份里,181,1,871,10,881,1412,3,1,3,0,1,0,62.39
苗栗縣,頭份鎮,頭份里,182,1,780,8,788,1226,3,1,3,0,1,0,64.27
苗栗縣,頭份鎮,忠孝里,183,1,842,9,851,1344,3,1,3,0,1,0,63.32
苗栗縣,頭份鎮,忠孝里,184,1,1064,8,1072,1560,3,1,3,0,1,0,68.72
苗栗縣,頭份鎮,忠孝里,185,1,862,7,869,1330,3,1,3,0,1,0,65.34
苗栗縣,頭份鎮,仁愛里,186,1,955,28,983,1510,3,1,3,0,1,0,65.10
苗栗縣,頭份鎮,信義里,187,1,532,7,539,736,3,1,3,0,1,0,73.23
苗栗縣,頭份鎮,和平里,188,1,679,5,684,983,3,1,3,0,1,0,69.58
苗栗縣,頭份鎮,上興里,189,1,756,8,764,1098,3,1,3,0,1,0,69.58
苗栗縣,頭份鎮,下興里,190,1,601,5,606,967,3,1,3,0,1,0,62.67
苗栗縣,頭份鎮,下興里,191,1,692,11,703,1031,3,1,3,0,1,0,68.19
苗栗縣,頭份鎮,山下里,192,1,854,13,867,1251,3,1,3,0,1,0,69.30
苗栗縣,頭份鎮,山下里,193,1,620,6,626,933,3,1,3,0,1,0,67.10
苗栗縣,頭份鎮,後庄里,194,1,1010,12,1022,1537,3,1,3,0,1,0,66.49
苗栗縣,頭份鎮,後庄里,195,1,1007,13,1020,1627,3,1,3,0,1,0,62.69
苗栗縣,頭份鎮,後庄里,196,1,891,14,905,1337,3,1,3,0,1,0,67.69
苗栗縣,頭份鎮,建國里,197,1,736,15,751,1190,3,1,3,0,1,0,63.11
苗栗縣,頭份鎮,建國里,198,1,800,7,807,1225,3,1,3,0,1,0,65.88
苗栗縣,頭份鎮,成功里,199,1,862,9,871,1344,3,1,3,0,1,0,64.81
苗栗縣,頭份鎮,成功里,200,1,735,11,746,1174,3,1,3,0,1,0,63.54
苗栗縣,頭份鎮,蟠桃里,201,1,664,8,672,984,3,1,3,0,1,0,68.29
苗栗縣,頭份鎮,蟠桃里,202,1,667,10,677,1134,3,1,3,0,1,0,59.70
苗栗縣,頭份鎮,東庄里,203,1,710,7,717,1095,3,1,3,0,1,0,65.48
苗栗縣,頭份鎮,東庄里,204,1,752,14,766,1218,3,1,3,0,1,0,62.89
苗栗縣,頭份鎮,民族里,205,1,990,18,1008,1543,3,1,3,0,1,0,65.33
苗栗縣,頭份鎮,民權里,206,1,550,8,558,864,3,1,3,0,1,0,64.58
苗栗縣,頭份鎮,民權里,207,1,488,6,494,768,3,1,3,0,1,0,64.32
苗栗縣,頭份鎮,民生里,208,1,577,7,584,916,3,1,3,0,1,0,63.76
苗栗縣,頭份鎮,民生里,209,1,620,13,633,974,3,1,3,0,1,0,64.99
苗栗縣,頭份鎮,田寮里,210,1,932,9,941,1400,3,1,3,0,1,0,67.21
苗栗縣,頭份鎮,田寮里,211,1,795,13,808,1257,3,1,3,0,1,0,64.28
苗栗縣,頭份鎮,蘆竹里,212,1,915,11,926,1293,3,1,3,0,1,0,71.62
苗栗縣,頭份鎮,尖山里,213,1,897,15,912,1269,3,1,3,0,1,0,71.87
苗栗縣,頭份鎮,廣興里,214,1,613,7,620,866,3,1,3,0,1,0,71.59
苗栗縣,頭份鎮,尖下里,215,1,702,6,708,1050,3,1,3,0,1,0,67.43
苗栗縣,頭份鎮,尖下里,216,1,820,16,836,1321,3,1,3,0,1,0,63.29
苗栗縣,頭份鎮,濫坑里,217,1,676,5,681,1046,3,1,3,0,1,0,65.11
苗栗縣,頭份鎮,濫坑里,218,1,607,6,613,884,3,1,3,0,1,0,69.34
苗栗縣,後龍鎮,南龍里,219,1,409,9,418,626,3,1,3,0,1,0,66.77
苗栗縣,後龍鎮,南龍里,220,1,538,10,548,823,3,1,3,0,1,0,66.59
苗栗縣,後龍鎮,中龍里,221,1,716,7,723,955,3,1,3,0,1,0,75.71
苗栗縣,後龍鎮,北龍里,222,1,929,16,945,1403,3,1,3,0,1,0,67.36
苗栗縣,後龍鎮,大庄里,223,1,892,11,903,1223,3,1,3,0,1,0,73.83
苗栗縣,後龍鎮,大庄里,224,1,747,10,757,1131,3,1,3,0,1,0,66.93
苗栗縣,後龍鎮,大庄里,225,1,619,6,625,932,3,1,3,0,1,0,67.06
苗栗縣,後龍鎮,溪洲里,226,1,656,12,668,1051,3,1,3,0,1,0,63.56
苗栗縣,後龍鎮,溪洲里,227,1,712,12,724,1126,3,1,3,0,1,0,64.30
苗栗縣,後龍鎮,豐富里,228,1,890,8,898,1264,3,1,3,0,1,0,71.04
苗栗縣,後龍鎮,校椅里,229,1,873,13,886,1180,3,1,3,0,1,0,75.08
苗栗縣,後龍鎮,埔頂里,230,1,732,16,748,1048,3,1,3,0,1,0,71.37
苗栗縣,後龍鎮,埔頂里,231,1,763,11,774,1185,3,1,3,0,1,0,65.32
苗栗縣,後龍鎮,新民里,232,1,916,17,933,1307,3,1,3,0,1,0,71.38
苗栗縣,後龍鎮,復興里,233,1,450,5,455,649,3,1,3,0,1,0,70.11
苗栗縣,後龍鎮,東明里,234,1,870,6,876,1399,3,1,3,0,1,0,62.62
苗栗縣,後龍鎮,大山里,235,1,469,9,478,783,3,1,3,0,1,0,61.05
苗栗縣,後龍鎮,大山里,236,1,500,5,505,826,3,1,3,0,1,0,61.14
苗栗縣,後龍鎮,灣寶里,237,1,802,15,817,1319,3,1,3,0,1,0,61.94
苗栗縣,後龍鎮,海寶里,238,1,607,17,624,999,3,1,3,0,1,0,62.46
苗栗縣,後龍鎮,外埔里,239,1,657,13,670,1157,3,1,3,0,1,0,57.91
苗栗縣,後龍鎮,海埔里,240,1,600,13,613,1033,3,1,3,0,1,0,59.34
苗栗縣,後龍鎮,秀水里,241,1,471,9,480,721,3,1,3,0,1,0,66.57
苗栗縣,後龍鎮,水尾里,242,1,677,20,697,1108,3,1,3,0,1,0,62.91
苗栗縣,後龍鎮,龍津里,243,1,417,6,423,644,3,1,3,0,1,0,65.68
苗栗縣,後龍鎮,龍坑里,244,1,805,12,817,1250,3,1,3,0,1,0,65.36
苗栗縣,後龍鎮,福寧里,245,1,528,3,531,816,3,1,3,0,1,0,65.07
苗栗縣,後龍鎮,中和里,246,1,641,10,651,1224,3,1,3,0,1,0,53.19
苗栗縣,後龍鎮,南港里,247,1,716,19,735,1272,3,1,3,0,1,0,57.78
苗栗縣,卓蘭鎮,老庄里,248,1,749,7,756,1045,3,1,3,0,1,0,72.34
苗栗縣,卓蘭鎮,老庄里,249,1,761,10,771,1065,3,1,3,0,1,0,72.39
苗栗縣,卓蘭鎮,新榮里,250,1,845,5,850,1168,3,1,3,0,1,0,72.77
苗栗縣,卓蘭鎮,中街里,251,1,598,8,606,814,3,1,3,0,1,0,74.45
苗栗縣,卓蘭鎮,新厝里,252,1,524,3,527,803,3,1,3,0,1,0,65.63
苗栗縣,卓蘭鎮,新厝里,253,1,549,6,555,762,3,1,3,0,1,0,72.83
苗栗縣,卓蘭鎮,豐田里,254,1,733,14,747,1011,3,1,3,0,1,0,73.89
苗栗縣,卓蘭鎮,西坪里,255,1,373,8,381,564,3,1,3,0,1,0,67.55
苗栗縣,卓蘭鎮,苗豐里,256,1,507,17,524,723,3,1,3,0,1,0,72.48
苗栗縣,卓蘭鎮,上新里,257,1,487,10,497,757,3,1,3,0,1,0,65.65
苗栗縣,卓蘭鎮,上新里,258,1,558,4,562,804,3,1,3,0,1,0,69.90
苗栗縣,卓蘭鎮,上新里,259,1,308,10,318,438,3,1,3,0,1,0,72.60
苗栗縣,卓蘭鎮,內灣里,260,1,476,5,481,675,3,1,3,0,1,0,71.26
苗栗縣,卓蘭鎮,內灣里,261,1,523,6,529,732,3,1,3,0,1,0,72.27
苗栗縣,卓蘭鎮,內灣里,262,1,487,7,494,668,3,1,3,0,1,0,73.95
苗栗縣,卓蘭鎮,坪林里,263,1,607,12,619,968,3,1,3,0,1,0,63.95
苗栗縣,卓蘭鎮,坪林里,264,1,326,6,332,473,3,1,3,0,1,0,70.19
苗栗縣,卓蘭鎮,景山里,265,1,446,11,457,693,3,1,3,0,1,0,65.95
苗栗縣,大湖鄉,大湖村,266,1,543,10,553,794,3,1,3,0,1,0,69.65
苗栗縣,大湖鄉,大湖村,267,1,594,8,602,907,3,1,3,0,1,0,66.37
苗栗縣,大湖鄉,明湖村,268,1,508,3,511,673,3,1,3,0,1,0,75.93
苗栗縣,大湖鄉,靜湖村,269,1,534,8,542,849,3,1,3,0,1,0,63.84
苗栗縣,大湖鄉,靜湖村,270,1,543,3,546,787,3,1,3,0,1,0,69.38
苗栗縣,大湖鄉,富興村,271,1,874,24,898,1364,3,1,3,0,1,0,65.84
苗栗縣,大湖鄉,大南村,272,1,403,9,412,662,3,1,3,0,1,0,62.24
苗栗縣,大湖鄉,大寮村,273,1,800,11,811,1238,3,1,3,0,1,0,65.51
苗栗縣,大湖鄉,南湖村,274,1,497,10,507,749,3,1,3,0,1,0,67.69
苗栗縣,大湖鄉,義和村,275,1,430,3,433,689,3,1,3,0,1,0,62.84
苗栗縣,大湖鄉,義和村,276,1,527,8,535,827,3,1,3,0,1,0,64.69
苗栗縣,大湖鄉,東興村,277,1,503,3,506,745,3,1,3,0,1,0,67.92
苗栗縣,大湖鄉,武榮村,278,1,356,3,359,528,3,1,3,0,1,0,67.99
苗栗縣,大湖鄉,栗林村,279,1,575,7,582,910,3,1,3,0,1,0,63.96
苗栗縣,大湖鄉,新開村,280,1,546,10,556,888,3,1,3,0,1,0,62.61
苗栗縣,公館鄉,館中村,281,1,608,6,614,814,3,1,3,0,1,0,75.43
苗栗縣,公館鄉,館中村,282,1,495,13,508,708,3,1,3,0,1,0,71.75
苗栗縣,公館鄉,館東村,283,1,727,20,747,1059,3,1,3,0,1,0,70.54
苗栗縣,公館鄉,館東村,284,1,726,19,745,1070,3,1,3,0,1,0,69.63
苗栗縣,公館鄉,館南村,285,1,889,5,894,1258,3,1,3,0,1,0,71.07
苗栗縣,公館鄉,館南村,286,1,931,17,948,1416,3,1,3,0,1,0,66.95
苗栗縣,公館鄉,中義村,287,1,656,15,671,997,3,1,3,0,1,0,67.30
苗栗縣,公館鄉,中義村,288,1,625,13,638,944,3,1,3,0,1,0,67.58
苗栗縣,公館鄉,玉泉村,289,1,629,12,641,893,3,1,3,0,1,0,71.78
苗栗縣,公館鄉,玉泉村,290,1,512,10,522,763,3,1,3,0,1,0,68.41
苗栗縣,公館鄉,大坑村,291,1,654,21,675,963,3,1,3,0,1,0,70.09
苗栗縣,公館鄉,福基村,292,1,736,14,750,1062,3,1,3,0,1,0,70.62
苗栗縣,公館鄉,福德村,293,1,278,5,283,406,3,1,3,0,1,0,69.70
苗栗縣,公館鄉,福星村,294,1,485,11,496,732,3,1,3,0,1,0,67.76
苗栗縣,公館鄉,福星村,295,1,596,10,606,902,3,1,3,0,1,0,67.18
苗栗縣,公館鄉,石墻村,296,1,522,8,530,717,3,1,3,0,1,0,73.92
苗栗縣,公館鄉,石墻村,297,1,459,13,472,699,3,1,3,0,1,0,67.53
苗栗縣,公館鄉,開礦村,298,1,250,2,252,318,3,1,3,0,1,0,79.25
苗栗縣,公館鄉,五谷村,299,1,600,11,611,891,3,1,3,0,1,0,68.57
苗栗縣,公館鄉,五谷村,300,1,597,12,609,865,3,1,3,0,1,0,70.40
苗栗縣,公館鄉,玉谷村,301,1,763,12,775,1078,3,1,3,0,1,0,71.89
苗栗縣,公館鄉,鶴岡村,302,1,1029,14,1043,1401,3,1,3,0,1,0,74.45
苗栗縣,公館鄉,鶴山村,303,1,929,14,943,1325,3,1,3,0,1,0,71.17
苗栗縣,公館鄉,尖山村,304,1,897,17,914,1367,3,1,3,0,1,0,66.86
苗栗縣,公館鄉,仁安村,305,1,815,12,827,1159,3,1,3,0,1,0,71.35
苗栗縣,公館鄉,南河村,306,1,160,4,164,233,3,1,3,0,1,0,70.39
苗栗縣,公館鄉,北河村,307,1,235,5,240,305,3,1,3,0,1,0,78.69
苗栗縣,銅鑼鄉,福興村,308,1,723,7,730,1046,3,1,3,0,1,0,69.79
苗栗縣,銅鑼鄉,朝陽村,309,1,583,12,595,883,3,1,3,0,1,0,67.38
苗栗縣,銅鑼鄉,朝陽村,310,1,523,13,536,756,3,1,3,0,1,0,70.90
苗栗縣,銅鑼鄉,竹森村,311,1,698,9,707,1078,3,1,3,0,1,0,65.58
苗栗縣,銅鑼鄉,銅鑼村,312,1,996,5,1001,1444,3,1,3,0,1,0,69.32
苗栗縣,銅鑼鄉,銅鑼村,313,1,1197,16,1213,1698,3,1,3,0,1,0,71.44
苗栗縣,銅鑼鄉,銅鑼村,314,1,623,7,630,988,3,1,3,0,1,0,63.77
苗栗縣,銅鑼鄉,九湖村,315,1,879,16,895,1263,3,1,3,0,1,0,70.86
苗栗縣,銅鑼鄉,樟樹村,316,1,840,11,851,1244,3,1,3,0,1,0,68.41
苗栗縣,銅鑼鄉,中平村,317,1,805,12,817,1212,3,1,3,0,1,0,67.41
苗栗縣,銅鑼鄉,中平村,318,1,962,16,978,1525,3,1,3,0,1,0,64.13
苗栗縣,銅鑼鄉,興隆村,319,1,432,7,439,634,3,1,3,0,1,0,69.24
苗栗縣,銅鑼鄉,盛隆村,320,1,318,9,327,499,3,1,3,0,1,0,65.53
苗栗縣,銅鑼鄉,新隆村,321,1,364,5,369,566,3,1,3,0,1,0,65.19
苗栗縣,南庄鄉,東,322,1,370,4,374,540,3,1,3,0,1,0,69.26
苗栗縣,南庄鄉,東,323,1,477,7,484,728,3,1,3,0,1,0,66.48
苗栗縣,南庄鄉,西,324,1,447,7,454,674,3,1,3,0,1,0,67.36
苗栗縣,南庄鄉,南江村,325,1,453,7,460,666,3,1,3,0,1,0,69.07
苗栗縣,南庄鄉,南江村,326,1,263,5,268,397,3,1,3,0,1,0,67.51
苗栗縣,南庄鄉,田美村,327,1,521,8,529,865,3,1,3,0,1,0,61.16
苗栗縣,南庄鄉,獅山村,328,1,318,2,320,484,3,1,3,0,1,0,66.12
苗栗縣,南庄鄉,獅山村,329,1,307,3,310,517,3,1,3,0,1,0,59.96
苗栗縣,南庄鄉,南富村,330,1,750,10,760,1066,3,1,3,0,1,0,71.29
苗栗縣,南庄鄉,員林村,331,1,683,6,689,1059,3,1,3,0,1,0,65.06
苗栗縣,南庄鄉,蓬萊村,332,1,274,3,277,450,3,1,3,0,1,0,61.56
苗栗縣,南庄鄉,東河村,333,1,167,1,168,286,3,1,3,0,1,0,58.74
苗栗縣,頭屋鄉,頭屋村,334,1,895,9,904,1280,3,1,3,0,1,0,70.63
苗栗縣,頭屋鄉,頭屋村,335,1,779,4,783,1087,3,1,3,0,1,0,72.03
苗栗縣,頭屋鄉,獅潭村,336,1,512,8,520,790,3,1,3,0,1,0,65.82
苗栗縣,頭屋鄉,獅潭村,337,1,567,7,574,796,3,1,3,0,1,0,72.11
苗栗縣,頭屋鄉,北坑村,338,1,440,9,449,658,3,1,3,0,1,0,68.24
苗栗縣,頭屋鄉,曲洞村,339,1,623,4,627,851,3,1,3,0,1,0,73.68
苗栗縣,頭屋鄉,飛鳳村,340,1,246,0,246,344,3,1,3,0,1,0,71.51
苗栗縣,頭屋鄉,象山村,341,1,611,10,621,899,3,1,3,0,1,0,69.08
苗栗縣,頭屋鄉,象山村,342,1,599,17,616,957,3,1,3,0,1,0,64.37
苗栗縣,頭屋鄉,明德村,343,1,646,10,656,900,3,1,3,0,1,0,72.89
苗栗縣,頭屋鄉,明德村,344,1,150,2,152,204,3,1,3,0,1,0,74.51
苗栗縣,頭屋鄉,鳴鳳村,345,1,225,1,226,332,3,1,3,0,1,0,68.07
苗栗縣,三義鄉,廣盛村,346,1,676,4,680,982,3,1,3,0,1,0,69.25
苗栗縣,三義鄉,廣盛村,347,1,625,8,633,936,3,1,3,0,1,0,67.63
苗栗縣,三義鄉,廣盛村,348,1,685,24,709,1018,3,1,3,0,1,0,69.65
苗栗縣,三義鄉,廣盛村,349,1,675,9,684,945,3,1,3,0,1,0,72.38
苗栗縣,三義鄉,勝興村,350,1,657,13,670,955,3,1,3,0,1,0,70.16
苗栗縣,三義鄉,勝興村,351,1,441,7,448,710,3,1,3,0,1,0,63.10
苗栗縣,三義鄉,勝興村,352,1,707,7,714,1210,3,1,3,0,1,0,59.01
苗栗縣,三義鄉,雙湖村,353,1,631,10,641,921,3,1,3,0,1,0,69.60
苗栗縣,三義鄉,雙湖村,354,1,520,6,526,706,3,1,3,0,1,0,74.50
苗栗縣,三義鄉,雙潭村,355,1,474,15,489,688,3,1,3,0,1,0,71.08
苗栗縣,三義鄉,雙潭村,356,1,474,9,483,664,3,1,3,0,1,0,72.74
苗栗縣,三義鄉,西湖村,357,1,402,6,408,554,3,1,3,0,1,0,73.65
苗栗縣,三義鄉,西湖村,358,1,493,9,502,728,3,1,3,0,1,0,68.96
苗栗縣,三義鄉,龍騰村,359,1,304,7,311,403,3,1,3,0,1,0,77.17
苗栗縣,三義鄉,鯉魚潭村,360,1,576,7,583,818,3,1,3,0,1,0,71.27
苗栗縣,三義鄉,鯉魚潭村,361,1,259,3,262,354,3,1,3,0,1,0,74.01
苗栗縣,西湖鄉,高埔村,362,1,418,7,425,606,3,1,3,0,1,0,70.13
苗栗縣,西湖鄉,下埔村,363,1,407,0,407,560,3,1,3,0,1,0,72.68
苗栗縣,西湖鄉,五湖村,364,1,603,9,612,915,3,1,3,0,1,0,66.89
苗栗縣,西湖鄉,四湖村,365,1,448,6,454,645,3,1,3,0,1,0,70.39
苗栗縣,西湖鄉,三湖村,366,1,630,13,643,971,3,1,3,0,1,0,66.22
苗栗縣,西湖鄉,龍洞村,367,1,353,4,357,540,3,1,3,0,1,0,66.11
苗栗縣,西湖鄉,金獅村,368,1,338,8,346,538,3,1,3,0,1,0,64.31
苗栗縣,西湖鄉,湖東村,369,1,734,21,755,1145,3,1,3,0,1,0,65.94
苗栗縣,西湖鄉,二湖村,370,1,417,7,424,650,3,1,3,0,1,0,65.23
苗栗縣,造橋鄉,造橋村,371,1,1132,13,1145,1669,3,1,3,0,1,0,68.60
苗栗縣,造橋鄉,平興村,372,1,340,9,349,477,3,1,3,0,1,0,73.17
苗栗縣,造橋鄉,豐湖村,373,1,678,7,685,971,3,1,3,0,1,0,70.55
苗栗縣,造橋鄉,大西村,374,1,1070,10,1080,1576,3,1,3,0,1,0,68.53
苗栗縣,造橋鄉,大西村,375,1,910,17,927,1388,3,1,3,0,1,0,66.79
苗栗縣,造橋鄉,錦水村,376,1,373,7,380,538,3,1,3,0,1,0,70.63
苗栗縣,造橋鄉,大龍村,377,1,380,2,382,506,3,1,3,0,1,0,75.49
苗栗縣,造橋鄉,朝陽村,378,1,886,10,896,1363,3,1,3,0,1,0,65.74
苗栗縣,造橋鄉,談文村,379,1,485,8,493,712,3,1,3,0,1,0,69.24
苗栗縣,造橋鄉,龍昇村,380,1,676,12,688,1003,3,1,3,0,1,0,68.59
苗栗縣,三灣鄉,三灣村,381,1,734,6,740,1027,3,1,3,0,1,0,72.05
苗栗縣,三灣鄉,三灣村,382,1,674,4,678,1072,3,1,3,0,1,0,63.25
苗栗縣,三灣鄉,內灣村,383,1,428,4,432,598,3,1,3,0,1,0,72.24
苗栗縣,三灣鄉,銅鏡村,384,1,562,7,569,840,3,1,3,0,1,0,67.74
苗栗縣,三灣鄉,頂寮村,385,1,162,3,165,231,3,1,3,0,1,0,71.43
苗栗縣,三灣鄉,北埔村,386,1,367,4,371,546,3,1,3,0,1,0,67.95
苗栗縣,三灣鄉,大河村,387,1,411,2,413,622,3,1,3,0,1,0,66.40
苗栗縣,三灣鄉,大坪村,388,1,316,4,320,484,3,1,3,0,1,0,66.12
苗栗縣,三灣鄉,永和村,389,1,249,2,251,352,3,1,3,0,1,0,71.31
苗栗縣,獅潭鄉,百壽村,390,1,176,4,180,272,3,1,3,0,1,0,66.18
苗栗縣,獅潭鄉,永興村,391,1,398,8,406,643,3,1,3,0,1,0,63.14
苗栗縣,獅潭鄉,新店村,392,1,666,5,671,958,3,1,3,0,1,0,70.04
苗栗縣,獅潭鄉,和興村,393,1,416,5,421,628,3,1,3,0,1,0,67.04
苗栗縣,獅潭鄉,豐林村,394,1,425,8,433,641,3,1,3,0,1,0,67.55
苗栗縣,獅潭鄉,新豐村,395,1,223,4,227,352,3,1,3,0,1,0,64.49
苗栗縣,獅潭鄉,竹木村,396,1,509,7,516,763,3,1,3,0,1,0,67.63
苗栗縣,泰安鄉,八卦村,397,1,99,3,102,137,3,1,3,0,1,0,74.45
苗栗縣,泰安鄉,錦水村,398,1,236,3,239,391,3,1,3,0,1,0,61.13
苗栗縣,泰安鄉,清安村,399,1,190,3,193,282,3,1,3,0,1,0,68.44
苗栗縣,泰安鄉,清安村,400,1,222,3,225,340,3,1,3,0,1,0,66.18
苗栗縣,泰安鄉,大興村,401,1,67,0,67,104,3,1,3,0,1,0,64.42
苗栗縣,泰安鄉,中興村,402,1,85,1,86,120,3,1,3,0,1,0,71.67
苗栗縣,泰安鄉,梅園村,403,1,17,0,17,26,3,1,3,0,1,0,65.38
苗栗縣,泰安鄉,象鼻村,404,1,30,0,30,49,3,1,3,0,1,0,61.22
苗栗縣,泰安鄉,士林村,405,1,15,1,16,31,3,1,3,0,1,0,51.61
臺中縣,豐原市,豐原里,1,1,601,8,609,935,3,1,3,0,1,0,65.13
臺中縣,豐原市,豐原里,2,1,647,11,658,985,3,1,3,0,1,0,66.80
臺中縣,豐原市,豐榮里,3,1,664,8,672,1033,3,1,3,0,1,0,65.05
臺中縣,豐原市,頂街里,4,1,561,3,564,880,3,1,3,0,1,0,64.09
臺中縣,豐原市,中山里,5,1,675,6,681,945,3,1,3,0,1,0,72.06
臺中縣,豐原市,下街里,6,1,549,5,554,801,3,1,3,0,1,0,69.16
臺中縣,豐原市,中陽里,7,1,951,9,960,1438,3,1,3,0,1,0,66.76
臺中縣,豐原市,中陽里,8,1,890,11,901,1372,3,1,3,0,1,0,65.67
臺中縣,豐原市,中陽里,9,1,1140,14,1154,1637,3,1,3,0,1,0,70.49
臺中縣,豐原市,大湳里,10,1,641,5,646,958,3,1,3,0,1,0,67.43
臺中縣,豐原市,大湳里,11,1,746,6,752,1107,3,1,3,0,1,0,67.93
臺中縣,豐原市,北湳里,12,1,808,13,821,1254,3,1,3,0,1,0,65.47
臺中縣,豐原市,北湳里,13,1,780,10,790,1177,3,1,3,0,1,0,67.12
臺中縣,豐原市,東湳里,14,1,803,13,816,1202,3,1,3,0,1,0,67.89
臺中縣,豐原市,東湳里,15,1,839,16,855,1323,3,1,3,0,1,0,64.63
臺中縣,豐原市,東湳里,16,1,768,16,784,1096,3,1,3,0,1,0,71.53
臺中縣,豐原市,西湳里,17,1,1163,27,1190,1792,3,1,3,0,1,0,66.41
臺中縣,豐原市,西湳里,18,1,1168,24,1192,1865,3,1,3,0,1,0,63.91
臺中縣,豐原市,西湳里,19,1,844,13,857,1266,3,1,3,0,1,0,67.69
臺中縣,豐原市,西湳里,20,1,746,9,755,1218,3,1,3,0,1,0,61.99
臺中縣,豐原市,豐西里,21,1,1174,14,1188,1732,3,1,3,0,1,0,68.59
臺中縣,豐原市,圳寮里,22,1,851,13,864,1208,3,1,3,0,1,0,71.52
臺中縣,豐原市,豐圳里,23,1,853,10,863,1263,3,1,3,0,1,0,68.33
臺中縣,豐原市,豐圳里,24,1,906,14,920,1422,3,1,3,0,1,0,64.70
臺中縣,豐原市,富春里,25,1,660,6,666,880,3,1,3,0,1,0,75.68
臺中縣,豐原市,葫蘆里,26,1,566,6,572,808,3,1,3,0,1,0,70.79
臺中縣,豐原市,西安里,27,1,1022,13,1035,1458,3,1,3,0,1,0,70.99
臺中縣,豐原市,西安里,28,1,1091,9,1100,1668,3,1,3,0,1,0,65.95
臺中縣,豐原市,西安里,29,1,1044,12,1056,1541,3,1,3,0,1,0,68.53
臺中縣,豐原市,西勢里,30,1,761,8,769,1159,3,1,3,0,1,0,66.35
臺中縣,豐原市,西勢里,31,1,696,9,705,984,3,1,3,0,1,0,71.65
臺中縣,豐原市,中興里,32,1,827,12,839,1234,3,1,3,0,1,0,67.99
臺中縣,豐原市,中興里,33,1,983,28,1011,1485,3,1,3,0,1,0,68.08
臺中縣,豐原市,社皮里,34,1,947,13,960,1485,3,1,3,0,1,0,64.65
臺中縣,豐原市,社皮里,35,1,913,12,925,1421,3,1,3,0,1,0,65.10
臺中縣,豐原市,社皮里,36,1,892,9,901,1479,3,1,3,0,1,0,60.92
臺中縣,豐原市,社皮里,37,1,824,14,838,1364,3,1,3,0,1,0,61.44
臺中縣,豐原市,社皮里,38,1,962,13,975,1544,3,1,3,0,1,0,63.15
臺中縣,豐原市,三村里,39,1,1055,21,1076,1624,3,1,3,0,1,0,66.26
臺中縣,豐原市,三村里,40,1,899,11,910,1424,3,1,3,0,1,0,63.90
臺中縣,豐原市,三村里,41,1,1061,17,1078,1627,3,1,3,0,1,0,66.26
臺中縣,豐原市,東勢里,42,1,969,17,986,1420,3,1,3,0,1,0,69.44
臺中縣,豐原市,民生里,43,1,664,7,671,1052,3,1,3,0,1,0,63.78
臺中縣,豐原市,田心里,44,1,1076,23,1099,1705,3,1,3,0,1,0,64.46
臺中縣,豐原市,田心里,45,1,955,11,966,1404,3,1,3,0,1,0,68.80
臺中縣,豐原市,田心里,46,1,895,10,905,1401,3,1,3,0,1,0,64.60
臺中縣,豐原市,豐田里,47,1,1136,26,1162,1727,3,1,3,0,1,0,67.28
臺中縣,豐原市,豐田里,48,1,1136,16,1152,1755,3,1,3,0,1,0,65.64
臺中縣,豐原市,豐田里,49,1,1034,31,1065,1657,3,1,3,0,1,0,64.27
臺中縣,豐原市,豐田里,50,1,1040,17,1057,1579,3,1,3,0,1,0,66.94
臺中縣,豐原市,豐田里,51,1,1019,23,1042,1563,3,1,3,0,1,0,66.67
臺中縣,豐原市,鐮村里,52,1,1201,19,1220,1794,3,1,3,0,1,0,68.00
臺中縣,豐原市,鐮村里,53,1,1052,20,1072,1600,3,1,3,0,1,0,67.00
臺中縣,豐原市,陽明里,54,1,775,19,794,1149,3,1,3,0,1,0,69.10
臺中縣,豐原市,陽明里,55,1,809,10,819,1223,3,1,3,0,1,0,66.97
臺中縣,豐原市,南陽里,56,1,967,12,979,1476,3,1,3,0,1,0,66.33
臺中縣,豐原市,南陽里,57,1,1234,24,1258,1979,3,1,3,0,1,0,63.57
臺中縣,豐原市,南陽里,58,1,986,11,997,1478,3,1,3,0,1,0,67.46
臺中縣,豐原市,南陽里,59,1,1049,19,1068,1597,3,1,3,0,1,0,66.88
臺中縣,豐原市,北陽里,60,1,975,13,988,1521,3,1,3,0,1,0,64.96
臺中縣,豐原市,北陽里,61,1,1146,13,1159,1666,3,1,3,0,1,0,69.57
臺中縣,豐原市,北陽里,62,1,1208,16,1224,1824,3,1,3,0,1,0,67.11
臺中縣,豐原市,北陽里,63,1,973,5,978,1454,3,1,3,0,1,0,67.26
臺中縣,豐原市,北陽里,64,1,933,14,947,1461,3,1,3,0,1,0,64.82
臺中縣,豐原市,北陽里,65,1,1014,13,1027,1549,3,1,3,0,1,0,66.30
臺中縣,豐原市,東陽里,66,1,950,10,960,1433,3,1,3,0,1,0,66.99
臺中縣,豐原市,南村里,67,1,825,12,837,1177,3,1,3,0,1,0,71.11
臺中縣,豐原市,南村里,68,1,770,8,778,1260,3,1,3,0,1,0,61.75
臺中縣,豐原市,南村里,69,1,956,10,966,1467,3,1,3,0,1,0,65.85
臺中縣,豐原市,南田里,70,1,1029,15,1044,1565,3,1,3,0,1,0,66.71
臺中縣,豐原市,南田里,71,1,930,6,936,1342,3,1,3,0,1,0,69.75
臺中縣,豐原市,南嵩里,72,1,944,15,959,1473,3,1,3,0,1,0,65.11
臺中縣,豐原市,南嵩里,73,1,846,9,855,1224,3,1,3,0,1,0,69.85
臺中縣,豐原市,翁明里,74,1,1115,19,1134,1636,3,1,3,0,1,0,69.32
臺中縣,豐原市,翁子里,75,1,799,12,811,1195,3,1,3,0,1,0,67.87
臺中縣,豐原市,翁子里,76,1,751,14,765,1124,3,1,3,0,1,0,68.06
臺中縣,豐原市,翁社里,77,1,531,12,543,762,3,1,3,0,1,0,71.26
臺中縣,豐原市,翁社里,78,1,697,15,712,1037,3,1,3,0,1,0,68.66
臺中縣,豐原市,朴子里,79,1,1041,20,1061,1554,3,1,3,0,1,0,68.28
臺中縣,豐原市,朴子里,80,1,802,9,811,1263,3,1,3,0,1,0,64.21
臺中縣,東勢鎮,北興里,81,1,757,11,768,1137,3,1,3,0,1,0,67.55
臺中縣,東勢鎮,中寧里,82,1,568,11,579,830,3,1,3,0,1,0,69.76
臺中縣,東勢鎮,東安里,83,1,857,19,876,1341,3,1,3,0,1,0,65.32
臺中縣,東勢鎮,南平里,84,1,552,8,560,815,3,1,3,0,1,0,68.71
臺中縣,東勢鎮,南平里,85,1,705,11,716,1000,3,1,3,0,1,0,71.60
臺中縣,東勢鎮,延平里,86,1,783,12,795,1156,3,1,3,0,1,0,68.77
臺中縣,東勢鎮,延平里,87,1,698,12,710,1072,3,1,3,0,1,0,66.23
臺中縣,東勢鎮,上新里,88,1,640,10,650,964,3,1,3,0,1,0,67.43
臺中縣,東勢鎮,廣興里,89,1,1009,19,1028,1538,3,1,3,0,1,0,66.84
臺中縣,東勢鎮,泰昌里,90,1,829,17,846,1286,3,1,3,0,1,0,65.79
臺中縣,東勢鎮,泰昌里,91,1,648,8,656,980,3,1,3,0,1,0,66.94
臺中縣,東勢鎮,泰昌里,92,1,512,3,515,794,3,1,3,0,1,0,64.86
臺中縣,東勢鎮,中嵙里,93,1,580,12,592,922,3,1,3,0,1,0,64.21
臺中縣,東勢鎮,中嵙里,94,1,549,2,551,898,3,1,3,0,1,0,61.36
臺中縣,東勢鎮,福隆里,95,1,810,7,817,1294,3,1,3,0,1,0,63.14
臺中縣,東勢鎮,福隆里,96,1,1154,27,1181,1728,3,1,3,0,1,0,68.34
臺中縣,東勢鎮,隆興里,97,1,852,14,866,1347,3,1,3,0,1,0,64.29
臺中縣,東勢鎮,新盛里,98,1,993,20,1013,1511,3,1,3,0,1,0,67.04
臺中縣,東勢鎮,新盛里,99,1,999,29,1028,1528,3,1,3,0,1,0,67.28
臺中縣,東勢鎮,新盛里,100,1,1065,15,1080,1579,3,1,3,0,1,0,68.40
臺中縣,東勢鎮,詒福里,101,1,932,13,945,1447,3,1,3,0,1,0,65.31
臺中縣,東勢鎮,上城里,102,1,658,11,669,977,3,1,3,0,1,0,68.47
臺中縣,東勢鎮,下城里,103,1,644,3,647,887,3,1,3,0,1,0,72.94
臺中縣,東勢鎮,慶東里,104,1,701,7,708,1063,3,1,3,0,1,0,66.60
臺中縣,東勢鎮,慶東里,105,1,581,3,584,855,3,1,3,0,1,0,68.30
臺中縣,東勢鎮,慶福里,106,1,814,16,830,1390,3,1,3,0,1,0,59.71
臺中縣,東勢鎮,東新里,107,1,550,5,555,805,3,1,3,0,1,0,68.94
臺中縣,東勢鎮,東新里,108,1,768,9,777,1176,3,1,3,0,1,0,66.07
臺中縣,東勢鎮,粵寧里,109,1,700,15,715,1070,3,1,3,0,1,0,66.82
臺中縣,東勢鎮,粵寧里,110,1,395,3,398,624,3,1,3,0,1,0,63.78
臺中縣,東勢鎮,下新里,111,1,1037,17,1054,1580,3,1,3,0,1,0,66.71
臺中縣,東勢鎮,興隆里,112,1,759,10,769,1221,3,1,3,0,1,0,62.98
臺中縣,東勢鎮,茂興里,113,1,989,17,1006,1684,3,1,3,0,1,0,59.74
臺中縣,東勢鎮,泰興里,114,1,473,10,483,734,3,1,3,0,1,0,65.80
臺中縣,東勢鎮,埤頭里,115,1,487,9,496,657,3,1,3,0,1,0,75.49
臺中縣,東勢鎮,明正里,116,1,923,23,946,1380,3,1,3,0,1,0,68.55
臺中縣,大甲鎮,朝陽里,117,1,859,12,871,1249,3,1,3,0,1,0,69.74
臺中縣,大甲鎮,大甲里,118,1,762,12,774,1161,3,1,3,0,1,0,66.67
臺中縣,大甲鎮,順天里,119,1,552,7,559,819,3,1,3,0,1,0,68.25
臺中縣,大甲鎮,順天里,120,1,536,6,542,825,3,1,3,0,1,0,65.70
臺中縣,大甲鎮,孔門里,121,1,516,8,524,745,3,1,3,0,1,0,70.34
臺中縣,大甲鎮,平安里,122,1,579,11,590,845,3,1,3,0,1,0,69.82
臺中縣,大甲鎮,平安里,123,1,657,10,667,1041,3,1,3,0,1,0,64.07
臺中縣,大甲鎮,庄美里,124,1,646,7,653,943,3,1,3,0,1,0,69.25
臺中縣,大甲鎮,庄美里,125,1,660,7,667,980,3,1,3,0,1,0,68.06
臺中縣,大甲鎮,新美里,126,1,672,13,685,1029,3,1,3,0,1,0,66.57
臺中縣,大甲鎮,新美里,127,1,709,9,718,1052,3,1,3,0,1,0,68.25
臺中縣,大甲鎮,新美里,128,1,699,12,711,1009,3,1,3,0,1,0,70.47
臺中縣,大甲鎮,岷山里,129,1,565,9,574,822,3,1,3,0,1,0,69.83
臺中縣,大甲鎮,岷山里,130,1,579,9,588,867,3,1,3,0,1,0,67.82
臺中縣,大甲鎮,中山里,131,1,613,8,621,963,3,1,3,0,1,0,64.49
臺中縣,大甲鎮,中山里,132,1,630,9,639,1019,3,1,3,0,1,0,62.71
臺中縣,大甲鎮,中山里,133,1,758,19,777,1194,3,1,3,0,1,0,65.08
臺中縣,大甲鎮,南陽里,134,1,570,5,575,845,3,1,3,0,1,0,68.05
臺中縣,大甲鎮,薰風里,135,1,585,5,590,892,3,1,3,0,1,0,66.14
臺中縣,大甲鎮,義和里,136,1,807,20,827,1244,3,1,3,0,1,0,66.48
臺中縣,大甲鎮,義和里,137,1,843,15,858,1297,3,1,3,0,1,0,66.15
臺中縣,大甲鎮,武陵里,138,1,797,18,815,1056,3,1,3,0,1,0,77.18
臺中縣,大甲鎮,文曲里,139,1,709,19,728,1068,3,1,3,0,1,0,68.16
臺中縣,大甲鎮,武曲里,140,1,541,11,552,753,3,1,3,0,1,0,73.31
臺中縣,大甲鎮,武曲里,141,1,490,7,497,740,3,1,3,0,1,0,67.16
臺中縣,大甲鎮,文武里,142,1,695,5,700,1089,3,1,3,0,1,0,64.28
臺中縣,大甲鎮,文武里,143,1,714,10,724,1034,3,1,3,0,1,0,70.02
臺中縣,大甲鎮,文武里,144,1,703,7,710,1071,3,1,3,0,1,0,66.29
臺中縣,大甲鎮,文武里,145,1,686,6,692,1110,3,1,3,0,1,0,62.34
臺中縣,大甲鎮,奉化里,146,1,825,20,845,1234,3,1,3,0,1,0,68.48
臺中縣,大甲鎮,德化里,147,1,517,8,525,776,3,1,3,0,1,0,67.65
臺中縣,大甲鎮,德化里,148,1,491,5,496,775,3,1,3,0,1,0,64.00
臺中縣,大甲鎮,江南里,149,1,669,9,678,979,3,1,3,0,1,0,69.25
臺中縣,大甲鎮,頂店里,150,1,631,11,642,972,3,1,3,0,1,0,66.05
臺中縣,大甲鎮,頂店里,151,1,689,11,700,1035,3,1,3,0,1,0,67.63
臺中縣,大甲鎮,頂店里,152,1,790,11,801,1217,3,1,3,0,1,0,65.82
臺中縣,大甲鎮,太白里,153,1,736,10,746,1193,3,1,3,0,1,0,62.53
臺中縣,大甲鎮,孟春里,154,1,752,3,755,1111,3,1,3,0,1,0,67.96
臺中縣,大甲鎮,孟春里,155,1,604,7,611,999,3,1,3,0,1,0,61.16
臺中縣,大甲鎮,孟春里,156,1,577,9,586,959,3,1,3,0,1,0,61.11
臺中縣,大甲鎮,幸福里,157,1,702,8,710,1101,3,1,3,0,1,0,64.49
臺中縣,大甲鎮,幸福里,158,1,750,12,762,1199,3,1,3,0,1,0,63.55
臺中縣,大甲鎮,日南里,159,1,579,9,588,939,3,1,3,0,1,0,62.62
臺中縣,大甲鎮,日南里,160,1,528,3,531,871,3,1,3,0,1,0,60.96
臺中縣,大甲鎮,日南里,161,1,592,7,599,979,3,1,3,0,1,0,61.18
臺中縣,大甲鎮,日南里,162,1,652,9,661,1016,3,1,3,0,1,0,65.06
臺中縣,大甲鎮,龍泉里,163,1,408,7,415,605,3,1,3,0,1,0,68.60
臺中縣,大甲鎮,龍泉里,164,1,505,10,515,753,3,1,3,0,1,0,68.39
臺中縣,大甲鎮,西岐里,165,1,512,8,520,733,3,1,3,0,1,0,70.94
臺中縣,大甲鎮,西岐里,166,1,479,12,491,691,3,1,3,0,1,0,71.06
臺中縣,大甲鎮,銅安里,167,1,763,24,787,1186,3,1,3,0,1,0,66.36
臺中縣,大甲鎮,福德里,168,1,752,12,764,1048,3,1,3,0,1,0,72.90
臺中縣,大甲鎮,建興里,169,1,876,8,884,1257,3,1,3,0,1,0,70.33
臺中縣,清水鎮,鰲峰里,170,1,776,5,781,1183,3,1,3,0,1,0,66.02
臺中縣,清水鎮,靈泉里,171,1,732,12,744,1063,3,1,3,0,1,0,69.99
臺中縣,清水鎮,清水里,172,1,634,5,639,976,3,1,3,0,1,0,65.47
臺中縣,清水鎮,清水里,173,1,706,6,712,1051,3,1,3,0,1,0,67.75
臺中縣,清水鎮,文昌里,174,1,473,6,479,731,3,1,3,0,1,0,65.53
臺中縣,清水鎮,南寧里,175,1,609,6,615,886,3,1,3,0,1,0,69.41
臺中縣,清水鎮,南寧里,176,1,636,6,642,954,3,1,3,0,1,0,67.30
臺中縣,清水鎮,西寧里,177,1,944,12,956,1438,3,1,3,0,1,0,66.48
臺中縣,清水鎮,北寧里,178,1,509,8,517,736,3,1,3,0,1,0,70.24
臺中縣,清水鎮,中興里,179,1,302,6,308,450,3,1,3,0,1,0,68.44
臺中縣,清水鎮,西社里,180,1,929,22,951,1434,3,1,3,0,1,0,66.32
臺中縣,清水鎮,西社里,181,1,643,14,657,974,3,1,3,0,1,0,67.45
臺中縣,清水鎮,南社里,182,1,704,10,714,1097,3,1,3,0,1,0,65.09
臺中縣,清水鎮,南社里,183,1,790,6,796,1198,3,1,3,0,1,0,66.44
臺中縣,清水鎮,南社里,184,1,829,12,841,1249,3,1,3,0,1,0,67.33
臺中縣,清水鎮,南社里,185,1,828,18,846,1208,3,1,3,0,1,0,70.03
臺中縣,清水鎮,裕嘉里,186,1,733,17,750,1158,3,1,3,0,1,0,64.77
臺中縣,清水鎮,臨江里,187,1,929,19,948,1434,3,1,3,0,1,0,66.11
臺中縣,清水鎮,秀水里,188,1,756,11,767,1185,3,1,3,0,1,0,64.73
臺中縣,清水鎮,秀水里,189,1,802,13,815,1283,3,1,3,0,1,0,63.52
臺中縣,清水鎮,秀水里,190,1,622,9,631,903,3,1,3,0,1,0,69.88
臺中縣,清水鎮,武鹿里,191,1,857,12,869,1317,3,1,3,0,1,0,65.98
臺中縣,清水鎮,武鹿里,192,1,866,17,883,1317,3,1,3,0,1,0,67.05
臺中縣,清水鎮,海濱里,193,1,728,16,744,1081,3,1,3,0,1,0,68.83
臺中縣,清水鎮,海濱里,194,1,486,10,496,761,3,1,3,0,1,0,65.18
臺中縣,清水鎮,康榔里,195,1,802,12,814,1259,3,1,3,0,1,0,64.65
臺中縣,清水鎮,康榔里,196,1,647,13,660,1016,3,1,3,0,1,0,64.96
臺中縣,清水鎮,康榔里,197,1,718,15,733,1102,3,1,3,0,1,0,66.52
臺中縣,清水鎮,中社里,198,1,472,6,478,702,3,1,3,0,1,0,68.09
臺中縣,清水鎮,中社里,199,1,511,3,514,751,3,1,3,0,1,0,68.44
臺中縣,清水鎮,高西里,200,1,830,21,851,1315,3,1,3,0,1,0,64.71
臺中縣,清水鎮,高南里,201,1,836,15,851,1285,3,1,3,0,1,0,66.23
臺中縣,清水鎮,高東里,202,1,750,13,763,1263,3,1,3,0,1,0,60.41
臺中縣,清水鎮,高北里,203,1,677,21,698,1061,3,1,3,0,1,0,65.79
臺中縣,清水鎮,高美里,204,1,804,6,810,1222,3,1,3,0,1,0,66.28
臺中縣,清水鎮,國姓里,205,1,646,8,654,1095,3,1,3,0,1,0,59.73
臺中縣,清水鎮,國姓里,206,1,553,7,560,872,3,1,3,0,1,0,64.22
臺中縣,清水鎮,菁埔里,207,1,677,12,689,1035,3,1,3,0,1,0,66.57
臺中縣,清水鎮,菁埔里,208,1,671,14,685,1117,3,1,3,0,1,0,61.32
臺中縣,清水鎮,頂湳里,209,1,496,5,501,805,3,1,3,0,1,0,62.24
臺中縣,清水鎮,頂湳里,210,1,573,8,581,903,3,1,3,0,1,0,64.34
臺中縣,清水鎮,田寮里,211,1,694,14,708,1120,3,1,3,0,1,0,63.21
臺中縣,清水鎮,田寮里,212,1,551,7,558,952,3,1,3,0,1,0,58.61
臺中縣,清水鎮,橋頭里,213,1,954,10,964,1488,3,1,3,0,1,0,64.78
臺中縣,清水鎮,橋頭里,214,1,946,14,960,1600,3,1,3,0,1,0,60.00
臺中縣,清水鎮,橋頭里,215,1,930,6,936,1506,3,1,3,0,1,0,62.15
臺中縣,清水鎮,橋頭里,216,1,539,9,548,835,3,1,3,0,1,0,65.63
臺中縣,清水鎮,下湳里,217,1,517,5,522,794,3,1,3,0,1,0,65.74
臺中縣,清水鎮,下湳里,218,1,507,4,511,797,3,1,3,0,1,0,64.12
臺中縣,清水鎮,下湳里,219,1,803,10,813,1249,3,1,3,0,1,0,65.09
臺中縣,清水鎮,東山里,220,1,712,17,729,1102,3,1,3,0,1,0,66.15
臺中縣,清水鎮,吳厝里,221,1,899,17,916,1244,3,1,3,0,1,0,73.63
臺中縣,清水鎮,楊厝里,222,1,649,10,659,1004,3,1,3,0,1,0,65.64
臺中縣,清水鎮,海風里,223,1,677,11,688,1174,3,1,3,0,1,0,58.60
臺中縣,沙鹿鎮,居仁里,224,1,936,11,947,1384,3,1,3,0,1,0,68.42
臺中縣,沙鹿鎮,洛泉里,225,1,632,8,640,963,3,1,3,0,1,0,66.46
臺中縣,沙鹿鎮,洛泉里,226,1,875,16,891,1213,3,1,3,0,1,0,73.45
臺中縣,沙鹿鎮,沙鹿里,227,1,789,6,795,1164,3,1,3,0,1,0,68.30
臺中縣,沙鹿鎮,美仁里,228,1,413,4,417,557,3,1,3,0,1,0,74.87
臺中縣,沙鹿鎮,興仁里,229,1,842,15,857,1257,3,1,3,0,1,0,68.18
臺中縣,沙鹿鎮,興仁里,230,1,651,13,664,992,3,1,3,0,1,0,66.94
臺中縣,沙鹿鎮,興安里,231,1,624,22,646,933,3,1,3,0,1,0,69.24
臺中縣,沙鹿鎮,興安里,232,1,1116,9,1125,1576,3,1,3,0,1,0,71.38
臺中縣,沙鹿鎮,斗抵里,233,1,675,16,691,994,3,1,3,0,1,0,69.52
臺中縣,沙鹿鎮,斗抵里,234,1,929,17,946,1434,3,1,3,0,1,0,65.97
臺中縣,沙鹿鎮,斗抵里,235,1,776,12,788,1105,3,1,3,0,1,0,71.31
臺中縣,沙鹿鎮,鹿峰里,236,1,759,11,770,1237,3,1,3,0,1,0,62.25
臺中縣,沙鹿鎮,鹿峰里,237,1,786,14,800,1230,3,1,3,0,1,0,65.04
臺中縣,沙鹿鎮,鹿峰里,238,1,815,16,831,1244,3,1,3,0,1,0,66.80
臺中縣,沙鹿鎮,鹿寮里,239,1,984,14,998,1513,3,1,3,0,1,0,65.96
臺中縣,沙鹿鎮,鹿寮里,240,1,708,9,717,1055,3,1,3,0,1,0,67.96
臺中縣,沙鹿鎮,鹿寮里,241,1,657,9,666,1070,3,1,3,0,1,0,62.24
臺中縣,沙鹿鎮,鹿寮里,242,1,853,15,868,1260,3,1,3,0,1,0,68.89
臺中縣,沙鹿鎮,竹林里,243,1,867,14,881,1231,3,1,3,0,1,0,71.57
臺中縣,沙鹿鎮,竹林里,244,1,835,20,855,1327,3,1,3,0,1,0,64.43
臺中縣,沙鹿鎮,竹林里,245,1,929,15,944,1390,3,1,3,0,1,0,67.91
臺中縣,沙鹿鎮,竹林里,246,1,817,11,828,1235,3,1,3,0,1,0,67.04
臺中縣,沙鹿鎮,犁分里,247,1,587,7,594,843,3,1,3,0,1,0,70.46
臺中縣,沙鹿鎮,福興里,248,1,889,9,898,1304,3,1,3,0,1,0,68.87
臺中縣,沙鹿鎮,福興里,249,1,555,7,562,803,3,1,3,0,1,0,69.99
臺中縣,沙鹿鎮,北勢里,250,1,631,6,637,923,3,1,3,0,1,0,69.01
臺中縣,沙鹿鎮,北勢里,251,1,651,19,670,978,3,1,3,0,1,0,68.51
臺中縣,沙鹿鎮,北勢里,252,1,800,15,815,1181,3,1,3,0,1,0,69.01
臺中縣,沙鹿鎮,晉江里,253,1,849,18,867,1189,3,1,3,0,1,0,72.92
臺中縣,沙鹿鎮,六路里,254,1,626,16,642,944,3,1,3,0,1,0,68.01
臺中縣,沙鹿鎮,六路里,255,1,731,11,742,1100,3,1,3,0,1,0,67.45
臺中縣,沙鹿鎮,南勢里,256,1,648,11,659,902,3,1,3,0,1,0,73.06
臺中縣,沙鹿鎮,南勢里,257,1,623,14,637,862,3,1,3,0,1,0,73.90
臺中縣,沙鹿鎮,埔子里,258,1,995,15,1010,1406,3,1,3,0,1,0,71.83
臺中縣,沙鹿鎮,埔子里,259,1,742,15,757,1043,3,1,3,0,1,0,72.58
臺中縣,沙鹿鎮,埔子里,260,1,1107,17,1124,1474,3,1,3,0,1,0,76.26
臺中縣,沙鹿鎮,公明里,261,1,786,10,796,1247,3,1,3,0,1,0,63.83
臺中縣,沙鹿鎮,公明里,262,1,578,9,587,886,3,1,3,0,1,0,66.25
臺中縣,沙鹿鎮,公明里,263,1,837,12,849,1237,3,1,3,0,1,0,68.63
臺中縣,沙鹿鎮,清泉里,264,1,1198,17,1215,1750,3,1,3,0,1,0,69.43
臺中縣,沙鹿鎮,西勢里,265,1,722,22,744,1053,3,1,3,0,1,0,70.66
臺中縣,沙鹿鎮,西勢里,266,1,612,9,621,932,3,1,3,0,1,0,66.63
臺中縣,梧棲鎮,頂寮里,267,1,718,20,738,1021,3,1,3,0,1,0,72.28
臺中縣,梧棲鎮,頂寮里,268,1,975,5,980,1395,3,1,3,0,1,0,70.25
臺中縣,梧棲鎮,下寮里,269,1,666,15,681,908,3,1,3,0,1,0,75.00
臺中縣,梧棲鎮,下寮里,270,1,721,18,739,1039,3,1,3,0,1,0,71.13
臺中縣,梧棲鎮,中正里,271,1,745,10,755,1055,3,1,3,0,1,0,71.56
臺中縣,梧棲鎮,中正里,272,1,712,11,723,1034,3,1,3,0,1,0,69.92
臺中縣,梧棲鎮,中正里,273,1,720,17,737,1093,3,1,3,0,1,0,67.43
臺中縣,梧棲鎮,中和里,274,1,414,5,419,554,3,1,3,0,1,0,75.63
臺中縣,梧棲鎮,文化里,275,1,888,19,907,1151,3,1,3,0,1,0,78.80
臺中縣,梧棲鎮,安仁里,276,1,537,10,547,741,3,1,3,0,1,0,73.82
臺中縣,梧棲鎮,草湳里,277,1,741,21,762,1073,3,1,3,0,1,0,71.02
臺中縣,梧棲鎮,草湳里,278,1,867,15,882,1268,3,1,3,0,1,0,69.56
臺中縣,梧棲鎮,草湳里,279,1,820,10,830,1172,3,1,3,0,1,0,70.82
臺中縣,梧棲鎮,草湳里,280,1,977,15,992,1320,3,1,3,0,1,0,75.15
臺中縣,梧棲鎮,南簡里,281,1,890,22,912,1172,3,1,3,0,1,0,77.82
臺中縣,梧棲鎮,南簡里,282,1,743,13,756,1111,3,1,3,0,1,0,68.05
臺中縣,梧棲鎮,福德里,283,1,936,15,951,1339,3,1,3,0,1,0,71.02
臺中縣,梧棲鎮,福德里,284,1,913,17,930,1301,3,1,3,0,1,0,71.48
臺中縣,梧棲鎮,大庄里,285,1,741,16,757,1077,3,1,3,0,1,0,70.29
臺中縣,梧棲鎮,大庄里,286,1,592,14,606,916,3,1,3,0,1,0,66.16
臺中縣,梧棲鎮,大庄里,287,1,879,15,894,1273,3,1,3,0,1,0,70.23
臺中縣,梧棲鎮,大庄里,288,1,1036,28,1064,1464,3,1,3,0,1,0,72.68
臺中縣,梧棲鎮,大村里,289,1,857,16,873,1252,3,1,3,0,1,0,69.73
臺中縣,梧棲鎮,大村里,290,1,794,15,809,1156,3,1,3,0,1,0,69.98
臺中縣,梧棲鎮,大村里,291,1,630,14,644,893,3,1,3,0,1,0,72.12
臺中縣,梧棲鎮,興農里,292,1,689,19,708,991,3,1,3,0,1,0,71.44
臺中縣,梧棲鎮,興農里,293,1,550,8,558,721,3,1,3,0,1,0,77.39
臺中縣,梧棲鎮,永寧里,294,1,736,19,755,971,3,1,3,0,1,0,77.75
臺中縣,梧棲鎮,永寧里,295,1,791,13,804,1081,3,1,3,0,1,0,74.38
臺中縣,梧棲鎮,永安里,296,1,833,12,845,1119,3,1,3,0,1,0,75.51
臺中縣,梧棲鎮,永安里,297,1,736,20,756,1059,3,1,3,0,1,0,71.39
臺中縣,后里鄉,廣福村,298,1,637,14,651,911,3,1,3,0,1,0,71.46
臺中縣,后里鄉,廣福村,299,1,658,18,676,930,3,1,3,0,1,0,72.69
臺中縣,后里鄉,仁里村,300,1,623,6,629,894,3,1,3,0,1,0,70.36
臺中縣,后里鄉,仁里村,301,1,995,16,1011,1364,3,1,3,0,1,0,74.12
臺中縣,后里鄉,義里村,302,1,746,10,756,1115,3,1,3,0,1,0,67.80
臺中縣,后里鄉,義里村,303,1,937,6,943,1341,3,1,3,0,1,0,70.32
臺中縣,后里鄉,義里村,304,1,697,14,711,1068,3,1,3,0,1,0,66.57
臺中縣,后里鄉,義里村,305,1,995,22,1017,1525,3,1,3,0,1,0,66.69
臺中縣,后里鄉,后里村,306,1,849,17,866,1205,3,1,3,0,1,0,71.87
臺中縣,后里鄉,后里村,307,1,877,8,885,1245,3,1,3,0,1,0,71.08
臺中縣,后里鄉,后里村,308,1,598,14,612,868,3,1,3,0,1,0,70.51
臺中縣,后里鄉,厚里村,309,1,1233,19,1252,1777,3,1,3,0,1,0,70.46
臺中縣,后里鄉,墩東村,310,1,950,17,967,1397,3,1,3,0,1,0,69.22
臺中縣,后里鄉,墩東村,311,1,856,16,872,1281,3,1,3,0,1,0,68.07
臺中縣,后里鄉,墩東村,312,1,940,15,955,1225,3,1,3,0,1,0,77.96
臺中縣,后里鄉,墩西村,313,1,636,7,643,879,3,1,3,0,1,0,73.15
臺中縣,后里鄉,墩西村,314,1,670,14,684,932,3,1,3,0,1,0,73.39
臺中縣,后里鄉,墩南村,315,1,776,12,788,1123,3,1,3,0,1,0,70.17
臺中縣,后里鄉,墩南村,316,1,899,12,911,1335,3,1,3,0,1,0,68.24
臺中縣,后里鄉,墩北村,317,1,871,15,886,1242,3,1,3,0,1,0,71.34
臺中縣,后里鄉,墩北村,318,1,1039,21,1060,1460,3,1,3,0,1,0,72.60
臺中縣,后里鄉,中和村,319,1,682,13,695,945,3,1,3,0,1,0,73.54
臺中縣,后里鄉,中和村,320,1,645,9,654,921,3,1,3,0,1,0,71.01
臺中縣,后里鄉,舊社村,321,1,863,29,892,1226,3,1,3,0,1,0,72.76
臺中縣,后里鄉,聯合村,322,1,988,23,1011,1461,3,1,3,0,1,0,69.20
臺中縣,后里鄉,太平村,323,1,587,13,600,877,3,1,3,0,1,0,68.42
臺中縣,后里鄉,太平村,324,1,746,12,758,1038,3,1,3,0,1,0,73.03
臺中縣,后里鄉,眉山村,325,1,862,14,876,1226,3,1,3,0,1,0,71.45
臺中縣,后里鄉,眉山村,326,1,745,11,756,1156,3,1,3,0,1,0,65.40
臺中縣,后里鄉,樂業村,327,1,234,8,242,331,3,1,3,0,1,0,73.11
臺中縣,后里鄉,月眉村,328,1,1081,24,1105,1538,3,1,3,0,1,0,71.85
臺中縣,后里鄉,公舘村,329,1,1141,22,1163,1687,3,1,3,0,1,0,68.94
臺中縣,后里鄉,泰安村,330,1,844,18,862,1231,3,1,3,0,1,0,70.02
臺中縣,神岡鄉,神岡村,331,1,811,8,819,1169,3,1,3,0,1,0,70.06
臺中縣,神岡鄉,神岡村,332,1,819,8,827,1184,3,1,3,0,1,0,69.85
臺中縣,神岡鄉,庄前村,333,1,1012,9,1021,1468,3,1,3,0,1,0,69.55
臺中縣,神岡鄉,北庄村,334,1,634,10,644,905,3,1,3,0,1,0,71.16
臺中縣,神岡鄉,北庄村,335,1,775,10,785,1120,3,1,3,0,1,0,70.09
臺中縣,神岡鄉,庄後村,336,1,709,13,722,1055,3,1,3,0,1,0,68.44
臺中縣,神岡鄉,庄後村,337,1,579,14,593,865,3,1,3,0,1,0,68.55
臺中縣,神岡鄉,圳前村,338,1,823,17,840,1221,3,1,3,0,1,0,68.80
臺中縣,神岡鄉,圳前村,339,1,583,12,595,837,3,1,3,0,1,0,71.09
臺中縣,神岡鄉,圳堵村,340,1,602,8,610,803,3,1,3,0,1,0,75.97
臺中縣,神岡鄉,圳堵村,341,1,762,14,776,1114,3,1,3,0,1,0,69.66
臺中縣,神岡鄉,新庄村,342,1,842,10,852,1182,3,1,3,0,1,0,72.08
臺中縣,神岡鄉,新庄村,343,1,761,8,769,1158,3,1,3,0,1,0,66.41
臺中縣,神岡鄉,新庄村,344,1,659,20,679,1092,3,1,3,0,1,0,62.18
臺中縣,神岡鄉,山皮村,345,1,645,11,656,897,3,1,3,0,1,0,73.13
臺中縣,神岡鄉,社口村,346,1,918,10,928,1281,3,1,3,0,1,0,72.44
臺中縣,神岡鄉,社口村,347,1,751,8,759,1130,3,1,3,0,1,0,67.17
臺中縣,神岡鄉,社口村,348,1,787,9,796,1241,3,1,3,0,1,0,64.14
臺中縣,神岡鄉,社口村,349,1,880,8,888,1279,3,1,3,0,1,0,69.43
臺中縣,神岡鄉,社南村,350,1,818,23,841,1266,3,1,3,0,1,0,66.43
臺中縣,神岡鄉,社南村,351,1,863,15,878,1285,3,1,3,0,1,0,68.33
臺中縣,神岡鄉,社南村,352,1,822,12,834,1265,3,1,3,0,1,0,65.93
臺中縣,神岡鄉,三角村,353,1,851,12,863,1264,3,1,3,0,1,0,68.28
臺中縣,神岡鄉,三角村,354,1,506,9,515,763,3,1,3,0,1,0,67.50
臺中縣,神岡鄉,大社村,355,1,1047,19,1066,1587,3,1,3,0,1,0,67.17
臺中縣,神岡鄉,大社村,356,1,814,9,823,1351,3,1,3,0,1,0,60.92
臺中縣,神岡鄉,岸裡村,357,1,866,7,873,1159,3,1,3,0,1,0,75.32
臺中縣,神岡鄉,岸裡村,358,1,793,17,810,1219,3,1,3,0,1,0,66.45
臺中縣,神岡鄉,豐洲村,359,1,975,20,995,1484,3,1,3,0,1,0,67.05
臺中縣,神岡鄉,豐洲村,360,1,1008,24,1032,1559,3,1,3,0,1,0,66.20
臺中縣,神岡鄉,豐洲村,361,1,988,20,1008,1497,3,1,3,0,1,0,67.33
臺中縣,神岡鄉,豐洲村,362,1,899,12,911,1401,3,1,3,0,1,0,65.02
臺中縣,神岡鄉,神洲村,363,1,753,21,774,1085,3,1,3,0,1,0,71.34
臺中縣,神岡鄉,神洲村,364,1,737,16,753,1118,3,1,3,0,1,0,67.35
臺中縣,神岡鄉,溪洲村,365,1,902,15,917,1217,3,1,3,0,1,0,75.35
臺中縣,神岡鄉,溪洲村,366,1,806,25,831,1201,3,1,3,0,1,0,69.19
臺中縣,潭子鄉,潭秀村,367,1,923,8,931,1357,3,1,3,0,1,0,68.61
臺中縣,潭子鄉,潭北村,368,1,1279,26,1305,1998,3,1,3,0,1,0,65.32
臺中縣,潭子鄉,潭陽村,369,1,868,18,886,1519,3,1,3,0,1,0,58.33
臺中縣,潭子鄉,潭陽村,370,1,1246,18,1264,1919,3,1,3,0,1,0,65.87
臺中縣,潭子鄉,潭陽村,371,1,890,6,896,1493,3,1,3,0,1,0,60.01
臺中縣,潭子鄉,潭陽村,372,1,1167,13,1180,1837,3,1,3,0,1,0,64.24
臺中縣,潭子鄉,潭陽村,373,1,928,9,937,1391,3,1,3,0,1,0,67.36
臺中縣,潭子鄉,福仁村,374,1,1149,26,1175,1741,3,1,3,0,1,0,67.49
臺中縣,潭子鄉,福仁村,375,1,1055,13,1068,1844,3,1,3,0,1,0,57.92
臺中縣,潭子鄉,福仁村,376,1,858,14,872,1411,3,1,3,0,1,0,61.80
臺中縣,潭子鄉,福仁村,377,1,1038,19,1057,1701,3,1,3,0,1,0,62.14
臺中縣,潭子鄉,頭家村,378,1,1282,15,1297,2378,3,1,3,0,1,0,54.54
臺中縣,潭子鄉,頭家村,379,1,791,12,803,1325,3,1,3,0,1,0,60.60
臺中縣,潭子鄉,頭家村,380,1,1134,20,1154,1797,3,1,3,0,1,0,64.22
臺中縣,潭子鄉,頭家村,381,1,1287,25,1312,2064,3,1,3,0,1,0,63.57
臺中縣,潭子鄉,頭家村,382,1,1012,9,1021,1533,3,1,3,0,1,0,66.60
臺中縣,潭子鄉,頭家村,383,1,1140,17,1157,1940,3,1,3,0,1,0,59.64
臺中縣,潭子鄉,頭家村,384,1,589,10,599,938,3,1,3,0,1,0,63.86
臺中縣,潭子鄉,甘蔗村,385,1,1306,27,1333,2065,3,1,3,0,1,0,64.55
臺中縣,潭子鄉,甘蔗村,386,1,1088,13,1101,1761,3,1,3,0,1,0,62.52
臺中縣,潭子鄉,甘蔗村,387,1,1225,11,1236,2047,3,1,3,0,1,0,60.38
臺中縣,潭子鄉,東寶村,388,1,687,12,699,1088,3,1,3,0,1,0,64.25
臺中縣,潭子鄉,東寶村,389,1,686,13,699,1038,3,1,3,0,1,0,67.34
臺中縣,潭子鄉,東寶村,390,1,718,9,727,1163,3,1,3,0,1,0,62.51
臺中縣,潭子鄉,東寶村,391,1,1081,19,1100,1679,3,1,3,0,1,0,65.52
臺中縣,潭子鄉,東寶村,392,1,1328,18,1346,1980,3,1,3,0,1,0,67.98
臺中縣,潭子鄉,東寶村,393,1,858,9,867,1371,3,1,3,0,1,0,63.24
臺中縣,潭子鄉,大富村,394,1,1042,22,1064,1678,3,1,3,0,1,0,63.41
臺中縣,潭子鄉,大豐村,395,1,786,10,796,1174,3,1,3,0,1,0,67.80
臺中縣,潭子鄉,大豐村,396,1,1091,17,1108,1786,3,1,3,0,1,0,62.04
臺中縣,潭子鄉,栗林村,397,1,1076,14,1090,1647,3,1,3,0,1,0,66.18
臺中縣,潭子鄉,栗林村,398,1,833,18,851,1264,3,1,3,0,1,0,67.33
臺中縣,潭子鄉,栗林村,399,1,759,4,763,1106,3,1,3,0,1,0,68.99
臺中縣,潭子鄉,嘉仁村,400,1,1012,26,1038,1596,3,1,3,0,1,0,65.04
臺中縣,潭子鄉,嘉仁村,401,1,1100,21,1121,1639,3,1,3,0,1,0,68.40
臺中縣,潭子鄉,新田村,402,1,861,18,879,1442,3,1,3,0,1,0,60.96
臺中縣,潭子鄉,聚興村,403,1,895,14,909,1410,3,1,3,0,1,0,64.47
臺中縣,潭子鄉,聚興村,404,1,836,20,856,1392,3,1,3,0,1,0,61.49
臺中縣,大雅鄉,上雅村,405,1,1123,19,1142,1822,3,1,3,0,1,0,62.68
臺中縣,大雅鄉,上雅村,406,1,1056,17,1073,1747,3,1,3,0,1,0,61.42
臺中縣,大雅鄉,大雅村,407,1,1172,11,1183,1796,3,1,3,0,1,0,65.87
臺中縣,大雅鄉,大雅村,408,1,1164,13,1177,1853,3,1,3,0,1,0,63.52
臺中縣,大雅鄉,文雅村,409,1,904,15,919,1563,3,1,3,0,1,0,58.80
臺中縣,大雅鄉,文雅村,410,1,925,16,941,1383,3,1,3,0,1,0,68.04
臺中縣,大雅鄉,文雅村,411,1,716,22,738,1199,3,1,3,0,1,0,61.55
臺中縣,大雅鄉,三和村,412,1,1186,21,1207,1925,3,1,3,0,1,0,62.70
臺中縣,大雅鄉,三和村,413,1,970,18,988,1556,3,1,3,0,1,0,63.50
臺中縣,大雅鄉,二和村,414,1,992,13,1005,1670,3,1,3,0,1,0,60.18
臺中縣,大雅鄉,二和村,415,1,1086,16,1102,1745,3,1,3,0,1,0,63.15
臺中縣,大雅鄉,四德村,416,1,775,11,786,1241,3,1,3,0,1,0,63.34
臺中縣,大雅鄉,四德村,417,1,949,9,958,1544,3,1,3,0,1,0,62.05
臺中縣,大雅鄉,西寶村,418,1,785,11,796,1209,3,1,3,0,1,0,65.84
臺中縣,大雅鄉,西寶村,419,1,1068,16,1084,1701,3,1,3,0,1,0,63.73
臺中縣,大雅鄉,上楓村,420,1,989,24,1013,1598,3,1,3,0,1,0,63.39
臺中縣,大雅鄉,上楓村,421,1,868,14,882,1549,3,1,3,0,1,0,56.94
臺中縣,大雅鄉,上楓村,422,1,650,14,664,1177,3,1,3,0,1,0,56.41
臺中縣,大雅鄉,上楓村,423,1,880,19,899,1385,3,1,3,0,1,0,64.91
臺中縣,大雅鄉,上楓村,424,1,864,10,874,1329,3,1,3,0,1,0,65.76
臺中縣,大雅鄉,上楓村,425,1,716,13,729,1120,3,1,3,0,1,0,65.09
臺中縣,大雅鄉,上楓村,426,1,572,13,585,1095,3,1,3,0,1,0,53.42
臺中縣,大雅鄉,員林村,427,1,1123,14,1137,1663,3,1,3,0,1,0,68.37
臺中縣,大雅鄉,員林村,428,1,1198,17,1215,1832,3,1,3,0,1,0,66.32
臺中縣,大雅鄉,員林村,429,1,1225,22,1247,1925,3,1,3,0,1,0,64.78
臺中縣,大雅鄉,六寶村,430,1,896,13,909,1333,3,1,3,0,1,0,68.19
臺中縣,大雅鄉,六寶村,431,1,906,15,921,1392,3,1,3,0,1,0,66.16
臺中縣,大雅鄉,六寶村,432,1,753,14,767,1136,3,1,3,0,1,0,67.52
臺中縣,大雅鄉,六寶村,433,1,795,6,801,1255,3,1,3,0,1,0,63.82
臺中縣,大雅鄉,秀山村,434,1,1052,24,1076,1589,3,1,3,0,1,0,67.72
臺中縣,大雅鄉,秀山村,435,1,734,8,742,1043,3,1,3,0,1,0,71.14
臺中縣,大雅鄉,橫山村,436,1,1139,24,1163,1736,3,1,3,0,1,0,66.99
臺中縣,大雅鄉,橫山村,437,1,938,9,947,1403,3,1,3,0,1,0,67.50
臺中縣,大雅鄉,忠義村,438,1,1099,14,1113,1564,3,1,3,0,1,0,71.16
臺中縣,大雅鄉,忠義村,439,1,1059,18,1077,1598,3,1,3,0,1,0,67.40
臺中縣,新社鄉,新社村,440,1,894,16,910,1268,3,1,3,0,1,0,71.77
臺中縣,新社鄉,新社村,441,1,1055,12,1067,1509,3,1,3,0,1,0,70.71
臺中縣,新社鄉,復盛村,442,1,1126,20,1146,1675,3,1,3,0,1,0,68.42
臺中縣,新社鄉,中正村,443,1,843,18,861,1208,3,1,3,0,1,0,71.27
臺中縣,新社鄉,月湖村,444,1,606,12,618,911,3,1,3,0,1,0,67.84
臺中縣,新社鄉,崑山村,445,1,806,21,827,1194,3,1,3,0,1,0,69.26
臺中縣,新社鄉,大南村,446,1,1309,25,1334,1939,3,1,3,0,1,0,68.80
臺中縣,新社鄉,永源村,447,1,1242,60,1302,1876,3,1,3,0,1,0,69.40
臺中縣,新社鄉,永源村,448,1,481,1,482,688,3,1,3,0,1,0,70.06
臺中縣,新社鄉,中興村,449,1,547,10,557,770,3,1,3,0,1,0,72.34
臺中縣,新社鄉,協成村,450,1,774,11,785,1151,3,1,3,0,1,0,68.20
臺中縣,新社鄉,協成村,451,1,961,13,974,1349,3,1,3,0,1,0,72.20
臺中縣,新社鄉,東興村,452,1,870,14,884,1269,3,1,3,0,1,0,69.66
臺中縣,新社鄉,慶西村,453,1,193,5,198,248,3,1,3,0,1,0,79.84
臺中縣,新社鄉,慶西村,454,1,394,6,400,613,3,1,3,0,1,0,65.25
臺中縣,新社鄉,中和村,455,1,378,7,385,584,3,1,3,0,1,0,65.92
臺中縣,新社鄉,福興村,456,1,650,12,662,1004,3,1,3,0,1,0,65.94
臺中縣,新社鄉,福興村,457,1,171,6,177,265,3,1,3,0,1,0,66.79
臺中縣,石岡鄉,石岡村,458,1,661,14,675,975,3,1,3,0,1,0,69.23
臺中縣,石岡鄉,萬安村,459,1,761,8,769,1070,3,1,3,0,1,0,71.87
臺中縣,石岡鄉,九房村,460,1,722,19,741,1037,3,1,3,0,1,0,71.46
臺中縣,石岡鄉,金星村,461,1,758,22,780,1185,3,1,3,0,1,0,65.82
臺中縣,石岡鄉,龍興村,462,1,461,3,464,649,3,1,3,0,1,0,71.49
臺中縣,石岡鄉,萬興村,463,1,921,12,933,1264,3,1,3,0,1,0,73.81
臺中縣,石岡鄉,梅子村,464,1,1084,13,1097,1677,3,1,3,0,1,0,65.41
臺中縣,石岡鄉,土牛村,465,1,606,11,617,920,3,1,3,0,1,0,67.07
臺中縣,石岡鄉,德興村,466,1,832,18,850,1236,3,1,3,0,1,0,68.77
臺中縣,石岡鄉,和盛村,467,1,843,17,860,1215,3,1,3,0,1,0,70.78
臺中縣,外埔鄉,永豐村,468,1,697,18,715,982,3,1,3,0,1,0,72.81
臺中縣,外埔鄉,六分村,469,1,993,17,1010,1471,3,1,3,0,1,0,68.66
臺中縣,外埔鄉,三崁村,470,1,1062,17,1079,1675,3,1,3,0,1,0,64.42
臺中縣,外埔鄉,大同村,471,1,822,9,831,1150,3,1,3,0,1,0,72.26
臺中縣,外埔鄉,大同村,472,1,766,10,776,1116,3,1,3,0,1,0,69.53
臺中縣,外埔鄉,大同村,473,1,763,10,773,1148,3,1,3,0,1,0,67.33
臺中縣,外埔鄉,水美村,474,1,965,16,981,1552,3,1,3,0,1,0,63.21
臺中縣,外埔鄉,水美村,475,1,768,15,783,1138,3,1,3,0,1,0,68.80
臺中縣,外埔鄉,大東村,476,1,921,15,936,1379,3,1,3,0,1,0,67.88
臺中縣,外埔鄉,大東村,477,1,961,13,974,1518,3,1,3,0,1,0,64.16
臺中縣,外埔鄉,大東村,478,1,936,20,956,1540,3,1,3,0,1,0,62.08
臺中縣,外埔鄉,馬鳴村,479,1,893,12,905,1323,3,1,3,0,1,0,68.41
臺中縣,外埔鄉,中山村,480,1,761,8,769,1004,3,1,3,0,1,0,76.59
臺中縣,外埔鄉,鐵山村,481,1,710,16,726,1045,3,1,3,0,1,0,69.47
臺中縣,外埔鄉,鐵山村,482,1,685,10,695,937,3,1,3,0,1,0,74.17
臺中縣,外埔鄉,土城村,483,1,1063,17,1080,1516,3,1,3,0,1,0,71.24
臺中縣,外埔鄉,廍子村,484,1,809,17,826,1163,3,1,3,0,1,0,71.02
臺中縣,大安鄉,南埔村,485,1,785,10,795,1061,3,1,3,0,1,0,74.93
臺中縣,大安鄉,南庄村,486,1,781,15,796,1104,3,1,3,0,1,0,72.10
臺中縣,大安鄉,中庄村,487,1,757,11,768,1109,3,1,3,0,1,0,69.25
臺中縣,大安鄉,中庄村,488,1,814,13,827,1229,3,1,3,0,1,0,67.29
臺中縣,大安鄉,東安村,489,1,857,11,868,1172,3,1,3,0,1,0,74.06
臺中縣,大安鄉,福興村,490,1,762,8,770,1115,3,1,3,0,1,0,69.06
臺中縣,大安鄉,龜殼村,491,1,642,14,656,813,3,1,3,0,1,0,80.69
臺中縣,大安鄉,龜殼村,492,1,532,12,544,750,3,1,3,0,1,0,72.53
臺中縣,大安鄉,頂安村,493,1,602,10,612,856,3,1,3,0,1,0,71.50
臺中縣,大安鄉,永安村,494,1,703,8,711,1055,3,1,3,0,1,0,67.39
臺中縣,大安鄉,永安村,495,1,402,5,407,526,3,1,3,0,1,0,77.38
臺中縣,大安鄉,福住村,496,1,652,7,659,985,3,1,3,0,1,0,66.90
臺中縣,大安鄉,海墘村,497,1,982,12,994,1353,3,1,3,0,1,0,73.47
臺中縣,大安鄉,西安村,498,1,896,8,904,1333,3,1,3,0,1,0,67.82
臺中縣,大安鄉,松雅村,499,1,567,3,570,728,3,1,3,0,1,0,78.30
臺中縣,烏日鄉,烏日村,500,1,884,15,899,1322,3,1,3,0,1,0,68.00
臺中縣,烏日鄉,烏日村,501,1,920,15,935,1388,3,1,3,0,1,0,67.36
臺中縣,烏日鄉,烏日村,502,1,888,11,899,1359,3,1,3,0,1,0,66.15
臺中縣,烏日鄉,烏日村,503,1,938,18,956,1356,3,1,3,0,1,0,70.50
臺中縣,烏日鄉,湖日村,504,1,785,15,800,1164,3,1,3,0,1,0,68.73
臺中縣,烏日鄉,湖日村,505,1,637,4,641,1012,3,1,3,0,1,0,63.34
臺中縣,烏日鄉,三和村,506,1,1115,12,1127,1668,3,1,3,0,1,0,67.57
臺中縣,烏日鄉,三和村,507,1,1176,27,1203,1704,3,1,3,0,1,0,70.60
臺中縣,烏日鄉,榮泉村,508,1,1084,16,1100,1513,3,1,3,0,1,0,72.70
臺中縣,烏日鄉,榮泉村,509,1,703,18,721,1075,3,1,3,0,1,0,67.07
臺中縣,烏日鄉,學田村,510,1,674,11,685,1009,3,1,3,0,1,0,67.89
臺中縣,烏日鄉,學田村,511,1,639,12,651,921,3,1,3,0,1,0,70.68
臺中縣,烏日鄉,九德村,512,1,1019,16,1035,1600,3,1,3,0,1,0,64.69
臺中縣,烏日鄉,九德村,513,1,1031,13,1044,1586,3,1,3,0,1,0,65.83
臺中縣,烏日鄉,九德村,514,1,911,7,918,1483,3,1,3,0,1,0,61.90
臺中縣,烏日鄉,九德村,515,1,1009,14,1023,1498,3,1,3,0,1,0,68.29
臺中縣,烏日鄉,九德村,516,1,960,11,971,1426,3,1,3,0,1,0,68.09
臺中縣,烏日鄉,九德村,517,1,828,16,844,1360,3,1,3,0,1,0,62.06
臺中縣,烏日鄉,仁德村,518,1,989,22,1011,1602,3,1,3,0,1,0,63.11
臺中縣,烏日鄉,仁德村,519,1,956,15,971,1565,3,1,3,0,1,0,62.04
臺中縣,烏日鄉,仁德村,520,1,974,12,986,1560,3,1,3,0,1,0,63.21
臺中縣,烏日鄉,前竹村,521,1,672,10,682,997,3,1,3,0,1,0,68.41
臺中縣,烏日鄉,前竹村,522,1,711,17,728,1013,3,1,3,0,1,0,71.87
臺中縣,烏日鄉,五光村,523,1,1010,12,1022,1426,3,1,3,0,1,0,71.67
臺中縣,烏日鄉,光明村,524,1,620,8,628,872,3,1,3,0,1,0,72.02
臺中縣,烏日鄉,光明村,525,1,766,6,772,1134,3,1,3,0,1,0,68.08
臺中縣,烏日鄉,東園村,526,1,1128,18,1146,1575,3,1,3,0,1,0,72.76
臺中縣,烏日鄉,溪埧村,527,1,1216,20,1236,1727,3,1,3,0,1,0,71.57
臺中縣,烏日鄉,溪埧村,528,1,1102,10,1112,1714,3,1,3,0,1,0,64.88
臺中縣,烏日鄉,螺潭村,529,1,1038,20,1058,1487,3,1,3,0,1,0,71.15
臺中縣,烏日鄉,北里村,530,1,867,14,881,1292,3,1,3,0,1,0,68.19
臺中縣,烏日鄉,南里村,531,1,752,13,765,1065,3,1,3,0,1,0,71.83
臺中縣,烏日鄉,溪尾村,532,1,509,18,527,811,3,1,3,0,1,0,64.98
臺中縣,大肚鄉,王田村,533,1,1217,20,1237,1768,3,1,3,0,1,0,69.97
臺中縣,大肚鄉,王田村,534,1,1146,20,1166,1721,3,1,3,0,1,0,67.75
臺中縣,大肚鄉,中和村,535,1,602,7,609,786,3,1,3,0,1,0,77.48
臺中縣,大肚鄉,福山村,536,1,651,6,657,979,3,1,3,0,1,0,67.11
臺中縣,大肚鄉,福山村,537,1,716,17,733,1100,3,1,3,0,1,0,66.64
臺中縣,大肚鄉,福山村,538,1,705,9,714,1044,3,1,3,0,1,0,68.39
臺中縣,大肚鄉,營埔村,539,1,916,17,933,1251,3,1,3,0,1,0,74.58
臺中縣,大肚鄉,社腳村,540,1,801,17,818,1059,3,1,3,0,1,0,77.24
臺中縣,大肚鄉,社腳村,541,1,752,8,760,1105,3,1,3,0,1,0,68.78
臺中縣,大肚鄉,新興村,542,1,769,4,773,1111,3,1,3,0,1,0,69.58
臺中縣,大肚鄉,新興村,543,1,615,9,624,1001,3,1,3,0,1,0,62.34
臺中縣,大肚鄉,大東村,544,1,862,8,870,1289,3,1,3,0,1,0,67.49
臺中縣,大肚鄉,大東村,545,1,864,15,879,1245,3,1,3,0,1,0,70.60
臺中縣,大肚鄉,大肚村,546,1,582,5,587,811,3,1,3,0,1,0,72.38
臺中縣,大肚鄉,大肚村,547,1,720,5,725,975,3,1,3,0,1,0,74.36
臺中縣,大肚鄉,永和村,548,1,642,4,646,840,3,1,3,0,1,0,76.90
臺中縣,大肚鄉,磺溪村,549,1,921,9,930,1296,3,1,3,0,1,0,71.76
臺中縣,大肚鄉,永順村,550,1,1031,14,1045,1475,3,1,3,0,1,0,70.85
臺中縣,大肚鄉,成功村,551,1,597,4,601,856,3,1,3,0,1,0,70.21
臺中縣,大肚鄉,山陽村,552,1,884,20,904,1308,3,1,3,0,1,0,69.11
臺中縣,大肚鄉,頂街村,553,1,991,15,1006,1450,3,1,3,0,1,0,69.38
臺中縣,大肚鄉,頂街村,554,1,1026,9,1035,1534,3,1,3,0,1,0,67.47
臺中縣,大肚鄉,頂街村,555,1,738,13,751,1154,3,1,3,0,1,0,65.08
臺中縣,大肚鄉,瑞井村,556,1,909,7,916,1237,3,1,3,0,1,0,74.05
臺中縣,大肚鄉,瑞井村,557,1,861,21,882,1277,3,1,3,0,1,0,69.07
臺中縣,大肚鄉,瑞井村,558,1,699,12,711,1085,3,1,3,0,1,0,65.53
臺中縣,大肚鄉,蔗廍村,559,1,1061,16,1077,1635,3,1,3,0,1,0,65.87
臺中縣,大肚鄉,蔗廍村,560,1,937,22,959,1386,3,1,3,0,1,0,69.19
臺中縣,大肚鄉,蔗廍村,561,1,941,11,952,1502,3,1,3,0,1,0,63.38
臺中縣,大肚鄉,蔗廍村,562,1,1114,19,1133,1592,3,1,3,0,1,0,71.17
臺中縣,龍井鄉,竹坑村,563,1,830,10,840,1274,3,1,3,0,1,0,65.93
臺中縣,龍井鄉,竹坑村,564,1,562,12,574,846,3,1,3,0,1,0,67.85
臺中縣,龍井鄉,龍東村,565,1,787,10,797,1184,3,1,3,0,1,0,67.31
臺中縣,龍井鄉,龍東村,566,1,671,10,681,1036,3,1,3,0,1,0,65.73
臺中縣,龍井鄉,龍西村,567,1,1069,17,1086,1495,3,1,3,0,1,0,72.64
臺中縣,龍井鄉,田中村,568,1,881,9,890,1297,3,1,3,0,1,0,68.62
臺中縣,龍井鄉,田中村,569,1,754,16,770,1120,3,1,3,0,1,0,68.75
臺中縣,龍井鄉,福田村,570,1,668,23,691,970,3,1,3,0,1,0,71.24
臺中縣,龍井鄉,麗水村,571,1,778,17,795,1144,3,1,3,0,1,0,69.49
臺中縣,龍井鄉,麗水村,572,1,598,11,609,808,3,1,3,0,1,0,75.37
臺中縣,龍井鄉,龍津村,573,1,956,19,975,1397,3,1,3,0,1,0,69.79
臺中縣,龍井鄉,龍津村,574,1,857,17,874,1240,3,1,3,0,1,0,70.48
臺中縣,龍井鄉,龍津村,575,1,462,8,470,672,3,1,3,0,1,0,69.94
臺中縣,龍井鄉,龍津村,576,1,547,10,557,811,3,1,3,0,1,0,68.68
臺中縣,龍井鄉,三德村,577,1,892,24,916,1355,3,1,3,0,1,0,67.60
臺中縣,龍井鄉,三德村,578,1,690,11,701,1024,3,1,3,0,1,0,68.46
臺中縣,龍井鄉,忠和村,579,1,798,10,808,1121,3,1,3,0,1,0,72.08
臺中縣,龍井鄉,忠和村,580,1,900,19,919,1318,3,1,3,0,1,0,69.73
臺中縣,龍井鄉,忠和村,581,1,864,11,875,1247,3,1,3,0,1,0,70.17
臺中縣,龍井鄉,山腳村,582,1,558,11,569,896,3,1,3,0,1,0,63.50
臺中縣,龍井鄉,山腳村,583,1,855,11,866,1383,3,1,3,0,1,0,62.62
臺中縣,龍井鄉,山腳村,584,1,866,6,872,1305,3,1,3,0,1,0,66.82
臺中縣,龍井鄉,龍泉村,585,1,737,7,744,1123,3,1,3,0,1,0,66.25
臺中縣,龍井鄉,龍泉村,586,1,773,15,788,1201,3,1,3,0,1,0,65.61
臺中縣,龍井鄉,龍泉村,587,1,732,9,741,1059,3,1,3,0,1,0,69.97
臺中縣,龍井鄉,龍泉村,588,1,422,8,430,673,3,1,3,0,1,0,63.89
臺中縣,龍井鄉,龍崗村,589,1,747,17,764,1189,3,1,3,0,1,0,64.26
臺中縣,龍井鄉,龍崗村,590,1,523,13,536,751,3,1,3,0,1,0,71.37
臺中縣,龍井鄉,新庄村,591,1,875,18,893,1313,3,1,3,0,1,0,68.01
臺中縣,龍井鄉,新庄村,592,1,994,11,1005,1467,3,1,3,0,1,0,68.51
臺中縣,龍井鄉,新庄村,593,1,939,17,956,1452,3,1,3,0,1,0,65.84
臺中縣,龍井鄉,南寮村,594,1,923,13,936,1307,3,1,3,0,1,0,71.61
臺中縣,龍井鄉,東海村,595,1,884,11,895,1480,3,1,3,0,1,0,60.47
臺中縣,龍井鄉,東海村,596,1,732,8,740,1191,3,1,3,0,1,0,62.13
臺中縣,龍井鄉,東海村,597,1,889,11,900,1571,3,1,3,0,1,0,57.29
臺中縣,龍井鄉,東海村,598,1,540,5,545,872,3,1,3,0,1,0,62.50
臺中縣,龍井鄉,新東村,599,1,941,13,954,1495,3,1,3,0,1,0,63.81
臺中縣,龍井鄉,新東村,600,1,898,6,904,1518,3,1,3,0,1,0,59.55
臺中縣,霧峰鄉,桐林村,601,1,811,11,822,1141,3,1,3,0,1,0,72.04
臺中縣,霧峰鄉,吉峰村,602,1,959,7,966,1515,3,1,3,0,1,0,63.76
臺中縣,霧峰鄉,吉峰村,603,1,954,9,963,1541,3,1,3,0,1,0,62.49
臺中縣,霧峰鄉,吉峰村,604,1,787,10,797,1247,3,1,3,0,1,0,63.91
臺中縣,霧峰鄉,吉峰村,605,1,882,9,891,1441,3,1,3,0,1,0,61.83
臺中縣,霧峰鄉,吉峰村,606,1,877,11,888,1420,3,1,3,0,1,0,62.54
臺中縣,霧峰鄉,甲寅村,607,1,968,10,978,1437,3,1,3,0,1,0,68.06
臺中縣,霧峰鄉,甲寅村,608,1,848,17,865,1383,3,1,3,0,1,0,62.55
臺中縣,霧峰鄉,甲寅村,609,1,666,14,680,1120,3,1,3,0,1,0,60.71
臺中縣,霧峰鄉,本鄉村,610,1,1210,18,1228,1824,3,1,3,0,1,0,67.32
臺中縣,霧峰鄉,中正村,611,1,1035,8,1043,1551,3,1,3,0,1,0,67.25
臺中縣,霧峰鄉,錦榮村,612,1,617,5,622,927,3,1,3,0,1,0,67.10
臺中縣,霧峰鄉,萊園村,613,1,639,10,649,1026,3,1,3,0,1,0,63.26
臺中縣,霧峰鄉,本堂村,614,1,1075,14,1089,1634,3,1,3,0,1,0,66.65
臺中縣,霧峰鄉,本堂村,615,1,1050,18,1068,1704,3,1,3,0,1,0,62.68
臺中縣,霧峰鄉,本堂村,616,1,919,12,931,1456,3,1,3,0,1,0,63.94
臺中縣,霧峰鄉,北柳村,617,1,954,12,966,1428,3,1,3,0,1,0,67.65
臺中縣,霧峰鄉,北柳村,618,1,978,13,991,1447,3,1,3,0,1,0,68.49
臺中縣,霧峰鄉,南柳村,619,1,918,18,936,1324,3,1,3,0,1,0,70.69
臺中縣,霧峰鄉,四德村,620,1,648,12,660,996,3,1,3,0,1,0,66.27
臺中縣,霧峰鄉,四德村,621,1,676,13,689,962,3,1,3,0,1,0,71.62
臺中縣,霧峰鄉,五福村,622,1,850,11,861,1116,3,1,3,0,1,0,77.15
臺中縣,霧峰鄉,五福村,623,1,801,15,816,1177,3,1,3,0,1,0,69.33
臺中縣,霧峰鄉,丁台村,624,1,1285,14,1299,1817,3,1,3,0,1,0,71.49
臺中縣,霧峰鄉,北勢村,625,1,1062,18,1080,1585,3,1,3,0,1,0,68.14
臺中縣,霧峰鄉,南勢村,626,1,744,12,756,1142,3,1,3,0,1,0,66.20
臺中縣,霧峰鄉,萬豐村,627,1,811,14,825,1232,3,1,3,0,1,0,66.96
臺中縣,霧峰鄉,萬豐村,628,1,716,9,725,1145,3,1,3,0,1,0,63.32
臺中縣,霧峰鄉,舊正村,629,1,708,9,717,1051,3,1,3,0,1,0,68.22
臺中縣,霧峰鄉,舊正村,630,1,687,8,695,961,3,1,3,0,1,0,72.32
臺中縣,霧峰鄉,坑口村,631,1,704,16,720,994,3,1,3,0,1,0,72.43
臺中縣,霧峰鄉,坑口村,632,1,575,13,588,895,3,1,3,0,1,0,65.70
臺中縣,霧峰鄉,坑口村,633,1,616,9,625,953,3,1,3,0,1,0,65.58
臺中縣,霧峰鄉,峰谷村,634,1,677,9,686,1037,3,1,3,0,1,0,66.15
臺中縣,霧峰鄉,六股村,635,1,800,19,819,1181,3,1,3,0,1,0,69.35
臺中縣,霧峰鄉,六股村,636,1,623,14,637,921,3,1,3,0,1,0,69.16
臺中縣,太平市,太平里,637,1,1184,11,1195,1891,3,1,3,0,1,0,63.19
臺中縣,太平市,太平里,638,1,1016,16,1032,1549,3,1,3,0,1,0,66.62
臺中縣,太平市,太平里,639,1,1000,25,1025,1532,3,1,3,0,1,0,66.91
臺中縣,太平市,長億里,640,1,1026,9,1035,1626,3,1,3,0,1,0,63.65
臺中縣,太平市,長億里,641,1,828,11,839,1352,3,1,3,0,1,0,62.06
臺中縣,太平市,長億里,642,1,653,8,661,1077,3,1,3,0,1,0,61.37
臺中縣,太平市,長億里,643,1,1091,10,1101,1775,3,1,3,0,1,0,62.03
臺中縣,太平市,長億里,644,1,992,11,1003,1604,3,1,3,0,1,0,62.53
臺中縣,太平市,中平里,645,1,931,18,949,1503,3,1,3,0,1,0,63.14
臺中縣,太平市,中平里,646,1,897,16,913,1429,3,1,3,0,1,0,63.89
臺中縣,太平市,中平里,647,1,948,5,953,1541,3,1,3,0,1,0,61.84
臺中縣,太平市,中平里,648,1,911,19,930,1513,3,1,3,0,1,0,61.47
臺中縣,太平市,中興里,649,1,790,8,798,1400,3,1,3,0,1,0,57.00
臺中縣,太平市,中興里,650,1,1198,19,1217,2064,3,1,3,0,1,0,58.96
臺中縣,太平市,中興里,651,1,910,15,925,1494,3,1,3,0,1,0,61.91
臺中縣,太平市,中興里,652,1,974,7,981,1521,3,1,3,0,1,0,64.50
臺中縣,太平市,東平里,653,1,1153,20,1173,1765,3,1,3,0,1,0,66.46
臺中縣,太平市,東平里,654,1,1135,23,1158,1681,3,1,3,0,1,0,68.89
臺中縣,太平市,東平里,655,1,1116,19,1135,1693,3,1,3,0,1,0,67.04
臺中縣,太平市,東平里,656,1,1033,11,1044,1634,3,1,3,0,1,0,63.89
臺中縣,太平市,東平里,657,1,1241,16,1257,1988,3,1,3,0,1,0,63.23
臺中縣,太平市,建國里,658,1,872,7,879,1480,3,1,3,0,1,0,59.39
臺中縣,太平市,建國里,659,1,936,20,956,1422,3,1,3,0,1,0,67.23
臺中縣,太平市,建國里,660,1,1154,22,1176,1841,3,1,3,0,1,0,63.88
臺中縣,太平市,坪林里,661,1,710,11,721,1067,3,1,3,0,1,0,67.57
臺中縣,太平市,坪林里,662,1,506,12,518,819,3,1,3,0,1,0,63.25
臺中縣,太平市,坪林里,663,1,773,10,783,1202,3,1,3,0,1,0,65.14
臺中縣,太平市,坪林里,664,1,848,7,855,1229,3,1,3,0,1,0,69.57
臺中縣,太平市,坪林里,665,1,830,18,848,1172,3,1,3,0,1,0,72.35
臺中縣,太平市,坪林里,666,1,1103,18,1121,1738,3,1,3,0,1,0,64.50
臺中縣,太平市,光華里,667,1,1003,15,1018,1495,3,1,3,0,1,0,68.09
臺中縣,太平市,光華里,668,1,1228,15,1243,1939,3,1,3,0,1,0,64.11
臺中縣,太平市,光華里,669,1,1137,18,1155,1784,3,1,3,0,1,0,64.74
臺中縣,太平市,光華里,670,1,1235,24,1259,1920,3,1,3,0,1,0,65.57
臺中縣,太平市,中山里,671,1,990,18,1008,1542,3,1,3,0,1,0,65.37
臺中縣,太平市,中山里,672,1,760,9,769,1158,3,1,3,0,1,0,66.41
臺中縣,太平市,中山里,673,1,973,20,993,1514,3,1,3,0,1,0,65.59
臺中縣,太平市,中山里,674,1,1195,25,1220,1887,3,1,3,0,1,0,64.65
臺中縣,太平市,宜欣里,675,1,855,18,873,1437,3,1,3,0,1,0,60.75
臺中縣,太平市,宜欣里,676,1,1025,18,1043,1711,3,1,3,0,1,0,60.96
臺中縣,太平市,宜欣里,677,1,1079,18,1097,1967,3,1,3,0,1,0,55.77
臺中縣,太平市,宜欣里,678,1,1018,14,1032,1803,3,1,3,0,1,0,57.24
臺中縣,太平市,宜欣里,679,1,1064,15,1079,1684,3,1,3,0,1,0,64.07
臺中縣,太平市,宜欣里,680,1,925,15,940,1472,3,1,3,0,1,0,63.86
臺中縣,太平市,宜欣里,681,1,944,16,960,1603,3,1,3,0,1,0,59.89
臺中縣,太平市,新坪里,682,1,662,17,679,1239,3,1,3,0,1,0,54.80
臺中縣,太平市,新坪里,683,1,751,7,758,1289,3,1,3,0,1,0,58.81
臺中縣,太平市,新坪里,684,1,734,13,747,1404,3,1,3,0,1,0,53.21
臺中縣,太平市,新坪里,685,1,840,8,848,1492,3,1,3,0,1,0,56.84
臺中縣,太平市,新坪里,686,1,772,14,786,1312,3,1,3,0,1,0,59.91
臺中縣,太平市,新坪里,687,1,690,12,702,1158,3,1,3,0,1,0,60.62
臺中縣,太平市,新坪里,688,1,597,12,609,1091,3,1,3,0,1,0,55.82
臺中縣,太平市,新坪里,689,1,842,8,850,1446,3,1,3,0,1,0,58.78
臺中縣,太平市,新光里,690,1,1175,27,1202,1914,3,1,3,0,1,0,62.80
臺中縣,太平市,新光里,691,1,1126,20,1146,1827,3,1,3,0,1,0,62.73
臺中縣,太平市,新光里,692,1,1021,20,1041,1657,3,1,3,0,1,0,62.82
臺中縣,太平市,新光里,693,1,1024,18,1042,1655,3,1,3,0,1,0,62.96
臺中縣,太平市,新光里,694,1,952,5,957,1547,3,1,3,0,1,0,61.86
臺中縣,太平市,新福里,695,1,870,13,883,1262,3,1,3,0,1,0,69.97
臺中縣,太平市,新福里,696,1,556,16,572,935,3,1,3,0,1,0,61.18
臺中縣,太平市,新福里,697,1,996,15,1011,1621,3,1,3,0,1,0,62.37
臺中縣,太平市,頭汴里,698,1,682,12,694,1085,3,1,3,0,1,0,63.96
臺中縣,太平市,頭汴里,699,1,722,7,729,1147,3,1,3,0,1,0,63.56
臺中縣,太平市,頭汴里,700,1,726,10,736,1075,3,1,3,0,1,0,68.47
臺中縣,太平市,東汴里,701,1,784,11,795,1202,3,1,3,0,1,0,66.14
臺中縣,太平市,興隆里,702,1,1034,12,1046,1583,3,1,3,0,1,0,66.08
臺中縣,太平市,興隆里,703,1,955,22,977,1569,3,1,3,0,1,0,62.27
臺中縣,太平市,興隆里,704,1,832,11,843,1316,3,1,3,0,1,0,64.06
臺中縣,太平市,興隆里,705,1,665,10,675,1027,3,1,3,0,1,0,65.73
臺中縣,太平市,黃竹里,706,1,634,13,647,879,3,1,3,0,1,0,73.61
臺中縣,太平市,光隆里,707,1,993,16,1009,1485,3,1,3,0,1,0,67.95
臺中縣,太平市,光隆里,708,1,1036,24,1060,1725,3,1,3,0,1,0,61.45
臺中縣,太平市,光隆里,709,1,787,18,805,1229,3,1,3,0,1,0,65.50
臺中縣,太平市,德隆里,710,1,1095,13,1108,1694,3,1,3,0,1,0,65.41
臺中縣,太平市,德隆里,711,1,934,17,951,1598,3,1,3,0,1,0,59.51
臺中縣,大里市,大里里,712,1,1183,16,1199,1779,3,1,3,0,1,0,67.40
臺中縣,大里市,大里里,713,1,875,10,885,1309,3,1,3,0,1,0,67.61
臺中縣,大里市,新里里,714,1,1118,12,1130,1751,3,1,3,0,1,0,64.53
臺中縣,大里市,新里里,715,1,1034,6,1040,1654,3,1,3,0,1,0,62.88
臺中縣,大里市,新里里,716,1,1031,9,1040,1689,3,1,3,0,1,0,61.57
臺中縣,大里市,新里里,717,1,1008,8,1016,1577,3,1,3,0,1,0,64.43
臺中縣,大里市,新里里,718,1,630,6,636,919,3,1,3,0,1,0,69.21
臺中縣,大里市,新里里,719,1,900,7,907,1385,3,1,3,0,1,0,65.49
臺中縣,大里市,樹王里,720,1,863,15,878,1332,3,1,3,0,1,0,65.92
臺中縣,大里市,樹王里,721,1,925,6,931,1347,3,1,3,0,1,0,69.12
臺中縣,大里市,祥興里,722,1,548,6,554,944,3,1,3,0,1,0,58.69
臺中縣,大里市,祥興里,723,1,642,10,652,1117,3,1,3,0,1,0,58.37
臺中縣,大里市,祥興里,724,1,700,10,710,1221,3,1,3,0,1,0,58.15
臺中縣,大里市,祥興里,725,1,654,5,659,1130,3,1,3,0,1,0,58.32
臺中縣,大里市,祥興里,726,1,539,9,548,889,3,1,3,0,1,0,61.64
臺中縣,大里市,內新里,727,1,1017,18,1035,1666,3,1,3,0,1,0,62.12
臺中縣,大里市,內新里,728,1,926,9,935,1476,3,1,3,0,1,0,63.35
臺中縣,大里市,內新里,729,1,877,12,889,1409,3,1,3,0,1,0,63.09
臺中縣,大里市,內新里,730,1,997,13,1010,1573,3,1,3,0,1,0,64.21
臺中縣,大里市,內新里,731,1,787,10,797,1237,3,1,3,0,1,0,64.43
臺中縣,大里市,內新里,732,1,667,8,675,1149,3,1,3,0,1,0,58.75
臺中縣,大里市,東昇里,733,1,717,4,721,1173,3,1,3,0,1,0,61.47
臺中縣,大里市,東昇里,734,1,919,10,929,1392,3,1,3,0,1,0,66.74
臺中縣,大里市,大元里,735,1,575,9,584,872,3,1,3,0,1,0,66.97
臺中縣,大里市,大元里,736,1,904,8,912,1325,3,1,3,0,1,0,68.83
臺中縣,大里市,大元里,737,1,705,6,711,1077,3,1,3,0,1,0,66.02
臺中縣,大里市,西湖里,738,1,661,14,675,1016,3,1,3,0,1,0,66.44
臺中縣,大里市,西湖里,739,1,674,7,681,987,3,1,3,0,1,0,69.00
臺中縣,大里市,夏田里,740,1,668,13,681,926,3,1,3,0,1,0,73.54
臺中縣,大里市,仁化里,741,1,914,6,920,1584,3,1,3,0,1,0,58.08
臺中縣,大里市,仁化里,742,1,955,14,969,1557,3,1,3,0,1,0,62.24
臺中縣,大里市,仁化里,743,1,995,10,1005,1562,3,1,3,0,1,0,64.34
臺中縣,大里市,仁化里,744,1,943,11,954,1600,3,1,3,0,1,0,59.62
臺中縣,大里市,仁化里,745,1,979,9,988,1654,3,1,3,0,1,0,59.73
臺中縣,大里市,仁化里,746,1,928,6,934,1444,3,1,3,0,1,0,64.68
臺中縣,大里市,健民里,747,1,901,13,914,1457,3,1,3,0,1,0,62.73
臺中縣,大里市,健民里,748,1,775,17,792,1236,3,1,3,0,1,0,64.08
臺中縣,大里市,健民里,749,1,983,18,1001,1563,3,1,3,0,1,0,64.04
臺中縣,大里市,塗城里,750,1,1001,10,1011,1619,3,1,3,0,1,0,62.45
臺中縣,大里市,塗城里,751,1,1006,16,1022,1505,3,1,3,0,1,0,67.91
臺中縣,大里市,塗城里,752,1,1017,11,1028,1598,3,1,3,0,1,0,64.33
臺中縣,大里市,塗城里,753,1,986,11,997,1624,3,1,3,0,1,0,61.39
臺中縣,大里市,東湖里,754,1,792,17,809,1361,3,1,3,0,1,0,59.44
臺中縣,大里市,東湖里,755,1,707,9,716,1247,3,1,3,0,1,0,57.42
臺中縣,大里市,東湖里,756,1,705,12,717,1104,3,1,3,0,1,0,64.95
臺中縣,大里市,東湖里,757,1,624,7,631,998,3,1,3,0,1,0,63.23
臺中縣,大里市,東湖里,758,1,681,9,690,1211,3,1,3,0,1,0,56.98
臺中縣,大里市,東興里,759,1,511,13,524,856,3,1,3,0,1,0,61.21
臺中縣,大里市,東興里,760,1,875,7,882,1409,3,1,3,0,1,0,62.60
臺中縣,大里市,東興里,761,1,1038,9,1047,1668,3,1,3,0,1,0,62.77
臺中縣,大里市,東興里,762,1,807,9,816,1235,3,1,3,0,1,0,66.07
臺中縣,大里市,東興里,763,1,1153,10,1163,1813,3,1,3,0,1,0,64.15
臺中縣,大里市,東興里,764,1,1077,11,1088,1671,3,1,3,0,1,0,65.11
臺中縣,大里市,東興里,765,1,731,8,739,1141,3,1,3,0,1,0,64.77
臺中縣,大里市,日新里,766,1,1033,16,1049,1658,3,1,3,0,1,0,63.27
臺中縣,大里市,日新里,767,1,941,20,961,1463,3,1,3,0,1,0,65.69
臺中縣,大里市,西榮里,768,1,790,7,797,1311,3,1,3,0,1,0,60.79
臺中縣,大里市,西榮里,769,1,1032,8,1040,1601,3,1,3,0,1,0,64.96
臺中縣,大里市,西榮里,770,1,956,17,973,1514,3,1,3,0,1,0,64.27
臺中縣,大里市,西榮里,771,1,949,17,966,1641,3,1,3,0,1,0,58.87
臺中縣,大里市,西榮里,772,1,1099,19,1118,1746,3,1,3,0,1,0,64.03
臺中縣,大里市,西榮里,773,1,1021,16,1037,1610,3,1,3,0,1,0,64.41
臺中縣,大里市,西榮里,774,1,1050,6,1056,1623,3,1,3,0,1,0,65.06
臺中縣,大里市,金城里,775,1,931,8,939,1511,3,1,3,0,1,0,62.14
臺中縣,大里市,金城里,776,1,805,11,816,1422,3,1,3,0,1,0,57.38
臺中縣,大里市,金城里,777,1,968,11,979,1597,3,1,3,0,1,0,61.30
臺中縣,大里市,金城里,778,1,995,9,1004,1646,3,1,3,0,1,0,61.00
臺中縣,大里市,金城里,779,1,930,11,941,1549,3,1,3,0,1,0,60.75
臺中縣,大里市,立仁里,780,1,970,18,988,1608,3,1,3,0,1,0,61.44
臺中縣,大里市,立仁里,781,1,1092,18,1110,1772,3,1,3,0,1,0,62.64
臺中縣,大里市,立仁里,782,1,952,9,961,1567,3,1,3,0,1,0,61.33
臺中縣,大里市,立仁里,783,1,764,8,772,1163,3,1,3,0,1,0,66.38
臺中縣,大里市,立仁里,784,1,747,11,758,1221,3,1,3,0,1,0,62.08
臺中縣,大里市,新仁里,785,1,881,14,895,1397,3,1,3,0,1,0,64.07
臺中縣,大里市,新仁里,786,1,973,11,984,1629,3,1,3,0,1,0,60.41
臺中縣,大里市,新仁里,787,1,917,12,929,1455,3,1,3,0,1,0,63.85
臺中縣,大里市,新仁里,788,1,809,13,822,1344,3,1,3,0,1,0,61.16
臺中縣,大里市,瑞城里,789,1,859,11,870,1492,3,1,3,0,1,0,58.31
臺中縣,大里市,瑞城里,790,1,991,14,1005,1559,3,1,3,0,1,0,64.46
臺中縣,大里市,瑞城里,791,1,1002,8,1010,1648,3,1,3,0,1,0,61.29
臺中縣,大里市,瑞城里,792,1,895,8,903,1451,3,1,3,0,1,0,62.23
臺中縣,大里市,瑞城里,793,1,1080,11,1091,1821,3,1,3,0,1,0,59.91
臺中縣,和平鄉,南勢村,794,1,90,1,91,146,3,1,3,0,1,0,62.33
臺中縣,和平鄉,南勢村,795,1,457,7,464,732,3,1,3,0,1,0,63.39
臺中縣,和平鄉,南勢村,796,1,326,6,332,519,3,1,3,0,1,0,63.97
臺中縣,和平鄉,天輪村,797,1,268,4,272,454,3,1,3,0,1,0,59.91
臺中縣,和平鄉,博愛村,798,1,386,7,393,622,3,1,3,0,1,0,63.18
臺中縣,和平鄉,博愛村,799,1,266,4,270,452,3,1,3,0,1,0,59.73
臺中縣,和平鄉,自由村,800,1,62,0,62,102,3,1,3,0,1,0,60.78
臺中縣,和平鄉,自由村,801,1,73,3,76,132,3,1,3,0,1,0,57.58
臺中縣,和平鄉,自由村,802,1,166,1,167,295,3,1,3,0,1,0,56.61
臺中縣,和平鄉,達觀村,803,1,256,2,258,439,3,1,3,0,1,0,58.77
臺中縣,和平鄉,達觀村,804,1,76,0,76,106,3,1,3,0,1,0,71.70
臺中縣,和平鄉,中坑村,805,1,233,3,236,309,3,1,3,0,1,0,76.38
臺中縣,和平鄉,梨山村,806,1,89,4,93,191,3,1,3,0,1,0,48.69
臺中縣,和平鄉,梨山村,807,1,369,3,372,815,3,1,3,0,1,0,45.64
臺中縣,和平鄉,梨山村,808,1,70,0,70,251,3,1,3,0,1,0,27.89
臺中縣,和平鄉,梨山村,809,1,29,0,29,90,3,1,3,0,1,0,32.22
臺中縣,和平鄉,平等村,810,1,99,1,100,217,3,1,3,0,1,0,46.08
臺中縣,和平鄉,平等村,811,1,94,5,99,197,3,1,3,0,1,0,50.25
彰化縣,彰化市,桃源里,1,1,824,12,836,1250,3,1,3,0,1,0,66.88
彰化縣,彰化市,桃源里,2,1,1000,20,1020,1548,3,1,3,0,1,0,65.89
彰化縣,彰化市,卦山里,3,1,737,7,744,1069,3,1,3,0,1,0,69.60
彰化縣,彰化市,卦山里,4,1,733,12,745,1161,3,1,3,0,1,0,64.17
彰化縣,彰化市,東興里,5,1,1090,17,1107,1580,3,1,3,0,1,0,70.06
彰化縣,彰化市,華北里,6,1,1035,7,1042,1539,3,1,3,0,1,0,67.71
彰化縣,彰化市,華陽里,7,1,198,81,279,300,3,1,3,0,1,0,93.00
彰化縣,彰化市,華陽里,8,1,669,6,675,993,3,1,3,0,1,0,67.98
彰化縣,彰化市,華陽里,9,1,723,12,735,1123,3,1,3,0,1,0,65.45
彰化縣,彰化市,建寶里,10,1,780,9,789,1077,3,1,3,0,1,0,73.26
彰化縣,彰化市,建寶里,11,1,877,14,891,1232,3,1,3,0,1,0,72.32
彰化縣,彰化市,光南里,12,1,936,9,945,1357,3,1,3,0,1,0,69.64
彰化縣,彰化市,介壽里,13,1,725,6,731,1020,3,1,3,0,1,0,71.67
彰化縣,彰化市,介壽里,14,1,564,12,576,889,3,1,3,0,1,0,64.79
彰化縣,彰化市,延平里,15,1,1107,14,1121,1697,3,1,3,0,1,0,66.06
彰化縣,彰化市,延平里,16,1,892,11,903,1337,3,1,3,0,1,0,67.54
彰化縣,彰化市,延平里,17,1,1217,16,1233,1847,3,1,3,0,1,0,66.76
彰化縣,彰化市,延平里,18,1,604,5,609,883,3,1,3,0,1,0,68.97
彰化縣,彰化市,延和里,19,1,1090,18,1108,1629,3,1,3,0,1,0,68.02
彰化縣,彰化市,延和里,20,1,1161,11,1172,1687,3,1,3,0,1,0,69.47
彰化縣,彰化市,南興里,21,1,1159,13,1172,1688,3,1,3,0,1,0,69.43
彰化縣,彰化市,南興里,22,1,1033,21,1054,1577,3,1,3,0,1,0,66.84
彰化縣,彰化市,南興里,23,1,1025,19,1044,1543,3,1,3,0,1,0,67.66
彰化縣,彰化市,南磘里,24,1,1192,11,1203,1735,3,1,3,0,1,0,69.34
彰化縣,彰化市,南磘里,25,1,919,15,934,1490,3,1,3,0,1,0,62.68
彰化縣,彰化市,南磘里,26,1,916,15,931,1460,3,1,3,0,1,0,63.77
彰化縣,彰化市,南磘里,27,1,949,11,960,1473,3,1,3,0,1,0,65.17
彰化縣,彰化市,成功里,28,1,987,16,1003,1458,3,1,3,0,1,0,68.79
彰化縣,彰化市,大同里,29,1,740,15,755,1085,3,1,3,0,1,0,69.59
彰化縣,彰化市,永生里,30,1,1011,17,1028,1445,3,1,3,0,1,0,71.14
彰化縣,彰化市,福安里,31,1,734,9,743,1046,3,1,3,0,1,0,71.03
彰化縣,彰化市,西安里,32,1,818,9,827,1199,3,1,3,0,1,0,68.97
彰化縣,彰化市,西安里,33,1,976,12,988,1490,3,1,3,0,1,0,66.31
彰化縣,彰化市,彰安里,34,1,981,11,992,1488,3,1,3,0,1,0,66.67
彰化縣,彰化市,彰安里,35,1,1043,8,1051,1557,3,1,3,0,1,0,67.50
彰化縣,彰化市,中央里,36,1,653,3,656,918,3,1,3,0,1,0,71.46
彰化縣,彰化市,富貴里,37,1,692,10,702,1012,3,1,3,0,1,0,69.37
彰化縣,彰化市,民權里,38,1,849,8,857,1238,3,1,3,0,1,0,69.22
彰化縣,彰化市,長樂里,39,1,845,10,855,1210,3,1,3,0,1,0,70.66
彰化縣,彰化市,萬壽里,40,1,679,8,687,976,3,1,3,0,1,0,70.39
彰化縣,彰化市,西興里,41,1,616,9,625,834,3,1,3,0,1,0,74.94
彰化縣,彰化市,西興里,42,1,855,3,858,1363,3,1,3,0,1,0,62.95
彰化縣,彰化市,平和里,43,1,1048,8,1056,1574,3,1,3,0,1,0,67.09
彰化縣,彰化市,平和里,44,1,1183,16,1199,1799,3,1,3,0,1,0,66.65
彰化縣,彰化市,崙平里,45,1,935,13,948,1361,3,1,3,0,1,0,69.65
彰化縣,彰化市,崙平里,46,1,811,14,825,1222,3,1,3,0,1,0,67.51
彰化縣,彰化市,崙平里,47,1,1013,12,1025,1546,3,1,3,0,1,0,66.30
彰化縣,彰化市,向陽里,48,1,909,13,922,1385,3,1,3,0,1,0,66.57
彰化縣,彰化市,向陽里,49,1,847,9,856,1287,3,1,3,0,1,0,66.51
彰化縣,彰化市,莿桐里,50,1,767,14,781,1126,3,1,3,0,1,0,69.36
彰化縣,彰化市,莿桐里,51,1,845,9,854,1221,3,1,3,0,1,0,69.94
彰化縣,彰化市,南美里,52,1,990,12,1002,1460,3,1,3,0,1,0,68.63
彰化縣,彰化市,南安里,53,1,1182,14,1196,1680,3,1,3,0,1,0,71.19
彰化縣,彰化市,東芳里,54,1,838,14,852,1277,3,1,3,0,1,0,66.72
彰化縣,彰化市,東芳里,55,1,987,12,999,1480,3,1,3,0,1,0,67.50
彰化縣,彰化市,磚磘里,56,1,718,11,729,1123,3,1,3,0,1,0,64.92
彰化縣,彰化市,磚磘里,57,1,993,25,1018,1425,3,1,3,0,1,0,71.44
彰化縣,彰化市,西勢里,58,1,809,18,827,1137,3,1,3,0,1,0,72.74
彰化縣,彰化市,西勢里,59,1,854,18,872,1243,3,1,3,0,1,0,70.15
彰化縣,彰化市,忠權里,60,1,791,8,799,1205,3,1,3,0,1,0,66.31
彰化縣,彰化市,忠權里,61,1,902,8,910,1249,3,1,3,0,1,0,72.86
彰化縣,彰化市,忠孝里,62,1,803,7,810,1159,3,1,3,0,1,0,69.89
彰化縣,彰化市,五權里,63,1,1031,19,1050,1555,3,1,3,0,1,0,67.52
彰化縣,彰化市,五權里,64,1,1002,12,1014,1539,3,1,3,0,1,0,65.89
彰化縣,彰化市,新興里,65,1,800,11,811,1173,3,1,3,0,1,0,69.14
彰化縣,彰化市,新興里,66,1,998,11,1009,1434,3,1,3,0,1,0,70.36
彰化縣,彰化市,新興里,67,1,793,11,804,1179,3,1,3,0,1,0,68.19
彰化縣,彰化市,新華里,68,1,557,11,568,869,3,1,3,0,1,0,65.36
彰化縣,彰化市,新華里,69,1,651,7,658,959,3,1,3,0,1,0,68.61
彰化縣,彰化市,興北里,70,1,946,9,955,1404,3,1,3,0,1,0,68.02
彰化縣,彰化市,信義里,71,1,609,8,617,898,3,1,3,0,1,0,68.71
彰化縣,彰化市,民生里,72,1,939,12,951,1401,3,1,3,0,1,0,67.88
彰化縣,彰化市,光復里,73,1,499,7,506,765,3,1,3,0,1,0,66.14
彰化縣,彰化市,永福里,74,1,618,3,621,948,3,1,3,0,1,0,65.51
彰化縣,彰化市,光華里,75,1,598,7,605,874,3,1,3,0,1,0,69.22
彰化縣,彰化市,中正里,76,1,897,14,911,1354,3,1,3,0,1,0,67.28
彰化縣,彰化市,中山里,77,1,574,8,582,835,3,1,3,0,1,0,69.70
彰化縣,彰化市,龍山里,78,1,748,15,763,1133,3,1,3,0,1,0,67.34
彰化縣,彰化市,龍山里,79,1,699,9,708,1052,3,1,3,0,1,0,67.30
彰化縣,彰化市,文化里,80,1,948,14,962,1428,3,1,3,0,1,0,67.37
彰化縣,彰化市,陽明里,81,1,586,6,592,838,3,1,3,0,1,0,70.64
彰化縣,彰化市,陽明里,82,1,595,9,604,919,3,1,3,0,1,0,65.72
彰化縣,彰化市,萬安里,83,1,1189,12,1201,1757,3,1,3,0,1,0,68.36
彰化縣,彰化市,萬安里,84,1,1193,15,1208,1820,3,1,3,0,1,0,66.37
彰化縣,彰化市,下廍里,85,1,1283,15,1298,1854,3,1,3,0,1,0,70.01
彰化縣,彰化市,下廍里,86,1,1107,23,1130,1673,3,1,3,0,1,0,67.54
彰化縣,彰化市,茄苳里,87,1,527,15,542,775,3,1,3,0,1,0,69.94
彰化縣,彰化市,茄南里,88,1,723,10,733,1090,3,1,3,0,1,0,67.25
彰化縣,彰化市,茄南里,89,1,659,12,671,971,3,1,3,0,1,0,69.10
彰化縣,彰化市,寶廍里,90,1,710,13,723,994,3,1,3,0,1,0,72.74
彰化縣,彰化市,古夷里,91,1,667,19,686,1007,3,1,3,0,1,0,68.12
彰化縣,彰化市,古夷里,92,1,693,10,703,1143,3,1,3,0,1,0,61.50
彰化縣,彰化市,阿夷里,93,1,1029,19,1048,1590,3,1,3,0,1,0,65.91
彰化縣,彰化市,阿夷里,94,1,896,14,910,1403,3,1,3,0,1,0,64.86
彰化縣,彰化市,阿夷里,95,1,1264,23,1287,2000,3,1,3,0,1,0,64.35
彰化縣,彰化市,和調里,96,1,715,19,734,1069,3,1,3,0,1,0,68.66
彰化縣,彰化市,和調里,97,1,749,18,767,1126,3,1,3,0,1,0,68.12
彰化縣,彰化市,復興里,98,1,1119,13,1132,1692,3,1,3,0,1,0,66.90
彰化縣,彰化市,復興里,99,1,1024,12,1036,1537,3,1,3,0,1,0,67.40
彰化縣,彰化市,復興里,100,1,425,9,434,640,3,1,3,0,1,0,67.81
彰化縣,彰化市,中庄里,101,1,780,8,788,1174,3,1,3,0,1,0,67.12
彰化縣,彰化市,中庄里,102,1,552,16,568,886,3,1,3,0,1,0,64.11
彰化縣,彰化市,國聖里,103,1,976,15,991,1404,3,1,3,0,1,0,70.58
彰化縣,彰化市,國聖里,104,1,607,15,622,811,3,1,3,0,1,0,76.70
彰化縣,彰化市,福山里,105,1,890,12,902,1298,3,1,3,0,1,0,69.49
彰化縣,彰化市,福山里,106,1,971,27,998,1450,3,1,3,0,1,0,68.83
彰化縣,彰化市,福山里,107,1,868,19,887,1412,3,1,3,0,1,0,62.82
彰化縣,彰化市,福山里,108,1,978,13,991,1485,3,1,3,0,1,0,66.73
彰化縣,彰化市,安溪里,109,1,630,13,643,930,3,1,3,0,1,0,69.14
彰化縣,彰化市,竹中里,110,1,1032,15,1047,1589,3,1,3,0,1,0,65.89
彰化縣,彰化市,三村里,111,1,698,10,708,961,3,1,3,0,1,0,73.67
彰化縣,彰化市,大竹里,112,1,761,10,771,1141,3,1,3,0,1,0,67.57
彰化縣,彰化市,大竹里,113,1,914,14,928,1423,3,1,3,0,1,0,65.21
彰化縣,彰化市,香山里,114,1,899,17,916,1374,3,1,3,0,1,0,66.67
彰化縣,彰化市,香山里,115,1,805,14,819,1074,3,1,3,0,1,0,76.26
彰化縣,彰化市,牛埔里,116,1,1107,24,1131,1504,3,1,3,0,1,0,75.20
彰化縣,彰化市,牛埔里,117,1,772,6,778,1206,3,1,3,0,1,0,64.51
彰化縣,彰化市,台鳳里,118,1,1124,7,1131,1800,3,1,3,0,1,0,62.83
彰化縣,彰化市,台鳳里,119,1,936,15,951,1450,3,1,3,0,1,0,65.59
彰化縣,彰化市,田中里,120,1,560,6,566,798,3,1,3,0,1,0,70.93
彰化縣,彰化市,快官里,121,1,639,10,649,978,3,1,3,0,1,0,66.36
彰化縣,彰化市,竹巷里,122,1,560,4,564,778,3,1,3,0,1,0,72.49
彰化縣,彰化市,福田里,123,1,833,13,846,1151,3,1,3,0,1,0,73.50
彰化縣,彰化市,石牌里,124,1,767,16,783,1093,3,1,3,0,1,0,71.64
彰化縣,花壇鄉,花壇村,125,1,783,12,795,1147,3,1,3,0,1,0,69.31
彰化縣,花壇鄉,花壇村,126,1,1149,17,1166,1583,3,1,3,0,1,0,73.66
彰化縣,花壇鄉,金墩村,127,1,1074,16,1090,1569,3,1,3,0,1,0,69.47
彰化縣,花壇鄉,中庄村,128,1,639,11,650,934,3,1,3,0,1,0,69.59
彰化縣,花壇鄉,中庄村,129,1,815,11,826,1221,3,1,3,0,1,0,67.65
彰化縣,花壇鄉,劉厝村,130,1,739,9,748,1000,3,1,3,0,1,0,74.80
彰化縣,花壇鄉,崙雅村,131,1,930,17,947,1339,3,1,3,0,1,0,70.72
彰化縣,花壇鄉,南口村,132,1,961,18,979,1374,3,1,3,0,1,0,71.25
彰化縣,花壇鄉,中口村,133,1,487,6,493,656,3,1,3,0,1,0,75.15
彰化縣,花壇鄉,北口村,134,1,625,5,630,829,3,1,3,0,1,0,76.00
彰化縣,花壇鄉,北口村,135,1,503,6,509,693,3,1,3,0,1,0,73.45
彰化縣,花壇鄉,長沙村,136,1,878,16,894,1229,3,1,3,0,1,0,72.74
彰化縣,花壇鄉,長沙村,137,1,842,15,857,1188,3,1,3,0,1,0,72.14
彰化縣,花壇鄉,長沙村,138,1,818,11,829,1194,3,1,3,0,1,0,69.43
彰化縣,花壇鄉,文德村,139,1,796,20,816,1182,3,1,3,0,1,0,69.04
彰化縣,花壇鄉,文德村,140,1,710,12,722,1022,3,1,3,0,1,0,70.65
彰化縣,花壇鄉,白沙村,141,1,1029,18,1047,1574,3,1,3,0,1,0,66.52
彰化縣,花壇鄉,白沙村,142,1,1167,22,1189,1829,3,1,3,0,1,0,65.01
彰化縣,花壇鄉,岩竹村,143,1,871,13,884,1283,3,1,3,0,1,0,68.90
彰化縣,花壇鄉,橋頭村,144,1,1158,17,1175,1763,3,1,3,0,1,0,66.65
彰化縣,花壇鄉,橋頭村,145,1,737,12,749,1072,3,1,3,0,1,0,69.87
彰化縣,花壇鄉,灣雅村,146,1,538,11,549,824,3,1,3,0,1,0,66.63
彰化縣,花壇鄉,灣東村,147,1,614,5,619,936,3,1,3,0,1,0,66.13
彰化縣,花壇鄉,三春村,148,1,966,11,977,1559,3,1,3,0,1,0,62.67
彰化縣,花壇鄉,永春村,149,1,924,15,939,1400,3,1,3,0,1,0,67.07
彰化縣,花壇鄉,長春村,150,1,941,14,955,1375,3,1,3,0,1,0,69.45
彰化縣,芬園鄉,舊社村,151,1,1059,20,1079,1663,3,1,3,0,1,0,64.88
彰化縣,芬園鄉,大埔村,152,1,920,7,927,1302,3,1,3,0,1,0,71.20
彰化縣,芬園鄉,竹林村,153,1,1040,24,1064,1561,3,1,3,0,1,0,68.16
彰化縣,芬園鄉,楓坑村,154,1,386,8,394,565,3,1,3,0,1,0,69.73
彰化縣,芬園鄉,社口村,155,1,609,10,619,903,3,1,3,0,1,0,68.55
彰化縣,芬園鄉,社口村,156,1,849,14,863,1332,3,1,3,0,1,0,64.79
彰化縣,芬園鄉,茄荖村,157,1,726,13,739,1158,3,1,3,0,1,0,63.82
彰化縣,芬園鄉,茄荖村,158,1,667,11,678,970,3,1,3,0,1,0,69.90
彰化縣,芬園鄉,嘉興村,159,1,987,14,1001,1452,3,1,3,0,1,0,68.94
彰化縣,芬園鄉,芬園村,160,1,581,6,587,872,3,1,3,0,1,0,67.32
彰化縣,芬園鄉,進芬村,161,1,595,14,609,898,3,1,3,0,1,0,67.82
彰化縣,芬園鄉,縣庄村,162,1,694,11,705,1056,3,1,3,0,1,0,66.76
彰化縣,芬園鄉,圳墘村,163,1,476,4,480,688,3,1,3,0,1,0,69.77
彰化縣,芬園鄉,溪頭村,164,1,962,22,984,1456,3,1,3,0,1,0,67.58
彰化縣,芬園鄉,同安村,165,1,856,10,866,1260,3,1,3,0,1,0,68.73
彰化縣,芬園鄉,中崙村,166,1,612,9,621,986,3,1,3,0,1,0,62.98
彰化縣,芬園鄉,大竹村,167,1,617,9,626,1066,3,1,3,0,1,0,58.72
彰化縣,鹿港鎮,大有里,168,1,779,9,788,1155,3,1,3,0,1,0,68.23
彰化縣,鹿港鎮,中興里,169,1,374,5,379,556,3,1,3,0,1,0,68.17
彰化縣,鹿港鎮,洛津里,170,1,683,4,687,1061,3,1,3,0,1,0,64.75
彰化縣,鹿港鎮,順興里,171,1,608,12,620,870,3,1,3,0,1,0,71.26
彰化縣,鹿港鎮,菜園里,172,1,706,8,714,1019,3,1,3,0,1,0,70.07
彰化縣,鹿港鎮,街尾里,173,1,1253,16,1269,1859,3,1,3,0,1,0,68.26
彰化縣,鹿港鎮,泰興里,174,1,815,15,830,1182,3,1,3,0,1,0,70.22
彰化縣,鹿港鎮,長興里,175,1,203,3,206,315,3,1,3,0,1,0,65.40
彰化縣,鹿港鎮,興化里,176,1,489,6,495,686,3,1,3,0,1,0,72.16
彰化縣,鹿港鎮,龍山里,177,1,540,10,550,760,3,1,3,0,1,0,72.37
彰化縣,鹿港鎮,景福里,178,1,785,12,797,1123,3,1,3,0,1,0,70.97
彰化縣,鹿港鎮,郭厝里,179,1,376,3,379,580,3,1,3,0,1,0,65.34
彰化縣,鹿港鎮,新宮里,180,1,646,8,654,926,3,1,3,0,1,0,70.63
彰化縣,鹿港鎮,玉順里,181,1,859,14,873,1288,3,1,3,0,1,0,67.78
彰化縣,鹿港鎮,東石里,182,1,948,24,972,1391,3,1,3,0,1,0,69.88
彰化縣,鹿港鎮,東石里,183,1,1114,10,1124,1662,3,1,3,0,1,0,67.63
彰化縣,鹿港鎮,永安里,184,1,1206,20,1226,1757,3,1,3,0,1,0,69.78
彰化縣,鹿港鎮,永安里,185,1,1173,14,1187,1760,3,1,3,0,1,0,67.44
彰化縣,鹿港鎮,埔崙里,186,1,1053,22,1075,1575,3,1,3,0,1,0,68.25
彰化縣,鹿港鎮,埔崙里,187,1,967,16,983,1467,3,1,3,0,1,0,67.01
彰化縣,鹿港鎮,頂厝里,188,1,1187,13,1200,1721,3,1,3,0,1,0,69.73
彰化縣,鹿港鎮,頂厝里,189,1,905,18,923,1359,3,1,3,0,1,0,67.92
彰化縣,鹿港鎮,頂厝里,190,1,1216,13,1229,1767,3,1,3,0,1,0,69.55
彰化縣,鹿港鎮,東崎里,191,1,1217,21,1238,1803,3,1,3,0,1,0,68.66
彰化縣,鹿港鎮,東崎里,192,1,1326,18,1344,2130,3,1,3,0,1,0,63.10
彰化縣,鹿港鎮,廖厝里,193,1,919,12,931,1410,3,1,3,0,1,0,66.03
彰化縣,鹿港鎮,廖厝里,194,1,1145,16,1161,1584,3,1,3,0,1,0,73.30
彰化縣,鹿港鎮,詔安里,195,1,979,17,996,1579,3,1,3,0,1,0,63.08
彰化縣,鹿港鎮,海埔里,196,1,927,14,941,1432,3,1,3,0,1,0,65.71
彰化縣,鹿港鎮,海埔里,197,1,862,14,876,1307,3,1,3,0,1,0,67.02
彰化縣,鹿港鎮,洋厝里,198,1,553,9,562,859,3,1,3,0,1,0,65.42
彰化縣,鹿港鎮,洋厝里,199,1,1006,11,1017,1448,3,1,3,0,1,0,70.23
彰化縣,鹿港鎮,草中里,200,1,899,20,919,1354,3,1,3,0,1,0,67.87
彰化縣,鹿港鎮,草中里,201,1,947,19,966,1421,3,1,3,0,1,0,67.98
彰化縣,鹿港鎮,山崙里,202,1,625,10,635,993,3,1,3,0,1,0,63.95
彰化縣,鹿港鎮,山崙里,203,1,1315,16,1331,1839,3,1,3,0,1,0,72.38
彰化縣,鹿港鎮,頭南里,204,1,1172,26,1198,1750,3,1,3,0,1,0,68.46
彰化縣,鹿港鎮,頭崙里,205,1,941,15,956,1329,3,1,3,0,1,0,71.93
彰化縣,鹿港鎮,頭崙里,206,1,587,4,591,768,3,1,3,0,1,0,76.95
彰化縣,鹿港鎮,頂番里,207,1,898,15,913,1296,3,1,3,0,1,0,70.45
彰化縣,鹿港鎮,頂番里,208,1,1138,15,1153,1651,3,1,3,0,1,0,69.84
彰化縣,鹿港鎮,溝墘里,209,1,908,11,919,1281,3,1,3,0,1,0,71.74
彰化縣,鹿港鎮,溝墘里,210,1,799,12,811,1228,3,1,3,0,1,0,66.04
彰化縣,鹿港鎮,溝墘里,211,1,506,12,518,738,3,1,3,0,1,0,70.19
彰化縣,福興鄉,番婆村,212,1,803,16,819,1141,3,1,3,0,1,0,71.78
彰化縣,福興鄉,番婆村,213,1,588,13,601,871,3,1,3,0,1,0,69.00
彰化縣,福興鄉,大崙村,214,1,800,5,805,1077,3,1,3,0,1,0,74.74
彰化縣,福興鄉,外埔村,215,1,756,8,764,1023,3,1,3,0,1,0,74.68
彰化縣,福興鄉,三汴村,216,1,892,14,906,1167,3,1,3,0,1,0,77.63
彰化縣,福興鄉,萬豐村,217,1,509,9,518,697,3,1,3,0,1,0,74.32
彰化縣,福興鄉,外中村,218,1,898,8,906,1144,3,1,3,0,1,0,79.20
彰化縣,福興鄉,元中村,219,1,756,14,770,1064,3,1,3,0,1,0,72.37
彰化縣,福興鄉,橋頭村,220,1,698,10,708,955,3,1,3,0,1,0,74.14
彰化縣,福興鄉,橋頭村,221,1,787,7,794,1108,3,1,3,0,1,0,71.66
彰化縣,福興鄉,社尾村,222,1,1062,10,1072,1331,3,1,3,0,1,0,80.54
彰化縣,福興鄉,番社村,223,1,936,8,944,1245,3,1,3,0,1,0,75.82
彰化縣,福興鄉,同安村,224,1,701,23,724,960,3,1,3,0,1,0,75.42
彰化縣,福興鄉,同安村,225,1,672,3,675,1033,3,1,3,0,1,0,65.34
彰化縣,福興鄉,西勢村,226,1,663,13,676,919,3,1,3,0,1,0,73.56
彰化縣,福興鄉,西勢村,227,1,470,6,476,690,3,1,3,0,1,0,68.99
彰化縣,福興鄉,秀厝村,228,1,633,7,640,879,3,1,3,0,1,0,72.81
彰化縣,福興鄉,秀厝村,229,1,774,13,787,1083,3,1,3,0,1,0,72.67
彰化縣,福興鄉,鎮平村,230,1,784,15,799,1095,3,1,3,0,1,0,72.97
彰化縣,福興鄉,三和村,231,1,710,13,723,1018,3,1,3,0,1,0,71.02
彰化縣,福興鄉,麥厝村,232,1,702,12,714,998,3,1,3,0,1,0,71.54
彰化縣,福興鄉,麥厝村,233,1,650,15,665,1023,3,1,3,0,1,0,65.00
彰化縣,福興鄉,廈粘村,234,1,610,6,616,853,3,1,3,0,1,0,72.22
彰化縣,福興鄉,廈粘村,235,1,653,18,671,914,3,1,3,0,1,0,73.41
彰化縣,福興鄉,頂粘村,236,1,669,9,678,870,3,1,3,0,1,0,77.93
彰化縣,福興鄉,頂粘村,237,1,800,13,813,1109,3,1,3,0,1,0,73.31
彰化縣,福興鄉,福寶村,238,1,849,14,863,1147,3,1,3,0,1,0,75.24
彰化縣,福興鄉,二港村,239,1,935,13,948,1241,3,1,3,0,1,0,76.39
彰化縣,福興鄉,福興村,240,1,995,13,1008,1472,3,1,3,0,1,0,68.48
彰化縣,福興鄉,福興村,241,1,790,6,796,1136,3,1,3,0,1,0,70.07
彰化縣,福興鄉,福南村,242,1,707,8,715,980,3,1,3,0,1,0,72.96
彰化縣,福興鄉,福南村,243,1,761,11,772,1084,3,1,3,0,1,0,71.22
彰化縣,秀水鄉,秀水村,244,1,661,7,668,983,3,1,3,0,1,0,67.96
彰化縣,秀水鄉,秀水村,245,1,421,5,426,584,3,1,3,0,1,0,72.95
彰化縣,秀水鄉,安溪村,246,1,972,21,993,1432,3,1,3,0,1,0,69.34
彰化縣,秀水鄉,莊雅村,247,1,832,7,839,1216,3,1,3,0,1,0,69.00
彰化縣,秀水鄉,莊雅村,248,1,522,9,531,767,3,1,3,0,1,0,69.23
彰化縣,秀水鄉,陝西村,249,1,832,6,838,1165,3,1,3,0,1,0,71.93
彰化縣,秀水鄉,金興村,250,1,589,12,601,850,3,1,3,0,1,0,70.71
彰化縣,秀水鄉,金興村,251,1,563,7,570,784,3,1,3,0,1,0,72.70
彰化縣,秀水鄉,安東村,252,1,819,10,829,1174,3,1,3,0,1,0,70.61
彰化縣,秀水鄉,安東村,253,1,619,7,626,854,3,1,3,0,1,0,73.30
彰化縣,秀水鄉,安東村,254,1,699,14,713,1095,3,1,3,0,1,0,65.11
彰化縣,秀水鄉,鶴鳴村,255,1,1033,15,1048,1434,3,1,3,0,1,0,73.08
彰化縣,秀水鄉,鶴鳴村,256,1,768,14,782,1105,3,1,3,0,1,0,70.77
彰化縣,秀水鄉,馬興村,257,1,826,10,836,1089,3,1,3,0,1,0,76.77
彰化縣,秀水鄉,馬興村,258,1,602,15,617,815,3,1,3,0,1,0,75.71
彰化縣,秀水鄉,義興村,259,1,759,14,773,1090,3,1,3,0,1,0,70.92
彰化縣,秀水鄉,福安村,260,1,1030,20,1050,1540,3,1,3,0,1,0,68.18
彰化縣,秀水鄉,福安村,261,1,1146,14,1160,1655,3,1,3,0,1,0,70.09
彰化縣,秀水鄉,埔崙村,262,1,447,9,456,621,3,1,3,0,1,0,73.43
彰化縣,秀水鄉,埔崙村,263,1,771,10,781,1073,3,1,3,0,1,0,72.79
彰化縣,秀水鄉,曾厝村,264,1,944,13,957,1303,3,1,3,0,1,0,73.45
彰化縣,秀水鄉,金陵村,265,1,984,16,1000,1364,3,1,3,0,1,0,73.31
彰化縣,秀水鄉,下崙村,266,1,845,13,858,1123,3,1,3,0,1,0,76.40
彰化縣,秀水鄉,下崙村,267,1,523,4,527,706,3,1,3,0,1,0,74.65
彰化縣,和美鎮,竹營里,268,1,1204,14,1218,1757,3,1,3,0,1,0,69.32
彰化縣,和美鎮,竹營里,269,1,1302,25,1327,1997,3,1,3,0,1,0,66.45
彰化縣,和美鎮,和東里,270,1,1197,23,1220,1814,3,1,3,0,1,0,67.25
彰化縣,和美鎮,和東里,271,1,993,13,1006,1489,3,1,3,0,1,0,67.56
彰化縣,和美鎮,和南里,272,1,348,5,353,465,3,1,3,0,1,0,75.91
彰化縣,和美鎮,和北里,273,1,936,13,949,1338,3,1,3,0,1,0,70.93
彰化縣,和美鎮,和西里,274,1,959,15,974,1412,3,1,3,0,1,0,68.98
彰化縣,和美鎮,和西里,275,1,1025,18,1043,1583,3,1,3,0,1,0,65.89
彰化縣,和美鎮,四張里,276,1,677,8,685,998,3,1,3,0,1,0,68.64
彰化縣,和美鎮,四張里,277,1,775,15,790,1190,3,1,3,0,1,0,66.39
彰化縣,和美鎮,頭前里,278,1,894,23,917,1257,3,1,3,0,1,0,72.95
彰化縣,和美鎮,還社里,279,1,563,11,574,767,3,1,3,0,1,0,74.84
彰化縣,和美鎮,面前里,280,1,432,5,437,549,3,1,3,0,1,0,79.60
彰化縣,和美鎮,面前里,281,1,761,11,772,1068,3,1,3,0,1,0,72.28
彰化縣,和美鎮,鎮平里,282,1,804,11,815,1121,3,1,3,0,1,0,72.70
彰化縣,和美鎮,鎮平里,283,1,775,5,780,1154,3,1,3,0,1,0,67.59
彰化縣,和美鎮,大霞里,284,1,864,16,880,1235,3,1,3,0,1,0,71.26
彰化縣,和美鎮,源埤里,285,1,1057,14,1071,1510,3,1,3,0,1,0,70.93
彰化縣,和美鎮,南佃里,286,1,1090,24,1114,1615,3,1,3,0,1,0,68.98
彰化縣,和美鎮,雅溝里,287,1,870,12,882,1224,3,1,3,0,1,0,72.06
彰化縣,和美鎮,山犁里,288,1,1143,19,1162,1705,3,1,3,0,1,0,68.15
彰化縣,和美鎮,山犁里,289,1,1294,17,1311,1954,3,1,3,0,1,0,67.09
彰化縣,和美鎮,山犁里,290,1,895,10,905,1385,3,1,3,0,1,0,65.34
彰化縣,和美鎮,嘉犁里,291,1,972,21,993,1527,3,1,3,0,1,0,65.03
彰化縣,和美鎮,詔安里,292,1,1062,19,1081,1599,3,1,3,0,1,0,67.60
彰化縣,和美鎮,鐵山里,293,1,825,21,846,1273,3,1,3,0,1,0,66.46
彰化縣,和美鎮,鐵山里,294,1,607,9,616,1016,3,1,3,0,1,0,60.63
彰化縣,和美鎮,柑井里,295,1,895,19,914,1329,3,1,3,0,1,0,68.77
彰化縣,和美鎮,柑井里,296,1,911,18,929,1284,3,1,3,0,1,0,72.35
彰化縣,和美鎮,竹園里,297,1,615,6,621,779,3,1,3,0,1,0,79.72
彰化縣,和美鎮,新庄里,298,1,817,21,838,1293,3,1,3,0,1,0,64.81
彰化縣,和美鎮,新庄里,299,1,644,8,652,887,3,1,3,0,1,0,73.51
彰化縣,和美鎮,犁盛里,300,1,724,16,740,1035,3,1,3,0,1,0,71.50
彰化縣,和美鎮,犁盛里,301,1,721,18,739,973,3,1,3,0,1,0,75.95
彰化縣,和美鎮,中寮里,302,1,712,14,726,1051,3,1,3,0,1,0,69.08
彰化縣,和美鎮,中圍里,303,1,668,10,678,992,3,1,3,0,1,0,68.35
彰化縣,和美鎮,中圍里,304,1,943,22,965,1490,3,1,3,0,1,0,64.77
彰化縣,和美鎮,糖友里,305,1,820,6,826,1223,3,1,3,0,1,0,67.54
彰化縣,和美鎮,糖友里,306,1,776,10,786,1145,3,1,3,0,1,0,68.65
彰化縣,和美鎮,塗厝里,307,1,1061,19,1080,1602,3,1,3,0,1,0,67.42
彰化縣,和美鎮,地潭里,308,1,548,10,558,834,3,1,3,0,1,0,66.91
彰化縣,和美鎮,湖內里,309,1,885,7,892,1227,3,1,3,0,1,0,72.70
彰化縣,和美鎮,嘉寶里,310,1,1119,30,1149,1683,3,1,3,0,1,0,68.27
彰化縣,和美鎮,月眉里,311,1,1033,24,1057,1554,3,1,3,0,1,0,68.02
彰化縣,和美鎮,月眉里,312,1,821,11,832,1191,3,1,3,0,1,0,69.86
彰化縣,和美鎮,好修里,313,1,440,9,449,695,3,1,3,0,1,0,64.60
彰化縣,和美鎮,好修里,314,1,654,15,669,930,3,1,3,0,1,0,71.94
彰化縣,線西鄉,線西村,315,1,1212,27,1239,1840,3,1,3,0,1,0,67.34
彰化縣,線西鄉,頂庄村,316,1,761,7,768,1115,3,1,3,0,1,0,68.88
彰化縣,線西鄉,寓埔村,317,1,1217,21,1238,1882,3,1,3,0,1,0,65.78
彰化縣,線西鄉,塭仔村,318,1,796,9,805,1143,3,1,3,0,1,0,70.43
彰化縣,線西鄉,溝內村,319,1,666,14,680,976,3,1,3,0,1,0,69.67
彰化縣,線西鄉,下犁村,320,1,1072,24,1096,1574,3,1,3,0,1,0,69.63
彰化縣,線西鄉,頂犁村,321,1,688,10,698,977,3,1,3,0,1,0,71.44
彰化縣,線西鄉,頂犁村,322,1,726,11,737,1109,3,1,3,0,1,0,66.46
彰化縣,線西鄉,德興村,323,1,719,10,729,1023,3,1,3,0,1,0,71.26
彰化縣,伸港鄉,新港村,324,1,779,7,786,1196,3,1,3,0,1,0,65.72
彰化縣,伸港鄉,新港村,325,1,834,10,844,1328,3,1,3,0,1,0,63.55
彰化縣,伸港鄉,新港村,326,1,890,17,907,1403,3,1,3,0,1,0,64.65
彰化縣,伸港鄉,什股村,327,1,953,16,969,1448,3,1,3,0,1,0,66.92
彰化縣,伸港鄉,大同村,328,1,851,16,867,1206,3,1,3,0,1,0,71.89
彰化縣,伸港鄉,海尾村,329,1,1137,16,1153,1564,3,1,3,0,1,0,73.72
彰化縣,伸港鄉,全興村,330,1,919,14,933,1418,3,1,3,0,1,0,65.80
彰化縣,伸港鄉,溪底村,331,1,1031,11,1042,1505,3,1,3,0,1,0,69.24
彰化縣,伸港鄉,定興村,332,1,662,9,671,971,3,1,3,0,1,0,69.10
彰化縣,伸港鄉,定興村,333,1,679,13,692,1122,3,1,3,0,1,0,61.68
彰化縣,伸港鄉,泉州村,334,1,1090,18,1108,1590,3,1,3,0,1,0,69.69
彰化縣,伸港鄉,泉厝村,335,1,744,14,758,1122,3,1,3,0,1,0,67.56
彰化縣,伸港鄉,曾家村,336,1,955,12,967,1459,3,1,3,0,1,0,66.28
彰化縣,伸港鄉,蚵寮村,337,1,746,8,754,1121,3,1,3,0,1,0,67.26
彰化縣,伸港鄉,埤墘村,338,1,580,11,591,886,3,1,3,0,1,0,66.70
彰化縣,伸港鄉,七嘉村,339,1,1240,17,1257,1786,3,1,3,0,1,0,70.38
彰化縣,伸港鄉,汴頭村,340,1,1306,12,1318,1880,3,1,3,0,1,0,70.11
彰化縣,員林鎮,東和里,341,1,694,13,707,1064,3,1,3,0,1,0,66.45
彰化縣,員林鎮,民生里,342,1,982,18,1000,1508,3,1,3,0,1,0,66.31
彰化縣,員林鎮,民生里,343,1,676,5,681,1039,3,1,3,0,1,0,65.54
彰化縣,員林鎮,中正里,344,1,764,11,775,1150,3,1,3,0,1,0,67.39
彰化縣,員林鎮,中正里,345,1,1074,7,1081,1682,3,1,3,0,1,0,64.27
彰化縣,員林鎮,仁美里,346,1,740,5,745,1103,3,1,3,0,1,0,67.54
彰化縣,員林鎮,仁美里,347,1,1096,10,1106,1608,3,1,3,0,1,0,68.78
彰化縣,員林鎮,新興里,348,1,574,3,577,816,3,1,3,0,1,0,70.71
彰化縣,員林鎮,和平里,349,1,689,7,696,1051,3,1,3,0,1,0,66.22
彰化縣,員林鎮,和平里,350,1,996,13,1009,1535,3,1,3,0,1,0,65.73
彰化縣,員林鎮,光明里,351,1,675,6,681,948,3,1,3,0,1,0,71.84
彰化縣,員林鎮,中山里,352,1,499,4,503,718,3,1,3,0,1,0,70.06
彰化縣,員林鎮,黎明里,353,1,582,10,592,870,3,1,3,0,1,0,68.05
彰化縣,員林鎮,黎明里,354,1,596,10,606,892,3,1,3,0,1,0,67.94
彰化縣,員林鎮,惠來里,355,1,1046,10,1056,1607,3,1,3,0,1,0,65.71
彰化縣,員林鎮,惠來里,356,1,843,5,848,1275,3,1,3,0,1,0,66.51
彰化縣,員林鎮,惠來里,357,1,869,15,884,1330,3,1,3,0,1,0,66.47
彰化縣,員林鎮,三義里,358,1,627,11,638,980,3,1,3,0,1,0,65.10
彰化縣,員林鎮,三義里,359,1,830,12,842,1243,3,1,3,0,1,0,67.74
彰化縣,員林鎮,新生里,360,1,690,9,699,1051,3,1,3,0,1,0,66.51
彰化縣,員林鎮,新生里,361,1,678,8,686,1018,3,1,3,0,1,0,67.39
彰化縣,員林鎮,新生里,362,1,558,4,562,760,3,1,3,0,1,0,73.95
彰化縣,員林鎮,新生里,363,1,537,8,545,816,3,1,3,0,1,0,66.79
彰化縣,員林鎮,南平里,364,1,617,7,624,1010,3,1,3,0,1,0,61.78
彰化縣,員林鎮,南平里,365,1,720,10,730,1081,3,1,3,0,1,0,67.53
彰化縣,員林鎮,南平里,366,1,913,8,921,1300,3,1,3,0,1,0,70.85
彰化縣,員林鎮,南興里,367,1,965,13,978,1465,3,1,3,0,1,0,66.76
彰化縣,員林鎮,南興里,368,1,940,21,961,1362,3,1,3,0,1,0,70.56
彰化縣,員林鎮,南興里,369,1,839,8,847,1249,3,1,3,0,1,0,67.81
彰化縣,員林鎮,源潭里,370,1,969,8,977,1424,3,1,3,0,1,0,68.61
彰化縣,員林鎮,大埔里,371,1,1154,16,1170,1688,3,1,3,0,1,0,69.31
彰化縣,員林鎮,三條里,372,1,707,9,716,1108,3,1,3,0,1,0,64.62
彰化縣,員林鎮,三條里,373,1,863,14,877,1300,3,1,3,0,1,0,67.46
彰化縣,員林鎮,三條里,374,1,771,9,780,1188,3,1,3,0,1,0,65.66
彰化縣,員林鎮,三條里,375,1,928,11,939,1392,3,1,3,0,1,0,67.46
彰化縣,員林鎮,三和里,376,1,970,7,977,1431,3,1,3,0,1,0,68.27
彰化縣,員林鎮,三和里,377,1,989,8,997,1482,3,1,3,0,1,0,67.27
彰化縣,員林鎮,三和里,378,1,1095,16,1111,1750,3,1,3,0,1,0,63.49
彰化縣,員林鎮,三橋里,379,1,780,11,791,1141,3,1,3,0,1,0,69.33
彰化縣,員林鎮,三橋里,380,1,840,15,855,1303,3,1,3,0,1,0,65.62
彰化縣,員林鎮,三愛里,381,1,804,5,809,1259,3,1,3,0,1,0,64.26
彰化縣,員林鎮,三愛里,382,1,694,6,700,1058,3,1,3,0,1,0,66.16
彰化縣,員林鎮,三信里,383,1,605,11,616,930,3,1,3,0,1,0,66.24
彰化縣,員林鎮,三信里,384,1,637,5,642,934,3,1,3,0,1,0,68.74
彰化縣,員林鎮,三多里,385,1,666,6,672,1031,3,1,3,0,1,0,65.18
彰化縣,員林鎮,三多里,386,1,569,8,577,859,3,1,3,0,1,0,67.17
彰化縣,員林鎮,中央里,387,1,960,15,975,1435,3,1,3,0,1,0,67.94
彰化縣,員林鎮,溝皂里,388,1,686,10,696,1038,3,1,3,0,1,0,67.05
彰化縣,員林鎮,溝皂里,389,1,639,4,643,953,3,1,3,0,1,0,67.47
彰化縣,員林鎮,大饒里,390,1,769,8,777,1138,3,1,3,0,1,0,68.28
彰化縣,員林鎮,大饒里,391,1,856,9,865,1298,3,1,3,0,1,0,66.64
彰化縣,員林鎮,大明里,392,1,694,18,712,1052,3,1,3,0,1,0,67.68
彰化縣,員林鎮,大明里,393,1,596,11,607,896,3,1,3,0,1,0,67.75
彰化縣,員林鎮,萬年里,394,1,526,6,532,817,3,1,3,0,1,0,65.12
彰化縣,員林鎮,萬年里,395,1,636,16,652,966,3,1,3,0,1,0,67.49
彰化縣,員林鎮,萬年里,396,1,803,7,810,1162,3,1,3,0,1,0,69.71
彰化縣,員林鎮,崙雅里,397,1,746,8,754,1050,3,1,3,0,1,0,71.81
彰化縣,員林鎮,崙雅里,398,1,804,8,812,1141,3,1,3,0,1,0,71.17
彰化縣,員林鎮,振興里,399,1,693,11,704,1066,3,1,3,0,1,0,66.04
彰化縣,員林鎮,振興里,400,1,714,13,727,1103,3,1,3,0,1,0,65.91
彰化縣,員林鎮,林厝里,401,1,655,13,668,1016,3,1,3,0,1,0,65.75
彰化縣,員林鎮,林厝里,402,1,731,13,744,1202,3,1,3,0,1,0,61.90
彰化縣,員林鎮,出水里,403,1,1015,17,1032,1677,3,1,3,0,1,0,61.54
彰化縣,員林鎮,湖水里,404,1,814,9,823,1272,3,1,3,0,1,0,64.70
彰化縣,員林鎮,大峰里,405,1,438,6,444,730,3,1,3,0,1,0,60.82
彰化縣,員林鎮,鎮興里,406,1,582,9,591,935,3,1,3,0,1,0,63.21
彰化縣,員林鎮,鎮興里,407,1,548,8,556,808,3,1,3,0,1,0,68.81
彰化縣,員林鎮,浮圳里,408,1,763,6,769,1095,3,1,3,0,1,0,70.23
彰化縣,員林鎮,浮圳里,409,1,574,3,577,885,3,1,3,0,1,0,65.20
彰化縣,員林鎮,西東里,410,1,1094,15,1109,1568,3,1,3,0,1,0,70.73
彰化縣,員林鎮,南東里,411,1,606,13,619,931,3,1,3,0,1,0,66.49
彰化縣,員林鎮,南東里,412,1,441,4,445,676,3,1,3,0,1,0,65.83
彰化縣,員林鎮,中東里,413,1,917,13,930,1412,3,1,3,0,1,0,65.86
彰化縣,員林鎮,東北里,414,1,694,9,703,959,3,1,3,0,1,0,73.31
彰化縣,員林鎮,東北里,415,1,633,10,643,999,3,1,3,0,1,0,64.36
彰化縣,大村鄉,大村村,416,1,762,15,777,1046,3,1,3,0,1,0,74.28
彰化縣,大村鄉,大村村,417,1,596,10,606,884,3,1,3,0,1,0,68.55
彰化縣,大村鄉,茄苳村,418,1,1067,16,1083,1526,3,1,3,0,1,0,70.97
彰化縣,大村鄉,田洋村,419,1,619,11,630,871,3,1,3,0,1,0,72.33
彰化縣,大村鄉,貢旗村,420,1,893,11,904,1299,3,1,3,0,1,0,69.59
彰化縣,大村鄉,加錫村,421,1,837,6,843,1217,3,1,3,0,1,0,69.27
彰化縣,大村鄉,大崙村,422,1,990,15,1005,1406,3,1,3,0,1,0,71.48
彰化縣,大村鄉,新興村,423,1,782,5,787,1130,3,1,3,0,1,0,69.65
彰化縣,大村鄉,南勢村,424,1,781,19,800,1173,3,1,3,0,1,0,68.20
彰化縣,大村鄉,擺塘村,425,1,862,7,869,1212,3,1,3,0,1,0,71.70
彰化縣,大村鄉,擺塘村,426,1,570,10,580,870,3,1,3,0,1,0,66.67
彰化縣,大村鄉,過溝村,427,1,1322,11,1333,1882,3,1,3,0,1,0,70.83
彰化縣,大村鄉,大橋村,428,1,1119,12,1131,1769,3,1,3,0,1,0,63.93
彰化縣,大村鄉,村上村,429,1,863,11,874,1182,3,1,3,0,1,0,73.94
彰化縣,大村鄉,美港村,430,1,927,10,937,1414,3,1,3,0,1,0,66.27
彰化縣,大村鄉,美港村,431,1,665,13,678,1055,3,1,3,0,1,0,64.27
彰化縣,大村鄉,黃厝村,432,1,1154,16,1170,1705,3,1,3,0,1,0,68.62
彰化縣,大村鄉,福興村,433,1,1096,16,1112,1711,3,1,3,0,1,0,64.99
彰化縣,大村鄉,平和村,434,1,708,12,720,1093,3,1,3,0,1,0,65.87
彰化縣,大村鄉,平和村,435,1,505,13,518,846,3,1,3,0,1,0,61.23
彰化縣,永靖鄉,永東村,436,1,601,8,609,812,3,1,3,0,1,0,75.00
彰化縣,永靖鄉,永西村,437,1,1012,12,1024,1446,3,1,3,0,1,0,70.82
彰化縣,永靖鄉,永南村,438,1,1215,17,1232,1788,3,1,3,0,1,0,68.90
彰化縣,永靖鄉,永北村,439,1,1216,19,1235,1810,3,1,3,0,1,0,68.23
彰化縣,永靖鄉,港西村,440,1,1092,24,1116,1591,3,1,3,0,1,0,70.14
彰化縣,永靖鄉,五福村,441,1,848,16,864,1275,3,1,3,0,1,0,67.76
彰化縣,永靖鄉,湳港村,442,1,651,12,663,906,3,1,3,0,1,0,73.18
彰化縣,永靖鄉,新莊村,443,1,570,8,578,835,3,1,3,0,1,0,69.22
彰化縣,永靖鄉,瑚璉村,444,1,715,4,719,1008,3,1,3,0,1,0,71.33
彰化縣,永靖鄉,瑚璉村,445,1,698,10,708,973,3,1,3,0,1,0,72.76
彰化縣,永靖鄉,五汴村,446,1,913,7,920,1268,3,1,3,0,1,0,72.56
彰化縣,永靖鄉,浮圳村,447,1,779,16,795,1055,3,1,3,0,1,0,75.36
彰化縣,永靖鄉,光雲村,448,1,1022,20,1042,1487,3,1,3,0,1,0,70.07
彰化縣,永靖鄉,東寧村,449,1,1055,10,1065,1608,3,1,3,0,1,0,66.23
彰化縣,永靖鄉,永興村,450,1,1058,8,1066,1487,3,1,3,0,1,0,71.69
彰化縣,永靖鄉,崙子村,451,1,797,16,813,1149,3,1,3,0,1,0,70.76
彰化縣,永靖鄉,獨鰲村,452,1,579,9,588,834,3,1,3,0,1,0,70.50
彰化縣,永靖鄉,敦厚村,453,1,483,5,488,690,3,1,3,0,1,0,70.72
彰化縣,永靖鄉,崙美村,454,1,540,5,545,726,3,1,3,0,1,0,75.07
彰化縣,永靖鄉,同安村,455,1,487,8,495,664,3,1,3,0,1,0,74.55
彰化縣,永靖鄉,同仁村,456,1,658,10,668,931,3,1,3,0,1,0,71.75
彰化縣,永靖鄉,湳墘村,457,1,610,11,621,834,3,1,3,0,1,0,74.46
彰化縣,永靖鄉,四芳村,458,1,488,7,495,657,3,1,3,0,1,0,75.34
彰化縣,永靖鄉,福興村,459,1,823,10,833,1119,3,1,3,0,1,0,74.44
彰化縣,永靖鄉,竹子村,460,1,948,10,958,1335,3,1,3,0,1,0,71.76
彰化縣,溪湖鎮,光平里,461,1,848,7,855,1208,3,1,3,0,1,0,70.78
彰化縣,溪湖鎮,平和里,462,1,569,3,572,759,3,1,3,0,1,0,75.36
彰化縣,溪湖鎮,太平里,463,1,923,8,931,1317,3,1,3,0,1,0,70.69
彰化縣,溪湖鎮,光華里,464,1,350,5,355,485,3,1,3,0,1,0,73.20
彰化縣,溪湖鎮,東寮里,465,1,836,6,842,1278,3,1,3,0,1,0,65.88
彰化縣,溪湖鎮,東寮里,466,1,954,12,966,1467,3,1,3,0,1,0,65.85
彰化縣,溪湖鎮,西寮里,467,1,574,6,580,854,3,1,3,0,1,0,67.92
彰化縣,溪湖鎮,西寮里,468,1,653,10,663,956,3,1,3,0,1,0,69.35
彰化縣,溪湖鎮,大突里,469,1,743,12,755,1063,3,1,3,0,1,0,71.03
彰化縣,溪湖鎮,大突里,470,1,636,8,644,928,3,1,3,0,1,0,69.40
彰化縣,溪湖鎮,北勢里,471,1,876,10,886,1241,3,1,3,0,1,0,71.39
彰化縣,溪湖鎮,汴頭里,472,1,867,8,875,1218,3,1,3,0,1,0,71.84
彰化縣,溪湖鎮,汴頭里,473,1,642,9,651,964,3,1,3,0,1,0,67.53
彰化縣,溪湖鎮,大竹里,474,1,703,5,708,1035,3,1,3,0,1,0,68.41
彰化縣,溪湖鎮,大竹里,475,1,788,5,793,1134,3,1,3,0,1,0,69.93
彰化縣,溪湖鎮,湖西里,476,1,634,5,639,904,3,1,3,0,1,0,70.69
彰化縣,溪湖鎮,湖西里,477,1,595,5,600,932,3,1,3,0,1,0,64.38
彰化縣,溪湖鎮,田中里,478,1,513,11,524,746,3,1,3,0,1,0,70.24
彰化縣,溪湖鎮,河東里,479,1,1067,16,1083,1577,3,1,3,0,1,0,68.67
彰化縣,溪湖鎮,中山里,480,1,738,8,746,1080,3,1,3,0,1,0,69.07
彰化縣,溪湖鎮,中山里,481,1,750,7,757,1080,3,1,3,0,1,0,70.09
彰化縣,溪湖鎮,中竹里,482,1,508,9,517,781,3,1,3,0,1,0,66.20
彰化縣,溪湖鎮,東溪里,483,1,791,14,805,1214,3,1,3,0,1,0,66.31
彰化縣,溪湖鎮,西溪里,484,1,983,13,996,1452,3,1,3,0,1,0,68.60
彰化縣,溪湖鎮,湖東里,485,1,811,11,822,1173,3,1,3,0,1,0,70.08
彰化縣,溪湖鎮,湖東里,486,1,793,14,807,1200,3,1,3,0,1,0,67.25
彰化縣,溪湖鎮,湖東里,487,1,726,7,733,1076,3,1,3,0,1,0,68.12
彰化縣,溪湖鎮,頂庄里,488,1,448,9,457,661,3,1,3,0,1,0,69.14
彰化縣,溪湖鎮,忠覺里,489,1,790,11,801,1184,3,1,3,0,1,0,67.65
彰化縣,溪湖鎮,湳底里,490,1,494,7,501,701,3,1,3,0,1,0,71.47
彰化縣,溪湖鎮,大庭里,491,1,782,8,790,1211,3,1,3,0,1,0,65.24
彰化縣,溪湖鎮,媽厝里,492,1,827,12,839,1312,3,1,3,0,1,0,63.95
彰化縣,溪湖鎮,西勢里,493,1,487,10,497,738,3,1,3,0,1,0,67.34
彰化縣,溪湖鎮,西勢里,494,1,665,5,670,1095,3,1,3,0,1,0,61.19
彰化縣,溪湖鎮,番婆里,495,1,881,15,896,1483,3,1,3,0,1,0,60.42
彰化縣,埔鹽鄉,埔鹽村,496,1,1060,24,1084,1461,3,1,3,0,1,0,74.20
彰化縣,埔鹽鄉,埔南村,497,1,980,23,1003,1449,3,1,3,0,1,0,69.22
彰化縣,埔鹽鄉,廍子村,498,1,788,15,803,1092,3,1,3,0,1,0,73.53
彰化縣,埔鹽鄉,出水村,499,1,600,10,610,787,3,1,3,0,1,0,77.51
彰化縣,埔鹽鄉,南港村,500,1,1180,15,1195,1579,3,1,3,0,1,0,75.68
彰化縣,埔鹽鄉,打廉村,501,1,645,8,653,917,3,1,3,0,1,0,71.21
彰化縣,埔鹽鄉,豐澤村,502,1,840,14,854,1258,3,1,3,0,1,0,67.89
彰化縣,埔鹽鄉,崑崙村,503,1,714,10,724,1001,3,1,3,0,1,0,72.33
彰化縣,埔鹽鄉,角樹村,504,1,519,5,524,676,3,1,3,0,1,0,77.51
彰化縣,埔鹽鄉,瓦窯村,505,1,814,15,829,1141,3,1,3,0,1,0,72.66
彰化縣,埔鹽鄉,好修村,506,1,911,11,922,1259,3,1,3,0,1,0,73.23
彰化縣,埔鹽鄉,西湖村,507,1,1328,35,1363,1921,3,1,3,0,1,0,70.95
彰化縣,埔鹽鄉,大有村,508,1,877,14,891,1226,3,1,3,0,1,0,72.68
彰化縣,埔鹽鄉,新興村,509,1,275,1,276,392,3,1,3,0,1,0,70.41
彰化縣,埔鹽鄉,永平村,510,1,677,8,685,1007,3,1,3,0,1,0,68.02
彰化縣,埔鹽鄉,永樂村,511,1,557,4,561,750,3,1,3,0,1,0,74.80
彰化縣,埔鹽鄉,石埤村,512,1,884,14,898,1301,3,1,3,0,1,0,69.02
彰化縣,埔鹽鄉,天盛村,513,1,620,3,623,809,3,1,3,0,1,0,77.01
彰化縣,埔鹽鄉,太平村,514,1,925,7,932,1454,3,1,3,0,1,0,64.10
彰化縣,埔鹽鄉,新水村,515,1,914,16,930,1301,3,1,3,0,1,0,71.48
彰化縣,埔鹽鄉,三省村,516,1,848,17,865,1258,3,1,3,0,1,0,68.76
彰化縣,埔鹽鄉,南新村,517,1,861,11,872,1232,3,1,3,0,1,0,70.78
彰化縣,埔心鄉,東門村,518,1,794,13,807,1149,3,1,3,0,1,0,70.23
彰化縣,埔心鄉,東門村,519,1,871,8,879,1327,3,1,3,0,1,0,66.24
彰化縣,埔心鄉,埔心村,520,1,821,9,830,1195,3,1,3,0,1,0,69.46
彰化縣,埔心鄉,義民村,521,1,981,14,995,1401,3,1,3,0,1,0,71.02
彰化縣,埔心鄉,油車村,522,1,761,18,779,1090,3,1,3,0,1,0,71.47
彰化縣,埔心鄉,瓦北村,523,1,1044,16,1060,1540,3,1,3,0,1,0,68.83
彰化縣,埔心鄉,瓦中村,524,1,1116,17,1133,1591,3,1,3,0,1,0,71.21
彰化縣,埔心鄉,瓦南村,525,1,937,13,950,1307,3,1,3,0,1,0,72.69
彰化縣,埔心鄉,經口村,526,1,1046,7,1053,1528,3,1,3,0,1,0,68.91
彰化縣,埔心鄉,太平村,527,1,1187,19,1206,1688,3,1,3,0,1,0,71.45
彰化縣,埔心鄉,大華村,528,1,414,4,418,590,3,1,3,0,1,0,70.85
彰化縣,埔心鄉,仁里村,529,1,678,13,691,1022,3,1,3,0,1,0,67.61
彰化縣,埔心鄉,舊舘村,530,1,782,12,794,1124,3,1,3,0,1,0,70.64
彰化縣,埔心鄉,南舘村,531,1,483,10,493,705,3,1,3,0,1,0,69.93
彰化縣,埔心鄉,新舘村,532,1,567,13,580,849,3,1,3,0,1,0,68.32
彰化縣,埔心鄉,芎蕉村,533,1,1101,22,1123,1608,3,1,3,0,1,0,69.84
彰化縣,埔心鄉,羅厝村,534,1,901,8,909,1285,3,1,3,0,1,0,70.74
彰化縣,埔心鄉,梧鳳村,535,1,590,6,596,861,3,1,3,0,1,0,69.22
彰化縣,埔心鄉,二重村,536,1,805,8,813,1174,3,1,3,0,1,0,69.25
彰化縣,埔心鄉,埤霞村,537,1,539,17,556,757,3,1,3,0,1,0,73.45
彰化縣,埔心鄉,埤腳村,538,1,608,10,618,830,3,1,3,0,1,0,74.46
彰化縣,田中鎮,香山里,539,1,606,5,611,884,3,1,3,0,1,0,69.12
彰化縣,田中鎮,碧峰里,540,1,414,9,423,644,3,1,3,0,1,0,65.68
彰化縣,田中鎮,碧峰里,541,1,828,72,900,1704,3,1,3,0,1,0,52.82
彰化縣,田中鎮,東源里,542,1,415,5,420,644,3,1,3,0,1,0,65.22
彰化縣,田中鎮,復興里,543,1,1008,18,1026,1459,3,1,3,0,1,0,70.32
彰化縣,田中鎮,平和里,544,1,964,24,988,1448,3,1,3,0,1,0,68.23
彰化縣,田中鎮,頂潭里,545,1,850,11,861,1202,3,1,3,0,1,0,71.63
彰化縣,田中鎮,中潭里,546,1,1119,9,1128,1642,3,1,3,0,1,0,68.70
彰化縣,田中鎮,龍潭里,547,1,449,6,455,638,3,1,3,0,1,0,71.32
彰化縣,田中鎮,北路里,548,1,1052,12,1064,1591,3,1,3,0,1,0,66.88
彰化縣,田中鎮,北路里,549,1,840,6,846,1127,3,1,3,0,1,0,75.07
彰化縣,田中鎮,西路里,550,1,606,6,612,867,3,1,3,0,1,0,70.59
彰化縣,田中鎮,西路里,551,1,838,14,852,1234,3,1,3,0,1,0,69.04
彰化縣,田中鎮,東路里,552,1,798,10,808,1070,3,1,3,0,1,0,75.51
彰化縣,田中鎮,南路里,553,1,893,9,902,1258,3,1,3,0,1,0,71.70
彰化縣,田中鎮,中路里,554,1,634,4,638,894,3,1,3,0,1,0,71.36
彰化縣,田中鎮,中路里,555,1,755,8,763,1069,3,1,3,0,1,0,71.38
彰化縣,田中鎮,新庄里,556,1,594,12,606,963,3,1,3,0,1,0,62.93
彰化縣,田中鎮,新庄里,557,1,711,17,728,1050,3,1,3,0,1,0,69.33
彰化縣,田中鎮,三安里,558,1,1062,18,1080,1608,3,1,3,0,1,0,67.16
彰化縣,田中鎮,大崙里,559,1,876,6,882,1272,3,1,3,0,1,0,69.34
彰化縣,田中鎮,沙崙里,560,1,983,13,996,1540,3,1,3,0,1,0,64.68
彰化縣,田中鎮,新民里,561,1,1084,16,1100,1629,3,1,3,0,1,0,67.53
彰化縣,田中鎮,新民里,562,1,1039,16,1055,1621,3,1,3,0,1,0,65.08
彰化縣,田中鎮,梅州里,563,1,844,14,858,1295,3,1,3,0,1,0,66.25
彰化縣,田中鎮,三民里,564,1,1017,14,1031,1482,3,1,3,0,1,0,69.57
彰化縣,田中鎮,三光里,565,1,573,9,582,861,3,1,3,0,1,0,67.60
彰化縣,田中鎮,大社里,566,1,541,3,544,766,3,1,3,0,1,0,71.02
彰化縣,社頭鄉,社頭村,567,1,839,10,849,1248,3,1,3,0,1,0,68.03
彰化縣,社頭鄉,社頭村,568,1,902,6,908,1319,3,1,3,0,1,0,68.84
彰化縣,社頭鄉,廣興村,569,1,752,8,760,1061,3,1,3,0,1,0,71.63
彰化縣,社頭鄉,廣興村,570,1,901,23,924,1341,3,1,3,0,1,0,68.90
彰化縣,社頭鄉,廣興村,571,1,828,8,836,1155,3,1,3,0,1,0,72.38
彰化縣,社頭鄉,仁雅村,572,1,727,3,730,1011,3,1,3,0,1,0,72.21
彰化縣,社頭鄉,仁雅村,573,1,932,9,941,1396,3,1,3,0,1,0,67.41
彰化縣,社頭鄉,崙雅村,574,1,523,11,534,770,3,1,3,0,1,0,69.35
彰化縣,社頭鄉,美雅村,575,1,701,10,711,994,3,1,3,0,1,0,71.53
彰化縣,社頭鄉,里仁村,576,1,693,13,706,990,3,1,3,0,1,0,71.31
彰化縣,社頭鄉,舊社村,577,1,937,15,952,1341,3,1,3,0,1,0,70.99
彰化縣,社頭鄉,松竹村,578,1,636,7,643,881,3,1,3,0,1,0,72.99
彰化縣,社頭鄉,東興村,579,1,844,20,864,1215,3,1,3,0,1,0,71.11
彰化縣,社頭鄉,廣福村,580,1,575,12,587,826,3,1,3,0,1,0,71.07
彰化縣,社頭鄉,橋頭村,581,1,1319,17,1336,1836,3,1,3,0,1,0,72.77
彰化縣,社頭鄉,湳底村,582,1,1026,10,1036,1436,3,1,3,0,1,0,72.14
彰化縣,社頭鄉,新厝村,583,1,985,13,998,1375,3,1,3,0,1,0,72.58
彰化縣,社頭鄉,張厝村,584,1,750,20,770,1065,3,1,3,0,1,0,72.30
彰化縣,社頭鄉,埤斗村,585,1,712,10,722,978,3,1,3,0,1,0,73.82
彰化縣,社頭鄉,清水村,586,1,770,9,779,1046,3,1,3,0,1,0,74.47
彰化縣,社頭鄉,山湖村,587,1,680,8,688,921,3,1,3,0,1,0,74.70
彰化縣,社頭鄉,朝興村,588,1,713,12,725,1020,3,1,3,0,1,0,71.08
彰化縣,社頭鄉,仁和村,589,1,456,12,468,669,3,1,3,0,1,0,69.96
彰化縣,社頭鄉,泰安村,590,1,580,8,588,827,3,1,3,0,1,0,71.10
彰化縣,社頭鄉,平和村,591,1,682,10,692,958,3,1,3,0,1,0,72.23
彰化縣,社頭鄉,龍井村,592,1,537,5,542,782,3,1,3,0,1,0,69.31
彰化縣,社頭鄉,湳雅村,593,1,898,17,915,1340,3,1,3,0,1,0,68.28
彰化縣,社頭鄉,協和村,594,1,1308,29,1337,1873,3,1,3,0,1,0,71.38
彰化縣,二水鄉,復興村,595,1,724,11,735,1018,3,1,3,0,1,0,72.20
彰化縣,二水鄉,十五村,596,1,487,7,494,704,3,1,3,0,1,0,70.17
彰化縣,二水鄉,合和村,597,1,590,9,599,879,3,1,3,0,1,0,68.15
彰化縣,二水鄉,上豐村,598,1,711,10,721,1017,3,1,3,0,1,0,70.89
彰化縣,二水鄉,過圳村,599,1,465,4,469,631,3,1,3,0,1,0,74.33
彰化縣,二水鄉,五伯村,600,1,492,1,493,660,3,1,3,0,1,0,74.70
彰化縣,二水鄉,光化村,601,1,716,10,726,965,3,1,3,0,1,0,75.23
彰化縣,二水鄉,文化村,602,1,730,5,735,1012,3,1,3,0,1,0,72.63
彰化縣,二水鄉,二水村,603,1,612,8,620,877,3,1,3,0,1,0,70.70
彰化縣,二水鄉,聖化村,604,1,371,1,372,513,3,1,3,0,1,0,72.51
彰化縣,二水鄉,裕民村,605,1,592,8,600,910,3,1,3,0,1,0,65.93
彰化縣,二水鄉,惠民村,606,1,606,10,616,862,3,1,3,0,1,0,71.46
彰化縣,二水鄉,大園村,607,1,589,2,591,758,3,1,3,0,1,0,77.97
彰化縣,二水鄉,修仁村,608,1,577,7,584,811,3,1,3,0,1,0,72.01
彰化縣,二水鄉,合興村,609,1,552,4,556,768,3,1,3,0,1,0,72.40
彰化縣,二水鄉,源泉村,610,1,454,6,460,688,3,1,3,0,1,0,66.86
彰化縣,二水鄉,倡和村,611,1,426,5,431,620,3,1,3,0,1,0,69.52
彰化縣,北斗鎮,中寮里,612,1,786,14,800,1133,3,1,3,0,1,0,70.61
彰化縣,北斗鎮,中寮里,613,1,732,17,749,1154,3,1,3,0,1,0,64.90
彰化縣,北斗鎮,大道里,614,1,1192,7,1199,1680,3,1,3,0,1,0,71.37
彰化縣,北斗鎮,西德里,615,1,907,18,925,1311,3,1,3,0,1,0,70.56
彰化縣,北斗鎮,西德里,616,1,774,3,777,1127,3,1,3,0,1,0,68.94
彰化縣,北斗鎮,西德里,617,1,895,25,920,1357,3,1,3,0,1,0,67.80
彰化縣,北斗鎮,西安里,618,1,984,15,999,1555,3,1,3,0,1,0,64.24
彰化縣,北斗鎮,光復里,619,1,915,5,920,1360,3,1,3,0,1,0,67.65
彰化縣,北斗鎮,新政里,620,1,566,5,571,783,3,1,3,0,1,0,72.92
彰化縣,北斗鎮,重慶里,621,1,452,11,463,632,3,1,3,0,1,0,73.26
彰化縣,北斗鎮,五權里,622,1,521,8,529,767,3,1,3,0,1,0,68.97
彰化縣,北斗鎮,七星里,623,1,891,11,902,1395,3,1,3,0,1,0,64.66
彰化縣,北斗鎮,居仁里,624,1,882,14,896,1288,3,1,3,0,1,0,69.57
彰化縣,北斗鎮,東光里,625,1,1094,16,1110,1686,3,1,3,0,1,0,65.84
彰化縣,北斗鎮,文昌里,626,1,668,9,677,978,3,1,3,0,1,0,69.22
彰化縣,北斗鎮,文昌里,627,1,781,6,787,1221,3,1,3,0,1,0,64.46
彰化縣,北斗鎮,中和里,628,1,702,9,711,1033,3,1,3,0,1,0,68.83
彰化縣,北斗鎮,新生里,629,1,1106,25,1131,1653,3,1,3,0,1,0,68.42
彰化縣,北斗鎮,大新里,630,1,915,27,942,1478,3,1,3,0,1,0,63.73
彰化縣,溪州鄉,溪厝村,631,1,481,10,491,771,3,1,3,0,1,0,63.68
彰化縣,溪州鄉,溪厝村,632,1,526,19,545,948,3,1,3,0,1,0,57.49
彰化縣,溪州鄉,坑厝村,633,1,441,13,454,675,3,1,3,0,1,0,67.26
彰化縣,溪州鄉,瓦厝村,634,1,593,12,605,922,3,1,3,0,1,0,65.62
彰化縣,溪州鄉,溪州村,635,1,518,11,529,762,3,1,3,0,1,0,69.42
彰化縣,溪州鄉,溪州村,636,1,529,12,541,825,3,1,3,0,1,0,65.58
彰化縣,溪州鄉,尾厝村,637,1,866,14,880,1314,3,1,3,0,1,0,66.97
彰化縣,溪州鄉,東州村,638,1,548,13,561,818,3,1,3,0,1,0,68.58
彰化縣,溪州鄉,東州村,639,1,594,7,601,900,3,1,3,0,1,0,66.78
彰化縣,溪州鄉,舊眉村,640,1,826,9,835,1246,3,1,3,0,1,0,67.01
彰化縣,溪州鄉,圳寮村,641,1,845,14,859,1417,3,1,3,0,1,0,60.62
彰化縣,溪州鄉,西畔村,642,1,700,11,711,1077,3,1,3,0,1,0,66.02
彰化縣,溪州鄉,西畔村,643,1,567,7,574,920,3,1,3,0,1,0,62.39
彰化縣,溪州鄉,成功村,644,1,574,11,585,937,3,1,3,0,1,0,62.43
彰化縣,溪州鄉,成功村,645,1,539,6,545,864,3,1,3,0,1,0,63.08
彰化縣,溪州鄉,大庄村,646,1,582,3,585,935,3,1,3,0,1,0,62.57
彰化縣,溪州鄉,大庄村,647,1,593,12,605,952,3,1,3,0,1,0,63.55
彰化縣,溪州鄉,榮光村,648,1,495,18,513,793,3,1,3,0,1,0,64.69
彰化縣,溪州鄉,柑園村,649,1,721,14,735,1091,3,1,3,0,1,0,67.37
彰化縣,溪州鄉,潮洋村,650,1,546,2,548,946,3,1,3,0,1,0,57.93
彰化縣,溪州鄉,張厝村,651,1,411,10,421,750,3,1,3,0,1,0,56.13
彰化縣,溪州鄉,菜公村,652,1,578,7,585,865,3,1,3,0,1,0,67.63
彰化縣,溪州鄉,三圳村,653,1,766,14,780,1219,3,1,3,0,1,0,63.99
彰化縣,溪州鄉,三條村,654,1,610,10,620,901,3,1,3,0,1,0,68.81
彰化縣,溪州鄉,水尾村,655,1,695,21,716,1210,3,1,3,0,1,0,59.17
彰化縣,田尾鄉,田尾村,656,1,767,9,776,1208,3,1,3,0,1,0,64.24
彰化縣,田尾鄉,豐田村,657,1,465,6,471,678,3,1,3,0,1,0,69.47
彰化縣,田尾鄉,饒平村,658,1,1308,24,1332,1911,3,1,3,0,1,0,69.70
彰化縣,田尾鄉,北曾村,659,1,753,16,769,1198,3,1,3,0,1,0,64.19
彰化縣,田尾鄉,南曾村,660,1,807,13,820,1159,3,1,3,0,1,0,70.75
彰化縣,田尾鄉,睦宜村,661,1,664,15,679,1005,3,1,3,0,1,0,67.56
彰化縣,田尾鄉,新生村,662,1,819,8,827,1132,3,1,3,0,1,0,73.06
彰化縣,田尾鄉,北鎮村,663,1,637,10,647,959,3,1,3,0,1,0,67.47
彰化縣,田尾鄉,南鎮村,664,1,449,14,463,669,3,1,3,0,1,0,69.21
彰化縣,田尾鄉,福田村,665,1,588,9,597,842,3,1,3,0,1,0,70.90
彰化縣,田尾鄉,新興村,666,1,710,15,725,1004,3,1,3,0,1,0,72.21
彰化縣,田尾鄉,溪畔村,667,1,831,17,848,1211,3,1,3,0,1,0,70.02
彰化縣,田尾鄉,打簾村,668,1,1137,20,1157,1700,3,1,3,0,1,0,68.06
彰化縣,田尾鄉,柳鳳村,669,1,587,5,592,810,3,1,3,0,1,0,73.09
彰化縣,田尾鄉,陸豐村,670,1,593,6,599,845,3,1,3,0,1,0,70.89
彰化縣,田尾鄉,海豐村,671,1,947,21,968,1465,3,1,3,0,1,0,66.08
彰化縣,田尾鄉,仁里村,672,1,1015,15,1030,1504,3,1,3,0,1,0,68.48
彰化縣,田尾鄉,新厝村,673,1,208,6,214,298,3,1,3,0,1,0,71.81
彰化縣,田尾鄉,溪頂村,674,1,400,8,408,608,3,1,3,0,1,0,67.11
彰化縣,田尾鄉,正義村,675,1,493,9,502,696,3,1,3,0,1,0,72.13
彰化縣,埤頭鄉,和豐村,676,1,604,19,623,1001,3,1,3,0,1,0,62.24
彰化縣,埤頭鄉,和豐村,677,1,759,22,781,1216,3,1,3,0,1,0,64.23
彰化縣,埤頭鄉,興農村,678,1,982,26,1008,1493,3,1,3,0,1,0,67.52
彰化縣,埤頭鄉,埤頭村,679,1,992,13,1005,1556,3,1,3,0,1,0,64.59
彰化縣,埤頭鄉,豐崙村,680,1,611,13,624,961,3,1,3,0,1,0,64.93
彰化縣,埤頭鄉,豐崙村,681,1,690,9,699,1124,3,1,3,0,1,0,62.19
彰化縣,埤頭鄉,崙子村,682,1,706,22,728,1119,3,1,3,0,1,0,65.06
彰化縣,埤頭鄉,永豐村,683,1,946,13,959,1431,3,1,3,0,1,0,67.02
彰化縣,埤頭鄉,合興村,684,1,944,14,958,1352,3,1,3,0,1,0,70.86
彰化縣,埤頭鄉,合興村,685,1,1021,28,1049,1565,3,1,3,0,1,0,67.03
彰化縣,埤頭鄉,平原村,686,1,1046,19,1065,1603,3,1,3,0,1,0,66.44
彰化縣,埤頭鄉,崙腳村,687,1,453,10,463,683,3,1,3,0,1,0,67.79
彰化縣,埤頭鄉,元埔村,688,1,382,3,385,594,3,1,3,0,1,0,64.81
彰化縣,埤頭鄉,芙朝村,689,1,1030,25,1055,1649,3,1,3,0,1,0,63.98
彰化縣,埤頭鄉,新庄村,690,1,710,8,718,1159,3,1,3,0,1,0,61.95
彰化縣,埤頭鄉,陸嘉村,691,1,532,17,549,831,3,1,3,0,1,0,66.06
彰化縣,埤頭鄉,竹圍村,692,1,547,15,562,853,3,1,3,0,1,0,65.89
彰化縣,埤頭鄉,中和村,693,1,790,12,802,1293,3,1,3,0,1,0,62.03
彰化縣,埤頭鄉,庄內村,694,1,547,13,560,928,3,1,3,0,1,0,60.34
彰化縣,埤頭鄉,大湖村,695,1,628,9,637,985,3,1,3,0,1,0,64.67
彰化縣,二林鎮,東和里,696,1,619,5,624,865,3,1,3,0,1,0,72.14
彰化縣,二林鎮,東和里,697,1,774,8,782,1201,3,1,3,0,1,0,65.11
彰化縣,二林鎮,南光里,698,1,809,19,828,1204,3,1,3,0,1,0,68.77
彰化縣,二林鎮,南光里,699,1,1028,14,1042,1556,3,1,3,0,1,0,66.97
彰化縣,二林鎮,西平里,700,1,879,13,892,1296,3,1,3,0,1,0,68.83
彰化縣,二林鎮,北平里,701,1,673,10,683,1034,3,1,3,0,1,0,66.05
彰化縣,二林鎮,北平里,702,1,942,29,971,1528,3,1,3,0,1,0,63.55
彰化縣,二林鎮,中西里,703,1,934,18,952,1573,3,1,3,0,1,0,60.52
彰化縣,二林鎮,廣興里,704,1,876,21,897,1453,3,1,3,0,1,0,61.73
彰化縣,二林鎮,香田里,705,1,722,20,742,1181,3,1,3,0,1,0,62.83
彰化縣,二林鎮,外竹里,706,1,709,18,727,1087,3,1,3,0,1,0,66.88
彰化縣,二林鎮,興華里,707,1,686,14,700,1085,3,1,3,0,1,0,64.52
彰化縣,二林鎮,東興里,708,1,778,10,788,1179,3,1,3,0,1,0,66.84
彰化縣,二林鎮,後厝里,709,1,691,13,704,1217,3,1,3,0,1,0,57.85
彰化縣,二林鎮,後厝里,710,1,716,11,727,1103,3,1,3,0,1,0,65.91
彰化縣,二林鎮,豐田里,711,1,428,10,438,710,3,1,3,0,1,0,61.69
彰化縣,二林鎮,豐田里,712,1,893,16,909,1377,3,1,3,0,1,0,66.01
彰化縣,二林鎮,頂厝里,713,1,819,14,833,1363,3,1,3,0,1,0,61.12
彰化縣,二林鎮,趙甲里,714,1,1081,31,1112,1637,3,1,3,0,1,0,67.93
彰化縣,二林鎮,振興里,715,1,812,22,834,1281,3,1,3,0,1,0,65.11
彰化縣,二林鎮,萬興里,716,1,535,12,547,786,3,1,3,0,1,0,69.59
彰化縣,二林鎮,永興里,717,1,960,8,968,1501,3,1,3,0,1,0,64.49
彰化縣,二林鎮,西庄里,718,1,790,9,799,1222,3,1,3,0,1,0,65.38
彰化縣,二林鎮,梅芳里,719,1,689,20,709,1065,3,1,3,0,1,0,66.57
彰化縣,二林鎮,華崙里,720,1,779,11,790,1173,3,1,3,0,1,0,67.35
彰化縣,二林鎮,華崙里,721,1,710,9,719,1109,3,1,3,0,1,0,64.83
彰化縣,二林鎮,華崙里,722,1,749,11,760,1187,3,1,3,0,1,0,64.03
彰化縣,二林鎮,萬合里,723,1,808,17,825,1309,3,1,3,0,1,0,63.03
彰化縣,二林鎮,東勢里,724,1,641,9,650,1002,3,1,3,0,1,0,64.87
彰化縣,二林鎮,大永里,725,1,573,11,584,864,3,1,3,0,1,0,67.59
彰化縣,二林鎮,原斗里,726,1,798,8,806,1206,3,1,3,0,1,0,66.83
彰化縣,二林鎮,西斗里,727,1,663,11,674,1011,3,1,3,0,1,0,66.67
彰化縣,二林鎮,東華里,728,1,673,10,683,1010,3,1,3,0,1,0,67.62
彰化縣,二林鎮,復豐里,729,1,507,7,514,745,3,1,3,0,1,0,68.99
彰化縣,芳苑鄉,芳苑村,730,1,595,12,607,1035,3,1,3,0,1,0,58.65
彰化縣,芳苑鄉,芳中村,731,1,317,7,324,537,3,1,3,0,1,0,60.34
彰化縣,芳苑鄉,仁愛村,732,1,553,14,567,898,3,1,3,0,1,0,63.14
彰化縣,芳苑鄉,信義村,733,1,398,4,402,673,3,1,3,0,1,0,59.73
彰化縣,芳苑鄉,後寮村,734,1,589,14,603,934,3,1,3,0,1,0,64.56
彰化縣,芳苑鄉,三合村,735,1,1161,23,1184,1812,3,1,3,0,1,0,65.34
彰化縣,芳苑鄉,永興村,736,1,875,16,891,1399,3,1,3,0,1,0,63.69
彰化縣,芳苑鄉,新街村,737,1,543,5,548,1062,3,1,3,0,1,0,51.60
彰化縣,芳苑鄉,路上村,738,1,467,8,475,763,3,1,3,0,1,0,62.25
彰化縣,芳苑鄉,路平村,739,1,495,8,503,768,3,1,3,0,1,0,65.49
彰化縣,芳苑鄉,三成村,740,1,644,15,659,1020,3,1,3,0,1,0,64.61
彰化縣,芳苑鄉,福榮村,741,1,392,13,405,679,3,1,3,0,1,0,59.65
彰化縣,芳苑鄉,頂廍村,742,1,382,8,390,645,3,1,3,0,1,0,60.47
彰化縣,芳苑鄉,王功村,743,1,698,12,710,1174,3,1,3,0,1,0,60.48
彰化縣,芳苑鄉,王功村,744,1,555,11,566,891,3,1,3,0,1,0,63.52
彰化縣,芳苑鄉,博愛村,745,1,526,5,531,792,3,1,3,0,1,0,67.05
彰化縣,芳苑鄉,和平村,746,1,519,9,528,809,3,1,3,0,1,0,65.27
彰化縣,芳苑鄉,興仁村,747,1,799,9,808,1369,3,1,3,0,1,0,59.02
彰化縣,芳苑鄉,民生村,748,1,475,9,484,789,3,1,3,0,1,0,61.34
彰化縣,芳苑鄉,新寶村,749,1,931,8,939,1330,3,1,3,0,1,0,70.60
彰化縣,芳苑鄉,五俊村,750,1,309,6,315,578,3,1,3,0,1,0,54.50
彰化縣,芳苑鄉,草湖村,751,1,882,13,895,1420,3,1,3,0,1,0,63.03
彰化縣,芳苑鄉,建平村,752,1,571,12,583,895,3,1,3,0,1,0,65.14
彰化縣,芳苑鄉,建平村,753,1,713,8,721,1134,3,1,3,0,1,0,63.58
彰化縣,芳苑鄉,崙腳村,754,1,514,4,518,728,3,1,3,0,1,0,71.15
彰化縣,芳苑鄉,文津村,755,1,682,16,698,1019,3,1,3,0,1,0,68.50
彰化縣,芳苑鄉,新生村,756,1,824,16,840,1368,3,1,3,0,1,0,61.40
彰化縣,芳苑鄉,漢寶村,757,1,1032,20,1052,1508,3,1,3,0,1,0,69.76
彰化縣,芳苑鄉,漢寶村,758,1,850,12,862,1276,3,1,3,0,1,0,67.55
彰化縣,大城鄉,潭墘村,759,1,832,15,847,1371,3,1,3,0,1,0,61.78
彰化縣,大城鄉,山腳村,760,1,829,18,847,1422,3,1,3,0,1,0,59.56
彰化縣,大城鄉,西城村,761,1,568,11,579,908,3,1,3,0,1,0,63.77
彰化縣,大城鄉,東城村,762,1,827,9,836,1289,3,1,3,0,1,0,64.86
彰化縣,大城鄉,大城村,763,1,666,6,672,1068,3,1,3,0,1,0,62.92
彰化縣,大城鄉,上山村,764,1,370,3,373,647,3,1,3,0,1,0,57.65
彰化縣,大城鄉,上山村,765,1,342,8,350,559,3,1,3,0,1,0,62.61
彰化縣,大城鄉,永和村,766,1,470,6,476,761,3,1,3,0,1,0,62.55
彰化縣,大城鄉,公館村,767,1,284,7,291,469,3,1,3,0,1,0,62.05
彰化縣,大城鄉,公館村,768,1,456,3,459,765,3,1,3,0,1,0,60.00
彰化縣,大城鄉,豐美村,769,1,539,7,546,919,3,1,3,0,1,0,59.41
彰化縣,大城鄉,三豐村,770,1,411,12,423,760,3,1,3,0,1,0,55.66
彰化縣,大城鄉,菜寮村,771,1,765,10,775,1206,3,1,3,0,1,0,64.26
彰化縣,大城鄉,東港村,772,1,821,12,833,1351,3,1,3,0,1,0,61.66
彰化縣,大城鄉,西港村,773,1,663,9,672,1138,3,1,3,0,1,0,59.05
彰化縣,大城鄉,頂庄村,774,1,465,7,472,811,3,1,3,0,1,0,58.20
彰化縣,大城鄉,台西村,775,1,644,8,652,1076,3,1,3,0,1,0,60.59
彰化縣,竹塘鄉,竹元村,776,1,680,5,685,1081,3,1,3,0,1,0,63.37
彰化縣,竹塘鄉,竹塘村,777,1,1082,8,1090,1651,3,1,3,0,1,0,66.02
彰化縣,竹塘鄉,小西村,778,1,529,9,538,831,3,1,3,0,1,0,64.74
彰化縣,竹塘鄉,民靖村,779,1,497,5,502,796,3,1,3,0,1,0,63.07
彰化縣,竹塘鄉,五庄村,780,1,904,15,919,1525,3,1,3,0,1,0,60.26
彰化縣,竹塘鄉,樹腳村,781,1,420,8,428,628,3,1,3,0,1,0,68.15
彰化縣,竹塘鄉,田頭村,782,1,603,8,611,957,3,1,3,0,1,0,63.85
彰化縣,竹塘鄉,新廣村,783,1,769,3,772,1183,3,1,3,0,1,0,65.26
彰化縣,竹塘鄉,溪墘村,784,1,352,7,359,570,3,1,3,0,1,0,62.98
彰化縣,竹塘鄉,竹林村,785,1,546,9,555,888,3,1,3,0,1,0,62.50
彰化縣,竹塘鄉,土庫村,786,1,431,5,436,723,3,1,3,0,1,0,60.30
彰化縣,竹塘鄉,內新村,787,1,377,5,382,669,3,1,3,0,1,0,57.10
彰化縣,竹塘鄉,長安村,788,1,474,6,480,774,3,1,3,0,1,0,62.02
彰化縣,竹塘鄉,永安村,789,1,374,5,379,707,3,1,3,0,1,0,53.61
南投縣,南投市,龍泉里,1,1,635,5,640,949,3,1,3,0,1,0,67.44
南投縣,南投市,康壽里,2,1,924,8,932,1347,3,1,3,0,1,0,69.19
南投縣,南投市,三民里,3,1,535,3,538,704,3,1,3,0,1,0,76.42
南投縣,南投市,仁和里,4,1,412,1,413,527,3,1,3,0,1,0,78.37
南投縣,南投市,南投里,5,1,493,6,499,701,3,1,3,0,1,0,71.18
南投縣,南投市,彰仁里,6,1,326,1,327,437,3,1,3,0,1,0,74.83
南投縣,南投市,崇文里,7,1,751,8,759,1042,3,1,3,0,1,0,72.84
南投縣,南投市,三興里,8,1,771,9,780,1144,3,1,3,0,1,0,68.18
南投縣,南投市,三興里,9,1,1116,12,1128,1643,3,1,3,0,1,0,68.65
南投縣,南投市,三興里,10,1,907,11,918,1371,3,1,3,0,1,0,66.96
南投縣,南投市,三和里,11,1,934,1,935,1305,3,1,3,0,1,0,71.65
南投縣,南投市,三和里,12,1,1063,7,1070,1467,3,1,3,0,1,0,72.94
南投縣,南投市,嘉興里,13,1,1174,8,1182,1712,3,1,3,0,1,0,69.04
南投縣,南投市,嘉和里,14,1,1133,8,1141,1575,3,1,3,0,1,0,72.44
南投縣,南投市,嘉和里,15,1,886,8,894,1282,3,1,3,0,1,0,69.73
南投縣,南投市,平和里,16,1,749,7,756,1137,3,1,3,0,1,0,66.49
南投縣,南投市,平和里,17,1,898,5,903,1288,3,1,3,0,1,0,70.11
南投縣,南投市,平和里,18,1,847,2,849,1224,3,1,3,0,1,0,69.36
南投縣,南投市,平和里,19,1,916,2,918,1312,3,1,3,0,1,0,69.97
南投縣,南投市,振興里,20,1,397,3,400,529,3,1,3,0,1,0,75.61
南投縣,南投市,振興里,21,1,964,3,967,1388,3,1,3,0,1,0,69.67
南投縣,南投市,千秋里,22,1,557,6,563,857,3,1,3,0,1,0,65.69
南投縣,南投市,軍功里,23,1,1167,13,1180,1707,3,1,3,0,1,0,69.13
南投縣,南投市,軍功里,24,1,1085,10,1095,1632,3,1,3,0,1,0,67.10
南投縣,南投市,軍功里,25,1,255,0,255,325,3,1,3,0,1,0,78.46
南投縣,南投市,東山里,26,1,250,3,253,384,3,1,3,0,1,0,65.89
南投縣,南投市,營南里,27,1,741,11,752,1023,3,1,3,0,1,0,73.51
南投縣,南投市,營南里,28,1,644,3,647,866,3,1,3,0,1,0,74.71
南投縣,南投市,營北里,29,1,1105,11,1116,1584,3,1,3,0,1,0,70.45
南投縣,南投市,營北里,30,1,1086,8,1094,1537,3,1,3,0,1,0,71.18
南投縣,南投市,營北里,31,1,1035,2,1037,1449,3,1,3,0,1,0,71.57
南投縣,南投市,內興里,32,1,784,7,791,1074,3,1,3,0,1,0,73.65
南投縣,南投市,內興里,33,1,926,6,932,1388,3,1,3,0,1,0,67.15
南投縣,南投市,內興里,34,1,1198,4,1202,1782,3,1,3,0,1,0,67.45
南投縣,南投市,內興里,35,1,426,5,431,543,3,1,3,0,1,0,79.37
南投縣,南投市,內新里,36,1,941,5,946,1299,3,1,3,0,1,0,72.83
南投縣,南投市,光輝里,37,1,372,5,377,561,3,1,3,0,1,0,67.20
南投縣,南投市,光榮里,38,1,548,5,553,788,3,1,3,0,1,0,70.18
南投縣,南投市,光榮里,39,1,717,3,720,1056,3,1,3,0,1,0,68.18
南投縣,南投市,光明里,40,1,661,4,665,936,3,1,3,0,1,0,71.05
南投縣,南投市,光明里,41,1,722,4,726,1004,3,1,3,0,1,0,72.31
南投縣,南投市,光華里,42,1,471,3,474,688,3,1,3,0,1,0,68.90
南投縣,南投市,光華里,43,1,569,3,572,794,3,1,3,0,1,0,72.04
南投縣,南投市,漳興里,44,1,797,8,805,1089,3,1,3,0,1,0,73.92
南投縣,南投市,漳興里,45,1,863,3,866,1212,3,1,3,0,1,0,71.45
南投縣,南投市,漳和里,46,1,846,6,852,1211,3,1,3,0,1,0,70.36
南投縣,南投市,漳和里,47,1,1118,14,1132,1580,3,1,3,0,1,0,71.65
南投縣,南投市,漳和里,48,1,844,5,849,1182,3,1,3,0,1,0,71.83
南投縣,南投市,漳和里,49,1,1030,7,1037,1489,3,1,3,0,1,0,69.64
南投縣,南投市,平山里,50,1,1048,8,1056,1553,3,1,3,0,1,0,68.00
南投縣,南投市,平山里,51,1,862,4,866,1237,3,1,3,0,1,0,70.01
南投縣,南投市,平山里,52,1,726,9,735,1115,3,1,3,0,1,0,65.92
南投縣,南投市,新興里,53,1,1104,12,1116,1668,3,1,3,0,1,0,66.91
南投縣,南投市,新興里,54,1,1188,11,1199,1720,3,1,3,0,1,0,69.71
南投縣,南投市,永豐里,55,1,831,13,844,1218,3,1,3,0,1,0,69.29
南投縣,南投市,永豐里,56,1,677,4,681,1044,3,1,3,0,1,0,65.23
南投縣,南投市,福興里,57,1,946,11,957,1333,3,1,3,0,1,0,71.79
南投縣,南投市,福興里,58,1,731,8,739,1170,3,1,3,0,1,0,63.16
南投縣,南投市,鳳山里,59,1,741,6,747,1269,3,1,3,0,1,0,58.87
南投縣,南投市,永興里,60,1,525,4,529,752,3,1,3,0,1,0,70.35
南投縣,南投市,鳳鳴里,61,1,510,5,515,763,3,1,3,0,1,0,67.50
南投縣,南投市,福山里,62,1,1078,11,1089,1730,3,1,3,0,1,0,62.95
南投縣,埔里鎮,東門里,63,1,577,5,582,900,3,1,3,0,1,0,64.67
南投縣,埔里鎮,東門里,64,1,714,7,721,1071,3,1,3,0,1,0,67.32
南投縣,埔里鎮,東門里,65,1,608,2,610,909,3,1,3,0,1,0,67.11
南投縣,埔里鎮,西門里,66,1,604,7,611,980,3,1,3,0,1,0,62.35
南投縣,埔里鎮,西門里,67,1,620,2,622,1026,3,1,3,0,1,0,60.62
南投縣,埔里鎮,西門里,68,1,683,3,686,1020,3,1,3,0,1,0,67.25
南投縣,埔里鎮,南門里,69,1,621,8,629,943,3,1,3,0,1,0,66.70
南投縣,埔里鎮,北門里,70,1,762,13,775,1175,3,1,3,0,1,0,65.96
南投縣,埔里鎮,北門里,71,1,701,12,713,1099,3,1,3,0,1,0,64.88
南投縣,埔里鎮,北安里,72,1,1022,6,1028,1563,3,1,3,0,1,0,65.77
南投縣,埔里鎮,北安里,73,1,945,8,953,1424,3,1,3,0,1,0,66.92
南投縣,埔里鎮,泰安里,74,1,656,9,665,961,3,1,3,0,1,0,69.20
南投縣,埔里鎮,泰安里,75,1,594,6,600,917,3,1,3,0,1,0,65.43
南投縣,埔里鎮,北梅里,76,1,620,1,621,991,3,1,3,0,1,0,62.66
南投縣,埔里鎮,北梅里,77,1,712,11,723,1109,3,1,3,0,1,0,65.19
南投縣,埔里鎮,同聲里,78,1,745,17,762,1112,3,1,3,0,1,0,68.53
南投縣,埔里鎮,同聲里,79,1,675,13,688,1057,3,1,3,0,1,0,65.09
南投縣,埔里鎮,清新里,80,1,678,8,686,1050,3,1,3,0,1,0,65.33
南投縣,埔里鎮,清新里,81,1,647,6,653,1001,3,1,3,0,1,0,65.23
南投縣,埔里鎮,清新里,82,1,849,9,858,1392,3,1,3,0,1,0,61.64
南投縣,埔里鎮,薰化里,83,1,863,11,874,1250,3,1,3,0,1,0,69.92
南投縣,埔里鎮,大城里,84,1,862,14,876,1361,3,1,3,0,1,0,64.36
南投縣,埔里鎮,大城里,85,1,937,11,948,1382,3,1,3,0,1,0,68.60
南投縣,埔里鎮,大城里,86,1,783,6,789,1245,3,1,3,0,1,0,63.37
南投縣,埔里鎮,大城里,87,1,971,7,978,1544,3,1,3,0,1,0,63.34
南投縣,埔里鎮,籃城里,88,1,619,6,625,913,3,1,3,0,1,0,68.46
南投縣,埔里鎮,杷城里,89,1,712,10,722,1063,3,1,3,0,1,0,67.92
南投縣,埔里鎮,杷城里,90,1,756,4,760,1147,3,1,3,0,1,0,66.26
南投縣,埔里鎮,枇杷里,91,1,762,7,769,1192,3,1,3,0,1,0,64.51
南投縣,埔里鎮,枇杷里,92,1,443,4,447,676,3,1,3,0,1,0,66.12
南投縣,埔里鎮,枇杷里,93,1,734,18,752,1168,3,1,3,0,1,0,64.38
南投縣,埔里鎮,枇杷里,94,1,840,10,850,1278,3,1,3,0,1,0,66.51
南投縣,埔里鎮,枇杷里,95,1,613,7,620,1008,3,1,3,0,1,0,61.51
南投縣,埔里鎮,水頭里,96,1,1090,18,1108,1820,3,1,3,0,1,0,60.88
南投縣,埔里鎮,水頭里,97,1,756,11,767,1213,3,1,3,0,1,0,63.23
南投縣,埔里鎮,麒麟里,98,1,607,6,613,963,3,1,3,0,1,0,63.66
南投縣,埔里鎮,珠格里,99,1,651,6,657,956,3,1,3,0,1,0,68.72
南投縣,埔里鎮,溪南里,100,1,522,3,525,765,3,1,3,0,1,0,68.63
南投縣,埔里鎮,桃米里,101,1,594,4,598,938,3,1,3,0,1,0,63.75
南投縣,埔里鎮,成功里,102,1,200,2,202,347,3,1,3,0,1,0,58.21
南投縣,埔里鎮,南村里,103,1,815,13,828,1299,3,1,3,0,1,0,63.74
南投縣,埔里鎮,愛蘭里,104,1,820,15,835,1315,3,1,3,0,1,0,63.50
南投縣,埔里鎮,鐵山里,105,1,999,7,1006,1530,3,1,3,0,1,0,65.75
南投縣,埔里鎮,房里里,106,1,567,6,573,865,3,1,3,0,1,0,66.24
南投縣,埔里鎮,房里里,107,1,212,4,216,324,3,1,3,0,1,0,66.67
南投縣,埔里鎮,向善里,108,1,481,4,485,664,3,1,3,0,1,0,73.04
南投縣,埔里鎮,一新里,109,1,889,15,904,1196,3,1,3,0,1,0,75.59
南投縣,埔里鎮,合成里,110,1,904,5,909,1274,3,1,3,0,1,0,71.35
南投縣,埔里鎮,合成里,111,1,157,1,158,262,3,1,3,0,1,0,60.31
南投縣,埔里鎮,廣成里,112,1,673,9,682,1140,3,1,3,0,1,0,59.82
南投縣,埔里鎮,史港里,113,1,382,2,384,633,3,1,3,0,1,0,60.66
南投縣,埔里鎮,福興里,114,1,603,9,612,981,3,1,3,0,1,0,62.39
南投縣,埔里鎮,牛眠里,115,1,699,8,707,1073,3,1,3,0,1,0,65.89
南投縣,埔里鎮,牛眠里,116,1,905,10,915,1298,3,1,3,0,1,0,70.49
南投縣,埔里鎮,大湳里,117,1,805,8,813,1187,3,1,3,0,1,0,68.49
南投縣,埔里鎮,蜈蚣里,118,1,636,7,643,1007,3,1,3,0,1,0,63.85
南投縣,埔里鎮,蜈蚣里,119,1,594,10,604,877,3,1,3,0,1,0,68.87
南投縣,埔里鎮,蜈蚣里,120,1,389,5,394,568,3,1,3,0,1,0,69.37
南投縣,草屯鎮,玉峰里,121,1,594,7,601,850,3,1,3,0,1,0,70.71
南投縣,草屯鎮,玉峰里,122,1,723,9,732,1028,3,1,3,0,1,0,71.21
南投縣,草屯鎮,明正里,123,1,1149,8,1157,1625,3,1,3,0,1,0,71.20
南投縣,草屯鎮,明正里,124,1,1140,4,1144,1693,3,1,3,0,1,0,67.57
南投縣,草屯鎮,炎峰里,125,1,689,4,693,942,3,1,3,0,1,0,73.57
南投縣,草屯鎮,炎峰里,126,1,783,7,790,1106,3,1,3,0,1,0,71.43
南投縣,草屯鎮,中正里,127,1,541,8,549,726,3,1,3,0,1,0,75.62
南投縣,草屯鎮,和平里,128,1,919,7,926,1262,3,1,3,0,1,0,73.38
南投縣,草屯鎮,中山里,129,1,654,4,658,962,3,1,3,0,1,0,68.40
南投縣,草屯鎮,中山里,130,1,879,10,889,1271,3,1,3,0,1,0,69.94
南投縣,草屯鎮,敦和里,131,1,814,8,822,1167,3,1,3,0,1,0,70.44
南投縣,草屯鎮,敦和里,132,1,887,12,899,1297,3,1,3,0,1,0,69.31
南投縣,草屯鎮,敦和里,133,1,881,10,891,1282,3,1,3,0,1,0,69.50
南投縣,草屯鎮,敦和里,134,1,1003,7,1010,1443,3,1,3,0,1,0,69.99
南投縣,草屯鎮,山腳里,135,1,1073,8,1081,1553,3,1,3,0,1,0,69.61
南投縣,草屯鎮,山腳里,136,1,1069,12,1081,1526,3,1,3,0,1,0,70.84
南投縣,草屯鎮,山腳里,137,1,870,5,875,1236,3,1,3,0,1,0,70.79
南投縣,草屯鎮,山腳里,138,1,1077,5,1082,1499,3,1,3,0,1,0,72.18
南投縣,草屯鎮,新厝里,139,1,939,10,949,1320,3,1,3,0,1,0,71.89
南投縣,草屯鎮,新厝里,140,1,960,10,970,1374,3,1,3,0,1,0,70.60
南投縣,草屯鎮,上林里,141,1,1005,13,1018,1376,3,1,3,0,1,0,73.98
南投縣,草屯鎮,上林里,142,1,648,7,655,924,3,1,3,0,1,0,70.89
南投縣,草屯鎮,碧峰里,143,1,741,7,748,1082,3,1,3,0,1,0,69.13
南投縣,草屯鎮,碧峰里,144,1,783,6,789,1151,3,1,3,0,1,0,68.55
南投縣,草屯鎮,碧峰里,145,1,647,5,652,1025,3,1,3,0,1,0,63.61
南投縣,草屯鎮,碧洲里,146,1,753,4,757,992,3,1,3,0,1,0,76.31
南投縣,草屯鎮,碧洲里,147,1,440,5,445,628,3,1,3,0,1,0,70.86
南投縣,草屯鎮,復興里,148,1,872,16,888,1259,3,1,3,0,1,0,70.53
南投縣,草屯鎮,復興里,149,1,973,11,984,1437,3,1,3,0,1,0,68.48
南投縣,草屯鎮,御史里,150,1,981,8,989,1395,3,1,3,0,1,0,70.90
南投縣,草屯鎮,御史里,151,1,1009,11,1020,1539,3,1,3,0,1,0,66.28
南投縣,草屯鎮,御史里,152,1,516,5,521,822,3,1,3,0,1,0,63.38
南投縣,草屯鎮,御史里,153,1,804,8,812,1195,3,1,3,0,1,0,67.95
南投縣,草屯鎮,新豐里,154,1,1043,9,1052,1491,3,1,3,0,1,0,70.56
南投縣,草屯鎮,新豐里,155,1,1271,15,1286,1800,3,1,3,0,1,0,71.44
南投縣,草屯鎮,新庄里,156,1,1003,10,1013,1416,3,1,3,0,1,0,71.54
南投縣,草屯鎮,新庄里,157,1,953,12,965,1378,3,1,3,0,1,0,70.03
南投縣,草屯鎮,加老里,158,1,508,6,514,688,3,1,3,0,1,0,74.71
南投縣,草屯鎮,加老里,159,1,912,9,921,1228,3,1,3,0,1,0,75.00
南投縣,草屯鎮,石川里,160,1,859,4,863,1203,3,1,3,0,1,0,71.74
南投縣,草屯鎮,北投里,161,1,838,4,842,1134,3,1,3,0,1,0,74.25
南投縣,草屯鎮,北投里,162,1,808,8,816,1188,3,1,3,0,1,0,68.69
南投縣,草屯鎮,富寮里,163,1,1022,11,1033,1427,3,1,3,0,1,0,72.39
南投縣,草屯鎮,富寮里,164,1,926,11,937,1404,3,1,3,0,1,0,66.74
南投縣,草屯鎮,富寮里,165,1,632,7,639,939,3,1,3,0,1,0,68.05
南投縣,草屯鎮,富寮里,166,1,330,3,333,502,3,1,3,0,1,0,66.33
南投縣,草屯鎮,北勢里,167,1,946,17,963,1380,3,1,3,0,1,0,69.78
南投縣,草屯鎮,北勢里,168,1,313,1,314,460,3,1,3,0,1,0,68.26
南投縣,草屯鎮,中原里,169,1,700,10,710,984,3,1,3,0,1,0,72.15
南投縣,草屯鎮,中原里,170,1,561,5,566,780,3,1,3,0,1,0,72.56
南投縣,草屯鎮,南埔里,171,1,933,10,943,1349,3,1,3,0,1,0,69.90
南投縣,草屯鎮,南埔里,172,1,688,8,696,984,3,1,3,0,1,0,70.73
南投縣,草屯鎮,南埔里,173,1,620,6,626,859,3,1,3,0,1,0,72.88
南投縣,草屯鎮,坪頂里,174,1,684,4,688,943,3,1,3,0,1,0,72.96
南投縣,草屯鎮,土城里,175,1,416,5,421,630,3,1,3,0,1,0,66.83
南投縣,草屯鎮,土城里,176,1,636,10,646,1009,3,1,3,0,1,0,64.02
南投縣,草屯鎮,平林里,177,1,717,4,721,994,3,1,3,0,1,0,72.54
南投縣,草屯鎮,雙冬里,178,1,762,8,770,1144,3,1,3,0,1,0,67.31
南投縣,草屯鎮,雙冬里,179,1,782,3,785,1160,3,1,3,0,1,0,67.67
南投縣,竹山鎮,竹山里,180,1,818,6,824,1215,3,1,3,0,1,0,67.82
南投縣,竹山鎮,竹山里,181,1,615,4,619,906,3,1,3,0,1,0,68.32
南投縣,竹山鎮,中正里,182,1,527,7,534,745,3,1,3,0,1,0,71.68
南投縣,竹山鎮,中山里,183,1,728,6,734,1070,3,1,3,0,1,0,68.60
南投縣,竹山鎮,中山里,184,1,997,8,1005,1477,3,1,3,0,1,0,68.04
南投縣,竹山鎮,中山里,185,1,1159,13,1172,1744,3,1,3,0,1,0,67.20
南投縣,竹山鎮,雲林里,186,1,926,9,935,1395,3,1,3,0,1,0,67.03
南投縣,竹山鎮,雲林里,187,1,1180,9,1189,1778,3,1,3,0,1,0,66.87
南投縣,竹山鎮,竹圍里,188,1,484,7,491,703,3,1,3,0,1,0,69.84
南投縣,竹山鎮,竹圍里,189,1,896,17,913,1489,3,1,3,0,1,0,61.32
南投縣,竹山鎮,桂林里,190,1,1130,9,1139,1705,3,1,3,0,1,0,66.80
南投縣,竹山鎮,桂林里,191,1,1036,8,1044,1572,3,1,3,0,1,0,66.41
南投縣,竹山鎮,下坪里,192,1,367,2,369,513,3,1,3,0,1,0,71.93
南投縣,竹山鎮,下坪里,193,1,336,5,341,542,3,1,3,0,1,0,62.92
南投縣,竹山鎮,中和里,194,1,729,10,739,1028,3,1,3,0,1,0,71.89
南投縣,竹山鎮,中崎里,195,1,803,8,811,1274,3,1,3,0,1,0,63.66
南投縣,竹山鎮,秀林里,196,1,171,0,171,257,3,1,3,0,1,0,66.54
南投縣,竹山鎮,秀林里,197,1,340,4,344,511,3,1,3,0,1,0,67.32
南投縣,竹山鎮,大鞍里,198,1,277,4,281,368,3,1,3,0,1,0,76.36
南投縣,竹山鎮,延和里,199,1,882,4,886,1385,3,1,3,0,1,0,63.97
南投縣,竹山鎮,延和里,200,1,883,9,892,1406,3,1,3,0,1,0,63.44
南投縣,竹山鎮,延和里,201,1,799,2,801,1223,3,1,3,0,1,0,65.49
南投縣,竹山鎮,延祥里,202,1,1140,14,1154,1714,3,1,3,0,1,0,67.33
南投縣,竹山鎮,延祥里,203,1,894,6,900,1466,3,1,3,0,1,0,61.39
南投縣,竹山鎮,延正里,204,1,451,10,461,678,3,1,3,0,1,0,67.99
南投縣,竹山鎮,延正里,205,1,634,10,644,963,3,1,3,0,1,0,66.87
南投縣,竹山鎮,延平里,206,1,703,18,721,1206,3,1,3,0,1,0,59.78
南投縣,竹山鎮,延平里,207,1,621,3,624,908,3,1,3,0,1,0,68.72
南投縣,竹山鎮,延平里,208,1,404,5,409,576,3,1,3,0,1,0,71.01
南投縣,竹山鎮,延山里,209,1,389,5,394,666,3,1,3,0,1,0,59.16
南投縣,竹山鎮,山崇里,210,1,740,10,750,1211,3,1,3,0,1,0,61.93
南投縣,竹山鎮,山崇里,211,1,424,4,428,662,3,1,3,0,1,0,64.65
南投縣,竹山鎮,社寮里,212,1,648,2,650,916,3,1,3,0,1,0,70.96
南投縣,竹山鎮,中央里,213,1,946,10,956,1377,3,1,3,0,1,0,69.43
南投縣,竹山鎮,富州里,214,1,434,11,445,705,3,1,3,0,1,0,63.12
南投縣,竹山鎮,田子里,215,1,290,5,295,436,3,1,3,0,1,0,67.66
南投縣,竹山鎮,田子里,216,1,119,1,120,198,3,1,3,0,1,0,60.61
南投縣,竹山鎮,硘磘里,217,1,914,5,919,1366,3,1,3,0,1,0,67.28
南投縣,竹山鎮,德興里,218,1,269,6,275,412,3,1,3,0,1,0,66.75
南投縣,竹山鎮,德興里,219,1,365,4,369,511,3,1,3,0,1,0,72.21
南投縣,竹山鎮,福興里,220,1,118,1,119,206,3,1,3,0,1,0,57.77
南投縣,竹山鎮,福興里,221,1,258,5,263,359,3,1,3,0,1,0,73.26
南投縣,竹山鎮,鯉魚里,222,1,335,6,341,543,3,1,3,0,1,0,62.80
南投縣,竹山鎮,鯉魚里,223,1,218,4,222,348,3,1,3,0,1,0,63.79
南投縣,竹山鎮,坪頂里,224,1,345,4,349,571,3,1,3,0,1,0,61.12
南投縣,竹山鎮,瑞竹里,225,1,487,7,494,769,3,1,3,0,1,0,64.24
南投縣,竹山鎮,桶頭里,226,1,352,4,356,618,3,1,3,0,1,0,57.61
南投縣,竹山鎮,桶頭里,227,1,298,5,303,463,3,1,3,0,1,0,65.44
南投縣,集集鎮,集集里,228,1,628,8,636,890,3,1,3,0,1,0,71.46
南投縣,集集鎮,和平里,229,1,637,10,647,950,3,1,3,0,1,0,68.11
南投縣,集集鎮,林尾里,230,1,376,2,378,556,3,1,3,0,1,0,67.99
南投縣,集集鎮,田寮里,231,1,732,10,742,1121,3,1,3,0,1,0,66.19
南投縣,集集鎮,隘寮里,232,1,389,5,394,554,3,1,3,0,1,0,71.12
南投縣,集集鎮,玉映里,233,1,330,5,335,464,3,1,3,0,1,0,72.20
南投縣,集集鎮,吳厝里,234,1,627,8,635,896,3,1,3,0,1,0,70.87
南投縣,集集鎮,八張里,235,1,902,13,915,1357,3,1,3,0,1,0,67.43
南投縣,集集鎮,永昌里,236,1,646,10,656,915,3,1,3,0,1,0,71.69
南投縣,集集鎮,廣明里,237,1,424,1,425,624,3,1,3,0,1,0,68.11
南投縣,集集鎮,廣明里,238,1,257,1,258,393,3,1,3,0,1,0,65.65
南投縣,集集鎮,富山里,239,1,252,3,255,409,3,1,3,0,1,0,62.35
南投縣,名間鄉,南雅村,240,1,706,3,709,1012,3,1,3,0,1,0,70.06
南投縣,名間鄉,中正村,241,1,807,8,815,1259,3,1,3,0,1,0,64.73
南投縣,名間鄉,中正村,242,1,1075,11,1086,1604,3,1,3,0,1,0,67.71
南投縣,名間鄉,中山村,243,1,443,7,450,736,3,1,3,0,1,0,61.14
南投縣,名間鄉,中山村,244,1,829,14,843,1217,3,1,3,0,1,0,69.27
南投縣,名間鄉,濁水村,245,1,1029,14,1043,1550,3,1,3,0,1,0,67.29
南投縣,名間鄉,新民村,246,1,714,10,724,1031,3,1,3,0,1,0,70.22
南投縣,名間鄉,炭寮村,247,1,640,13,653,1002,3,1,3,0,1,0,65.17
南投縣,名間鄉,新街村,248,1,1134,15,1149,1556,3,1,3,0,1,0,73.84
南投縣,名間鄉,新街村,249,1,618,6,624,917,3,1,3,0,1,0,68.05
南投縣,名間鄉,新街村,250,1,616,2,618,959,3,1,3,0,1,0,64.44
南投縣,名間鄉,東湖村,251,1,515,3,518,778,3,1,3,0,1,0,66.58
南投縣,名間鄉,東湖村,252,1,526,5,531,847,3,1,3,0,1,0,62.69
南投縣,名間鄉,仁和村,253,1,584,6,590,848,3,1,3,0,1,0,69.58
南投縣,名間鄉,萬丹村,254,1,731,8,739,989,3,1,3,0,1,0,74.72
南投縣,名間鄉,田仔.大庄.部下.大坑村,255,1,688,8,696,1022,3,1,3,0,1,0,68.10
南投縣,名間鄉,田仔.大庄.部下.大坑村,256,1,556,4,560,850,3,1,3,0,1,0,65.88
南投縣,名間鄉,田仔.大庄.部下.大坑村,257,1,676,11,687,1024,3,1,3,0,1,0,67.09
南投縣,名間鄉,田仔.大庄.部下.大坑村,258,1,628,9,637,918,3,1,3,0,1,0,69.39
南投縣,名間鄉,田仔.大庄.部下.大坑村,259,1,484,0,484,746,3,1,3,0,1,0,64.88
南投縣,名間鄉,赤水村,260,1,469,9,478,686,3,1,3,0,1,0,69.68
南投縣,名間鄉,赤水村,261,1,371,5,376,569,3,1,3,0,1,0,66.08
南投縣,名間鄉,竹圍村,262,1,622,8,630,918,3,1,3,0,1,0,68.63
南投縣,名間鄉,三崙村,263,1,663,10,673,1011,3,1,3,0,1,0,66.57
南投縣,名間鄉,三崙村,264,1,270,2,272,444,3,1,3,0,1,0,61.26
南投縣,名間鄉,松山村,265,1,889,11,900,1410,3,1,3,0,1,0,63.83
南投縣,名間鄉,松柏村,266,1,717,8,725,1093,3,1,3,0,1,0,66.33
南投縣,名間鄉,崁腳村,267,1,559,5,564,799,3,1,3,0,1,0,70.59
南投縣,名間鄉,埔中村,268,1,551,11,562,849,3,1,3,0,1,0,66.20
南投縣,名間鄉,新厝村,269,1,533,6,539,819,3,1,3,0,1,0,65.81
南投縣,名間鄉,新光村,270,1,473,6,479,735,3,1,3,0,1,0,65.17
南投縣,名間鄉,新光村,271,1,546,5,551,848,3,1,3,0,1,0,64.98
南投縣,鹿谷鄉,初鄉村,272,1,950,15,965,1553,3,1,3,0,1,0,62.14
南投縣,鹿谷鄉,鹿谷村,273,1,1094,10,1104,1648,3,1,3,0,1,0,66.99
南投縣,鹿谷鄉,彰雅村,274,1,508,6,514,722,3,1,3,0,1,0,71.19
南投縣,鹿谷鄉,彰雅村,275,1,262,4,266,403,3,1,3,0,1,0,66.00
南投縣,鹿谷鄉,廣興村,276,1,548,4,552,798,3,1,3,0,1,0,69.17
南投縣,鹿谷鄉,廣興村,277,1,733,3,736,1052,3,1,3,0,1,0,69.96
南投縣,鹿谷鄉,內湖村,278,1,364,5,369,573,3,1,3,0,1,0,64.40
南投縣,鹿谷鄉,內湖村,279,1,308,4,312,446,3,1,3,0,1,0,69.96
南投縣,鹿谷鄉,和雅村,280,1,405,6,411,623,3,1,3,0,1,0,65.97
南投縣,鹿谷鄉,竹林村,281,1,928,9,937,1522,3,1,3,0,1,0,61.56
南投縣,鹿谷鄉,竹豐村,282,1,557,1,558,882,3,1,3,0,1,0,63.27
南投縣,鹿谷鄉,鳳凰村,283,1,913,9,922,1325,3,1,3,0,1,0,69.58
南投縣,鹿谷鄉,永隆村,284,1,883,9,892,1276,3,1,3,0,1,0,69.91
南投縣,鹿谷鄉,秀峰村,285,1,251,3,254,443,3,1,3,0,1,0,57.34
南投縣,鹿谷鄉,秀峰村,286,1,358,5,363,642,3,1,3,0,1,0,56.54
南投縣,鹿谷鄉,清水村,287,1,438,3,441,751,3,1,3,0,1,0,58.72
南投縣,鹿谷鄉,瑞田村,288,1,470,10,480,802,3,1,3,0,1,0,59.85
南投縣,中寮鄉,廣興村,289,1,543,7,550,856,3,1,3,0,1,0,64.25
南投縣,中寮鄉,崁頂村,290,1,195,3,198,277,3,1,3,0,1,0,71.48
南投縣,中寮鄉,崁頂村,291,1,157,2,159,236,3,1,3,0,1,0,67.37
南投縣,中寮鄉,八仙村,292,1,259,2,261,378,3,1,3,0,1,0,69.05
南投縣,中寮鄉,八仙村,293,1,243,3,246,378,3,1,3,0,1,0,65.08
南投縣,中寮鄉,福盛村,294,1,288,2,290,444,3,1,3,0,1,0,65.32
南投縣,中寮鄉,福盛村,295,1,200,2,202,368,3,1,3,0,1,0,54.89
南投縣,中寮鄉,和興村,296,1,400,3,403,691,3,1,3,0,1,0,58.32
南投縣,中寮鄉,復興村,297,1,717,6,723,1007,3,1,3,0,1,0,71.80
南投縣,中寮鄉,永平村,298,1,571,5,576,798,3,1,3,0,1,0,72.18
南投縣,中寮鄉,永平村,299,1,167,0,167,271,3,1,3,0,1,0,61.62
南投縣,中寮鄉,中寮村,300,1,465,8,473,698,3,1,3,0,1,0,67.77
南投縣,中寮鄉,廣福村,301,1,332,6,338,542,3,1,3,0,1,0,62.36
南投縣,中寮鄉,永福村,302,1,257,1,258,377,3,1,3,0,1,0,68.44
南投縣,中寮鄉,永福村,303,1,477,6,483,713,3,1,3,0,1,0,67.74
南投縣,中寮鄉,義和村,304,1,328,1,329,470,3,1,3,0,1,0,70.00
南投縣,中寮鄉,義和村,305,1,459,5,464,643,3,1,3,0,1,0,72.16
南投縣,中寮鄉,清水村,306,1,599,12,611,993,3,1,3,0,1,0,61.53
南投縣,中寮鄉,內城村,307,1,309,3,312,463,3,1,3,0,1,0,67.39
南投縣,中寮鄉,龍安村,308,1,466,7,473,703,3,1,3,0,1,0,67.28
南投縣,中寮鄉,爽文村,309,1,377,6,383,590,3,1,3,0,1,0,64.92
南投縣,中寮鄉,龍岩村,310,1,416,7,423,676,3,1,3,0,1,0,62.57
南投縣,中寮鄉,永芳村,311,1,289,4,293,435,3,1,3,0,1,0,67.36
南投縣,中寮鄉,永和村,312,1,358,6,364,553,3,1,3,0,1,0,65.82
南投縣,魚池鄉,魚池村,313,1,1135,8,1143,1842,3,1,3,0,1,0,62.05
南投縣,魚池鄉,東池村,314,1,933,7,940,1525,3,1,3,0,1,0,61.64
南投縣,魚池鄉,大林村,315,1,307,0,307,496,3,1,3,0,1,0,61.90
南投縣,魚池鄉,大林村,316,1,336,1,337,541,3,1,3,0,1,0,62.29
南投縣,魚池鄉,東光村,317,1,728,8,736,1183,3,1,3,0,1,0,62.21
南投縣,魚池鄉,共和村,318,1,134,8,142,218,3,1,3,0,1,0,65.14
南投縣,魚池鄉,共和村,319,1,342,4,346,517,3,1,3,0,1,0,66.92
南投縣,魚池鄉,共和村,320,1,132,1,133,220,3,1,3,0,1,0,60.45
南投縣,魚池鄉,新城村,321,1,504,8,512,731,3,1,3,0,1,0,70.04
南投縣,魚池鄉,新城村,322,1,187,2,189,287,3,1,3,0,1,0,65.85
南投縣,魚池鄉,新城村,323,1,193,0,193,300,3,1,3,0,1,0,64.33
南投縣,魚池鄉,大雁村,324,1,177,0,177,277,3,1,3,0,1,0,63.90
南投縣,魚池鄉,大雁村,325,1,245,1,246,379,3,1,3,0,1,0,64.91
南投縣,魚池鄉,五城村,326,1,364,2,366,550,3,1,3,0,1,0,66.55
南投縣,魚池鄉,五城村,327,1,109,3,112,157,3,1,3,0,1,0,71.34
南投縣,魚池鄉,中明村,328,1,386,2,388,606,3,1,3,0,1,0,64.03
南投縣,魚池鄉,中明村,329,1,236,4,240,371,3,1,3,0,1,0,64.69
南投縣,魚池鄉,水社村,330,1,489,7,496,771,3,1,3,0,1,0,64.33
南投縣,魚池鄉,日月村,331,1,326,3,329,539,3,1,3,0,1,0,61.04
南投縣,魚池鄉,頭社村,332,1,252,4,256,442,3,1,3,0,1,0,57.92
南投縣,魚池鄉,頭社村,333,1,337,1,338,550,3,1,3,0,1,0,61.45
南投縣,魚池鄉,武登村,334,1,255,2,257,465,3,1,3,0,1,0,55.27
南投縣,魚池鄉,武登村,335,1,191,5,196,325,3,1,3,0,1,0,60.31
南投縣,國姓鄉,國姓村,336,1,1073,16,1089,1668,3,1,3,0,1,0,65.29
南投縣,國姓鄉,石門村,337,1,1027,10,1037,1641,3,1,3,0,1,0,63.19
南投縣,國姓鄉,大旗村,338,1,492,5,497,765,3,1,3,0,1,0,64.97
南投縣,國姓鄉,長流村,339,1,908,9,917,1540,3,1,3,0,1,0,59.55
南投縣,國姓鄉,長福村,340,1,427,8,435,717,3,1,3,0,1,0,60.67
南投縣,國姓鄉,長豐村,341,1,492,5,497,860,3,1,3,0,1,0,57.79
南投縣,國姓鄉,北港村,342,1,665,6,671,1124,3,1,3,0,1,0,59.70
南投縣,國姓鄉,北港村,343,1,554,3,557,928,3,1,3,0,1,0,60.02
南投縣,國姓鄉,福龜村,344,1,601,10,611,888,3,1,3,0,1,0,68.81
南投縣,國姓鄉,福龜村,345,1,673,6,679,952,3,1,3,0,1,0,71.32
南投縣,國姓鄉,乾溝村,346,1,582,3,585,881,3,1,3,0,1,0,66.40
南投縣,國姓鄉,柑林村,347,1,812,4,816,1205,3,1,3,0,1,0,67.72
南投縣,國姓鄉,大石村,348,1,465,3,468,757,3,1,3,0,1,0,61.82
南投縣,國姓鄉,北山村,349,1,732,5,737,1143,3,1,3,0,1,0,64.48
南投縣,國姓鄉,北山村,350,1,302,9,311,497,3,1,3,0,1,0,62.58
南投縣,國姓鄉,南港村,351,1,800,15,815,1387,3,1,3,0,1,0,58.76
南投縣,國姓鄉,南港村,352,1,351,4,355,529,3,1,3,0,1,0,67.11
南投縣,水里鄉,水里村,353,1,536,10,546,893,3,1,3,0,1,0,61.14
南投縣,水里鄉,新城村,354,1,359,2,361,586,3,1,3,0,1,0,61.60
南投縣,水里鄉,新城村,355,1,672,13,685,1095,3,1,3,0,1,0,62.56
南投縣,水里鄉,中央村,356,1,478,6,484,718,3,1,3,0,1,0,67.41
南投縣,水里鄉,城中村,357,1,721,6,727,1069,3,1,3,0,1,0,68.01
南投縣,水里鄉,農富村,358,1,379,9,388,553,3,1,3,0,1,0,70.16
南投縣,水里鄉,北埔村,359,1,653,5,658,986,3,1,3,0,1,0,66.73
南投縣,水里鄉,南光村,360,1,844,4,848,1288,3,1,3,0,1,0,65.84
南投縣,水里鄉,鉅工村,361,1,755,7,762,1062,3,1,3,0,1,0,71.75
南投縣,水里鄉,永豐村,362,1,916,12,928,1382,3,1,3,0,1,0,67.15
南投縣,水里鄉,民和村,363,1,638,6,644,1044,3,1,3,0,1,0,61.69
南投縣,水里鄉,頂崁村,364,1,714,10,724,1111,3,1,3,0,1,0,65.17
南投縣,水里鄉,新山村,365,1,226,4,230,371,3,1,3,0,1,0,61.99
南投縣,水里鄉,郡坑村,366,1,249,2,251,392,3,1,3,0,1,0,64.03
南投縣,水里鄉,上安村,367,1,733,8,741,1183,3,1,3,0,1,0,62.64
南投縣,水里鄉,興隆村,368,1,206,0,206,357,3,1,3,0,1,0,57.70
南投縣,水里鄉,永興村,369,1,254,1,255,387,3,1,3,0,1,0,65.89
南投縣,水里鄉,玉峰村,370,1,665,6,671,914,3,1,3,0,1,0,73.41
南投縣,水里鄉,車埕村,371,1,356,5,361,558,3,1,3,0,1,0,64.70
南投縣,水里鄉,新興村,372,1,446,8,454,691,3,1,3,0,1,0,65.70
南投縣,信義鄉,明德村,373,1,503,5,508,728,3,1,3,0,1,0,69.78
南投縣,信義鄉,明德村,374,1,246,0,246,388,3,1,3,0,1,0,63.40
南投縣,信義鄉,愛國村,375,1,374,2,376,527,3,1,3,0,1,0,71.35
南投縣,信義鄉,自強村,376,1,297,5,302,411,3,1,3,0,1,0,73.48
南投縣,信義鄉,自強村,377,1,213,2,215,320,3,1,3,0,1,0,67.19
南投縣,信義鄉,豐丘村,378,1,224,2,226,329,3,1,3,0,1,0,68.69
南投縣,信義鄉,新鄉村,379,1,47,0,47,74,3,1,3,0,1,0,63.51
南投縣,信義鄉,羅娜村,380,1,142,3,145,241,3,1,3,0,1,0,60.17
南投縣,信義鄉,望美村,381,1,19,0,19,36,3,1,3,0,1,0,52.78
南投縣,信義鄉,望美村,382,1,170,0,170,260,3,1,3,0,1,0,65.38
南投縣,信義鄉,東埔村,383,1,173,3,176,260,3,1,3,0,1,0,67.69
南投縣,信義鄉,神木村,384,1,283,1,284,474,3,1,3,0,1,0,59.92
南投縣,信義鄉,神木村,385,1,167,3,170,276,3,1,3,0,1,0,61.59
南投縣,信義鄉,同富村,386,1,604,4,608,891,3,1,3,0,1,0,68.24
南投縣,信義鄉,同富村,387,1,293,1,294,443,3,1,3,0,1,0,66.37
南投縣,信義鄉,人和村,388,1,36,0,36,65,3,1,3,0,1,0,55.38
南投縣,信義鄉,人和村,389,1,90,0,90,165,3,1,3,0,1,0,54.55
南投縣,信義鄉,雙龍村,390,1,8,0,8,12,3,1,3,0,1,0,66.67
南投縣,信義鄉,地利村,391,1,61,0,61,94,3,1,3,0,1,0,64.89
南投縣,信義鄉,潭南村,392,1,28,0,28,48,3,1,3,0,1,0,58.33
南投縣,仁愛鄉,南豐村,393,1,140,1,141,226,3,1,3,0,1,0,62.39
南投縣,仁愛鄉,南豐村,394,1,184,4,188,307,3,1,3,0,1,0,61.24
南投縣,仁愛鄉,大同村,395,1,315,2,317,516,3,1,3,0,1,0,61.43
南投縣,仁愛鄉,大同村,396,1,194,11,205,307,3,1,3,0,1,0,66.78
南投縣,仁愛鄉,大同村,397,1,144,1,145,214,3,1,3,0,1,0,67.76
南投縣,仁愛鄉,榮興村,398,1,53,2,55,85,3,1,3,0,1,0,64.71
南投縣,仁愛鄉,春陽村,399,1,34,1,35,63,3,1,3,0,1,0,55.56
南投縣,仁愛鄉,精英村,400,1,60,1,61,126,3,1,3,0,1,0,48.41
南投縣,仁愛鄉,精英村,401,1,11,0,11,21,3,1,3,0,1,0,52.38
南投縣,仁愛鄉,合作村,402,1,13,1,14,24,3,1,3,0,1,0,58.33
南投縣,仁愛鄉,力行村,403,1,10,0,10,20,3,1,3,0,1,0,50.00
南投縣,仁愛鄉,翠華村,404,1,9,1,10,24,3,1,3,0,1,0,41.67
南投縣,仁愛鄉,翠華村,405,1,97,6,103,230,3,1,3,0,1,0,44.78
南投縣,仁愛鄉,發祥村,406,1,11,0,11,18,3,1,3,0,1,0,61.11
南投縣,仁愛鄉,發祥村,407,1,5,0,5,13,3,1,3,0,1,0,38.46
南投縣,仁愛鄉,發祥村,408,1,16,1,17,33,3,1,3,0,1,0,51.52
南投縣,仁愛鄉,親愛村,409,1,16,0,16,35,3,1,3,0,1,0,45.71
南投縣,仁愛鄉,親愛村,410,1,7,0,7,10,3,1,3,0,1,0,70.00
南投縣,仁愛鄉,親愛村,411,1,23,0,23,45,3,1,3,0,1,0,51.11
南投縣,仁愛鄉,萬豐村,412,1,25,0,25,50,3,1,3,0,1,0,50.00
南投縣,仁愛鄉,法治村,413,1,9,1,10,26,3,1,3,0,1,0,38.46
南投縣,仁愛鄉,中正村,414,1,44,0,44,83,3,1,3,0,1,0,53.01
南投縣,仁愛鄉,互助村,415,1,48,0,48,93,3,1,3,0,1,0,51.61
南投縣,仁愛鄉,互助村,416,1,20,1,21,32,3,1,3,0,1,0,65.63
南投縣,仁愛鄉,新生村,417,1,38,0,38,56,3,1,3,0,1,0,67.86
雲林縣,斗六市,信義里,1,1,654,6,660,952,3,1,3,0,1,0,69.33
雲林縣,斗六市,四維里,2,1,505,9,514,727,3,1,3,0,1,0,70.70
雲林縣,斗六市,太平里,3,1,527,5,532,762,3,1,3,0,1,0,69.82
雲林縣,斗六市,中和里,4,1,432,6,438,600,3,1,3,0,1,0,73.00
雲林縣,斗六市,光興里,5,1,571,3,574,909,3,1,3,0,1,0,63.15
雲林縣,斗六市,鎮西里,6,1,759,10,769,1160,3,1,3,0,1,0,66.29
雲林縣,斗六市,鎮西里,7,1,867,9,876,1405,3,1,3,0,1,0,62.35
雲林縣,斗六市,鎮東里,8,1,673,8,681,1032,3,1,3,0,1,0,65.99
雲林縣,斗六市,鎮東里,9,1,720,9,729,1110,3,1,3,0,1,0,65.68
雲林縣,斗六市,鎮東里,10,1,865,13,878,1313,3,1,3,0,1,0,66.87
雲林縣,斗六市,三平里,11,1,1130,19,1149,1769,3,1,3,0,1,0,64.95
雲林縣,斗六市,三平里,12,1,1004,16,1020,1497,3,1,3,0,1,0,68.14
雲林縣,斗六市,鎮北里,13,1,1081,18,1099,1725,3,1,3,0,1,0,63.71
雲林縣,斗六市,鎮北里,14,1,755,6,761,1136,3,1,3,0,1,0,66.99
雲林縣,斗六市,鎮北里,15,1,1053,11,1064,1608,3,1,3,0,1,0,66.17
雲林縣,斗六市,鎮北里,16,1,901,13,914,1463,3,1,3,0,1,0,62.47
雲林縣,斗六市,忠孝里,17,1,523,8,531,804,3,1,3,0,1,0,66.04
雲林縣,斗六市,忠孝里,18,1,469,4,473,676,3,1,3,0,1,0,69.97
雲林縣,斗六市,仁愛里,19,1,736,14,750,1142,3,1,3,0,1,0,65.67
雲林縣,斗六市,八德里,20,1,737,11,748,1079,3,1,3,0,1,0,69.32
雲林縣,斗六市,八德里,21,1,898,12,910,1389,3,1,3,0,1,0,65.51
雲林縣,斗六市,公正里,22,1,731,8,739,1165,3,1,3,0,1,0,63.43
雲林縣,斗六市,公正里,23,1,821,14,835,1190,3,1,3,0,1,0,70.17
雲林縣,斗六市,重光里,24,1,618,11,629,926,3,1,3,0,1,0,67.93
雲林縣,斗六市,重光里,25,1,683,13,696,1072,3,1,3,0,1,0,64.93
雲林縣,斗六市,林頭里,26,1,1029,18,1047,1631,3,1,3,0,1,0,64.19
雲林縣,斗六市,林頭里,27,1,846,12,858,1278,3,1,3,0,1,0,67.14
雲林縣,斗六市,林頭里,28,1,969,11,980,1469,3,1,3,0,1,0,66.71
雲林縣,斗六市,林頭里,29,1,661,16,677,944,3,1,3,0,1,0,71.72
雲林縣,斗六市,鎮南里,30,1,962,14,976,1419,3,1,3,0,1,0,68.78
雲林縣,斗六市,鎮南里,31,1,1072,9,1081,1770,3,1,3,0,1,0,61.07
雲林縣,斗六市,社口里,32,1,614,8,622,948,3,1,3,0,1,0,65.61
雲林縣,斗六市,社口里,33,1,780,14,794,1178,3,1,3,0,1,0,67.40
雲林縣,斗六市,龍潭里,34,1,654,10,664,989,3,1,3,0,1,0,67.14
雲林縣,斗六市,嘉東里,35,1,510,11,521,715,3,1,3,0,1,0,72.87
雲林縣,斗六市,崙峰里,36,1,663,12,675,990,3,1,3,0,1,0,68.18
雲林縣,斗六市,崙峰里,37,1,441,4,445,669,3,1,3,0,1,0,66.52
雲林縣,斗六市,溝埧里,38,1,376,7,383,564,3,1,3,0,1,0,67.91
雲林縣,斗六市,江厝里,39,1,809,14,823,1232,3,1,3,0,1,0,66.80
雲林縣,斗六市,三光里,40,1,384,1,385,569,3,1,3,0,1,0,67.66
雲林縣,斗六市,久安里,41,1,823,11,834,1171,3,1,3,0,1,0,71.22
雲林縣,斗六市,久安里,42,1,431,10,441,613,3,1,3,0,1,0,71.94
雲林縣,斗六市,虎溪里,43,1,806,9,815,1230,3,1,3,0,1,0,66.26
雲林縣,斗六市,虎溪里,44,1,883,11,894,1488,3,1,3,0,1,0,60.08
雲林縣,斗六市,虎溪里,45,1,940,12,952,1483,3,1,3,0,1,0,64.19
雲林縣,斗六市,保庄里,46,1,1081,9,1090,1585,3,1,3,0,1,0,68.77
雲林縣,斗六市,保庄里,47,1,880,7,887,1338,3,1,3,0,1,0,66.29
雲林縣,斗六市,長平里,48,1,1078,13,1091,1509,3,1,3,0,1,0,72.30
雲林縣,斗六市,榴中里,49,1,833,8,841,1175,3,1,3,0,1,0,71.57
雲林縣,斗六市,榴中里,50,1,798,11,809,1176,3,1,3,0,1,0,68.79
雲林縣,斗六市,榴中里,51,1,811,7,818,1273,3,1,3,0,1,0,64.26
雲林縣,斗六市,榴北里,52,1,649,8,657,918,3,1,3,0,1,0,71.57
雲林縣,斗六市,榴南里,53,1,623,17,640,917,3,1,3,0,1,0,69.79
雲林縣,斗六市,梅林里,54,1,523,15,538,756,3,1,3,0,1,0,71.16
雲林縣,斗六市,梅林里,55,1,636,5,641,984,3,1,3,0,1,0,65.14
雲林縣,斗六市,湖山里,56,1,910,24,934,1304,3,1,3,0,1,0,71.63
雲林縣,斗六市,長安里,57,1,720,13,733,1023,3,1,3,0,1,0,71.65
雲林縣,斗六市,長安里,58,1,914,19,933,1412,3,1,3,0,1,0,66.08
雲林縣,斗六市,溪洲里,59,1,663,8,671,953,3,1,3,0,1,0,70.41
雲林縣,斗六市,溪洲里,60,1,939,15,954,1408,3,1,3,0,1,0,67.76
雲林縣,斗六市,十三里,61,1,773,13,786,1118,3,1,3,0,1,0,70.30
雲林縣,斗南鎮,東仁里,62,1,761,19,780,1140,3,1,3,0,1,0,68.42
雲林縣,斗南鎮,西岐里,63,1,954,12,966,1517,3,1,3,0,1,0,63.68
雲林縣,斗南鎮,西岐里,64,1,899,16,915,1379,3,1,3,0,1,0,66.35
雲林縣,斗南鎮,西岐里,65,1,801,14,815,1300,3,1,3,0,1,0,62.69
雲林縣,斗南鎮,南昌里,66,1,691,4,695,1159,3,1,3,0,1,0,59.97
雲林縣,斗南鎮,南昌里,67,1,561,7,568,849,3,1,3,0,1,0,66.90
雲林縣,斗南鎮,北銘里,68,1,857,5,862,1269,3,1,3,0,1,0,67.93
雲林縣,斗南鎮,中天里,69,1,854,9,863,1255,3,1,3,0,1,0,68.76
雲林縣,斗南鎮,林子里,70,1,790,10,800,1194,3,1,3,0,1,0,67.00
雲林縣,斗南鎮,石龜里,71,1,583,13,596,863,3,1,3,0,1,0,69.06
雲林縣,斗南鎮,石溪里,72,1,597,10,607,905,3,1,3,0,1,0,67.07
雲林縣,斗南鎮,靖興里,73,1,611,10,621,876,3,1,3,0,1,0,70.89
雲林縣,斗南鎮,新南里,74,1,480,6,486,738,3,1,3,0,1,0,65.85
雲林縣,斗南鎮,阿丹里,75,1,850,14,864,1160,3,1,3,0,1,0,74.48
雲林縣,斗南鎮,將軍里,76,1,929,9,938,1413,3,1,3,0,1,0,66.38
雲林縣,斗南鎮,舊社里,77,1,1129,17,1146,1781,3,1,3,0,1,0,64.35
雲林縣,斗南鎮,明昌里,78,1,943,9,952,1424,3,1,3,0,1,0,66.85
雲林縣,斗南鎮,明昌里,79,1,886,10,896,1385,3,1,3,0,1,0,64.69
雲林縣,斗南鎮,明昌里,80,1,942,17,959,1434,3,1,3,0,1,0,66.88
雲林縣,斗南鎮,大東里,81,1,699,13,712,982,3,1,3,0,1,0,72.51
雲林縣,斗南鎮,埤麻里,82,1,592,6,598,851,3,1,3,0,1,0,70.27
雲林縣,斗南鎮,西伯里,83,1,638,7,645,932,3,1,3,0,1,0,69.21
雲林縣,斗南鎮,新崙里,84,1,581,6,587,835,3,1,3,0,1,0,70.30
雲林縣,斗南鎮,新崙里,85,1,517,2,519,769,3,1,3,0,1,0,67.49
雲林縣,斗南鎮,東明里,86,1,688,10,698,995,3,1,3,0,1,0,70.15
雲林縣,斗南鎮,新光里,87,1,655,5,660,935,3,1,3,0,1,0,70.59
雲林縣,斗南鎮,新光里,88,1,956,12,968,1449,3,1,3,0,1,0,66.80
雲林縣,斗南鎮,田頭里,89,1,729,5,734,1018,3,1,3,0,1,0,72.10
雲林縣,斗南鎮,田頭里,90,1,708,7,715,1010,3,1,3,0,1,0,70.79
雲林縣,斗南鎮,小東里,91,1,1018,14,1032,1552,3,1,3,0,1,0,66.49
雲林縣,虎尾鎮,東仁里,92,1,688,4,692,1070,3,1,3,0,1,0,64.67
雲林縣,虎尾鎮,東仁里,93,1,763,6,769,1158,3,1,3,0,1,0,66.41
雲林縣,虎尾鎮,新興里,94,1,442,3,445,705,3,1,3,0,1,0,63.12
雲林縣,虎尾鎮,新興里,95,1,645,11,656,1004,3,1,3,0,1,0,65.34
雲林縣,虎尾鎮,公安里,96,1,796,4,800,1244,3,1,3,0,1,0,64.31
雲林縣,虎尾鎮,公安里,97,1,848,10,858,1372,3,1,3,0,1,0,62.54
雲林縣,虎尾鎮,德興里,98,1,574,11,585,944,3,1,3,0,1,0,61.97
雲林縣,虎尾鎮,德興里,99,1,792,7,799,1388,3,1,3,0,1,0,57.56
雲林縣,虎尾鎮,中山里,100,1,706,8,714,1130,3,1,3,0,1,0,63.19
雲林縣,虎尾鎮,西安里,101,1,831,12,843,1384,3,1,3,0,1,0,60.91
雲林縣,虎尾鎮,西安里,102,1,890,9,899,1499,3,1,3,0,1,0,59.97
雲林縣,虎尾鎮,立仁里,103,1,973,18,991,1537,3,1,3,0,1,0,64.48
雲林縣,虎尾鎮,立仁里,104,1,1038,7,1045,1782,3,1,3,0,1,0,58.64
雲林縣,虎尾鎮,安慶里,105,1,888,14,902,1328,3,1,3,0,1,0,67.92
雲林縣,虎尾鎮,平和里,106,1,721,15,736,1120,3,1,3,0,1,0,65.71
雲林縣,虎尾鎮,興南里,107,1,1040,20,1060,1672,3,1,3,0,1,0,63.40
雲林縣,虎尾鎮,新吉里,108,1,729,20,749,1241,3,1,3,0,1,0,60.35
雲林縣,虎尾鎮,新吉里,109,1,562,5,567,896,3,1,3,0,1,0,63.28
雲林縣,虎尾鎮,穎川里,110,1,1022,7,1029,1618,3,1,3,0,1,0,63.60
雲林縣,虎尾鎮,延平里,111,1,563,10,573,881,3,1,3,0,1,0,65.04
雲林縣,虎尾鎮,建國里,112,1,470,1,471,717,3,1,3,0,1,0,65.69
雲林縣,虎尾鎮,埒內里,113,1,774,17,791,1202,3,1,3,0,1,0,65.81
雲林縣,虎尾鎮,埒內里,114,1,703,10,713,1083,3,1,3,0,1,0,65.84
雲林縣,虎尾鎮,堀頭里,115,1,549,7,556,790,3,1,3,0,1,0,70.38
雲林縣,虎尾鎮,安溪里,116,1,1008,24,1032,1670,3,1,3,0,1,0,61.80
雲林縣,虎尾鎮,興中里,117,1,1006,26,1032,1515,3,1,3,0,1,0,68.12
雲林縣,虎尾鎮,廉使里,118,1,839,12,851,1343,3,1,3,0,1,0,63.37
雲林縣,虎尾鎮,廉使里,119,1,945,12,957,1500,3,1,3,0,1,0,63.80
雲林縣,虎尾鎮,惠來里,120,1,732,14,746,1209,3,1,3,0,1,0,61.70
雲林縣,虎尾鎮,惠來里,121,1,644,16,660,1042,3,1,3,0,1,0,63.34
雲林縣,虎尾鎮,頂溪里,122,1,787,8,795,1154,3,1,3,0,1,0,68.89
雲林縣,虎尾鎮,頂溪里,123,1,764,14,778,1202,3,1,3,0,1,0,64.73
雲林縣,虎尾鎮,中溪里,124,1,799,12,811,1283,3,1,3,0,1,0,63.21
雲林縣,虎尾鎮,下溪里,125,1,817,16,833,1294,3,1,3,0,1,0,64.37
雲林縣,虎尾鎮,東屯里,126,1,754,11,765,1143,3,1,3,0,1,0,66.93
雲林縣,虎尾鎮,西屯里,127,1,994,23,1017,1475,3,1,3,0,1,0,68.95
雲林縣,虎尾鎮,芳草里,128,1,535,9,544,864,3,1,3,0,1,0,62.96
雲林縣,虎尾鎮,墾地里,129,1,551,10,561,948,3,1,3,0,1,0,59.18
雲林縣,虎尾鎮,北溪里,130,1,504,7,511,766,3,1,3,0,1,0,66.71
雲林縣,虎尾鎮,三合里,131,1,660,9,669,1011,3,1,3,0,1,0,66.17
雲林縣,西螺鎮,振興里,132,1,959,10,969,1567,3,1,3,0,1,0,61.84
雲林縣,西螺鎮,大園里,133,1,907,13,920,1440,3,1,3,0,1,0,63.89
雲林縣,西螺鎮,廣福里,134,1,952,8,960,1608,3,1,3,0,1,0,59.70
雲林縣,西螺鎮,正興里,135,1,855,8,863,1326,3,1,3,0,1,0,65.08
雲林縣,西螺鎮,正興里,136,1,910,9,919,1533,3,1,3,0,1,0,59.95
雲林縣,西螺鎮,永安里,137,1,280,7,287,450,3,1,3,0,1,0,63.78
雲林縣,西螺鎮,中和里,138,1,491,1,492,734,3,1,3,0,1,0,67.03
雲林縣,西螺鎮,福興里,139,1,399,7,406,671,3,1,3,0,1,0,60.51
雲林縣,西螺鎮,光華里,140,1,618,8,626,986,3,1,3,0,1,0,63.49
雲林縣,西螺鎮,中興里,141,1,622,7,629,1001,3,1,3,0,1,0,62.84
雲林縣,西螺鎮,中興里,142,1,716,7,723,1152,3,1,3,0,1,0,62.76
雲林縣,西螺鎮,漢光里,143,1,984,10,994,1648,3,1,3,0,1,0,60.32
雲林縣,西螺鎮,漢光里,144,1,1010,13,1023,1652,3,1,3,0,1,0,61.92
雲林縣,西螺鎮,新安里,145,1,753,12,765,1274,3,1,3,0,1,0,60.05
雲林縣,西螺鎮,新豐里,146,1,901,15,916,1422,3,1,3,0,1,0,64.42
雲林縣,西螺鎮,大新里,147,1,570,4,574,914,3,1,3,0,1,0,62.80
雲林縣,西螺鎮,大新里,148,1,525,4,529,815,3,1,3,0,1,0,64.91
雲林縣,西螺鎮,埤頭里,149,1,533,11,544,904,3,1,3,0,1,0,60.18
雲林縣,西螺鎮,東興里,150,1,685,6,691,1119,3,1,3,0,1,0,61.75
雲林縣,西螺鎮,鹿場里,151,1,885,11,896,1481,3,1,3,0,1,0,60.50
雲林縣,西螺鎮,廣興里,152,1,533,8,541,871,3,1,3,0,1,0,62.11
雲林縣,西螺鎮,頂湳里,153,1,645,9,654,974,3,1,3,0,1,0,67.15
雲林縣,西螺鎮,吳厝里,154,1,842,13,855,1374,3,1,3,0,1,0,62.23
雲林縣,西螺鎮,九隆里,155,1,458,8,466,742,3,1,3,0,1,0,62.80
雲林縣,西螺鎮,下湳里,156,1,539,5,544,796,3,1,3,0,1,0,68.34
雲林縣,西螺鎮,七座里,157,1,612,6,618,1005,3,1,3,0,1,0,61.49
雲林縣,西螺鎮,公舘里,158,1,791,14,805,1389,3,1,3,0,1,0,57.96
雲林縣,西螺鎮,詔安里,159,1,557,10,567,955,3,1,3,0,1,0,59.37
雲林縣,西螺鎮,河南里,160,1,516,10,526,927,3,1,3,0,1,0,56.74
雲林縣,西螺鎮,安定里,161,1,527,5,532,930,3,1,3,0,1,0,57.20
雲林縣,西螺鎮,安定里,162,1,506,4,510,865,3,1,3,0,1,0,58.96
雲林縣,西螺鎮,福田里,163,1,891,10,901,1392,3,1,3,0,1,0,64.73
雲林縣,土庫鎮,忠正里,164,1,657,5,662,967,3,1,3,0,1,0,68.46
雲林縣,土庫鎮,順天里,165,1,685,8,693,1003,3,1,3,0,1,0,69.09
雲林縣,土庫鎮,宮北里,166,1,870,5,875,1320,3,1,3,0,1,0,66.29
雲林縣,土庫鎮,越港里,167,1,620,14,634,874,3,1,3,0,1,0,72.54
雲林縣,土庫鎮,溪邊里,168,1,476,6,482,707,3,1,3,0,1,0,68.18
雲林縣,土庫鎮,溪邊里,169,1,323,4,327,440,3,1,3,0,1,0,74.32
雲林縣,土庫鎮,石廟里,170,1,941,11,952,1524,3,1,3,0,1,0,62.47
雲林縣,土庫鎮,興新里,171,1,387,7,394,612,3,1,3,0,1,0,64.38
雲林縣,土庫鎮,興新里,172,1,407,10,417,694,3,1,3,0,1,0,60.09
雲林縣,土庫鎮,奮起里,173,1,469,11,480,843,3,1,3,0,1,0,56.94
雲林縣,土庫鎮,奮起里,174,1,388,4,392,619,3,1,3,0,1,0,63.33
雲林縣,土庫鎮,埤腳里,175,1,560,9,569,898,3,1,3,0,1,0,63.36
雲林縣,土庫鎮,埤腳里,176,1,395,7,402,567,3,1,3,0,1,0,70.90
雲林縣,土庫鎮,後埔里,177,1,807,14,821,1299,3,1,3,0,1,0,63.20
雲林縣,土庫鎮,後埔里,178,1,662,9,671,1010,3,1,3,0,1,0,66.44
雲林縣,土庫鎮,崙內里,179,1,561,7,568,804,3,1,3,0,1,0,70.65
雲林縣,土庫鎮,崙內里,180,1,464,9,473,698,3,1,3,0,1,0,67.77
雲林縣,土庫鎮,大荖里,181,1,554,9,563,850,3,1,3,0,1,0,66.24
雲林縣,土庫鎮,東平里,182,1,664,14,678,1021,3,1,3,0,1,0,66.41
雲林縣,土庫鎮,東平里,183,1,530,7,537,833,3,1,3,0,1,0,64.47
雲林縣,土庫鎮,南平里,184,1,669,12,681,971,3,1,3,0,1,0,70.13
雲林縣,土庫鎮,南平里,185,1,531,8,539,802,3,1,3,0,1,0,67.21
雲林縣,土庫鎮,西平里,186,1,608,17,625,926,3,1,3,0,1,0,67.49
雲林縣,土庫鎮,西平里,187,1,580,7,587,867,3,1,3,0,1,0,67.70
雲林縣,土庫鎮,北平里,188,1,674,12,686,974,3,1,3,0,1,0,70.43
雲林縣,土庫鎮,新庄里,189,1,924,26,950,1442,3,1,3,0,1,0,65.88
雲林縣,北港鎮,東陽里,190,1,603,14,617,818,3,1,3,0,1,0,75.43
雲林縣,北港鎮,光民里,191,1,584,10,594,797,3,1,3,0,1,0,74.53
雲林縣,北港鎮,東華里,192,1,376,3,379,511,3,1,3,0,1,0,74.17
雲林縣,北港鎮,南安里,193,1,733,8,741,1049,3,1,3,0,1,0,70.64
雲林縣,北港鎮,中和里,194,1,281,5,286,412,3,1,3,0,1,0,69.42
雲林縣,北港鎮,義民里,195,1,298,4,302,447,3,1,3,0,1,0,67.56
雲林縣,北港鎮,共榮里,196,1,317,6,323,467,3,1,3,0,1,0,69.16
雲林縣,北港鎮,西勢里,197,1,612,7,619,922,3,1,3,0,1,0,67.14
雲林縣,北港鎮,仁和里,198,1,408,7,415,551,3,1,3,0,1,0,75.32
雲林縣,北港鎮,賜福里,199,1,275,6,281,398,3,1,3,0,1,0,70.60
雲林縣,北港鎮,公舘里,200,1,431,9,440,651,3,1,3,0,1,0,67.59
雲林縣,北港鎮,大同里,201,1,394,4,398,557,3,1,3,0,1,0,71.45
雲林縣,北港鎮,大同里,202,1,482,9,491,786,3,1,3,0,1,0,62.47
雲林縣,北港鎮,仁安里,203,1,321,8,329,485,3,1,3,0,1,0,67.84
雲林縣,北港鎮,華勝里,204,1,727,8,735,1124,3,1,3,0,1,0,65.39
雲林縣,北港鎮,華勝里,205,1,905,13,918,1401,3,1,3,0,1,0,65.52
雲林縣,北港鎮,華勝里,206,1,695,10,705,1056,3,1,3,0,1,0,66.76
雲林縣,北港鎮,華勝里,207,1,891,15,906,1345,3,1,3,0,1,0,67.36
雲林縣,北港鎮,光復里,208,1,820,11,831,1271,3,1,3,0,1,0,65.38
雲林縣,北港鎮,新街里,209,1,922,9,931,1423,3,1,3,0,1,0,65.43
雲林縣,北港鎮,新街里,210,1,652,8,660,1018,3,1,3,0,1,0,64.83
雲林縣,北港鎮,新街里,211,1,842,13,855,1302,3,1,3,0,1,0,65.67
雲林縣,北港鎮,新街里,212,1,670,12,682,1055,3,1,3,0,1,0,64.64
雲林縣,北港鎮,劉厝里,213,1,722,11,733,1148,3,1,3,0,1,0,63.85
雲林縣,北港鎮,後溝里,214,1,378,9,387,627,3,1,3,0,1,0,61.72
雲林縣,北港鎮,後溝里,215,1,230,2,232,387,3,1,3,0,1,0,59.95
雲林縣,北港鎮,新厝里,216,1,259,3,262,411,3,1,3,0,1,0,63.75
雲林縣,北港鎮,府番里,217,1,505,5,510,849,3,1,3,0,1,0,60.07
雲林縣,北港鎮,草湖里,218,1,881,16,897,1407,3,1,3,0,1,0,63.75
雲林縣,北港鎮,溝皂里,219,1,709,11,720,1255,3,1,3,0,1,0,57.37
雲林縣,北港鎮,番溝里,220,1,522,16,538,1049,3,1,3,0,1,0,51.29
雲林縣,北港鎮,大北里,221,1,342,12,354,639,3,1,3,0,1,0,55.40
雲林縣,北港鎮,好收里,222,1,707,17,724,1011,3,1,3,0,1,0,71.61
雲林縣,北港鎮,好收里,223,1,400,5,405,604,3,1,3,0,1,0,67.05
雲林縣,北港鎮,樹腳里,224,1,742,9,751,1231,3,1,3,0,1,0,61.01
雲林縣,北港鎮,樹腳里,225,1,920,6,926,1503,3,1,3,0,1,0,61.61
雲林縣,北港鎮,扶朝里,226,1,675,7,682,1067,3,1,3,0,1,0,63.92
雲林縣,北港鎮,水埔里,227,1,369,5,374,592,3,1,3,0,1,0,63.18
雲林縣,古坑鄉,棋盤村,228,1,780,15,795,1130,3,1,3,0,1,0,70.35
雲林縣,古坑鄉,棋盤村,229,1,652,8,660,945,3,1,3,0,1,0,69.84
雲林縣,古坑鄉,新庄村,230,1,1013,15,1028,1509,3,1,3,0,1,0,68.12
雲林縣,古坑鄉,東和村,231,1,818,10,828,1295,3,1,3,0,1,0,63.94
雲林縣,古坑鄉,東和村,232,1,887,20,907,1501,3,1,3,0,1,0,60.43
雲林縣,古坑鄉,荷苞村,233,1,743,13,756,1159,3,1,3,0,1,0,65.23
雲林縣,古坑鄉,荷苞村,234,1,215,4,219,302,3,1,3,0,1,0,72.52
雲林縣,古坑鄉,高林村,235,1,813,7,820,1142,3,1,3,0,1,0,71.80
雲林縣,古坑鄉,水碓村,236,1,784,13,797,1200,3,1,3,0,1,0,66.42
雲林縣,古坑鄉,田心村,237,1,657,2,659,946,3,1,3,0,1,0,69.66
雲林縣,古坑鄉,古坑村,238,1,628,5,633,922,3,1,3,0,1,0,68.66
雲林縣,古坑鄉,古坑村,239,1,690,12,702,1089,3,1,3,0,1,0,64.46
雲林縣,古坑鄉,朝陽村,240,1,625,6,631,906,3,1,3,0,1,0,69.65
雲林縣,古坑鄉,朝陽村,241,1,679,9,688,1044,3,1,3,0,1,0,65.90
雲林縣,古坑鄉,西平村,242,1,951,11,962,1383,3,1,3,0,1,0,69.56
雲林縣,古坑鄉,湳仔村,243,1,501,6,507,686,3,1,3,0,1,0,73.91
雲林縣,古坑鄉,永光村,244,1,609,6,615,951,3,1,3,0,1,0,64.67
雲林縣,古坑鄉,永光村,245,1,562,4,566,923,3,1,3,0,1,0,61.32
雲林縣,古坑鄉,永昌村,246,1,674,11,685,1068,3,1,3,0,1,0,64.14
雲林縣,古坑鄉,永昌村,247,1,609,6,615,941,3,1,3,0,1,0,65.36
雲林縣,古坑鄉,麻園村,248,1,473,6,479,650,3,1,3,0,1,0,73.69
雲林縣,古坑鄉,崁腳村,249,1,886,17,903,1302,3,1,3,0,1,0,69.35
雲林縣,古坑鄉,華南村,250,1,213,3,216,335,3,1,3,0,1,0,64.48
雲林縣,古坑鄉,華山村,251,1,465,7,472,785,3,1,3,0,1,0,60.13
雲林縣,古坑鄉,桂林村,252,1,738,6,744,1153,3,1,3,0,1,0,64.53
雲林縣,古坑鄉,樟湖村,253,1,320,9,329,519,3,1,3,0,1,0,63.39
雲林縣,古坑鄉,草嶺村,254,1,428,6,434,659,3,1,3,0,1,0,65.86
雲林縣,大埤鄉,北和村,255,1,530,7,537,785,3,1,3,0,1,0,68.41
雲林縣,大埤鄉,南和村,256,1,960,10,970,1467,3,1,3,0,1,0,66.12
雲林縣,大埤鄉,南和村,257,1,414,5,419,577,3,1,3,0,1,0,72.62
雲林縣,大埤鄉,大德村,258,1,709,8,717,1125,3,1,3,0,1,0,63.73
雲林縣,大埤鄉,松竹村,259,1,669,8,677,1037,3,1,3,0,1,0,65.28
雲林縣,大埤鄉,尚義村,260,1,856,3,859,1325,3,1,3,0,1,0,64.83
雲林縣,大埤鄉,尚義村,261,1,318,0,318,471,3,1,3,0,1,0,67.52
雲林縣,大埤鄉,嘉興村,262,1,881,17,898,1306,3,1,3,0,1,0,68.76
雲林縣,大埤鄉,嘉興村,263,1,336,4,340,482,3,1,3,0,1,0,70.54
雲林縣,大埤鄉,豐田村,264,1,824,12,836,1291,3,1,3,0,1,0,64.76
雲林縣,大埤鄉,三結村,265,1,835,9,844,1247,3,1,3,0,1,0,67.68
雲林縣,大埤鄉,吉田村,266,1,500,14,514,807,3,1,3,0,1,0,63.69
雲林縣,大埤鄉,豐岡村,267,1,494,10,504,700,3,1,3,0,1,0,72.00
雲林縣,大埤鄉,聯美村,268,1,750,10,760,1227,3,1,3,0,1,0,61.94
雲林縣,大埤鄉,怡然村,269,1,543,11,554,836,3,1,3,0,1,0,66.27
雲林縣,大埤鄉,北鎮村,270,1,436,7,443,723,3,1,3,0,1,0,61.27
雲林縣,大埤鄉,興安村,271,1,537,6,543,838,3,1,3,0,1,0,64.80
雲林縣,大埤鄉,西鎮村,272,1,559,4,563,811,3,1,3,0,1,0,69.42
雲林縣,莿桐鄉,莿桐村,273,1,921,21,942,1403,3,1,3,0,1,0,67.14
雲林縣,莿桐鄉,莿桐村,274,1,860,10,870,1308,3,1,3,0,1,0,66.51
雲林縣,莿桐鄉,莿桐村,275,1,501,8,509,709,3,1,3,0,1,0,71.79
雲林縣,莿桐鄉,甘厝村,276,1,623,9,632,914,3,1,3,0,1,0,69.15
雲林縣,莿桐鄉,甘西村,277,1,990,7,997,1601,3,1,3,0,1,0,62.27
雲林縣,莿桐鄉,興桐村,278,1,379,3,382,575,3,1,3,0,1,0,66.43
雲林縣,莿桐鄉,興桐村,279,1,485,7,492,698,3,1,3,0,1,0,70.49
雲林縣,莿桐鄉,義和村,280,1,767,4,771,1145,3,1,3,0,1,0,67.34
雲林縣,莿桐鄉,埔子村,281,1,595,5,600,847,3,1,3,0,1,0,70.84
雲林縣,莿桐鄉,埔子村,282,1,569,2,571,894,3,1,3,0,1,0,63.87
雲林縣,莿桐鄉,大美村,283,1,832,15,847,1277,3,1,3,0,1,0,66.33
雲林縣,莿桐鄉,大美村,284,1,708,16,724,1104,3,1,3,0,1,0,65.58
雲林縣,莿桐鄉,埔尾村,285,1,844,12,856,1223,3,1,3,0,1,0,69.99
雲林縣,莿桐鄉,興貴村,286,1,612,10,622,900,3,1,3,0,1,0,69.11
雲林縣,莿桐鄉,興貴村,287,1,650,12,662,960,3,1,3,0,1,0,68.96
雲林縣,莿桐鄉,饒平村,288,1,826,10,836,1149,3,1,3,0,1,0,72.76
雲林縣,莿桐鄉,四合村,289,1,1129,18,1147,1755,3,1,3,0,1,0,65.36
雲林縣,莿桐鄉,麻園村,290,1,1027,9,1036,1570,3,1,3,0,1,0,65.99
雲林縣,莿桐鄉,五華村,291,1,866,14,880,1331,3,1,3,0,1,0,66.12
雲林縣,莿桐鄉,六合村,292,1,1128,13,1141,1752,3,1,3,0,1,0,65.13
雲林縣,林內鄉,林南村,293,1,723,15,738,1036,3,1,3,0,1,0,71.24
雲林縣,林內鄉,林中村,294,1,1041,19,1060,1616,3,1,3,0,1,0,65.59
雲林縣,林內鄉,林中村,295,1,1115,25,1140,1683,3,1,3,0,1,0,67.74
雲林縣,林內鄉,林北村,296,1,941,17,958,1391,3,1,3,0,1,0,68.87
雲林縣,林內鄉,林北村,297,1,463,6,469,720,3,1,3,0,1,0,65.14
雲林縣,林內鄉,坪頂村,298,1,464,3,467,626,3,1,3,0,1,0,74.60
雲林縣,林內鄉,林茂村,299,1,632,11,643,934,3,1,3,0,1,0,68.84
雲林縣,林內鄉,九芎村,300,1,724,9,733,1025,3,1,3,0,1,0,71.51
雲林縣,林內鄉,九芎村,301,1,975,9,984,1477,3,1,3,0,1,0,66.62
雲林縣,林內鄉,湖本村,302,1,451,8,459,640,3,1,3,0,1,0,71.72
雲林縣,林內鄉,烏塗村,303,1,776,13,789,1129,3,1,3,0,1,0,69.88
雲林縣,林內鄉,烏麻村,304,1,724,6,730,1054,3,1,3,0,1,0,69.26
雲林縣,林內鄉,重興村,305,1,612,13,625,894,3,1,3,0,1,0,69.91
雲林縣,林內鄉,重興村,306,1,575,11,586,845,3,1,3,0,1,0,69.35
雲林縣,二崙鄉,崙東村,307,1,902,11,913,1405,3,1,3,0,1,0,64.98
雲林縣,二崙鄉,崙西村,308,1,1019,12,1031,1633,3,1,3,0,1,0,63.14
雲林縣,二崙鄉,來惠村,309,1,453,3,456,719,3,1,3,0,1,0,63.42
雲林縣,二崙鄉,來惠村,310,1,681,5,686,1092,3,1,3,0,1,0,62.82
雲林縣,二崙鄉,三和村,311,1,325,3,328,499,3,1,3,0,1,0,65.73
雲林縣,二崙鄉,三和村,312,1,702,8,710,1154,3,1,3,0,1,0,61.53
雲林縣,二崙鄉,湳仔村,313,1,813,14,827,1226,3,1,3,0,1,0,67.46
雲林縣,二崙鄉,田尾村,314,1,621,6,627,1012,3,1,3,0,1,0,61.96
雲林縣,二崙鄉,田尾村,315,1,647,5,652,981,3,1,3,0,1,0,66.46
雲林縣,二崙鄉,定安村,316,1,577,9,586,964,3,1,3,0,1,0,60.79
雲林縣,二崙鄉,永定村,317,1,786,8,794,1336,3,1,3,0,1,0,59.43
雲林縣,二崙鄉,大華村,318,1,544,9,553,958,3,1,3,0,1,0,57.72
雲林縣,二崙鄉,義庄村,319,1,455,6,461,785,3,1,3,0,1,0,58.73
雲林縣,二崙鄉,楊賢村,320,1,951,9,960,1534,3,1,3,0,1,0,62.58
雲林縣,二崙鄉,港後村,321,1,656,9,665,1200,3,1,3,0,1,0,55.42
雲林縣,二崙鄉,港後村,322,1,445,8,453,714,3,1,3,0,1,0,63.45
雲林縣,二崙鄉,大義村,323,1,558,9,567,903,3,1,3,0,1,0,62.79
雲林縣,二崙鄉,油車村,324,1,712,9,721,1118,3,1,3,0,1,0,64.49
雲林縣,二崙鄉,油車村,325,1,389,4,393,685,3,1,3,0,1,0,57.37
雲林縣,二崙鄉,大庄村,326,1,804,13,817,1417,3,1,3,0,1,0,57.66
雲林縣,二崙鄉,庄西村,327,1,585,7,592,1012,3,1,3,0,1,0,58.50
雲林縣,二崙鄉,大同村,328,1,544,1,545,851,3,1,3,0,1,0,64.04
雲林縣,二崙鄉,復興村,329,1,668,7,675,1059,3,1,3,0,1,0,63.74
雲林縣,崙背鄉,東明村,330,1,805,6,811,1284,3,1,3,0,1,0,63.16
雲林縣,崙背鄉,西榮村,331,1,866,12,878,1414,3,1,3,0,1,0,62.09
雲林縣,崙背鄉,南陽村,332,1,591,17,608,983,3,1,3,0,1,0,61.85
雲林縣,崙背鄉,南陽村,333,1,823,7,830,1245,3,1,3,0,1,0,66.67
雲林縣,崙背鄉,崙前村,334,1,659,12,671,1053,3,1,3,0,1,0,63.72
雲林縣,崙背鄉,崙前村,335,1,564,8,572,970,3,1,3,0,1,0,58.97
雲林縣,崙背鄉,羅厝村,336,1,586,8,594,954,3,1,3,0,1,0,62.26
雲林縣,崙背鄉,羅厝村,337,1,686,15,701,1053,3,1,3,0,1,0,66.57
雲林縣,崙背鄉,港尾村,338,1,847,19,866,1358,3,1,3,0,1,0,63.77
雲林縣,崙背鄉,阿勸村,339,1,661,12,673,1045,3,1,3,0,1,0,64.40
雲林縣,崙背鄉,阿勸村,340,1,635,5,640,943,3,1,3,0,1,0,67.87
雲林縣,崙背鄉,五魁村,341,1,564,5,569,883,3,1,3,0,1,0,64.44
雲林縣,崙背鄉,大有村,342,1,516,8,524,831,3,1,3,0,1,0,63.06
雲林縣,崙背鄉,大有村,343,1,548,4,552,960,3,1,3,0,1,0,57.50
雲林縣,崙背鄉,豐榮村,344,1,570,5,575,969,3,1,3,0,1,0,59.34
雲林縣,崙背鄉,豐榮村,345,1,562,2,564,1080,3,1,3,0,1,0,52.22
雲林縣,崙背鄉,草湖村,346,1,803,17,820,1472,3,1,3,0,1,0,55.71
雲林縣,崙背鄉,舊庄村,347,1,710,17,727,1196,3,1,3,0,1,0,60.79
雲林縣,崙背鄉,水尾村,348,1,802,7,809,1279,3,1,3,0,1,0,63.25
雲林縣,崙背鄉,枋南村,349,1,521,7,528,869,3,1,3,0,1,0,60.76
雲林縣,麥寮鄉,麥豐村,350,1,409,5,414,596,3,1,3,0,1,0,69.46
雲林縣,麥寮鄉,麥豐村,351,1,906,8,914,1458,3,1,3,0,1,0,62.69
雲林縣,麥寮鄉,麥豐村,352,1,687,7,694,1094,3,1,3,0,1,0,63.44
雲林縣,麥寮鄉,麥津村,353,1,716,6,722,1162,3,1,3,0,1,0,62.13
雲林縣,麥寮鄉,麥津村,354,1,885,17,902,1414,3,1,3,0,1,0,63.79
雲林縣,麥寮鄉,瓦窯村,355,1,296,3,299,501,3,1,3,0,1,0,59.68
雲林縣,麥寮鄉,瓦窯村,356,1,557,6,563,871,3,1,3,0,1,0,64.64
雲林縣,麥寮鄉,興華村,357,1,446,10,456,735,3,1,3,0,1,0,62.04
雲林縣,麥寮鄉,興華村,358,1,669,10,679,1111,3,1,3,0,1,0,61.12
雲林縣,麥寮鄉,海豐村,359,1,505,10,515,834,3,1,3,0,1,0,61.75
雲林縣,麥寮鄉,海豐村,360,1,375,7,382,612,3,1,3,0,1,0,62.42
雲林縣,麥寮鄉,後安村,361,1,568,6,574,992,3,1,3,0,1,0,57.86
雲林縣,麥寮鄉,後安村,362,1,613,12,625,1106,3,1,3,0,1,0,56.51
雲林縣,麥寮鄉,三盛村,363,1,590,7,597,933,3,1,3,0,1,0,63.99
雲林縣,麥寮鄉,三盛村,364,1,734,12,746,1221,3,1,3,0,1,0,61.10
雲林縣,麥寮鄉,崙後村,365,1,456,10,466,901,3,1,3,0,1,0,51.72
雲林縣,麥寮鄉,崙後村,366,1,535,5,540,945,3,1,3,0,1,0,57.14
雲林縣,麥寮鄉,橋頭村,367,1,581,10,591,982,3,1,3,0,1,0,60.18
雲林縣,麥寮鄉,橋頭村,368,1,957,15,972,1553,3,1,3,0,1,0,62.59
雲林縣,麥寮鄉,新吉村,369,1,446,9,455,793,3,1,3,0,1,0,57.38
雲林縣,麥寮鄉,施厝村,370,1,623,10,633,1140,3,1,3,0,1,0,55.53
雲林縣,麥寮鄉,施厝村,371,1,540,8,548,1027,3,1,3,0,1,0,53.36
雲林縣,麥寮鄉,雷厝村,372,1,772,17,789,1502,3,1,3,0,1,0,52.53
雲林縣,東勢鄉,月眉村,373,1,676,8,684,1291,3,1,3,0,1,0,52.98
雲林縣,東勢鄉,復興村,374,1,272,1,273,492,3,1,3,0,1,0,55.49
雲林縣,東勢鄉,嘉隆村,375,1,574,12,586,1027,3,1,3,0,1,0,57.06
雲林縣,東勢鄉,嘉隆村,376,1,448,4,452,765,3,1,3,0,1,0,59.08
雲林縣,東勢鄉,東南村,377,1,910,15,925,1442,3,1,3,0,1,0,64.15
雲林縣,東勢鄉,東北村,378,1,715,7,722,1210,3,1,3,0,1,0,59.67
雲林縣,東勢鄉,昌南村,379,1,591,9,600,976,3,1,3,0,1,0,61.48
雲林縣,東勢鄉,同安村,380,1,617,15,632,1053,3,1,3,0,1,0,60.02
雲林縣,東勢鄉,同安村,381,1,697,21,718,1137,3,1,3,0,1,0,63.15
雲林縣,東勢鄉,四美村,382,1,451,5,456,850,3,1,3,0,1,0,53.65
雲林縣,東勢鄉,四美村,383,1,267,4,271,468,3,1,3,0,1,0,57.91
雲林縣,東勢鄉,新坤村,384,1,777,16,793,1284,3,1,3,0,1,0,61.76
雲林縣,東勢鄉,安南村,385,1,495,14,509,949,3,1,3,0,1,0,53.64
雲林縣,東勢鄉,龍潭村,386,1,508,14,522,1036,3,1,3,0,1,0,50.39
雲林縣,東勢鄉,程海村,387,1,357,3,360,582,3,1,3,0,1,0,61.86
雲林縣,褒忠鄉,中民村,388,1,658,8,666,958,3,1,3,0,1,0,69.52
雲林縣,褒忠鄉,中民村,389,1,580,11,591,884,3,1,3,0,1,0,66.86
雲林縣,褒忠鄉,埔姜村,390,1,900,16,916,1378,3,1,3,0,1,0,66.47
雲林縣,褒忠鄉,中勝村,391,1,867,12,879,1385,3,1,3,0,1,0,63.47
雲林縣,褒忠鄉,馬鳴村,392,1,282,2,284,412,3,1,3,0,1,0,68.93
雲林縣,褒忠鄉,馬鳴村,393,1,617,9,626,964,3,1,3,0,1,0,64.94
雲林縣,褒忠鄉,新湖村,394,1,352,4,356,526,3,1,3,0,1,0,67.68
雲林縣,褒忠鄉,新湖村,395,1,499,9,508,794,3,1,3,0,1,0,63.98
雲林縣,褒忠鄉,有才村,396,1,587,7,594,970,3,1,3,0,1,0,61.24
雲林縣,褒忠鄉,田洋村,397,1,542,8,550,830,3,1,3,0,1,0,66.27
雲林縣,褒忠鄉,龍岩村,398,1,847,14,861,1259,3,1,3,0,1,0,68.39
雲林縣,褒忠鄉,潮厝村,399,1,578,7,585,973,3,1,3,0,1,0,60.12
雲林縣,台西鄉,台西村,400,1,818,8,826,1312,3,1,3,0,1,0,62.96
雲林縣,台西鄉,海南村,401,1,623,7,630,1032,3,1,3,0,1,0,61.05
雲林縣,台西鄉,海北村,402,1,589,9,598,1062,3,1,3,0,1,0,56.31
雲林縣,台西鄉,海口村,403,1,593,8,601,1030,3,1,3,0,1,0,58.35
雲林縣,台西鄉,海口村,404,1,522,8,530,928,3,1,3,0,1,0,57.11
雲林縣,台西鄉,山寮村,405,1,482,8,490,931,3,1,3,0,1,0,52.63
雲林縣,台西鄉,溪頂村,406,1,781,19,800,1552,3,1,3,0,1,0,51.55
雲林縣,台西鄉,牛厝村,407,1,647,6,653,1264,3,1,3,0,1,0,51.66
雲林縣,台西鄉,牛厝村,408,1,398,11,409,715,3,1,3,0,1,0,57.20
雲林縣,台西鄉,泉州村,409,1,296,15,311,635,3,1,3,0,1,0,48.98
雲林縣,台西鄉,五榔村,410,1,259,3,262,539,3,1,3,0,1,0,48.61
雲林縣,台西鄉,光華村,411,1,382,11,393,671,3,1,3,0,1,0,58.57
雲林縣,台西鄉,五港村,412,1,722,7,729,1279,3,1,3,0,1,0,57.00
雲林縣,台西鄉,五港村,413,1,393,5,398,638,3,1,3,0,1,0,62.38
雲林縣,台西鄉,富琦村,414,1,622,10,632,1033,3,1,3,0,1,0,61.18
雲林縣,台西鄉,富琦村,415,1,287,10,297,518,3,1,3,0,1,0,57.34
雲林縣,台西鄉,永豐村,416,1,873,9,882,1418,3,1,3,0,1,0,62.20
雲林縣,台西鄉,和豐村,417,1,631,2,633,1071,3,1,3,0,1,0,59.10
雲林縣,台西鄉,和豐村,418,1,593,4,597,1037,3,1,3,0,1,0,57.57
雲林縣,台西鄉,和豐村,419,1,600,15,615,1140,3,1,3,0,1,0,53.95
雲林縣,台西鄉,蚊港村,420,1,900,21,921,1307,3,1,3,0,1,0,70.47
雲林縣,台西鄉,蚊港村,421,1,560,5,565,718,3,1,3,0,1,0,78.69
雲林縣,元長鄉,長南村,422,1,1066,17,1083,1714,3,1,3,0,1,0,63.19
雲林縣,元長鄉,長南村,423,1,765,13,778,1381,3,1,3,0,1,0,56.34
雲林縣,元長鄉,長北村,424,1,467,8,475,826,3,1,3,0,1,0,57.51
雲林縣,元長鄉,長北村,425,1,428,6,434,793,3,1,3,0,1,0,54.73
雲林縣,元長鄉,子茂村,426,1,831,10,841,1506,3,1,3,0,1,0,55.84
雲林縣,元長鄉,後湖村,427,1,484,4,488,780,3,1,3,0,1,0,62.56
雲林縣,元長鄉,山內村,428,1,601,9,610,1049,3,1,3,0,1,0,58.15
雲林縣,元長鄉,合和村,429,1,629,11,640,1211,3,1,3,0,1,0,52.85
雲林縣,元長鄉,五塊村,430,1,603,7,610,1034,3,1,3,0,1,0,58.99
雲林縣,元長鄉,潭西村,431,1,460,8,468,938,3,1,3,0,1,0,49.89
雲林縣,元長鄉,潭東村,432,1,405,1,406,706,3,1,3,0,1,0,57.51
雲林縣,元長鄉,客厝村,433,1,516,7,523,876,3,1,3,0,1,0,59.70
雲林縣,元長鄉,卓運村,434,1,262,2,264,470,3,1,3,0,1,0,56.17
雲林縣,元長鄉,頂寮村,435,1,712,9,721,1256,3,1,3,0,1,0,57.40
雲林縣,元長鄉,下寮村,436,1,903,15,918,1586,3,1,3,0,1,0,57.88
雲林縣,元長鄉,龍岩村,437,1,649,5,654,1113,3,1,3,0,1,0,58.76
雲林縣,元長鄉,西莊村,438,1,568,11,579,942,3,1,3,0,1,0,61.46
雲林縣,元長鄉,鹿北村,439,1,805,7,812,1359,3,1,3,0,1,0,59.75
雲林縣,元長鄉,鹿南村,440,1,616,6,622,1060,3,1,3,0,1,0,58.68
雲林縣,元長鄉,瓦窯村,441,1,434,7,441,781,3,1,3,0,1,0,56.47
雲林縣,元長鄉,瓦窯村,442,1,554,4,558,905,3,1,3,0,1,0,61.66
雲林縣,元長鄉,內寮村,443,1,416,4,420,687,3,1,3,0,1,0,61.14
雲林縣,元長鄉,崙仔村,444,1,545,17,562,945,3,1,3,0,1,0,59.47
雲林縣,元長鄉,新吉村,445,1,472,5,477,733,3,1,3,0,1,0,65.08
雲林縣,四湖鄉,四湖村,446,1,564,15,579,1033,3,1,3,0,1,0,56.05
雲林縣,四湖鄉,四湖村,447,1,433,6,439,703,3,1,3,0,1,0,62.45
雲林縣,四湖鄉,湖西村,448,1,943,11,954,1502,3,1,3,0,1,0,63.52
雲林縣,四湖鄉,湖西村,449,1,335,10,345,585,3,1,3,0,1,0,58.97
雲林縣,四湖鄉,新庄村,450,1,398,6,404,709,3,1,3,0,1,0,56.98
雲林縣,四湖鄉,溪底村,451,1,624,17,641,1112,3,1,3,0,1,0,57.64
雲林縣,四湖鄉,鹿場村,452,1,598,9,607,1136,3,1,3,0,1,0,53.43
雲林縣,四湖鄉,蔡厝村,453,1,506,5,511,979,3,1,3,0,1,0,52.20
雲林縣,四湖鄉,湖寮村,454,1,492,10,502,922,3,1,3,0,1,0,54.45
雲林縣,四湖鄉,施湖村,455,1,655,11,666,1227,3,1,3,0,1,0,54.28
雲林縣,四湖鄉,羊調村,456,1,583,13,596,1143,3,1,3,0,1,0,52.14
雲林縣,四湖鄉,內湖村,457,1,442,4,446,982,3,1,3,0,1,0,45.42
雲林縣,四湖鄉,飛東村,458,1,367,5,372,682,3,1,3,0,1,0,54.55
雲林縣,四湖鄉,飛沙村,459,1,509,12,521,993,3,1,3,0,1,0,52.47
雲林縣,四湖鄉,三姓村,460,1,236,2,238,411,3,1,3,0,1,0,57.91
雲林縣,四湖鄉,崙北村,461,1,462,8,470,968,3,1,3,0,1,0,48.55
雲林縣,四湖鄉,崙北村,462,1,450,8,458,802,3,1,3,0,1,0,57.11
雲林縣,四湖鄉,崙南村,463,1,471,12,483,911,3,1,3,0,1,0,53.02
雲林縣,四湖鄉,廣溝村,464,1,389,9,398,814,3,1,3,0,1,0,48.89
雲林縣,四湖鄉,箔子村,465,1,465,8,473,1004,3,1,3,0,1,0,47.11
雲林縣,四湖鄉,箔東村,466,1,533,10,543,1138,3,1,3,0,1,0,47.72
雲林縣,四湖鄉,林厝村,467,1,649,10,659,1299,3,1,3,0,1,0,50.73
雲林縣,四湖鄉,林東村,468,1,503,12,515,1088,3,1,3,0,1,0,47.33
雲林縣,四湖鄉,溪尾村,469,1,368,4,372,836,3,1,3,0,1,0,44.50
雲林縣,口湖鄉,口湖村,470,1,654,3,657,1033,3,1,3,0,1,0,63.60
雲林縣,口湖鄉,湖東村,471,1,831,16,847,1255,3,1,3,0,1,0,67.49
雲林縣,口湖鄉,頂湖村,472,1,372,8,380,708,3,1,3,0,1,0,53.67
雲林縣,口湖鄉,埔南村,473,1,383,2,385,649,3,1,3,0,1,0,59.32
雲林縣,口湖鄉,埔北村,474,1,453,5,458,927,3,1,3,0,1,0,49.41
雲林縣,口湖鄉,謝厝村,475,1,591,11,602,997,3,1,3,0,1,0,60.38
雲林縣,口湖鄉,蚵寮村,476,1,888,13,901,1435,3,1,3,0,1,0,62.79
雲林縣,口湖鄉,下崙村,477,1,414,5,419,888,3,1,3,0,1,0,47.18
雲林縣,口湖鄉,下崙村,478,1,605,6,611,1108,3,1,3,0,1,0,55.14
雲林縣,口湖鄉,崙中村,479,1,430,11,441,855,3,1,3,0,1,0,51.58
雲林縣,口湖鄉,崙中村,480,1,455,7,462,877,3,1,3,0,1,0,52.68
雲林縣,口湖鄉,崙東村,481,1,843,13,856,1517,3,1,3,0,1,0,56.43
雲林縣,口湖鄉,青蚶村,482,1,291,8,299,543,3,1,3,0,1,0,55.06
雲林縣,口湖鄉,港東村,483,1,845,19,864,1439,3,1,3,0,1,0,60.04
雲林縣,口湖鄉,港西村,484,1,447,0,447,743,3,1,3,0,1,0,60.16
雲林縣,口湖鄉,台子村,485,1,224,2,226,336,3,1,3,0,1,0,67.26
雲林縣,口湖鄉,台子村,486,1,772,16,788,1285,3,1,3,0,1,0,61.32
雲林縣,口湖鄉,成龍村,487,1,622,6,628,1019,3,1,3,0,1,0,61.63
雲林縣,口湖鄉,梧南村,488,1,600,12,612,916,3,1,3,0,1,0,66.81
雲林縣,口湖鄉,梧南村,489,1,559,7,566,950,3,1,3,0,1,0,59.58
雲林縣,口湖鄉,梧北村,490,1,782,9,791,1323,3,1,3,0,1,0,59.79
雲林縣,口湖鄉,水井村,491,1,635,12,647,1049,3,1,3,0,1,0,61.68
雲林縣,口湖鄉,後厝村,492,1,468,8,476,812,3,1,3,0,1,0,58.62
雲林縣,口湖鄉,湖口村,493,1,602,12,614,1036,3,1,3,0,1,0,59.27
雲林縣,口湖鄉,過港村,494,1,440,9,449,758,3,1,3,0,1,0,59.23
雲林縣,水林鄉,水北村,495,1,877,16,893,1380,3,1,3,0,1,0,64.71
雲林縣,水林鄉,水北村,496,1,630,9,639,903,3,1,3,0,1,0,70.76
雲林縣,水林鄉,水南村,497,1,749,8,757,1100,3,1,3,0,1,0,68.82
雲林縣,水林鄉,水南村,498,1,483,7,490,791,3,1,3,0,1,0,61.95
雲林縣,水林鄉,萬興村,499,1,478,6,484,785,3,1,3,0,1,0,61.66
雲林縣,水林鄉,尖山村,500,1,441,16,457,765,3,1,3,0,1,0,59.74
雲林縣,水林鄉,大溝村,501,1,675,16,691,1083,3,1,3,0,1,0,63.80
雲林縣,水林鄉,順興村,502,1,532,13,545,948,3,1,3,0,1,0,57.49
雲林縣,水林鄉,大山村,503,1,708,14,722,1222,3,1,3,0,1,0,59.08
雲林縣,水林鄉,後寮村,504,1,483,9,492,808,3,1,3,0,1,0,60.89
雲林縣,水林鄉,春埔村,505,1,608,6,614,1067,3,1,3,0,1,0,57.54
雲林縣,水林鄉,西井村,506,1,433,12,445,770,3,1,3,0,1,0,57.79
雲林縣,水林鄉,車港村,507,1,416,4,420,693,3,1,3,0,1,0,60.61
雲林縣,水林鄉,蘇秦村,508,1,666,8,674,1235,3,1,3,0,1,0,54.57
雲林縣,水林鄉,灣東村,509,1,456,10,466,759,3,1,3,0,1,0,61.40
雲林縣,水林鄉,灣西村,510,1,651,9,660,1073,3,1,3,0,1,0,61.51
雲林縣,水林鄉,蕃薯村,511,1,658,9,667,1060,3,1,3,0,1,0,62.92
雲林縣,水林鄉,山腳村,512,1,555,14,569,904,3,1,3,0,1,0,62.94
雲林縣,水林鄉,松北村,513,1,899,9,908,1267,3,1,3,0,1,0,71.67
雲林縣,水林鄉,松中村,514,1,401,5,406,634,3,1,3,0,1,0,64.04
雲林縣,水林鄉,松西村,515,1,524,9,533,834,3,1,3,0,1,0,63.91
雲林縣,水林鄉,舊埔村,516,1,516,10,526,878,3,1,3,0,1,0,59.91
雲林縣,水林鄉,塭底村,517,1,440,7,447,811,3,1,3,0,1,0,55.12
雲林縣,水林鄉,海埔村,518,1,703,9,712,1099,3,1,3,0,1,0,64.79
雲林縣,水林鄉,土厝村,519,1,762,14,776,1269,3,1,3,0,1,0,61.15
雲林縣,水林鄉,溪墘村,520,1,539,8,547,826,3,1,3,0,1,0,66.22
嘉義縣,太保市,太保里,1,1,1100,28,1128,1704,3,1,3,0,1,0,66.20
嘉義縣,太保市,後庄里,2,1,298,7,305,486,3,1,3,0,1,0,62.76
嘉義縣,太保市,前潭里,3,1,895,14,909,1367,3,1,3,0,1,0,66.50
嘉義縣,太保市,後潭里,4,1,1009,23,1032,1503,3,1,3,0,1,0,68.66
嘉義縣,太保市,梅埔里,5,1,514,14,528,714,3,1,3,0,1,0,73.95
嘉義縣,太保市,梅埔里,6,1,266,3,269,368,3,1,3,0,1,0,73.10
嘉義縣,太保市,春珠里,7,1,560,17,577,804,3,1,3,0,1,0,71.77
嘉義縣,太保市,崙頂里,8,1,568,7,575,800,3,1,3,0,1,0,71.88
嘉義縣,太保市,安仁里,9,1,149,8,157,210,3,1,3,0,1,0,74.76
嘉義縣,太保市,安仁里,10,1,535,8,543,725,3,1,3,0,1,0,74.90
嘉義縣,太保市,東勢里,11,1,583,11,594,890,3,1,3,0,1,0,66.74
嘉義縣,太保市,新埤里,12,1,750,17,767,1183,3,1,3,0,1,0,64.84
嘉義縣,太保市,舊埤里,13,1,430,12,442,664,3,1,3,0,1,0,66.57
嘉義縣,太保市,舊埤里,14,1,638,7,645,1026,3,1,3,0,1,0,62.87
嘉義縣,太保市,田尾里,15,1,288,12,300,498,3,1,3,0,1,0,60.24
嘉義縣,太保市,田尾里,16,1,150,2,152,217,3,1,3,0,1,0,70.05
嘉義縣,太保市,港尾里,17,1,206,5,211,316,3,1,3,0,1,0,66.77
嘉義縣,太保市,港尾里,18,1,156,2,158,260,3,1,3,0,1,0,60.77
嘉義縣,太保市,過溝里,19,1,388,7,395,593,3,1,3,0,1,0,66.61
嘉義縣,太保市,過溝里,20,1,850,26,876,1376,3,1,3,0,1,0,63.66
嘉義縣,太保市,麻寮里,21,1,913,26,939,1480,3,1,3,0,1,0,63.45
嘉義縣,太保市,麻寮里,22,1,691,15,706,1150,3,1,3,0,1,0,61.39
嘉義縣,太保市,南新里,23,1,1086,30,1116,1686,3,1,3,0,1,0,66.19
嘉義縣,太保市,北新里,24,1,645,16,661,1067,3,1,3,0,1,0,61.95
嘉義縣,太保市,北新里,25,1,625,11,636,1118,3,1,3,0,1,0,56.89
嘉義縣,太保市,埤鄉里,26,1,457,8,465,707,3,1,3,0,1,0,65.77
嘉義縣,朴子市,安福里,27,1,579,10,589,946,3,1,3,0,1,0,62.26
嘉義縣,朴子市,安福里,28,1,578,6,584,862,3,1,3,0,1,0,67.75
嘉義縣,朴子市,平和里,29,1,1224,16,1240,1827,3,1,3,0,1,0,67.87
嘉義縣,朴子市,內厝里,30,1,731,9,740,1103,3,1,3,0,1,0,67.09
嘉義縣,朴子市,開元里,31,1,326,3,329,503,3,1,3,0,1,0,65.41
嘉義縣,朴子市,順天里,32,1,464,5,469,754,3,1,3,0,1,0,62.20
嘉義縣,朴子市,中正里,33,1,535,4,539,758,3,1,3,0,1,0,71.11
嘉義縣,朴子市,博厚里,34,1,511,5,516,748,3,1,3,0,1,0,68.98
嘉義縣,朴子市,文化里,35,1,575,9,584,836,3,1,3,0,1,0,69.86
嘉義縣,朴子市,文化里,36,1,680,6,686,985,3,1,3,0,1,0,69.64
嘉義縣,朴子市,永和里,37,1,602,9,611,938,3,1,3,0,1,0,65.14
嘉義縣,朴子市,永和里,38,1,930,19,949,1497,3,1,3,0,1,0,63.39
嘉義縣,朴子市,竹圍里,39,1,1280,21,1301,2001,3,1,3,0,1,0,65.02
嘉義縣,朴子市,竹圍里,40,1,1099,10,1109,1648,3,1,3,0,1,0,67.29
嘉義縣,朴子市,新寮里,41,1,448,8,456,652,3,1,3,0,1,0,69.94
嘉義縣,朴子市,雙溪里,42,1,427,7,434,684,3,1,3,0,1,0,63.45
嘉義縣,朴子市,溪口里,43,1,545,14,559,810,3,1,3,0,1,0,69.01
嘉義縣,朴子市,德興里,44,1,726,8,734,1016,3,1,3,0,1,0,72.24
嘉義縣,朴子市,仁和里,45,1,398,7,405,571,3,1,3,0,1,0,70.93
嘉義縣,朴子市,大鄉里,46,1,914,13,927,1311,3,1,3,0,1,0,70.71
嘉義縣,朴子市,大鄉里,47,1,833,26,859,1261,3,1,3,0,1,0,68.12
嘉義縣,朴子市,大葛里,48,1,1137,36,1173,1710,3,1,3,0,1,0,68.60
嘉義縣,朴子市,佳禾里,49,1,393,6,399,596,3,1,3,0,1,0,66.95
嘉義縣,朴子市,竹村里,50,1,600,14,614,975,3,1,3,0,1,0,62.97
嘉義縣,朴子市,崁前里,51,1,649,20,669,989,3,1,3,0,1,0,67.64
嘉義縣,朴子市,崁後里,52,1,529,14,543,875,3,1,3,0,1,0,62.06
嘉義縣,朴子市,順安里,53,1,207,3,210,296,3,1,3,0,1,0,70.95
嘉義縣,朴子市,德家里,54,1,519,18,537,821,3,1,3,0,1,0,65.41
嘉義縣,朴子市,新庄里,55,1,375,7,382,597,3,1,3,0,1,0,63.99
嘉義縣,朴子市,梅華里,56,1,722,12,734,1153,3,1,3,0,1,0,63.66
嘉義縣,朴子市,松華里,57,1,910,17,927,1428,3,1,3,0,1,0,64.92
嘉義縣,朴子市,南竹里,58,1,364,3,367,561,3,1,3,0,1,0,65.42
嘉義縣,布袋鎮,岱江里,59,1,412,13,425,748,3,1,3,0,1,0,56.82
嘉義縣,布袋鎮,九龍里,60,1,268,4,272,438,3,1,3,0,1,0,62.10
嘉義縣,布袋鎮,岑海里,61,1,256,3,259,410,3,1,3,0,1,0,63.17
嘉義縣,布袋鎮,岑海里,62,1,762,9,771,1176,3,1,3,0,1,0,65.56
嘉義縣,布袋鎮,興中里,63,1,801,17,818,1285,3,1,3,0,1,0,63.66
嘉義縣,布袋鎮,光復里,64,1,711,6,717,1113,3,1,3,0,1,0,64.42
嘉義縣,布袋鎮,光復里,65,1,468,8,476,710,3,1,3,0,1,0,67.04
嘉義縣,布袋鎮,見龍里,66,1,565,9,574,925,3,1,3,0,1,0,62.05
嘉義縣,布袋鎮,新厝里,67,1,475,16,491,817,3,1,3,0,1,0,60.10
嘉義縣,布袋鎮,龍江里,68,1,532,12,544,849,3,1,3,0,1,0,64.08
嘉義縣,布袋鎮,西安里,69,1,912,12,924,1432,3,1,3,0,1,0,64.53
嘉義縣,布袋鎮,中安里,70,1,955,17,972,1599,3,1,3,0,1,0,60.79
嘉義縣,布袋鎮,東安里,71,1,945,11,956,1548,3,1,3,0,1,0,61.76
嘉義縣,布袋鎮,樹林里,72,1,211,4,215,306,3,1,3,0,1,0,70.26
嘉義縣,布袋鎮,樹林里,73,1,177,2,179,266,3,1,3,0,1,0,67.29
嘉義縣,布袋鎮,貴舍里,74,1,296,8,304,492,3,1,3,0,1,0,61.79
嘉義縣,布袋鎮,貴舍里,75,1,184,5,189,260,3,1,3,0,1,0,72.69
嘉義縣,布袋鎮,永安里,76,1,734,11,745,1192,3,1,3,0,1,0,62.50
嘉義縣,布袋鎮,東港里,77,1,581,11,592,949,3,1,3,0,1,0,62.38
嘉義縣,布袋鎮,東港里,78,1,599,11,610,983,3,1,3,0,1,0,62.05
嘉義縣,布袋鎮,江山里,79,1,235,8,243,362,3,1,3,0,1,0,67.13
嘉義縣,布袋鎮,菜舖里,80,1,125,1,126,213,3,1,3,0,1,0,59.15
嘉義縣,布袋鎮,菜舖里,81,1,160,3,163,252,3,1,3,0,1,0,64.68
嘉義縣,布袋鎮,考試里,82,1,80,2,82,133,3,1,3,0,1,0,61.65
嘉義縣,布袋鎮,考試里,83,1,130,1,131,217,3,1,3,0,1,0,60.37
嘉義縣,布袋鎮,振寮里,84,1,539,9,548,794,3,1,3,0,1,0,69.02
嘉義縣,布袋鎮,新岑里,85,1,654,10,664,1029,3,1,3,0,1,0,64.53
嘉義縣,布袋鎮,新民里,86,1,833,16,849,1236,3,1,3,0,1,0,68.69
嘉義縣,布袋鎮,復興里,87,1,732,15,747,1121,3,1,3,0,1,0,66.64
嘉義縣,布袋鎮,復興里,88,1,852,16,868,1308,3,1,3,0,1,0,66.36
嘉義縣,布袋鎮,好美里,89,1,717,20,737,1102,3,1,3,0,1,0,66.88
嘉義縣,大林鎮,東林里,90,1,314,5,319,500,3,1,3,0,1,0,63.80
嘉義縣,大林鎮,西林里,91,1,1173,12,1185,1906,3,1,3,0,1,0,62.17
嘉義縣,大林鎮,吉林里,92,1,609,10,619,988,3,1,3,0,1,0,62.65
嘉義縣,大林鎮,平林里,93,1,1103,14,1117,1722,3,1,3,0,1,0,64.87
嘉義縣,大林鎮,平林里,94,1,811,11,822,1323,3,1,3,0,1,0,62.13
嘉義縣,大林鎮,平林里,95,1,1069,16,1085,1777,3,1,3,0,1,0,61.06
嘉義縣,大林鎮,明華里,96,1,730,12,742,1146,3,1,3,0,1,0,64.75
嘉義縣,大林鎮,明和里,97,1,844,12,856,1340,3,1,3,0,1,0,63.88
嘉義縣,大林鎮,排路里,98,1,448,2,450,695,3,1,3,0,1,0,64.75
嘉義縣,大林鎮,西結里,99,1,496,9,505,838,3,1,3,0,1,0,60.26
嘉義縣,大林鎮,湖北里,100,1,473,15,488,684,3,1,3,0,1,0,71.35
嘉義縣,大林鎮,大糖里,101,1,191,8,199,319,3,1,3,0,1,0,62.38
嘉義縣,大林鎮,大美里,102,1,1107,25,1132,1748,3,1,3,0,1,0,64.76
嘉義縣,大林鎮,過溪里,103,1,937,35,972,1461,3,1,3,0,1,0,66.53
嘉義縣,大林鎮,中坑里,104,1,749,13,762,1101,3,1,3,0,1,0,69.21
嘉義縣,大林鎮,中坑里,105,1,261,5,266,427,3,1,3,0,1,0,62.30
嘉義縣,大林鎮,上林里,106,1,532,14,546,815,3,1,3,0,1,0,66.99
嘉義縣,大林鎮,中林里,107,1,1011,13,1024,1525,3,1,3,0,1,0,67.15
嘉義縣,大林鎮,三和里,108,1,1186,12,1198,1885,3,1,3,0,1,0,63.55
嘉義縣,大林鎮,溝背里,109,1,658,9,667,987,3,1,3,0,1,0,67.58
嘉義縣,大林鎮,義和里,110,1,489,6,495,693,3,1,3,0,1,0,71.43
嘉義縣,大林鎮,內林里,111,1,540,5,545,773,3,1,3,0,1,0,70.50
嘉義縣,大林鎮,三角里,112,1,679,14,693,1093,3,1,3,0,1,0,63.40
嘉義縣,大林鎮,三村里,113,1,492,8,500,754,3,1,3,0,1,0,66.31
嘉義縣,民雄鄉,東榮村,114,1,734,9,743,1080,3,1,3,0,1,0,68.80
嘉義縣,民雄鄉,東榮村,115,1,613,4,617,912,3,1,3,0,1,0,67.65
嘉義縣,民雄鄉,中樂村,116,1,1026,10,1036,1554,3,1,3,0,1,0,66.67
嘉義縣,民雄鄉,西安村,117,1,909,13,922,1471,3,1,3,0,1,0,62.68
嘉義縣,民雄鄉,西安村,118,1,992,11,1003,1492,3,1,3,0,1,0,67.23
嘉義縣,民雄鄉,寮頂村,119,1,655,10,665,940,3,1,3,0,1,0,70.74
嘉義縣,民雄鄉,寮頂村,120,1,633,6,639,1021,3,1,3,0,1,0,62.59
嘉義縣,民雄鄉,福權村,121,1,852,12,864,1258,3,1,3,0,1,0,68.68
嘉義縣,民雄鄉,東湖村,122,1,1210,17,1227,1799,3,1,3,0,1,0,68.20
嘉義縣,民雄鄉,頂崙村,123,1,834,13,847,1321,3,1,3,0,1,0,64.12
嘉義縣,民雄鄉,菁埔村,124,1,1159,22,1181,1629,3,1,3,0,1,0,72.50
嘉義縣,民雄鄉,中和村,125,1,479,0,479,731,3,1,3,0,1,0,65.53
嘉義縣,民雄鄉,平和村,126,1,485,7,492,734,3,1,3,0,1,0,67.03
嘉義縣,民雄鄉,西昌村,127,1,500,11,511,776,3,1,3,0,1,0,65.85
嘉義縣,民雄鄉,豐收村,128,1,922,18,940,1454,3,1,3,0,1,0,64.65
嘉義縣,民雄鄉,豐收村,129,1,286,3,289,402,3,1,3,0,1,0,71.89
嘉義縣,民雄鄉,三興村,130,1,519,8,527,827,3,1,3,0,1,0,63.72
嘉義縣,民雄鄉,東興村,131,1,348,4,352,584,3,1,3,0,1,0,60.27
嘉義縣,民雄鄉,鎮北村,132,1,553,10,563,880,3,1,3,0,1,0,63.98
嘉義縣,民雄鄉,北斗村,133,1,1274,11,1285,1901,3,1,3,0,1,0,67.60
嘉義縣,民雄鄉,北斗村,134,1,447,11,458,716,3,1,3,0,1,0,63.97
嘉義縣,民雄鄉,北斗村,135,1,334,8,342,451,3,1,3,0,1,0,75.83
嘉義縣,民雄鄉,雙福村,136,1,1063,14,1077,1692,3,1,3,0,1,0,63.65
嘉義縣,民雄鄉,福樂村,137,1,1460,17,1477,2390,3,1,3,0,1,0,61.80
嘉義縣,民雄鄉,福樂村,138,1,902,17,919,1449,3,1,3,0,1,0,63.42
嘉義縣,民雄鄉,大崎村,139,1,593,12,605,953,3,1,3,0,1,0,63.48
嘉義縣,民雄鄉,大崎村,140,1,637,10,647,1025,3,1,3,0,1,0,63.12
嘉義縣,民雄鄉,秀林村,141,1,1269,19,1288,2092,3,1,3,0,1,0,61.57
嘉義縣,民雄鄉,松山村,142,1,913,13,926,1588,3,1,3,0,1,0,58.31
嘉義縣,民雄鄉,興中村,143,1,1090,24,1114,1694,3,1,3,0,1,0,65.76
嘉義縣,民雄鄉,興南村,144,1,697,17,714,1149,3,1,3,0,1,0,62.14
嘉義縣,民雄鄉,興南村,145,1,531,9,540,1003,3,1,3,0,1,0,53.84
嘉義縣,民雄鄉,金興村,146,1,723,11,734,1139,3,1,3,0,1,0,64.44
嘉義縣,民雄鄉,金興村,147,1,801,22,823,1360,3,1,3,0,1,0,60.51
嘉義縣,民雄鄉,福興村,148,1,1066,22,1088,1667,3,1,3,0,1,0,65.27
嘉義縣,民雄鄉,文隆村,149,1,1216,26,1242,1945,3,1,3,0,1,0,63.86
嘉義縣,民雄鄉,山中村,150,1,1155,17,1172,1632,3,1,3,0,1,0,71.81
嘉義縣,民雄鄉,山中村,151,1,1095,22,1117,1738,3,1,3,0,1,0,64.27
嘉義縣,民雄鄉,中央村,152,1,779,9,788,1203,3,1,3,0,1,0,65.50
嘉義縣,溪口鄉,溪東村,153,1,882,11,893,1383,3,1,3,0,1,0,64.57
嘉義縣,溪口鄉,溪西村,154,1,479,5,484,738,3,1,3,0,1,0,65.58
嘉義縣,溪口鄉,溪北村,155,1,234,9,243,413,3,1,3,0,1,0,58.84
嘉義縣,溪口鄉,溪北村,156,1,197,2,199,307,3,1,3,0,1,0,64.82
嘉義縣,溪口鄉,柴林村,157,1,542,6,548,848,3,1,3,0,1,0,64.62
嘉義縣,溪口鄉,林腳村,158,1,584,12,596,880,3,1,3,0,1,0,67.73
嘉義縣,溪口鄉,美南村,159,1,784,10,794,1246,3,1,3,0,1,0,63.72
嘉義縣,溪口鄉,美北村,160,1,624,5,629,984,3,1,3,0,1,0,63.92
嘉義縣,溪口鄉,本厝村,161,1,380,4,384,571,3,1,3,0,1,0,67.25
嘉義縣,溪口鄉,本厝村,162,1,308,6,314,406,3,1,3,0,1,0,77.34
嘉義縣,溪口鄉,游東村,163,1,646,8,654,1108,3,1,3,0,1,0,59.03
嘉義縣,溪口鄉,游西村,164,1,460,8,468,785,3,1,3,0,1,0,59.62
嘉義縣,溪口鄉,柳溝村,165,1,621,11,632,906,3,1,3,0,1,0,69.76
嘉義縣,溪口鄉,柳溝村,166,1,251,4,255,373,3,1,3,0,1,0,68.36
嘉義縣,溪口鄉,疊溪村,167,1,598,7,605,997,3,1,3,0,1,0,60.68
嘉義縣,溪口鄉,妙崙村,168,1,442,7,449,736,3,1,3,0,1,0,61.01
嘉義縣,溪口鄉,坪頂村,169,1,600,15,615,900,3,1,3,0,1,0,68.33
嘉義縣,新港鄉,宮前村,170,1,531,5,536,843,3,1,3,0,1,0,63.58
嘉義縣,新港鄉,宮前村,171,1,583,8,591,873,3,1,3,0,1,0,67.70
嘉義縣,新港鄉,宮後村,172,1,496,6,502,815,3,1,3,0,1,0,61.60
嘉義縣,新港鄉,宮後村,173,1,523,9,532,859,3,1,3,0,1,0,61.93
嘉義縣,新港鄉,大興村,174,1,834,15,849,1408,3,1,3,0,1,0,60.30
嘉義縣,新港鄉,福德村,175,1,882,15,897,1471,3,1,3,0,1,0,60.98
嘉義縣,新港鄉,古民村,176,1,689,7,696,1186,3,1,3,0,1,0,58.68
嘉義縣,新港鄉,中庄村,177,1,495,4,499,793,3,1,3,0,1,0,62.93
嘉義縣,新港鄉,中庄村,178,1,438,9,447,737,3,1,3,0,1,0,60.65
嘉義縣,新港鄉,大潭村,179,1,441,7,448,735,3,1,3,0,1,0,60.95
嘉義縣,新港鄉,大潭村,180,1,580,8,588,870,3,1,3,0,1,0,67.59
嘉義縣,新港鄉,西庄村,181,1,591,8,599,968,3,1,3,0,1,0,61.88
嘉義縣,新港鄉,月眉村,182,1,507,5,512,862,3,1,3,0,1,0,59.40
嘉義縣,新港鄉,月眉村,183,1,535,10,545,820,3,1,3,0,1,0,66.46
嘉義縣,新港鄉,月潭村,184,1,906,14,920,1457,3,1,3,0,1,0,63.14
嘉義縣,新港鄉,溪北村,185,1,848,18,866,1419,3,1,3,0,1,0,61.03
嘉義縣,新港鄉,菜公村,186,1,541,7,548,891,3,1,3,0,1,0,61.50
嘉義縣,新港鄉,中洋村,187,1,620,9,629,1021,3,1,3,0,1,0,61.61
嘉義縣,新港鄉,三間村,188,1,543,15,558,911,3,1,3,0,1,0,61.25
嘉義縣,新港鄉,安和村,189,1,680,16,696,1109,3,1,3,0,1,0,62.76
嘉義縣,新港鄉,潭大村,190,1,660,14,674,1135,3,1,3,0,1,0,59.38
嘉義縣,新港鄉,南港村,191,1,626,6,632,1089,3,1,3,0,1,0,58.03
嘉義縣,新港鄉,板頭村,192,1,391,3,394,594,3,1,3,0,1,0,66.33
嘉義縣,新港鄉,共和村,193,1,479,5,484,834,3,1,3,0,1,0,58.03
嘉義縣,新港鄉,埤子村,194,1,370,8,378,591,3,1,3,0,1,0,63.96
嘉義縣,新港鄉,南崙村,195,1,604,10,614,936,3,1,3,0,1,0,65.60
嘉義縣,新港鄉,北崙村,196,1,326,8,334,604,3,1,3,0,1,0,55.30
嘉義縣,新港鄉,海瀛村,197,1,324,7,331,501,3,1,3,0,1,0,66.07
嘉義縣,六腳鄉,蒜頭村,198,1,832,7,839,1292,3,1,3,0,1,0,64.94
嘉義縣,六腳鄉,蒜東村,199,1,532,15,547,950,3,1,3,0,1,0,57.58
嘉義縣,六腳鄉,蒜南村,200,1,553,12,565,877,3,1,3,0,1,0,64.42
嘉義縣,六腳鄉,工廠村,201,1,210,4,214,317,3,1,3,0,1,0,67.51
嘉義縣,六腳鄉,灣南村,202,1,777,15,792,1261,3,1,3,0,1,0,62.81
嘉義縣,六腳鄉,灣北村,203,1,777,18,795,1316,3,1,3,0,1,0,60.41
嘉義縣,六腳鄉,雙涵村,204,1,521,10,531,894,3,1,3,0,1,0,59.40
嘉義縣,六腳鄉,塗師村,205,1,449,8,457,740,3,1,3,0,1,0,61.76
嘉義縣,六腳鄉,三義村,206,1,333,10,343,604,3,1,3,0,1,0,56.79
嘉義縣,六腳鄉,三義村,207,1,96,2,98,193,3,1,3,0,1,0,50.78
嘉義縣,六腳鄉,正義村,208,1,145,1,146,252,3,1,3,0,1,0,57.94
嘉義縣,六腳鄉,正義村,209,1,172,2,174,305,3,1,3,0,1,0,57.05
嘉義縣,六腳鄉,正義村,210,1,237,3,240,392,3,1,3,0,1,0,61.22
嘉義縣,六腳鄉,正義村,211,1,337,3,340,493,3,1,3,0,1,0,68.97
嘉義縣,六腳鄉,溪厝村,212,1,368,10,378,634,3,1,3,0,1,0,59.62
嘉義縣,六腳鄉,港美村,213,1,475,8,483,770,3,1,3,0,1,0,62.73
嘉義縣,六腳鄉,豐美村,214,1,627,10,637,1065,3,1,3,0,1,0,59.81
嘉義縣,六腳鄉,六斗村,215,1,559,7,566,883,3,1,3,0,1,0,64.10
嘉義縣,六腳鄉,崙陽村,216,1,628,13,641,1033,3,1,3,0,1,0,62.05
嘉義縣,六腳鄉,蘇厝村,217,1,858,20,878,1431,3,1,3,0,1,0,61.36
嘉義縣,六腳鄉,竹本村,218,1,409,5,414,730,3,1,3,0,1,0,56.71
嘉義縣,六腳鄉,永賢村,219,1,319,6,325,573,3,1,3,0,1,0,56.72
嘉義縣,六腳鄉,魚寮村,220,1,411,7,418,807,3,1,3,0,1,0,51.80
嘉義縣,六腳鄉,潭墘村,221,1,508,15,523,961,3,1,3,0,1,0,54.42
嘉義縣,六腳鄉,六腳村,222,1,508,9,517,905,3,1,3,0,1,0,57.13
嘉義縣,六腳鄉,六南村,223,1,365,15,380,645,3,1,3,0,1,0,58.91
嘉義縣,六腳鄉,崩山村,224,1,483,8,491,812,3,1,3,0,1,0,60.47
嘉義縣,六腳鄉,古林村,225,1,523,10,533,872,3,1,3,0,1,0,61.12
嘉義縣,六腳鄉,更寮村,226,1,239,6,245,408,3,1,3,0,1,0,60.05
嘉義縣,六腳鄉,更寮村,227,1,106,7,113,217,3,1,3,0,1,0,52.07
嘉義縣,東石鄉,東石村,228,1,1138,28,1166,1726,3,1,3,0,1,0,67.56
嘉義縣,東石鄉,猿樹村,229,1,602,19,621,1001,3,1,3,0,1,0,62.04
嘉義縣,東石鄉,塭港村,230,1,997,23,1020,1564,3,1,3,0,1,0,65.22
嘉義縣,東石鄉,型厝村,231,1,985,19,1004,1475,3,1,3,0,1,0,68.07
嘉義縣,東石鄉,三家村,232,1,805,26,831,1247,3,1,3,0,1,0,66.64
嘉義縣,東石鄉,永屯村,233,1,482,13,495,724,3,1,3,0,1,0,68.37
嘉義縣,東石鄉,海埔村,234,1,279,3,282,461,3,1,3,0,1,0,61.17
嘉義縣,東石鄉,龍港村,235,1,591,12,603,1002,3,1,3,0,1,0,60.18
嘉義縣,東石鄉,副瀨村,236,1,661,14,675,1133,3,1,3,0,1,0,59.58
嘉義縣,東石鄉,下揖村,237,1,554,15,569,885,3,1,3,0,1,0,64.29
嘉義縣,東石鄉,頂揖村,238,1,117,2,119,187,3,1,3,0,1,0,63.64
嘉義縣,東石鄉,頂揖村,239,1,126,4,130,254,3,1,3,0,1,0,51.18
嘉義縣,東石鄉,溪下村,240,1,712,13,725,1113,3,1,3,0,1,0,65.14
嘉義縣,東石鄉,港口村,241,1,255,4,259,394,3,1,3,0,1,0,65.74
嘉義縣,東石鄉,鰲鼓村,242,1,763,18,781,1099,3,1,3,0,1,0,71.06
嘉義縣,東石鄉,鰲鼓村,243,1,209,10,219,313,3,1,3,0,1,0,69.97
嘉義縣,東石鄉,港墘村,244,1,869,14,883,1301,3,1,3,0,1,0,67.87
嘉義縣,東石鄉,蔦松村,245,1,614,27,641,933,3,1,3,0,1,0,68.70
嘉義縣,東石鄉,圍潭村,246,1,474,7,481,780,3,1,3,0,1,0,61.67
嘉義縣,東石鄉,洲仔村,247,1,633,19,652,966,3,1,3,0,1,0,67.49
嘉義縣,東石鄉,東崙村,248,1,236,7,243,387,3,1,3,0,1,0,62.79
嘉義縣,東石鄉,東崙村,249,1,253,5,258,412,3,1,3,0,1,0,62.62
嘉義縣,東石鄉,西崙村,250,1,661,15,676,1096,3,1,3,0,1,0,61.68
嘉義縣,東石鄉,塭仔村,251,1,731,15,746,1017,3,1,3,0,1,0,73.35
嘉義縣,東石鄉,網寮村,252,1,843,11,854,1304,3,1,3,0,1,0,65.49
嘉義縣,東石鄉,掌潭村,253,1,291,3,294,453,3,1,3,0,1,0,64.90
嘉義縣,東石鄉,掌潭村,254,1,283,2,285,373,3,1,3,0,1,0,76.41
嘉義縣,義竹鄉,岸腳村,255,1,644,19,663,898,3,1,3,0,1,0,73.83
嘉義縣,義竹鄉,義竹村,256,1,1158,27,1185,1608,3,1,3,0,1,0,73.69
嘉義縣,義竹鄉,六桂村,257,1,1042,21,1063,1451,3,1,3,0,1,0,73.26
嘉義縣,義竹鄉,仁里村,258,1,818,13,831,1033,3,1,3,0,1,0,80.45
嘉義縣,義竹鄉,傳芳村,259,1,508,23,531,767,3,1,3,0,1,0,69.23
嘉義縣,義竹鄉,頭竹村,260,1,1013,13,1026,1378,3,1,3,0,1,0,74.46
嘉義縣,義竹鄉,五厝村,261,1,288,7,295,437,3,1,3,0,1,0,67.51
嘉義縣,義竹鄉,中平村,262,1,260,9,269,367,3,1,3,0,1,0,73.30
嘉義縣,義竹鄉,中平村,263,1,89,4,93,133,3,1,3,0,1,0,69.92
嘉義縣,義竹鄉,埤前村,264,1,625,13,638,842,3,1,3,0,1,0,75.77
嘉義縣,義竹鄉,平溪村,265,1,324,7,331,464,3,1,3,0,1,0,71.34
嘉義縣,義竹鄉,後鎮村,266,1,366,8,374,527,3,1,3,0,1,0,70.97
嘉義縣,義竹鄉,北華村,267,1,412,11,423,612,3,1,3,0,1,0,69.12
嘉義縣,義竹鄉,新店村,268,1,1104,24,1128,1552,3,1,3,0,1,0,72.68
嘉義縣,義竹鄉,東過村,269,1,592,11,603,871,3,1,3,0,1,0,69.23
嘉義縣,義竹鄉,西過村,270,1,632,15,647,933,3,1,3,0,1,0,69.35
嘉義縣,義竹鄉,官和村,271,1,596,10,606,878,3,1,3,0,1,0,69.02
嘉義縣,義竹鄉,官順村,272,1,351,11,362,556,3,1,3,0,1,0,65.11
嘉義縣,義竹鄉,新富村,273,1,441,8,449,583,3,1,3,0,1,0,77.02
嘉義縣,義竹鄉,東光村,274,1,533,8,541,734,3,1,3,0,1,0,73.71
嘉義縣,義竹鄉,東光村,275,1,129,5,134,177,3,1,3,0,1,0,75.71
嘉義縣,義竹鄉,東榮村,276,1,337,5,342,517,3,1,3,0,1,0,66.15
嘉義縣,義竹鄉,龍蛟村,277,1,484,9,493,744,3,1,3,0,1,0,66.26
嘉義縣,義竹鄉,溪洲村,278,1,511,15,526,772,3,1,3,0,1,0,68.13
嘉義縣,鹿草鄉,後寮村,279,1,312,6,318,492,3,1,3,0,1,0,64.63
嘉義縣,鹿草鄉,鹿東村,280,1,452,7,459,646,3,1,3,0,1,0,71.05
嘉義縣,鹿草鄉,鹿草村,281,1,843,14,857,1315,3,1,3,0,1,0,65.17
嘉義縣,鹿草鄉,西井村,282,1,763,16,779,1150,3,1,3,0,1,0,67.74
嘉義縣,鹿草鄉,豐稠村,283,1,197,2,199,291,3,1,3,0,1,0,68.38
嘉義縣,鹿草鄉,豐稠村,284,1,83,3,86,139,3,1,3,0,1,0,61.87
嘉義縣,鹿草鄉,重寮村,285,1,683,9,692,1147,3,1,3,0,1,0,60.33
嘉義縣,鹿草鄉,施家村,286,1,304,7,311,528,3,1,3,0,1,0,58.90
嘉義縣,鹿草鄉,下潭村,287,1,551,6,557,905,3,1,3,0,1,0,61.55
嘉義縣,鹿草鄉,光潭村,288,1,685,10,695,1130,3,1,3,0,1,0,61.50
嘉義縣,鹿草鄉,碧潭村,289,1,644,21,665,1117,3,1,3,0,1,0,59.53
嘉義縣,鹿草鄉,松竹村,290,1,563,12,575,931,3,1,3,0,1,0,61.76
嘉義縣,鹿草鄉,竹山村,291,1,388,4,392,679,3,1,3,0,1,0,57.73
嘉義縣,鹿草鄉,竹山村,292,1,142,5,147,233,3,1,3,0,1,0,63.09
嘉義縣,鹿草鄉,後堀村,293,1,696,12,708,971,3,1,3,0,1,0,72.91
嘉義縣,鹿草鄉,後堀村,294,1,217,4,221,320,3,1,3,0,1,0,69.06
嘉義縣,鹿草鄉,三角村,295,1,789,25,814,1153,3,1,3,0,1,0,70.60
嘉義縣,鹿草鄉,三角村,296,1,264,7,271,387,3,1,3,0,1,0,70.03
嘉義縣,鹿草鄉,下麻村,297,1,197,5,202,295,3,1,3,0,1,0,68.47
嘉義縣,鹿草鄉,下麻村,298,1,201,1,202,283,3,1,3,0,1,0,71.38
嘉義縣,水上鄉,水上村,299,1,392,9,401,555,3,1,3,0,1,0,72.25
嘉義縣,水上鄉,水上村,300,1,521,7,528,755,3,1,3,0,1,0,69.93
嘉義縣,水上鄉,水上村,301,1,1066,16,1082,1646,3,1,3,0,1,0,65.74
嘉義縣,水上鄉,水頭村,302,1,1040,11,1051,1559,3,1,3,0,1,0,67.42
嘉義縣,水上鄉,水頭村,303,1,367,5,372,512,3,1,3,0,1,0,72.66
嘉義縣,水上鄉,粗溪村,304,1,687,26,713,1107,3,1,3,0,1,0,64.41
嘉義縣,水上鄉,粗溪村,305,1,265,5,270,367,3,1,3,0,1,0,73.57
嘉義縣,水上鄉,下寮村,306,1,273,9,282,455,3,1,3,0,1,0,61.98
嘉義縣,水上鄉,下寮村,307,1,705,10,715,1126,3,1,3,0,1,0,63.50
嘉義縣,水上鄉,三和村,308,1,668,18,686,1098,3,1,3,0,1,0,62.48
嘉義縣,水上鄉,三和村,309,1,470,8,478,665,3,1,3,0,1,0,71.88
嘉義縣,水上鄉,回歸村,310,1,471,12,483,664,3,1,3,0,1,0,72.74
嘉義縣,水上鄉,大堀村,311,1,360,6,366,501,3,1,3,0,1,0,73.05
嘉義縣,水上鄉,大堀村,312,1,403,6,409,558,3,1,3,0,1,0,73.30
嘉義縣,水上鄉,大堀村,313,1,269,1,270,352,3,1,3,0,1,0,76.70
嘉義縣,水上鄉,大崙村,314,1,1265,18,1283,1874,3,1,3,0,1,0,68.46
嘉義縣,水上鄉,塗溝村,315,1,576,15,591,823,3,1,3,0,1,0,71.81
嘉義縣,水上鄉,龍德村,316,1,1215,27,1242,1780,3,1,3,0,1,0,69.78
嘉義縣,水上鄉,溪洲村,317,1,731,12,743,1094,3,1,3,0,1,0,67.92
嘉義縣,水上鄉,三鎮村,318,1,440,9,449,616,3,1,3,0,1,0,72.89
嘉義縣,水上鄉,靖和村,319,1,396,5,401,531,3,1,3,0,1,0,75.52
嘉義縣,水上鄉,南和村,320,1,566,10,576,790,3,1,3,0,1,0,72.91
嘉義縣,水上鄉,南和村,321,1,279,6,285,448,3,1,3,0,1,0,63.62
嘉義縣,水上鄉,柳新村,322,1,901,18,919,1372,3,1,3,0,1,0,66.98
嘉義縣,水上鄉,柳新村,323,1,493,12,505,791,3,1,3,0,1,0,63.84
嘉義縣,水上鄉,柳林村,324,1,1095,21,1116,1770,3,1,3,0,1,0,63.05
嘉義縣,水上鄉,柳鄉村,325,1,1186,24,1210,1802,3,1,3,0,1,0,67.15
嘉義縣,水上鄉,內溪村,326,1,605,9,614,990,3,1,3,0,1,0,62.02
嘉義縣,水上鄉,寬士村,327,1,998,24,1022,1707,3,1,3,0,1,0,59.87
嘉義縣,水上鄉,寬士村,328,1,977,17,994,1758,3,1,3,0,1,0,56.54
嘉義縣,水上鄉,民生村,329,1,774,17,791,1292,3,1,3,0,1,0,61.22
嘉義縣,水上鄉,民生村,330,1,913,13,926,1540,3,1,3,0,1,0,60.13
嘉義縣,水上鄉,義興村,331,1,524,8,532,755,3,1,3,0,1,0,70.46
嘉義縣,水上鄉,中庄村,332,1,1165,25,1190,1822,3,1,3,0,1,0,65.31
嘉義縣,水上鄉,忠和村,333,1,1165,26,1191,1831,3,1,3,0,1,0,65.05
嘉義縣,水上鄉,南鄉村,334,1,545,15,560,801,3,1,3,0,1,0,69.91
嘉義縣,水上鄉,三界村,335,1,727,17,744,1055,3,1,3,0,1,0,70.52
嘉義縣,水上鄉,國姓村,336,1,769,17,786,1301,3,1,3,0,1,0,60.42
嘉義縣,中埔鄉,中埔村,337,1,997,21,1018,1606,3,1,3,0,1,0,63.39
嘉義縣,中埔鄉,塩舘村,338,1,561,11,572,816,3,1,3,0,1,0,70.10
嘉義縣,中埔鄉,龍門村,339,1,466,13,479,734,3,1,3,0,1,0,65.26
嘉義縣,中埔鄉,裕民村,340,1,524,7,531,850,3,1,3,0,1,0,62.47
嘉義縣,中埔鄉,金蘭村,341,1,792,9,801,1347,3,1,3,0,1,0,59.47
嘉義縣,中埔鄉,富收村,342,1,631,15,646,1043,3,1,3,0,1,0,61.94
嘉義縣,中埔鄉,富收村,343,1,862,10,872,1501,3,1,3,0,1,0,58.09
嘉義縣,中埔鄉,和睦村,344,1,664,16,680,1118,3,1,3,0,1,0,60.82
嘉義縣,中埔鄉,和睦村,345,1,874,13,887,1418,3,1,3,0,1,0,62.55
嘉義縣,中埔鄉,和美村,346,1,1087,14,1101,1728,3,1,3,0,1,0,63.72
嘉義縣,中埔鄉,和美村,347,1,944,11,955,1669,3,1,3,0,1,0,57.22
嘉義縣,中埔鄉,和美村,348,1,1205,15,1220,1901,3,1,3,0,1,0,64.18
嘉義縣,中埔鄉,和興村,349,1,1225,26,1251,2169,3,1,3,0,1,0,57.68
嘉義縣,中埔鄉,和興村,350,1,818,14,832,1496,3,1,3,0,1,0,55.61
嘉義縣,中埔鄉,和興村,351,1,634,22,656,1097,3,1,3,0,1,0,59.80
嘉義縣,中埔鄉,隆興村,352,1,1046,13,1059,1698,3,1,3,0,1,0,62.37
嘉義縣,中埔鄉,義仁村,353,1,847,7,854,1295,3,1,3,0,1,0,65.95
嘉義縣,中埔鄉,社口村,354,1,961,15,976,1588,3,1,3,0,1,0,61.46
嘉義縣,中埔鄉,社口村,355,1,289,3,292,472,3,1,3,0,1,0,61.86
嘉義縣,中埔鄉,灣潭村,356,1,662,12,674,1068,3,1,3,0,1,0,63.11
嘉義縣,中埔鄉,石硦村,357,1,567,6,573,876,3,1,3,0,1,0,65.41
嘉義縣,中埔鄉,石硦村,358,1,212,1,213,309,3,1,3,0,1,0,68.93
嘉義縣,中埔鄉,頂埔村,359,1,663,9,672,938,3,1,3,0,1,0,71.64
嘉義縣,中埔鄉,同仁村,360,1,812,10,822,1267,3,1,3,0,1,0,64.88
嘉義縣,中埔鄉,同仁村,361,1,414,4,418,674,3,1,3,0,1,0,62.02
嘉義縣,中埔鄉,深坑村,362,1,532,10,542,736,3,1,3,0,1,0,73.64
嘉義縣,中埔鄉,三層村,363,1,419,6,425,627,3,1,3,0,1,0,67.78
嘉義縣,中埔鄉,瑞豐村,364,1,498,4,502,707,3,1,3,0,1,0,71.00
嘉義縣,中埔鄉,沄水村,365,1,378,2,380,539,3,1,3,0,1,0,70.50
嘉義縣,中埔鄉,沄水村,366,1,376,6,382,578,3,1,3,0,1,0,66.09
嘉義縣,中埔鄉,東興村,367,1,207,3,210,331,3,1,3,0,1,0,63.44
嘉義縣,中埔鄉,中崙村,368,1,234,0,234,323,3,1,3,0,1,0,72.45
嘉義縣,竹崎鄉,竹崎村,369,1,727,13,740,1157,3,1,3,0,1,0,63.96
嘉義縣,竹崎鄉,竹崎村,370,1,692,14,706,1043,3,1,3,0,1,0,67.69
嘉義縣,竹崎鄉,和平村,371,1,1153,23,1176,1866,3,1,3,0,1,0,63.02
嘉義縣,竹崎鄉,坑頭村,372,1,522,6,528,764,3,1,3,0,1,0,69.11
嘉義縣,竹崎鄉,沙坑村,373,1,587,6,593,868,3,1,3,0,1,0,68.32
嘉義縣,竹崎鄉,獅埜村,374,1,840,12,852,1293,3,1,3,0,1,0,65.89
嘉義縣,竹崎鄉,義和村,375,1,416,5,421,545,3,1,3,0,1,0,77.25
嘉義縣,竹崎鄉,義仁村,376,1,652,4,656,1049,3,1,3,0,1,0,62.54
嘉義縣,竹崎鄉,灣橋村,377,1,753,9,762,1174,3,1,3,0,1,0,64.91
嘉義縣,竹崎鄉,灣橋村,378,1,1095,12,1107,1788,3,1,3,0,1,0,61.91
嘉義縣,竹崎鄉,灣橋村,379,1,981,21,1002,1679,3,1,3,0,1,0,59.68
嘉義縣,竹崎鄉,鹿滿村,380,1,802,14,816,1265,3,1,3,0,1,0,64.51
嘉義縣,竹崎鄉,紫雲村,381,1,830,7,837,1296,3,1,3,0,1,0,64.58
嘉義縣,竹崎鄉,內埔村,382,1,1008,12,1020,1591,3,1,3,0,1,0,64.11
嘉義縣,竹崎鄉,昇平村,383,1,478,5,483,688,3,1,3,0,1,0,70.20
嘉義縣,竹崎鄉,昇平村,384,1,662,9,671,1036,3,1,3,0,1,0,64.77
嘉義縣,竹崎鄉,桃源村,385,1,474,9,483,705,3,1,3,0,1,0,68.51
嘉義縣,竹崎鄉,桃源村,386,1,246,1,247,363,3,1,3,0,1,0,68.04
嘉義縣,竹崎鄉,白杞村,387,1,470,10,480,773,3,1,3,0,1,0,62.10
嘉義縣,竹崎鄉,塘興村,388,1,334,4,338,518,3,1,3,0,1,0,65.25
嘉義縣,竹崎鄉,塘興村,389,1,264,2,266,386,3,1,3,0,1,0,68.91
嘉義縣,竹崎鄉,義隆村,390,1,403,4,407,586,3,1,3,0,1,0,69.45
嘉義縣,竹崎鄉,龍山村,391,1,156,0,156,244,3,1,3,0,1,0,63.93
嘉義縣,竹崎鄉,龍山村,392,1,917,9,926,1401,3,1,3,0,1,0,66.10
嘉義縣,竹崎鄉,文峯村,393,1,476,5,481,751,3,1,3,0,1,0,64.05
嘉義縣,竹崎鄉,金獅村,394,1,321,0,321,480,3,1,3,0,1,0,66.88
嘉義縣,竹崎鄉,復金村,395,1,616,9,625,924,3,1,3,0,1,0,67.64
嘉義縣,竹崎鄉,復金村,396,1,583,5,588,906,3,1,3,0,1,0,64.90
嘉義縣,竹崎鄉,緞繻村,397,1,557,8,565,890,3,1,3,0,1,0,63.48
嘉義縣,竹崎鄉,緞繻村,398,1,85,0,85,126,3,1,3,0,1,0,67.46
嘉義縣,竹崎鄉,仁壽村,399,1,163,2,165,298,3,1,3,0,1,0,55.37
嘉義縣,竹崎鄉,中和村,400,1,225,5,230,397,3,1,3,0,1,0,57.93
嘉義縣,竹崎鄉,中和村,401,1,275,5,280,383,3,1,3,0,1,0,73.11
嘉義縣,竹崎鄉,光華村,402,1,292,4,296,444,3,1,3,0,1,0,66.67
嘉義縣,竹崎鄉,光華村,403,1,169,1,170,300,3,1,3,0,1,0,56.67
嘉義縣,梅山鄉,梅東村,404,1,720,14,734,1130,3,1,3,0,1,0,64.96
嘉義縣,梅山鄉,梅東村,405,1,746,7,753,1241,3,1,3,0,1,0,60.68
嘉義縣,梅山鄉,梅南村,406,1,667,9,676,997,3,1,3,0,1,0,67.80
嘉義縣,梅山鄉,梅北村,407,1,751,6,757,1163,3,1,3,0,1,0,65.09
嘉義縣,梅山鄉,梅北村,408,1,781,15,796,1233,3,1,3,0,1,0,64.56
嘉義縣,梅山鄉,梅北村,409,1,817,7,824,1336,3,1,3,0,1,0,61.68
嘉義縣,梅山鄉,過山村,410,1,402,5,407,620,3,1,3,0,1,0,65.65
嘉義縣,梅山鄉,圳南村,411,1,325,4,329,501,3,1,3,0,1,0,65.67
嘉義縣,梅山鄉,圳北村,412,1,435,6,441,669,3,1,3,0,1,0,65.92
嘉義縣,梅山鄉,双溪村,413,1,433,1,434,573,3,1,3,0,1,0,75.74
嘉義縣,梅山鄉,大南村,414,1,1080,24,1104,1707,3,1,3,0,1,0,64.67
嘉義縣,梅山鄉,安靖村,415,1,541,5,546,934,3,1,3,0,1,0,58.46
嘉義縣,梅山鄉,永興村,416,1,292,7,299,503,3,1,3,0,1,0,59.44
嘉義縣,梅山鄉,半天村,417,1,281,3,284,456,3,1,3,0,1,0,62.28
嘉義縣,梅山鄉,太平村,418,1,315,4,319,497,3,1,3,0,1,0,64.19
嘉義縣,梅山鄉,太興村,419,1,278,6,284,395,3,1,3,0,1,0,71.90
嘉義縣,梅山鄉,龍眼村,420,1,264,6,270,478,3,1,3,0,1,0,56.49
嘉義縣,梅山鄉,碧湖村,421,1,187,0,187,291,3,1,3,0,1,0,64.26
嘉義縣,梅山鄉,瑞峯村,422,1,454,7,461,743,3,1,3,0,1,0,62.05
嘉義縣,梅山鄉,瑞里村,423,1,493,8,501,736,3,1,3,0,1,0,68.07
嘉義縣,梅山鄉,太和村,424,1,366,11,377,580,3,1,3,0,1,0,65.00
嘉義縣,梅山鄉,太和村,425,1,307,1,308,441,3,1,3,0,1,0,69.84
嘉義縣,番路鄉,江西村,426,1,669,13,682,994,3,1,3,0,1,0,68.61
嘉義縣,番路鄉,內甕村,427,1,236,4,240,389,3,1,3,0,1,0,61.70
嘉義縣,番路鄉,新福村,428,1,532,6,538,799,3,1,3,0,1,0,67.33
嘉義縣,番路鄉,下坑村,429,1,1011,24,1035,1604,3,1,3,0,1,0,64.53
嘉義縣,番路鄉,番路村,430,1,551,13,564,815,3,1,3,0,1,0,69.20
嘉義縣,番路鄉,民和村,431,1,466,13,479,773,3,1,3,0,1,0,61.97
嘉義縣,番路鄉,觸口村,432,1,595,10,605,834,3,1,3,0,1,0,72.54
嘉義縣,番路鄉,大湖村,433,1,462,4,466,821,3,1,3,0,1,0,56.76
嘉義縣,番路鄉,公田村,434,1,241,0,241,407,3,1,3,0,1,0,59.21
嘉義縣,番路鄉,公田村,435,1,326,15,341,542,3,1,3,0,1,0,62.92
嘉義縣,番路鄉,公興村,436,1,304,6,310,581,3,1,3,0,1,0,53.36
嘉義縣,番路鄉,草山村,437,1,105,1,106,164,3,1,3,0,1,0,64.63
嘉義縣,番路鄉,草山村,438,1,135,1,136,230,3,1,3,0,1,0,59.13
嘉義縣,大埔鄉,大埔村,439,1,568,9,577,1043,3,1,3,0,1,0,55.32
嘉義縣,大埔鄉,和平村,440,1,131,3,134,243,3,1,3,0,1,0,55.14
嘉義縣,大埔鄉,和平村,441,1,132,2,134,227,3,1,3,0,1,0,59.03
嘉義縣,大埔鄉,永樂村,442,1,116,3,119,173,3,1,3,0,1,0,68.79
嘉義縣,大埔鄉,永樂村,443,1,121,1,122,169,3,1,3,0,1,0,72.19
嘉義縣,大埔鄉,茄苳村,444,1,209,3,212,361,3,1,3,0,1,0,58.73
嘉義縣,大埔鄉,茄苳村,445,1,92,2,94,155,3,1,3,0,1,0,60.65
嘉義縣,大埔鄉,茄苳村,446,1,103,1,104,244,3,1,3,0,1,0,42.62
嘉義縣,大埔鄉,西興村,447,1,204,0,204,368,3,1,3,0,1,0,55.43
嘉義縣,阿里山鄉,中山村,448,1,187,4,191,333,3,1,3,0,1,0,57.36
嘉義縣,阿里山鄉,中正村,449,1,95,1,96,163,3,1,3,0,1,0,58.90
嘉義縣,阿里山鄉,香林村,450,1,102,1,103,216,3,1,3,0,1,0,47.69
嘉義縣,阿里山鄉,十字村,451,1,120,3,123,227,3,1,3,0,1,0,54.19
嘉義縣,阿里山鄉,十字村,452,1,29,2,31,72,3,1,3,0,1,0,43.06
嘉義縣,阿里山鄉,豐山村,453,1,165,3,168,254,3,1,3,0,1,0,66.14
嘉義縣,阿里山鄉,來吉村,454,1,17,1,18,25,3,1,3,0,1,0,72.00
嘉義縣,阿里山鄉,樂野村,455,1,170,5,175,254,3,1,3,0,1,0,68.90
嘉義縣,阿里山鄉,達邦村,456,1,59,0,59,116,3,1,3,0,1,0,50.86
嘉義縣,阿里山鄉,里佳村,457,1,6,0,6,18,3,1,3,0,1,0,33.33
嘉義縣,阿里山鄉,山美村,458,1,9,2,11,26,3,1,3,0,1,0,42.31
嘉義縣,阿里山鄉,新美村,459,1,10,0,10,22,3,1,3,0,1,0,45.45
嘉義縣,阿里山鄉,茶山村,460,1,56,1,57,94,3,1,3,0,1,0,60.64
臺南縣,新營市,忠政里,1,1,896,6,902,1419,3,1,3,0,1,0,63.57
臺南縣,新營市,忠政里,2,1,880,10,890,1333,3,1,3,0,1,0,66.77
臺南縣,新營市,忠政里,3,1,955,7,962,1481,3,1,3,0,1,0,64.96
臺南縣,新營市,民權里,4,1,791,6,797,1228,3,1,3,0,1,0,64.90
臺南縣,新營市,民權里,5,1,786,8,794,1220,3,1,3,0,1,0,65.08
臺南縣,新營市,三仙里,6,1,834,5,839,1317,3,1,3,0,1,0,63.71
臺南縣,新營市,三仙里,7,1,848,8,856,1367,3,1,3,0,1,0,62.62
臺南縣,新營市,好平里,8,1,518,6,524,900,3,1,3,0,1,0,58.22
臺南縣,新營市,延平里,9,1,783,10,793,1260,3,1,3,0,1,0,62.94
臺南縣,新營市,永生里,10,1,651,7,658,966,3,1,3,0,1,0,68.12
臺南縣,新營市,大宏里,11,1,620,9,629,1060,3,1,3,0,1,0,59.34
臺南縣,新營市,大宏里,12,1,624,7,631,998,3,1,3,0,1,0,63.23
臺南縣,新營市,大宏里,13,1,719,7,726,1174,3,1,3,0,1,0,61.84
臺南縣,新營市,王公里,14,1,742,8,750,1149,3,1,3,0,1,0,65.27
臺南縣,新營市,王公里,15,1,696,12,708,1182,3,1,3,0,1,0,59.90
臺南縣,新營市,王公里,16,1,752,9,761,1167,3,1,3,0,1,0,65.21
臺南縣,新營市,王公里,17,1,663,12,675,1061,3,1,3,0,1,0,63.62
臺南縣,新營市,王公里,18,1,950,9,959,1430,3,1,3,0,1,0,67.06
臺南縣,新營市,中營里,19,1,628,8,636,1010,3,1,3,0,1,0,62.97
臺南縣,新營市,土庫里,20,1,886,16,902,1422,3,1,3,0,1,0,63.43
臺南縣,新營市,興安里,21,1,309,4,313,470,3,1,3,0,1,0,66.60
臺南縣,新營市,南興里,22,1,783,10,793,1165,3,1,3,0,1,0,68.07
臺南縣,新營市,南興里,23,1,751,13,764,1241,3,1,3,0,1,0,61.56
臺南縣,新營市,興業里,24,1,979,5,984,1535,3,1,3,0,1,0,64.10
臺南縣,新營市,民生里,25,1,896,10,906,1490,3,1,3,0,1,0,60.81
臺南縣,新營市,民生里,26,1,905,10,915,1485,3,1,3,0,1,0,61.62
臺南縣,新營市,新北里,27,1,956,3,959,1526,3,1,3,0,1,0,62.84
臺南縣,新營市,新北里,28,1,1007,13,1020,1661,3,1,3,0,1,0,61.41
臺南縣,新營市,新南里,29,1,773,10,783,1181,3,1,3,0,1,0,66.30
臺南縣,新營市,新南里,30,1,774,9,783,1285,3,1,3,0,1,0,60.93
臺南縣,新營市,民榮里,31,1,637,11,648,1040,3,1,3,0,1,0,62.31
臺南縣,新營市,民榮里,32,1,698,14,712,1185,3,1,3,0,1,0,60.08
臺南縣,新營市,民榮里,33,1,958,13,971,1572,3,1,3,0,1,0,61.77
臺南縣,新營市,埤寮里,34,1,993,12,1005,1583,3,1,3,0,1,0,63.49
臺南縣,新營市,護鎮里,35,1,796,11,807,1239,3,1,3,0,1,0,65.13
臺南縣,新營市,太南里,36,1,889,14,903,1464,3,1,3,0,1,0,61.68
臺南縣,新營市,太北里,37,1,1007,16,1023,1508,3,1,3,0,1,0,67.84
臺南縣,新營市,南紙里,38,1,884,12,896,1356,3,1,3,0,1,0,66.08
臺南縣,新營市,南紙里,39,1,875,12,887,1435,3,1,3,0,1,0,61.81
臺南縣,新營市,嘉芳里,40,1,935,17,952,1466,3,1,3,0,1,0,64.94
臺南縣,新營市,舊埔里,41,1,232,1,233,359,3,1,3,0,1,0,64.90
臺南縣,新營市,角帶里,42,1,322,5,327,457,3,1,3,0,1,0,71.55
臺南縣,新營市,鐵線里,43,1,490,4,494,743,3,1,3,0,1,0,66.49
臺南縣,新營市,五興里,44,1,630,9,639,996,3,1,3,0,1,0,64.16
臺南縣,新營市,姑爺里,45,1,388,5,393,584,3,1,3,0,1,0,67.29
臺南縣,鹽水鎮,水秀里,46,1,536,7,543,878,3,1,3,0,1,0,61.85
臺南縣,鹽水鎮,水秀里,47,1,307,8,315,463,3,1,3,0,1,0,68.03
臺南縣,鹽水鎮,福得里,48,1,367,0,367,549,3,1,3,0,1,0,66.85
臺南縣,鹽水鎮,三生里,49,1,259,2,261,386,3,1,3,0,1,0,67.62
臺南縣,鹽水鎮,武廟里,50,1,378,4,382,556,3,1,3,0,1,0,68.71
臺南縣,鹽水鎮,中境里,51,1,376,3,379,541,3,1,3,0,1,0,70.06
臺南縣,鹽水鎮,水仙里,52,1,239,4,243,392,3,1,3,0,1,0,61.99
臺南縣,鹽水鎮,水正里,53,1,519,7,526,785,3,1,3,0,1,0,67.01
臺南縣,鹽水鎮,橋南里,54,1,402,8,410,682,3,1,3,0,1,0,60.12
臺南縣,鹽水鎮,橋南里,55,1,741,10,751,1205,3,1,3,0,1,0,62.32
臺南縣,鹽水鎮,橋南里,56,1,713,9,722,1231,3,1,3,0,1,0,58.65
臺南縣,鹽水鎮,舊營里,57,1,477,3,480,753,3,1,3,0,1,0,63.75
臺南縣,鹽水鎮,汫水里,58,1,611,10,621,1000,3,1,3,0,1,0,62.10
臺南縣,鹽水鎮,岸內里,59,1,602,7,609,1009,3,1,3,0,1,0,60.36
臺南縣,鹽水鎮,岸內里,60,1,773,10,783,1160,3,1,3,0,1,0,67.50
臺南縣,鹽水鎮,岸內里,61,1,708,8,716,1038,3,1,3,0,1,0,68.98
臺南縣,鹽水鎮,義稠里,62,1,414,1,415,696,3,1,3,0,1,0,59.63
臺南縣,鹽水鎮,下中里,63,1,483,11,494,787,3,1,3,0,1,0,62.77
臺南縣,鹽水鎮,歡雅里,64,1,560,3,563,854,3,1,3,0,1,0,65.93
臺南縣,鹽水鎮,歡雅里,65,1,480,5,485,766,3,1,3,0,1,0,63.32
臺南縣,鹽水鎮,大莊里,66,1,339,6,345,512,3,1,3,0,1,0,67.38
臺南縣,鹽水鎮,桐寮里,67,1,216,5,221,284,3,1,3,0,1,0,77.82
臺南縣,鹽水鎮,後宅里,68,1,420,8,428,702,3,1,3,0,1,0,60.97
臺南縣,鹽水鎮,孫厝里,69,1,298,5,303,497,3,1,3,0,1,0,60.97
臺南縣,鹽水鎮,竹埔里,70,1,562,8,570,805,3,1,3,0,1,0,70.81
臺南縣,鹽水鎮,下林里,71,1,288,4,292,437,3,1,3,0,1,0,66.82
臺南縣,鹽水鎮,田寮里,72,1,192,3,195,274,3,1,3,0,1,0,71.17
臺南縣,鹽水鎮,大豐里,73,1,277,4,281,375,3,1,3,0,1,0,74.93
臺南縣,鹽水鎮,飯店里,74,1,251,3,254,412,3,1,3,0,1,0,61.65
臺南縣,鹽水鎮,河南里,75,1,367,8,375,573,3,1,3,0,1,0,65.45
臺南縣,鹽水鎮,南港里,76,1,661,5,666,941,3,1,3,0,1,0,70.78
臺南縣,白河鎮,白河里,77,1,815,10,825,1266,3,1,3,0,1,0,65.17
臺南縣,白河鎮,白河里,78,1,397,5,402,610,3,1,3,0,1,0,65.90
臺南縣,白河鎮,永安里,79,1,952,10,962,1564,3,1,3,0,1,0,61.51
臺南縣,白河鎮,永安里,80,1,781,3,784,1188,3,1,3,0,1,0,65.99
臺南縣,白河鎮,外角里,81,1,910,13,923,1455,3,1,3,0,1,0,63.44
臺南縣,白河鎮,庄內里,82,1,964,11,975,1514,3,1,3,0,1,0,64.40
臺南縣,白河鎮,秀祐里,83,1,530,11,541,864,3,1,3,0,1,0,62.62
臺南縣,白河鎮,河東里,84,1,824,16,840,1369,3,1,3,0,1,0,61.36
臺南縣,白河鎮,虎山里,85,1,298,4,302,477,3,1,3,0,1,0,63.31
臺南縣,白河鎮,大林里,86,1,369,7,376,621,3,1,3,0,1,0,60.55
臺南縣,白河鎮,崁頭里,87,1,321,2,323,479,3,1,3,0,1,0,67.43
臺南縣,白河鎮,六溪里,88,1,362,9,371,658,3,1,3,0,1,0,56.38
臺南縣,白河鎮,關嶺里,89,1,721,7,728,1238,3,1,3,0,1,0,58.80
臺南縣,白河鎮,仙草里,90,1,441,5,446,737,3,1,3,0,1,0,60.52
臺南縣,白河鎮,仙草里,91,1,316,9,325,570,3,1,3,0,1,0,57.02
臺南縣,白河鎮,仙草里,92,1,368,30,398,693,3,1,3,0,1,0,57.43
臺南縣,白河鎮,玉豐里,93,1,827,11,838,1242,3,1,3,0,1,0,67.47
臺南縣,白河鎮,大竹里,94,1,876,14,890,1356,3,1,3,0,1,0,65.63
臺南縣,白河鎮,詔安里,95,1,602,10,612,883,3,1,3,0,1,0,69.31
臺南縣,白河鎮,廣安里,96,1,443,8,451,684,3,1,3,0,1,0,65.94
臺南縣,白河鎮,蓮潭里,97,1,612,10,622,904,3,1,3,0,1,0,68.81
臺南縣,白河鎮,竹門里,98,1,608,8,616,931,3,1,3,0,1,0,66.17
臺南縣,白河鎮,崎內里,99,1,512,8,520,781,3,1,3,0,1,0,66.58
臺南縣,白河鎮,昇安里,100,1,825,13,838,1275,3,1,3,0,1,0,65.73
臺南縣,白河鎮,汴頭里,101,1,507,9,516,751,3,1,3,0,1,0,68.71
臺南縣,白河鎮,內角里,102,1,496,9,505,785,3,1,3,0,1,0,64.33
臺南縣,白河鎮,草店里,103,1,609,7,616,936,3,1,3,0,1,0,65.81
臺南縣,白河鎮,甘宅里,104,1,416,5,421,675,3,1,3,0,1,0,62.37
臺南縣,柳營鄉,士林村,105,1,970,14,984,1481,3,1,3,0,1,0,66.44
臺南縣,柳營鄉,光福村,106,1,529,7,536,796,3,1,3,0,1,0,67.34
臺南縣,柳營鄉,光福村,107,1,666,4,670,945,3,1,3,0,1,0,70.90
臺南縣,柳營鄉,中埕村,108,1,482,7,489,702,3,1,3,0,1,0,69.66
臺南縣,柳營鄉,東昇村,109,1,794,19,813,1177,3,1,3,0,1,0,69.07
臺南縣,柳營鄉,東昇村,110,1,815,16,831,1251,3,1,3,0,1,0,66.43
臺南縣,柳營鄉,八翁村,111,1,867,4,871,1253,3,1,3,0,1,0,69.51
臺南縣,柳營鄉,人和村,112,1,309,4,313,466,3,1,3,0,1,0,67.17
臺南縣,柳營鄉,人和村,113,1,230,4,234,314,3,1,3,0,1,0,74.52
臺南縣,柳營鄉,太康村,114,1,567,5,572,760,3,1,3,0,1,0,75.26
臺南縣,柳營鄉,太康村,115,1,493,10,503,721,3,1,3,0,1,0,69.76
臺南縣,柳營鄉,重溪村,116,1,1063,15,1078,1486,3,1,3,0,1,0,72.54
臺南縣,柳營鄉,重溪村,117,1,222,1,223,297,3,1,3,0,1,0,75.08
臺南縣,柳營鄉,篤農村,118,1,924,13,937,1398,3,1,3,0,1,0,67.02
臺南縣,柳營鄉,大農村,119,1,465,4,469,666,3,1,3,0,1,0,70.42
臺南縣,柳營鄉,神農村,120,1,743,10,753,1175,3,1,3,0,1,0,64.09
臺南縣,柳營鄉,神農村,121,1,151,3,154,219,3,1,3,0,1,0,70.32
臺南縣,柳營鄉,果毅村,122,1,720,10,730,1086,3,1,3,0,1,0,67.22
臺南縣,柳營鄉,果毅村,123,1,114,2,116,156,3,1,3,0,1,0,74.36
臺南縣,柳營鄉,旭山村,124,1,626,10,636,972,3,1,3,0,1,0,65.43
臺南縣,柳營鄉,旭山村,125,1,331,1,332,495,3,1,3,0,1,0,67.07
臺南縣,柳營鄉,旭山村,126,1,134,1,135,196,3,1,3,0,1,0,68.88
臺南縣,後壁鄉,後壁村,127,1,464,10,474,699,3,1,3,0,1,0,67.81
臺南縣,後壁鄉,後壁村,128,1,549,5,554,809,3,1,3,0,1,0,68.48
臺南縣,後壁鄉,侯伯村,129,1,507,2,509,747,3,1,3,0,1,0,68.14
臺南縣,後壁鄉,侯伯村,130,1,358,4,362,535,3,1,3,0,1,0,67.66
臺南縣,後壁鄉,嘉苳村,131,1,653,8,661,1028,3,1,3,0,1,0,64.30
臺南縣,後壁鄉,嘉苳村,132,1,168,1,169,251,3,1,3,0,1,0,67.33
臺南縣,後壁鄉,土溝村,133,1,389,5,394,593,3,1,3,0,1,0,66.44
臺南縣,後壁鄉,土溝村,134,1,466,13,479,716,3,1,3,0,1,0,66.90
臺南縣,後壁鄉,嘉田村,135,1,787,12,799,1173,3,1,3,0,1,0,68.12
臺南縣,後壁鄉,嘉民村,136,1,813,7,820,1240,3,1,3,0,1,0,66.13
臺南縣,後壁鄉,菁豐村,137,1,481,8,489,806,3,1,3,0,1,0,60.67
臺南縣,後壁鄉,崁頂村,138,1,350,8,358,499,3,1,3,0,1,0,71.74
臺南縣,後壁鄉,後廍村,139,1,306,18,324,565,3,1,3,0,1,0,57.35
臺南縣,後壁鄉,墨林村,140,1,519,9,528,809,3,1,3,0,1,0,65.27
臺南縣,後壁鄉,菁寮村,141,1,305,1,306,450,3,1,3,0,1,0,68.00
臺南縣,後壁鄉,新嘉村,142,1,389,5,394,592,3,1,3,0,1,0,66.55
臺南縣,後壁鄉,新嘉村,143,1,354,6,360,547,3,1,3,0,1,0,65.81
臺南縣,後壁鄉,頂長村,144,1,351,4,355,538,3,1,3,0,1,0,65.99
臺南縣,後壁鄉,平安村,145,1,673,7,680,1046,3,1,3,0,1,0,65.01
臺南縣,後壁鄉,仕安村,146,1,367,4,371,568,3,1,3,0,1,0,65.32
臺南縣,後壁鄉,竹新村,147,1,724,9,733,1001,3,1,3,0,1,0,73.23
臺南縣,後壁鄉,竹新村,148,1,298,6,304,425,3,1,3,0,1,0,71.53
臺南縣,後壁鄉,新東村,149,1,454,6,460,662,3,1,3,0,1,0,69.49
臺南縣,後壁鄉,新東村,150,1,521,4,525,824,3,1,3,0,1,0,63.71
臺南縣,後壁鄉,頂安村,151,1,748,16,764,1195,3,1,3,0,1,0,63.93
臺南縣,後壁鄉,長安村,152,1,483,2,485,697,3,1,3,0,1,0,69.58
臺南縣,後壁鄉,長安村,153,1,444,6,450,673,3,1,3,0,1,0,66.86
臺南縣,後壁鄉,福安村,154,1,758,9,767,1147,3,1,3,0,1,0,66.87
臺南縣,後壁鄉,烏樹村,155,1,527,13,540,845,3,1,3,0,1,0,63.91
臺南縣,東山鄉,東山村,156,1,864,11,875,1459,3,1,3,0,1,0,59.97
臺南縣,東山鄉,東中村,157,1,749,4,753,1164,3,1,3,0,1,0,64.69
臺南縣,東山鄉,東中村,158,1,734,8,742,1163,3,1,3,0,1,0,63.80
臺南縣,東山鄉,東正村,159,1,952,14,966,1571,3,1,3,0,1,0,61.49
臺南縣,東山鄉,三榮村,160,1,595,9,604,945,3,1,3,0,1,0,63.92
臺南縣,東山鄉,大客村,161,1,656,4,660,1175,3,1,3,0,1,0,56.17
臺南縣,東山鄉,科里村,162,1,517,9,526,780,3,1,3,0,1,0,67.44
臺南縣,東山鄉,科里村,163,1,424,4,428,604,3,1,3,0,1,0,70.86
臺南縣,東山鄉,東河村,164,1,561,7,568,908,3,1,3,0,1,0,62.56
臺南縣,東山鄉,聖賢村,165,1,559,4,563,808,3,1,3,0,1,0,69.68
臺南縣,東山鄉,聖賢村,166,1,718,4,722,1066,3,1,3,0,1,0,67.73
臺南縣,東山鄉,南溪村,167,1,349,6,355,517,3,1,3,0,1,0,68.67
臺南縣,東山鄉,水雲村,168,1,280,1,281,499,3,1,3,0,1,0,56.31
臺南縣,東山鄉,林安村,169,1,249,3,252,396,3,1,3,0,1,0,63.64
臺南縣,東山鄉,東原村,170,1,582,7,589,986,3,1,3,0,1,0,59.74
臺南縣,東山鄉,東原村,171,1,782,7,789,1273,3,1,3,0,1,0,61.98
臺南縣,東山鄉,嶺南村,172,1,414,1,415,776,3,1,3,0,1,0,53.48
臺南縣,東山鄉,南勢村,173,1,668,4,672,1130,3,1,3,0,1,0,59.47
臺南縣,東山鄉,青山村,174,1,679,7,686,1116,3,1,3,0,1,0,61.47
臺南縣,東山鄉,高原村,175,1,584,3,587,949,3,1,3,0,1,0,61.85
臺南縣,麻豆鎮,穀興里,176,1,466,2,468,632,3,1,3,0,1,0,74.05
臺南縣,麻豆鎮,保安里,177,1,422,2,424,614,3,1,3,0,1,0,69.06
臺南縣,麻豆鎮,東角里,178,1,801,11,812,1112,3,1,3,0,1,0,73.02
臺南縣,麻豆鎮,東角里,179,1,612,1,613,910,3,1,3,0,1,0,67.36
臺南縣,麻豆鎮,晉江里,180,1,765,9,774,1108,3,1,3,0,1,0,69.86
臺南縣,麻豆鎮,晉江里,181,1,748,12,760,1187,3,1,3,0,1,0,64.03
臺南縣,麻豆鎮,巷口里,182,1,965,7,972,1393,3,1,3,0,1,0,69.78
臺南縣,麻豆鎮,中興里,183,1,624,3,627,933,3,1,3,0,1,0,67.20
臺南縣,麻豆鎮,中興里,184,1,618,6,624,932,3,1,3,0,1,0,66.95
臺南縣,麻豆鎮,興農里,185,1,915,14,929,1320,3,1,3,0,1,0,70.38
臺南縣,麻豆鎮,新建里,186,1,699,4,703,1013,3,1,3,0,1,0,69.40
臺南縣,麻豆鎮,油車里,187,1,950,11,961,1432,3,1,3,0,1,0,67.11
臺南縣,麻豆鎮,油車里,188,1,995,4,999,1450,3,1,3,0,1,0,68.90
臺南縣,麻豆鎮,北勢里,189,1,825,9,834,1151,3,1,3,0,1,0,72.46
臺南縣,麻豆鎮,大埕里,190,1,891,9,900,1359,3,1,3,0,1,0,66.23
臺南縣,麻豆鎮,大埕里,191,1,743,8,751,1079,3,1,3,0,1,0,69.60
臺南縣,麻豆鎮,總榮里,192,1,469,3,472,645,3,1,3,0,1,0,73.18
臺南縣,麻豆鎮,龍泉里,193,1,551,9,560,722,3,1,3,0,1,0,77.56
臺南縣,麻豆鎮,南勢里,194,1,465,7,472,675,3,1,3,0,1,0,69.93
臺南縣,麻豆鎮,南勢里,195,1,1082,13,1095,1570,3,1,3,0,1,0,69.75
臺南縣,麻豆鎮,寮廍里,196,1,1040,9,1049,1466,3,1,3,0,1,0,71.56
臺南縣,麻豆鎮,小埤里,197,1,662,6,668,912,3,1,3,0,1,0,73.25
臺南縣,麻豆鎮,埤頭里,198,1,966,14,980,1298,3,1,3,0,1,0,75.50
臺南縣,麻豆鎮,大山里,199,1,395,4,399,514,3,1,3,0,1,0,77.63
臺南縣,麻豆鎮,海埔里,200,1,739,6,745,977,3,1,3,0,1,0,76.25
臺南縣,麻豆鎮,莊禮里,201,1,404,3,407,537,3,1,3,0,1,0,75.79
臺南縣,麻豆鎮,港尾里,202,1,740,12,752,1104,3,1,3,0,1,0,68.12
臺南縣,麻豆鎮,麻口里,203,1,731,5,736,1021,3,1,3,0,1,0,72.09
臺南縣,麻豆鎮,安東里,204,1,433,4,437,602,3,1,3,0,1,0,72.59
臺南縣,麻豆鎮,安業里,205,1,464,4,468,673,3,1,3,0,1,0,69.54
臺南縣,麻豆鎮,安西里,206,1,496,6,502,710,3,1,3,0,1,0,70.70
臺南縣,麻豆鎮,謝安里,207,1,666,9,675,895,3,1,3,0,1,0,75.42
臺南縣,麻豆鎮,中民里,208,1,619,7,626,813,3,1,3,0,1,0,77.00
臺南縣,麻豆鎮,安正里,209,1,578,8,586,802,3,1,3,0,1,0,73.07
臺南縣,麻豆鎮,磚井里,210,1,818,12,830,1120,3,1,3,0,1,0,74.11
臺南縣,下營鄉,下營村,211,1,680,2,682,980,3,1,3,0,1,0,69.59
臺南縣,下營鄉,仁里村,212,1,877,10,887,1295,3,1,3,0,1,0,68.49
臺南縣,下營鄉,仁里村,213,1,840,8,848,1287,3,1,3,0,1,0,65.89
臺南縣,下營鄉,宅內村,214,1,756,10,766,1149,3,1,3,0,1,0,66.67
臺南縣,下營鄉,後街村,215,1,1032,14,1046,1514,3,1,3,0,1,0,69.09
臺南縣,下營鄉,新興村,216,1,692,8,700,1023,3,1,3,0,1,0,68.43
臺南縣,下營鄉,新興村,217,1,699,6,705,1056,3,1,3,0,1,0,66.76
臺南縣,下營鄉,營前村,218,1,710,4,714,1066,3,1,3,0,1,0,66.98
臺南縣,下營鄉,營前村,219,1,711,9,720,1073,3,1,3,0,1,0,67.10
臺南縣,下營鄉,大屯村,220,1,570,3,573,785,3,1,3,0,1,0,72.99
臺南縣,下營鄉,大埤村,221,1,550,10,560,766,3,1,3,0,1,0,73.11
臺南縣,下營鄉,茅港村,222,1,830,13,843,1189,3,1,3,0,1,0,70.90
臺南縣,下營鄉,中營村,223,1,790,10,800,1107,3,1,3,0,1,0,72.27
臺南縣,下營鄉,開化村,224,1,718,3,721,993,3,1,3,0,1,0,72.61
臺南縣,下營鄉,開化村,225,1,553,10,563,823,3,1,3,0,1,0,68.41
臺南縣,下營鄉,西連村,226,1,640,8,648,893,3,1,3,0,1,0,72.56
臺南縣,下營鄉,賀建村,227,1,883,9,892,1317,3,1,3,0,1,0,67.73
臺南縣,下營鄉,甲中村,228,1,836,10,846,1181,3,1,3,0,1,0,71.63
臺南縣,下營鄉,紅厝村,229,1,852,15,867,1245,3,1,3,0,1,0,69.64
臺南縣,六甲鄉,六甲村,230,1,956,13,969,1422,3,1,3,0,1,0,68.14
臺南縣,六甲鄉,六甲村,231,1,893,8,901,1325,3,1,3,0,1,0,68.00
臺南縣,六甲鄉,甲東村,232,1,856,12,868,1303,3,1,3,0,1,0,66.62
臺南縣,六甲鄉,甲東村,233,1,723,6,729,1160,3,1,3,0,1,0,62.84
臺南縣,六甲鄉,甲南村,234,1,900,7,907,1336,3,1,3,0,1,0,67.89
臺南縣,六甲鄉,龍湖村,235,1,696,6,702,1040,3,1,3,0,1,0,67.50
臺南縣,六甲鄉,七甲村,236,1,595,8,603,863,3,1,3,0,1,0,69.87
臺南縣,六甲鄉,二甲村,237,1,857,12,869,1304,3,1,3,0,1,0,66.64
臺南縣,六甲鄉,二甲村,238,1,992,16,1008,1495,3,1,3,0,1,0,67.42
臺南縣,六甲鄉,水林村,239,1,665,7,672,954,3,1,3,0,1,0,70.44
臺南縣,六甲鄉,水林村,240,1,606,12,618,902,3,1,3,0,1,0,68.51
臺南縣,六甲鄉,中社村,241,1,515,8,523,751,3,1,3,0,1,0,69.64
臺南縣,六甲鄉,中社村,242,1,515,9,524,800,3,1,3,0,1,0,65.50
臺南縣,六甲鄉,龜港村,243,1,737,12,749,1087,3,1,3,0,1,0,68.91
臺南縣,六甲鄉,菁埔村,244,1,392,6,398,583,3,1,3,0,1,0,68.27
臺南縣,六甲鄉,王爺村,245,1,565,6,571,881,3,1,3,0,1,0,64.81
臺南縣,六甲鄉,大丘村,246,1,476,7,483,736,3,1,3,0,1,0,65.63
臺南縣,官田鄉,官田村,247,1,635,9,644,953,3,1,3,0,1,0,67.58
臺南縣,官田鄉,官田村,248,1,630,9,639,972,3,1,3,0,1,0,65.74
臺南縣,官田鄉,二鎮村,249,1,835,5,840,1231,3,1,3,0,1,0,68.24
臺南縣,官田鄉,二鎮村,250,1,746,4,750,1105,3,1,3,0,1,0,67.87
臺南縣,官田鄉,湖山村,251,1,727,13,740,1040,3,1,3,0,1,0,71.15
臺南縣,官田鄉,嘉南村,252,1,204,4,208,316,3,1,3,0,1,0,65.82
臺南縣,官田鄉,大崎村,253,1,324,1,325,500,3,1,3,0,1,0,65.00
臺南縣,官田鄉,隆田村,254,1,606,7,613,905,3,1,3,0,1,0,67.73
臺南縣,官田鄉,隆田村,255,1,651,3,654,929,3,1,3,0,1,0,70.40
臺南縣,官田鄉,隆本村,256,1,497,9,506,797,3,1,3,0,1,0,63.49
臺南縣,官田鄉,隆本村,257,1,746,9,755,1018,3,1,3,0,1,0,74.17
臺南縣,官田鄉,隆本村,258,1,698,9,707,984,3,1,3,0,1,0,71.85
臺南縣,官田鄉,南廍村,259,1,711,12,723,1095,3,1,3,0,1,0,66.03
臺南縣,官田鄉,東庄村,260,1,1008,11,1019,1387,3,1,3,0,1,0,73.47
臺南縣,官田鄉,西庄村,261,1,474,7,481,671,3,1,3,0,1,0,71.68
臺南縣,官田鄉,拔林村,262,1,448,5,453,601,3,1,3,0,1,0,75.37
臺南縣,官田鄉,渡頭村,263,1,562,5,567,797,3,1,3,0,1,0,71.14
臺南縣,官田鄉,渡頭村,264,1,621,8,629,827,3,1,3,0,1,0,76.06
臺南縣,官田鄉,渡頭村,265,1,377,10,387,578,3,1,3,0,1,0,66.96
臺南縣,官田鄉,社子村,266,1,607,8,615,913,3,1,3,0,1,0,67.36
臺南縣,大內鄉,石湖村,267,1,725,11,736,1105,3,1,3,0,1,0,66.61
臺南縣,大內鄉,石林村,268,1,502,2,504,760,3,1,3,0,1,0,66.32
臺南縣,大內鄉,石城村,269,1,978,6,984,1524,3,1,3,0,1,0,64.57
臺南縣,大內鄉,內江村,270,1,746,12,758,1110,3,1,3,0,1,0,68.29
臺南縣,大內鄉,大內村,271,1,576,8,584,847,3,1,3,0,1,0,68.95
臺南縣,大內鄉,內郭村,272,1,434,6,440,690,3,1,3,0,1,0,63.77
臺南縣,大內鄉,頭社村,273,1,655,4,659,1057,3,1,3,0,1,0,62.35
臺南縣,大內鄉,環湖村,274,1,590,4,594,915,3,1,3,0,1,0,64.92
臺南縣,大內鄉,二溪村,275,1,557,9,566,954,3,1,3,0,1,0,59.33
臺南縣,大內鄉,曲溪村,276,1,454,1,455,650,3,1,3,0,1,0,70.00
臺南縣,佳里鎮,東寧里,277,1,601,8,609,887,3,1,3,0,1,0,68.66
臺南縣,佳里鎮,東寧里,278,1,630,5,635,921,3,1,3,0,1,0,68.95
臺南縣,佳里鎮,忠仁里,279,1,816,10,826,1194,3,1,3,0,1,0,69.18
臺南縣,佳里鎮,忠仁里,280,1,1004,12,1016,1443,3,1,3,0,1,0,70.41
臺南縣,佳里鎮,鎮山里,281,1,724,9,733,1049,3,1,3,0,1,0,69.88
臺南縣,佳里鎮,鎮山里,282,1,791,5,796,1130,3,1,3,0,1,0,70.44
臺南縣,佳里鎮,鎮山里,283,1,768,5,773,1079,3,1,3,0,1,0,71.64
臺南縣,佳里鎮,鎮山里,284,1,850,6,856,1296,3,1,3,0,1,0,66.05
臺南縣,佳里鎮,建南里,285,1,929,9,938,1384,3,1,3,0,1,0,67.77
臺南縣,佳里鎮,建南里,286,1,940,8,948,1377,3,1,3,0,1,0,68.85
臺南縣,佳里鎮,建南里,287,1,827,6,833,1214,3,1,3,0,1,0,68.62
臺南縣,佳里鎮,建南里,288,1,1122,15,1137,1704,3,1,3,0,1,0,66.73
臺南縣,佳里鎮,安西里,289,1,831,12,843,1245,3,1,3,0,1,0,67.71
臺南縣,佳里鎮,安西里,290,1,817,8,825,1202,3,1,3,0,1,0,68.64
臺南縣,佳里鎮,安西里,291,1,839,7,846,1277,3,1,3,0,1,0,66.25
臺南縣,佳里鎮,安西里,292,1,1008,11,1019,1534,3,1,3,0,1,0,66.43
臺南縣,佳里鎮,安西里,293,1,816,5,821,1147,3,1,3,0,1,0,71.58
臺南縣,佳里鎮,安西里,294,1,1203,13,1216,1865,3,1,3,0,1,0,65.20
臺南縣,佳里鎮,六安里,295,1,741,13,754,1021,3,1,3,0,1,0,73.85
臺南縣,佳里鎮,六安里,296,1,722,6,728,1053,3,1,3,0,1,0,69.14
臺南縣,佳里鎮,六安里,297,1,720,3,723,1039,3,1,3,0,1,0,69.59
臺南縣,佳里鎮,佳化里,298,1,673,8,681,941,3,1,3,0,1,0,72.37
臺南縣,佳里鎮,佳化里,299,1,650,11,661,892,3,1,3,0,1,0,74.10
臺南縣,佳里鎮,禮化里,300,1,634,4,638,848,3,1,3,0,1,0,75.24
臺南縣,佳里鎮,興化里,301,1,1059,9,1068,1339,3,1,3,0,1,0,79.76
臺南縣,佳里鎮,營頂里,302,1,491,2,493,691,3,1,3,0,1,0,71.35
臺南縣,佳里鎮,溪洲里,303,1,293,2,295,395,3,1,3,0,1,0,74.68
臺南縣,佳里鎮,海澄里,304,1,907,12,919,1355,3,1,3,0,1,0,67.82
臺南縣,佳里鎮,漳洲里,305,1,474,1,475,644,3,1,3,0,1,0,73.76
臺南縣,佳里鎮,頂廍里,306,1,588,10,598,830,3,1,3,0,1,0,72.05
臺南縣,佳里鎮,嘉福里,307,1,684,5,689,970,3,1,3,0,1,0,71.03
臺南縣,佳里鎮,通興里,308,1,757,10,767,1093,3,1,3,0,1,0,70.17
臺南縣,佳里鎮,蚶寮里,309,1,611,6,617,813,3,1,3,0,1,0,75.89
臺南縣,佳里鎮,龍安里,310,1,764,6,770,995,3,1,3,0,1,0,77.39
臺南縣,佳里鎮,民安里,311,1,894,11,905,1255,3,1,3,0,1,0,72.11
臺南縣,佳里鎮,子龍里,312,1,540,6,546,766,3,1,3,0,1,0,71.28
臺南縣,佳里鎮,子龍里,313,1,528,7,535,768,3,1,3,0,1,0,69.66
臺南縣,佳里鎮,三協里,314,1,593,6,599,863,3,1,3,0,1,0,69.41
臺南縣,學甲鎮,一秀里,315,1,467,6,473,710,3,1,3,0,1,0,66.62
臺南縣,學甲鎮,一秀里,316,1,330,2,332,467,3,1,3,0,1,0,71.09
臺南縣,學甲鎮,西明里,317,1,854,7,861,1307,3,1,3,0,1,0,65.88
臺南縣,學甲鎮,宜民里,318,1,350,4,354,503,3,1,3,0,1,0,70.38
臺南縣,學甲鎮,煥昌里,319,1,607,6,613,870,3,1,3,0,1,0,70.46
臺南縣,學甲鎮,慈生里,320,1,432,4,436,625,3,1,3,0,1,0,69.76
臺南縣,學甲鎮,仁得里,321,1,794,6,800,1186,3,1,3,0,1,0,67.45
臺南縣,學甲鎮,仁得里,322,1,709,4,713,1012,3,1,3,0,1,0,70.45
臺南縣,學甲鎮,仁得里,323,1,850,6,856,1326,3,1,3,0,1,0,64.56
臺南縣,學甲鎮,新生里,324,1,958,14,972,1481,3,1,3,0,1,0,65.63
臺南縣,學甲鎮,百福里,325,1,540,7,547,785,3,1,3,0,1,0,69.68
臺南縣,學甲鎮,百福里,326,1,373,2,375,537,3,1,3,0,1,0,69.83
臺南縣,學甲鎮,新榮里,327,1,439,5,444,641,3,1,3,0,1,0,69.27
臺南縣,學甲鎮,新榮里,328,1,483,5,488,768,3,1,3,0,1,0,63.54
臺南縣,學甲鎮,文化里,329,1,404,2,406,559,3,1,3,0,1,0,72.63
臺南縣,學甲鎮,大安里,330,1,363,1,364,521,3,1,3,0,1,0,69.87
臺南縣,學甲鎮,美豐里,331,1,566,3,569,834,3,1,3,0,1,0,68.23
臺南縣,學甲鎮,美和里,332,1,211,5,216,327,3,1,3,0,1,0,66.06
臺南縣,學甲鎮,達明里,333,1,446,6,452,662,3,1,3,0,1,0,68.28
臺南縣,學甲鎮,光明里,334,1,210,4,214,336,3,1,3,0,1,0,63.69
臺南縣,學甲鎮,民吉里,335,1,298,3,301,423,3,1,3,0,1,0,71.16
臺南縣,學甲鎮,西進里,336,1,324,3,327,505,3,1,3,0,1,0,64.75
臺南縣,學甲鎮,白渚里,337,1,217,1,218,332,3,1,3,0,1,0,65.66
臺南縣,學甲鎮,光華里,338,1,377,4,381,570,3,1,3,0,1,0,66.84
臺南縣,學甲鎮,光華里,339,1,210,0,210,315,3,1,3,0,1,0,66.67
臺南縣,學甲鎮,頭港里,340,1,291,2,293,444,3,1,3,0,1,0,65.99
臺南縣,學甲鎮,宅港里,341,1,694,5,699,1093,3,1,3,0,1,0,63.95
臺南縣,學甲鎮,平東里,342,1,332,7,339,505,3,1,3,0,1,0,67.13
臺南縣,學甲鎮,平西里,343,1,450,10,460,710,3,1,3,0,1,0,64.79
臺南縣,學甲鎮,頂洲里,344,1,467,4,471,684,3,1,3,0,1,0,68.86
臺南縣,學甲鎮,紅茄里,345,1,313,3,316,489,3,1,3,0,1,0,64.62
臺南縣,學甲鎮,新芳里,346,1,299,3,302,461,3,1,3,0,1,0,65.51
臺南縣,西港鄉,西港村,347,1,563,4,567,825,3,1,3,0,1,0,68.73
臺南縣,西港鄉,西港村,348,1,589,13,602,819,3,1,3,0,1,0,73.50
臺南縣,西港鄉,西港村,349,1,781,6,787,1100,3,1,3,0,1,0,71.55
臺南縣,西港鄉,慶安村,350,1,828,5,833,1223,3,1,3,0,1,0,68.11
臺南縣,西港鄉,慶安村,351,1,672,2,674,930,3,1,3,0,1,0,72.47
臺南縣,西港鄉,慶安村,352,1,906,8,914,1300,3,1,3,0,1,0,70.31
臺南縣,西港鄉,南海村,353,1,928,19,947,1284,3,1,3,0,1,0,73.75
臺南縣,西港鄉,南海村,354,1,476,5,481,626,3,1,3,0,1,0,76.84
臺南縣,西港鄉,港東村,355,1,671,4,675,929,3,1,3,0,1,0,72.66
臺南縣,西港鄉,港東村,356,1,268,5,273,382,3,1,3,0,1,0,71.47
臺南縣,西港鄉,檨林村,357,1,527,8,535,758,3,1,3,0,1,0,70.58
臺南縣,西港鄉,檨林村,358,1,566,13,579,804,3,1,3,0,1,0,72.01
臺南縣,西港鄉,後營村,359,1,922,10,932,1316,3,1,3,0,1,0,70.82
臺南縣,西港鄉,營西村,360,1,891,5,896,1285,3,1,3,0,1,0,69.73
臺南縣,西港鄉,金砂村,361,1,590,9,599,827,3,1,3,0,1,0,72.43
臺南縣,西港鄉,劉厝村,362,1,850,9,859,1152,3,1,3,0,1,0,74.57
臺南縣,西港鄉,竹林村,363,1,845,10,855,1171,3,1,3,0,1,0,73.01
臺南縣,西港鄉,永樂村,364,1,665,5,670,876,3,1,3,0,1,0,76.48
臺南縣,西港鄉,新復村,365,1,531,6,537,727,3,1,3,0,1,0,73.87
臺南縣,西港鄉,永樂村,366,1,284,4,288,407,3,1,3,0,1,0,70.76
臺南縣,七股鄉,後港村,367,1,370,5,375,537,3,1,3,0,1,0,69.83
臺南縣,七股鄉,大潭村,368,1,463,4,467,743,3,1,3,0,1,0,62.85
臺南縣,七股鄉,城內村,369,1,411,4,415,511,3,1,3,0,1,0,81.21
臺南縣,七股鄉,篤加村,370,1,548,9,557,817,3,1,3,0,1,0,68.18
臺南縣,七股鄉,頂山村,371,1,663,3,666,939,3,1,3,0,1,0,70.93
臺南縣,七股鄉,西寮村,372,1,375,6,381,550,3,1,3,0,1,0,69.27
臺南縣,七股鄉,鹽埕村,373,1,301,5,306,458,3,1,3,0,1,0,66.81
臺南縣,七股鄉,中寮村,374,1,544,11,555,784,3,1,3,0,1,0,70.79
臺南縣,七股鄉,龍山村,375,1,531,4,535,796,3,1,3,0,1,0,67.21
臺南縣,七股鄉,龍山村,376,1,620,15,635,884,3,1,3,0,1,0,71.83
臺南縣,七股鄉,溪南村,377,1,284,7,291,382,3,1,3,0,1,0,76.18
臺南縣,七股鄉,七股村,378,1,563,7,570,882,3,1,3,0,1,0,64.63
臺南縣,七股鄉,玉成村,379,1,550,5,555,822,3,1,3,0,1,0,67.52
臺南縣,七股鄉,大埕村,380,1,885,15,900,1359,3,1,3,0,1,0,66.23
臺南縣,七股鄉,大寮村,381,1,655,7,662,949,3,1,3,0,1,0,69.76
臺南縣,七股鄉,看坪村,382,1,363,5,368,580,3,1,3,0,1,0,63.45
臺南縣,七股鄉,樹林村,383,1,699,4,703,1026,3,1,3,0,1,0,68.52
臺南縣,七股鄉,竹港村,384,1,439,2,441,586,3,1,3,0,1,0,75.26
臺南縣,七股鄉,竹橋村,385,1,552,8,560,751,3,1,3,0,1,0,74.57
臺南縣,七股鄉,義合村,386,1,664,3,667,995,3,1,3,0,1,0,67.04
臺南縣,七股鄉,康榔村,387,1,462,12,474,641,3,1,3,0,1,0,73.95
臺南縣,七股鄉,永吉村,388,1,575,7,582,878,3,1,3,0,1,0,66.29
臺南縣,七股鄉,三股村,389,1,823,12,835,1170,3,1,3,0,1,0,71.37
臺南縣,七股鄉,三股村,390,1,402,27,429,639,3,1,3,0,1,0,67.14
臺南縣,七股鄉,十份村,391,1,881,12,893,1326,3,1,3,0,1,0,67.35
臺南縣,將軍鄉,長榮村,392,1,640,3,643,921,3,1,3,0,1,0,69.82
臺南縣,將軍鄉,西華村,393,1,892,6,898,1296,3,1,3,0,1,0,69.29
臺南縣,將軍鄉,西和村,394,1,716,12,728,1038,3,1,3,0,1,0,70.13
臺南縣,將軍鄉,忠興村,395,1,352,1,353,514,3,1,3,0,1,0,68.68
臺南縣,將軍鄉,忠興村,396,1,629,4,633,963,3,1,3,0,1,0,65.73
臺南縣,將軍鄉,嘉昌村,397,1,409,8,417,594,3,1,3,0,1,0,70.20
臺南縣,將軍鄉,嘉昌村,398,1,233,4,237,326,3,1,3,0,1,0,72.70
臺南縣,將軍鄉,保源村,399,1,426,4,430,582,3,1,3,0,1,0,73.88
臺南縣,將軍鄉,保源村,400,1,316,8,324,447,3,1,3,0,1,0,72.48
臺南縣,將軍鄉,苓和村,401,1,437,2,439,659,3,1,3,0,1,0,66.62
臺南縣,將軍鄉,苓和村,402,1,258,1,259,388,3,1,3,0,1,0,66.75
臺南縣,將軍鄉,仁和村,403,1,509,3,512,793,3,1,3,0,1,0,64.56
臺南縣,將軍鄉,北埔村,404,1,441,1,442,644,3,1,3,0,1,0,68.63
臺南縣,將軍鄉,將富村,405,1,450,5,455,718,3,1,3,0,1,0,63.37
臺南縣,將軍鄉,將貴村,406,1,254,4,258,390,3,1,3,0,1,0,66.15
臺南縣,將軍鄉,將貴村,407,1,161,1,162,219,3,1,3,0,1,0,73.97
臺南縣,將軍鄉,三吉村,408,1,301,1,302,426,3,1,3,0,1,0,70.89
臺南縣,將軍鄉,玉山村,409,1,577,7,584,895,3,1,3,0,1,0,65.25
臺南縣,將軍鄉,廣山村,410,1,476,7,483,715,3,1,3,0,1,0,67.55
臺南縣,將軍鄉,長沙村,411,1,512,2,514,789,3,1,3,0,1,0,65.15
臺南縣,將軍鄉,長沙村,412,1,386,11,397,655,3,1,3,0,1,0,60.61
臺南縣,將軍鄉,平沙村,413,1,810,5,815,1307,3,1,3,0,1,0,62.36
臺南縣,將軍鄉,鯤鯓村,414,1,557,4,561,859,3,1,3,0,1,0,65.31
臺南縣,將軍鄉,鯤鯓村,415,1,739,5,744,1162,3,1,3,0,1,0,64.03
臺南縣,將軍鄉,鯤溟村,416,1,610,8,618,1012,3,1,3,0,1,0,61.07
臺南縣,北門鄉,北門村,417,1,361,2,363,527,3,1,3,0,1,0,68.88
臺南縣,北門鄉,北門村,418,1,262,5,267,379,3,1,3,0,1,0,70.45
臺南縣,北門鄉,永隆村,419,1,347,2,349,509,3,1,3,0,1,0,68.57
臺南縣,北門鄉,永華村,420,1,268,7,275,405,3,1,3,0,1,0,67.90
臺南縣,北門鄉,玉港村,421,1,315,5,320,467,3,1,3,0,1,0,68.52
臺南縣,北門鄉,玉港村,422,1,207,2,209,318,3,1,3,0,1,0,65.72
臺南縣,北門鄉,保吉村,423,1,520,6,526,797,3,1,3,0,1,0,66.00
臺南縣,北門鄉,保吉村,424,1,364,1,365,537,3,1,3,0,1,0,67.97
臺南縣,北門鄉,東壁村,425,1,456,10,466,749,3,1,3,0,1,0,62.22
臺南縣,北門鄉,鯤江村,426,1,263,2,265,396,3,1,3,0,1,0,66.92
臺南縣,北門鄉,鯤江村,427,1,253,1,254,365,3,1,3,0,1,0,69.59
臺南縣,北門鄉,雙春村,428,1,383,3,386,594,3,1,3,0,1,0,64.98
臺南縣,北門鄉,錦湖村,429,1,679,7,686,1087,3,1,3,0,1,0,63.11
臺南縣,北門鄉,慈安村,430,1,424,6,430,653,3,1,3,0,1,0,65.85
臺南縣,北門鄉,三光村,431,1,424,4,428,644,3,1,3,0,1,0,66.46
臺南縣,北門鄉,三光村,432,1,343,3,346,512,3,1,3,0,1,0,67.58
臺南縣,北門鄉,中樞村,433,1,418,4,422,707,3,1,3,0,1,0,59.69
臺南縣,北門鄉,仁里村,434,1,482,6,488,712,3,1,3,0,1,0,68.54
臺南縣,新化鎮,武安里,435,1,492,3,495,707,3,1,3,0,1,0,70.01
臺南縣,新化鎮,武安里,436,1,616,7,623,895,3,1,3,0,1,0,69.61
臺南縣,新化鎮,東榮里,437,1,838,9,847,1316,3,1,3,0,1,0,64.36
臺南縣,新化鎮,東榮里,438,1,861,9,870,1285,3,1,3,0,1,0,67.70
臺南縣,新化鎮,東榮里,439,1,734,3,737,1114,3,1,3,0,1,0,66.16
臺南縣,新化鎮,護國里,440,1,528,7,535,787,3,1,3,0,1,0,67.98
臺南縣,新化鎮,護國里,441,1,505,15,520,818,3,1,3,0,1,0,63.57
臺南縣,新化鎮,太平里,442,1,685,8,693,1018,3,1,3,0,1,0,68.07
臺南縣,新化鎮,太平里,443,1,592,4,596,838,3,1,3,0,1,0,71.12
臺南縣,新化鎮,太平里,444,1,645,6,651,988,3,1,3,0,1,0,65.89
臺南縣,新化鎮,太平里,445,1,559,7,566,809,3,1,3,0,1,0,69.96
臺南縣,新化鎮,中央里,446,1,301,1,302,438,3,1,3,0,1,0,68.95
臺南縣,新化鎮,觀音里,447,1,430,2,432,633,3,1,3,0,1,0,68.25
臺南縣,新化鎮,竹林里,448,1,317,5,322,435,3,1,3,0,1,0,74.02
臺南縣,新化鎮,清水里,449,1,694,7,701,1008,3,1,3,0,1,0,69.54
臺南縣,新化鎮,協興里,450,1,583,7,590,837,3,1,3,0,1,0,70.49
臺南縣,新化鎮,協興里,451,1,717,13,730,1096,3,1,3,0,1,0,66.61
臺南縣,新化鎮,協興里,452,1,666,10,676,999,3,1,3,0,1,0,67.67
臺南縣,新化鎮,唪口里,453,1,517,8,525,783,3,1,3,0,1,0,67.05
臺南縣,新化鎮,唪口里,454,1,574,6,580,817,3,1,3,0,1,0,70.99
臺南縣,新化鎮,北勢里,455,1,546,1,547,726,3,1,3,0,1,0,75.34
臺南縣,新化鎮,北勢里,456,1,263,1,264,421,3,1,3,0,1,0,62.71
臺南縣,新化鎮,豐榮里,457,1,649,9,658,925,3,1,3,0,1,0,71.14
臺南縣,新化鎮,豐榮里,458,1,406,5,411,587,3,1,3,0,1,0,70.02
臺南縣,新化鎮,豐榮里,459,1,602,6,608,885,3,1,3,0,1,0,68.70
臺南縣,新化鎮,全興里,460,1,332,4,336,512,3,1,3,0,1,0,65.63
臺南縣,新化鎮,全興里,461,1,368,4,372,520,3,1,3,0,1,0,71.54
臺南縣,新化鎮,全興里,462,1,607,1,608,887,3,1,3,0,1,0,68.55
臺南縣,新化鎮,崙頂里,463,1,647,9,656,922,3,1,3,0,1,0,71.15
臺南縣,新化鎮,崙頂里,464,1,558,13,571,800,3,1,3,0,1,0,71.38
臺南縣,新化鎮,知義里,465,1,750,15,765,1034,3,1,3,0,1,0,73.98
臺南縣,新化鎮,知義里,466,1,664,20,684,1038,3,1,3,0,1,0,65.90
臺南縣,新化鎮,山腳里,467,1,861,5,866,1268,3,1,3,0,1,0,68.30
臺南縣,新化鎮,大坑里,468,1,337,5,342,499,3,1,3,0,1,0,68.54
臺南縣,新化鎮,那拔里,469,1,646,10,656,1000,3,1,3,0,1,0,65.60
臺南縣,新化鎮,那拔里,470,1,707,10,717,1002,3,1,3,0,1,0,71.56
臺南縣,新化鎮,羊林里,471,1,549,5,554,838,3,1,3,0,1,0,66.11
臺南縣,新化鎮,礁坑里,472,1,727,8,735,1042,3,1,3,0,1,0,70.54
臺南縣,善化鎮,東關里,473,1,620,4,624,926,3,1,3,0,1,0,67.39
臺南縣,善化鎮,坐駕里,474,1,812,15,827,1176,3,1,3,0,1,0,70.32
臺南縣,善化鎮,坐駕里,475,1,937,10,947,1388,3,1,3,0,1,0,68.23
臺南縣,善化鎮,光文里,476,1,750,16,766,1110,3,1,3,0,1,0,69.01
臺南縣,善化鎮,光文里,477,1,922,12,934,1417,3,1,3,0,1,0,65.91
臺南縣,善化鎮,光文里,478,1,995,10,1005,1442,3,1,3,0,1,0,69.69
臺南縣,善化鎮,文昌里,479,1,607,2,609,936,3,1,3,0,1,0,65.06
臺南縣,善化鎮,文昌里,480,1,751,5,756,1122,3,1,3,0,1,0,67.38
臺南縣,善化鎮,南關里,481,1,853,9,862,1306,3,1,3,0,1,0,66.00
臺南縣,善化鎮,西關里,482,1,439,7,446,663,3,1,3,0,1,0,67.27
臺南縣,善化鎮,北關里,483,1,324,3,327,470,3,1,3,0,1,0,69.57
臺南縣,善化鎮,文正里,484,1,761,12,773,1160,3,1,3,0,1,0,66.64
臺南縣,善化鎮,胡家里,485,1,966,12,978,1274,3,1,3,0,1,0,76.77
臺南縣,善化鎮,胡厝里,486,1,894,8,902,1238,3,1,3,0,1,0,72.86
臺南縣,善化鎮,胡厝里,487,1,414,23,437,607,3,1,3,0,1,0,71.99
臺南縣,善化鎮,什乃里,488,1,625,15,640,879,3,1,3,0,1,0,72.81
臺南縣,善化鎮,溪美里,489,1,626,6,632,890,3,1,3,0,1,0,71.01
臺南縣,善化鎮,溪美里,490,1,526,2,528,718,3,1,3,0,1,0,73.54
臺南縣,善化鎮,六分里,491,1,477,4,481,667,3,1,3,0,1,0,72.11
臺南縣,善化鎮,六德里,492,1,736,8,744,1070,3,1,3,0,1,0,69.53
臺南縣,善化鎮,田寮里,493,1,506,7,513,719,3,1,3,0,1,0,71.35
臺南縣,善化鎮,田寮里,494,1,724,9,733,1029,3,1,3,0,1,0,71.23
臺南縣,善化鎮,東隆里,495,1,633,9,642,860,3,1,3,0,1,0,74.65
臺南縣,善化鎮,東昌里,496,1,658,5,663,1006,3,1,3,0,1,0,65.90
臺南縣,善化鎮,牛庄里,497,1,917,13,930,1368,3,1,3,0,1,0,67.98
臺南縣,善化鎮,嘉北里,498,1,958,10,968,1351,3,1,3,0,1,0,71.65
臺南縣,善化鎮,嘉南里,499,1,692,6,698,1038,3,1,3,0,1,0,67.24
臺南縣,善化鎮,小新里,500,1,838,10,848,1237,3,1,3,0,1,0,68.55
臺南縣,善化鎮,小新里,501,1,932,12,944,1441,3,1,3,0,1,0,65.51
臺南縣,新市鄉,新市村,502,1,602,9,611,897,3,1,3,0,1,0,68.12
臺南縣,新市鄉,新市村,503,1,463,6,469,675,3,1,3,0,1,0,69.48
臺南縣,新市鄉,新市村,504,1,524,8,532,823,3,1,3,0,1,0,64.64
臺南縣,新市鄉,新和村,505,1,691,7,698,1028,3,1,3,0,1,0,67.90
臺南縣,新市鄉,新和村,506,1,717,7,724,1074,3,1,3,0,1,0,67.41
臺南縣,新市鄉,新和村,507,1,499,10,509,742,3,1,3,0,1,0,68.60
臺南縣,新市鄉,新和村,508,1,742,3,745,1091,3,1,3,0,1,0,68.29
臺南縣,新市鄉,新和村,509,1,792,14,806,1204,3,1,3,0,1,0,66.94
臺南縣,新市鄉,社內村,510,1,518,4,522,789,3,1,3,0,1,0,66.16
臺南縣,新市鄉,社內村,511,1,735,6,741,1017,3,1,3,0,1,0,72.86
臺南縣,新市鄉,大洲村,512,1,436,9,445,603,3,1,3,0,1,0,73.80
臺南縣,新市鄉,豐華村,513,1,571,7,578,881,3,1,3,0,1,0,65.61
臺南縣,新市鄉,三舍村,514,1,730,4,734,1003,3,1,3,0,1,0,73.18
臺南縣,新市鄉,大營村,515,1,714,7,721,1030,3,1,3,0,1,0,70.00
臺南縣,新市鄉,大營村,516,1,463,6,469,636,3,1,3,0,1,0,73.74
臺南縣,新市鄉,大營村,517,1,484,7,491,649,3,1,3,0,1,0,75.65
臺南縣,新市鄉,大社村,518,1,689,12,701,991,3,1,3,0,1,0,70.74
臺南縣,新市鄉,大社村,519,1,714,4,718,1050,3,1,3,0,1,0,68.38
臺南縣,新市鄉,大社村,520,1,813,12,825,1171,3,1,3,0,1,0,70.45
臺南縣,新市鄉,潭頂村,521,1,535,7,542,735,3,1,3,0,1,0,73.74
臺南縣,新市鄉,潭頂村,522,1,525,7,532,765,3,1,3,0,1,0,69.54
臺南縣,新市鄉,港墘村,523,1,509,10,519,745,3,1,3,0,1,0,69.66
臺南縣,新市鄉,港墘村,524,1,719,5,724,1063,3,1,3,0,1,0,68.11
臺南縣,新市鄉,港墘村,525,1,687,6,693,998,3,1,3,0,1,0,69.44
臺南縣,新市鄉,永就村,526,1,326,4,330,450,3,1,3,0,1,0,73.33
臺南縣,新市鄉,永就村,527,1,545,2,547,873,3,1,3,0,1,0,62.66
臺南縣,新市鄉,永就村,528,1,595,13,608,839,3,1,3,0,1,0,72.47
臺南縣,安定鄉,蘇林村,529,1,816,6,822,1178,3,1,3,0,1,0,69.78
臺南縣,安定鄉,蘇林村,530,1,600,12,612,852,3,1,3,0,1,0,71.83
臺南縣,安定鄉,蘇厝村,531,1,632,7,639,949,3,1,3,0,1,0,67.33
臺南縣,安定鄉,蘇厝村,532,1,549,7,556,801,3,1,3,0,1,0,69.41
臺南縣,安定鄉,安定村,533,1,958,8,966,1336,3,1,3,0,1,0,72.31
臺南縣,安定鄉,安加村,534,1,858,7,865,1150,3,1,3,0,1,0,75.22
臺南縣,安定鄉,保西村,535,1,547,7,554,718,3,1,3,0,1,0,77.16
臺南縣,安定鄉,港尾村,536,1,619,7,626,767,3,1,3,0,1,0,81.62
臺南縣,安定鄉,港尾村,537,1,581,8,589,734,3,1,3,0,1,0,80.25
臺南縣,安定鄉,中榮村,538,1,681,11,692,961,3,1,3,0,1,0,72.01
臺南縣,安定鄉,港口村,539,1,708,14,722,1014,3,1,3,0,1,0,71.20
臺南縣,安定鄉,港口村,540,1,818,8,826,1100,3,1,3,0,1,0,75.09
臺南縣,安定鄉,港南村,541,1,839,13,852,1195,3,1,3,0,1,0,71.30
臺南縣,安定鄉,港南村,542,1,677,9,686,953,3,1,3,0,1,0,71.98
臺南縣,安定鄉,大同村,543,1,470,7,477,643,3,1,3,0,1,0,74.18
臺南縣,安定鄉,六嘉村,544,1,917,10,927,1348,3,1,3,0,1,0,68.77
臺南縣,安定鄉,中沙村,545,1,496,2,498,697,3,1,3,0,1,0,71.45
臺南縣,安定鄉,新吉村,546,1,630,7,637,898,3,1,3,0,1,0,70.94
臺南縣,安定鄉,新吉村,547,1,581,13,594,812,3,1,3,0,1,0,73.15
臺南縣,安定鄉,海寮村,548,1,823,8,831,1090,3,1,3,0,1,0,76.24
臺南縣,安定鄉,海寮村,549,1,751,9,760,1078,3,1,3,0,1,0,70.50
臺南縣,安定鄉,管寮村,550,1,659,2,661,908,3,1,3,0,1,0,72.80
臺南縣,安定鄉,南安村,551,1,393,7,400,490,3,1,3,0,1,0,81.63
臺南縣,山上鄉,明和村,552,1,584,6,590,876,3,1,3,0,1,0,67.35
臺南縣,山上鄉,明和村,553,1,574,12,586,865,3,1,3,0,1,0,67.75
臺南縣,山上鄉,南洲村,554,1,527,4,531,736,3,1,3,0,1,0,72.15
臺南縣,山上鄉,南洲村,555,1,573,1,574,780,3,1,3,0,1,0,73.59
臺南縣,山上鄉,山上村,556,1,590,13,603,886,3,1,3,0,1,0,68.06
臺南縣,山上鄉,新莊村,557,1,491,5,496,746,3,1,3,0,1,0,66.49
臺南縣,山上鄉,玉峰村,558,1,387,5,392,576,3,1,3,0,1,0,68.06
臺南縣,山上鄉,平陽村,559,1,259,5,264,352,3,1,3,0,1,0,75.00
臺南縣,山上鄉,豐德村,560,1,236,3,239,354,3,1,3,0,1,0,67.51
臺南縣,玉井鄉,玉井村,561,1,641,4,645,914,3,1,3,0,1,0,70.57
臺南縣,玉井鄉,玉田村,562,1,897,8,905,1343,3,1,3,0,1,0,67.39
臺南縣,玉井鄉,玉田村,563,1,852,12,864,1321,3,1,3,0,1,0,65.40
臺南縣,玉井鄉,玉田村,564,1,928,11,939,1387,3,1,3,0,1,0,67.70
臺南縣,玉井鄉,中正村,565,1,890,12,902,1279,3,1,3,0,1,0,70.52
臺南縣,玉井鄉,竹圍村,566,1,875,4,879,1370,3,1,3,0,1,0,64.16
臺南縣,玉井鄉,沙田村,567,1,346,6,352,496,3,1,3,0,1,0,70.97
臺南縣,玉井鄉,三埔村,568,1,310,1,311,489,3,1,3,0,1,0,63.60
臺南縣,玉井鄉,三和村,569,1,553,5,558,776,3,1,3,0,1,0,71.91
臺南縣,玉井鄉,望明村,570,1,521,10,531,684,3,1,3,0,1,0,77.63
臺南縣,玉井鄉,望明村,571,1,583,11,594,895,3,1,3,0,1,0,66.37
臺南縣,玉井鄉,層林村,572,1,526,4,530,682,3,1,3,0,1,0,77.71
臺南縣,玉井鄉,豐里村,573,1,685,9,694,1021,3,1,3,0,1,0,67.97
臺南縣,楠西鄉,楠西村,574,1,665,4,669,995,3,1,3,0,1,0,67.24
臺南縣,楠西鄉,楠西村,575,1,608,15,623,940,3,1,3,0,1,0,66.28
臺南縣,楠西鄉,灣丘村,576,1,784,17,801,1261,3,1,3,0,1,0,63.52
臺南縣,楠西鄉,密枝村,577,1,599,3,602,856,3,1,3,0,1,0,70.33
臺南縣,楠西鄉,照興村,578,1,696,13,709,1066,3,1,3,0,1,0,66.51
臺南縣,楠西鄉,鹿田村,579,1,737,3,740,1040,3,1,3,0,1,0,71.15
臺南縣,楠西鄉,龜丹村,580,1,513,9,522,720,3,1,3,0,1,0,72.50
臺南縣,楠西鄉,東勢村,581,1,756,1,757,1039,3,1,3,0,1,0,72.86
臺南縣,楠西鄉,東勢村,582,1,812,11,823,1212,3,1,3,0,1,0,67.90
臺南縣,南化鄉,南化村,583,1,506,4,510,710,3,1,3,0,1,0,71.83
臺南縣,南化鄉,南化村,584,1,476,6,482,678,3,1,3,0,1,0,71.09
臺南縣,南化鄉,小崙村,585,1,558,4,562,801,3,1,3,0,1,0,70.16
臺南縣,南化鄉,東和村,586,1,451,1,452,673,3,1,3,0,1,0,67.16
臺南縣,南化鄉,中坑村,587,1,339,3,342,495,3,1,3,0,1,0,69.09
臺南縣,南化鄉,北平村,588,1,431,1,432,585,3,1,3,0,1,0,73.85
臺南縣,南化鄉,西埔村,589,1,552,7,559,825,3,1,3,0,1,0,67.76
臺南縣,南化鄉,北寮村,590,1,805,9,814,1222,3,1,3,0,1,0,66.61
臺南縣,南化鄉,玉山村,591,1,638,6,644,917,3,1,3,0,1,0,70.23
臺南縣,南化鄉,關山村,592,1,298,4,302,549,3,1,3,0,1,0,55.01
臺南縣,左鎮鄉,光和村,593,1,267,4,271,429,3,1,3,0,1,0,63.17
臺南縣,左鎮鄉,榮和村,594,1,502,8,510,720,3,1,3,0,1,0,70.83
臺南縣,左鎮鄉,左鎮村,595,1,342,2,344,530,3,1,3,0,1,0,64.91
臺南縣,左鎮鄉,中正村,596,1,651,3,654,904,3,1,3,0,1,0,72.35
臺南縣,左鎮鄉,睦光村,597,1,264,3,267,370,3,1,3,0,1,0,72.16
臺南縣,左鎮鄉,內庄村,598,1,311,8,319,463,3,1,3,0,1,0,68.90
臺南縣,左鎮鄉,岡林村,599,1,288,2,290,430,3,1,3,0,1,0,67.44
臺南縣,左鎮鄉,草山村,600,1,209,3,212,328,3,1,3,0,1,0,64.63
臺南縣,左鎮鄉,二寮村,601,1,172,1,173,244,3,1,3,0,1,0,70.90
臺南縣,左鎮鄉,澄山村,602,1,384,2,386,585,3,1,3,0,1,0,65.98
臺南縣,仁德鄉,太子村,603,1,1025,6,1031,1462,3,1,3,0,1,0,70.52
臺南縣,仁德鄉,太子村,604,1,907,10,917,1268,3,1,3,0,1,0,72.32
臺南縣,仁德鄉,太子村,605,1,797,6,803,1216,3,1,3,0,1,0,66.04
臺南縣,仁德鄉,土庫村,606,1,737,5,742,1028,3,1,3,0,1,0,72.18
臺南縣,仁德鄉,土庫村,607,1,865,8,873,1193,3,1,3,0,1,0,73.18
臺南縣,仁德鄉,一甲村,608,1,571,4,575,831,3,1,3,0,1,0,69.19
臺南縣,仁德鄉,一甲村,609,1,656,9,665,999,3,1,3,0,1,0,66.57
臺南縣,仁德鄉,仁德村,610,1,955,8,963,1477,3,1,3,0,1,0,65.20
臺南縣,仁德鄉,仁德村,611,1,658,8,666,1121,3,1,3,0,1,0,59.41
臺南縣,仁德鄉,仁德村,612,1,741,7,748,1267,3,1,3,0,1,0,59.04
臺南縣,仁德鄉,仁義村,613,1,935,6,941,1307,3,1,3,0,1,0,72.00
臺南縣,仁德鄉,仁義村,614,1,764,10,774,1120,3,1,3,0,1,0,69.11
臺南縣,仁德鄉,仁義村,615,1,1110,17,1127,1859,3,1,3,0,1,0,60.62
臺南縣,仁德鄉,仁義村,616,1,541,10,551,798,3,1,3,0,1,0,69.05
臺南縣,仁德鄉,仁義村,617,1,845,10,855,1274,3,1,3,0,1,0,67.11
臺南縣,仁德鄉,新田村,618,1,1047,15,1062,1647,3,1,3,0,1,0,64.48
臺南縣,仁德鄉,新田村,619,1,577,4,581,862,3,1,3,0,1,0,67.40
臺南縣,仁德鄉,後壁村,620,1,951,7,958,1413,3,1,3,0,1,0,67.80
臺南縣,仁德鄉,後壁村,621,1,1082,9,1091,1783,3,1,3,0,1,0,61.19
臺南縣,仁德鄉,後壁村,622,1,909,19,928,1355,3,1,3,0,1,0,68.49
臺南縣,仁德鄉,後壁村,623,1,970,19,989,1682,3,1,3,0,1,0,58.80
臺南縣,仁德鄉,上崙村,624,1,864,12,876,1482,3,1,3,0,1,0,59.11
臺南縣,仁德鄉,上崙村,625,1,1070,9,1079,1702,3,1,3,0,1,0,63.40
臺南縣,仁德鄉,上崙村,626,1,456,6,462,744,3,1,3,0,1,0,62.10
臺南縣,仁德鄉,田厝村,627,1,974,14,988,1303,3,1,3,0,1,0,75.83
臺南縣,仁德鄉,三甲村,628,1,472,2,474,697,3,1,3,0,1,0,68.01
臺南縣,仁德鄉,保安村,629,1,551,9,560,854,3,1,3,0,1,0,65.57
臺南縣,仁德鄉,保安村,630,1,856,12,868,1291,3,1,3,0,1,0,67.23
臺南縣,仁德鄉,成功村,631,1,796,10,806,1237,3,1,3,0,1,0,65.16
臺南縣,仁德鄉,成功村,632,1,637,16,653,1005,3,1,3,0,1,0,64.98
臺南縣,仁德鄉,成功村,633,1,687,5,692,970,3,1,3,0,1,0,71.34
臺南縣,仁德鄉,成功村,634,1,219,2,221,342,3,1,3,0,1,0,64.62
臺南縣,仁德鄉,仁和村,635,1,755,19,774,1123,3,1,3,0,1,0,68.92
臺南縣,仁德鄉,仁愛村,636,1,617,17,634,921,3,1,3,0,1,0,68.84
臺南縣,仁德鄉,仁愛村,637,1,662,14,676,1068,3,1,3,0,1,0,63.30
臺南縣,仁德鄉,二行村,638,1,790,19,809,1184,3,1,3,0,1,0,68.33
臺南縣,仁德鄉,二行村,639,1,567,11,578,812,3,1,3,0,1,0,71.18
臺南縣,仁德鄉,大甲村,640,1,651,11,662,853,3,1,3,0,1,0,77.61
臺南縣,仁德鄉,大甲村,641,1,745,16,761,1075,3,1,3,0,1,0,70.79
臺南縣,仁德鄉,中洲村,642,1,859,6,865,1242,3,1,3,0,1,0,69.65
臺南縣,仁德鄉,中生村,643,1,983,12,995,1393,3,1,3,0,1,0,71.43
臺南縣,歸仁鄉,南保村,644,1,887,9,896,1318,3,1,3,0,1,0,67.98
臺南縣,歸仁鄉,南保村,645,1,907,10,917,1390,3,1,3,0,1,0,65.97
臺南縣,歸仁鄉,南保村,646,1,532,5,537,862,3,1,3,0,1,0,62.30
臺南縣,歸仁鄉,南保村,647,1,639,7,646,963,3,1,3,0,1,0,67.08
臺南縣,歸仁鄉,南興村,648,1,890,3,893,1381,3,1,3,0,1,0,64.66
臺南縣,歸仁鄉,南興村,649,1,838,8,846,1301,3,1,3,0,1,0,65.03
臺南縣,歸仁鄉,六甲村,650,1,650,10,660,979,3,1,3,0,1,0,67.42
臺南縣,歸仁鄉,六甲村,651,1,661,12,673,1013,3,1,3,0,1,0,66.44
臺南縣,歸仁鄉,六甲村,652,1,655,10,665,1005,3,1,3,0,1,0,66.17
臺南縣,歸仁鄉,歸南村,653,1,674,7,681,1033,3,1,3,0,1,0,65.92
臺南縣,歸仁鄉,歸南村,654,1,609,12,621,921,3,1,3,0,1,0,67.43
臺南縣,歸仁鄉,後市村,655,1,825,5,830,1192,3,1,3,0,1,0,69.63
臺南縣,歸仁鄉,後市村,656,1,629,8,637,872,3,1,3,0,1,0,73.05
臺南縣,歸仁鄉,後市村,657,1,559,6,565,851,3,1,3,0,1,0,66.39
臺南縣,歸仁鄉,文化村,658,1,834,10,844,1313,3,1,3,0,1,0,64.28
臺南縣,歸仁鄉,文化村,659,1,596,11,607,961,3,1,3,0,1,0,63.16
臺南縣,歸仁鄉,辜厝村,660,1,506,7,513,792,3,1,3,0,1,0,64.77
臺南縣,歸仁鄉,辜厝村,661,1,537,8,545,810,3,1,3,0,1,0,67.28
臺南縣,歸仁鄉,辜厝村,662,1,642,8,650,981,3,1,3,0,1,0,66.26
臺南縣,歸仁鄉,新厝村,663,1,660,4,664,975,3,1,3,0,1,0,68.10
臺南縣,歸仁鄉,新厝村,664,1,713,3,716,1035,3,1,3,0,1,0,69.18
臺南縣,歸仁鄉,許厝村,665,1,994,9,1003,1455,3,1,3,0,1,0,68.93
臺南縣,歸仁鄉,許厝村,666,1,888,4,892,1275,3,1,3,0,1,0,69.96
臺南縣,歸仁鄉,看西村,667,1,968,11,979,1334,3,1,3,0,1,0,73.39
臺南縣,歸仁鄉,看東村,668,1,876,7,883,1305,3,1,3,0,1,0,67.66
臺南縣,歸仁鄉,崙頂村,669,1,782,3,785,1053,3,1,3,0,1,0,74.55
臺南縣,歸仁鄉,崙頂村,670,1,569,6,575,825,3,1,3,0,1,0,69.70
臺南縣,歸仁鄉,沙崙村,671,1,395,5,400,568,3,1,3,0,1,0,70.42
臺南縣,歸仁鄉,大潭村,672,1,608,10,618,890,3,1,3,0,1,0,69.44
臺南縣,歸仁鄉,大潭村,673,1,526,6,532,788,3,1,3,0,1,0,67.51
臺南縣,歸仁鄉,武東村,674,1,728,10,738,1173,3,1,3,0,1,0,62.92
臺南縣,歸仁鄉,歸仁村,675,1,724,2,726,1013,3,1,3,0,1,0,71.67
臺南縣,歸仁鄉,歸仁村,676,1,592,8,600,931,3,1,3,0,1,0,64.45
臺南縣,歸仁鄉,八甲村,677,1,858,10,868,1239,3,1,3,0,1,0,70.06
臺南縣,歸仁鄉,八甲村,678,1,592,3,595,831,3,1,3,0,1,0,71.60
臺南縣,歸仁鄉,七甲村,679,1,746,4,750,1045,3,1,3,0,1,0,71.77
臺南縣,歸仁鄉,七甲村,680,1,651,5,656,997,3,1,3,0,1,0,65.80
臺南縣,歸仁鄉,媽廟村,681,1,665,0,665,969,3,1,3,0,1,0,68.63
臺南縣,歸仁鄉,媽廟村,682,1,570,5,575,835,3,1,3,0,1,0,68.86
臺南縣,歸仁鄉,西埔村,683,1,504,6,510,724,3,1,3,0,1,0,70.44
臺南縣,歸仁鄉,西埔村,684,1,427,6,433,583,3,1,3,0,1,0,74.27
臺南縣,歸仁鄉,大廟村,685,1,667,7,674,1060,3,1,3,0,1,0,63.58
臺南縣,歸仁鄉,大廟村,686,1,796,17,813,1147,3,1,3,0,1,0,70.88
臺南縣,關廟鄉,關廟村,687,1,601,2,603,855,3,1,3,0,1,0,70.53
臺南縣,關廟鄉,關廟村,688,1,778,2,780,1048,3,1,3,0,1,0,74.43
臺南縣,關廟鄉,山西村,689,1,613,4,617,822,3,1,3,0,1,0,75.06
臺南縣,關廟鄉,山西村,690,1,753,4,757,1016,3,1,3,0,1,0,74.51
臺南縣,關廟鄉,香洋村,691,1,753,5,758,1038,3,1,3,0,1,0,73.03
臺南縣,關廟鄉,香洋村,692,1,798,5,803,1064,3,1,3,0,1,0,75.47
臺南縣,關廟鄉,香洋村,693,1,950,8,958,1307,3,1,3,0,1,0,73.30
臺南縣,關廟鄉,北勢村,694,1,968,5,973,1253,3,1,3,0,1,0,77.65
臺南縣,關廟鄉,北勢村,695,1,937,5,942,1247,3,1,3,0,1,0,75.54
臺南縣,關廟鄉,新埔村,696,1,615,6,621,840,3,1,3,0,1,0,73.93
臺南縣,關廟鄉,新光村,697,1,533,4,537,745,3,1,3,0,1,0,72.08
臺南縣,關廟鄉,五甲村,698,1,923,11,934,1346,3,1,3,0,1,0,69.39
臺南縣,關廟鄉,五甲村,699,1,938,5,943,1271,3,1,3,0,1,0,74.19
臺南縣,關廟鄉,東勢村,700,1,1102,16,1118,1550,3,1,3,0,1,0,72.13
臺南縣,關廟鄉,東勢村,701,1,936,8,944,1393,3,1,3,0,1,0,67.77
臺南縣,關廟鄉,松腳村,702,1,608,2,610,846,3,1,3,0,1,0,72.10
臺南縣,關廟鄉,松腳村,703,1,759,8,767,1028,3,1,3,0,1,0,74.61
臺南縣,關廟鄉,南花村,704,1,1045,5,1050,1425,3,1,3,0,1,0,73.68
臺南縣,關廟鄉,北花村,705,1,638,4,642,863,3,1,3,0,1,0,74.39
臺南縣,關廟鄉,北花村,706,1,851,15,866,1213,3,1,3,0,1,0,71.39
臺南縣,關廟鄉,深坑村,707,1,538,5,543,725,3,1,3,0,1,0,74.90
臺南縣,關廟鄉,深坑村,708,1,589,6,595,786,3,1,3,0,1,0,75.70
臺南縣,關廟鄉,布袋村,709,1,794,9,803,1196,3,1,3,0,1,0,67.14
臺南縣,關廟鄉,田中村,710,1,532,4,536,730,3,1,3,0,1,0,73.42
臺南縣,關廟鄉,龜洞村,711,1,566,3,569,761,3,1,3,0,1,0,74.77
臺南縣,關廟鄉,埤頭村,712,1,548,2,550,786,3,1,3,0,1,0,69.97
臺南縣,關廟鄉,埤頭村,713,1,503,6,509,708,3,1,3,0,1,0,71.89
臺南縣,關廟鄉,下湖村,714,1,290,2,292,376,3,1,3,0,1,0,77.66
臺南縣,龍崎鄉,崎頂村,715,1,838,7,845,1145,3,1,3,0,1,0,73.80
臺南縣,龍崎鄉,土崎村,716,1,498,2,500,694,3,1,3,0,1,0,72.05
臺南縣,龍崎鄉,中坑村,717,1,115,1,116,197,3,1,3,0,1,0,58.88
臺南縣,龍崎鄉,楠坑村,718,1,224,4,228,306,3,1,3,0,1,0,74.51
臺南縣,龍崎鄉,牛埔村,719,1,204,1,205,270,3,1,3,0,1,0,75.93
臺南縣,龍崎鄉,大坪村,720,1,207,2,209,297,3,1,3,0,1,0,70.37
臺南縣,龍崎鄉,龍船村,721,1,324,1,325,425,3,1,3,0,1,0,76.47
臺南縣,龍崎鄉,石曹村,722,1,268,4,272,383,3,1,3,0,1,0,71.02
臺南縣,永康市,五王里,723,1,716,8,724,1199,3,1,3,0,1,0,60.38
臺南縣,永康市,五王里,724,1,734,8,742,1247,3,1,3,0,1,0,59.50
臺南縣,永康市,五王里,725,1,768,6,774,1378,3,1,3,0,1,0,56.17
臺南縣,永康市,三合里,726,1,832,8,840,1312,3,1,3,0,1,0,64.02
臺南縣,永康市,三合里,727,1,860,9,869,1475,3,1,3,0,1,0,58.92
臺南縣,永康市,六合里,728,1,419,6,425,673,3,1,3,0,1,0,63.15
臺南縣,永康市,六合里,729,1,438,6,444,729,3,1,3,0,1,0,60.91
臺南縣,永康市,六合里,730,1,511,5,516,937,3,1,3,0,1,0,55.07
臺南縣,永康市,六合里,731,1,488,8,496,946,3,1,3,0,1,0,52.43
臺南縣,永康市,網寮里,732,1,807,6,813,1292,3,1,3,0,1,0,62.93
臺南縣,永康市,網寮里,733,1,748,4,752,1199,3,1,3,0,1,0,62.72
臺南縣,永康市,網寮里,734,1,877,8,885,1438,3,1,3,0,1,0,61.54
臺南縣,永康市,二王里,735,1,688,13,701,1091,3,1,3,0,1,0,64.25
臺南縣,永康市,二王里,736,1,795,9,804,1385,3,1,3,0,1,0,58.05
臺南縣,永康市,二王里,737,1,548,6,554,847,3,1,3,0,1,0,65.41
臺南縣,永康市,二王里,738,1,591,5,596,967,3,1,3,0,1,0,61.63
臺南縣,永康市,二王里,739,1,720,13,733,1191,3,1,3,0,1,0,61.54
臺南縣,永康市,永康里,740,1,724,15,739,1072,3,1,3,0,1,0,68.94
臺南縣,永康市,永康里,741,1,703,6,709,1079,3,1,3,0,1,0,65.71
臺南縣,永康市,永康里,742,1,683,7,690,1099,3,1,3,0,1,0,62.78
臺南縣,永康市,永康里,743,1,757,8,765,1333,3,1,3,0,1,0,57.39
臺南縣,永康市,永康里,744,1,608,3,611,1152,3,1,3,0,1,0,53.04
臺南縣,永康市,埔園里,745,1,769,10,779,1241,3,1,3,0,1,0,62.77
臺南縣,永康市,埔園里,746,1,803,7,810,1353,3,1,3,0,1,0,59.87
臺南縣,永康市,埔園里,747,1,828,11,839,1347,3,1,3,0,1,0,62.29
臺南縣,永康市,埔園里,748,1,796,8,804,1335,3,1,3,0,1,0,60.22
臺南縣,永康市,正強里,749,1,800,9,809,1192,3,1,3,0,1,0,67.87
臺南縣,永康市,正強里,750,1,714,8,722,1152,3,1,3,0,1,0,62.67
臺南縣,永康市,正強里,751,1,663,8,671,1031,3,1,3,0,1,0,65.08
臺南縣,永康市,正強里,752,1,675,4,679,1112,3,1,3,0,1,0,61.06
臺南縣,永康市,正強里,753,1,615,6,621,1019,3,1,3,0,1,0,60.94
臺南縣,永康市,大橋里,754,1,836,4,840,1412,3,1,3,0,1,0,59.49
臺南縣,永康市,大橋里,755,1,824,6,830,1319,3,1,3,0,1,0,62.93
臺南縣,永康市,大橋里,756,1,765,3,768,1232,3,1,3,0,1,0,62.34
臺南縣,永康市,東橋里,757,1,452,6,458,749,3,1,3,0,1,0,61.15
臺南縣,永康市,東橋里,758,1,491,5,496,760,3,1,3,0,1,0,65.26
臺南縣,永康市,東橋里,759,1,457,6,463,695,3,1,3,0,1,0,66.62
臺南縣,永康市,西橋里,760,1,691,8,699,1161,3,1,3,0,1,0,60.21
臺南縣,永康市,西橋里,761,1,701,11,712,1164,3,1,3,0,1,0,61.17
臺南縣,永康市,安康里,762,1,662,7,669,1164,3,1,3,0,1,0,57.47
臺南縣,永康市,安康里,763,1,757,3,760,1210,3,1,3,0,1,0,62.81
臺南縣,永康市,安康里,764,1,538,4,542,978,3,1,3,0,1,0,55.42
臺南縣,永康市,蔦松里,765,1,540,5,545,794,3,1,3,0,1,0,68.64
臺南縣,永康市,蔦松里,766,1,476,11,487,662,3,1,3,0,1,0,73.56
臺南縣,永康市,三民里,767,1,747,13,760,1067,3,1,3,0,1,0,71.23
臺南縣,永康市,鹽行里,768,1,720,6,726,1182,3,1,3,0,1,0,61.42
臺南縣,永康市,鹽行里,769,1,794,9,803,1197,3,1,3,0,1,0,67.08
臺南縣,永康市,鹽行里,770,1,754,8,762,1198,3,1,3,0,1,0,63.61
臺南縣,永康市,鹽行里,771,1,688,3,691,1231,3,1,3,0,1,0,56.13
臺南縣,永康市,鹽行里,772,1,691,9,700,1126,3,1,3,0,1,0,62.17
臺南縣,永康市,鹽洲里,773,1,609,9,618,939,3,1,3,0,1,0,65.81
臺南縣,永康市,鹽洲里,774,1,706,3,709,1110,3,1,3,0,1,0,63.87
臺南縣,永康市,鹽洲里,775,1,628,14,642,978,3,1,3,0,1,0,65.64
臺南縣,永康市,鹽洲里,776,1,813,10,823,1232,3,1,3,0,1,0,66.80
臺南縣,永康市,甲頂里,777,1,447,4,451,730,3,1,3,0,1,0,61.78
臺南縣,永康市,甲頂里,778,1,617,5,622,882,3,1,3,0,1,0,70.52
臺南縣,永康市,甲頂里,779,1,384,7,391,552,3,1,3,0,1,0,70.83
臺南縣,永康市,尚頂里,780,1,717,7,724,1075,3,1,3,0,1,0,67.35
臺南縣,永康市,尚頂里,781,1,684,9,693,1044,3,1,3,0,1,0,66.38
臺南縣,永康市,尚頂里,782,1,683,8,691,1154,3,1,3,0,1,0,59.88
臺南縣,永康市,龍潭里,783,1,621,12,633,964,3,1,3,0,1,0,65.66
臺南縣,永康市,龍潭里,784,1,648,4,652,956,3,1,3,0,1,0,68.20
臺南縣,永康市,龍潭里,785,1,661,8,669,1079,3,1,3,0,1,0,62.00
臺南縣,永康市,龍潭里,786,1,687,13,700,1090,3,1,3,0,1,0,64.22
臺南縣,永康市,龍潭里,787,1,659,6,665,1088,3,1,3,0,1,0,61.12
臺南縣,永康市,龍潭里,788,1,602,4,606,1026,3,1,3,0,1,0,59.06
臺南縣,永康市,王行里,789,1,852,8,860,1282,3,1,3,0,1,0,67.08
臺南縣,永康市,王行里,790,1,389,5,394,532,3,1,3,0,1,0,74.06
臺南縣,永康市,烏竹里,791,1,1007,16,1023,1558,3,1,3,0,1,0,65.66
臺南縣,永康市,西勢里,792,1,662,9,671,929,3,1,3,0,1,0,72.23
臺南縣,永康市,西勢里,793,1,591,6,597,915,3,1,3,0,1,0,65.25
臺南縣,永康市,西勢里,794,1,627,8,635,956,3,1,3,0,1,0,66.42
臺南縣,永康市,西勢里,795,1,658,8,666,1046,3,1,3,0,1,0,63.67
臺南縣,永康市,新樹里,796,1,794,4,798,1253,3,1,3,0,1,0,63.69
臺南縣,永康市,大灣里,797,1,709,5,714,1020,3,1,3,0,1,0,70.00
臺南縣,永康市,大灣里,798,1,536,6,542,754,3,1,3,0,1,0,71.88
臺南縣,永康市,大灣里,799,1,760,5,765,1108,3,1,3,0,1,0,69.04
臺南縣,永康市,東灣里,800,1,567,9,576,811,3,1,3,0,1,0,71.02
臺南縣,永康市,東灣里,801,1,675,8,683,997,3,1,3,0,1,0,68.51
臺南縣,永康市,東灣里,802,1,802,12,814,1225,3,1,3,0,1,0,66.45
臺南縣,永康市,西灣里,803,1,715,22,737,1097,3,1,3,0,1,0,67.18
臺南縣,永康市,西灣里,804,1,924,6,930,1411,3,1,3,0,1,0,65.91
臺南縣,永康市,西灣里,805,1,801,8,809,1277,3,1,3,0,1,0,63.35
臺南縣,永康市,西灣里,806,1,749,8,757,1141,3,1,3,0,1,0,66.35
臺南縣,永康市,南灣里,807,1,793,8,801,1262,3,1,3,0,1,0,63.47
臺南縣,永康市,南灣里,808,1,807,9,816,1153,3,1,3,0,1,0,70.77
臺南縣,永康市,南灣里,809,1,687,8,695,1010,3,1,3,0,1,0,68.81
臺南縣,永康市,崑山里,810,1,723,8,731,1152,3,1,3,0,1,0,63.45
臺南縣,永康市,崑山里,811,1,846,8,854,1313,3,1,3,0,1,0,65.04
臺南縣,永康市,崑山里,812,1,805,9,814,1253,3,1,3,0,1,0,64.96
臺南縣,永康市,崑山里,813,1,883,11,894,1353,3,1,3,0,1,0,66.08
臺南縣,永康市,北灣里,814,1,685,10,695,1053,3,1,3,0,1,0,66.00
臺南縣,永康市,北灣里,815,1,682,7,689,1003,3,1,3,0,1,0,68.69
臺南縣,永康市,北灣里,816,1,695,5,700,1052,3,1,3,0,1,0,66.54
臺南縣,永康市,北灣里,817,1,615,5,620,1003,3,1,3,0,1,0,61.81
臺南縣,永康市,北灣里,818,1,743,9,752,1117,3,1,3,0,1,0,67.32
臺南縣,永康市,復興里,819,1,521,15,536,812,3,1,3,0,1,0,66.01
臺南縣,永康市,復興里,820,1,641,16,657,929,3,1,3,0,1,0,70.72
臺南縣,永康市,光復里,821,1,765,13,778,1122,3,1,3,0,1,0,69.34
臺南縣,永康市,建國里,822,1,698,16,714,1089,3,1,3,0,1,0,65.56
臺南縣,永康市,建國里,823,1,622,14,636,893,3,1,3,0,1,0,71.22
臺南縣,永康市,復國里,824,1,651,6,657,974,3,1,3,0,1,0,67.45
臺南縣,永康市,復國里,825,1,674,6,680,1028,3,1,3,0,1,0,66.15
臺南縣,永康市,復華里,826,1,598,7,605,1130,3,1,3,0,1,0,53.54
臺南縣,永康市,復華里,827,1,782,6,788,1401,3,1,3,0,1,0,56.25
臺南縣,永康市,復華里,828,1,680,9,689,1056,3,1,3,0,1,0,65.25
臺南縣,永康市,復華里,829,1,581,4,585,1016,3,1,3,0,1,0,57.58
臺南縣,永康市,復華里,830,1,637,6,643,1028,3,1,3,0,1,0,62.55
臺南縣,永康市,復華里,831,1,628,3,631,1078,3,1,3,0,1,0,58.53
臺南縣,永康市,復華里,832,1,577,4,581,989,3,1,3,0,1,0,58.75
臺南縣,永康市,復華里,833,1,534,7,541,834,3,1,3,0,1,0,64.87
臺南縣,永康市,復華里,834,1,691,9,700,1109,3,1,3,0,1,0,63.12
臺南縣,永康市,神洲里,835,1,621,9,630,899,3,1,3,0,1,0,70.08
臺南縣,永康市,神洲里,836,1,487,7,494,800,3,1,3,0,1,0,61.75
臺南縣,永康市,成功里,837,1,704,7,711,1003,3,1,3,0,1,0,70.89
臺南縣,永康市,成功里,838,1,661,14,675,1123,3,1,3,0,1,0,60.11
臺南縣,永康市,中華里,839,1,629,2,631,935,3,1,3,0,1,0,67.49
臺南縣,永康市,中華里,840,1,625,3,628,1033,3,1,3,0,1,0,60.79
臺南縣,永康市,中興里,841,1,785,7,792,1284,3,1,3,0,1,0,61.68
臺南縣,永康市,中興里,842,1,902,9,911,1399,3,1,3,0,1,0,65.12
臺南縣,永康市,勝利里,843,1,750,8,758,1389,3,1,3,0,1,0,54.57
臺南縣,永康市,勝利里,844,1,581,6,587,1043,3,1,3,0,1,0,56.28
臺南縣,永康市,勝利里,845,1,532,3,535,850,3,1,3,0,1,0,62.94
臺南縣,永康市,勝利里,846,1,545,8,553,869,3,1,3,0,1,0,63.64
臺南縣,永康市,勝利里,847,1,520,3,523,904,3,1,3,0,1,0,57.85
高雄縣,鳳山市,鳳崗里,1,1,357,6,363,561,3,1,3,0,1,0,64.71
高雄縣,鳳山市,鳳崗里,2,1,435,3,438,702,3,1,3,0,1,0,62.39
高雄縣,鳳山市,縣衙里,3,1,560,4,564,862,3,1,3,0,1,0,65.43
高雄縣,鳳山市,曹公里,4,1,771,5,776,1203,3,1,3,0,1,0,64.51
高雄縣,鳳山市,曹公里,5,1,736,11,747,1079,3,1,3,0,1,0,69.23
高雄縣,鳳山市,鎮西里,6,1,903,10,913,1415,3,1,3,0,1,0,64.52
高雄縣,鳳山市,鎮西里,7,1,786,7,793,1249,3,1,3,0,1,0,63.49
高雄縣,鳳山市,鎮西里,8,1,731,11,742,1167,3,1,3,0,1,0,63.58
高雄縣,鳳山市,鎮西里,9,1,744,10,754,1177,3,1,3,0,1,0,64.06
高雄縣,鳳山市,北門里,10,1,661,5,666,1038,3,1,3,0,1,0,64.16
高雄縣,鳳山市,北門里,11,1,585,8,593,930,3,1,3,0,1,0,63.76
高雄縣,鳳山市,北門里,12,1,533,4,537,895,3,1,3,0,1,0,60.00
高雄縣,鳳山市,北門里,13,1,576,5,581,871,3,1,3,0,1,0,66.70
高雄縣,鳳山市,鎮北里,14,1,630,5,635,1013,3,1,3,0,1,0,62.69
高雄縣,鳳山市,鎮北里,15,1,800,9,809,1237,3,1,3,0,1,0,65.40
高雄縣,鳳山市,鎮北里,16,1,484,4,488,800,3,1,3,0,1,0,61.00
高雄縣,鳳山市,鎮北里,17,1,757,3,760,1163,3,1,3,0,1,0,65.35
高雄縣,鳳山市,武松里,18,1,772,6,778,1270,3,1,3,0,1,0,61.26
高雄縣,鳳山市,武松里,19,1,706,5,711,1074,3,1,3,0,1,0,66.20
高雄縣,鳳山市,忠誠里,20,1,885,10,895,1368,3,1,3,0,1,0,65.42
高雄縣,鳳山市,忠誠里,21,1,1010,16,1026,1579,3,1,3,0,1,0,64.98
高雄縣,鳳山市,文英里,22,1,867,11,878,1296,3,1,3,0,1,0,67.75
高雄縣,鳳山市,文英里,23,1,960,8,968,1542,3,1,3,0,1,0,62.78
高雄縣,鳳山市,文華里,24,1,712,10,722,1057,3,1,3,0,1,0,68.31
高雄縣,鳳山市,文華里,25,1,634,6,640,976,3,1,3,0,1,0,65.57
高雄縣,鳳山市,文華里,26,1,670,11,681,1083,3,1,3,0,1,0,62.88
高雄縣,鳳山市,文華里,27,1,701,9,710,1036,3,1,3,0,1,0,68.53
高雄縣,鳳山市,文山里,28,1,579,6,585,927,3,1,3,0,1,0,63.11
高雄縣,鳳山市,文山里,29,1,899,8,907,1426,3,1,3,0,1,0,63.60
高雄縣,鳳山市,文山里,30,1,666,7,673,1018,3,1,3,0,1,0,66.11
高雄縣,鳳山市,文山里,31,1,590,7,597,881,3,1,3,0,1,0,67.76
高雄縣,鳳山市,文山里,32,1,422,6,428,681,3,1,3,0,1,0,62.85
高雄縣,鳳山市,文德里,33,1,685,5,690,1193,3,1,3,0,1,0,57.84
高雄縣,鳳山市,文德里,34,1,721,7,728,1245,3,1,3,0,1,0,58.47
高雄縣,鳳山市,文德里,35,1,645,3,648,1098,3,1,3,0,1,0,59.02
高雄縣,鳳山市,文德里,36,1,793,7,800,1372,3,1,3,0,1,0,58.31
高雄縣,鳳山市,文衡里,37,1,636,7,643,947,3,1,3,0,1,0,67.90
高雄縣,鳳山市,文衡里,38,1,677,2,679,1094,3,1,3,0,1,0,62.07
高雄縣,鳳山市,文福里,39,1,730,3,733,1207,3,1,3,0,1,0,60.73
高雄縣,鳳山市,文福里,40,1,647,12,659,1110,3,1,3,0,1,0,59.37
高雄縣,鳳山市,文福里,41,1,574,4,578,983,3,1,3,0,1,0,58.80
高雄縣,鳳山市,文福里,42,1,607,11,618,1098,3,1,3,0,1,0,56.28
高雄縣,鳳山市,文福里,43,1,578,8,586,979,3,1,3,0,1,0,59.86
高雄縣,鳳山市,成功里,44,1,526,6,532,761,3,1,3,0,1,0,69.91
高雄縣,鳳山市,縣口里,45,1,324,1,325,497,3,1,3,0,1,0,65.39
高雄縣,鳳山市,光明里,46,1,368,4,372,570,3,1,3,0,1,0,65.26
高雄縣,鳳山市,光明里,47,1,571,3,574,811,3,1,3,0,1,0,70.78
高雄縣,鳳山市,和德里,48,1,530,4,534,798,3,1,3,0,1,0,66.92
高雄縣,鳳山市,和德里,49,1,529,5,534,836,3,1,3,0,1,0,63.88
高雄縣,鳳山市,和興里,50,1,747,6,753,1109,3,1,3,0,1,0,67.90
高雄縣,鳳山市,和興里,51,1,765,14,779,1155,3,1,3,0,1,0,67.45
高雄縣,鳳山市,和興里,52,1,740,5,745,1133,3,1,3,0,1,0,65.75
高雄縣,鳳山市,和興里,53,1,776,5,781,1138,3,1,3,0,1,0,68.63
高雄縣,鳳山市,南興里,54,1,724,12,736,1082,3,1,3,0,1,0,68.02
高雄縣,鳳山市,三民里,55,1,734,10,744,1082,3,1,3,0,1,0,68.76
高雄縣,鳳山市,新興里,56,1,819,9,828,1250,3,1,3,0,1,0,66.24
高雄縣,鳳山市,興仁里,57,1,689,6,695,1047,3,1,3,0,1,0,66.38
高雄縣,鳳山市,興仁里,58,1,488,7,495,795,3,1,3,0,1,0,62.26
高雄縣,鳳山市,興仁里,59,1,587,4,591,884,3,1,3,0,1,0,66.86
高雄縣,鳳山市,興仁里,60,1,578,7,585,891,3,1,3,0,1,0,65.66
高雄縣,鳳山市,興中里,61,1,503,6,509,777,3,1,3,0,1,0,65.51
高雄縣,鳳山市,協和里,62,1,780,5,785,1197,3,1,3,0,1,0,65.58
高雄縣,鳳山市,協和里,63,1,842,10,852,1308,3,1,3,0,1,0,65.14
高雄縣,鳳山市,協和里,64,1,756,8,764,1092,3,1,3,0,1,0,69.96
高雄縣,鳳山市,忠義里,65,1,641,6,647,942,3,1,3,0,1,0,68.68
高雄縣,鳳山市,忠義里,66,1,486,3,489,863,3,1,3,0,1,0,56.66
高雄縣,鳳山市,忠義里,67,1,490,2,492,887,3,1,3,0,1,0,55.47
高雄縣,鳳山市,忠義里,68,1,874,10,884,1316,3,1,3,0,1,0,67.17
高雄縣,鳳山市,忠孝里,69,1,695,6,701,1108,3,1,3,0,1,0,63.27
高雄縣,鳳山市,忠孝里,70,1,670,6,676,1065,3,1,3,0,1,0,63.47
高雄縣,鳳山市,忠孝里,71,1,639,6,645,1058,3,1,3,0,1,0,60.96
高雄縣,鳳山市,忠孝里,72,1,805,14,819,1189,3,1,3,0,1,0,68.88
高雄縣,鳳山市,忠孝里,73,1,624,5,629,965,3,1,3,0,1,0,65.18
高雄縣,鳳山市,中和里,74,1,754,10,764,1122,3,1,3,0,1,0,68.09
高雄縣,鳳山市,中和里,75,1,663,12,675,1006,3,1,3,0,1,0,67.10
高雄縣,鳳山市,中和里,76,1,750,11,761,1127,3,1,3,0,1,0,67.52
高雄縣,鳳山市,誠正里,77,1,315,2,317,476,3,1,3,0,1,0,66.60
高雄縣,鳳山市,誠正里,78,1,355,5,360,504,3,1,3,0,1,0,71.43
高雄縣,鳳山市,誠義里,79,1,382,4,386,574,3,1,3,0,1,0,67.25
高雄縣,鳳山市,生明里,80,1,1000,2,1002,1436,3,1,3,0,1,0,69.78
高雄縣,鳳山市,鎮東里,81,1,699,6,705,1091,3,1,3,0,1,0,64.62
高雄縣,鳳山市,鎮東里,82,1,645,4,649,1033,3,1,3,0,1,0,62.83
高雄縣,鳳山市,瑞竹里,83,1,701,8,709,1026,3,1,3,0,1,0,69.10
高雄縣,鳳山市,瑞竹里,84,1,593,8,601,862,3,1,3,0,1,0,69.72
高雄縣,鳳山市,瑞竹里,85,1,674,5,679,1025,3,1,3,0,1,0,66.24
高雄縣,鳳山市,瑞竹里,86,1,571,9,580,892,3,1,3,0,1,0,65.02
高雄縣,鳳山市,瑞竹里,87,1,696,5,701,1048,3,1,3,0,1,0,66.89
高雄縣,鳳山市,瑞興里,88,1,771,6,777,1245,3,1,3,0,1,0,62.41
高雄縣,鳳山市,瑞興里,89,1,766,9,775,1297,3,1,3,0,1,0,59.75
高雄縣,鳳山市,瑞興里,90,1,796,12,808,1234,3,1,3,0,1,0,65.48
高雄縣,鳳山市,東門里,91,1,814,15,829,1270,3,1,3,0,1,0,65.28
高雄縣,鳳山市,東門里,92,1,784,4,788,1232,3,1,3,0,1,0,63.96
高雄縣,鳳山市,東門里,93,1,831,4,835,1267,3,1,3,0,1,0,65.90
高雄縣,鳳山市,誠德里,94,1,639,3,642,972,3,1,3,0,1,0,66.05
高雄縣,鳳山市,誠德里,95,1,667,8,675,1058,3,1,3,0,1,0,63.80
高雄縣,鳳山市,誠信里,96,1,558,5,563,868,3,1,3,0,1,0,64.86
高雄縣,鳳山市,誠信里,97,1,508,4,512,839,3,1,3,0,1,0,61.03
高雄縣,鳳山市,誠智里,98,1,720,12,732,1235,3,1,3,0,1,0,59.27
高雄縣,鳳山市,誠智里,99,1,640,12,652,1016,3,1,3,0,1,0,64.17
高雄縣,鳳山市,鳳東里,100,1,812,6,818,1275,3,1,3,0,1,0,64.16
高雄縣,鳳山市,鳳東里,101,1,815,9,824,1210,3,1,3,0,1,0,68.10
高雄縣,鳳山市,鳳東里,102,1,902,11,913,1392,3,1,3,0,1,0,65.59
高雄縣,鳳山市,埤頂里,103,1,682,6,688,985,3,1,3,0,1,0,69.85
高雄縣,鳳山市,埤頂里,104,1,741,9,750,1092,3,1,3,0,1,0,68.68
高雄縣,鳳山市,埤頂里,105,1,695,5,700,1039,3,1,3,0,1,0,67.37
高雄縣,鳳山市,埤頂里,106,1,822,12,834,1268,3,1,3,0,1,0,65.77
高雄縣,鳳山市,美齡里,107,1,575,6,581,849,3,1,3,0,1,0,68.43
高雄縣,鳳山市,中正里,108,1,595,5,600,904,3,1,3,0,1,0,66.37
高雄縣,鳳山市,中正里,109,1,650,12,662,1069,3,1,3,0,1,0,61.93
高雄縣,鳳山市,海光里,110,1,598,7,605,824,3,1,3,0,1,0,73.42
高雄縣,鳳山市,海光里,111,1,503,5,508,731,3,1,3,0,1,0,69.49
高雄縣,鳳山市,海光里,112,1,647,8,655,1003,3,1,3,0,1,0,65.30
高雄縣,鳳山市,海光里,113,1,821,10,831,1304,3,1,3,0,1,0,63.73
高雄縣,鳳山市,海風里,114,1,477,5,482,686,3,1,3,0,1,0,70.26
高雄縣,鳳山市,海風里,115,1,583,1,584,782,3,1,3,0,1,0,74.68
高雄縣,鳳山市,海風里,116,1,641,8,649,876,3,1,3,0,1,0,74.09
高雄縣,鳳山市,國泰里,117,1,608,6,614,941,3,1,3,0,1,0,65.25
高雄縣,鳳山市,國泰里,118,1,517,7,524,827,3,1,3,0,1,0,63.36
高雄縣,鳳山市,國泰里,119,1,543,5,548,874,3,1,3,0,1,0,62.70
高雄縣,鳳山市,國泰里,120,1,805,7,812,1238,3,1,3,0,1,0,65.59
高雄縣,鳳山市,國光里,121,1,757,7,764,1196,3,1,3,0,1,0,63.88
高雄縣,鳳山市,國光里,122,1,729,9,738,1238,3,1,3,0,1,0,59.61
高雄縣,鳳山市,國光里,123,1,698,5,703,1122,3,1,3,0,1,0,62.66
高雄縣,鳳山市,國隆里,124,1,587,10,597,1034,3,1,3,0,1,0,57.74
高雄縣,鳳山市,國隆里,125,1,551,6,557,874,3,1,3,0,1,0,63.73
高雄縣,鳳山市,國隆里,126,1,424,1,425,699,3,1,3,0,1,0,60.80
高雄縣,鳳山市,國富里,127,1,665,12,677,1056,3,1,3,0,1,0,64.11
高雄縣,鳳山市,國富里,128,1,624,12,636,1004,3,1,3,0,1,0,63.35
高雄縣,鳳山市,武慶里,129,1,628,8,636,986,3,1,3,0,1,0,64.50
高雄縣,鳳山市,武慶里,130,1,634,8,642,982,3,1,3,0,1,0,65.38
高雄縣,鳳山市,武漢里,131,1,555,8,563,882,3,1,3,0,1,0,63.83
高雄縣,鳳山市,武漢里,132,1,543,11,554,864,3,1,3,0,1,0,64.12
高雄縣,鳳山市,武漢里,133,1,594,7,601,961,3,1,3,0,1,0,62.54
高雄縣,鳳山市,武漢里,134,1,602,7,609,1005,3,1,3,0,1,0,60.60
高雄縣,鳳山市,新甲里,135,1,570,3,573,856,3,1,3,0,1,0,66.94
高雄縣,鳳山市,新甲里,136,1,505,7,512,816,3,1,3,0,1,0,62.75
高雄縣,鳳山市,新甲里,137,1,391,1,392,618,3,1,3,0,1,0,63.43
高雄縣,鳳山市,新武里,138,1,585,9,594,983,3,1,3,0,1,0,60.43
高雄縣,鳳山市,新武里,139,1,556,7,563,904,3,1,3,0,1,0,62.28
高雄縣,鳳山市,新泰里,140,1,495,5,500,793,3,1,3,0,1,0,63.05
高雄縣,鳳山市,新泰里,141,1,465,4,469,817,3,1,3,0,1,0,57.41
高雄縣,鳳山市,新泰里,142,1,568,7,575,957,3,1,3,0,1,0,60.08
高雄縣,鳳山市,新樂里,143,1,627,6,633,1062,3,1,3,0,1,0,59.60
高雄縣,鳳山市,新樂里,144,1,717,7,724,1100,3,1,3,0,1,0,65.82
高雄縣,鳳山市,新樂里,145,1,617,6,623,1056,3,1,3,0,1,0,59.00
高雄縣,鳳山市,新強里,146,1,785,6,791,1175,3,1,3,0,1,0,67.32
高雄縣,鳳山市,新強里,147,1,733,6,739,1077,3,1,3,0,1,0,68.62
高雄縣,鳳山市,新強里,148,1,780,5,785,1231,3,1,3,0,1,0,63.77
高雄縣,鳳山市,海洋里,149,1,536,10,546,839,3,1,3,0,1,0,65.08
高雄縣,鳳山市,海洋里,150,1,542,6,548,911,3,1,3,0,1,0,60.15
高雄縣,鳳山市,海洋里,151,1,727,3,730,1109,3,1,3,0,1,0,65.83
高雄縣,鳳山市,新富里,152,1,641,8,649,1037,3,1,3,0,1,0,62.58
高雄縣,鳳山市,新富里,153,1,611,6,617,1018,3,1,3,0,1,0,60.61
高雄縣,鳳山市,新富里,154,1,779,9,788,1292,3,1,3,0,1,0,60.99
高雄縣,鳳山市,老爺里,155,1,759,6,765,1253,3,1,3,0,1,0,61.05
高雄縣,鳳山市,老爺里,156,1,796,9,805,1296,3,1,3,0,1,0,62.11
高雄縣,鳳山市,老爺里,157,1,804,8,812,1282,3,1,3,0,1,0,63.34
高雄縣,鳳山市,老爺里,158,1,636,11,647,1058,3,1,3,0,1,0,61.15
高雄縣,鳳山市,老爺里,159,1,568,9,577,962,3,1,3,0,1,0,59.98
高雄縣,鳳山市,中民里,160,1,700,4,704,1172,3,1,3,0,1,0,60.07
高雄縣,鳳山市,中民里,161,1,599,6,605,1041,3,1,3,0,1,0,58.12
高雄縣,鳳山市,中民里,162,1,580,4,584,1041,3,1,3,0,1,0,56.10
高雄縣,鳳山市,中崙里,163,1,541,9,550,810,3,1,3,0,1,0,67.90
高雄縣,鳳山市,中崙里,164,1,665,13,678,1053,3,1,3,0,1,0,64.39
高雄縣,鳳山市,中榮里,165,1,614,9,623,1028,3,1,3,0,1,0,60.60
高雄縣,鳳山市,中榮里,166,1,523,12,535,901,3,1,3,0,1,0,59.38
高雄縣,鳳山市,中榮里,167,1,617,7,624,990,3,1,3,0,1,0,63.03
高雄縣,鳳山市,中榮里,168,1,623,5,628,985,3,1,3,0,1,0,63.76
高雄縣,鳳山市,過埤里,169,1,536,6,542,835,3,1,3,0,1,0,64.91
高雄縣,鳳山市,過埤里,170,1,495,9,504,860,3,1,3,0,1,0,58.60
高雄縣,鳳山市,過埤里,171,1,621,7,628,1015,3,1,3,0,1,0,61.87
高雄縣,鳳山市,正義里,172,1,918,10,928,1556,3,1,3,0,1,0,59.64
高雄縣,鳳山市,正義里,173,1,680,7,687,1100,3,1,3,0,1,0,62.45
高雄縣,鳳山市,正義里,174,1,697,6,703,1103,3,1,3,0,1,0,63.74
高雄縣,鳳山市,正義里,175,1,677,5,682,1113,3,1,3,0,1,0,61.28
高雄縣,鳳山市,正義里,176,1,667,9,676,1107,3,1,3,0,1,0,61.07
高雄縣,鳳山市,一甲里,177,1,726,9,735,1245,3,1,3,0,1,0,59.04
高雄縣,鳳山市,一甲里,178,1,601,6,607,988,3,1,3,0,1,0,61.44
高雄縣,鳳山市,一甲里,179,1,578,7,585,922,3,1,3,0,1,0,63.45
高雄縣,鳳山市,二甲里,180,1,912,13,925,1549,3,1,3,0,1,0,59.72
高雄縣,鳳山市,二甲里,181,1,941,11,952,1542,3,1,3,0,1,0,61.74
高雄縣,鳳山市,龍成里,182,1,863,19,882,1408,3,1,3,0,1,0,62.64
高雄縣,鳳山市,龍成里,183,1,691,12,703,1191,3,1,3,0,1,0,59.03
高雄縣,鳳山市,鎮南里,184,1,661,10,671,1012,3,1,3,0,1,0,66.30
高雄縣,鳳山市,鎮南里,185,1,471,5,476,747,3,1,3,0,1,0,63.72
高雄縣,鳳山市,鎮南里,186,1,689,11,700,1127,3,1,3,0,1,0,62.11
高雄縣,鳳山市,鎮南里,187,1,634,6,640,1023,3,1,3,0,1,0,62.56
高雄縣,鳳山市,富甲里,188,1,449,5,454,713,3,1,3,0,1,0,63.67
高雄縣,鳳山市,富甲里,189,1,434,9,443,632,3,1,3,0,1,0,70.09
高雄縣,鳳山市,富甲里,190,1,384,5,389,601,3,1,3,0,1,0,64.73
高雄縣,鳳山市,善美里,191,1,605,6,611,1028,3,1,3,0,1,0,59.44
高雄縣,鳳山市,善美里,192,1,612,12,624,1007,3,1,3,0,1,0,61.97
高雄縣,鳳山市,善美里,193,1,588,6,594,1075,3,1,3,0,1,0,55.26
高雄縣,鳳山市,善美里,194,1,627,6,633,1247,3,1,3,0,1,0,50.76
高雄縣,鳳山市,富榮里,195,1,538,6,544,867,3,1,3,0,1,0,62.75
高雄縣,鳳山市,富榮里,196,1,623,2,625,1027,3,1,3,0,1,0,60.86
高雄縣,鳳山市,南和里,197,1,464,8,472,744,3,1,3,0,1,0,63.44
高雄縣,鳳山市,南和里,198,1,534,5,539,857,3,1,3,0,1,0,62.89
高雄縣,鳳山市,南和里,199,1,580,6,586,946,3,1,3,0,1,0,61.95
高雄縣,鳳山市,南成里,200,1,821,8,829,1349,3,1,3,0,1,0,61.45
高雄縣,鳳山市,南成里,201,1,684,9,693,1084,3,1,3,0,1,0,63.93
高雄縣,鳳山市,南成里,202,1,711,9,720,1055,3,1,3,0,1,0,68.25
高雄縣,鳳山市,天興里,203,1,505,6,511,809,3,1,3,0,1,0,63.16
高雄縣,鳳山市,天興里,204,1,582,9,591,907,3,1,3,0,1,0,65.16
高雄縣,鳳山市,天興里,205,1,556,12,568,893,3,1,3,0,1,0,63.61
高雄縣,鳳山市,天興里,206,1,520,5,525,793,3,1,3,0,1,0,66.20
高雄縣,鳳山市,大德里,207,1,622,11,633,1029,3,1,3,0,1,0,61.52
高雄縣,鳳山市,大德里,208,1,612,4,616,988,3,1,3,0,1,0,62.35
高雄縣,鳳山市,大德里,209,1,776,10,786,1173,3,1,3,0,1,0,67.01
高雄縣,鳳山市,五福里,210,1,646,6,652,935,3,1,3,0,1,0,69.73
高雄縣,鳳山市,五福里,211,1,663,10,673,975,3,1,3,0,1,0,69.03
高雄縣,鳳山市,五福里,212,1,705,7,712,1085,3,1,3,0,1,0,65.62
高雄縣,鳳山市,福興里,213,1,705,10,715,1077,3,1,3,0,1,0,66.39
高雄縣,鳳山市,福興里,214,1,659,10,669,986,3,1,3,0,1,0,67.85
高雄縣,鳳山市,福興里,215,1,622,7,629,1064,3,1,3,0,1,0,59.12
高雄縣,鳳山市,福興里,216,1,586,3,589,973,3,1,3,0,1,0,60.53
高雄縣,鳳山市,福興里,217,1,676,8,684,1123,3,1,3,0,1,0,60.91
高雄縣,鳳山市,福祥里,218,1,612,8,620,1064,3,1,3,0,1,0,58.27
高雄縣,鳳山市,福祥里,219,1,816,9,825,1377,3,1,3,0,1,0,59.91
高雄縣,鳳山市,福誠里,220,1,544,11,555,892,3,1,3,0,1,0,62.22
高雄縣,鳳山市,福誠里,221,1,468,7,475,769,3,1,3,0,1,0,61.77
高雄縣,鳳山市,福誠里,222,1,637,4,641,1079,3,1,3,0,1,0,59.41
高雄縣,林園鄉,仁愛村,223,1,916,10,926,1310,3,1,3,0,1,0,70.69
高雄縣,林園鄉,仁愛村,224,1,852,7,859,1215,3,1,3,0,1,0,70.70
高雄縣,林園鄉,林園村,225,1,729,10,739,1057,3,1,3,0,1,0,69.91
高雄縣,林園鄉,林園村,226,1,653,9,662,970,3,1,3,0,1,0,68.25
高雄縣,林園鄉,林園村,227,1,647,6,653,914,3,1,3,0,1,0,71.44
高雄縣,林園鄉,文賢村,228,1,779,3,782,1137,3,1,3,0,1,0,68.78
高雄縣,林園鄉,文賢村,229,1,629,10,639,941,3,1,3,0,1,0,67.91
高雄縣,林園鄉,東林村,230,1,806,8,814,1191,3,1,3,0,1,0,68.35
高雄縣,林園鄉,東林村,231,1,822,8,830,1284,3,1,3,0,1,0,64.64
高雄縣,林園鄉,溪州村,232,1,771,10,781,1147,3,1,3,0,1,0,68.09
高雄縣,林園鄉,溪州村,233,1,698,4,702,1026,3,1,3,0,1,0,68.42
高雄縣,林園鄉,溪州村,234,1,643,6,649,1036,3,1,3,0,1,0,62.64
高雄縣,林園鄉,五福村,235,1,613,8,621,950,3,1,3,0,1,0,65.37
高雄縣,林園鄉,五福村,236,1,510,10,520,857,3,1,3,0,1,0,60.68
高雄縣,林園鄉,潭頭村,237,1,784,6,790,1222,3,1,3,0,1,0,64.65
高雄縣,林園鄉,潭頭村,238,1,711,14,725,1115,3,1,3,0,1,0,65.02
高雄縣,林園鄉,中厝村,239,1,913,16,929,1389,3,1,3,0,1,0,66.88
高雄縣,林園鄉,中厝村,240,1,814,5,819,1166,3,1,3,0,1,0,70.24
高雄縣,林園鄉,林內村,241,1,597,4,601,893,3,1,3,0,1,0,67.30
高雄縣,林園鄉,林內村,242,1,608,12,620,845,3,1,3,0,1,0,73.37
高雄縣,林園鄉,王公村,243,1,670,2,672,997,3,1,3,0,1,0,67.40
高雄縣,林園鄉,王公村,244,1,691,8,699,1024,3,1,3,0,1,0,68.26
高雄縣,林園鄉,王公村,245,1,679,8,687,922,3,1,3,0,1,0,74.51
高雄縣,林園鄉,廣應村,246,1,616,8,624,874,3,1,3,0,1,0,71.40
高雄縣,林園鄉,廣應村,247,1,764,4,768,1098,3,1,3,0,1,0,69.95
高雄縣,林園鄉,廣應村,248,1,590,10,600,871,3,1,3,0,1,0,68.89
高雄縣,林園鄉,林家村,249,1,908,11,919,1224,3,1,3,0,1,0,75.08
高雄縣,林園鄉,龔厝村,250,1,551,3,554,795,3,1,3,0,1,0,69.69
高雄縣,林園鄉,龔厝村,251,1,602,9,611,828,3,1,3,0,1,0,73.79
高雄縣,林園鄉,中門村,252,1,576,9,585,827,3,1,3,0,1,0,70.74
高雄縣,林園鄉,中門村,253,1,764,5,769,1123,3,1,3,0,1,0,68.48
高雄縣,林園鄉,頂厝村,254,1,601,3,604,957,3,1,3,0,1,0,63.11
高雄縣,林園鄉,頂厝村,255,1,734,11,745,1081,3,1,3,0,1,0,68.92
高雄縣,林園鄉,頂厝村,256,1,921,15,936,1376,3,1,3,0,1,0,68.02
高雄縣,林園鄉,港埔村,257,1,590,6,596,869,3,1,3,0,1,0,68.58
高雄縣,林園鄉,港埔村,258,1,539,6,545,771,3,1,3,0,1,0,70.69
高雄縣,林園鄉,港嘴村,259,1,929,18,947,1282,3,1,3,0,1,0,73.87
高雄縣,林園鄉,西溪村,260,1,566,4,570,875,3,1,3,0,1,0,65.14
高雄縣,林園鄉,西溪村,261,1,550,7,557,844,3,1,3,0,1,0,66.00
高雄縣,林園鄉,西溪村,262,1,694,7,701,978,3,1,3,0,1,0,71.68
高雄縣,林園鄉,中芸村,263,1,634,7,641,925,3,1,3,0,1,0,69.30
高雄縣,林園鄉,中芸村,264,1,530,5,535,779,3,1,3,0,1,0,68.68
高雄縣,林園鄉,鳳芸村,265,1,568,6,574,779,3,1,3,0,1,0,73.68
高雄縣,林園鄉,鳳芸村,266,1,622,6,628,913,3,1,3,0,1,0,68.78
高雄縣,林園鄉,東汕村,267,1,614,10,624,917,3,1,3,0,1,0,68.05
高雄縣,林園鄉,西汕村,268,1,449,15,464,704,3,1,3,0,1,0,65.91
高雄縣,林園鄉,中汕村,269,1,708,9,717,1105,3,1,3,0,1,0,64.89
高雄縣,林園鄉,中汕村,270,1,631,8,639,1025,3,1,3,0,1,0,62.34
高雄縣,林園鄉,北汕村,271,1,347,3,350,617,3,1,3,0,1,0,56.73
高雄縣,林園鄉,北汕村,272,1,521,6,527,844,3,1,3,0,1,0,62.44
高雄縣,大寮鄉,義和村,273,1,656,7,663,931,3,1,3,0,1,0,71.21
高雄縣,大寮鄉,義和村,274,1,678,12,690,1044,3,1,3,0,1,0,66.09
高雄縣,大寮鄉,溪寮村,275,1,1011,13,1024,1386,3,1,3,0,1,0,73.88
高雄縣,大寮鄉,江山村,276,1,453,4,457,664,3,1,3,0,1,0,68.83
高雄縣,大寮鄉,江山村,277,1,616,4,620,828,3,1,3,0,1,0,74.88
高雄縣,大寮鄉,中庄村,278,1,652,10,662,1062,3,1,3,0,1,0,62.34
高雄縣,大寮鄉,中庄村,279,1,639,3,642,992,3,1,3,0,1,0,64.72
高雄縣,大寮鄉,中庄村,280,1,546,7,553,859,3,1,3,0,1,0,64.38
高雄縣,大寮鄉,中庄村,281,1,717,7,724,1113,3,1,3,0,1,0,65.05
高雄縣,大寮鄉,中庄村,282,1,626,9,635,952,3,1,3,0,1,0,66.70
高雄縣,大寮鄉,中庄村,283,1,683,7,690,1016,3,1,3,0,1,0,67.91
高雄縣,大寮鄉,中庄村,284,1,644,4,648,1030,3,1,3,0,1,0,62.91
高雄縣,大寮鄉,中庄村,285,1,735,10,745,1100,3,1,3,0,1,0,67.73
高雄縣,大寮鄉,後庄村,286,1,727,32,759,1144,3,1,3,0,1,0,66.35
高雄縣,大寮鄉,後庄村,287,1,801,7,808,1237,3,1,3,0,1,0,65.32
高雄縣,大寮鄉,後庄村,288,1,754,12,766,1212,3,1,3,0,1,0,63.20
高雄縣,大寮鄉,後庄村,289,1,837,11,848,1396,3,1,3,0,1,0,60.74
高雄縣,大寮鄉,前庄村,290,1,673,10,683,956,3,1,3,0,1,0,71.44
高雄縣,大寮鄉,前庄村,291,1,643,4,647,1009,3,1,3,0,1,0,64.12
高雄縣,大寮鄉,中興村,292,1,939,15,954,1419,3,1,3,0,1,0,67.23
高雄縣,大寮鄉,中興村,293,1,770,8,778,1188,3,1,3,0,1,0,65.49
高雄縣,大寮鄉,中興村,294,1,689,7,696,1077,3,1,3,0,1,0,64.62
高雄縣,大寮鄉,中興村,295,1,664,8,672,958,3,1,3,0,1,0,70.15
高雄縣,大寮鄉,中興村,296,1,611,12,623,888,3,1,3,0,1,0,70.16
高雄縣,大寮鄉,忠義村,297,1,862,11,873,1224,3,1,3,0,1,0,71.32
高雄縣,大寮鄉,忠義村,298,1,807,9,816,1133,3,1,3,0,1,0,72.02
高雄縣,大寮鄉,光武村,299,1,710,9,719,1015,3,1,3,0,1,0,70.84
高雄縣,大寮鄉,光武村,300,1,712,11,723,986,3,1,3,0,1,0,73.33
高雄縣,大寮鄉,復興村,301,1,593,8,601,816,3,1,3,0,1,0,73.65
高雄縣,大寮鄉,復興村,302,1,624,12,636,901,3,1,3,0,1,0,70.59
高雄縣,大寮鄉,復興村,303,1,715,5,720,977,3,1,3,0,1,0,73.69
高雄縣,大寮鄉,復興村,304,1,631,12,643,872,3,1,3,0,1,0,73.74
高雄縣,大寮鄉,翁園村,305,1,996,13,1009,1414,3,1,3,0,1,0,71.36
高雄縣,大寮鄉,翁園村,306,1,784,8,792,1182,3,1,3,0,1,0,67.01
高雄縣,大寮鄉,琉球村,307,1,532,10,542,830,3,1,3,0,1,0,65.30
高雄縣,大寮鄉,琉球村,308,1,596,7,603,932,3,1,3,0,1,0,64.70
高雄縣,大寮鄉,琉球村,309,1,879,4,883,1196,3,1,3,0,1,0,73.83
高雄縣,大寮鄉,永芳村,310,1,613,4,617,924,3,1,3,0,1,0,66.77
高雄縣,大寮鄉,永芳村,311,1,593,6,599,919,3,1,3,0,1,0,65.18
高雄縣,大寮鄉,永芳村,312,1,614,10,624,1032,3,1,3,0,1,0,60.47
高雄縣,大寮鄉,永芳村,313,1,551,4,555,834,3,1,3,0,1,0,66.55
高雄縣,大寮鄉,永芳村,314,1,755,6,761,1160,3,1,3,0,1,0,65.60
高雄縣,大寮鄉,永芳村,315,1,661,6,667,989,3,1,3,0,1,0,67.44
高雄縣,大寮鄉,山頂村,316,1,915,7,922,1295,3,1,3,0,1,0,71.20
高雄縣,大寮鄉,山頂村,317,1,901,8,909,1344,3,1,3,0,1,0,67.63
高雄縣,大寮鄉,山頂村,318,1,736,9,745,1279,3,1,3,0,1,0,58.25
高雄縣,大寮鄉,山頂村,319,1,991,9,1000,1578,3,1,3,0,1,0,63.37
高雄縣,大寮鄉,會社村,320,1,610,6,616,944,3,1,3,0,1,0,65.25
高雄縣,大寮鄉,會社村,321,1,740,4,744,1028,3,1,3,0,1,0,72.37
高雄縣,大寮鄉,會社村,322,1,879,8,887,1367,3,1,3,0,1,0,64.89
高雄縣,大寮鄉,會社村,323,1,728,2,730,1071,3,1,3,0,1,0,68.16
高雄縣,大寮鄉,三隆村,324,1,885,7,892,1278,3,1,3,0,1,0,69.80
高雄縣,大寮鄉,三隆村,325,1,842,9,851,1291,3,1,3,0,1,0,65.92
高雄縣,大寮鄉,三隆村,326,1,813,7,820,1284,3,1,3,0,1,0,63.86
高雄縣,大寮鄉,上寮村,327,1,713,3,716,1077,3,1,3,0,1,0,66.48
高雄縣,大寮鄉,上寮村,328,1,672,3,675,954,3,1,3,0,1,0,70.75
高雄縣,大寮鄉,大寮村,329,1,773,11,784,1276,3,1,3,0,1,0,61.44
高雄縣,大寮鄉,大寮村,330,1,900,6,906,1484,3,1,3,0,1,0,61.05
高雄縣,大寮鄉,大寮村,331,1,867,4,871,1346,3,1,3,0,1,0,64.71
高雄縣,大寮鄉,大寮村,332,1,741,9,750,1225,3,1,3,0,1,0,61.22
高雄縣,大寮鄉,拷潭村,333,1,500,8,508,705,3,1,3,0,1,0,72.06
高雄縣,大寮鄉,拷潭村,334,1,377,4,381,567,3,1,3,0,1,0,67.20
高雄縣,大寮鄉,內坑村,335,1,672,12,684,1223,3,1,3,0,1,0,55.93
高雄縣,大寮鄉,內坑村,336,1,584,6,590,901,3,1,3,0,1,0,65.48
高雄縣,大寮鄉,內坑村,337,1,442,2,444,863,3,1,3,0,1,0,51.45
高雄縣,大寮鄉,內坑村,338,1,293,3,296,435,3,1,3,0,1,0,68.05
高雄縣,大寮鄉,新厝村,339,1,872,18,890,1367,3,1,3,0,1,0,65.11
高雄縣,大寮鄉,過溪村,340,1,706,8,714,1069,3,1,3,0,1,0,66.79
高雄縣,大寮鄉,過溪村,341,1,446,9,455,658,3,1,3,0,1,0,69.15
高雄縣,大寮鄉,潮寮村,342,1,891,11,902,1278,3,1,3,0,1,0,70.58
高雄縣,大寮鄉,潮寮村,343,1,912,5,917,1262,3,1,3,0,1,0,72.66
高雄縣,大寮鄉,會結村,344,1,867,13,880,1219,3,1,3,0,1,0,72.19
高雄縣,大寮鄉,昭明村,345,1,698,5,703,1026,3,1,3,0,1,0,68.52
高雄縣,大寮鄉,昭明村,346,1,671,7,678,979,3,1,3,0,1,0,69.25
高雄縣,大寮鄉,昭明村,347,1,558,3,561,915,3,1,3,0,1,0,61.31
高雄縣,大寮鄉,義仁村,348,1,633,2,635,973,3,1,3,0,1,0,65.26
高雄縣,大寮鄉,義仁村,349,1,543,9,552,785,3,1,3,0,1,0,70.32
高雄縣,大樹鄉,竹寮村,350,1,679,9,688,1017,3,1,3,0,1,0,67.65
高雄縣,大樹鄉,竹寮村,351,1,652,6,658,1033,3,1,3,0,1,0,63.70
高雄縣,大樹鄉,九曲村,352,1,980,17,997,1633,3,1,3,0,1,0,61.05
高雄縣,大樹鄉,九曲村,353,1,864,9,873,1237,3,1,3,0,1,0,70.57
高雄縣,大樹鄉,九曲村,354,1,733,14,747,1152,3,1,3,0,1,0,64.84
高雄縣,大樹鄉,久堂村,355,1,977,16,993,1426,3,1,3,0,1,0,69.64
高雄縣,大樹鄉,久堂村,356,1,778,9,787,1092,3,1,3,0,1,0,72.07
高雄縣,大樹鄉,久堂村,357,1,1015,13,1028,1493,3,1,3,0,1,0,68.85
高雄縣,大樹鄉,水安村,358,1,777,7,784,1088,3,1,3,0,1,0,72.06
高雄縣,大樹鄉,水安村,359,1,715,5,720,1058,3,1,3,0,1,0,68.05
高雄縣,大樹鄉,水寮村,360,1,773,9,782,1078,3,1,3,0,1,0,72.54
高雄縣,大樹鄉,水寮村,361,1,813,6,819,1155,3,1,3,0,1,0,70.91
高雄縣,大樹鄉,井腳村,362,1,552,6,558,760,3,1,3,0,1,0,73.42
高雄縣,大樹鄉,井腳村,363,1,537,7,544,791,3,1,3,0,1,0,68.77
高雄縣,大樹鄉,小坪村,364,1,874,9,883,1226,3,1,3,0,1,0,72.02
高雄縣,大樹鄉,龍目村,365,1,531,6,537,725,3,1,3,0,1,0,74.07
高雄縣,大樹鄉,龍目村,366,1,622,5,627,841,3,1,3,0,1,0,74.55
高雄縣,大樹鄉,大樹村,367,1,812,6,818,1125,3,1,3,0,1,0,72.71
高雄縣,大樹鄉,大樹村,368,1,761,9,770,1043,3,1,3,0,1,0,73.83
高雄縣,大樹鄉,檨腳村,369,1,773,6,779,1107,3,1,3,0,1,0,70.37
高雄縣,大樹鄉,檨腳村,370,1,623,4,627,922,3,1,3,0,1,0,68.00
高雄縣,大樹鄉,檨腳村,371,1,715,6,721,1068,3,1,3,0,1,0,67.51
高雄縣,大樹鄉,興山村,372,1,721,6,727,1061,3,1,3,0,1,0,68.52
高雄縣,大樹鄉,和山村,373,1,674,4,678,952,3,1,3,0,1,0,71.22
高雄縣,大樹鄉,姑山村,374,1,689,12,701,988,3,1,3,0,1,0,70.95
高雄縣,大樹鄉,三和村,375,1,557,4,561,831,3,1,3,0,1,0,67.51
高雄縣,大樹鄉,大坑村,376,1,916,7,923,1328,3,1,3,0,1,0,69.50
高雄縣,大樹鄉,溪埔村,377,1,569,2,571,812,3,1,3,0,1,0,70.32
高雄縣,大樹鄉,溪埔村,378,1,651,8,659,953,3,1,3,0,1,0,69.15
高雄縣,大樹鄉,興田村,379,1,672,2,674,988,3,1,3,0,1,0,68.22
高雄縣,大樹鄉,興田村,380,1,492,3,495,917,3,1,3,0,1,0,53.98
高雄縣,大樹鄉,鐘鈴村,381,1,450,6,456,631,3,1,3,0,1,0,72.27
高雄縣,大社鄉,嘉誠村,382,1,623,15,638,965,3,1,3,0,1,0,66.11
高雄縣,大社鄉,保社村,383,1,757,12,769,1087,3,1,3,0,1,0,70.75
高雄縣,大社鄉,保社村,384,1,545,9,554,931,3,1,3,0,1,0,59.51
高雄縣,大社鄉,大社村,385,1,627,8,635,986,3,1,3,0,1,0,64.40
高雄縣,大社鄉,大社村,386,1,600,7,607,922,3,1,3,0,1,0,65.84
高雄縣,大社鄉,大社村,387,1,736,6,742,1079,3,1,3,0,1,0,68.77
高雄縣,大社鄉,大社村,388,1,676,9,685,990,3,1,3,0,1,0,69.19
高雄縣,大社鄉,保安村,389,1,815,7,822,1196,3,1,3,0,1,0,68.73
高雄縣,大社鄉,保安村,390,1,882,5,887,1305,3,1,3,0,1,0,67.97
高雄縣,大社鄉,三奶村,391,1,1019,10,1029,1522,3,1,3,0,1,0,67.61
高雄縣,大社鄉,三奶村,392,1,698,7,705,1011,3,1,3,0,1,0,69.73
高雄縣,大社鄉,觀音村,393,1,699,4,703,960,3,1,3,0,1,0,73.23
高雄縣,大社鄉,觀音村,394,1,914,9,923,1378,3,1,3,0,1,0,66.98
高雄縣,大社鄉,觀音村,395,1,742,11,753,1124,3,1,3,0,1,0,66.99
高雄縣,大社鄉,觀音村,396,1,685,10,695,1074,3,1,3,0,1,0,64.71
高雄縣,大社鄉,神農村,397,1,740,9,749,1196,3,1,3,0,1,0,62.63
高雄縣,大社鄉,神農村,398,1,772,8,780,1196,3,1,3,0,1,0,65.22
高雄縣,大社鄉,神農村,399,1,711,8,719,1096,3,1,3,0,1,0,65.60
高雄縣,大社鄉,中里村,400,1,1003,11,1014,1429,3,1,3,0,1,0,70.96
高雄縣,大社鄉,中里村,401,1,824,12,836,1311,3,1,3,0,1,0,63.77
高雄縣,大社鄉,翠屏村,402,1,1030,18,1048,1449,3,1,3,0,1,0,72.33
高雄縣,仁武鄉,仁武村,403,1,902,7,909,1379,3,1,3,0,1,0,65.92
高雄縣,仁武鄉,仁武村,404,1,846,14,860,1285,3,1,3,0,1,0,66.93
高雄縣,仁武鄉,仁武村,405,1,929,10,939,1358,3,1,3,0,1,0,69.15
高雄縣,仁武鄉,文武村,406,1,773,9,782,1180,3,1,3,0,1,0,66.27
高雄縣,仁武鄉,文武村,407,1,877,10,887,1463,3,1,3,0,1,0,60.63
高雄縣,仁武鄉,文武村,408,1,647,9,656,981,3,1,3,0,1,0,66.87
高雄縣,仁武鄉,文武村,409,1,541,1,542,897,3,1,3,0,1,0,60.42
高雄縣,仁武鄉,後安村,410,1,641,9,650,987,3,1,3,0,1,0,65.86
高雄縣,仁武鄉,後安村,411,1,676,6,682,1077,3,1,3,0,1,0,63.32
高雄縣,仁武鄉,竹後村,412,1,780,13,793,1109,3,1,3,0,1,0,71.51
高雄縣,仁武鄉,竹後村,413,1,694,9,703,1056,3,1,3,0,1,0,66.57
高雄縣,仁武鄉,中華村,414,1,780,12,792,1264,3,1,3,0,1,0,62.66
高雄縣,仁武鄉,八卦村,415,1,739,8,747,1115,3,1,3,0,1,0,67.00
高雄縣,仁武鄉,八卦村,416,1,871,10,881,1448,3,1,3,0,1,0,60.84
高雄縣,仁武鄉,八卦村,417,1,672,14,686,1109,3,1,3,0,1,0,61.86
高雄縣,仁武鄉,八卦村,418,1,667,10,677,1222,3,1,3,0,1,0,55.40
高雄縣,仁武鄉,五和村,419,1,690,10,700,1151,3,1,3,0,1,0,60.82
高雄縣,仁武鄉,五和村,420,1,657,14,671,975,3,1,3,0,1,0,68.82
高雄縣,仁武鄉,高楠村,421,1,594,8,602,886,3,1,3,0,1,0,67.95
高雄縣,仁武鄉,高楠村,422,1,581,18,599,812,3,1,3,0,1,0,73.77
高雄縣,仁武鄉,大灣村,423,1,994,14,1008,1622,3,1,3,0,1,0,62.15
高雄縣,仁武鄉,赤山村,424,1,644,14,658,974,3,1,3,0,1,0,67.56
高雄縣,仁武鄉,赤山村,425,1,523,9,532,842,3,1,3,0,1,0,63.18
高雄縣,仁武鄉,仁和村,426,1,657,9,666,991,3,1,3,0,1,0,67.20
高雄縣,仁武鄉,仁和村,427,1,478,4,482,803,3,1,3,0,1,0,60.02
高雄縣,仁武鄉,灣內村,428,1,945,6,951,1473,3,1,3,0,1,0,64.56
高雄縣,仁武鄉,灣內村,429,1,894,12,906,1406,3,1,3,0,1,0,64.44
高雄縣,仁武鄉,仁慈村,430,1,767,7,774,1217,3,1,3,0,1,0,63.60
高雄縣,仁武鄉,考潭村,431,1,822,10,832,1303,3,1,3,0,1,0,63.85
高雄縣,仁武鄉,考潭村,432,1,811,15,826,1218,3,1,3,0,1,0,67.82
高雄縣,仁武鄉,烏林村,433,1,1062,11,1073,1590,3,1,3,0,1,0,67.48
高雄縣,仁武鄉,烏林村,434,1,683,9,692,1081,3,1,3,0,1,0,64.01
高雄縣,仁武鄉,仁福村,435,1,412,6,418,571,3,1,3,0,1,0,73.20
高雄縣,鳥松鄉,鳥松村,436,1,1054,7,1061,1702,3,1,3,0,1,0,62.34
高雄縣,鳥松鄉,鳥松村,437,1,918,11,929,1366,3,1,3,0,1,0,68.01
高雄縣,鳥松鄉,鳥松村,438,1,782,5,787,1420,3,1,3,0,1,0,55.42
高雄縣,鳥松鄉,鳥松村,439,1,705,9,714,1190,3,1,3,0,1,0,60.00
高雄縣,鳥松鄉,鳥松村,440,1,906,17,923,1387,3,1,3,0,1,0,66.55
高雄縣,鳥松鄉,夢裡村,441,1,805,14,819,1121,3,1,3,0,1,0,73.06
高雄縣,鳥松鄉,夢裡村,442,1,817,9,826,1335,3,1,3,0,1,0,61.87
高雄縣,鳥松鄉,大華村,443,1,1037,19,1056,1498,3,1,3,0,1,0,70.49
高雄縣,鳥松鄉,大華村,444,1,967,11,978,1595,3,1,3,0,1,0,61.32
高雄縣,鳥松鄉,大華村,445,1,736,6,742,1297,3,1,3,0,1,0,57.21
高雄縣,鳥松鄉,大華村,446,1,762,10,772,1314,3,1,3,0,1,0,58.75
高雄縣,鳥松鄉,大華村,447,1,806,7,813,1328,3,1,3,0,1,0,61.22
高雄縣,鳥松鄉,濫埔村,448,1,903,11,914,1276,3,1,3,0,1,0,71.63
高雄縣,鳥松鄉,濫埔村,449,1,1029,18,1047,1486,3,1,3,0,1,0,70.46
高雄縣,鳥松鄉,仁美村,450,1,875,14,889,1279,3,1,3,0,1,0,69.51
高雄縣,鳥松鄉,仁美村,451,1,996,7,1003,1305,3,1,3,0,1,0,76.86
高雄縣,鳥松鄉,仁美村,452,1,1055,15,1070,1623,3,1,3,0,1,0,65.93
高雄縣,鳥松鄉,仁美村,453,1,839,10,849,1364,3,1,3,0,1,0,62.24
高雄縣,鳥松鄉,華美村,454,1,1084,9,1093,1540,3,1,3,0,1,0,70.97
高雄縣,鳥松鄉,華美村,455,1,1041,17,1058,1539,3,1,3,0,1,0,68.75
高雄縣,鳥松鄉,大竹村,456,1,451,5,456,657,3,1,3,0,1,0,69.41
高雄縣,岡山鎮,岡山里,457,1,905,7,912,1342,3,1,3,0,1,0,67.96
高雄縣,岡山鎮,岡山里,458,1,718,6,724,1163,3,1,3,0,1,0,62.25
高雄縣,岡山鎮,岡山里,459,1,719,6,725,1131,3,1,3,0,1,0,64.10
高雄縣,岡山鎮,平安里,460,1,865,7,872,1273,3,1,3,0,1,0,68.50
高雄縣,岡山鎮,壽天里,461,1,734,8,742,1197,3,1,3,0,1,0,61.99
高雄縣,岡山鎮,壽天里,462,1,708,16,724,1080,3,1,3,0,1,0,67.04
高雄縣,岡山鎮,壽天里,463,1,431,1,432,655,3,1,3,0,1,0,65.95
高雄縣,岡山鎮,維仁里,464,1,391,2,393,604,3,1,3,0,1,0,65.07
高雄縣,岡山鎮,維仁里,465,1,431,5,436,631,3,1,3,0,1,0,69.10
高雄縣,岡山鎮,灣裡里,466,1,830,11,841,1219,3,1,3,0,1,0,68.99
高雄縣,岡山鎮,大遼里,467,1,853,9,862,1212,3,1,3,0,1,0,71.12
高雄縣,岡山鎮,後紅里,468,1,788,11,799,1212,3,1,3,0,1,0,65.92
高雄縣,岡山鎮,後紅里,469,1,1031,5,1036,1679,3,1,3,0,1,0,61.70
高雄縣,岡山鎮,碧紅里,470,1,977,14,991,1540,3,1,3,0,1,0,64.35
高雄縣,岡山鎮,碧紅里,471,1,834,4,838,1325,3,1,3,0,1,0,63.25
高雄縣,岡山鎮,程香里,472,1,1051,12,1063,1511,3,1,3,0,1,0,70.35
高雄縣,岡山鎮,程香里,473,1,788,6,794,1233,3,1,3,0,1,0,64.40
高雄縣,岡山鎮,竹圍里,474,1,871,8,879,1404,3,1,3,0,1,0,62.61
高雄縣,岡山鎮,竹圍里,475,1,863,12,875,1346,3,1,3,0,1,0,65.01
高雄縣,岡山鎮,竹圍里,476,1,813,11,824,1226,3,1,3,0,1,0,67.21
高雄縣,岡山鎮,台上里,477,1,1110,16,1126,1676,3,1,3,0,1,0,67.18
高雄縣,岡山鎮,台上里,478,1,1098,10,1108,1673,3,1,3,0,1,0,66.23
高雄縣,岡山鎮,為隨里,479,1,415,3,418,572,3,1,3,0,1,0,73.08
高雄縣,岡山鎮,前峰里,480,1,726,16,742,1125,3,1,3,0,1,0,65.96
高雄縣,岡山鎮,前峰里,481,1,870,14,884,1324,3,1,3,0,1,0,66.77
高雄縣,岡山鎮,壽峰里,482,1,611,13,624,941,3,1,3,0,1,0,66.31
高雄縣,岡山鎮,壽峰里,483,1,571,7,578,802,3,1,3,0,1,0,72.07
高雄縣,岡山鎮,仁壽里,484,1,708,6,714,1042,3,1,3,0,1,0,68.52
高雄縣,岡山鎮,仁壽里,485,1,653,3,656,955,3,1,3,0,1,0,68.69
高雄縣,岡山鎮,仁壽里,486,1,872,8,880,1263,3,1,3,0,1,0,69.68
高雄縣,岡山鎮,協和里,487,1,775,11,786,1244,3,1,3,0,1,0,63.18
高雄縣,岡山鎮,協和里,488,1,856,6,862,1310,3,1,3,0,1,0,65.80
高雄縣,岡山鎮,協和里,489,1,382,6,388,530,3,1,3,0,1,0,73.21
高雄縣,岡山鎮,本洲里,490,1,973,6,979,1360,3,1,3,0,1,0,71.99
高雄縣,岡山鎮,後協里,491,1,640,4,644,1088,3,1,3,0,1,0,59.19
高雄縣,岡山鎮,後協里,492,1,711,5,716,1041,3,1,3,0,1,0,68.78
高雄縣,岡山鎮,後協里,493,1,739,10,749,1124,3,1,3,0,1,0,66.64
高雄縣,岡山鎮,後協里,494,1,850,17,867,1396,3,1,3,0,1,0,62.11
高雄縣,岡山鎮,協榮里,495,1,760,7,767,1134,3,1,3,0,1,0,67.64
高雄縣,岡山鎮,協榮里,496,1,525,7,532,791,3,1,3,0,1,0,67.26
高雄縣,岡山鎮,劉厝里,497,1,934,9,943,1357,3,1,3,0,1,0,69.49
高雄縣,岡山鎮,白米里,498,1,658,5,663,872,3,1,3,0,1,0,76.03
高雄縣,岡山鎮,石潭里,499,1,874,7,881,1215,3,1,3,0,1,0,72.51
高雄縣,岡山鎮,福興里,500,1,747,8,755,1035,3,1,3,0,1,0,72.95
高雄縣,岡山鎮,嘉興里,501,1,731,11,742,1071,3,1,3,0,1,0,69.28
高雄縣,岡山鎮,嘉興里,502,1,692,4,696,1032,3,1,3,0,1,0,67.44
高雄縣,岡山鎮,嘉興里,503,1,705,12,717,1077,3,1,3,0,1,0,66.57
高雄縣,岡山鎮,嘉峰里,504,1,949,14,963,1334,3,1,3,0,1,0,72.19
高雄縣,岡山鎮,嘉峰里,505,1,228,1,229,290,3,1,3,0,1,0,78.97
高雄縣,岡山鎮,潭底里,506,1,555,18,573,737,3,1,3,0,1,0,77.75
高雄縣,岡山鎮,華崗里,507,1,1077,11,1088,1341,3,1,3,0,1,0,81.13
高雄縣,岡山鎮,三和里,508,1,539,6,545,731,3,1,3,0,1,0,74.56
高雄縣,岡山鎮,大莊里,509,1,594,12,606,869,3,1,3,0,1,0,69.74
高雄縣,岡山鎮,忠孝里,510,1,286,2,288,430,3,1,3,0,1,0,66.98
高雄縣,岡山鎮,和平里,511,1,613,11,624,916,3,1,3,0,1,0,68.12
高雄縣,岡山鎮,信義里,512,1,648,7,655,944,3,1,3,0,1,0,69.39
高雄縣,岡山鎮,信義里,513,1,785,12,797,1180,3,1,3,0,1,0,67.54
高雄縣,岡山鎮,仁愛里,514,1,394,3,397,603,3,1,3,0,1,0,65.84
高雄縣,岡山鎮,仁愛里,515,1,535,9,544,758,3,1,3,0,1,0,71.77
高雄縣,岡山鎮,四維里,516,1,395,4,399,546,3,1,3,0,1,0,73.08
高雄縣,岡山鎮,四維里,517,1,474,9,483,648,3,1,3,0,1,0,74.54
高雄縣,岡山鎮,復興里,518,1,286,9,295,450,3,1,3,0,1,0,65.56
高雄縣,橋頭鄉,橋頭村,519,1,644,11,655,976,3,1,3,0,1,0,67.11
高雄縣,橋頭鄉,橋頭村,520,1,463,4,467,644,3,1,3,0,1,0,72.52
高雄縣,橋頭鄉,橋南村,521,1,592,15,607,881,3,1,3,0,1,0,68.90
高雄縣,橋頭鄉,興糖村,522,1,186,1,187,258,3,1,3,0,1,0,72.48
高雄縣,橋頭鄉,仕隆村,523,1,624,4,628,904,3,1,3,0,1,0,69.47
高雄縣,橋頭鄉,仕隆村,524,1,828,8,836,1233,3,1,3,0,1,0,67.80
高雄縣,橋頭鄉,仕豐村,525,1,670,10,680,1032,3,1,3,0,1,0,65.89
高雄縣,橋頭鄉,仕豐村,526,1,740,7,747,1102,3,1,3,0,1,0,67.79
高雄縣,橋頭鄉,仕和村,527,1,746,9,755,1117,3,1,3,0,1,0,67.59
高雄縣,橋頭鄉,仕和村,528,1,737,8,745,1088,3,1,3,0,1,0,68.47
高雄縣,橋頭鄉,仕和村,529,1,657,7,664,962,3,1,3,0,1,0,69.02
高雄縣,橋頭鄉,新莊村,530,1,584,7,591,779,3,1,3,0,1,0,75.87
高雄縣,橋頭鄉,新莊村,531,1,234,6,240,313,3,1,3,0,1,0,76.68
高雄縣,橋頭鄉,新莊村,532,1,142,1,143,190,3,1,3,0,1,0,75.26
高雄縣,橋頭鄉,甲北村,533,1,757,14,771,1081,3,1,3,0,1,0,71.32
高雄縣,橋頭鄉,甲北村,534,1,538,11,549,826,3,1,3,0,1,0,66.46
高雄縣,橋頭鄉,甲南村,535,1,714,13,727,1033,3,1,3,0,1,0,70.38
高雄縣,橋頭鄉,甲南村,536,1,748,11,759,1001,3,1,3,0,1,0,75.82
高雄縣,橋頭鄉,頂鹽村,537,1,781,10,791,1069,3,1,3,0,1,0,73.99
高雄縣,橋頭鄉,白樹村,538,1,864,7,871,1325,3,1,3,0,1,0,65.74
高雄縣,橋頭鄉,白樹村,539,1,671,11,682,988,3,1,3,0,1,0,69.03
高雄縣,橋頭鄉,白樹村,540,1,255,10,265,316,3,1,3,0,1,0,83.86
高雄縣,橋頭鄉,芋寮村,541,1,841,7,848,1133,3,1,3,0,1,0,74.85
高雄縣,橋頭鄉,芋寮村,542,1,481,7,488,713,3,1,3,0,1,0,68.44
高雄縣,橋頭鄉,西林村,543,1,535,8,543,729,3,1,3,0,1,0,74.49
高雄縣,橋頭鄉,西林村,544,1,536,12,548,738,3,1,3,0,1,0,74.25
高雄縣,橋頭鄉,東林村,545,1,723,11,734,1046,3,1,3,0,1,0,70.17
高雄縣,橋頭鄉,東林村,546,1,806,12,818,1070,3,1,3,0,1,0,76.45
高雄縣,橋頭鄉,德松村,547,1,726,9,735,1023,3,1,3,0,1,0,71.85
高雄縣,橋頭鄉,筆秀村,548,1,413,5,418,549,3,1,3,0,1,0,76.14
高雄縣,橋頭鄉,筆秀村,549,1,654,12,666,864,3,1,3,0,1,0,77.08
高雄縣,橋頭鄉,中崎村,550,1,432,2,434,647,3,1,3,0,1,0,67.08
高雄縣,燕巢鄉,金山村,551,1,317,1,318,432,3,1,3,0,1,0,73.61
高雄縣,燕巢鄉,尖山村,552,1,802,16,818,1113,3,1,3,0,1,0,73.50
高雄縣,燕巢鄉,東燕村,553,1,990,8,998,1325,3,1,3,0,1,0,75.32
高雄縣,燕巢鄉,東燕村,554,1,664,8,672,883,3,1,3,0,1,0,76.10
高雄縣,燕巢鄉,西燕村,555,1,748,4,752,1035,3,1,3,0,1,0,72.66
高雄縣,燕巢鄉,西燕村,556,1,654,3,657,919,3,1,3,0,1,0,71.49
高雄縣,燕巢鄉,西燕村,557,1,711,4,715,1015,3,1,3,0,1,0,70.44
高雄縣,燕巢鄉,南燕村,558,1,966,13,979,1347,3,1,3,0,1,0,72.68
高雄縣,燕巢鄉,南燕村,559,1,923,9,932,1274,3,1,3,0,1,0,73.16
高雄縣,燕巢鄉,瓊林村,560,1,546,8,554,786,3,1,3,0,1,0,70.48
高雄縣,燕巢鄉,瓊林村,561,1,667,5,672,938,3,1,3,0,1,0,71.64
高雄縣,燕巢鄉,安招村,562,1,958,17,975,1324,3,1,3,0,1,0,73.64
高雄縣,燕巢鄉,安招村,563,1,1030,21,1051,1408,3,1,3,0,1,0,74.64
高雄縣,燕巢鄉,安招村,564,1,162,6,168,290,3,1,3,0,1,0,57.93
高雄縣,燕巢鄉,安招村,565,1,238,5,243,376,3,1,3,0,1,0,64.63
高雄縣,燕巢鄉,安招村,566,1,364,13,377,639,3,1,3,0,1,0,59.00
高雄縣,燕巢鄉,角宿村,567,1,603,8,611,823,3,1,3,0,1,0,74.24
高雄縣,燕巢鄉,角宿村,568,1,435,12,447,554,3,1,3,0,1,0,80.69
高雄縣,燕巢鄉,角宿村,569,1,483,9,492,758,3,1,3,0,1,0,64.91
高雄縣,燕巢鄉,鳳雄村,570,1,689,11,700,1009,3,1,3,0,1,0,69.38
高雄縣,燕巢鄉,鳳雄村,571,1,878,15,893,1243,3,1,3,0,1,0,71.84
高雄縣,燕巢鄉,橫山村,572,1,648,13,661,918,3,1,3,0,1,0,72.00
高雄縣,燕巢鄉,橫山村,573,1,558,3,561,846,3,1,3,0,1,0,66.31
高雄縣,燕巢鄉,深水村,574,1,887,12,899,1245,3,1,3,0,1,0,72.21
高雄縣,燕巢鄉,深水村,575,1,814,18,832,1184,3,1,3,0,1,0,70.27
高雄縣,田寮鄉,鹿埔村,576,1,243,1,244,356,3,1,3,0,1,0,68.54
高雄縣,田寮鄉,古亭村,577,1,428,6,434,672,3,1,3,0,1,0,64.58
高雄縣,田寮鄉,崇德村,578,1,718,10,728,966,3,1,3,0,1,0,75.36
高雄縣,田寮鄉,三和村,579,1,278,5,283,437,3,1,3,0,1,0,64.76
高雄縣,田寮鄉,西德村,580,1,570,14,584,898,3,1,3,0,1,0,65.03
高雄縣,田寮鄉,南安村,581,1,541,6,547,795,3,1,3,0,1,0,68.81
高雄縣,田寮鄉,南安村,582,1,378,8,386,557,3,1,3,0,1,0,69.30
高雄縣,田寮鄉,大同村,583,1,299,1,300,417,3,1,3,0,1,0,71.94
高雄縣,田寮鄉,田寮村,584,1,295,2,297,452,3,1,3,0,1,0,65.71
高雄縣,田寮鄉,七星村,585,1,639,4,643,921,3,1,3,0,1,0,69.82
高雄縣,田寮鄉,新興村,586,1,984,17,1001,1332,3,1,3,0,1,0,75.15
高雄縣,阿蓮鄉,阿蓮村,587,1,973,4,977,1517,3,1,3,0,1,0,64.40
高雄縣,阿蓮鄉,阿蓮村,588,1,798,3,801,1185,3,1,3,0,1,0,67.59
高雄縣,阿蓮鄉,阿蓮村,589,1,868,13,881,1319,3,1,3,0,1,0,66.79
高雄縣,阿蓮鄉,南蓮村,590,1,976,13,989,1430,3,1,3,0,1,0,69.16
高雄縣,阿蓮鄉,南蓮村,591,1,817,9,826,1217,3,1,3,0,1,0,67.87
高雄縣,阿蓮鄉,清蓮村,592,1,936,11,947,1433,3,1,3,0,1,0,66.09
高雄縣,阿蓮鄉,清蓮村,593,1,712,7,719,1075,3,1,3,0,1,0,66.88
高雄縣,阿蓮鄉,和蓮村,594,1,628,8,636,883,3,1,3,0,1,0,72.03
高雄縣,阿蓮鄉,和蓮村,595,1,706,6,712,1107,3,1,3,0,1,0,64.32
高雄縣,阿蓮鄉,青旗村,596,1,875,11,886,1289,3,1,3,0,1,0,68.74
高雄縣,阿蓮鄉,石安村,597,1,804,14,818,1279,3,1,3,0,1,0,63.96
高雄縣,阿蓮鄉,中路村,598,1,654,12,666,1006,3,1,3,0,1,0,66.20
高雄縣,阿蓮鄉,中路村,599,1,564,3,567,905,3,1,3,0,1,0,62.65
高雄縣,阿蓮鄉,峰山村,600,1,837,11,848,1125,3,1,3,0,1,0,75.38
高雄縣,阿蓮鄉,港後村,601,1,928,15,943,1303,3,1,3,0,1,0,72.37
高雄縣,阿蓮鄉,港後村,602,1,368,1,369,506,3,1,3,0,1,0,72.92
高雄縣,阿蓮鄉,崗山村,603,1,481,7,488,701,3,1,3,0,1,0,69.61
高雄縣,阿蓮鄉,復安村,604,1,590,11,601,796,3,1,3,0,1,0,75.50
高雄縣,阿蓮鄉,復安村,605,1,532,6,538,779,3,1,3,0,1,0,69.06
高雄縣,阿蓮鄉,玉庫村,606,1,686,12,698,967,3,1,3,0,1,0,72.18
高雄縣,路竹鄉,竹園村,607,1,560,6,566,789,3,1,3,0,1,0,71.74
高雄縣,路竹鄉,竹園村,608,1,616,10,626,915,3,1,3,0,1,0,68.42
高雄縣,路竹鄉,下坑村,609,1,880,10,890,1207,3,1,3,0,1,0,73.74
高雄縣,路竹鄉,下坑村,610,1,921,12,933,1258,3,1,3,0,1,0,74.17
高雄縣,路竹鄉,甲南村,611,1,683,10,693,936,3,1,3,0,1,0,74.04
高雄縣,路竹鄉,甲南村,612,1,705,7,712,920,3,1,3,0,1,0,77.39
高雄縣,路竹鄉,甲南村,613,1,697,29,726,1056,3,1,3,0,1,0,68.75
高雄縣,路竹鄉,甲北村,614,1,628,8,636,941,3,1,3,0,1,0,67.59
高雄縣,路竹鄉,甲北村,615,1,690,2,692,996,3,1,3,0,1,0,69.48
高雄縣,路竹鄉,社東村,616,1,542,6,548,789,3,1,3,0,1,0,69.46
高雄縣,路竹鄉,社東村,617,1,537,6,543,810,3,1,3,0,1,0,67.04
高雄縣,路竹鄉,社中村,618,1,641,5,646,897,3,1,3,0,1,0,72.02
高雄縣,路竹鄉,社西村,619,1,763,8,771,1069,3,1,3,0,1,0,72.12
高雄縣,路竹鄉,社西村,620,1,755,13,768,1148,3,1,3,0,1,0,66.90
高雄縣,路竹鄉,社南村,621,1,742,9,751,1088,3,1,3,0,1,0,69.03
高雄縣,路竹鄉,社南村,622,1,732,6,738,1107,3,1,3,0,1,0,66.67
高雄縣,路竹鄉,社南村,623,1,709,11,720,1198,3,1,3,0,1,0,60.10
高雄縣,路竹鄉,竹東村,624,1,866,8,874,1379,3,1,3,0,1,0,63.38
高雄縣,路竹鄉,竹東村,625,1,847,7,854,1332,3,1,3,0,1,0,64.11
高雄縣,路竹鄉,竹南村,626,1,982,0,982,1475,3,1,3,0,1,0,66.58
高雄縣,路竹鄉,竹南村,627,1,795,5,800,1146,3,1,3,0,1,0,69.81
高雄縣,路竹鄉,竹西村,628,1,652,8,660,890,3,1,3,0,1,0,74.16
高雄縣,路竹鄉,竹西村,629,1,777,13,790,1137,3,1,3,0,1,0,69.48
高雄縣,路竹鄉,文南村,630,1,720,7,727,1066,3,1,3,0,1,0,68.20
高雄縣,路竹鄉,文南村,631,1,671,7,678,1007,3,1,3,0,1,0,67.33
高雄縣,路竹鄉,文北村,632,1,835,10,845,1203,3,1,3,0,1,0,70.24
高雄縣,路竹鄉,文北村,633,1,962,13,975,1381,3,1,3,0,1,0,70.60
高雄縣,路竹鄉,竹滬村,634,1,708,3,711,1143,3,1,3,0,1,0,62.20
高雄縣,路竹鄉,竹滬村,635,1,818,8,826,1305,3,1,3,0,1,0,63.30
高雄縣,路竹鄉,頂寮村,636,1,826,7,833,1165,3,1,3,0,1,0,71.50
高雄縣,路竹鄉,新達村,637,1,761,11,772,1153,3,1,3,0,1,0,66.96
高雄縣,路竹鄉,後鄉村,638,1,664,8,672,916,3,1,3,0,1,0,73.36
高雄縣,路竹鄉,北嶺村,639,1,796,7,803,1061,3,1,3,0,1,0,75.68
高雄縣,路竹鄉,三爺村,640,1,629,6,635,852,3,1,3,0,1,0,74.53
高雄縣,路竹鄉,鴨寮村,641,1,975,10,985,1425,3,1,3,0,1,0,69.12
高雄縣,湖內鄉,大湖村,642,1,437,7,444,666,3,1,3,0,1,0,66.67
高雄縣,湖內鄉,大湖村,643,1,530,6,536,787,3,1,3,0,1,0,68.11
高雄縣,湖內鄉,大湖村,644,1,704,4,708,1044,3,1,3,0,1,0,67.82
高雄縣,湖內鄉,田尾村,645,1,723,16,739,1048,3,1,3,0,1,0,70.52
高雄縣,湖內鄉,湖內村,646,1,628,11,639,924,3,1,3,0,1,0,69.16
高雄縣,湖內鄉,湖內村,647,1,984,14,998,1651,3,1,3,0,1,0,60.45
高雄縣,湖內鄉,湖內村,648,1,468,3,471,714,3,1,3,0,1,0,65.97
高雄縣,湖內鄉,湖內村,649,1,705,9,714,1183,3,1,3,0,1,0,60.36
高雄縣,湖內鄉,海埔村,650,1,510,5,515,764,3,1,3,0,1,0,67.41
高雄縣,湖內鄉,海埔村,651,1,587,11,598,946,3,1,3,0,1,0,63.21
高雄縣,湖內鄉,海山村,652,1,790,12,802,1167,3,1,3,0,1,0,68.72
高雄縣,湖內鄉,劉家村,653,1,679,5,684,1081,3,1,3,0,1,0,63.27
高雄縣,湖內鄉,太爺村,654,1,549,8,557,838,3,1,3,0,1,0,66.47
高雄縣,湖內鄉,公舘村,655,1,446,8,454,695,3,1,3,0,1,0,65.32
高雄縣,湖內鄉,公舘村,656,1,515,7,522,878,3,1,3,0,1,0,59.45
高雄縣,湖內鄉,葉厝村,657,1,548,13,561,860,3,1,3,0,1,0,65.23
高雄縣,湖內鄉,葉厝村,658,1,573,7,580,912,3,1,3,0,1,0,63.60
高雄縣,湖內鄉,文賢村,659,1,783,13,796,1157,3,1,3,0,1,0,68.80
高雄縣,湖內鄉,中賢村,660,1,594,13,607,911,3,1,3,0,1,0,66.63
高雄縣,湖內鄉,中賢村,661,1,682,7,689,1108,3,1,3,0,1,0,62.18
高雄縣,湖內鄉,逸賢村,662,1,551,15,566,992,3,1,3,0,1,0,57.06
高雄縣,湖內鄉,忠興村,663,1,478,4,482,739,3,1,3,0,1,0,65.22
高雄縣,茄萣鄉,福德村,664,1,736,13,749,1056,3,1,3,0,1,0,70.93
高雄縣,茄萣鄉,萬福村,665,1,606,6,612,878,3,1,3,0,1,0,69.70
高雄縣,茄萣鄉,白雲村,666,1,1053,12,1065,1563,3,1,3,0,1,0,68.14
高雄縣,茄萣鄉,嘉賜村,667,1,766,8,774,1247,3,1,3,0,1,0,62.07
高雄縣,茄萣鄉,嘉賜村,668,1,954,8,962,1543,3,1,3,0,1,0,62.35
高雄縣,茄萣鄉,嘉安村,669,1,910,5,915,1392,3,1,3,0,1,0,65.73
高雄縣,茄萣鄉,嘉樂村,670,1,1168,9,1177,1853,3,1,3,0,1,0,63.52
高雄縣,茄萣鄉,嘉泰村,671,1,755,8,763,1194,3,1,3,0,1,0,63.90
高雄縣,茄萣鄉,嘉福村,672,1,659,5,664,1006,3,1,3,0,1,0,66.00
高雄縣,茄萣鄉,和協村,673,1,791,10,801,1270,3,1,3,0,1,0,63.07
高雄縣,茄萣鄉,嘉定村,674,1,868,18,886,1304,3,1,3,0,1,0,67.94
高雄縣,茄萣鄉,保定村,675,1,776,7,783,1275,3,1,3,0,1,0,61.41
高雄縣,茄萣鄉,保定村,676,1,1006,14,1020,1628,3,1,3,0,1,0,62.65
高雄縣,茄萣鄉,大定村,677,1,766,8,774,1205,3,1,3,0,1,0,64.23
高雄縣,茄萣鄉,光定村,678,1,680,5,685,1053,3,1,3,0,1,0,65.05
高雄縣,茄萣鄉,吉定村,679,1,774,7,781,1239,3,1,3,0,1,0,63.03
高雄縣,茄萣鄉,崎漏村,680,1,1056,12,1068,1492,3,1,3,0,1,0,71.58
高雄縣,茄萣鄉,崎漏村,681,1,1095,14,1109,1867,3,1,3,0,1,0,59.40
高雄縣,永安鄉,永安村,682,1,508,5,513,723,3,1,3,0,1,0,70.95
高雄縣,永安鄉,永安村,683,1,547,11,558,805,3,1,3,0,1,0,69.32
高雄縣,永安鄉,永華村,684,1,581,4,585,868,3,1,3,0,1,0,67.40
高雄縣,永安鄉,永華村,685,1,584,4,588,863,3,1,3,0,1,0,68.13
高雄縣,永安鄉,新港村,686,1,717,4,721,945,3,1,3,0,1,0,76.30
高雄縣,永安鄉,新港村,687,1,478,3,481,731,3,1,3,0,1,0,65.80
高雄縣,永安鄉,新港村,688,1,439,5,444,694,3,1,3,0,1,0,63.98
高雄縣,永安鄉,鹽田村,689,1,255,1,256,416,3,1,3,0,1,0,61.54
高雄縣,永安鄉,保寧村,690,1,837,16,853,1099,3,1,3,0,1,0,77.62
高雄縣,永安鄉,保寧村,691,1,613,2,615,990,3,1,3,0,1,0,62.12
高雄縣,永安鄉,維新村,692,1,873,9,882,1225,3,1,3,0,1,0,72.00
高雄縣,永安鄉,維新村,693,1,829,10,839,1310,3,1,3,0,1,0,64.05
高雄縣,彌陀鄉,舊港村,694,1,1144,12,1156,1472,3,1,3,0,1,0,78.53
高雄縣,彌陀鄉,文安村,695,1,1316,12,1328,1788,3,1,3,0,1,0,74.27
高雄縣,彌陀鄉,鹽埕村,696,1,1385,29,1414,1878,3,1,3,0,1,0,75.29
高雄縣,彌陀鄉,過港村,697,1,736,8,744,961,3,1,3,0,1,0,77.42
高雄縣,彌陀鄉,光和村,698,1,773,11,784,1051,3,1,3,0,1,0,74.60
高雄縣,彌陀鄉,彌靖村,699,1,1357,8,1365,1841,3,1,3,0,1,0,74.14
高雄縣,彌陀鄉,彌仁村,700,1,420,6,426,574,3,1,3,0,1,0,74.22
高雄縣,彌陀鄉,彌壽村,701,1,556,3,559,728,3,1,3,0,1,0,76.79
高雄縣,彌陀鄉,彌陀村,702,1,1125,6,1131,1553,3,1,3,0,1,0,72.83
高雄縣,彌陀鄉,海尾村,703,1,582,19,601,842,3,1,3,0,1,0,71.38
高雄縣,彌陀鄉,漯底村,704,1,775,6,781,964,3,1,3,0,1,0,81.02
高雄縣,彌陀鄉,南寮村,705,1,1499,15,1514,1991,3,1,3,0,1,0,76.04
高雄縣,梓官鄉,梓信村,706,1,644,14,658,964,3,1,3,0,1,0,68.26
高雄縣,梓官鄉,梓信村,707,1,627,6,633,939,3,1,3,0,1,0,67.41
高雄縣,梓官鄉,梓義村,708,1,647,3,650,934,3,1,3,0,1,0,69.59
高雄縣,梓官鄉,梓義村,709,1,695,10,705,1048,3,1,3,0,1,0,67.27
高雄縣,梓官鄉,梓和村,710,1,950,8,958,1393,3,1,3,0,1,0,68.77
高雄縣,梓官鄉,梓和村,711,1,622,8,630,877,3,1,3,0,1,0,71.84
高雄縣,梓官鄉,梓平村,712,1,790,4,794,1058,3,1,3,0,1,0,75.05
高雄縣,梓官鄉,中崙村,713,1,718,15,733,1055,3,1,3,0,1,0,69.48
高雄縣,梓官鄉,同安村,714,1,699,5,704,936,3,1,3,0,1,0,75.21
高雄縣,梓官鄉,大舍村,715,1,809,10,819,1153,3,1,3,0,1,0,71.03
高雄縣,梓官鄉,大舍村,716,1,790,13,803,1164,3,1,3,0,1,0,68.99
高雄縣,梓官鄉,大舍村,717,1,668,6,674,1054,3,1,3,0,1,0,63.95
高雄縣,梓官鄉,赤崁村,718,1,776,3,779,1169,3,1,3,0,1,0,66.64
高雄縣,梓官鄉,赤崁村,719,1,511,6,517,736,3,1,3,0,1,0,70.24
高雄縣,梓官鄉,赤東村,720,1,919,6,925,1380,3,1,3,0,1,0,67.03
高雄縣,梓官鄉,赤東村,721,1,634,11,645,977,3,1,3,0,1,0,66.02
高雄縣,梓官鄉,赤西村,722,1,427,5,432,660,3,1,3,0,1,0,65.45
高雄縣,梓官鄉,禮蚵村,723,1,772,3,775,1144,3,1,3,0,1,0,67.74
高雄縣,梓官鄉,禮蚵村,724,1,823,10,833,1205,3,1,3,0,1,0,69.13
高雄縣,梓官鄉,智蚵村,725,1,694,8,702,1129,3,1,3,0,1,0,62.18
高雄縣,梓官鄉,智蚵村,726,1,781,10,791,1235,3,1,3,0,1,0,64.05
高雄縣,梓官鄉,信蚵村,727,1,937,13,950,1526,3,1,3,0,1,0,62.25
高雄縣,梓官鄉,茄苳村,728,1,801,13,814,1192,3,1,3,0,1,0,68.29
高雄縣,梓官鄉,茄苳村,729,1,639,6,645,979,3,1,3,0,1,0,65.88
高雄縣,梓官鄉,典寶村,730,1,793,9,802,1101,3,1,3,0,1,0,72.84
高雄縣,梓官鄉,典寶村,731,1,850,14,864,1295,3,1,3,0,1,0,66.72
高雄縣,旗山鎮,太平里,732,1,716,11,727,1136,3,1,3,0,1,0,64.00
高雄縣,旗山鎮,太平里,733,1,681,5,686,1160,3,1,3,0,1,0,59.14
高雄縣,旗山鎮,大德里,734,1,888,6,894,1316,3,1,3,0,1,0,67.93
高雄縣,旗山鎮,大德里,735,1,733,11,744,1118,3,1,3,0,1,0,66.55
高雄縣,旗山鎮,湄洲里,736,1,581,3,584,885,3,1,3,0,1,0,65.99
高雄縣,旗山鎮,鼓山里,737,1,417,5,422,605,3,1,3,0,1,0,69.75
高雄縣,旗山鎮,新山里,738,1,561,6,567,807,3,1,3,0,1,0,70.26
高雄縣,旗山鎮,和平里,739,1,496,6,502,736,3,1,3,0,1,0,68.21
高雄縣,旗山鎮,竹峰里,740,1,350,1,351,527,3,1,3,0,1,0,66.60
高雄縣,旗山鎮,瑞吉里,741,1,554,4,558,885,3,1,3,0,1,0,63.05
高雄縣,旗山鎮,瑞吉里,742,1,633,6,639,1003,3,1,3,0,1,0,63.71
高雄縣,旗山鎮,永和里,743,1,941,8,949,1552,3,1,3,0,1,0,61.15
高雄縣,旗山鎮,永和里,744,1,923,7,930,1403,3,1,3,0,1,0,66.29
高雄縣,旗山鎮,三協里,745,1,618,11,629,1062,3,1,3,0,1,0,59.23
高雄縣,旗山鎮,三協里,746,1,363,3,366,552,3,1,3,0,1,0,66.30
高雄縣,旗山鎮,三協里,747,1,197,1,198,312,3,1,3,0,1,0,63.46
高雄縣,旗山鎮,圓富里,748,1,654,9,663,1047,3,1,3,0,1,0,63.32
高雄縣,旗山鎮,圓富里,749,1,535,6,541,872,3,1,3,0,1,0,62.04
高雄縣,旗山鎮,中正里,750,1,715,7,722,1073,3,1,3,0,1,0,67.29
高雄縣,旗山鎮,中正里,751,1,324,6,330,460,3,1,3,0,1,0,71.74
高雄縣,旗山鎮,大林里,752,1,652,9,661,999,3,1,3,0,1,0,66.17
高雄縣,旗山鎮,大林里,753,1,353,3,356,539,3,1,3,0,1,0,66.05
高雄縣,旗山鎮,上洲里,754,1,703,8,711,984,3,1,3,0,1,0,72.26
高雄縣,旗山鎮,鯤洲里,755,1,634,8,642,903,3,1,3,0,1,0,71.10
高雄縣,旗山鎮,大山里,756,1,950,13,963,1346,3,1,3,0,1,0,71.55
高雄縣,旗山鎮,中洲里,757,1,708,3,711,931,3,1,3,0,1,0,76.37
高雄縣,旗山鎮,南洲里,758,1,1019,14,1033,1371,3,1,3,0,1,0,75.35
高雄縣,旗山鎮,新光里,759,1,669,12,681,896,3,1,3,0,1,0,76.00
高雄縣,旗山鎮,南勝里,760,1,870,8,878,1239,3,1,3,0,1,0,70.86
高雄縣,旗山鎮,南勝里,761,1,793,15,808,1138,3,1,3,0,1,0,71.00
高雄縣,旗山鎮,東平里,762,1,629,6,635,914,3,1,3,0,1,0,69.47
高雄縣,旗山鎮,東平里,763,1,592,7,599,967,3,1,3,0,1,0,61.94
高雄縣,旗山鎮,東昌里,764,1,453,1,454,655,3,1,3,0,1,0,69.31
高雄縣,旗山鎮,糖廠里,765,1,281,0,281,376,3,1,3,0,1,0,74.73
高雄縣,旗山鎮,廣福里,766,1,431,3,434,602,3,1,3,0,1,0,72.09
高雄縣,旗山鎮,中寮里,767,1,147,0,147,205,3,1,3,0,1,0,71.71
高雄縣,美濃鎮,中圳里,768,1,621,12,633,945,3,1,3,0,1,0,66.98
高雄縣,美濃鎮,中圳里,769,1,520,5,525,818,3,1,3,0,1,0,64.18
高雄縣,美濃鎮,東門里,770,1,899,11,910,1397,3,1,3,0,1,0,65.14
高雄縣,美濃鎮,泰安里,771,1,934,6,940,1438,3,1,3,0,1,0,65.37
高雄縣,美濃鎮,合和里,772,1,627,9,636,975,3,1,3,0,1,0,65.23
高雄縣,美濃鎮,合和里,773,1,801,11,812,1273,3,1,3,0,1,0,63.79
高雄縣,美濃鎮,瀰濃里,774,1,747,15,762,1201,3,1,3,0,1,0,63.45
高雄縣,美濃鎮,瀰濃里,775,1,655,4,659,1010,3,1,3,0,1,0,65.25
高雄縣,美濃鎮,福安里,776,1,749,8,757,1134,3,1,3,0,1,0,66.75
高雄縣,美濃鎮,福安里,777,1,814,10,824,1343,3,1,3,0,1,0,61.36
高雄縣,美濃鎮,祿興里,778,1,801,8,809,1271,3,1,3,0,1,0,63.65
高雄縣,美濃鎮,祿興里,779,1,808,7,815,1238,3,1,3,0,1,0,65.83
高雄縣,美濃鎮,中壇里,780,1,569,9,578,875,3,1,3,0,1,0,66.06
高雄縣,美濃鎮,中壇里,781,1,728,7,735,1170,3,1,3,0,1,0,62.82
高雄縣,美濃鎮,德興里,782,1,1046,13,1059,1492,3,1,3,0,1,0,70.98
高雄縣,美濃鎮,清水里,783,1,621,8,629,985,3,1,3,0,1,0,63.86
高雄縣,美濃鎮,清水里,784,1,503,4,507,734,3,1,3,0,1,0,69.07
高雄縣,美濃鎮,吉和里,785,1,923,8,931,1423,3,1,3,0,1,0,65.43
高雄縣,美濃鎮,吉洋里,786,1,644,11,655,991,3,1,3,0,1,0,66.09
高雄縣,美濃鎮,吉洋里,787,1,624,10,634,998,3,1,3,0,1,0,63.53
高雄縣,美濃鎮,吉東里,788,1,517,6,523,825,3,1,3,0,1,0,63.39
高雄縣,美濃鎮,吉東里,789,1,538,6,544,838,3,1,3,0,1,0,64.92
高雄縣,美濃鎮,龍山里,790,1,736,12,748,1143,3,1,3,0,1,0,65.44
高雄縣,美濃鎮,龍山里,791,1,668,10,678,1048,3,1,3,0,1,0,64.69
高雄縣,美濃鎮,獅山里,792,1,906,11,917,1360,3,1,3,0,1,0,67.43
高雄縣,美濃鎮,獅山里,793,1,675,8,683,992,3,1,3,0,1,0,68.85
高雄縣,美濃鎮,龍肚里,794,1,533,1,534,742,3,1,3,0,1,0,71.97
高雄縣,美濃鎮,龍肚里,795,1,559,9,568,878,3,1,3,0,1,0,64.69
高雄縣,美濃鎮,廣德里,796,1,921,9,930,1426,3,1,3,0,1,0,65.22
高雄縣,美濃鎮,興隆里,797,1,777,10,787,1212,3,1,3,0,1,0,64.93
高雄縣,美濃鎮,廣林里,798,1,550,6,556,885,3,1,3,0,1,0,62.82
高雄縣,美濃鎮,廣林里,799,1,499,0,499,873,3,1,3,0,1,0,57.16
高雄縣,六龜鄉,六龜村,800,1,642,18,660,1073,3,1,3,0,1,0,61.51
高雄縣,六龜鄉,義寶村,801,1,795,12,807,1187,3,1,3,0,1,0,67.99
高雄縣,六龜鄉,文武村,802,1,867,15,882,1612,3,1,3,0,1,0,54.71
高雄縣,六龜鄉,中興村,803,1,818,13,831,1346,3,1,3,0,1,0,61.74
高雄縣,六龜鄉,興龍村,804,1,558,11,569,926,3,1,3,0,1,0,61.45
高雄縣,六龜鄉,新威村,805,1,507,2,509,841,3,1,3,0,1,0,60.52
高雄縣,六龜鄉,新興村,806,1,439,8,447,759,3,1,3,0,1,0,58.89
高雄縣,六龜鄉,新寮村,807,1,416,10,426,650,3,1,3,0,1,0,65.54
高雄縣,六龜鄉,大津村,808,1,241,2,243,359,3,1,3,0,1,0,67.69
高雄縣,六龜鄉,新發村,809,1,735,9,744,1390,3,1,3,0,1,0,53.53
高雄縣,六龜鄉,荖濃村,810,1,799,26,825,1537,3,1,3,0,1,0,53.68
高雄縣,六龜鄉,寶來村,811,1,679,14,693,1090,3,1,3,0,1,0,63.58
高雄縣,甲仙鄉,東安村,812,1,398,2,400,628,3,1,3,0,1,0,63.69
高雄縣,甲仙鄉,西安村,813,1,787,9,796,1084,3,1,3,0,1,0,73.43
高雄縣,甲仙鄉,和安村,814,1,550,9,559,849,3,1,3,0,1,0,65.84
高雄縣,甲仙鄉,大田村,815,1,1009,28,1037,1601,3,1,3,0,1,0,64.77
高雄縣,甲仙鄉,寶隆村,816,1,481,7,488,733,3,1,3,0,1,0,66.58
高雄縣,甲仙鄉,關山村,817,1,472,4,476,726,3,1,3,0,1,0,65.56
高雄縣,甲仙鄉,小林村,818,1,673,12,685,1129,3,1,3,0,1,0,60.67
高雄縣,杉林鄉,杉林村,819,1,509,8,517,811,3,1,3,0,1,0,63.75
高雄縣,杉林鄉,木梓村,820,1,439,5,444,788,3,1,3,0,1,0,56.35
高雄縣,杉林鄉,集來村,821,1,647,8,655,1146,3,1,3,0,1,0,57.16
高雄縣,杉林鄉,集來村,822,1,388,7,395,784,3,1,3,0,1,0,50.38
高雄縣,杉林鄉,新庄村,823,1,752,10,762,1227,3,1,3,0,1,0,62.10
高雄縣,杉林鄉,新庄村,824,1,362,6,368,596,3,1,3,0,1,0,61.74
高雄縣,杉林鄉,上平村,825,1,939,14,953,1531,3,1,3,0,1,0,62.25
高雄縣,杉林鄉,月眉村,826,1,1080,8,1088,1819,3,1,3,0,1,0,59.81
高雄縣,杉林鄉,月美村,827,1,716,6,722,1348,3,1,3,0,1,0,53.56
高雄縣,內門鄉,金竹村,828,1,526,4,530,790,3,1,3,0,1,0,67.09
高雄縣,內門鄉,溝坪村,829,1,623,15,638,1051,3,1,3,0,1,0,60.70
高雄縣,內門鄉,永興村,830,1,317,5,322,492,3,1,3,0,1,0,65.45
高雄縣,內門鄉,永吉村,831,1,348,4,352,494,3,1,3,0,1,0,71.26
高雄縣,內門鄉,永富村,832,1,699,12,711,1051,3,1,3,0,1,0,67.65
高雄縣,內門鄉,觀亭村,833,1,510,4,514,764,3,1,3,0,1,0,67.28
高雄縣,內門鄉,觀亭村,834,1,702,6,708,1032,3,1,3,0,1,0,68.60
高雄縣,內門鄉,中埔村,835,1,455,6,461,609,3,1,3,0,1,0,75.70
高雄縣,內門鄉,瑞山村,836,1,252,3,255,363,3,1,3,0,1,0,70.25
高雄縣,內門鄉,內南村,837,1,279,2,281,382,3,1,3,0,1,0,73.56
高雄縣,內門鄉,內東村,838,1,602,6,608,773,3,1,3,0,1,0,78.65
高雄縣,內門鄉,光興村,839,1,448,6,454,643,3,1,3,0,1,0,70.61
高雄縣,內門鄉,東埔村,840,1,312,4,316,500,3,1,3,0,1,0,63.20
高雄縣,內門鄉,內豐村,841,1,772,6,778,1126,3,1,3,0,1,0,69.09
高雄縣,內門鄉,內門村,842,1,666,3,669,977,3,1,3,0,1,0,68.47
高雄縣,內門鄉,石坑村,843,1,339,1,340,512,3,1,3,0,1,0,66.41
高雄縣,內門鄉,三平村,844,1,473,5,478,688,3,1,3,0,1,0,69.48
高雄縣,內門鄉,木柵村,845,1,408,7,415,680,3,1,3,0,1,0,61.03
高雄縣,內門鄉,內興村,846,1,404,3,407,623,3,1,3,0,1,0,65.33
高雄縣,茂林鄉,茂林村,847,1,35,0,35,81,3,1,3,0,1,0,43.21
高雄縣,茂林鄉,萬山村,848,1,11,0,11,23,3,1,3,0,1,0,47.83
高雄縣,茂林鄉,多納村,849,1,14,1,15,27,3,1,3,0,1,0,55.56
高雄縣,桃源鄉,寶山村,850,1,21,1,22,40,3,1,3,0,1,0,55.00
高雄縣,桃源鄉,寶山村,851,1,7,0,7,13,3,1,3,0,1,0,53.85
高雄縣,桃源鄉,建山村,852,1,53,0,53,75,3,1,3,0,1,0,70.67
高雄縣,桃源鄉,高中村,853,1,33,3,36,71,3,1,3,0,1,0,50.70
高雄縣,桃源鄉,桃源村,854,1,68,2,70,128,3,1,3,0,1,0,54.69
高雄縣,桃源鄉,勤和村,855,1,7,0,7,14,3,1,3,0,1,0,50.00
高雄縣,桃源鄉,復興村,856,1,8,0,8,15,3,1,3,0,1,0,53.33
高雄縣,桃源鄉,梅蘭村,857,1,6,0,6,12,3,1,3,0,1,0,50.00
高雄縣,桃源鄉,梅山村,858,1,8,0,8,20,3,1,3,0,1,0,40.00
高雄縣,三民鄉,民族村,859,1,54,0,54,171,3,1,3,0,1,0,31.58
高雄縣,三民鄉,民權村,860,1,23,0,23,49,3,1,3,0,1,0,46.94
高雄縣,三民鄉,民生村,861,1,63,1,64,113,3,1,3,0,1,0,56.64
屏東縣,屏東市,端正里、武廟里,1,1,769,6,775,1186,3,1,3,0,1,0,65.35
屏東縣,屏東市,光榮里、民權里,2,1,982,12,994,1488,3,1,3,0,1,0,66.80
屏東縣,屏東市,大同里,3,1,549,5,554,756,3,1,3,0,1,0,73.28
屏東縣,屏東市,泰安里、文明里,4,1,901,8,909,1392,3,1,3,0,1,0,65.30
屏東縣,屏東市,維新里,5,1,983,6,989,1455,3,1,3,0,1,0,67.97
屏東縣,屏東市,維新里,6,1,948,13,961,1434,3,1,3,0,1,0,67.02
屏東縣,屏東市,大埔里、必信里,7,1,952,10,962,1424,3,1,3,0,1,0,67.56
屏東縣,屏東市,崇禮里、崇智里,8,1,621,6,627,890,3,1,3,0,1,0,70.45
屏東縣,屏東市,楠樹里、慶春里,9,1,607,4,611,815,3,1,3,0,1,0,74.97
屏東縣,屏東市,金泉里、勝峰里,10,1,832,10,842,1249,3,1,3,0,1,0,67.41
屏東縣,屏東市,平和里,11,1,597,5,602,890,3,1,3,0,1,0,67.64
屏東縣,屏東市,安樂里、扶風里,12,1,772,7,779,1088,3,1,3,0,1,0,71.60
屏東縣,屏東市,橋南里,13,1,979,6,985,1524,3,1,3,0,1,0,64.63
屏東縣,屏東市,橋北里,14,1,637,4,641,920,3,1,3,0,1,0,69.67
屏東縣,屏東市,長春里,15,1,698,10,708,1113,3,1,3,0,1,0,63.61
屏東縣,屏東市,長春里,16,1,605,6,611,992,3,1,3,0,1,0,61.59
屏東縣,屏東市,豐榮里,17,1,809,3,812,1210,3,1,3,0,1,0,67.11
屏東縣,屏東市,豐榮里,18,1,804,10,814,1223,3,1,3,0,1,0,66.56
屏東縣,屏東市,豐田里,19,1,693,6,699,1066,3,1,3,0,1,0,65.57
屏東縣,屏東市,豐田里,20,1,887,7,894,1368,3,1,3,0,1,0,65.35
屏東縣,屏東市,豐田里,21,1,927,6,933,1388,3,1,3,0,1,0,67.22
屏東縣,屏東市,大連里,22,1,1039,9,1048,1598,3,1,3,0,1,0,65.58
屏東縣,屏東市,大連里,23,1,1084,5,1089,1595,3,1,3,0,1,0,68.28
屏東縣,屏東市,大連里,24,1,1066,9,1075,1600,3,1,3,0,1,0,67.19
屏東縣,屏東市,大連里,25,1,1059,8,1067,1618,3,1,3,0,1,0,65.95
屏東縣,屏東市,大連里,26,1,1085,8,1093,1657,3,1,3,0,1,0,65.96
屏東縣,屏東市,豐源里,27,1,794,10,804,1222,3,1,3,0,1,0,65.79
屏東縣,屏東市,豐源里,28,1,846,10,856,1257,3,1,3,0,1,0,68.10
屏東縣,屏東市,豐源里,29,1,782,6,788,1141,3,1,3,0,1,0,69.06
屏東縣,屏東市,湖南里,30,1,670,5,675,973,3,1,3,0,1,0,69.37
屏東縣,屏東市,湖西里,31,1,923,3,926,1375,3,1,3,0,1,0,67.35
屏東縣,屏東市,歸心里,32,1,737,8,745,1127,3,1,3,0,1,0,66.10
屏東縣,屏東市,瑞光里,33,1,1068,7,1075,1674,3,1,3,0,1,0,64.22
屏東縣,屏東市,瑞光里,34,1,872,29,901,1389,3,1,3,0,1,0,64.87
屏東縣,屏東市,瑞光里,35,1,850,8,858,1371,3,1,3,0,1,0,62.58
屏東縣,屏東市,瑞光里,36,1,1044,5,1049,1641,3,1,3,0,1,0,63.92
屏東縣,屏東市,永光里,37,1,811,6,817,1149,3,1,3,0,1,0,71.11
屏東縣,屏東市,安鎮里,38,1,648,8,656,953,3,1,3,0,1,0,68.84
屏東縣,屏東市,安鎮里,39,1,614,6,620,940,3,1,3,0,1,0,65.96
屏東縣,屏東市,永昌里、永順里,40,1,841,6,847,1269,3,1,3,0,1,0,66.75
屏東縣,屏東市,長安里,41,1,682,12,694,1050,3,1,3,0,1,0,66.10
屏東縣,屏東市,長安里,42,1,614,11,625,967,3,1,3,0,1,0,64.63
屏東縣,屏東市,崇武里,43,1,1112,9,1121,1723,3,1,3,0,1,0,65.06
屏東縣,屏東市,大武里,44,1,835,9,844,1280,3,1,3,0,1,0,65.94
屏東縣,屏東市,大武里,45,1,1072,13,1085,1618,3,1,3,0,1,0,67.06
屏東縣,屏東市,大武里,46,1,1099,11,1110,1703,3,1,3,0,1,0,65.18
屏東縣,屏東市,清溪里,47,1,1077,13,1090,1571,3,1,3,0,1,0,69.38
屏東縣,屏東市,清溪里,48,1,781,15,796,1252,3,1,3,0,1,0,63.58
屏東縣,屏東市,清溪里,49,1,867,3,870,1364,3,1,3,0,1,0,63.78
屏東縣,屏東市,前進里,50,1,832,16,848,1196,3,1,3,0,1,0,70.90
屏東縣,屏東市,大洲里,51,1,723,9,732,1034,3,1,3,0,1,0,70.79
屏東縣,屏東市,凌雲里,52,1,947,9,956,1406,3,1,3,0,1,0,67.99
屏東縣,屏東市,鵬程里,53,1,947,15,962,1358,3,1,3,0,1,0,70.84
屏東縣,屏東市,一心里、義勇里,54,1,1034,11,1045,1590,3,1,3,0,1,0,65.72
屏東縣,屏東市,建國里、擇仁里,55,1,1031,11,1042,1645,3,1,3,0,1,0,63.34
屏東縣,屏東市,光華里,56,1,474,9,483,771,3,1,3,0,1,0,62.65
屏東縣,屏東市,萬年里,57,1,527,3,530,787,3,1,3,0,1,0,67.34
屏東縣,屏東市,厚生里,58,1,883,10,893,1409,3,1,3,0,1,0,63.38
屏東縣,屏東市,厚生里,59,1,1105,4,1109,1713,3,1,3,0,1,0,64.74
屏東縣,屏東市,永安里,60,1,907,14,921,1429,3,1,3,0,1,0,64.45
屏東縣,屏東市,永安里,61,1,986,12,998,1589,3,1,3,0,1,0,62.81
屏東縣,屏東市,永安里,62,1,1075,17,1092,1783,3,1,3,0,1,0,61.25
屏東縣,屏東市,永安里,63,1,1112,6,1118,1746,3,1,3,0,1,0,64.03
屏東縣,屏東市,新生里,64,1,824,3,827,1198,3,1,3,0,1,0,69.03
屏東縣,屏東市,新生里,65,1,1262,12,1274,1971,3,1,3,0,1,0,64.64
屏東縣,屏東市,新生里,66,1,928,11,939,1395,3,1,3,0,1,0,67.31
屏東縣,屏東市,頂宅里,67,1,372,4,376,516,3,1,3,0,1,0,72.87
屏東縣,屏東市,頂柳里,68,1,715,7,722,980,3,1,3,0,1,0,73.67
屏東縣,屏東市,龍華里,69,1,981,8,989,1393,3,1,3,0,1,0,71.00
屏東縣,屏東市,龍華里,70,1,652,3,655,998,3,1,3,0,1,0,65.63
屏東縣,屏東市,大湖里,71,1,1003,19,1022,1424,3,1,3,0,1,0,71.77
屏東縣,屏東市,新興里,72,1,965,4,969,1331,3,1,3,0,1,0,72.80
屏東縣,屏東市,新興里,73,1,535,8,543,846,3,1,3,0,1,0,64.18
屏東縣,屏東市,公館里,74,1,1069,19,1088,1473,3,1,3,0,1,0,73.86
屏東縣,屏東市,玉成里,75,1,965,10,975,1318,3,1,3,0,1,0,73.98
屏東縣,屏東市,勝利里,76,1,735,8,743,1151,3,1,3,0,1,0,64.55
屏東縣,屏東市,勝利里,77,1,920,2,922,1520,3,1,3,0,1,0,60.66
屏東縣,屏東市,勝利里,78,1,982,12,994,1525,3,1,3,0,1,0,65.18
屏東縣,屏東市,永城里,79,1,669,3,672,1056,3,1,3,0,1,0,63.64
屏東縣,屏東市,永城里,80,1,780,9,789,1266,3,1,3,0,1,0,62.32
屏東縣,屏東市,崇蘭里,81,1,959,12,971,1428,3,1,3,0,1,0,68.00
屏東縣,屏東市,崇蘭里,82,1,1209,12,1221,1856,3,1,3,0,1,0,65.79
屏東縣,屏東市,崇蘭里,83,1,985,13,998,1525,3,1,3,0,1,0,65.44
屏東縣,屏東市,崇蘭里,84,1,1186,9,1195,1817,3,1,3,0,1,0,65.77
屏東縣,屏東市,廣興里,85,1,1225,7,1232,1787,3,1,3,0,1,0,68.94
屏東縣,屏東市,空翔里,86,1,1048,13,1061,1587,3,1,3,0,1,0,66.86
屏東縣,屏東市,大鵬里,87,1,444,10,454,700,3,1,3,0,1,0,64.86
屏東縣,屏東市,潭墘里,88,1,1048,20,1068,1720,3,1,3,0,1,0,62.09
屏東縣,屏東市,潭墘里,89,1,973,9,982,1596,3,1,3,0,1,0,61.53
屏東縣,屏東市,潭墘里,90,1,1041,8,1049,1671,3,1,3,0,1,0,62.78
屏東縣,屏東市,潭墘里,91,1,1339,10,1349,2220,3,1,3,0,1,0,60.77
屏東縣,屏東市,興樂里,92,1,649,4,653,967,3,1,3,0,1,0,67.53
屏東縣,屏東市,斯文里,93,1,627,6,633,905,3,1,3,0,1,0,69.94
屏東縣,屏東市,斯文里,94,1,715,6,721,1048,3,1,3,0,1,0,68.80
屏東縣,屏東市,太平里、明正里,95,1,672,6,678,1028,3,1,3,0,1,0,65.95
屏東縣,屏東市,華山里,96,1,941,4,945,1362,3,1,3,0,1,0,69.38
屏東縣,屏東市,華山里,97,1,918,10,928,1390,3,1,3,0,1,0,66.76
屏東縣,屏東市,華山里,98,1,1056,8,1064,1598,3,1,3,0,1,0,66.58
屏東縣,屏東市,溝美里,99,1,803,8,811,1266,3,1,3,0,1,0,64.06
屏東縣,屏東市,溝美里,100,1,839,11,850,1282,3,1,3,0,1,0,66.30
屏東縣,屏東市,中正里,101,1,1083,6,1089,1641,3,1,3,0,1,0,66.36
屏東縣,屏東市,中正里,102,1,994,12,1006,1570,3,1,3,0,1,0,64.08
屏東縣,屏東市,仁愛里,103,1,683,6,689,1074,3,1,3,0,1,0,64.15
屏東縣,屏東市,仁愛里,104,1,688,3,691,1041,3,1,3,0,1,0,66.38
屏東縣,屏東市,北興里,105,1,810,12,822,1201,3,1,3,0,1,0,68.44
屏東縣,屏東市,北興里,106,1,791,12,803,1331,3,1,3,0,1,0,60.33
屏東縣,屏東市,北興里,107,1,965,10,975,1501,3,1,3,0,1,0,64.96
屏東縣,屏東市,北興里,108,1,805,12,817,1253,3,1,3,0,1,0,65.20
屏東縣,屏東市,北勢里,109,1,752,3,755,1110,3,1,3,0,1,0,68.02
屏東縣,屏東市,北勢里,110,1,915,9,924,1270,3,1,3,0,1,0,72.76
屏東縣,屏東市,三山里,111,1,849,9,858,1216,3,1,3,0,1,0,70.56
屏東縣,屏東市,海豐里,112,1,596,5,601,839,3,1,3,0,1,0,71.63
屏東縣,屏東市,仁義里,113,1,688,5,693,1005,3,1,3,0,1,0,68.96
屏東縣,屏東市,信和里,114,1,1004,9,1013,1440,3,1,3,0,1,0,70.35
屏東縣,屏東市,和興里,115,1,621,3,624,935,3,1,3,0,1,0,66.74
屏東縣,潮州鎮,潮州里,116,1,413,1,414,627,3,1,3,0,1,0,66.03
屏東縣,潮州鎮,光華里,117,1,1317,12,1329,2116,3,1,3,0,1,0,62.81
屏東縣,潮州鎮,光華里,118,1,1025,13,1038,1658,3,1,3,0,1,0,62.61
屏東縣,潮州鎮,同榮里,119,1,514,4,518,736,3,1,3,0,1,0,70.38
屏東縣,潮州鎮,新生里,120,1,761,10,771,1170,3,1,3,0,1,0,65.90
屏東縣,潮州鎮,新榮里,121,1,957,15,972,1484,3,1,3,0,1,0,65.50
屏東縣,潮州鎮,彭城里,122,1,584,5,589,791,3,1,3,0,1,0,74.46
屏東縣,潮州鎮,三星里,123,1,815,6,821,1246,3,1,3,0,1,0,65.89
屏東縣,潮州鎮,三星里,124,1,859,14,873,1338,3,1,3,0,1,0,65.25
屏東縣,潮州鎮,三星里,125,1,1056,9,1065,1585,3,1,3,0,1,0,67.19
屏東縣,潮州鎮,三共里,126,1,1102,4,1106,1685,3,1,3,0,1,0,65.64
屏東縣,潮州鎮,三共里,127,1,1180,7,1187,1828,3,1,3,0,1,0,64.93
屏東縣,潮州鎮,三共里,128,1,1135,9,1144,1813,3,1,3,0,1,0,63.10
屏東縣,潮州鎮,三和里,129,1,1149,13,1162,1769,3,1,3,0,1,0,65.69
屏東縣,潮州鎮,五魁里,130,1,701,10,711,1133,3,1,3,0,1,0,62.75
屏東縣,潮州鎮,蓬萊里,131,1,1140,12,1152,1776,3,1,3,0,1,0,64.86
屏東縣,潮州鎮,八爺里,132,1,1239,15,1254,1978,3,1,3,0,1,0,63.40
屏東縣,潮州鎮,永春里,133,1,1101,14,1115,1786,3,1,3,0,1,0,62.43
屏東縣,潮州鎮,永春里,134,1,927,6,933,1452,3,1,3,0,1,0,64.26
屏東縣,潮州鎮,永春里,135,1,987,9,996,1548,3,1,3,0,1,0,64.34
屏東縣,潮州鎮,富春里,136,1,880,8,888,1434,3,1,3,0,1,0,61.92
屏東縣,潮州鎮,光春里,137,1,831,11,842,1307,3,1,3,0,1,0,64.42
屏東縣,潮州鎮,興美里,138,1,569,6,575,825,3,1,3,0,1,0,69.70
屏東縣,潮州鎮,檨子里,139,1,379,2,381,591,3,1,3,0,1,0,64.47
屏東縣,潮州鎮,九塊里,140,1,997,10,1007,1559,3,1,3,0,1,0,64.59
屏東縣,潮州鎮,泗林里,141,1,1019,15,1034,1514,3,1,3,0,1,0,68.30
屏東縣,潮州鎮,四春里,142,1,1244,17,1261,1925,3,1,3,0,1,0,65.51
屏東縣,潮州鎮,崙東里,143,1,1007,15,1022,1588,3,1,3,0,1,0,64.36
屏東縣,東港鎮,新勝里,144,1,758,7,765,1126,3,1,3,0,1,0,67.94
屏東縣,東港鎮,新勝里,145,1,840,8,848,1203,3,1,3,0,1,0,70.49
屏東縣,東港鎮,頂新里,146,1,376,3,379,565,3,1,3,0,1,0,67.08
屏東縣,東港鎮,頂中里,147,1,349,6,355,479,3,1,3,0,1,0,74.11
屏東縣,東港鎮,東和里,148,1,445,9,454,724,3,1,3,0,1,0,62.71
屏東縣,東港鎮,興台里,149,1,363,4,367,565,3,1,3,0,1,0,64.96
屏東縣,東港鎮,興東里,150,1,791,10,801,1208,3,1,3,0,1,0,66.31
屏東縣,東港鎮,興東里,151,1,519,5,524,810,3,1,3,0,1,0,64.69
屏東縣,東港鎮,興東里,152,1,1097,14,1111,1859,3,1,3,0,1,0,59.76
屏東縣,東港鎮,興東里,153,1,1056,12,1068,1635,3,1,3,0,1,0,65.32
屏東縣,東港鎮,興農里,154,1,516,3,519,732,3,1,3,0,1,0,70.90
屏東縣,東港鎮,中興里,155,1,513,8,521,770,3,1,3,0,1,0,67.66
屏東縣,東港鎮,朝安里,156,1,783,10,793,1214,3,1,3,0,1,0,65.32
屏東縣,東港鎮,朝安里,157,1,396,3,399,584,3,1,3,0,1,0,68.32
屏東縣,東港鎮,八德里,158,1,560,3,563,855,3,1,3,0,1,0,65.85
屏東縣,東港鎮,東隆里,159,1,870,7,877,1359,3,1,3,0,1,0,64.53
屏東縣,東港鎮,豐漁里,160,1,452,4,456,724,3,1,3,0,1,0,62.98
屏東縣,東港鎮,盛漁里,161,1,746,10,756,1304,3,1,3,0,1,0,57.98
屏東縣,東港鎮,興漁里,162,1,479,4,483,749,3,1,3,0,1,0,64.49
屏東縣,東港鎮,興漁里,163,1,698,9,707,1121,3,1,3,0,1,0,63.07
屏東縣,東港鎮,鎮海里,164,1,773,10,783,1199,3,1,3,0,1,0,65.30
屏東縣,東港鎮,鎮海里,165,1,780,7,787,1308,3,1,3,0,1,0,60.17
屏東縣,東港鎮,嘉蓮里,166,1,966,10,976,1540,3,1,3,0,1,0,63.38
屏東縣,東港鎮,南平里,167,1,334,4,338,491,3,1,3,0,1,0,68.84
屏東縣,東港鎮,南平里,168,1,750,8,758,1279,3,1,3,0,1,0,59.27
屏東縣,東港鎮,船頭里,169,1,632,7,639,1027,3,1,3,0,1,0,62.22
屏東縣,東港鎮,船頭里,170,1,725,6,731,1159,3,1,3,0,1,0,63.07
屏東縣,東港鎮,船頭里,171,1,852,6,858,1445,3,1,3,0,1,0,59.38
屏東縣,東港鎮,下廍里,172,1,1209,10,1219,1783,3,1,3,0,1,0,68.37
屏東縣,東港鎮,大潭里,173,1,1056,12,1068,1557,3,1,3,0,1,0,68.59
屏東縣,東港鎮,興和里,174,1,612,7,619,874,3,1,3,0,1,0,70.82
屏東縣,東港鎮,共和里,175,1,454,4,458,700,3,1,3,0,1,0,65.43
屏東縣,東港鎮,大鵬里,176,1,193,4,197,296,3,1,3,0,1,0,66.55
屏東縣,恆春鎮,城南里,177,1,614,5,619,973,3,1,3,0,1,0,63.62
屏東縣,恆春鎮,城北里,178,1,537,15,552,878,3,1,3,0,1,0,62.87
屏東縣,恆春鎮,城北里,179,1,619,8,627,1017,3,1,3,0,1,0,61.65
屏東縣,恆春鎮,城西里,180,1,725,5,730,1143,3,1,3,0,1,0,63.87
屏東縣,恆春鎮,山腳里,181,1,646,12,658,1164,3,1,3,0,1,0,56.53
屏東縣,恆春鎮,山腳里,182,1,576,10,586,1061,3,1,3,0,1,0,55.23
屏東縣,恆春鎮,山腳里,183,1,611,6,617,1160,3,1,3,0,1,0,53.19
屏東縣,恆春鎮,網紗里,184,1,775,14,789,1379,3,1,3,0,1,0,57.22
屏東縣,恆春鎮,網紗里,185,1,669,8,677,1203,3,1,3,0,1,0,56.28
屏東縣,恆春鎮,仁壽里,186,1,423,10,433,789,3,1,3,0,1,0,54.88
屏東縣,恆春鎮,茄湖里,187,1,286,4,290,493,3,1,3,0,1,0,58.82
屏東縣,恆春鎮,頭溝里,188,1,244,5,249,472,3,1,3,0,1,0,52.75
屏東縣,恆春鎮,四溝里,189,1,528,10,538,916,3,1,3,0,1,0,58.73
屏東縣,恆春鎮,德和里,190,1,391,12,403,663,3,1,3,0,1,0,60.78
屏東縣,恆春鎮,龍水里,191,1,576,6,582,928,3,1,3,0,1,0,62.72
屏東縣,恆春鎮,山海里,192,1,491,3,494,756,3,1,3,0,1,0,65.34
屏東縣,恆春鎮,山海里,193,1,428,5,433,742,3,1,3,0,1,0,58.36
屏東縣,恆春鎮,大光里,194,1,518,12,530,879,3,1,3,0,1,0,60.30
屏東縣,恆春鎮,大光里,195,1,495,10,505,915,3,1,3,0,1,0,55.19
屏東縣,恆春鎮,水泉里,196,1,355,6,361,695,3,1,3,0,1,0,51.94
屏東縣,恆春鎮,水泉里,197,1,357,4,361,676,3,1,3,0,1,0,53.40
屏東縣,恆春鎮,南灣里,198,1,365,2,367,651,3,1,3,0,1,0,56.37
屏東縣,恆春鎮,南灣里,199,1,404,11,415,692,3,1,3,0,1,0,59.97
屏東縣,恆春鎮,墾丁里,200,1,754,10,764,1173,3,1,3,0,1,0,65.13
屏東縣,恆春鎮,鵝鑾里,201,1,635,12,647,1050,3,1,3,0,1,0,61.62
屏東縣,萬丹鄉,社上村,202,1,968,8,976,1414,3,1,3,0,1,0,69.02
屏東縣,萬丹鄉,社中村,203,1,955,15,970,1392,3,1,3,0,1,0,69.68
屏東縣,萬丹鄉,社皮村,204,1,593,3,596,813,3,1,3,0,1,0,73.31
屏東縣,萬丹鄉,社皮村,205,1,675,9,684,962,3,1,3,0,1,0,71.10
屏東縣,萬丹鄉,磚寮村,206,1,664,6,670,887,3,1,3,0,1,0,75.54
屏東縣,萬丹鄉,社口村,207,1,879,5,884,1144,3,1,3,0,1,0,77.27
屏東縣,萬丹鄉,加興村,208,1,803,9,812,1092,3,1,3,0,1,0,74.36
屏東縣,萬丹鄉,上村村,209,1,516,2,518,655,3,1,3,0,1,0,79.08
屏東縣,萬丹鄉,廈北村,210,1,1156,18,1174,1573,3,1,3,0,1,0,74.63
屏東縣,萬丹鄉,廈南村,211,1,975,8,983,1357,3,1,3,0,1,0,72.44
屏東縣,萬丹鄉,崙頂村,212,1,1099,9,1108,1563,3,1,3,0,1,0,70.89
屏東縣,萬丹鄉,田厝村,213,1,624,10,634,855,3,1,3,0,1,0,74.15
屏東縣,萬丹鄉,後村村,214,1,811,6,817,1011,3,1,3,0,1,0,80.81
屏東縣,萬丹鄉,灣內村,215,1,881,9,890,1226,3,1,3,0,1,0,72.59
屏東縣,萬丹鄉,香社村,216,1,1014,6,1020,1389,3,1,3,0,1,0,73.43
屏東縣,萬丹鄉,新庄村,217,1,1300,14,1314,1810,3,1,3,0,1,0,72.60
屏東縣,萬丹鄉,新鐘村,218,1,650,7,657,928,3,1,3,0,1,0,70.80
屏東縣,萬丹鄉,新鐘村,219,1,686,6,692,901,3,1,3,0,1,0,76.80
屏東縣,萬丹鄉,水仙村,220,1,407,3,410,513,3,1,3,0,1,0,79.92
屏東縣,萬丹鄉,興安村,221,1,581,6,587,802,3,1,3,0,1,0,73.19
屏東縣,萬丹鄉,興全村,222,1,840,7,847,1111,3,1,3,0,1,0,76.24
屏東縣,萬丹鄉,甘棠村,223,1,252,1,253,347,3,1,3,0,1,0,72.91
屏東縣,萬丹鄉,水泉村,224,1,894,11,905,1276,3,1,3,0,1,0,70.92
屏東縣,萬丹鄉,竹林村,225,1,1063,13,1076,1463,3,1,3,0,1,0,73.55
屏東縣,萬丹鄉,廣安村,226,1,635,8,643,885,3,1,3,0,1,0,72.66
屏東縣,萬丹鄉,廣安村,227,1,699,10,709,976,3,1,3,0,1,0,72.64
屏東縣,萬丹鄉,四維村,228,1,1183,22,1205,1734,3,1,3,0,1,0,69.49
屏東縣,萬丹鄉,寶厝村,229,1,667,9,676,980,3,1,3,0,1,0,68.98
屏東縣,萬丹鄉,寶厝村,230,1,711,2,713,994,3,1,3,0,1,0,71.73
屏東縣,萬丹鄉,萬生村,231,1,884,10,894,1233,3,1,3,0,1,0,72.51
屏東縣,萬丹鄉,萬惠村,232,1,541,2,543,715,3,1,3,0,1,0,75.94
屏東縣,萬丹鄉,萬安村,233,1,403,1,404,563,3,1,3,0,1,0,71.76
屏東縣,萬丹鄉,萬後村,234,1,353,1,354,465,3,1,3,0,1,0,76.13
屏東縣,萬丹鄉,萬全村,235,1,1225,7,1232,1723,3,1,3,0,1,0,71.50
屏東縣,萬丹鄉,萬全村,236,1,1100,3,1103,1513,3,1,3,0,1,0,72.90
屏東縣,長治鄉,進興村,237,1,651,4,655,916,3,1,3,0,1,0,71.51
屏東縣,長治鄉,進興村,238,1,817,13,830,1195,3,1,3,0,1,0,69.46
屏東縣,長治鄉,新潭村,239,1,818,3,821,1184,3,1,3,0,1,0,69.34
屏東縣,長治鄉,新潭村,240,1,993,15,1008,1424,3,1,3,0,1,0,70.79
屏東縣,長治鄉,潭頭村,241,1,1038,8,1046,1452,3,1,3,0,1,0,72.04
屏東縣,長治鄉,香楊村,242,1,419,3,422,591,3,1,3,0,1,0,71.40
屏東縣,長治鄉,香楊村,243,1,714,9,723,1098,3,1,3,0,1,0,65.85
屏東縣,長治鄉,長興村,244,1,732,5,737,998,3,1,3,0,1,0,73.85
屏東縣,長治鄉,崙上村,245,1,1058,17,1075,1441,3,1,3,0,1,0,74.60
屏東縣,長治鄉,德榮村,246,1,786,8,794,1066,3,1,3,0,1,0,74.48
屏東縣,長治鄉,德和村,247,1,543,10,553,772,3,1,3,0,1,0,71.63
屏東縣,長治鄉,復興村,248,1,1008,8,1016,1383,3,1,3,0,1,0,73.46
屏東縣,長治鄉,德成村,249,1,642,5,647,848,3,1,3,0,1,0,76.30
屏東縣,長治鄉,德協村,250,1,786,10,796,1091,3,1,3,0,1,0,72.96
屏東縣,長治鄉,繁榮村,251,1,917,11,928,1314,3,1,3,0,1,0,70.62
屏東縣,長治鄉,繁昌村,252,1,1236,17,1253,1644,3,1,3,0,1,0,76.22
屏東縣,長治鄉,繁隆村,253,1,800,16,816,1057,3,1,3,0,1,0,77.20
屏東縣,長治鄉,繁華村,254,1,893,10,903,1222,3,1,3,0,1,0,73.90
屏東縣,長治鄉,繁華村,255,1,708,11,719,1009,3,1,3,0,1,0,71.26
屏東縣,長治鄉,榮華村,256,1,318,6,324,495,3,1,3,0,1,0,65.45
屏東縣,麟洛鄉,新田村,257,1,478,4,482,677,3,1,3,0,1,0,71.20
屏東縣,麟洛鄉,新田村,258,1,713,6,719,1014,3,1,3,0,1,0,70.91
屏東縣,麟洛鄉,麟頂村,259,1,651,5,656,898,3,1,3,0,1,0,73.05
屏東縣,麟洛鄉,麟蹄村,260,1,1090,10,1100,1559,3,1,3,0,1,0,70.56
屏東縣,麟洛鄉,麟趾村,261,1,707,4,711,1034,3,1,3,0,1,0,68.76
屏東縣,麟洛鄉,麟趾村,262,1,774,9,783,1131,3,1,3,0,1,0,69.23
屏東縣,麟洛鄉,田中村,263,1,800,7,807,1067,3,1,3,0,1,0,75.63
屏東縣,麟洛鄉,田心村,264,1,576,8,584,823,3,1,3,0,1,0,70.96
屏東縣,麟洛鄉,田道村,265,1,500,5,505,674,3,1,3,0,1,0,74.93
屏東縣,九如鄉,九清村,266,1,1098,13,1111,1541,3,1,3,0,1,0,72.10
屏東縣,九如鄉,九塊村,267,1,898,8,906,1262,3,1,3,0,1,0,71.79
屏東縣,九如鄉,九明村,268,1,974,15,989,1381,3,1,3,0,1,0,71.61
屏東縣,九如鄉,大坵村,269,1,707,8,715,972,3,1,3,0,1,0,73.56
屏東縣,九如鄉,玉水村,270,1,898,18,916,1220,3,1,3,0,1,0,75.08
屏東縣,九如鄉,玉泉村,271,1,982,20,1002,1439,3,1,3,0,1,0,69.63
屏東縣,九如鄉,東寧村,272,1,471,7,478,623,3,1,3,0,1,0,76.73
屏東縣,九如鄉,東寧村,273,1,1145,8,1153,1663,3,1,3,0,1,0,69.33
屏東縣,九如鄉,東寧村,274,1,779,8,787,1188,3,1,3,0,1,0,66.25
屏東縣,九如鄉,三塊村,275,1,929,9,938,1290,3,1,3,0,1,0,72.71
屏東縣,九如鄉,耆老村,276,1,852,12,864,1234,3,1,3,0,1,0,70.02
屏東縣,九如鄉,後庄村,277,1,1254,17,1271,1644,3,1,3,0,1,0,77.31
屏東縣,九如鄉,洽興村,278,1,942,11,953,1279,3,1,3,0,1,0,74.51
屏東縣,里港鄉,玉田村,279,1,618,6,624,883,3,1,3,0,1,0,70.67
屏東縣,里港鄉,玉田村,280,1,786,8,794,1163,3,1,3,0,1,0,68.27
屏東縣,里港鄉,塔樓村,281,1,938,8,946,1362,3,1,3,0,1,0,69.46
屏東縣,里港鄉,潮厝村,282,1,940,8,948,1359,3,1,3,0,1,0,69.76
屏東縣,里港鄉,大平村,283,1,803,6,809,1116,3,1,3,0,1,0,72.49
屏東縣,里港鄉,永春村,284,1,561,5,566,785,3,1,3,0,1,0,72.10
屏東縣,里港鄉,春林村,285,1,819,11,830,1189,3,1,3,0,1,0,69.81
屏東縣,里港鄉,過江村,286,1,598,11,609,859,3,1,3,0,1,0,70.90
屏東縣,里港鄉,過江村,287,1,530,6,536,795,3,1,3,0,1,0,67.42
屏東縣,里港鄉,鐵店村,288,1,861,6,867,1232,3,1,3,0,1,0,70.37
屏東縣,里港鄉,茄苳村,289,1,308,2,310,407,3,1,3,0,1,0,76.17
屏東縣,里港鄉,茄苳村,290,1,904,7,911,1164,3,1,3,0,1,0,78.26
屏東縣,里港鄉,載興村,291,1,735,11,746,1007,3,1,3,0,1,0,74.08
屏東縣,里港鄉,載興村,292,1,905,10,915,1290,3,1,3,0,1,0,70.93
屏東縣,里港鄉,土庫村,293,1,955,16,971,1475,3,1,3,0,1,0,65.83
屏東縣,里港鄉,土庫村,294,1,360,9,369,514,3,1,3,0,1,0,71.79
屏東縣,里港鄉,三廍村,295,1,592,13,605,847,3,1,3,0,1,0,71.43
屏東縣,里港鄉,三廍村,296,1,620,8,628,870,3,1,3,0,1,0,72.18
屏東縣,里港鄉,中和村,297,1,541,3,544,805,3,1,3,0,1,0,67.58
屏東縣,里港鄉,瀰力村,298,1,324,4,328,453,3,1,3,0,1,0,72.41
屏東縣,鹽埔鄉,鹽北村,299,1,1233,13,1246,1703,3,1,3,0,1,0,73.17
屏東縣,鹽埔鄉,鹽中村,300,1,753,9,762,1041,3,1,3,0,1,0,73.20
屏東縣,鹽埔鄉,鹽中村,301,1,855,18,873,1170,3,1,3,0,1,0,74.62
屏東縣,鹽埔鄉,鹽南村,302,1,1083,14,1097,1600,3,1,3,0,1,0,68.56
屏東縣,鹽埔鄉,仕絨村,303,1,743,11,754,911,3,1,3,0,1,0,82.77
屏東縣,鹽埔鄉,高朗村,304,1,921,16,937,1310,3,1,3,0,1,0,71.53
屏東縣,鹽埔鄉,高朗村,305,1,970,9,979,1348,3,1,3,0,1,0,72.63
屏東縣,鹽埔鄉,振興村,306,1,1271,24,1295,1878,3,1,3,0,1,0,68.96
屏東縣,鹽埔鄉,久愛村,307,1,625,17,642,850,3,1,3,0,1,0,75.53
屏東縣,鹽埔鄉,新圍村,308,1,893,15,908,1398,3,1,3,0,1,0,64.95
屏東縣,鹽埔鄉,新圍村,309,1,900,12,912,1384,3,1,3,0,1,0,65.90
屏東縣,鹽埔鄉,新二村,310,1,860,10,870,1285,3,1,3,0,1,0,67.70
屏東縣,鹽埔鄉,新二村,311,1,1040,11,1051,1672,3,1,3,0,1,0,62.86
屏東縣,鹽埔鄉,彭厝村,312,1,639,9,648,958,3,1,3,0,1,0,67.64
屏東縣,鹽埔鄉,洛陽村,313,1,1002,13,1015,1443,3,1,3,0,1,0,70.34
屏東縣,鹽埔鄉,永隆村,314,1,412,3,415,571,3,1,3,0,1,0,72.68
屏東縣,高樹鄉,高樹村,315,1,655,4,659,978,3,1,3,0,1,0,67.38
屏東縣,高樹鄉,高樹村,316,1,749,6,755,1203,3,1,3,0,1,0,62.76
屏東縣,高樹鄉,長榮村,317,1,922,15,937,1380,3,1,3,0,1,0,67.90
屏東縣,高樹鄉,東興村,318,1,580,10,590,828,3,1,3,0,1,0,71.26
屏東縣,高樹鄉,東振村,319,1,392,3,395,630,3,1,3,0,1,0,62.70
屏東縣,高樹鄉,源泉村,320,1,675,4,679,1025,3,1,3,0,1,0,66.24
屏東縣,高樹鄉,建興村,321,1,738,8,746,1185,3,1,3,0,1,0,62.95
屏東縣,高樹鄉,大埔村,322,1,419,9,428,675,3,1,3,0,1,0,63.41
屏東縣,高樹鄉,菜寮村,323,1,564,10,574,824,3,1,3,0,1,0,69.66
屏東縣,高樹鄉,司馬村,324,1,504,5,509,751,3,1,3,0,1,0,67.78
屏東縣,高樹鄉,舊寮村,325,1,793,12,805,1314,3,1,3,0,1,0,61.26
屏東縣,高樹鄉,新豐村,326,1,925,13,938,1518,3,1,3,0,1,0,61.79
屏東縣,高樹鄉,泰山村,327,1,566,11,577,959,3,1,3,0,1,0,60.17
屏東縣,高樹鄉,泰山村,328,1,626,11,637,1024,3,1,3,0,1,0,62.21
屏東縣,高樹鄉,南華村,329,1,770,11,781,1239,3,1,3,0,1,0,63.03
屏東縣,高樹鄉,廣福村,330,1,643,9,652,968,3,1,3,0,1,0,67.36
屏東縣,高樹鄉,廣興村,331,1,674,9,683,1046,3,1,3,0,1,0,65.30
屏東縣,高樹鄉,舊庄村,332,1,692,14,706,1037,3,1,3,0,1,0,68.08
屏東縣,高樹鄉,田子村,333,1,767,10,777,1126,3,1,3,0,1,0,69.01
屏東縣,高樹鄉,鹽樹村,334,1,505,6,511,753,3,1,3,0,1,0,67.86
屏東縣,高樹鄉,鹽樹村,335,1,404,4,408,613,3,1,3,0,1,0,66.56
屏東縣,高樹鄉,新南村,336,1,926,9,935,1438,3,1,3,0,1,0,65.02
屏東縣,萬巒鄉,萬巒村,337,1,854,12,866,1263,3,1,3,0,1,0,68.57
屏東縣,萬巒鄉,萬全村,338,1,560,3,563,782,3,1,3,0,1,0,71.99
屏東縣,萬巒鄉,萬和村,339,1,981,14,995,1421,3,1,3,0,1,0,70.02
屏東縣,萬巒鄉,鹿寮村,340,1,648,3,651,899,3,1,3,0,1,0,72.41
屏東縣,萬巒鄉,硫黃村,341,1,375,8,383,542,3,1,3,0,1,0,70.66
屏東縣,萬巒鄉,泗溝村,342,1,866,13,879,1264,3,1,3,0,1,0,69.54
屏東縣,萬巒鄉,五溝村,343,1,836,15,851,1144,3,1,3,0,1,0,74.39
屏東縣,萬巒鄉,成德村,344,1,960,14,974,1372,3,1,3,0,1,0,70.99
屏東縣,萬巒鄉,赤山村,345,1,504,7,511,878,3,1,3,0,1,0,58.20
屏東縣,萬巒鄉,赤山村,346,1,487,10,497,795,3,1,3,0,1,0,62.52
屏東縣,萬巒鄉,萬金村,347,1,660,11,671,987,3,1,3,0,1,0,67.98
屏東縣,萬巒鄉,萬金村,348,1,594,15,609,904,3,1,3,0,1,0,67.37
屏東縣,萬巒鄉,佳佐村,349,1,1105,7,1112,1535,3,1,3,0,1,0,72.44
屏東縣,萬巒鄉,佳和村,350,1,1092,12,1104,1493,3,1,3,0,1,0,73.95
屏東縣,萬巒鄉,新厝村,351,1,741,7,748,1075,3,1,3,0,1,0,69.58
屏東縣,萬巒鄉,新置村,352,1,402,3,405,571,3,1,3,0,1,0,70.93
屏東縣,萬巒鄉,新置村,353,1,390,9,399,613,3,1,3,0,1,0,65.09
屏東縣,內埔鄉,內埔村,354,1,841,6,847,1239,3,1,3,0,1,0,68.36
屏東縣,內埔鄉,內埔村,355,1,1295,6,1301,1922,3,1,3,0,1,0,67.69
屏東縣,內埔鄉,內田村,356,1,713,6,719,1078,3,1,3,0,1,0,66.70
屏東縣,內埔鄉,內田村,357,1,1074,8,1082,1662,3,1,3,0,1,0,65.10
屏東縣,內埔鄉,興南村,358,1,945,6,951,1314,3,1,3,0,1,0,72.37
屏東縣,內埔鄉,義亭村,359,1,397,8,405,590,3,1,3,0,1,0,68.64
屏東縣,內埔鄉,美和村,360,1,696,6,702,1023,3,1,3,0,1,0,68.62
屏東縣,內埔鄉,美和村,361,1,714,8,722,1060,3,1,3,0,1,0,68.11
屏東縣,內埔鄉,和興村,362,1,590,6,596,853,3,1,3,0,1,0,69.87
屏東縣,內埔鄉,和興村,363,1,674,5,679,995,3,1,3,0,1,0,68.24
屏東縣,內埔鄉,東寧村,364,1,690,11,701,1001,3,1,3,0,1,0,70.03
屏東縣,內埔鄉,東寧村,365,1,921,10,931,1336,3,1,3,0,1,0,69.69
屏東縣,內埔鄉,東寧村,366,1,1086,9,1095,1625,3,1,3,0,1,0,67.38
屏東縣,內埔鄉,豐田村,367,1,704,5,709,1197,3,1,3,0,1,0,59.23
屏東縣,內埔鄉,豐田村,368,1,792,6,798,1239,3,1,3,0,1,0,64.41
屏東縣,內埔鄉,振豐村,369,1,657,2,659,870,3,1,3,0,1,0,75.75
屏東縣,內埔鄉,振豐村,370,1,530,5,535,774,3,1,3,0,1,0,69.12
屏東縣,內埔鄉,富田村,371,1,563,4,567,815,3,1,3,0,1,0,69.57
屏東縣,內埔鄉,富田村,372,1,769,5,774,1090,3,1,3,0,1,0,71.01
屏東縣,內埔鄉,竹圍村,373,1,996,16,1012,1532,3,1,3,0,1,0,66.06
屏東縣,內埔鄉,東勢村,374,1,771,5,776,1123,3,1,3,0,1,0,69.10
屏東縣,內埔鄉,東勢村,375,1,1134,14,1148,1752,3,1,3,0,1,0,65.53
屏東縣,內埔鄉,東片村,376,1,658,9,667,948,3,1,3,0,1,0,70.36
屏東縣,內埔鄉,上樹村,377,1,740,6,746,1068,3,1,3,0,1,0,69.85
屏東縣,內埔鄉,老埤村,378,1,663,8,671,1146,3,1,3,0,1,0,58.55
屏東縣,內埔鄉,老埤村,379,1,725,9,734,1213,3,1,3,0,1,0,60.51
屏東縣,內埔鄉,中林村,380,1,896,18,914,1453,3,1,3,0,1,0,62.90
屏東縣,內埔鄉,龍泉村,381,1,873,5,878,1338,3,1,3,0,1,0,65.62
屏東縣,內埔鄉,龍泉村,382,1,711,12,723,1126,3,1,3,0,1,0,64.21
屏東縣,內埔鄉,龍潭村,383,1,109,3,112,179,3,1,3,0,1,0,62.57
屏東縣,內埔鄉,龍潭村,384,1,868,8,876,1363,3,1,3,0,1,0,64.27
屏東縣,內埔鄉,龍潭村,385,1,664,10,674,1017,3,1,3,0,1,0,66.27
屏東縣,內埔鄉,建興村,386,1,399,2,401,586,3,1,3,0,1,0,68.43
屏東縣,內埔鄉,建興村,387,1,642,47,689,1259,3,1,3,0,1,0,54.73
屏東縣,內埔鄉,大新村,388,1,880,12,892,1329,3,1,3,0,1,0,67.12
屏東縣,內埔鄉,大新村,389,1,251,1,252,397,3,1,3,0,1,0,63.48
屏東縣,內埔鄉,黎明村,390,1,747,5,752,1159,3,1,3,0,1,0,64.88
屏東縣,內埔鄉,黎明村,391,1,677,8,685,1042,3,1,3,0,1,0,65.74
屏東縣,內埔鄉,隘寮村,392,1,680,18,698,1146,3,1,3,0,1,0,60.91
屏東縣,內埔鄉,水門村,393,1,493,8,501,784,3,1,3,0,1,0,63.90
屏東縣,竹田鄉,竹田村,394,1,1036,16,1052,1437,3,1,3,0,1,0,73.21
屏東縣,竹田鄉,竹南村,395,1,573,3,576,843,3,1,3,0,1,0,68.33
屏東縣,竹田鄉,糶糴村,396,1,509,3,512,676,3,1,3,0,1,0,75.74
屏東縣,竹田鄉,履豐村,397,1,427,1,428,596,3,1,3,0,1,0,71.81
屏東縣,竹田鄉,頭崙村,398,1,920,9,929,1315,3,1,3,0,1,0,70.65
屏東縣,竹田鄉,二崙村,399,1,718,7,725,960,3,1,3,0,1,0,75.52
屏東縣,竹田鄉,美崙村,400,1,439,6,445,606,3,1,3,0,1,0,73.43
屏東縣,竹田鄉,南勢村,401,1,345,4,349,464,3,1,3,0,1,0,75.22
屏東縣,竹田鄉,西勢村,402,1,926,11,937,1320,3,1,3,0,1,0,70.98
屏東縣,竹田鄉,西勢村,403,1,860,9,869,1218,3,1,3,0,1,0,71.35
屏東縣,竹田鄉,福田村,404,1,355,1,356,442,3,1,3,0,1,0,80.54
屏東縣,竹田鄉,永豐村,405,1,420,3,423,608,3,1,3,0,1,0,69.57
屏東縣,竹田鄉,六巷村,406,1,501,6,507,673,3,1,3,0,1,0,75.33
屏東縣,竹田鄉,泗洲村,407,1,714,12,726,1089,3,1,3,0,1,0,66.67
屏東縣,竹田鄉,大湖村,408,1,812,4,816,1171,3,1,3,0,1,0,69.68
屏東縣,竹田鄉,鳳明村,409,1,678,10,688,983,3,1,3,0,1,0,69.99
屏東縣,新埤鄉,新埤村,410,1,1033,9,1042,1570,3,1,3,0,1,0,66.37
屏東縣,新埤鄉,新埤村,411,1,246,2,248,339,3,1,3,0,1,0,73.16
屏東縣,新埤鄉,建功村,412,1,598,1,599,831,3,1,3,0,1,0,72.08
屏東縣,新埤鄉,建功村,413,1,274,2,276,396,3,1,3,0,1,0,69.70
屏東縣,新埤鄉,打鐵村,414,1,739,6,745,1014,3,1,3,0,1,0,73.47
屏東縣,新埤鄉,南豐村,415,1,519,5,524,758,3,1,3,0,1,0,69.13
屏東縣,新埤鄉,萬隆村,416,1,447,5,452,692,3,1,3,0,1,0,65.32
屏東縣,新埤鄉,萬隆村,417,1,246,4,250,354,3,1,3,0,1,0,70.62
屏東縣,新埤鄉,萬隆村,418,1,391,5,396,640,3,1,3,0,1,0,61.88
屏東縣,新埤鄉,餉潭村,419,1,792,8,800,1345,3,1,3,0,1,0,59.48
屏東縣,新埤鄉,箕湖村,420,1,342,8,350,549,3,1,3,0,1,0,63.75
屏東縣,新埤鄉,箕湖村,421,1,365,4,369,541,3,1,3,0,1,0,68.21
屏東縣,枋寮鄉,枋寮村,422,1,758,10,768,1282,3,1,3,0,1,0,59.91
屏東縣,枋寮鄉,新龍村,423,1,543,6,549,839,3,1,3,0,1,0,65.44
屏東縣,枋寮鄉,保生村,424,1,624,5,629,937,3,1,3,0,1,0,67.13
屏東縣,枋寮鄉,中寮村,425,1,429,5,434,684,3,1,3,0,1,0,63.45
屏東縣,枋寮鄉,安樂村,426,1,1130,15,1145,1819,3,1,3,0,1,0,62.95
屏東縣,枋寮鄉,隆山村,427,1,1041,11,1052,1849,3,1,3,0,1,0,56.90
屏東縣,枋寮鄉,隆山村,428,1,1049,13,1062,1819,3,1,3,0,1,0,58.38
屏東縣,枋寮鄉,天時村,429,1,639,3,642,960,3,1,3,0,1,0,66.88
屏東縣,枋寮鄉,天時村,430,1,701,5,706,1068,3,1,3,0,1,0,66.10
屏東縣,枋寮鄉,地利村,431,1,1175,9,1184,1678,3,1,3,0,1,0,70.56
屏東縣,枋寮鄉,人和村,432,1,677,10,687,1049,3,1,3,0,1,0,65.49
屏東縣,枋寮鄉,人和村,433,1,752,8,760,1146,3,1,3,0,1,0,66.32
屏東縣,枋寮鄉,內寮村,434,1,410,6,416,741,3,1,3,0,1,0,56.14
屏東縣,枋寮鄉,新開村,435,1,562,20,582,974,3,1,3,0,1,0,59.75
屏東縣,枋寮鄉,東海村,436,1,747,6,753,1147,3,1,3,0,1,0,65.65
屏東縣,枋寮鄉,東海村,437,1,1032,8,1040,1617,3,1,3,0,1,0,64.32
屏東縣,枋寮鄉,大庄村,438,1,406,2,408,608,3,1,3,0,1,0,67.11
屏東縣,枋寮鄉,太源村,439,1,598,11,609,948,3,1,3,0,1,0,64.24
屏東縣,枋寮鄉,玉泉村,440,1,293,2,295,441,3,1,3,0,1,0,66.89
屏東縣,新園鄉,瓦磘村,441,1,1163,7,1170,1595,3,1,3,0,1,0,73.35
屏東縣,新園鄉,仙吉村,442,1,760,2,762,1075,3,1,3,0,1,0,70.88
屏東縣,新園鄉,仙吉村,443,1,877,11,888,1276,3,1,3,0,1,0,69.59
屏東縣,新園鄉,田洋村,444,1,686,7,693,999,3,1,3,0,1,0,69.37
屏東縣,新園鄉,田洋村,445,1,715,9,724,1018,3,1,3,0,1,0,71.12
屏東縣,新園鄉,港墘村,446,1,497,12,509,774,3,1,3,0,1,0,65.76
屏東縣,新園鄉,內庄村,447,1,588,5,593,789,3,1,3,0,1,0,75.16
屏東縣,新園鄉,新東村,448,1,830,16,846,1219,3,1,3,0,1,0,69.40
屏東縣,新園鄉,新東村,449,1,691,20,711,1008,3,1,3,0,1,0,70.54
屏東縣,新園鄉,新園村,450,1,623,7,630,870,3,1,3,0,1,0,72.41
屏東縣,新園鄉,新園村,451,1,755,7,762,1057,3,1,3,0,1,0,72.09
屏東縣,新園鄉,港西村,452,1,822,4,826,1047,3,1,3,0,1,0,78.89
屏東縣,新園鄉,港西村,453,1,848,12,860,1117,3,1,3,0,1,0,76.99
屏東縣,新園鄉,五房村,454,1,657,12,669,968,3,1,3,0,1,0,69.11
屏東縣,新園鄉,五房村,455,1,531,6,537,756,3,1,3,0,1,0,71.03
屏東縣,新園鄉,五房村,456,1,678,20,698,1085,3,1,3,0,1,0,64.33
屏東縣,新園鄉,烏龍村,457,1,935,11,946,1265,3,1,3,0,1,0,74.78
屏東縣,新園鄉,興龍村,458,1,627,11,638,894,3,1,3,0,1,0,71.36
屏東縣,新園鄉,興龍村,459,1,800,9,809,1190,3,1,3,0,1,0,67.98
屏東縣,新園鄉,中洲村,460,1,1132,13,1145,1713,3,1,3,0,1,0,66.84
屏東縣,新園鄉,南龍村,461,1,947,10,957,1405,3,1,3,0,1,0,68.11
屏東縣,新園鄉,鹽埔村,462,1,859,7,866,1398,3,1,3,0,1,0,61.95
屏東縣,新園鄉,鹽埔村,463,1,817,17,834,1259,3,1,3,0,1,0,66.24
屏東縣,新園鄉,鹽埔村,464,1,719,5,724,1241,3,1,3,0,1,0,58.34
屏東縣,新園鄉,共和村,465,1,661,19,680,1080,3,1,3,0,1,0,62.96
屏東縣,新園鄉,共和村,466,1,744,11,755,1135,3,1,3,0,1,0,66.52
屏東縣,崁頂鄉,崁頂村,467,1,1405,15,1420,2009,3,1,3,0,1,0,70.68
屏東縣,崁頂鄉,園寮村,468,1,1074,4,1078,1654,3,1,3,0,1,0,65.18
屏東縣,崁頂鄉,力社村,469,1,777,16,793,1100,3,1,3,0,1,0,72.09
屏東縣,崁頂鄉,圍內村,470,1,779,7,786,1118,3,1,3,0,1,0,70.30
屏東縣,崁頂鄉,洲子村,471,1,570,6,576,874,3,1,3,0,1,0,65.90
屏東縣,崁頂鄉,北勢村,472,1,1036,12,1048,1497,3,1,3,0,1,0,70.01
屏東縣,崁頂鄉,越溪村,473,1,544,10,554,774,3,1,3,0,1,0,71.58
屏東縣,崁頂鄉,港東村,474,1,1196,20,1216,1737,3,1,3,0,1,0,70.01
屏東縣,林邊鄉,林邊村,475,1,1023,11,1034,1460,3,1,3,0,1,0,70.82
屏東縣,林邊鄉,光林村,476,1,1070,13,1083,1625,3,1,3,0,1,0,66.65
屏東縣,林邊鄉,中林村,477,1,581,5,586,843,3,1,3,0,1,0,69.51
屏東縣,林邊鄉,仁和村,478,1,1111,6,1117,1588,3,1,3,0,1,0,70.34
屏東縣,林邊鄉,永樂村,479,1,1081,15,1096,1509,3,1,3,0,1,0,72.63
屏東縣,林邊鄉,永樂村,480,1,1212,6,1218,1687,3,1,3,0,1,0,72.20
屏東縣,林邊鄉,田厝村,481,1,632,2,634,905,3,1,3,0,1,0,70.06
屏東縣,林邊鄉,崎峰村,482,1,815,9,824,1329,3,1,3,0,1,0,62.00
屏東縣,林邊鄉,水利村,483,1,1178,10,1188,1864,3,1,3,0,1,0,63.73
屏東縣,林邊鄉,竹林村,484,1,1020,6,1026,1505,3,1,3,0,1,0,68.17
屏東縣,林邊鄉,竹林村,485,1,886,12,898,1371,3,1,3,0,1,0,65.50
屏東縣,林邊鄉,鎮安村,486,1,775,9,784,1130,3,1,3,0,1,0,69.38
屏東縣,南州鄉,溪洲村,487,1,1256,12,1268,1778,3,1,3,0,1,0,71.32
屏東縣,南州鄉,溪南村,488,1,695,2,697,1003,3,1,3,0,1,0,69.49
屏東縣,南州鄉,仁里村,489,1,380,5,385,574,3,1,3,0,1,0,67.07
屏東縣,南州鄉,溪北村,490,1,555,12,567,777,3,1,3,0,1,0,72.97
屏東縣,南州鄉,七塊村,491,1,720,9,729,1040,3,1,3,0,1,0,70.10
屏東縣,南州鄉,萬華村,492,1,706,6,712,1002,3,1,3,0,1,0,71.06
屏東縣,南州鄉,米崙村,493,1,742,9,751,1019,3,1,3,0,1,0,73.70
屏東縣,南州鄉,壽元村,494,1,728,13,741,1105,3,1,3,0,1,0,67.06
屏東縣,南州鄉,同安村,495,1,645,5,650,949,3,1,3,0,1,0,68.49
屏東縣,南州鄉,南安村,496,1,418,4,422,582,3,1,3,0,1,0,72.51
屏東縣,佳冬鄉,佳冬村,497,1,1027,9,1036,1510,3,1,3,0,1,0,68.61
屏東縣,佳冬鄉,六根村,498,1,1109,14,1123,1625,3,1,3,0,1,0,69.11
屏東縣,佳冬鄉,賴家村,499,1,641,7,648,959,3,1,3,0,1,0,67.57
屏東縣,佳冬鄉,萬建村,500,1,1156,8,1164,1687,3,1,3,0,1,0,69.00
屏東縣,佳冬鄉,石光村,501,1,1273,21,1294,1920,3,1,3,0,1,0,67.40
屏東縣,佳冬鄉,玉光村,502,1,631,7,638,958,3,1,3,0,1,0,66.60
屏東縣,佳冬鄉,玉光村,503,1,782,9,791,1227,3,1,3,0,1,0,64.47
屏東縣,佳冬鄉,昌隆村,504,1,818,9,827,1126,3,1,3,0,1,0,73.45
屏東縣,佳冬鄉,豐隆村,505,1,629,7,636,840,3,1,3,0,1,0,75.71
屏東縣,佳冬鄉,大同村,506,1,868,13,881,1215,3,1,3,0,1,0,72.51
屏東縣,佳冬鄉,羌園村,507,1,717,11,728,1037,3,1,3,0,1,0,70.20
屏東縣,佳冬鄉,燄溫村,508,1,711,8,719,1103,3,1,3,0,1,0,65.19
屏東縣,佳冬鄉,塭豐村,509,1,703,7,710,1065,3,1,3,0,1,0,66.67
屏東縣,佳冬鄉,塭豐村,510,1,784,5,789,1171,3,1,3,0,1,0,67.38
屏東縣,琉球鄉,本福村,511,1,1036,19,1055,1968,3,1,3,0,1,0,53.61
屏東縣,琉球鄉,中福村,512,1,599,10,609,1108,3,1,3,0,1,0,54.96
屏東縣,琉球鄉,漁福村,513,1,485,9,494,1018,3,1,3,0,1,0,48.53
屏東縣,琉球鄉,大福村,514,1,750,9,759,1587,3,1,3,0,1,0,47.83
屏東縣,琉球鄉,南福村,515,1,492,9,501,1231,3,1,3,0,1,0,40.70
屏東縣,琉球鄉,天福村,516,1,432,10,442,1083,3,1,3,0,1,0,40.81
屏東縣,琉球鄉,上福村,517,1,626,11,637,1477,3,1,3,0,1,0,43.13
屏東縣,琉球鄉,杉福村,518,1,347,3,350,779,3,1,3,0,1,0,44.93
屏東縣,車城鄉,福興村,519,1,296,10,306,446,3,1,3,0,1,0,68.61
屏東縣,車城鄉,福興村,520,1,578,7,585,904,3,1,3,0,1,0,64.71
屏東縣,車城鄉,福安村,521,1,390,3,393,564,3,1,3,0,1,0,69.68
屏東縣,車城鄉,田中村,522,1,440,6,446,743,3,1,3,0,1,0,60.03
屏東縣,車城鄉,海口村,523,1,478,6,484,810,3,1,3,0,1,0,59.75
屏東縣,車城鄉,統埔村,524,1,255,4,259,429,3,1,3,0,1,0,60.37
屏東縣,車城鄉,溫泉村,525,1,543,13,556,997,3,1,3,0,1,0,55.77
屏東縣,車城鄉,保力村,526,1,420,3,423,690,3,1,3,0,1,0,61.30
屏東縣,車城鄉,保力村,527,1,364,11,375,687,3,1,3,0,1,0,54.59
屏東縣,車城鄉,新街村,528,1,287,2,289,427,3,1,3,0,1,0,67.68
屏東縣,車城鄉,埔墘村,529,1,242,7,249,455,3,1,3,0,1,0,54.73
屏東縣,車城鄉,射寮村,530,1,327,2,329,537,3,1,3,0,1,0,61.27
屏東縣,車城鄉,後灣村,531,1,275,10,285,488,3,1,3,0,1,0,58.40
屏東縣,滿州鄉,滿州村,532,1,742,9,751,1346,3,1,3,0,1,0,55.79
屏東縣,滿州鄉,里德村,533,1,136,5,141,271,3,1,3,0,1,0,52.03
屏東縣,滿州鄉,永靖村,534,1,650,14,664,1170,3,1,3,0,1,0,56.75
屏東縣,滿州鄉,港口村,535,1,666,5,671,1108,3,1,3,0,1,0,60.56
屏東縣,滿州鄉,響林村,536,1,217,3,220,412,3,1,3,0,1,0,53.40
屏東縣,滿州鄉,長樂村,537,1,313,8,321,646,3,1,3,0,1,0,49.69
屏東縣,滿州鄉,九棚村,538,1,112,0,112,227,3,1,3,0,1,0,49.34
屏東縣,滿州鄉,港仔村,539,1,165,0,165,302,3,1,3,0,1,0,54.64
屏東縣,枋山鄉,加祿村,540,1,597,10,607,921,3,1,3,0,1,0,65.91
屏東縣,枋山鄉,加祿村,541,1,635,5,640,917,3,1,3,0,1,0,69.79
屏東縣,枋山鄉,枋山村,542,1,382,4,386,591,3,1,3,0,1,0,65.31
屏東縣,枋山鄉,枋山村,543,1,301,4,305,468,3,1,3,0,1,0,65.17
屏東縣,枋山鄉,楓港村,544,1,537,10,547,1067,3,1,3,0,1,0,51.27
屏東縣,枋山鄉,善餘村,545,1,461,3,464,985,3,1,3,0,1,0,47.11
屏東縣,三地門鄉,三地村,546,1,79,2,81,122,3,1,3,0,1,0,66.39
屏東縣,三地門鄉,達來村,547,1,9,0,9,17,3,1,3,0,1,0,52.94
屏東縣,三地門鄉,德文村,548,1,6,0,6,15,3,1,3,0,1,0,40.00
屏東縣,三地門鄉,大社村,549,1,6,0,6,20,3,1,3,0,1,0,30.00
屏東縣,三地門鄉,賽嘉村,550,1,25,3,28,49,3,1,3,0,1,0,57.14
屏東縣,三地門鄉,口社村,551,1,30,0,30,42,3,1,3,0,1,0,71.43
屏東縣,三地門鄉,馬兒村,552,1,9,0,9,15,3,1,3,0,1,0,60.00
屏東縣,三地門鄉,安坡村,553,1,21,0,21,38,3,1,3,0,1,0,55.26
屏東縣,三地門鄉,青山村,554,1,49,1,50,79,3,1,3,0,1,0,63.29
屏東縣,三地門鄉,青葉村,555,1,15,1,16,39,3,1,3,0,1,0,41.03
屏東縣,霧台鄉,霧台村,556,1,3,0,3,10,3,1,3,0,1,0,30.00
屏東縣,霧台鄉,霧台村,557,1,7,1,8,12,3,1,3,0,1,0,66.67
屏東縣,霧台鄉,霧台村,558,1,0,0,0,2,3,1,3,0,1,0,0.00
屏東縣,霧台鄉,好茶村,559,1,7,0,7,15,3,1,3,0,1,0,46.67
屏東縣,霧台鄉,阿禮村,560,1,2,0,2,3,3,1,3,0,1,0,66.67
屏東縣,霧台鄉,吉露村,561,1,2,0,2,3,3,1,3,0,1,0,66.67
屏東縣,霧台鄉,大武村,562,1,6,0,6,17,3,1,3,0,1,0,35.29
屏東縣,霧台鄉,佳暮村,563,1,1,0,1,4,3,1,3,0,1,0,25.00
屏東縣,瑪家鄉,瑪家村,564,1,10,0,10,18,3,1,3,0,1,0,55.56
屏東縣,瑪家鄉,北葉村,565,1,57,0,57,86,3,1,3,0,1,0,66.28
屏東縣,瑪家鄉,涼山村,566,1,34,0,34,59,3,1,3,0,1,0,57.63
屏東縣,瑪家鄉,佳義村,567,1,27,2,29,53,3,1,3,0,1,0,54.72
屏東縣,瑪家鄉,排灣村,568,1,5,0,5,12,3,1,3,0,1,0,41.67
屏東縣,瑪家鄉,三和村,569,1,19,2,21,36,3,1,3,0,1,0,58.33
屏東縣,瑪家鄉,三和村,570,1,21,3,24,39,3,1,3,0,1,0,61.54
屏東縣,瑪家鄉,三和村,571,1,29,3,32,47,3,1,3,0,1,0,68.09
屏東縣,泰武鄉,佳平村,572,1,19,0,19,27,3,1,3,0,1,0,70.37
屏東縣,泰武鄉,佳平村,573,1,9,0,9,12,3,1,3,0,1,0,75.00
屏東縣,泰武鄉,武潭村,574,1,17,0,17,42,3,1,3,0,1,0,40.48
屏東縣,泰武鄉,平和村,575,1,10,0,10,22,3,1,3,0,1,0,45.45
屏東縣,泰武鄉,佳興村,576,1,7,0,7,12,3,1,3,0,1,0,58.33
屏東縣,泰武鄉,泰武村,577,1,2,0,2,6,3,1,3,0,1,0,33.33
屏東縣,泰武鄉,萬安村,578,1,14,0,14,29,3,1,3,0,1,0,48.28
屏東縣,來義鄉,來義村,579,1,15,0,15,26,3,1,3,0,1,0,57.69
屏東縣,來義鄉,義林村,580,1,13,0,13,21,3,1,3,0,1,0,61.90
屏東縣,來義鄉,義林村,581,1,2,0,2,6,3,1,3,0,1,0,33.33
屏東縣,來義鄉,丹林村,582,1,24,0,24,41,3,1,3,0,1,0,58.54
屏東縣,來義鄉,丹林村,583,1,11,0,11,19,3,1,3,0,1,0,57.89
屏東縣,來義鄉,古樓村,584,1,42,2,44,73,3,1,3,0,1,0,60.27
屏東縣,來義鄉,文樂村,585,1,26,1,27,45,3,1,3,0,1,0,60.00
屏東縣,來義鄉,望嘉村,586,1,39,2,41,53,3,1,3,0,1,0,77.36
屏東縣,來義鄉,南和村,587,1,31,3,34,60,3,1,3,0,1,0,56.67
屏東縣,春日鄉,春日村,588,1,20,3,23,54,3,1,3,0,1,0,42.59
屏東縣,春日鄉,古華村,589,1,27,1,28,45,3,1,3,0,1,0,62.22
屏東縣,春日鄉,士文村,590,1,2,0,2,9,3,1,3,0,1,0,22.22
屏東縣,春日鄉,歸崇村,591,1,64,0,64,125,3,1,3,0,1,0,51.20
屏東縣,春日鄉,七佳村,592,1,78,1,79,113,3,1,3,0,1,0,69.91
屏東縣,春日鄉,力里村,593,1,6,0,6,16,3,1,3,0,1,0,37.50
屏東縣,獅子鄉,楓林村,594,1,30,1,31,50,3,1,3,0,1,0,62.00
屏東縣,獅子鄉,丹路村,595,1,37,1,38,75,3,1,3,0,1,0,50.67
屏東縣,獅子鄉,草埔村,596,1,20,1,21,48,3,1,3,0,1,0,43.75
屏東縣,獅子鄉,內文村,597,1,7,0,7,22,3,1,3,0,1,0,31.82
屏東縣,獅子鄉,竹坑村,598,1,15,2,17,29,3,1,3,0,1,0,58.62
屏東縣,獅子鄉,獅子村,599,1,9,0,9,17,3,1,3,0,1,0,52.94
屏東縣,獅子鄉,內獅村,600,1,21,1,22,35,3,1,3,0,1,0,62.86
屏東縣,獅子鄉,南世村,601,1,8,0,8,23,3,1,3,0,1,0,34.78
屏東縣,牡丹鄉,石門村,602,1,72,2,74,118,3,1,3,0,1,0,62.71
屏東縣,牡丹鄉,石門村,603,1,26,2,28,43,3,1,3,0,1,0,65.12
屏東縣,牡丹鄉,牡丹村,604,1,16,1,17,31,3,1,3,0,1,0,54.84
屏東縣,牡丹鄉,東源村,605,1,13,1,14,23,3,1,3,0,1,0,60.87
屏東縣,牡丹鄉,旭海村,606,1,44,3,47,108,3,1,3,0,1,0,43.52
屏東縣,牡丹鄉,高士村,607,1,14,0,14,37,3,1,3,0,1,0,37.84
屏東縣,牡丹鄉,四林村,608,1,7,2,9,26,3,1,3,0,1,0,34.62
臺東縣,台東市,文化里,1,1,682,9,691,1054,3,1,3,0,1,0,65.56
臺東縣,台東市,民族里,2,1,471,5,476,739,3,1,3,0,1,0,64.41
臺東縣,台東市,民族里,3,1,529,3,532,718,3,1,3,0,1,0,74.09
臺東縣,台東市,自強里,4,1,882,6,888,1423,3,1,3,0,1,0,62.40
臺東縣,台東市,自強里,5,1,1132,11,1143,1842,3,1,3,0,1,0,62.05
臺東縣,台東市,民生里,6,1,924,13,937,1506,3,1,3,0,1,0,62.22
臺東縣,台東市,民生里,7,1,795,13,808,1235,3,1,3,0,1,0,65.43
臺東縣,台東市,寶桑里,8,1,442,5,447,765,3,1,3,0,1,0,58.43
臺東縣,台東市,民權里,9,1,639,7,646,1086,3,1,3,0,1,0,59.48
臺東縣,台東市,四維里,10,1,264,5,269,462,3,1,3,0,1,0,58.23
臺東縣,台東市,中華里,11,1,555,10,565,881,3,1,3,0,1,0,64.13
臺東縣,台東市,中華里,12,1,434,7,441,773,3,1,3,0,1,0,57.05
臺東縣,台東市,仁愛里,13,1,463,9,472,733,3,1,3,0,1,0,64.39
臺東縣,台東市,強國里,14,1,392,4,396,637,3,1,3,0,1,0,62.17
臺東縣,台東市,大同里,15,1,458,5,463,771,3,1,3,0,1,0,60.05
臺東縣,台東市,成功里,16,1,524,9,533,867,3,1,3,0,1,0,61.48
臺東縣,台東市,建國里,17,1,805,14,819,1355,3,1,3,0,1,0,60.44
臺東縣,台東市,中正里,18,1,551,7,558,887,3,1,3,0,1,0,62.91
臺東縣,台東市,中山里,19,1,640,6,646,998,3,1,3,0,1,0,64.73
臺東縣,台東市,興國里,20,1,444,6,450,721,3,1,3,0,1,0,62.41
臺東縣,台東市,鐵花里,21,1,302,2,304,441,3,1,3,0,1,0,68.93
臺東縣,台東市,東海里,22,1,683,13,696,1165,3,1,3,0,1,0,59.74
臺東縣,台東市,東海里,23,1,1068,5,1073,1679,3,1,3,0,1,0,63.91
臺東縣,台東市,復國里,24,1,397,7,404,701,3,1,3,0,1,0,57.63
臺東縣,台東市,復興里,25,1,267,6,273,474,3,1,3,0,1,0,57.59
臺東縣,台東市,新興里,26,1,678,8,686,1173,3,1,3,0,1,0,58.48
臺東縣,台東市,新生里,27,1,673,5,678,1141,3,1,3,0,1,0,59.42
臺東縣,台東市,新生里,28,1,1032,13,1045,1663,3,1,3,0,1,0,62.84
臺東縣,台東市,新生里,29,1,975,9,984,1636,3,1,3,0,1,0,60.15
臺東縣,台東市,中心里,30,1,512,4,516,825,3,1,3,0,1,0,62.55
臺東縣,台東市,中心里,31,1,785,10,795,1313,3,1,3,0,1,0,60.55
臺東縣,台東市,馬蘭里,32,1,602,4,606,915,3,1,3,0,1,0,66.23
臺東縣,台東市,馬蘭里,33,1,566,7,573,871,3,1,3,0,1,0,65.79
臺東縣,台東市,馬蘭里,34,1,606,5,611,957,3,1,3,0,1,0,63.85
臺東縣,台東市,光明里,35,1,846,12,858,1420,3,1,3,0,1,0,60.42
臺東縣,台東市,豐年里,36,1,317,7,324,543,3,1,3,0,1,0,59.67
臺東縣,台東市,豐年里,37,1,632,11,643,1114,3,1,3,0,1,0,57.72
臺東縣,台東市,豐樂里,38,1,561,4,565,865,3,1,3,0,1,0,65.32
臺東縣,台東市,永樂里,39,1,720,9,729,1092,3,1,3,0,1,0,66.76
臺東縣,台東市,康樂里,40,1,686,13,699,1078,3,1,3,0,1,0,64.84
臺東縣,台東市,豐榮里,41,1,713,7,720,1221,3,1,3,0,1,0,58.97
臺東縣,台東市,豐榮里,42,1,661,3,664,1205,3,1,3,0,1,0,55.10
臺東縣,台東市,豐榮里,43,1,798,10,808,1355,3,1,3,0,1,0,59.63
臺東縣,台東市,豐榮里,44,1,1053,9,1062,1710,3,1,3,0,1,0,62.11
臺東縣,台東市,豐谷里,45,1,621,12,633,1047,3,1,3,0,1,0,60.46
臺東縣,台東市,豐谷里,46,1,366,8,374,650,3,1,3,0,1,0,57.54
臺東縣,台東市,豐谷里,47,1,762,9,771,1332,3,1,3,0,1,0,57.88
臺東縣,台東市,豐里里,48,1,907,13,920,1578,3,1,3,0,1,0,58.30
臺東縣,台東市,豐原里,49,1,557,11,568,939,3,1,3,0,1,0,60.49
臺東縣,台東市,富岡里,50,1,680,22,702,1108,3,1,3,0,1,0,63.36
臺東縣,台東市,富豐里,51,1,274,7,281,479,3,1,3,0,1,0,58.66
臺東縣,台東市,南榮里,52,1,546,26,572,929,3,1,3,0,1,0,61.57
臺東縣,台東市,南榮里,53,1,270,2,272,439,3,1,3,0,1,0,61.96
臺東縣,台東市,南榮里,54,1,139,2,141,228,3,1,3,0,1,0,61.84
臺東縣,台東市,岩灣里,55,1,643,4,647,1080,3,1,3,0,1,0,59.91
臺東縣,台東市,卑南里,56,1,1224,15,1239,1791,3,1,3,0,1,0,69.18
臺東縣,台東市,南王里,57,1,508,7,515,839,3,1,3,0,1,0,61.38
臺東縣,台東市,南王里,58,1,341,5,346,600,3,1,3,0,1,0,57.67
臺東縣,台東市,豐田里,59,1,549,5,554,864,3,1,3,0,1,0,64.12
臺東縣,台東市,豐田里,60,1,548,9,557,916,3,1,3,0,1,0,60.81
臺東縣,台東市,新園里,61,1,569,5,574,993,3,1,3,0,1,0,57.80
臺東縣,台東市,建和里,62,1,499,5,504,866,3,1,3,0,1,0,58.20
臺東縣,台東市,建興里,63,1,516,6,522,831,3,1,3,0,1,0,62.82
臺東縣,台東市,建業里,64,1,531,4,535,836,3,1,3,0,1,0,64.00
臺東縣,台東市,知本里,65,1,519,10,529,870,3,1,3,0,1,0,60.80
臺東縣,台東市,建農里,66,1,623,23,646,1113,3,1,3,0,1,0,58.04
臺東縣,成功鎮,信義里,67,1,103,1,104,204,3,1,3,0,1,0,50.98
臺東縣,成功鎮,信義里,68,1,86,2,88,158,3,1,3,0,1,0,55.70
臺東縣,成功鎮,信義里,69,1,49,0,49,104,3,1,3,0,1,0,47.12
臺東縣,成功鎮,和平里,70,1,84,3,87,163,3,1,3,0,1,0,53.37
臺東縣,成功鎮,忠仁里,71,1,43,2,45,103,3,1,3,0,1,0,43.69
臺東縣,成功鎮,忠仁里,72,1,597,5,602,1003,3,1,3,0,1,0,60.02
臺東縣,成功鎮,忠仁里,73,1,815,14,829,1337,3,1,3,0,1,0,62.00
臺東縣,成功鎮,忠智里,74,1,680,7,687,1048,3,1,3,0,1,0,65.55
臺東縣,成功鎮,三民里,75,1,212,2,214,409,3,1,3,0,1,0,52.32
臺東縣,成功鎮,三民里,76,1,390,5,395,678,3,1,3,0,1,0,58.26
臺東縣,成功鎮,三仙里,77,1,93,1,94,191,3,1,3,0,1,0,49.21
臺東縣,成功鎮,三仙里,78,1,199,7,206,400,3,1,3,0,1,0,51.50
臺東縣,成功鎮,忠孝里,79,1,125,2,127,238,3,1,3,0,1,0,53.36
臺東縣,成功鎮,忠孝里,80,1,129,0,129,256,3,1,3,0,1,0,50.39
臺東縣,成功鎮,博愛里,81,1,28,2,30,67,3,1,3,0,1,0,44.78
臺東縣,成功鎮,博愛里,82,1,19,0,19,42,3,1,3,0,1,0,45.24
臺東縣,關山鎮,里壟里,83,1,561,6,567,921,3,1,3,0,1,0,61.56
臺東縣,關山鎮,里壟里,84,1,410,8,418,697,3,1,3,0,1,0,59.97
臺東縣,關山鎮,中福里,85,1,547,8,555,863,3,1,3,0,1,0,64.31
臺東縣,關山鎮,新福里,86,1,394,5,399,670,3,1,3,0,1,0,59.55
臺東縣,關山鎮,豐泉里,87,1,622,4,626,957,3,1,3,0,1,0,65.41
臺東縣,關山鎮,月眉里,88,1,363,3,366,682,3,1,3,0,1,0,53.67
臺東縣,關山鎮,德高里,89,1,285,3,288,495,3,1,3,0,1,0,58.18
臺東縣,關山鎮,德高里,90,1,442,7,449,738,3,1,3,0,1,0,60.84
臺東縣,關山鎮,電光里,91,1,101,1,102,229,3,1,3,0,1,0,44.54
臺東縣,卑南鄉,賓朗村,92,1,547,7,554,893,3,1,3,0,1,0,62.04
臺東縣,卑南鄉,賓朗村,93,1,538,11,549,906,3,1,3,0,1,0,60.60
臺東縣,卑南鄉,美農村,94,1,142,1,143,231,3,1,3,0,1,0,61.90
臺東縣,卑南鄉,美農村,95,1,259,4,263,421,3,1,3,0,1,0,62.47
臺東縣,卑南鄉,美農村,96,1,160,0,160,304,3,1,3,0,1,0,52.63
臺東縣,卑南鄉,初鹿村,97,1,322,6,328,599,3,1,3,0,1,0,54.76
臺東縣,卑南鄉,初鹿村,98,1,297,6,303,493,3,1,3,0,1,0,61.46
臺東縣,卑南鄉,明峰村,99,1,398,3,401,733,3,1,3,0,1,0,54.71
臺東縣,卑南鄉,明峰村,100,1,164,5,169,318,3,1,3,0,1,0,53.14
臺東縣,卑南鄉,嘉豐村,101,1,108,4,112,195,3,1,3,0,1,0,57.44
臺東縣,卑南鄉,嘉豐村,102,1,16,0,16,38,3,1,3,0,1,0,42.11
臺東縣,卑南鄉,太平村,103,1,794,9,803,1254,3,1,3,0,1,0,64.04
臺東縣,卑南鄉,太平村,104,1,456,27,483,839,3,1,3,0,1,0,57.57
臺東縣,卑南鄉,太平村,105,1,456,8,464,748,3,1,3,0,1,0,62.03
臺東縣,卑南鄉,泰安村,106,1,394,10,404,697,3,1,3,0,1,0,57.96
臺東縣,卑南鄉,利嘉村,107,1,242,6,248,423,3,1,3,0,1,0,58.63
臺東縣,卑南鄉,東興村,108,1,154,6,160,268,3,1,3,0,1,0,59.70
臺東縣,卑南鄉,溫泉村,109,1,521,5,526,869,3,1,3,0,1,0,60.53
臺東縣,卑南鄉,溫泉村,110,1,107,2,109,195,3,1,3,0,1,0,55.90
臺東縣,卑南鄉,富山村,111,1,261,7,268,448,3,1,3,0,1,0,59.82
臺東縣,卑南鄉,富源村,112,1,236,3,239,373,3,1,3,0,1,0,64.08
臺東縣,卑南鄉,利吉村,113,1,135,6,141,245,3,1,3,0,1,0,57.55
臺東縣,鹿野鄉,鹿野村,114,1,99,2,101,194,3,1,3,0,1,0,52.06
臺東縣,鹿野鄉,鹿野村,115,1,341,8,349,577,3,1,3,0,1,0,60.49
臺東縣,鹿野鄉,龍田村,116,1,564,12,576,1046,3,1,3,0,1,0,55.07
臺東縣,鹿野鄉,永安村,117,1,383,6,389,776,3,1,3,0,1,0,50.13
臺東縣,鹿野鄉,永安村,118,1,131,0,131,270,3,1,3,0,1,0,48.52
臺東縣,鹿野鄉,瑞隆村,119,1,392,10,402,782,3,1,3,0,1,0,51.41
臺東縣,鹿野鄉,瑞源村,120,1,320,10,330,633,3,1,3,0,1,0,52.13
臺東縣,鹿野鄉,瑞和村,121,1,193,4,197,361,3,1,3,0,1,0,54.57
臺東縣,鹿野鄉,瑞豐村,122,1,239,4,243,449,3,1,3,0,1,0,54.12
臺東縣,鹿野鄉,瑞豐村,123,1,306,2,308,535,3,1,3,0,1,0,57.57
臺東縣,池上鄉,福原村,124,1,537,12,549,962,3,1,3,0,1,0,57.07
臺東縣,池上鄉,福原村,125,1,507,1,508,903,3,1,3,0,1,0,56.26
臺東縣,池上鄉,福文村,126,1,320,4,324,616,3,1,3,0,1,0,52.60
臺東縣,池上鄉,福文村,127,1,326,7,333,691,3,1,3,0,1,0,48.19
臺東縣,池上鄉,慶豐村,128,1,307,2,309,679,3,1,3,0,1,0,45.51
臺東縣,池上鄉,大坡村,129,1,47,2,49,109,3,1,3,0,1,0,44.95
臺東縣,池上鄉,大埔村,130,1,239,3,242,410,3,1,3,0,1,0,59.02
臺東縣,池上鄉,新興村,131,1,406,11,417,809,3,1,3,0,1,0,51.55
臺東縣,池上鄉,錦園村,132,1,208,2,210,426,3,1,3,0,1,0,49.30
臺東縣,池上鄉,萬安村,133,1,181,8,189,374,3,1,3,0,1,0,50.53
臺東縣,池上鄉,富興村,134,1,185,5,190,354,3,1,3,0,1,0,53.67
臺東縣,池上鄉,振興村,135,1,67,5,72,161,3,1,3,0,1,0,44.72
臺東縣,東河鄉,都蘭村,136,1,128,4,132,293,3,1,3,0,1,0,45.05
臺東縣,東河鄉,都蘭村,137,1,253,1,254,406,3,1,3,0,1,0,62.56
臺東縣,東河鄉,都蘭村,138,1,286,5,291,530,3,1,3,0,1,0,54.91
臺東縣,東河鄉,興昌村,139,1,323,8,331,606,3,1,3,0,1,0,54.62
臺東縣,東河鄉,隆昌村,140,1,110,2,112,219,3,1,3,0,1,0,51.14
臺東縣,東河鄉,東河村,141,1,155,4,159,315,3,1,3,0,1,0,50.48
臺東縣,東河鄉,泰源村,142,1,346,6,352,652,3,1,3,0,1,0,53.99
臺東縣,東河鄉,北源村,143,1,169,2,171,420,3,1,3,0,1,0,40.71
臺東縣,東河鄉,北源村,144,1,101,4,105,215,3,1,3,0,1,0,48.84
臺東縣,東河鄉,北源村,145,1,173,4,177,310,3,1,3,0,1,0,57.10
臺東縣,東河鄉,尚德村,146,1,78,1,79,179,3,1,3,0,1,0,44.13
臺東縣,長濱鄉,寧埔村,147,1,57,2,59,104,3,1,3,0,1,0,56.73
臺東縣,長濱鄉,寧埔村,148,1,115,1,116,273,3,1,3,0,1,0,42.49
臺東縣,長濱鄉,竹湖村,149,1,182,3,185,406,3,1,3,0,1,0,45.57
臺東縣,長濱鄉,長濱村,150,1,587,7,594,1104,3,1,3,0,1,0,53.80
臺東縣,長濱鄉,忠勇村,151,1,252,12,264,537,3,1,3,0,1,0,49.16
臺東縣,長濱鄉,長濱村,152,1,103,2,105,215,3,1,3,0,1,0,48.84
臺東縣,長濱鄉,三間村,153,1,90,5,95,197,3,1,3,0,1,0,48.22
臺東縣,長濱鄉,三間村,154,1,55,2,57,105,3,1,3,0,1,0,54.29
臺東縣,長濱鄉,三間村,155,1,64,2,66,135,3,1,3,0,1,0,48.89
臺東縣,長濱鄉,樟原村,156,1,167,0,167,276,3,1,3,0,1,0,60.51
臺東縣,太麻里鄉,美和村,157,1,514,10,524,924,3,1,3,0,1,0,56.71
臺東縣,太麻里鄉,三和村,158,1,347,11,358,614,3,1,3,0,1,0,58.31
臺東縣,太麻里鄉,華源村,159,1,376,8,384,701,3,1,3,0,1,0,54.78
臺東縣,太麻里鄉,北里村,160,1,227,5,232,380,3,1,3,0,1,0,61.05
臺東縣,太麻里鄉,大王村,161,1,291,3,294,502,3,1,3,0,1,0,58.57
臺東縣,太麻里鄉,大王村,162,1,389,6,395,688,3,1,3,0,1,0,57.41
臺東縣,太麻里鄉,泰和村,163,1,501,5,506,767,3,1,3,0,1,0,65.97
臺東縣,太麻里鄉,泰和村,164,1,284,4,288,498,3,1,3,0,1,0,57.83
臺東縣,太麻里鄉,香蘭村,165,1,211,3,214,375,3,1,3,0,1,0,57.07
臺東縣,太麻里鄉,香蘭村,166,1,59,4,63,118,3,1,3,0,1,0,53.39
臺東縣,太麻里鄉,金崙村,167,1,107,2,109,200,3,1,3,0,1,0,54.50
臺東縣,太麻里鄉,金崙村,168,1,133,1,134,250,3,1,3,0,1,0,53.60
臺東縣,太麻里鄉,金崙村,169,1,24,0,24,59,3,1,3,0,1,0,40.68
臺東縣,太麻里鄉,多良村,170,1,6,0,6,18,3,1,3,0,1,0,33.33
臺東縣,太麻里鄉,多良村,171,1,119,5,124,229,3,1,3,0,1,0,54.15
臺東縣,大武鄉,南興村,172,1,128,0,128,248,3,1,3,0,1,0,51.61
臺東縣,大武鄉,尚武村,173,1,597,9,606,1178,3,1,3,0,1,0,51.44
臺東縣,大武鄉,大武村,174,1,481,10,491,861,3,1,3,0,1,0,57.03
臺東縣,大武鄉,大鳥村,175,1,47,0,47,104,3,1,3,0,1,0,45.19
臺東縣,大武鄉,大竹村,176,1,26,0,26,49,3,1,3,0,1,0,53.06
臺東縣,大武鄉,大竹村,177,1,19,0,19,39,3,1,3,0,1,0,48.72
臺東縣,綠島鄉,南寮村,178,1,356,7,363,663,3,1,3,0,1,0,54.75
臺東縣,綠島鄉,中寮村,179,1,341,7,348,738,3,1,3,0,1,0,47.15
臺東縣,綠島鄉,公館村,180,1,247,6,253,468,3,1,3,0,1,0,54.06
臺東縣,綠島鄉,公館村,181,1,86,1,87,130,3,1,3,0,1,0,66.92
臺東縣,海端鄉,加拿村,182,1,13,1,14,27,3,1,3,0,1,0,51.85
臺東縣,海端鄉,崁頂村,183,1,34,0,34,55,3,1,3,0,1,0,61.82
臺東縣,海端鄉,海端村,184,1,71,2,73,125,3,1,3,0,1,0,58.40
臺東縣,海端鄉,廣原村,185,1,44,1,45,75,3,1,3,0,1,0,60.00
臺東縣,海端鄉,霧鹿村,186,1,14,0,14,22,3,1,3,0,1,0,63.64
臺東縣,海端鄉,利稻村,187,1,19,0,19,29,3,1,3,0,1,0,65.52
臺東縣,延平鄉,桃源村,188,1,58,1,59,95,3,1,3,0,1,0,62.11
臺東縣,延平鄉,紅葉村,189,1,14,0,14,24,3,1,3,0,1,0,58.33
臺東縣,延平鄉,永康村,190,1,13,0,13,22,3,1,3,0,1,0,59.09
臺東縣,延平鄉,武陵村,191,1,19,0,19,40,3,1,3,0,1,0,47.50
臺東縣,延平鄉,鸞山村,192,1,14,0,14,24,3,1,3,0,1,0,58.33
臺東縣,延平鄉,鸞山村,193,1,42,1,43,78,3,1,3,0,1,0,55.13
臺東縣,金峰鄉,嘉蘭村,194,1,46,1,47,77,3,1,3,0,1,0,61.04
臺東縣,金峰鄉,正興村,195,1,31,0,31,46,3,1,3,0,1,0,67.39
臺東縣,金峰鄉,新興村,196,1,16,0,16,31,3,1,3,0,1,0,51.61
臺東縣,金峰鄉,賓茂村,197,1,5,0,5,8,3,1,3,0,1,0,62.50
臺東縣,金峰鄉,歷坵村,198,1,8,0,8,15,3,1,3,0,1,0,53.33
臺東縣,達仁鄉,安朔村,199,1,63,0,63,112,3,1,3,0,1,0,56.25
臺東縣,達仁鄉,安朔村,200,1,20,0,20,51,3,1,3,0,1,0,39.22
臺東縣,達仁鄉,南田村,201,1,19,1,20,55,3,1,3,0,1,0,36.36
臺東縣,達仁鄉,森永村,202,1,30,2,32,67,3,1,3,0,1,0,47.76
臺東縣,達仁鄉,新化村,203,1,3,0,3,12,3,1,3,0,1,0,25.00
臺東縣,達仁鄉,台板村,204,1,13,0,13,35,3,1,3,0,1,0,37.14
臺東縣,達仁鄉,土板村,205,1,9,0,9,24,3,1,3,0,1,0,37.50
臺東縣,蘭嶼鄉,椰油村,206,1,37,0,37,80,3,1,3,0,1,0,46.25
臺東縣,蘭嶼鄉,紅頭村,207,1,42,0,42,79,3,1,3,0,1,0,53.16
臺東縣,蘭嶼鄉,東清村,208,1,6,0,6,20,3,1,3,0,1,0,30.00
臺東縣,蘭嶼鄉,朗島村,209,1,10,0,10,15,3,1,3,0,1,0,66.67
花蓮縣,花蓮市,民德里,1,1,954,8,962,1412,3,1,3,0,1,0,68.13
花蓮縣,花蓮市,民勤里,2,1,799,8,807,1216,3,1,3,0,1,0,66.37
花蓮縣,花蓮市,民勤里,3,1,520,8,528,832,3,1,3,0,1,0,63.46
花蓮縣,花蓮市,民勤里,4,1,736,12,748,1105,3,1,3,0,1,0,67.69
花蓮縣,花蓮市,民意里,5,1,517,8,525,856,3,1,3,0,1,0,61.33
花蓮縣,花蓮市,民意里,6,1,486,30,516,998,3,1,3,0,1,0,51.70
花蓮縣,花蓮市,民意里,7,1,471,11,482,768,3,1,3,0,1,0,62.76
花蓮縣,花蓮市,民心里,8,1,430,4,434,748,3,1,3,0,1,0,58.02
花蓮縣,花蓮市,民享里,9,1,455,6,461,716,3,1,3,0,1,0,64.39
花蓮縣,花蓮市,民享里,10,1,607,11,618,1023,3,1,3,0,1,0,60.41
花蓮縣,花蓮市,民享里,11,1,845,9,854,1313,3,1,3,0,1,0,65.04
花蓮縣,花蓮市,民運里,12,1,624,20,644,958,3,1,3,0,1,0,67.22
花蓮縣,花蓮市,民運里,13,1,526,10,536,808,3,1,3,0,1,0,66.34
花蓮縣,花蓮市,民政里,14,1,755,11,766,1219,3,1,3,0,1,0,62.84
花蓮縣,花蓮市,民政里,15,1,920,9,929,1377,3,1,3,0,1,0,67.47
花蓮縣,花蓮市,民立里,16,1,863,16,879,1326,3,1,3,0,1,0,66.29
花蓮縣,花蓮市,民樂里,17,1,289,7,296,511,3,1,3,0,1,0,57.93
花蓮縣,花蓮市,民有里,18,1,406,5,411,626,3,1,3,0,1,0,65.65
花蓮縣,花蓮市,民主里,19,1,392,10,402,592,3,1,3,0,1,0,67.91
花蓮縣,花蓮市,民治里,20,1,256,5,261,379,3,1,3,0,1,0,68.87
花蓮縣,花蓮市,民族里,21,1,370,5,375,577,3,1,3,0,1,0,64.99
花蓮縣,花蓮市,民生里,22,1,838,7,845,1294,3,1,3,0,1,0,65.30
花蓮縣,花蓮市,民權里,23,1,267,4,271,435,3,1,3,0,1,0,62.30
花蓮縣,花蓮市,主商里,24,1,501,1,502,741,3,1,3,0,1,0,67.75
花蓮縣,花蓮市,主勤里,25,1,643,11,654,966,3,1,3,0,1,0,67.70
花蓮縣,花蓮市,主工里,26,1,419,5,424,632,3,1,3,0,1,0,67.09
花蓮縣,花蓮市,主信里,27,1,441,8,449,731,3,1,3,0,1,0,61.42
花蓮縣,花蓮市,主睦里、主義里,28,1,657,10,667,1016,3,1,3,0,1,0,65.65
花蓮縣,花蓮市,主計里,29,1,472,7,479,818,3,1,3,0,1,0,58.56
花蓮縣,花蓮市,主和里,30,1,762,12,774,1206,3,1,3,0,1,0,64.18
花蓮縣,花蓮市,主和里,31,1,922,17,939,1487,3,1,3,0,1,0,63.15
花蓮縣,花蓮市,主學里,32,1,515,8,523,815,3,1,3,0,1,0,64.17
花蓮縣,花蓮市,主學里,33,1,542,2,544,863,3,1,3,0,1,0,63.04
花蓮縣,花蓮市,主農里,34,1,984,10,994,1507,3,1,3,0,1,0,65.96
花蓮縣,花蓮市,主農里,35,1,728,10,738,1145,3,1,3,0,1,0,64.45
花蓮縣,花蓮市,主農里,36,1,721,11,732,1126,3,1,3,0,1,0,65.01
花蓮縣,花蓮市,主農里,37,1,809,10,819,1284,3,1,3,0,1,0,63.79
花蓮縣,花蓮市,主權里,38,1,739,13,752,1191,3,1,3,0,1,0,63.14
花蓮縣,花蓮市,主權里,39,1,853,10,863,1461,3,1,3,0,1,0,59.07
花蓮縣,花蓮市,主權里,40,1,814,11,825,1279,3,1,3,0,1,0,64.50
花蓮縣,花蓮市,主力里,41,1,782,10,792,1224,3,1,3,0,1,0,64.71
花蓮縣,花蓮市,主力里,42,1,711,5,716,1123,3,1,3,0,1,0,63.76
花蓮縣,花蓮市,國風里,43,1,985,11,996,1546,3,1,3,0,1,0,64.42
花蓮縣,花蓮市,國風里,44,1,916,12,928,1503,3,1,3,0,1,0,61.74
花蓮縣,花蓮市,國威里,45,1,966,7,973,1630,3,1,3,0,1,0,59.69
花蓮縣,花蓮市,國治里,46,1,678,12,690,1078,3,1,3,0,1,0,64.01
花蓮縣,花蓮市,國安里,47,1,272,10,282,439,3,1,3,0,1,0,64.24
花蓮縣,花蓮市,國光里,48,1,919,17,936,1396,3,1,3,0,1,0,67.05
花蓮縣,花蓮市,國防里,49,1,475,7,482,772,3,1,3,0,1,0,62.44
花蓮縣,花蓮市,國華里,50,1,727,6,733,1186,3,1,3,0,1,0,61.80
花蓮縣,花蓮市,國華里,51,1,562,6,568,845,3,1,3,0,1,0,67.22
花蓮縣,花蓮市,國魂里,52,1,656,13,669,1040,3,1,3,0,1,0,64.33
花蓮縣,花蓮市,國魂里,53,1,464,4,468,697,3,1,3,0,1,0,67.14
花蓮縣,花蓮市,國聯里,54,1,649,11,660,1044,3,1,3,0,1,0,63.22
花蓮縣,花蓮市,國聯里,55,1,650,8,658,1085,3,1,3,0,1,0,60.65
花蓮縣,花蓮市,國聯里,56,1,692,9,701,1209,3,1,3,0,1,0,57.98
花蓮縣,花蓮市,國聯里,57,1,595,7,602,1105,3,1,3,0,1,0,54.48
花蓮縣,花蓮市,國強里,58,1,739,10,749,1148,3,1,3,0,1,0,65.24
花蓮縣,花蓮市,國富里,59,1,857,5,862,1336,3,1,3,0,1,0,64.52
花蓮縣,花蓮市,國富里,60,1,965,8,973,1514,3,1,3,0,1,0,64.27
花蓮縣,花蓮市,國富里,61,1,901,8,909,1419,3,1,3,0,1,0,64.06
花蓮縣,花蓮市,國裕里,62,1,598,6,604,1008,3,1,3,0,1,0,59.92
花蓮縣,花蓮市,國裕里,63,1,714,9,723,1090,3,1,3,0,1,0,66.33
花蓮縣,花蓮市,國裕里,64,1,625,10,635,1008,3,1,3,0,1,0,63.00
花蓮縣,花蓮市,國慶里,65,1,531,4,535,833,3,1,3,0,1,0,64.23
花蓮縣,花蓮市,國慶里,66,1,736,8,744,1263,3,1,3,0,1,0,58.91
花蓮縣,花蓮市,國慶里,67,1,783,12,795,1282,3,1,3,0,1,0,62.01
花蓮縣,花蓮市,國福里,68,1,475,10,485,858,3,1,3,0,1,0,56.53
花蓮縣,新城鄉,新城村,69,1,214,2,216,347,3,1,3,0,1,0,62.25
花蓮縣,新城鄉,新城村,70,1,547,10,557,918,3,1,3,0,1,0,60.68
花蓮縣,新城鄉,順安村,71,1,323,5,328,601,3,1,3,0,1,0,54.58
花蓮縣,新城鄉,順安村,72,1,166,5,171,243,3,1,3,0,1,0,70.37
花蓮縣,新城鄉,康樂村,73,1,184,1,185,304,3,1,3,0,1,0,60.86
花蓮縣,新城鄉,康樂村,74,1,905,17,922,1631,3,1,3,0,1,0,56.53
花蓮縣,新城鄉,大漢村,75,1,718,22,740,1260,3,1,3,0,1,0,58.73
花蓮縣,新城鄉,大漢村,76,1,266,6,272,432,3,1,3,0,1,0,62.96
花蓮縣,新城鄉,北埔村,77,1,669,10,679,1128,3,1,3,0,1,0,60.20
花蓮縣,新城鄉,北埔村,78,1,748,9,757,1277,3,1,3,0,1,0,59.28
花蓮縣,新城鄉,佳林村,79,1,329,5,334,555,3,1,3,0,1,0,60.18
花蓮縣,新城鄉,嘉里村,80,1,789,16,805,1338,3,1,3,0,1,0,60.16
花蓮縣,新城鄉,嘉里村,81,1,789,25,814,1294,3,1,3,0,1,0,62.91
花蓮縣,新城鄉,嘉新村,82,1,419,15,434,612,3,1,3,0,1,0,70.92
花蓮縣,新城鄉,嘉新村,83,1,217,7,224,430,3,1,3,0,1,0,52.09
花蓮縣,秀林鄉,和平村,84,1,122,3,125,255,3,1,3,0,1,0,49.02
花蓮縣,秀林鄉,和平村,85,1,65,2,67,124,3,1,3,0,1,0,54.03
花蓮縣,秀林鄉,崇德村,86,1,222,3,225,367,3,1,3,0,1,0,61.31
花蓮縣,秀林鄉,富世村,87,1,136,3,139,235,3,1,3,0,1,0,59.15
花蓮縣,秀林鄉,富世村,88,1,95,0,95,197,3,1,3,0,1,0,48.22
花蓮縣,秀林鄉,秀林村,89,1,69,1,70,137,3,1,3,0,1,0,51.09
花蓮縣,秀林鄉,景美村,90,1,42,2,44,85,3,1,3,0,1,0,51.76
花蓮縣,秀林鄉,景美村,91,1,32,2,34,64,3,1,3,0,1,0,53.13
花蓮縣,秀林鄉,佳民村,92,1,87,2,89,141,3,1,3,0,1,0,63.12
花蓮縣,秀林鄉,水源村,93,1,83,5,88,112,3,1,3,0,1,0,78.57
花蓮縣,秀林鄉,銅門村,94,1,56,1,57,87,3,1,3,0,1,0,65.52
花蓮縣,秀林鄉,文蘭村,95,1,33,3,36,69,3,1,3,0,1,0,52.17
花蓮縣,秀林鄉,文蘭村,96,1,13,1,14,23,3,1,3,0,1,0,60.87
花蓮縣,吉安鄉,永安村,97,1,872,6,878,1456,3,1,3,0,1,0,60.30
花蓮縣,吉安鄉,永安村,98,1,919,14,933,1563,3,1,3,0,1,0,59.69
花蓮縣,吉安鄉,太昌村,99,1,889,13,902,1474,3,1,3,0,1,0,61.19
花蓮縣,吉安鄉,太昌村,100,1,565,17,582,933,3,1,3,0,1,0,62.38
花蓮縣,吉安鄉,慶豐村,101,1,903,14,917,1440,3,1,3,0,1,0,63.68
花蓮縣,吉安鄉,慶豐村,102,1,912,12,924,1407,3,1,3,0,1,0,65.67
花蓮縣,吉安鄉,慶豐村,103,1,828,13,841,1326,3,1,3,0,1,0,63.42
花蓮縣,吉安鄉,吉安村,104,1,746,11,757,1236,3,1,3,0,1,0,61.25
花蓮縣,吉安鄉,吉安村,105,1,1047,23,1070,1763,3,1,3,0,1,0,60.69
花蓮縣,吉安鄉,福興村,106,1,499,5,504,806,3,1,3,0,1,0,62.53
花蓮縣,吉安鄉,福興村,107,1,748,13,761,1135,3,1,3,0,1,0,67.05
花蓮縣,吉安鄉,南華村,108,1,708,21,729,1108,3,1,3,0,1,0,65.79
花蓮縣,吉安鄉,干城村,109,1,475,14,489,833,3,1,3,0,1,0,58.70
花蓮縣,吉安鄉,永興村,110,1,908,13,921,1487,3,1,3,0,1,0,61.94
花蓮縣,吉安鄉,永興村,111,1,328,3,331,556,3,1,3,0,1,0,59.53
花蓮縣,吉安鄉,稻香村,112,1,697,7,704,1085,3,1,3,0,1,0,64.88
花蓮縣,吉安鄉,稻香村,113,1,813,22,835,1287,3,1,3,0,1,0,64.88
花蓮縣,吉安鄉,南昌村,114,1,470,6,476,780,3,1,3,0,1,0,61.03
花蓮縣,吉安鄉,南昌村,115,1,732,5,737,1210,3,1,3,0,1,0,60.91
花蓮縣,吉安鄉,宜昌村,116,1,817,13,830,1331,3,1,3,0,1,0,62.36
花蓮縣,吉安鄉,宜昌村,117,1,768,11,779,1255,3,1,3,0,1,0,62.07
花蓮縣,吉安鄉,北昌村,118,1,879,19,898,1476,3,1,3,0,1,0,60.84
花蓮縣,吉安鄉,北昌村,119,1,958,9,967,1449,3,1,3,0,1,0,66.74
花蓮縣,吉安鄉,北昌村,120,1,912,10,922,1381,3,1,3,0,1,0,66.76
花蓮縣,吉安鄉,北昌村,121,1,860,15,875,1354,3,1,3,0,1,0,64.62
花蓮縣,吉安鄉,勝安村,122,1,944,14,958,1535,3,1,3,0,1,0,62.41
花蓮縣,吉安鄉,勝安村,123,1,1106,17,1123,1782,3,1,3,0,1,0,63.02
花蓮縣,吉安鄉,仁里村,124,1,536,6,542,857,3,1,3,0,1,0,63.24
花蓮縣,吉安鄉,仁里村,125,1,862,8,870,1381,3,1,3,0,1,0,63.00
花蓮縣,吉安鄉,仁里村,126,1,619,10,629,990,3,1,3,0,1,0,63.54
花蓮縣,吉安鄉,仁里村,127,1,701,5,706,1170,3,1,3,0,1,0,60.34
花蓮縣,吉安鄉,東昌村,128,1,646,5,651,1042,3,1,3,0,1,0,62.48
花蓮縣,吉安鄉,東昌村,129,1,753,7,760,1214,3,1,3,0,1,0,62.60
花蓮縣,吉安鄉,東昌村,130,1,454,10,464,787,3,1,3,0,1,0,58.96
花蓮縣,吉安鄉,仁安村,131,1,812,16,828,1389,3,1,3,0,1,0,59.61
花蓮縣,吉安鄉,仁和村,132,1,768,7,775,1255,3,1,3,0,1,0,61.75
花蓮縣,吉安鄉,仁和村,133,1,610,17,627,1022,3,1,3,0,1,0,61.35
花蓮縣,吉安鄉,仁和村,134,1,543,14,557,994,3,1,3,0,1,0,56.04
花蓮縣,吉安鄉,光華村,135,1,532,19,551,889,3,1,3,0,1,0,61.98
花蓮縣,壽豐鄉,溪口村,136,1,416,10,426,704,3,1,3,0,1,0,60.51
花蓮縣,壽豐鄉,樹湖村,137,1,199,7,206,320,3,1,3,0,1,0,64.38
花蓮縣,壽豐鄉,豐山村,138,1,1104,21,1125,1825,3,1,3,0,1,0,61.64
花蓮縣,壽豐鄉,豐裡村,139,1,683,9,692,1166,3,1,3,0,1,0,59.35
花蓮縣,壽豐鄉,豐坪村,140,1,396,9,405,635,3,1,3,0,1,0,63.78
花蓮縣,壽豐鄉,壽豐村,141,1,649,3,652,1050,3,1,3,0,1,0,62.10
花蓮縣,壽豐鄉,共和村,142,1,338,12,350,530,3,1,3,0,1,0,66.04
花蓮縣,壽豐鄉,光榮村,143,1,87,3,90,152,3,1,3,0,1,0,59.21
花蓮縣,壽豐鄉,池南村,144,1,328,6,334,565,3,1,3,0,1,0,59.12
花蓮縣,壽豐鄉,平和村,145,1,446,4,450,726,3,1,3,0,1,0,61.98
花蓮縣,壽豐鄉,平和村,146,1,184,4,188,309,3,1,3,0,1,0,60.84
花蓮縣,壽豐鄉,志學村,147,1,1073,19,1092,1822,3,1,3,0,1,0,59.93
花蓮縣,壽豐鄉,志學村,148,1,230,5,235,381,3,1,3,0,1,0,61.68
花蓮縣,壽豐鄉,米棧村,149,1,55,0,55,88,3,1,3,0,1,0,62.50
花蓮縣,壽豐鄉,米棧村,150,1,23,3,26,43,3,1,3,0,1,0,60.47
花蓮縣,壽豐鄉,月眉村,151,1,132,2,134,249,3,1,3,0,1,0,53.82
花蓮縣,壽豐鄉,鹽寮村,152,1,183,2,185,349,3,1,3,0,1,0,53.01
花蓮縣,壽豐鄉,水璉村,153,1,178,5,183,384,3,1,3,0,1,0,47.66
花蓮縣,壽豐鄉,水璉村,154,1,36,0,36,55,3,1,3,0,1,0,65.45
花蓮縣,鳳林鎮,鳳仁里,155,1,730,20,750,1127,3,1,3,0,1,0,66.55
花蓮縣,鳳林鎮,鳳義里,156,1,433,9,442,640,3,1,3,0,1,0,69.06
花蓮縣,鳳林鎮,鳳禮里,157,1,494,2,496,698,3,1,3,0,1,0,71.06
花蓮縣,鳳林鎮,鳳智里,158,1,730,15,745,1129,3,1,3,0,1,0,65.99
花蓮縣,鳳林鎮,鳳信里,159,1,440,10,450,659,3,1,3,0,1,0,68.29
花蓮縣,鳳林鎮,鳳信里,160,1,123,5,128,205,3,1,3,0,1,0,62.44
花蓮縣,鳳林鎮,山興里,161,1,95,2,97,166,3,1,3,0,1,0,58.43
花蓮縣,鳳林鎮,山興里,162,1,46,1,47,75,3,1,3,0,1,0,62.67
花蓮縣,鳳林鎮,大榮里,163,1,371,16,387,670,3,1,3,0,1,0,57.76
花蓮縣,鳳林鎮,大榮里,164,1,363,8,371,606,3,1,3,0,1,0,61.22
花蓮縣,鳳林鎮,北林里,165,1,365,14,379,631,3,1,3,0,1,0,60.06
花蓮縣,鳳林鎮,南平里,166,1,385,4,389,689,3,1,3,0,1,0,56.46
花蓮縣,鳳林鎮,林榮里,167,1,554,18,572,853,3,1,3,0,1,0,67.06
花蓮縣,鳳林鎮,長橋里,168,1,602,19,621,1042,3,1,3,0,1,0,59.60
花蓮縣,鳳林鎮,森榮里,169,1,86,0,86,129,3,1,3,0,1,0,66.67
花蓮縣,光復鄉,大華村,170,1,608,8,616,993,3,1,3,0,1,0,62.03
花蓮縣,光復鄉,大安村,171,1,559,6,565,861,3,1,3,0,1,0,65.62
花蓮縣,光復鄉,大馬村,172,1,227,10,237,399,3,1,3,0,1,0,59.40
花蓮縣,光復鄉,大平村,173,1,155,6,161,300,3,1,3,0,1,0,53.67
花蓮縣,光復鄉,大同村,174,1,427,3,430,713,3,1,3,0,1,0,60.31
花蓮縣,光復鄉,東富村,175,1,44,0,44,93,3,1,3,0,1,0,47.31
花蓮縣,光復鄉,東富村,176,1,66,0,66,136,3,1,3,0,1,0,48.53
花蓮縣,光復鄉,西富村,177,1,77,1,78,122,3,1,3,0,1,0,63.93
花蓮縣,光復鄉,南富村,178,1,55,2,57,110,3,1,3,0,1,0,51.82
花蓮縣,光復鄉,北富村,179,1,103,2,105,189,3,1,3,0,1,0,55.56
花蓮縣,光復鄉,西富村,180,1,132,2,134,227,3,1,3,0,1,0,59.03
花蓮縣,光復鄉,大進村,181,1,331,5,336,469,3,1,3,0,1,0,71.64
花蓮縣,光復鄉,大全村,182,1,300,13,313,517,3,1,3,0,1,0,60.54
花蓮縣,光復鄉,大全村,183,1,74,4,78,124,3,1,3,0,1,0,62.90
花蓮縣,光復鄉,大興村,184,1,179,6,185,328,3,1,3,0,1,0,56.40
花蓮縣,光復鄉,大富村,185,1,218,9,227,367,3,1,3,0,1,0,61.85
花蓮縣,光復鄉,大豐村,186,1,322,8,330,589,3,1,3,0,1,0,56.03
花蓮縣,豐濱鄉,靜浦村,187,1,43,3,46,113,3,1,3,0,1,0,40.71
花蓮縣,豐濱鄉,港口村,188,1,70,4,74,146,3,1,3,0,1,0,50.68
花蓮縣,豐濱鄉,豐濱村,189,1,35,2,37,59,3,1,3,0,1,0,62.71
花蓮縣,豐濱鄉,豐濱村,190,1,307,4,311,589,3,1,3,0,1,0,52.80
花蓮縣,豐濱鄉,豐濱村,191,1,31,1,32,59,3,1,3,0,1,0,54.24
花蓮縣,豐濱鄉,新社村,192,1,44,2,46,107,3,1,3,0,1,0,42.99
花蓮縣,豐濱鄉,磯崎村,193,1,57,2,59,100,3,1,3,0,1,0,59.00
花蓮縣,萬榮鄉,西林村,194,1,26,3,29,60,3,1,3,0,1,0,48.33
花蓮縣,萬榮鄉,見晴村,195,1,9,2,11,31,3,1,3,0,1,0,35.48
花蓮縣,萬榮鄉,萬榮村,196,1,31,0,31,61,3,1,3,0,1,0,50.82
花蓮縣,萬榮鄉,明利村,197,1,37,1,38,60,3,1,3,0,1,0,63.33
花蓮縣,萬榮鄉,馬遠村,198,1,5,1,6,13,3,1,3,0,1,0,46.15
花蓮縣,萬榮鄉,馬遠村,199,1,8,0,8,25,3,1,3,0,1,0,32.00
花蓮縣,萬榮鄉,紅葉村,200,1,56,0,56,104,3,1,3,0,1,0,53.85
花蓮縣,瑞穗鄉,瑞穗村,201,1,472,3,475,745,3,1,3,0,1,0,63.76
花蓮縣,瑞穗鄉,瑞穗村,202,1,637,8,645,1068,3,1,3,0,1,0,60.39
花蓮縣,瑞穗鄉,瑞美村,203,1,462,3,465,787,3,1,3,0,1,0,59.09
花蓮縣,瑞穗鄉,瑞美村,204,1,439,10,449,799,3,1,3,0,1,0,56.20
花蓮縣,瑞穗鄉,瑞良村,205,1,246,1,247,395,3,1,3,0,1,0,62.53
花蓮縣,瑞穗鄉,瑞祥村,206,1,475,12,487,857,3,1,3,0,1,0,56.83
花蓮縣,瑞穗鄉,瑞北村,207,1,244,0,244,422,3,1,3,0,1,0,57.82
花蓮縣,瑞穗鄉,舞鶴村,208,1,272,7,279,505,3,1,3,0,1,0,55.25
花蓮縣,瑞穗鄉,鶴岡村,209,1,140,4,144,285,3,1,3,0,1,0,50.53
花蓮縣,瑞穗鄉,奇美村,210,1,24,0,24,51,3,1,3,0,1,0,47.06
花蓮縣,瑞穗鄉,富源村,211,1,383,11,394,619,3,1,3,0,1,0,63.65
花蓮縣,瑞穗鄉,富民村,212,1,143,3,146,305,3,1,3,0,1,0,47.87
花蓮縣,瑞穗鄉,富興村,213,1,266,6,272,462,3,1,3,0,1,0,58.87
花蓮縣,玉里鎮,中城里,214,1,999,16,1015,1695,3,1,3,0,1,0,59.88
花蓮縣,玉里鎮,中城里,215,1,874,9,883,1460,3,1,3,0,1,0,60.48
花蓮縣,玉里鎮,中城里,216,1,665,10,675,1061,3,1,3,0,1,0,63.62
花蓮縣,玉里鎮,國武里,217,1,837,9,846,1338,3,1,3,0,1,0,63.23
花蓮縣,玉里鎮,啟模里,218,1,498,4,502,849,3,1,3,0,1,0,59.13
花蓮縣,玉里鎮,啟模里,219,1,496,13,509,852,3,1,3,0,1,0,59.74
花蓮縣,玉里鎮,泰昌里,220,1,662,11,673,1093,3,1,3,0,1,0,61.57
花蓮縣,玉里鎮,泰昌里,221,1,380,40,420,1046,3,1,3,0,1,0,40.15
花蓮縣,玉里鎮,泰昌里,222,1,132,22,154,747,3,1,3,0,1,0,20.62
花蓮縣,玉里鎮,永昌里,223,1,624,17,641,1078,3,1,3,0,1,0,59.46
花蓮縣,玉里鎮,源城里,224,1,619,15,634,1100,3,1,3,0,1,0,57.64
花蓮縣,玉里鎮,長良里,225,1,286,21,307,619,3,1,3,0,1,0,49.60
花蓮縣,玉里鎮,樂合里,226,1,198,6,204,401,3,1,3,0,1,0,50.87
花蓮縣,玉里鎮,東豐里,227,1,189,1,190,334,3,1,3,0,1,0,56.89
花蓮縣,玉里鎮,觀音里,228,1,355,9,364,694,3,1,3,0,1,0,52.45
花蓮縣,玉里鎮,觀音里,229,1,155,3,158,317,3,1,3,0,1,0,49.84
花蓮縣,玉里鎮,松浦里,230,1,253,8,261,532,3,1,3,0,1,0,49.06
花蓮縣,玉里鎮,春日里,231,1,232,7,239,474,3,1,3,0,1,0,50.42
花蓮縣,玉里鎮,德武里,232,1,29,1,30,81,3,1,3,0,1,0,37.04
花蓮縣,玉里鎮,三民里,233,1,556,13,569,974,3,1,3,0,1,0,58.42
花蓮縣,玉里鎮,大禹里,234,1,586,8,594,1034,3,1,3,0,1,0,57.45
花蓮縣,富里鄉,吳江村,235,1,225,7,232,435,3,1,3,0,1,0,53.33
花蓮縣,富里鄉,東里村,236,1,593,16,609,1199,3,1,3,0,1,0,50.79
花蓮縣,富里鄉,萬寧村,237,1,287,7,294,623,3,1,3,0,1,0,47.19
花蓮縣,富里鄉,新興村,238,1,289,9,298,571,3,1,3,0,1,0,52.19
花蓮縣,富里鄉,竹田村,239,1,554,19,573,1012,3,1,3,0,1,0,56.62
花蓮縣,富里鄉,羅山村,240,1,219,5,224,457,3,1,3,0,1,0,49.02
花蓮縣,富里鄉,石牌村,241,1,482,15,497,855,3,1,3,0,1,0,58.13
花蓮縣,富里鄉,明里村,242,1,245,5,250,400,3,1,3,0,1,0,62.50
花蓮縣,富里鄉,富里村,243,1,880,24,904,1578,3,1,3,0,1,0,57.29
花蓮縣,富里鄉,永豐村,244,1,255,2,257,519,3,1,3,0,1,0,49.52
花蓮縣,富里鄉,豐南村,245,1,167,4,171,345,3,1,3,0,1,0,49.57
花蓮縣,富里鄉,富南村,246,1,270,6,276,523,3,1,3,0,1,0,52.77
花蓮縣,富里鄉,學田村,247,1,320,5,325,550,3,1,3,0,1,0,59.09
花蓮縣,卓溪鄉,崙山村,248,1,13,2,15,27,3,1,3,0,1,0,55.56
花蓮縣,卓溪鄉,立山村,249,1,8,0,8,18,3,1,3,0,1,0,44.44
花蓮縣,卓溪鄉,立山村,250,1,7,0,7,22,3,1,3,0,1,0,31.82
花蓮縣,卓溪鄉,太平村,251,1,11,0,11,15,3,1,3,0,1,0,73.33
花蓮縣,卓溪鄉,太平村,252,1,14,0,14,19,3,1,3,0,1,0,73.68
花蓮縣,卓溪鄉,卓溪村,253,1,38,0,38,78,3,1,3,0,1,0,48.72
花蓮縣,卓溪鄉,卓清村,254,1,30,1,31,58,3,1,3,0,1,0,53.45
花蓮縣,卓溪鄉,卓清村,255,1,17,1,18,30,3,1,3,0,1,0,60.00
花蓮縣,卓溪鄉,古風村,256,1,25,0,25,43,3,1,3,0,1,0,58.14
花蓮縣,卓溪鄉,古風村,257,1,16,2,18,25,3,1,3,0,1,0,72.00
花蓮縣,卓溪鄉,古風村,258,1,13,0,13,16,3,1,3,0,1,0,81.25
澎湖縣,馬公市,新復里,1,1,210,3,213,341,3,1,3,0,1,0,62.46
澎湖縣,馬公市,復興里,2,1,232,5,237,333,3,1,3,0,1,0,71.17
澎湖縣,馬公市,長安里,3,1,346,4,350,534,3,1,3,0,1,0,65.54
澎湖縣,馬公市,中央里,4,1,322,5,327,484,3,1,3,0,1,0,67.56
澎湖縣,馬公市,啟明里,5,1,534,5,539,855,3,1,3,0,1,0,63.04
澎湖縣,馬公市,重慶里,6,1,657,8,665,988,3,1,3,0,1,0,67.31
澎湖縣,馬公市,中興里,7,1,509,10,519,755,3,1,3,0,1,0,68.74
澎湖縣,馬公市,光復里,8,1,579,4,583,927,3,1,3,0,1,0,62.89
澎湖縣,馬公市,光復里,9,1,601,9,610,899,3,1,3,0,1,0,67.85
澎湖縣,馬公市,光明里,10,1,363,4,367,557,3,1,3,0,1,0,65.89
澎湖縣,馬公市,光明里,11,1,405,15,420,632,3,1,3,0,1,0,66.46
澎湖縣,馬公市,光榮里,12,1,759,8,767,1147,3,1,3,0,1,0,66.87
澎湖縣,馬公市,光榮里,13,1,689,11,700,1049,3,1,3,0,1,0,66.73
澎湖縣,馬公市,朝陽里,14,1,778,6,784,1275,3,1,3,0,1,0,61.49
澎湖縣,馬公市,朝陽里,15,1,754,8,762,1208,3,1,3,0,1,0,63.08
澎湖縣,馬公市,朝陽里,16,1,1169,9,1178,1795,3,1,3,0,1,0,65.63
澎湖縣,馬公市,陽明里,17,1,686,8,694,1130,3,1,3,0,1,0,61.42
澎湖縣,馬公市,陽明里,18,1,719,6,725,1103,3,1,3,0,1,0,65.73
澎湖縣,馬公市,重光里,19,1,702,6,708,1069,3,1,3,0,1,0,66.23
澎湖縣,馬公市,西衛里,20,1,815,20,835,1250,3,1,3,0,1,0,66.80
澎湖縣,馬公市,西衛里,21,1,925,8,933,1360,3,1,3,0,1,0,68.60
澎湖縣,馬公市,西文里,22,1,719,13,732,1080,3,1,3,0,1,0,67.78
澎湖縣,馬公市,西文里,23,1,506,10,516,822,3,1,3,0,1,0,62.77
澎湖縣,馬公市,東文里,24,1,659,7,666,993,3,1,3,0,1,0,67.07
澎湖縣,馬公市,東文里,25,1,529,9,538,848,3,1,3,0,1,0,63.44
澎湖縣,馬公市,案山里,26,1,822,20,842,1207,3,1,3,0,1,0,69.76
澎湖縣,馬公市,光華里,27,1,359,7,366,584,3,1,3,0,1,0,62.67
澎湖縣,馬公市,前寮里,28,1,358,5,363,519,3,1,3,0,1,0,69.94
澎湖縣,馬公市,石泉里,29,1,889,10,899,1392,3,1,3,0,1,0,64.58
澎湖縣,馬公市,菜園里,30,1,223,1,224,313,3,1,3,0,1,0,71.57
澎湖縣,馬公市,東衛里,31,1,871,10,881,1290,3,1,3,0,1,0,68.29
澎湖縣,馬公市,安宅里,32,1,282,7,289,427,3,1,3,0,1,0,67.68
澎湖縣,馬公市,興仁里,33,1,372,5,377,550,3,1,3,0,1,0,68.55
澎湖縣,馬公市,烏崁里,34,1,523,10,533,791,3,1,3,0,1,0,67.38
澎湖縣,馬公市,鐵線里,35,1,262,2,264,365,3,1,3,0,1,0,72.33
澎湖縣,馬公市,鎖港里,36,1,623,12,635,1025,3,1,3,0,1,0,61.95
澎湖縣,馬公市,鎖港里,37,1,555,7,562,957,3,1,3,0,1,0,58.73
澎湖縣,馬公市,山水里,38,1,732,10,742,1310,3,1,3,0,1,0,56.64
澎湖縣,馬公市,五德里,39,1,114,3,117,175,3,1,3,0,1,0,66.86
澎湖縣,馬公市,井垵里,40,1,208,5,213,332,3,1,3,0,1,0,64.16
澎湖縣,馬公市,時裡里,41,1,661,10,671,1016,3,1,3,0,1,0,66.04
澎湖縣,馬公市,風櫃里,42,1,626,12,638,1126,3,1,3,0,1,0,56.66
澎湖縣,馬公市,虎井里,43,1,194,8,202,691,3,1,3,0,1,0,29.23
澎湖縣,馬公市,桶盤里,44,1,90,0,90,194,3,1,3,0,1,0,46.39
澎湖縣,湖西鄉,湖西村,45,1,549,6,555,824,3,1,3,0,1,0,67.35
澎湖縣,湖西鄉,湖東村,46,1,202,1,203,295,3,1,3,0,1,0,68.81
澎湖縣,湖西鄉,青螺村,47,1,120,1,121,203,3,1,3,0,1,0,59.61
澎湖縣,湖西鄉,白坑村,48,1,147,3,150,236,3,1,3,0,1,0,63.56
澎湖縣,湖西鄉,南寮村,49,1,359,6,365,599,3,1,3,0,1,0,60.93
澎湖縣,湖西鄉,北寮村,50,1,193,2,195,268,3,1,3,0,1,0,72.76
澎湖縣,湖西鄉,紅羅村,51,1,354,6,360,540,3,1,3,0,1,0,66.67
澎湖縣,湖西鄉,西溪村,52,1,271,6,277,441,3,1,3,0,1,0,62.81
澎湖縣,湖西鄉,成功村,53,1,253,3,256,402,3,1,3,0,1,0,63.68
澎湖縣,湖西鄉,東石村,54,1,73,0,73,130,3,1,3,0,1,0,56.15
澎湖縣,湖西鄉,沙港村,55,1,462,4,466,695,3,1,3,0,1,0,67.05
澎湖縣,湖西鄉,中西村,56,1,100,3,103,162,3,1,3,0,1,0,63.58
澎湖縣,湖西鄉,鼎灣村,57,1,185,2,187,277,3,1,3,0,1,0,67.51
澎湖縣,湖西鄉,潭邊村,58,1,165,2,167,217,3,1,3,0,1,0,76.96
澎湖縣,湖西鄉,許家村,59,1,126,1,127,182,3,1,3,0,1,0,69.78
澎湖縣,湖西鄉,城北村,60,1,127,3,130,178,3,1,3,0,1,0,73.03
澎湖縣,湖西鄉,太武村,61,1,70,1,71,120,3,1,3,0,1,0,59.17
澎湖縣,湖西鄉,隘門村,62,1,410,3,413,615,3,1,3,0,1,0,67.15
澎湖縣,湖西鄉,林投村,63,1,490,10,500,814,3,1,3,0,1,0,61.43
澎湖縣,湖西鄉,尖山村,64,1,316,7,323,510,3,1,3,0,1,0,63.33
澎湖縣,湖西鄉,龍門村,65,1,484,3,487,758,3,1,3,0,1,0,64.25
澎湖縣,湖西鄉,龍門村,66,1,464,7,471,727,3,1,3,0,1,0,64.79
澎湖縣,湖西鄉,果葉村,67,1,372,4,376,616,3,1,3,0,1,0,61.04
澎湖縣,白沙鄉,中屯村,68,1,287,1,288,435,3,1,3,0,1,0,66.21
澎湖縣,白沙鄉,講美村,69,1,339,2,341,522,3,1,3,0,1,0,65.33
澎湖縣,白沙鄉,城前村,70,1,60,0,60,91,3,1,3,0,1,0,65.93
澎湖縣,白沙鄉,鎮海村,71,1,70,1,71,102,3,1,3,0,1,0,69.61
澎湖縣,白沙鄉,港子村,72,1,144,3,147,249,3,1,3,0,1,0,59.04
澎湖縣,白沙鄉,岐頭村,73,1,109,2,111,207,3,1,3,0,1,0,53.62
澎湖縣,白沙鄉,小赤村,74,1,104,2,106,152,3,1,3,0,1,0,69.74
澎湖縣,白沙鄉,赤崁村,75,1,851,6,857,1339,3,1,3,0,1,0,64.00
澎湖縣,白沙鄉,瓦硐村,76,1,169,0,169,281,3,1,3,0,1,0,60.14
澎湖縣,白沙鄉,後寮村,77,1,376,1,377,637,3,1,3,0,1,0,59.18
澎湖縣,白沙鄉,通梁村,78,1,396,6,402,666,3,1,3,0,1,0,60.36
澎湖縣,白沙鄉,吉貝村,79,1,476,7,483,1142,3,1,3,0,1,0,42.29
澎湖縣,白沙鄉,鳥嶼村,80,1,375,2,377,929,3,1,3,0,1,0,40.58
澎湖縣,白沙鄉,員貝村,81,1,105,1,106,209,3,1,3,0,1,0,50.72
澎湖縣,白沙鄉,大倉村,82,1,73,4,77,158,3,1,3,0,1,0,48.73
澎湖縣,西嶼鄉,橫礁村,83,1,142,7,149,237,3,1,3,0,1,0,62.87
澎湖縣,西嶼鄉,合界村,84,1,256,5,261,404,3,1,3,0,1,0,64.60
澎湖縣,西嶼鄉,竹灣村,85,1,422,19,441,760,3,1,3,0,1,0,58.03
澎湖縣,西嶼鄉,小門村,86,1,139,1,140,251,3,1,3,0,1,0,55.78
澎湖縣,西嶼鄉,大池村,87,1,329,11,340,588,3,1,3,0,1,0,57.82
澎湖縣,西嶼鄉,二崁村,88,1,61,1,62,103,3,1,3,0,1,0,60.19
澎湖縣,西嶼鄉,池東村,89,1,299,12,311,486,3,1,3,0,1,0,63.99
澎湖縣,西嶼鄉,池西村,90,1,112,2,114,195,3,1,3,0,1,0,58.46
澎湖縣,西嶼鄉,赤馬村,91,1,321,8,329,605,3,1,3,0,1,0,54.38
澎湖縣,西嶼鄉,內垵村,92,1,660,14,674,1147,3,1,3,0,1,0,58.76
澎湖縣,西嶼鄉,外垵村,93,1,404,7,411,782,3,1,3,0,1,0,52.56
澎湖縣,西嶼鄉,外垵村,94,1,523,8,531,948,3,1,3,0,1,0,56.01
澎湖縣,望安鄉,東安村,95,1,215,6,221,492,3,1,3,0,1,0,44.92
澎湖縣,望安鄉,西安村,96,1,166,2,168,322,3,1,3,0,1,0,52.17
澎湖縣,望安鄉,中社村,97,1,82,5,87,234,3,1,3,0,1,0,37.18
澎湖縣,望安鄉,水垵村,98,1,133,2,135,285,3,1,3,0,1,0,47.37
澎湖縣,望安鄉,將軍村,99,1,198,8,206,643,3,1,3,0,1,0,32.04
澎湖縣,望安鄉,將軍村,100,1,212,3,215,685,3,1,3,0,1,0,31.39
澎湖縣,望安鄉,東吉村,101,1,75,2,77,233,3,1,3,0,1,0,33.05
澎湖縣,望安鄉,東坪村,102,1,76,0,76,316,3,1,3,0,1,0,24.05
澎湖縣,望安鄉,西坪村,103,1,29,0,29,170,3,1,3,0,1,0,17.06
澎湖縣,望安鄉,花嶼村,104,1,103,3,106,253,3,1,3,0,1,0,41.90
澎湖縣,七美鄉,東湖村,105,1,83,6,89,218,3,1,3,0,1,0,40.83
澎湖縣,七美鄉,西湖村,106,1,154,4,158,448,3,1,3,0,1,0,35.27
澎湖縣,七美鄉,中和村,107,1,169,16,185,427,3,1,3,0,1,0,43.33
澎湖縣,七美鄉,平和村,108,1,97,6,103,277,3,1,3,0,1,0,37.18
澎湖縣,七美鄉,海豐村,109,1,90,4,94,244,3,1,3,0,1,0,38.52
澎湖縣,七美鄉,南港村,110,1,315,7,322,789,3,1,3,0,1,0,40.81
基隆市,中正區,長潭里,1,1,420,4,424,557,3,1,3,0,1,0,76.12
基隆市,中正區,砂子里,2,1,1022,14,1036,1741,3,1,3,0,1,0,59.51
基隆市,中正區,砂子里,3,1,386,12,398,625,3,1,3,0,1,0,63.68
基隆市,中正區,八斗里,4,1,974,8,982,1546,3,1,3,0,1,0,63.52
基隆市,中正區,碧砂里,5,1,771,8,779,1308,3,1,3,0,1,0,59.56
基隆市,中正區,新豐里,6,1,720,17,737,1519,3,1,3,0,1,0,48.52
基隆市,中正區,新豐里,7,1,958,20,978,2015,3,1,3,0,1,0,48.54
基隆市,中正區,新豐里,8,1,1121,11,1132,2142,3,1,3,0,1,0,52.85
基隆市,中正區,平寮里,9,1,939,20,959,1524,3,1,3,0,1,0,62.93
基隆市,中正區,社寮里,10,1,593,10,603,972,3,1,3,0,1,0,62.04
基隆市,中正區,社寮里,11,1,614,9,623,956,3,1,3,0,1,0,65.17
基隆市,中正區,和憲里,12,1,561,14,575,918,3,1,3,0,1,0,62.64
基隆市,中正區,海濱里,13,1,576,13,589,995,3,1,3,0,1,0,59.20
基隆市,中正區,正濱里,14,1,744,21,765,1269,3,1,3,0,1,0,60.28
基隆市,中正區,中正里,15,1,585,15,600,937,3,1,3,0,1,0,64.03
基隆市,中正區,中正里,16,1,608,14,622,1034,3,1,3,0,1,0,60.15
基隆市,中正區,中濱里,17,1,875,13,888,1423,3,1,3,0,1,0,62.40
基隆市,中正區,建國里,18,1,749,4,753,1181,3,1,3,0,1,0,63.76
基隆市,中正區,建國里,19,1,582,10,592,925,3,1,3,0,1,0,64.00
基隆市,中正區,砂灣里,20,1,672,9,681,1104,3,1,3,0,1,0,61.68
基隆市,中正區,砂灣里,21,1,598,9,607,983,3,1,3,0,1,0,61.75
基隆市,中正區,真砂里,22,1,900,12,912,1484,3,1,3,0,1,0,61.46
基隆市,中正區,正砂里,23,1,926,10,936,1492,3,1,3,0,1,0,62.73
基隆市,中正區,正砂里,24,1,561,4,565,899,3,1,3,0,1,0,62.85
基隆市,中正區,中砂里,25,1,874,5,879,1367,3,1,3,0,1,0,64.30
基隆市,中正區,入船里,26,1,832,14,846,1316,3,1,3,0,1,0,64.29
基隆市,中正區,正船里,27,1,997,7,1004,1535,3,1,3,0,1,0,65.41
基隆市,中正區,中船里,28,1,849,6,855,1363,3,1,3,0,1,0,62.73
基隆市,中正區,港通里,29,1,755,9,764,1210,3,1,3,0,1,0,63.14
基隆市,中正區,義重里,30,1,773,23,796,1224,3,1,3,0,1,0,65.03
基隆市,中正區,信義里,31,1,707,12,719,1072,3,1,3,0,1,0,67.07
基隆市,中正區,正義里,32,1,953,17,970,1488,3,1,3,0,1,0,65.19
基隆市,中正區,德義里,33,1,575,4,579,837,3,1,3,0,1,0,69.18
基隆市,信義區,仁壽里,34,1,796,13,809,1188,3,1,3,0,1,0,68.10
基隆市,信義區,仁義里,35,1,792,14,806,1202,3,1,3,0,1,0,67.05
基隆市,信義區,義昭里,36,1,670,6,676,1034,3,1,3,0,1,0,65.38
基隆市,信義區,義幸里,37,1,805,9,814,1177,3,1,3,0,1,0,69.16
基隆市,信義區,義幸里,38,1,770,15,785,1140,3,1,3,0,1,0,68.86
基隆市,信義區,義民里,39,1,610,7,617,861,3,1,3,0,1,0,71.66
基隆市,信義區,義和里,40,1,877,7,884,1312,3,1,3,0,1,0,67.38
基隆市,信義區,智慧里,41,1,495,7,502,707,3,1,3,0,1,0,71.00
基隆市,信義區,智誠里,42,1,464,3,467,691,3,1,3,0,1,0,67.58
基隆市,信義區,智誠里,43,1,695,8,703,1054,3,1,3,0,1,0,66.70
基隆市,信義區,禮儀里,44,1,1009,8,1017,1527,3,1,3,0,1,0,66.60
基隆市,信義區,禮東里,45,1,972,10,982,1527,3,1,3,0,1,0,64.31
基隆市,信義區,信綠里,46,1,844,13,857,1262,3,1,3,0,1,0,67.91
基隆市,信義區,信綠里,47,1,665,10,675,1091,3,1,3,0,1,0,61.87
基隆市,信義區,東信里,48,1,552,8,560,898,3,1,3,0,1,0,62.36
基隆市,信義區,東信里,49,1,1371,19,1390,2214,3,1,3,0,1,0,62.78
基隆市,信義區,東光里,50,1,1141,15,1156,1833,3,1,3,0,1,0,63.07
基隆市,信義區,東明里,51,1,926,8,934,1472,3,1,3,0,1,0,63.45
基隆市,信義區,東明里,52,1,1126,16,1142,1841,3,1,3,0,1,0,62.03
基隆市,信義區,東安里,53,1,904,14,918,1417,3,1,3,0,1,0,64.78
基隆市,信義區,東安里,54,1,831,16,847,1257,3,1,3,0,1,0,67.38
基隆市,信義區,孝賢里,55,1,1934,17,1951,3073,3,1,3,0,1,0,63.49
基隆市,信義區,孝深里,56,1,1004,11,1015,1574,3,1,3,0,1,0,64.49
基隆市,信義區,孝深里,57,1,1039,12,1051,1887,3,1,3,0,1,0,55.70
基隆市,信義區,孝深里,58,1,1289,19,1308,2282,3,1,3,0,1,0,57.32
基隆市,信義區,孝岡里,59,1,538,4,542,887,3,1,3,0,1,0,61.10
基隆市,仁愛區,林泉里,60,1,473,9,482,770,3,1,3,0,1,0,62.60
基隆市,仁愛區,林泉里,61,1,664,13,677,1018,3,1,3,0,1,0,66.50
基隆市,仁愛區,花崗里,62,1,635,5,640,910,3,1,3,0,1,0,70.33
基隆市,仁愛區,虹橋里,63,1,999,16,1015,1526,3,1,3,0,1,0,66.51
基隆市,仁愛區,水錦里,64,1,1125,19,1144,1725,3,1,3,0,1,0,66.32
基隆市,仁愛區,智仁里,65,1,731,11,742,1148,3,1,3,0,1,0,64.63
基隆市,仁愛區,智仁里,66,1,702,12,714,1095,3,1,3,0,1,0,65.21
基隆市,仁愛區,和明里,67,1,722,8,730,1112,3,1,3,0,1,0,65.65
基隆市,仁愛區,忠勇里,68,1,623,15,638,1032,3,1,3,0,1,0,61.82
基隆市,仁愛區,玉田里,69,1,778,8,786,1157,3,1,3,0,1,0,67.93
基隆市,仁愛區,仁德里,70,1,653,12,665,1011,3,1,3,0,1,0,65.78
基隆市,仁愛區,博愛里,71,1,784,7,791,1160,3,1,3,0,1,0,68.19
基隆市,仁愛區,博愛里,72,1,375,4,379,531,3,1,3,0,1,0,71.37
基隆市,仁愛區,福仁里,73,1,517,7,524,842,3,1,3,0,1,0,62.23
基隆市,仁愛區,誠仁里,74,1,664,16,680,1061,3,1,3,0,1,0,64.09
基隆市,仁愛區,吉仁里,75,1,954,18,972,1513,3,1,3,0,1,0,64.24
基隆市,仁愛區,吉仁里,76,1,890,20,910,1431,3,1,3,0,1,0,63.59
基隆市,仁愛區,育仁里,77,1,519,13,532,871,3,1,3,0,1,0,61.08
基隆市,仁愛區,英仁里,78,1,508,6,514,785,3,1,3,0,1,0,65.48
基隆市,仁愛區,英仁里,79,1,433,4,437,691,3,1,3,0,1,0,63.24
基隆市,仁愛區,龍門里,80,1,546,11,557,886,3,1,3,0,1,0,62.87
基隆市,仁愛區,德厚里,81,1,866,18,884,1356,3,1,3,0,1,0,65.19
基隆市,仁愛區,曲水里,82,1,626,8,634,981,3,1,3,0,1,0,64.63
基隆市,仁愛區,崇文里,83,1,609,14,623,971,3,1,3,0,1,0,64.16
基隆市,仁愛區,文安里,84,1,700,20,720,1095,3,1,3,0,1,0,65.75
基隆市,仁愛區,兆連里,85,1,405,5,410,655,3,1,3,0,1,0,62.60
基隆市,仁愛區,獅球里,86,1,739,7,746,1164,3,1,3,0,1,0,64.09
基隆市,仁愛區,書院里,87,1,719,20,739,1126,3,1,3,0,1,0,65.63
基隆市,仁愛區,朝棟里,88,1,857,18,875,1259,3,1,3,0,1,0,69.50
基隆市,仁愛區,朝棟里,89,1,1024,13,1037,1636,3,1,3,0,1,0,63.39
基隆市,仁愛區,光華里,90,1,766,9,775,1185,3,1,3,0,1,0,65.40
基隆市,仁愛區,光華里,91,1,721,7,728,1108,3,1,3,0,1,0,65.70
基隆市,仁愛區,明德里,92,1,519,4,523,761,3,1,3,0,1,0,68.73
基隆市,仁愛區,同風里,93,1,477,4,481,663,3,1,3,0,1,0,72.55
基隆市,仁愛區,文昌里,94,1,567,6,573,852,3,1,3,0,1,0,67.25
基隆市,仁愛區,新店里,95,1,496,8,504,735,3,1,3,0,1,0,68.57
基隆市,中山區,新建里,96,1,554,13,567,803,3,1,3,0,1,0,70.61
基隆市,中山區,安民里,97,1,742,15,757,1106,3,1,3,0,1,0,68.44
基隆市,中山區,安平里,98,1,686,8,694,994,3,1,3,0,1,0,69.82
基隆市,中山區,中山里,99,1,750,8,758,1124,3,1,3,0,1,0,67.44
基隆市,中山區,民治里,100,1,648,8,656,987,3,1,3,0,1,0,66.46
基隆市,中山區,中興里,101,1,872,16,888,1312,3,1,3,0,1,0,67.68
基隆市,中山區,仁正里,102,1,532,15,547,836,3,1,3,0,1,0,65.43
基隆市,中山區,健民里,103,1,1014,27,1041,1558,3,1,3,0,1,0,66.82
基隆市,中山區,通化里,104,1,801,18,819,1268,3,1,3,0,1,0,64.59
基隆市,中山區,居仁里,105,1,403,8,411,716,3,1,3,0,1,0,57.40
基隆市,中山區,居仁里,106,1,503,6,509,810,3,1,3,0,1,0,62.84
基隆市,中山區,通明里,107,1,706,12,718,1087,3,1,3,0,1,0,66.05
基隆市,中山區,通明里,108,1,617,10,627,964,3,1,3,0,1,0,65.04
基隆市,中山區,和平里,109,1,440,9,449,707,3,1,3,0,1,0,63.51
基隆市,中山區,仙洞里,110,1,479,6,485,772,3,1,3,0,1,0,62.82
基隆市,中山區,太白里,111,1,612,15,627,973,3,1,3,0,1,0,64.44
基隆市,中山區,協和里,112,1,512,9,521,833,3,1,3,0,1,0,62.55
基隆市,中山區,協和里,113,1,522,11,533,766,3,1,3,0,1,0,69.58
基隆市,中山區,文化里,114,1,653,17,670,1109,3,1,3,0,1,0,60.41
基隆市,中山區,德安里,115,1,656,13,669,979,3,1,3,0,1,0,68.34
基隆市,中山區,德安里,116,1,1279,27,1306,2100,3,1,3,0,1,0,62.19
基隆市,中山區,德和里,117,1,1917,27,1944,2934,3,1,3,0,1,0,66.26
基隆市,中山區,德和里,118,1,1014,7,1021,1555,3,1,3,0,1,0,65.66
基隆市,中山區,中和里,119,1,855,14,869,1353,3,1,3,0,1,0,64.23
基隆市,中山區,中和里,120,1,1120,12,1132,1962,3,1,3,0,1,0,57.70
基隆市,中山區,中和里,121,1,1442,12,1454,2639,3,1,3,0,1,0,55.10
基隆市,中山區,中和里,122,1,1321,12,1333,2289,3,1,3,0,1,0,58.24
基隆市,中山區,西康里,123,1,462,11,473,753,3,1,3,0,1,0,62.82
基隆市,中山區,西康里,124,1,601,13,614,938,3,1,3,0,1,0,65.46
基隆市,中山區,西定里,125,1,637,5,642,988,3,1,3,0,1,0,64.98
基隆市,中山區,西華里,126,1,657,16,673,1014,3,1,3,0,1,0,66.37
基隆市,中山區,西榮里,127,1,538,9,547,863,3,1,3,0,1,0,63.38
基隆市,安樂區,新西里,128,1,925,21,946,1485,3,1,3,0,1,0,63.70
基隆市,安樂區,西川里,129,1,872,16,888,1377,3,1,3,0,1,0,64.49
基隆市,安樂區,定國里,130,1,786,18,804,1273,3,1,3,0,1,0,63.16
基隆市,安樂區,定邦里,131,1,839,20,859,1331,3,1,3,0,1,0,64.54
基隆市,安樂區,干城里,132,1,973,11,984,1507,3,1,3,0,1,0,65.30
基隆市,安樂區,干城里,133,1,510,19,529,820,3,1,3,0,1,0,64.51
基隆市,安樂區,永康里,134,1,925,22,947,1536,3,1,3,0,1,0,61.65
基隆市,安樂區,永康里,135,1,296,10,306,479,3,1,3,0,1,0,63.88
基隆市,安樂區,慈仁里,136,1,651,11,662,1057,3,1,3,0,1,0,62.63
基隆市,安樂區,安和里,137,1,581,9,590,896,3,1,3,0,1,0,65.85
基隆市,安樂區,樂一里,138,1,467,8,475,704,3,1,3,0,1,0,67.47
基隆市,安樂區,嘉仁里,139,1,1206,7,1213,1916,3,1,3,0,1,0,63.31
基隆市,安樂區,嘉仁里,140,1,863,19,882,1366,3,1,3,0,1,0,64.57
基隆市,安樂區,鶯歌里,141,1,857,9,866,1376,3,1,3,0,1,0,62.94
基隆市,安樂區,鶯歌里,142,1,875,11,886,1434,3,1,3,0,1,0,61.79
基隆市,安樂區,鶯歌里,143,1,1220,14,1234,2024,3,1,3,0,1,0,60.97
基隆市,安樂區,七賢里,144,1,922,11,933,1451,3,1,3,0,1,0,64.30
基隆市,安樂區,七賢里,145,1,852,10,862,1389,3,1,3,0,1,0,62.06
基隆市,安樂區,三民里,146,1,954,16,970,1535,3,1,3,0,1,0,63.19
基隆市,安樂區,三民里,147,1,931,12,943,1564,3,1,3,0,1,0,60.29
基隆市,安樂區,三民里,148,1,617,9,626,1056,3,1,3,0,1,0,59.28
基隆市,安樂區,四維里,149,1,1052,14,1066,1554,3,1,3,0,1,0,68.60
基隆市,安樂區,四維里,150,1,797,9,806,1300,3,1,3,0,1,0,62.00
基隆市,安樂區,四維里,151,1,585,14,599,885,3,1,3,0,1,0,67.68
基隆市,安樂區,五福里,152,1,1192,21,1213,1903,3,1,3,0,1,0,63.74
基隆市,安樂區,五福里,153,1,880,14,894,1414,3,1,3,0,1,0,63.22
基隆市,安樂區,長樂里,154,1,1057,6,1063,1731,3,1,3,0,1,0,61.41
基隆市,安樂區,長樂里,155,1,363,3,366,578,3,1,3,0,1,0,63.32
基隆市,安樂區,六合里,156,1,1051,17,1068,1635,3,1,3,0,1,0,65.32
基隆市,安樂區,六合里,157,1,1133,11,1144,1747,3,1,3,0,1,0,65.48
基隆市,安樂區,外寮里,158,1,1623,17,1640,2741,3,1,3,0,1,0,59.83
基隆市,安樂區,外寮里,159,1,1184,13,1197,2085,3,1,3,0,1,0,57.41
基隆市,安樂區,外寮里,160,1,882,21,903,1498,3,1,3,0,1,0,60.28
基隆市,安樂區,新崙里,161,1,1116,8,1124,1901,3,1,3,0,1,0,59.13
基隆市,安樂區,新崙里,162,1,592,17,609,999,3,1,3,0,1,0,60.96
基隆市,安樂區,武崙里,163,1,1658,19,1677,2912,3,1,3,0,1,0,57.59
基隆市,安樂區,中崙里,164,1,725,12,737,1211,3,1,3,0,1,0,60.86
基隆市,安樂區,內寮里,165,1,930,16,946,1742,3,1,3,0,1,0,54.31
基隆市,安樂區,內寮里,166,1,893,14,907,1592,3,1,3,0,1,0,56.97
基隆市,暖暖區,八西里,167,1,733,8,741,1177,3,1,3,0,1,0,62.96
基隆市,暖暖區,八中里,168,1,401,5,406,636,3,1,3,0,1,0,63.84
基隆市,暖暖區,八堵里,169,1,488,6,494,746,3,1,3,0,1,0,66.22
基隆市,暖暖區,八南里,170,1,408,6,414,650,3,1,3,0,1,0,63.69
基隆市,暖暖區,過港里,171,1,970,10,980,1637,3,1,3,0,1,0,59.87
基隆市,暖暖區,過港里,172,1,962,13,975,1521,3,1,3,0,1,0,64.10
基隆市,暖暖區,暖暖里,173,1,749,15,764,1190,3,1,3,0,1,0,64.20
基隆市,暖暖區,暖暖里,174,1,601,6,607,936,3,1,3,0,1,0,64.85
基隆市,暖暖區,暖同里,175,1,628,10,638,956,3,1,3,0,1,0,66.74
基隆市,暖暖區,暖同里,176,1,695,13,708,1164,3,1,3,0,1,0,60.82
基隆市,暖暖區,暖東里,177,1,257,8,265,389,3,1,3,0,1,0,68.12
基隆市,暖暖區,暖西里,178,1,1115,24,1139,1897,3,1,3,0,1,0,60.04
基隆市,暖暖區,暖西里,179,1,948,15,963,1602,3,1,3,0,1,0,60.11
基隆市,暖暖區,碇內里,180,1,559,6,565,908,3,1,3,0,1,0,62.22
基隆市,暖暖區,碇內里,181,1,787,12,799,1369,3,1,3,0,1,0,58.36
基隆市,暖暖區,碇和里,182,1,567,11,578,800,3,1,3,0,1,0,72.25
基隆市,暖暖區,碇和里,183,1,862,6,868,1508,3,1,3,0,1,0,57.56
基隆市,暖暖區,碇祥里,184,1,666,9,675,1430,3,1,3,0,1,0,47.20
基隆市,暖暖區,碇祥里,185,1,984,8,992,1758,3,1,3,0,1,0,56.43
基隆市,暖暖區,碇安里,186,1,1416,28,1444,2380,3,1,3,0,1,0,60.67
基隆市,暖暖區,碇安里,187,1,1014,19,1033,1829,3,1,3,0,1,0,56.48
基隆市,七堵區,長興里,188,1,947,16,963,1483,3,1,3,0,1,0,64.94
基隆市,七堵區,長興里,189,1,681,16,697,1093,3,1,3,0,1,0,63.77
基隆市,七堵區,長興里,190,1,760,17,777,1112,3,1,3,0,1,0,69.87
基隆市,七堵區,正光里,191,1,781,20,801,1156,3,1,3,0,1,0,69.29
基隆市,七堵區,正光里,192,1,593,7,600,884,3,1,3,0,1,0,67.87
基隆市,七堵區,正明里,193,1,863,9,872,1281,3,1,3,0,1,0,68.07
基隆市,七堵區,正明里,194,1,496,9,505,719,3,1,3,0,1,0,70.24
基隆市,七堵區,富民里,195,1,1210,11,1221,1808,3,1,3,0,1,0,67.53
基隆市,七堵區,富民里,196,1,1183,11,1194,1773,3,1,3,0,1,0,67.34
基隆市,七堵區,永平里,197,1,712,11,723,1034,3,1,3,0,1,0,69.92
基隆市,七堵區,永平里,198,1,675,8,683,1037,3,1,3,0,1,0,65.86
基隆市,七堵區,永安里,199,1,782,19,801,1147,3,1,3,0,1,0,69.83
基隆市,七堵區,永安里,200,1,599,12,611,887,3,1,3,0,1,0,68.88
基隆市,七堵區,八德里,201,1,198,6,204,303,3,1,3,0,1,0,67.33
基隆市,七堵區,八德里,202,1,802,13,815,1217,3,1,3,0,1,0,66.97
基隆市,七堵區,自強里,203,1,595,13,608,932,3,1,3,0,1,0,65.24
基隆市,七堵區,泰安里,204,1,601,12,613,922,3,1,3,0,1,0,66.49
基隆市,七堵區,泰安里,205,1,766,8,774,1270,3,1,3,0,1,0,60.94
基隆市,七堵區,泰安里,206,1,627,11,638,920,3,1,3,0,1,0,69.35
基隆市,七堵區,六堵里,207,1,871,16,887,1396,3,1,3,0,1,0,63.54
基隆市,七堵區,堵南里,208,1,858,18,876,1434,3,1,3,0,1,0,61.09
基隆市,七堵區,堵南里,209,1,908,13,921,1655,3,1,3,0,1,0,55.65
基隆市,七堵區,堵北里,210,1,823,8,831,1337,3,1,3,0,1,0,62.15
基隆市,七堵區,堵北里,211,1,971,14,985,1598,3,1,3,0,1,0,61.64
基隆市,七堵區,百福里,212,1,763,9,772,1275,3,1,3,0,1,0,60.55
基隆市,七堵區,百福里,213,1,986,17,1003,1549,3,1,3,0,1,0,64.75
基隆市,七堵區,百福里,214,1,887,3,890,1485,3,1,3,0,1,0,59.93
基隆市,七堵區,實踐里,215,1,707,9,716,1168,3,1,3,0,1,0,61.30
基隆市,七堵區,實踐里,216,1,515,10,525,887,3,1,3,0,1,0,59.19
基隆市,七堵區,實踐里,217,1,654,11,665,1156,3,1,3,0,1,0,57.53
基隆市,七堵區,瑪南里,218,1,287,4,291,457,3,1,3,0,1,0,63.68
基隆市,七堵區,瑪東里,219,1,223,6,229,315,3,1,3,0,1,0,72.70
基隆市,七堵區,瑪西里,220,1,235,6,241,360,3,1,3,0,1,0,66.94
基隆市,七堵區,友一里,221,1,746,9,755,1171,3,1,3,0,1,0,64.47
基隆市,七堵區,友二里,222,1,304,11,315,443,3,1,3,0,1,0,71.11
新竹市,東區,育賢里,1,1,592,6,598,1093,3,1,3,0,1,0,54.71
新竹市,東區,親仁里,2,1,574,2,576,930,3,1,3,0,1,0,61.94
新竹市,東區,親仁里,3,1,518,8,526,856,3,1,3,0,1,0,61.45
新竹市,東區,東門里,4,1,483,6,489,766,3,1,3,0,1,0,63.84
新竹市,東區,成功里,5,1,483,9,492,783,3,1,3,0,1,0,62.84
新竹市,東區,榮光里,6,1,262,5,267,468,3,1,3,0,1,0,57.05
新竹市,東區,中正里,7,1,311,5,316,523,3,1,3,0,1,0,60.42
新竹市,東區,錦華里,8,1,693,6,699,1078,3,1,3,0,1,0,64.84
新竹市,東區,錦華里,9,1,492,7,499,747,3,1,3,0,1,0,66.80
新竹市,東區,文華里,10,1,679,6,685,1084,3,1,3,0,1,0,63.19
新竹市,東區,文華里,11,1,637,8,645,937,3,1,3,0,1,0,68.84
新竹市,東區,文華里,12,1,779,12,791,1270,3,1,3,0,1,0,62.28
新竹市,東區,復中里,13,1,1089,14,1103,1710,3,1,3,0,1,0,64.50
新竹市,東區,復中里,14,1,1169,15,1184,1907,3,1,3,0,1,0,62.09
新竹市,東區,復興里,15,1,970,10,980,1549,3,1,3,0,1,0,63.27
新竹市,東區,復興里,16,1,1149,10,1159,1791,3,1,3,0,1,0,64.71
新竹市,東區,三民里,17,1,769,11,780,1199,3,1,3,0,1,0,65.05
新竹市,東區,三民里,18,1,908,8,916,1363,3,1,3,0,1,0,67.20
新竹市,東區,三民里,19,1,735,4,739,1160,3,1,3,0,1,0,63.71
新竹市,東區,東園里,20,1,545,10,555,911,3,1,3,0,1,0,60.92
新竹市,東區,東園里,21,1,987,14,1001,1541,3,1,3,0,1,0,64.96
新竹市,東區,公園里,22,1,588,12,600,1014,3,1,3,0,1,0,59.17
新竹市,東區,公園里,23,1,764,10,774,1162,3,1,3,0,1,0,66.61
新竹市,東區,建華里,24,1,726,16,742,1141,3,1,3,0,1,0,65.03
新竹市,東區,建華里,25,1,573,11,584,920,3,1,3,0,1,0,63.48
新竹市,東區,東山里,26,1,589,6,595,933,3,1,3,0,1,0,63.77
新竹市,東區,東山里,27,1,666,2,668,988,3,1,3,0,1,0,67.61
新竹市,東區,東山里,28,1,606,4,610,974,3,1,3,0,1,0,62.63
新竹市,東區,綠水里,29,1,771,13,784,1207,3,1,3,0,1,0,64.95
新竹市,東區,綠水里,30,1,872,14,886,1385,3,1,3,0,1,0,63.97
新竹市,東區,綠水里,31,1,900,9,909,1377,3,1,3,0,1,0,66.01
新竹市,東區,光復里,32,1,596,12,608,943,3,1,3,0,1,0,64.48
新竹市,東區,光復里,33,1,524,6,530,843,3,1,3,0,1,0,62.87
新竹市,東區,東勢里,34,1,656,23,679,1037,3,1,3,0,1,0,65.48
新竹市,東區,前溪里,35,1,870,9,879,1400,3,1,3,0,1,0,62.79
新竹市,東區,前溪里,36,1,592,12,604,931,3,1,3,0,1,0,64.88
新竹市,東區,水源里,37,1,885,8,893,1407,3,1,3,0,1,0,63.47
新竹市,東區,水源里,38,1,974,18,992,1535,3,1,3,0,1,0,64.63
新竹市,東區,千甲里,39,1,562,8,570,824,3,1,3,0,1,0,69.17
新竹市,東區,千甲里,40,1,594,14,608,837,3,1,3,0,1,0,72.64
新竹市,東區,豐功里,41,1,795,9,804,1279,3,1,3,0,1,0,62.86
新竹市,東區,豐功里,42,1,744,10,754,1187,3,1,3,0,1,0,63.52
新竹市,東區,偉功里,43,1,174,2,176,335,3,1,3,0,1,0,52.54
新竹市,東區,武功里,44,1,1075,16,1091,1520,3,1,3,0,1,0,71.78
新竹市,東區,軍功里,45,1,947,15,962,1487,3,1,3,0,1,0,64.69
新竹市,東區,軍功里,46,1,1057,13,1070,1615,3,1,3,0,1,0,66.25
新竹市,東區,立功里,47,1,511,8,519,763,3,1,3,0,1,0,68.02
新竹市,東區,建功里,48,1,860,10,870,1290,3,1,3,0,1,0,67.44
新竹市,東區,建功里,49,1,562,7,569,797,3,1,3,0,1,0,71.39
新竹市,東區,建功里,50,1,564,7,571,816,3,1,3,0,1,0,69.98
新竹市,東區,光明里,51,1,737,7,744,1176,3,1,3,0,1,0,63.27
新竹市,東區,光明里,52,1,333,1,334,508,3,1,3,0,1,0,65.75
新竹市,東區,光明里,53,1,853,12,865,1371,3,1,3,0,1,0,63.09
新竹市,東區,龍山里,54,1,598,5,603,888,3,1,3,0,1,0,67.91
新竹市,東區,龍山里,55,1,526,7,533,843,3,1,3,0,1,0,63.23
新竹市,東區,龍山里,56,1,698,10,708,1001,3,1,3,0,1,0,70.73
新竹市,東區,科園里,57,1,970,14,984,1511,3,1,3,0,1,0,65.12
新竹市,東區,科園里,58,1,1128,18,1146,1762,3,1,3,0,1,0,65.04
新竹市,東區,科園里,59,1,970,8,978,1408,3,1,3,0,1,0,69.46
新竹市,東區,埔頂里,60,1,748,12,760,1167,3,1,3,0,1,0,65.12
新竹市,東區,埔頂里,61,1,622,9,631,995,3,1,3,0,1,0,63.42
新竹市,東區,新莊里,62,1,894,30,924,1378,3,1,3,0,1,0,67.05
新竹市,東區,新莊里,63,1,875,22,897,1388,3,1,3,0,1,0,64.63
新竹市,東區,新莊里,64,1,716,10,726,1085,3,1,3,0,1,0,66.91
新竹市,東區,關東里,65,1,651,16,667,1077,3,1,3,0,1,0,61.93
新竹市,東區,關東里,66,1,749,16,765,1179,3,1,3,0,1,0,64.89
新竹市,東區,關東里,67,1,784,11,795,1274,3,1,3,0,1,0,62.40
新竹市,東區,金山里,68,1,863,13,876,1490,3,1,3,0,1,0,58.79
新竹市,東區,金山里,69,1,679,16,695,995,3,1,3,0,1,0,69.85
新竹市,東區,金山里,70,1,819,9,828,1333,3,1,3,0,1,0,62.12
新竹市,東區,仙水里,71,1,1001,9,1010,1551,3,1,3,0,1,0,65.12
新竹市,東區,仙水里,72,1,904,7,911,1417,3,1,3,0,1,0,64.29
新竹市,東區,仙宮里,73,1,500,4,504,808,3,1,3,0,1,0,62.38
新竹市,東區,關帝里,74,1,346,7,353,590,3,1,3,0,1,0,59.83
新竹市,東區,南門里,75,1,426,1,427,654,3,1,3,0,1,0,65.29
新竹市,東區,南市里,76,1,599,4,603,904,3,1,3,0,1,0,66.70
新竹市,東區,福德里,77,1,765,9,774,1223,3,1,3,0,1,0,63.29
新竹市,東區,振興里,78,1,759,12,771,1215,3,1,3,0,1,0,63.46
新竹市,東區,振興里,79,1,954,7,961,1605,3,1,3,0,1,0,59.88
新竹市,東區,振興里,80,1,836,11,847,1464,3,1,3,0,1,0,57.86
新竹市,東區,新興里,81,1,616,8,624,960,3,1,3,0,1,0,65.00
新竹市,東區,新興里,82,1,710,8,718,1099,3,1,3,0,1,0,65.33
新竹市,東區,新興里,83,1,630,11,641,956,3,1,3,0,1,0,67.05
新竹市,東區,寺前里,84,1,503,13,516,820,3,1,3,0,1,0,62.93
新竹市,東區,竹蓮里,85,1,538,5,543,809,3,1,3,0,1,0,67.12
新竹市,東區,下竹里,86,1,763,19,782,1185,3,1,3,0,1,0,65.99
新竹市,東區,頂竹里,87,1,577,17,594,959,3,1,3,0,1,0,61.94
新竹市,東區,頂竹里,88,1,610,9,619,977,3,1,3,0,1,0,63.36
新竹市,東區,頂竹里,89,1,648,15,663,1040,3,1,3,0,1,0,63.75
新竹市,東區,南大里,90,1,381,3,384,662,3,1,3,0,1,0,58.01
新竹市,東區,南大里,91,1,562,8,570,868,3,1,3,0,1,0,65.67
新竹市,東區,新光里,92,1,385,6,391,560,3,1,3,0,1,0,69.82
新竹市,東區,新光里,93,1,858,22,880,1403,3,1,3,0,1,0,62.72
新竹市,東區,新光里,94,1,700,11,711,1125,3,1,3,0,1,0,63.20
新竹市,東區,光鎮里,95,1,826,19,845,1401,3,1,3,0,1,0,60.31
新竹市,東區,光鎮里,96,1,919,14,933,1464,3,1,3,0,1,0,63.73
新竹市,東區,高峰里,97,1,1037,12,1049,1580,3,1,3,0,1,0,66.39
新竹市,東區,高峰里,98,1,699,14,713,1177,3,1,3,0,1,0,60.58
新竹市,東區,高峰里,99,1,1074,10,1084,1747,3,1,3,0,1,0,62.05
新竹市,東區,湖濱里,100,1,1042,12,1054,1593,3,1,3,0,1,0,66.16
新竹市,東區,湖濱里,101,1,690,14,704,1088,3,1,3,0,1,0,64.71
新竹市,東區,柴橋里,102,1,1177,22,1199,1850,3,1,3,0,1,0,64.81
新竹市,東區,柴橋里,103,1,703,14,717,1155,3,1,3,0,1,0,62.08
新竹市,東區,明湖里,104,1,537,8,545,955,3,1,3,0,1,0,57.07
新竹市,東區,明湖里,105,1,1042,15,1057,1930,3,1,3,0,1,0,54.77
新竹市,北區,西門里,106,1,326,1,327,500,3,1,3,0,1,0,65.40
新竹市,北區,潛園里,107,1,563,4,567,838,3,1,3,0,1,0,67.66
新竹市,北區,中央里,108,1,356,4,360,525,3,1,3,0,1,0,68.57
新竹市,北區,石坊里,109,1,327,3,330,537,3,1,3,0,1,0,61.45
新竹市,北區,仁德里,110,1,478,4,482,751,3,1,3,0,1,0,64.18
新竹市,北區,崇禮里,111,1,767,13,780,1130,3,1,3,0,1,0,69.03
新竹市,北區,興南里,112,1,831,10,841,1265,3,1,3,0,1,0,66.48
新竹市,北區,育英里,113,1,533,5,538,836,3,1,3,0,1,0,64.35
新竹市,北區,育英里,114,1,687,9,696,1119,3,1,3,0,1,0,62.20
新竹市,北區,育英里,115,1,955,13,968,1500,3,1,3,0,1,0,64.53
新竹市,北區,台溪里,116,1,704,8,712,1163,3,1,3,0,1,0,61.22
新竹市,北區,曲溪里,117,1,533,18,551,832,3,1,3,0,1,0,66.23
新竹市,北區,曲溪里,118,1,1069,27,1096,1744,3,1,3,0,1,0,62.84
新竹市,北區,曲溪里,119,1,504,22,526,753,3,1,3,0,1,0,69.85
新竹市,北區,曲溪里,120,1,851,7,858,1328,3,1,3,0,1,0,64.61
新竹市,北區,西雅里,121,1,836,9,845,1293,3,1,3,0,1,0,65.35
新竹市,北區,西雅里,122,1,770,11,781,1131,3,1,3,0,1,0,69.05
新竹市,北區,客雅里,123,1,582,7,589,884,3,1,3,0,1,0,66.63
新竹市,北區,客雅里,124,1,611,9,620,961,3,1,3,0,1,0,64.52
新竹市,北區,客雅里,125,1,764,9,773,1249,3,1,3,0,1,0,61.89
新竹市,北區,南勢里,126,1,625,11,636,913,3,1,3,0,1,0,69.66
新竹市,北區,南勢里,127,1,863,8,871,1314,3,1,3,0,1,0,66.29
新竹市,北區,南勢里,128,1,629,16,645,960,3,1,3,0,1,0,67.19
新竹市,北區,大鵬里,129,1,554,9,563,833,3,1,3,0,1,0,67.59
新竹市,北區,大鵬里,130,1,505,11,516,680,3,1,3,0,1,0,75.88
新竹市,北區,大同里,131,1,501,4,505,796,3,1,3,0,1,0,63.44
新竹市,北區,中山里,132,1,436,3,439,669,3,1,3,0,1,0,65.62
新竹市,北區,中興里,133,1,345,5,350,598,3,1,3,0,1,0,58.53
新竹市,北區,新民里,134,1,845,19,864,1323,3,1,3,0,1,0,65.31
新竹市,北區,長和里,135,1,767,12,779,1183,3,1,3,0,1,0,65.85
新竹市,北區,北門里,136,1,567,4,571,899,3,1,3,0,1,0,63.52
新竹市,北區,民富里,137,1,742,13,755,1173,3,1,3,0,1,0,64.36
新竹市,北區,民富里,138,1,832,11,843,1363,3,1,3,0,1,0,61.85
新竹市,北區,民富里,139,1,787,10,797,1348,3,1,3,0,1,0,59.12
新竹市,北區,磐石里,140,1,792,10,802,1291,3,1,3,0,1,0,62.12
新竹市,北區,磐石里,141,1,868,19,887,1382,3,1,3,0,1,0,64.18
新竹市,北區,磐石里,142,1,763,6,769,1153,3,1,3,0,1,0,66.70
新竹市,北區,新雅里,143,1,954,10,964,1508,3,1,3,0,1,0,63.93
新竹市,北區,新雅里,144,1,776,15,791,1235,3,1,3,0,1,0,64.05
新竹市,北區,新雅里,145,1,556,9,565,867,3,1,3,0,1,0,65.17
新竹市,北區,文雅里,146,1,950,16,966,1441,3,1,3,0,1,0,67.04
新竹市,北區,文雅里,147,1,1077,14,1091,1689,3,1,3,0,1,0,64.59
新竹市,北區,水田里,148,1,794,10,804,1238,3,1,3,0,1,0,64.94
新竹市,北區,水田里,149,1,819,11,830,1276,3,1,3,0,1,0,65.05
新竹市,北區,光田里,150,1,601,10,611,951,3,1,3,0,1,0,64.25
新竹市,北區,光田里,151,1,689,11,700,1084,3,1,3,0,1,0,64.58
新竹市,北區,光華里,152,1,650,12,662,1238,3,1,3,0,1,0,53.47
新竹市,北區,光華里,153,1,956,16,972,1539,3,1,3,0,1,0,63.16
新竹市,北區,金華里,154,1,974,16,990,1634,3,1,3,0,1,0,60.59
新竹市,北區,金華里,155,1,1125,12,1137,1763,3,1,3,0,1,0,64.49
新竹市,北區,湳雅里,156,1,641,10,651,967,3,1,3,0,1,0,67.32
新竹市,北區,湳雅里,157,1,785,12,797,1289,3,1,3,0,1,0,61.83
新竹市,北區,金雅里,158,1,846,14,860,1246,3,1,3,0,1,0,69.02
新竹市,北區,湳中里,159,1,898,5,903,1400,3,1,3,0,1,0,64.50
新竹市,北區,湳中里,160,1,678,6,684,1101,3,1,3,0,1,0,62.13
新竹市,北區,湳中里,161,1,647,11,658,1037,3,1,3,0,1,0,63.45
新竹市,北區,舊社里,162,1,882,12,894,1433,3,1,3,0,1,0,62.39
新竹市,北區,舊社里,163,1,762,8,770,1319,3,1,3,0,1,0,58.38
新竹市,北區,舊社里,164,1,945,10,955,1478,3,1,3,0,1,0,64.61
新竹市,北區,金竹里,165,1,831,10,841,1333,3,1,3,0,1,0,63.09
新竹市,北區,金竹里,166,1,856,19,875,1390,3,1,3,0,1,0,62.95
新竹市,北區,金竹里,167,1,727,8,735,1204,3,1,3,0,1,0,61.05
新竹市,北區,武陵里,168,1,822,7,829,1207,3,1,3,0,1,0,68.68
新竹市,北區,福林里,169,1,821,12,833,1269,3,1,3,0,1,0,65.64
新竹市,北區,福林里,170,1,1007,16,1023,1582,3,1,3,0,1,0,64.66
新竹市,北區,境福里,171,1,642,7,649,1018,3,1,3,0,1,0,63.75
新竹市,北區,境福里,172,1,595,8,603,979,3,1,3,0,1,0,61.59
新竹市,北區,境福里,173,1,960,20,980,1509,3,1,3,0,1,0,64.94
新竹市,北區,士林里,174,1,807,12,819,1222,3,1,3,0,1,0,67.02
新竹市,北區,士林里,175,1,537,10,547,786,3,1,3,0,1,0,69.59
新竹市,北區,士林里,176,1,616,12,628,873,3,1,3,0,1,0,71.94
新竹市,北區,古賢里,177,1,506,12,518,855,3,1,3,0,1,0,60.58
新竹市,北區,南寮里,178,1,606,9,615,1008,3,1,3,0,1,0,61.01
新竹市,北區,南寮里,179,1,581,14,595,970,3,1,3,0,1,0,61.34
新竹市,北區,南寮里,180,1,897,11,908,1578,3,1,3,0,1,0,57.54
新竹市,北區,康樂里,181,1,1049,25,1074,1690,3,1,3,0,1,0,63.55
新竹市,北區,中寮里,182,1,826,9,835,1318,3,1,3,0,1,0,63.35
新竹市,北區,海濱里,183,1,843,14,857,1400,3,1,3,0,1,0,61.21
新竹市,北區,港北里,184,1,707,19,726,1122,3,1,3,0,1,0,64.71
新竹市,北區,舊港里,185,1,313,3,316,501,3,1,3,0,1,0,63.07
新竹市,香山區,頂埔里,186,1,1039,8,1047,1640,3,1,3,0,1,0,63.84
新竹市,香山區,頂埔里,187,1,783,13,796,1293,3,1,3,0,1,0,61.56
新竹市,香山區,頂福里,188,1,607,10,617,965,3,1,3,0,1,0,63.94
新竹市,香山區,頂福里,189,1,919,12,931,1521,3,1,3,0,1,0,61.21
新竹市,香山區,中埔里,190,1,731,10,741,1146,3,1,3,0,1,0,64.66
新竹市,香山區,中埔里,191,1,661,10,671,1070,3,1,3,0,1,0,62.71
新竹市,香山區,牛埔里,192,1,521,5,526,871,3,1,3,0,1,0,60.39
新竹市,香山區,牛埔里,193,1,751,9,760,1315,3,1,3,0,1,0,57.79
新竹市,香山區,埔前里,194,1,750,3,753,1169,3,1,3,0,1,0,64.41
新竹市,香山區,埔前里,195,1,712,10,722,1107,3,1,3,0,1,0,65.22
新竹市,香山區,樹下里,196,1,578,5,583,958,3,1,3,0,1,0,60.86
新竹市,香山區,樹下里,197,1,475,14,489,788,3,1,3,0,1,0,62.06
新竹市,香山區,浸水里,198,1,957,22,979,1525,3,1,3,0,1,0,64.20
新竹市,香山區,虎林里,199,1,758,14,772,1147,3,1,3,0,1,0,67.31
新竹市,香山區,虎林里,200,1,508,8,516,767,3,1,3,0,1,0,67.28
新竹市,香山區,虎山里,201,1,797,12,809,1262,3,1,3,0,1,0,64.10
新竹市,香山區,虎山里,202,1,767,12,779,1417,3,1,3,0,1,0,54.98
新竹市,香山區,虎山里,203,1,1047,18,1065,1754,3,1,3,0,1,0,60.72
新竹市,香山區,港南里,204,1,584,8,592,888,3,1,3,0,1,0,66.67
新竹市,香山區,港南里,205,1,498,15,513,802,3,1,3,0,1,0,63.97
新竹市,香山區,東香里,206,1,665,11,676,1142,3,1,3,0,1,0,59.19
新竹市,香山區,東香里,207,1,479,8,487,725,3,1,3,0,1,0,67.17
新竹市,香山區,香村里,208,1,491,16,507,798,3,1,3,0,1,0,63.53
新竹市,香山區,香村里,209,1,683,13,696,1122,3,1,3,0,1,0,62.03
新竹市,香山區,香山里,210,1,957,12,969,1527,3,1,3,0,1,0,63.46
新竹市,香山區,香山里,211,1,729,6,735,1194,3,1,3,0,1,0,61.56
新竹市,香山區,大庄里,212,1,671,9,680,961,3,1,3,0,1,0,70.76
新竹市,香山區,大庄里,213,1,616,9,625,963,3,1,3,0,1,0,64.90
新竹市,香山區,美山里,214,1,585,8,593,960,3,1,3,0,1,0,61.77
新竹市,香山區,朝山里,215,1,1101,18,1119,1687,3,1,3,0,1,0,66.33
新竹市,香山區,海山里,216,1,667,10,677,941,3,1,3,0,1,0,71.94
新竹市,香山區,海山里,217,1,463,12,475,779,3,1,3,0,1,0,60.98
新竹市,香山區,鹽水里,218,1,740,16,756,1131,3,1,3,0,1,0,66.84
新竹市,香山區,內湖里,219,1,1197,21,1218,1920,3,1,3,0,1,0,63.44
新竹市,香山區,內湖里,220,1,750,9,759,1350,3,1,3,0,1,0,56.22
新竹市,香山區,南港里,221,1,478,8,486,755,3,1,3,0,1,0,64.37
新竹市,香山區,中隘里,222,1,761,15,776,1250,3,1,3,0,1,0,62.08
新竹市,香山區,南隘里,223,1,381,8,389,623,3,1,3,0,1,0,62.44
新竹市,香山區,大湖里,224,1,471,8,479,680,3,1,3,0,1,0,70.44
新竹市,香山區,茄苳里,225,1,467,10,477,722,3,1,3,0,1,0,66.07
臺中市,中區,中山里、建國里,1,1,595,12,607,926,3,1,3,0,1,0,65.55
臺中市,中區,南京里,2,1,729,10,739,1051,3,1,3,0,1,0,70.31
臺中市,中區,繼光里,3,1,710,8,718,1116,3,1,3,0,1,0,64.34
臺中市,中區,自由里、繼榮里,4,1,862,15,877,1409,3,1,3,0,1,0,62.24
臺中市,中區,重慶里,5,1,557,8,565,868,3,1,3,0,1,0,65.09
臺中市,中區,錦上里、錦添里,6,1,839,14,853,1271,3,1,3,0,1,0,67.11
臺中市,中區,錦花里,7,1,703,11,714,1137,3,1,3,0,1,0,62.80
臺中市,中區,大墩里,8,1,920,16,936,1406,3,1,3,0,1,0,66.57
臺中市,中區,中墩里、柳堤里,9,1,706,12,718,1119,3,1,3,0,1,0,64.16
臺中市,中區,柳岸里、正音里,10,1,721,14,735,1123,3,1,3,0,1,0,65.45
臺中市,中區,柳原里、東墩里,11,1,643,15,658,1028,3,1,3,0,1,0,64.01
臺中市,中區,光音里、中音里,12,1,774,16,790,1248,3,1,3,0,1,0,63.30
臺中市,中區,博松里、愛松里、青松里,13,1,776,13,789,1163,3,1,3,0,1,0,67.84
臺中市,中區,中政里、中榮里、中功里,14,1,701,10,711,1109,3,1,3,0,1,0,64.11
臺中市,東區,新庄里,15,1,710,15,725,1053,3,1,3,0,1,0,68.85
臺中市,東區,立德里,16,1,405,13,418,651,3,1,3,0,1,0,64.21
臺中市,東區,朱文里,17,1,522,5,527,838,3,1,3,0,1,0,62.89
臺中市,東區,翰第里,18,1,617,7,624,897,3,1,3,0,1,0,69.57
臺中市,東區,振興里、曙峰里,19,1,873,6,879,1298,3,1,3,0,1,0,67.72
臺中市,東區,振興里、曙峰里,20,1,728,16,744,1087,3,1,3,0,1,0,68.45
臺中市,東區,頂峰里,21,1,841,16,857,1286,3,1,3,0,1,0,66.64
臺中市,東區,忠孝里,22,1,634,6,640,972,3,1,3,0,1,0,65.84
臺中市,東區,東橋里,23,1,816,13,829,1182,3,1,3,0,1,0,70.14
臺中市,東區,東橋里,24,1,864,12,876,1269,3,1,3,0,1,0,69.03
臺中市,東區,東橋里,25,1,855,13,868,1298,3,1,3,0,1,0,66.87
臺中市,東區,東興里,26,1,688,7,695,975,3,1,3,0,1,0,71.28
臺中市,東區,東興里,27,1,663,11,674,964,3,1,3,0,1,0,69.92
臺中市,東區,樂業里,28,1,512,12,524,818,3,1,3,0,1,0,64.06
臺中市,東區,泉源里,29,1,535,6,541,828,3,1,3,0,1,0,65.34
臺中市,東區,文化里,30,1,741,2,743,1102,3,1,3,0,1,0,67.42
臺中市,東區,干城里,31,1,429,7,436,644,3,1,3,0,1,0,67.70
臺中市,東區,祖聖里,32,1,665,10,675,996,3,1,3,0,1,0,67.77
臺中市,東區,旱溪里,33,1,974,9,983,1417,3,1,3,0,1,0,69.37
臺中市,東區,樂成里,34,1,897,23,920,1354,3,1,3,0,1,0,67.95
臺中市,東區,東門里,35,1,883,22,905,1332,3,1,3,0,1,0,67.94
臺中市,東區,東門里,36,1,835,17,852,1219,3,1,3,0,1,0,69.89
臺中市,東區,東門里,37,1,914,15,929,1303,3,1,3,0,1,0,71.30
臺中市,東區,東門里,38,1,726,6,732,1096,3,1,3,0,1,0,66.79
臺中市,東區,十甲里,39,1,740,18,758,1133,3,1,3,0,1,0,66.90
臺中市,東區,十甲里,40,1,883,5,888,1319,3,1,3,0,1,0,67.32
臺中市,東區,十甲里,41,1,748,13,761,1195,3,1,3,0,1,0,63.68
臺中市,東區,十甲里,42,1,743,15,758,1184,3,1,3,0,1,0,64.02
臺中市,東區,十甲里,43,1,748,13,761,1187,3,1,3,0,1,0,64.11
臺中市,東區,東南里,44,1,840,12,852,1300,3,1,3,0,1,0,65.54
臺中市,東區,東南里,45,1,867,13,880,1329,3,1,3,0,1,0,66.22
臺中市,東區,東南里,46,1,526,11,537,771,3,1,3,0,1,0,69.65
臺中市,東區,東勢里,47,1,489,7,496,751,3,1,3,0,1,0,66.05
臺中市,東區,東勢里,48,1,473,11,484,768,3,1,3,0,1,0,63.02
臺中市,東區,合作里,49,1,660,4,664,928,3,1,3,0,1,0,71.55
臺中市,東區,合作里,50,1,662,7,669,992,3,1,3,0,1,0,67.44
臺中市,東區,東明里,51,1,860,15,875,1335,3,1,3,0,1,0,65.54
臺中市,東區,成功里,52,1,490,7,497,802,3,1,3,0,1,0,61.97
臺中市,東區,尚武里、練武里,53,1,869,22,891,1346,3,1,3,0,1,0,66.20
臺中市,東區,富台里,54,1,494,7,501,732,3,1,3,0,1,0,68.44
臺中市,東區,富台里,55,1,494,10,504,743,3,1,3,0,1,0,67.83
臺中市,東區,富仁里,56,1,925,19,944,1418,3,1,3,0,1,0,66.57
臺中市,東區,東信里,57,1,904,15,919,1356,3,1,3,0,1,0,67.77
臺中市,東區,東信里,58,1,868,9,877,1228,3,1,3,0,1,0,71.42
臺中市,東區,東信里,59,1,842,18,860,1281,3,1,3,0,1,0,67.14
臺中市,東區,東信里,60,1,660,10,670,977,3,1,3,0,1,0,68.58
臺中市,南區,南興里,61,1,448,2,450,674,3,1,3,0,1,0,66.77
臺中市,南區,正義里,62,1,459,4,463,710,3,1,3,0,1,0,65.21
臺中市,南區,民主里,63,1,555,8,563,790,3,1,3,0,1,0,71.27
臺中市,南區,復興里,64,1,1151,16,1167,1711,3,1,3,0,1,0,68.21
臺中市,南區,萬安里,65,1,634,17,651,968,3,1,3,0,1,0,67.25
臺中市,南區,信義里,66,1,745,13,758,1064,3,1,3,0,1,0,71.24
臺中市,南區,城隍里,67,1,920,17,937,1392,3,1,3,0,1,0,67.31
臺中市,南區,頂南里、中南里,68,1,673,8,681,1026,3,1,3,0,1,0,66.37
臺中市,南區,國光里,69,1,1224,18,1242,1887,3,1,3,0,1,0,65.82
臺中市,南區,國光里,70,1,1057,17,1074,1531,3,1,3,0,1,0,70.15
臺中市,南區,南門里,71,1,1022,25,1047,1582,3,1,3,0,1,0,66.18
臺中市,南區,南門里,72,1,1034,15,1049,1575,3,1,3,0,1,0,66.60
臺中市,南區,德義里,73,1,730,12,742,1111,3,1,3,0,1,0,66.79
臺中市,南區,德義里,74,1,895,11,906,1331,3,1,3,0,1,0,68.07
臺中市,南區,積善里,75,1,744,14,758,1187,3,1,3,0,1,0,63.86
臺中市,南區,積善里,76,1,1001,20,1021,1511,3,1,3,0,1,0,67.57
臺中市,南區,江川里,77,1,1241,17,1258,1814,3,1,3,0,1,0,69.35
臺中市,南區,新榮里,78,1,897,13,910,1534,3,1,3,0,1,0,59.32
臺中市,南區,新榮里,79,1,763,13,776,1410,3,1,3,0,1,0,55.04
臺中市,南區,福興里,80,1,845,15,860,1268,3,1,3,0,1,0,67.82
臺中市,南區,福興里,81,1,981,16,997,1479,3,1,3,0,1,0,67.41
臺中市,南區,福平里,82,1,1105,16,1121,1768,3,1,3,0,1,0,63.40
臺中市,南區,福平里,83,1,1125,23,1148,1774,3,1,3,0,1,0,64.71
臺中市,南區,福平里,84,1,1121,18,1139,1800,3,1,3,0,1,0,63.28
臺中市,南區,福平里,85,1,1133,26,1159,1819,3,1,3,0,1,0,63.72
臺中市,南區,和平里,86,1,1283,16,1299,2095,3,1,3,0,1,0,62.00
臺中市,南區,和平里,87,1,1081,11,1092,1811,3,1,3,0,1,0,60.30
臺中市,南區,和平里,88,1,915,22,937,1399,3,1,3,0,1,0,66.98
臺中市,南區,和平里,89,1,914,16,930,1404,3,1,3,0,1,0,66.24
臺中市,南區,和平里,90,1,1316,24,1340,2063,3,1,3,0,1,0,64.95
臺中市,南區,永興里,91,1,925,10,935,1419,3,1,3,0,1,0,65.89
臺中市,南區,永興里,92,1,993,17,1010,1547,3,1,3,0,1,0,65.29
臺中市,南區,永興里,93,1,894,15,909,1508,3,1,3,0,1,0,60.28
臺中市,南區,永興里,94,1,764,11,775,1253,3,1,3,0,1,0,61.85
臺中市,南區,永興里,95,1,943,14,957,1479,3,1,3,0,1,0,64.71
臺中市,南區,樹義里,96,1,1002,15,1017,1576,3,1,3,0,1,0,64.53
臺中市,南區,樹義里,97,1,1062,19,1081,1655,3,1,3,0,1,0,65.32
臺中市,南區,樹義里,98,1,1031,20,1051,1663,3,1,3,0,1,0,63.20
臺中市,南區,樹義里,99,1,906,10,916,1528,3,1,3,0,1,0,59.95
臺中市,南區,樹義里,100,1,1080,28,1108,1738,3,1,3,0,1,0,63.75
臺中市,南區,樹德里,101,1,1159,20,1179,1952,3,1,3,0,1,0,60.40
臺中市,南區,樹德里,102,1,1033,22,1055,1694,3,1,3,0,1,0,62.28
臺中市,南區,西川里,103,1,948,13,961,1361,3,1,3,0,1,0,70.61
臺中市,南區,西川里,104,1,1218,22,1240,1891,3,1,3,0,1,0,65.57
臺中市,南區,西川里,105,1,925,13,938,1350,3,1,3,0,1,0,69.48
臺中市,南區,西川里,106,1,957,13,970,1442,3,1,3,0,1,0,67.27
臺中市,西區,福壽里、民生里,107,1,973,13,986,1425,3,1,3,0,1,0,69.19
臺中市,西區,光明里,108,1,439,6,445,627,3,1,3,0,1,0,70.97
臺中市,西區,利民里,109,1,617,9,626,929,3,1,3,0,1,0,67.38
臺中市,西區,利民里,110,1,671,10,681,1111,3,1,3,0,1,0,61.30
臺中市,西區,平和里,111,1,966,9,975,1542,3,1,3,0,1,0,63.23
臺中市,西區,公民里,112,1,964,12,976,1430,3,1,3,0,1,0,68.25
臺中市,西區,公民里,113,1,842,19,861,1257,3,1,3,0,1,0,68.50
臺中市,西區,公民里,114,1,866,17,883,1318,3,1,3,0,1,0,67.00
臺中市,西區,中民里,115,1,787,11,798,1096,3,1,3,0,1,0,72.81
臺中市,西區,中民里,116,1,565,7,572,809,3,1,3,0,1,0,70.70
臺中市,西區,藍興里,117,1,732,19,751,1056,3,1,3,0,1,0,71.12
臺中市,西區,藍興里,118,1,911,9,920,1325,3,1,3,0,1,0,69.43
臺中市,西區,公舘里,119,1,955,18,973,1413,3,1,3,0,1,0,68.86
臺中市,西區,公舘里,120,1,1158,18,1176,1665,3,1,3,0,1,0,70.63
臺中市,西區,公舘里,121,1,886,16,902,1458,3,1,3,0,1,0,61.87
臺中市,西區,元龍里、平龍里,122,1,508,11,519,772,3,1,3,0,1,0,67.23
臺中市,西區,和龍里,123,1,1022,12,1034,1606,3,1,3,0,1,0,64.38
臺中市,西區,三民里,124,1,778,8,786,1201,3,1,3,0,1,0,65.45
臺中市,西區,平民里,125,1,752,7,759,1136,3,1,3,0,1,0,66.81
臺中市,西區,東昇里,126,1,883,9,892,1322,3,1,3,0,1,0,67.47
臺中市,西區,廣民里,127,1,742,9,751,1143,3,1,3,0,1,0,65.70
臺中市,西區,民龍里,128,1,665,16,681,1073,3,1,3,0,1,0,63.47
臺中市,西區,民龍里,129,1,668,11,679,979,3,1,3,0,1,0,69.36
臺中市,西區,福龍里、後龍里,130,1,774,13,787,1209,3,1,3,0,1,0,65.10
臺中市,西區,靖龍里,131,1,560,5,565,918,3,1,3,0,1,0,61.55
臺中市,西區,靖龍里,132,1,595,6,601,911,3,1,3,0,1,0,65.97
臺中市,西區,雲龍里,133,1,626,5,631,943,3,1,3,0,1,0,66.91
臺中市,西區,雲龍里,134,1,633,8,641,966,3,1,3,0,1,0,66.36
臺中市,西區,永龍里,135,1,671,6,677,984,3,1,3,0,1,0,68.80
臺中市,西區,安龍里,136,1,798,13,811,1187,3,1,3,0,1,0,68.32
臺中市,西區,安龍里,137,1,620,15,635,995,3,1,3,0,1,0,63.82
臺中市,西區,吉龍里,138,1,861,10,871,1234,3,1,3,0,1,0,70.58
臺中市,西區,吉龍里,139,1,999,10,1009,1485,3,1,3,0,1,0,67.95
臺中市,西區,吉龍里,140,1,1013,18,1031,1501,3,1,3,0,1,0,68.69
臺中市,西區,吉龍里,141,1,907,13,920,1326,3,1,3,0,1,0,69.38
臺中市,西區,昇平里,142,1,846,10,856,1227,3,1,3,0,1,0,69.76
臺中市,西區,昇平里,143,1,796,10,806,1236,3,1,3,0,1,0,65.21
臺中市,西區,昇平里,144,1,843,14,857,1344,3,1,3,0,1,0,63.76
臺中市,西區,忠明里,145,1,889,9,898,1398,3,1,3,0,1,0,64.23
臺中市,西區,忠明里,146,1,915,13,928,1381,3,1,3,0,1,0,67.20
臺中市,西區,忠明里,147,1,1020,12,1032,1563,3,1,3,0,1,0,66.03
臺中市,西區,忠誠里,148,1,785,12,797,1265,3,1,3,0,1,0,63.00
臺中市,西區,忠誠里,149,1,902,11,913,1373,3,1,3,0,1,0,66.50
臺中市,西區,忠誠里,150,1,705,9,714,1064,3,1,3,0,1,0,67.11
臺中市,西區,忠誠里,151,1,789,10,799,1177,3,1,3,0,1,0,67.88
臺中市,西區,公正里,152,1,1076,19,1095,1620,3,1,3,0,1,0,67.59
臺中市,西區,公正里,153,1,887,5,892,1332,3,1,3,0,1,0,66.97
臺中市,西區,公正里,154,1,728,12,740,1192,3,1,3,0,1,0,62.08
臺中市,西區,公正里,155,1,631,10,641,960,3,1,3,0,1,0,66.77
臺中市,西區,公正里,156,1,867,8,875,1383,3,1,3,0,1,0,63.27
臺中市,西區,公正里,157,1,1038,9,1047,1559,3,1,3,0,1,0,67.16
臺中市,西區,公正里,158,1,1017,8,1025,1517,3,1,3,0,1,0,67.57
臺中市,西區,公正里,159,1,731,8,739,1146,3,1,3,0,1,0,64.49
臺中市,西區,公益里,160,1,885,12,897,1267,3,1,3,0,1,0,70.80
臺中市,西區,公益里,161,1,908,19,927,1314,3,1,3,0,1,0,70.55
臺中市,西區,中興里,162,1,950,10,960,1420,3,1,3,0,1,0,67.61
臺中市,西區,中興里,163,1,1136,23,1159,1668,3,1,3,0,1,0,69.48
臺中市,西區,土庫里,164,1,913,11,924,1349,3,1,3,0,1,0,68.50
臺中市,西區,土庫里,165,1,1047,16,1063,1605,3,1,3,0,1,0,66.23
臺中市,西區,土庫里,166,1,839,10,849,1266,3,1,3,0,1,0,67.06
臺中市,西區,土庫里,167,1,950,17,967,1449,3,1,3,0,1,0,66.74
臺中市,西區,土庫里,168,1,951,21,972,1479,3,1,3,0,1,0,65.72
臺中市,北區,遠志里、光華里、南靖里,169,1,609,10,619,926,3,1,3,0,1,0,66.85
臺中市,北區,高風里、高平里,170,1,547,9,556,841,3,1,3,0,1,0,66.11
臺中市,北區,文正里、大安里、長安里,171,1,598,9,607,923,3,1,3,0,1,0,65.76
臺中市,北區,光興里、光榮里、光正里,172,1,534,11,545,856,3,1,3,0,1,0,63.67
臺中市,北區,光大里,173,1,569,12,581,858,3,1,3,0,1,0,67.72
臺中市,北區,光大里,174,1,615,10,625,969,3,1,3,0,1,0,64.50
臺中市,北區,文莊里,175,1,673,12,685,1004,3,1,3,0,1,0,68.23
臺中市,北區,文莊里,176,1,638,6,644,1020,3,1,3,0,1,0,63.14
臺中市,北區,湖北里,177,1,560,7,567,931,3,1,3,0,1,0,60.90
臺中市,北區,中湖里、平等里,178,1,784,8,792,1281,3,1,3,0,1,0,61.83
臺中市,北區,錦和里、湖南里,179,1,789,9,798,1221,3,1,3,0,1,0,65.36
臺中市,北區,五常里,180,1,1062,12,1074,1678,3,1,3,0,1,0,64.00
臺中市,北區,仁和里、香蕉里,181,1,493,6,499,721,3,1,3,0,1,0,69.21
臺中市,北區,新興里,182,1,765,7,772,1187,3,1,3,0,1,0,65.04
臺中市,北區,武順里,183,1,510,5,515,824,3,1,3,0,1,0,62.50
臺中市,北區,新北里,184,1,852,19,871,1346,3,1,3,0,1,0,64.71
臺中市,北區,新北里,185,1,536,6,542,923,3,1,3,0,1,0,58.72
臺中市,北區,樂英里,186,1,724,11,735,1036,3,1,3,0,1,0,70.95
臺中市,北區,樂英里,187,1,823,14,837,1196,3,1,3,0,1,0,69.98
臺中市,北區,樂英里,188,1,454,15,469,766,3,1,3,0,1,0,61.23
臺中市,北區,錦村里,189,1,622,8,630,918,3,1,3,0,1,0,68.63
臺中市,北區,錦村里,190,1,599,7,606,903,3,1,3,0,1,0,67.11
臺中市,北區,錦村里,191,1,776,15,791,1134,3,1,3,0,1,0,69.75
臺中市,北區,建成里,192,1,1132,17,1149,1688,3,1,3,0,1,0,68.07
臺中市,北區,建成里,193,1,1011,11,1022,1501,3,1,3,0,1,0,68.09
臺中市,北區,建成里,194,1,616,15,631,1081,3,1,3,0,1,0,58.37
臺中市,北區,建成里,195,1,770,9,779,1227,3,1,3,0,1,0,63.49
臺中市,北區,建成里,196,1,883,15,898,1340,3,1,3,0,1,0,67.01
臺中市,北區,錦洲里,197,1,906,19,925,1347,3,1,3,0,1,0,68.67
臺中市,北區,錦洲里,198,1,1079,7,1086,1617,3,1,3,0,1,0,67.16
臺中市,北區,錦祥里,199,1,841,11,852,1425,3,1,3,0,1,0,59.79
臺中市,北區,錦祥里,200,1,979,12,991,1589,3,1,3,0,1,0,62.37
臺中市,北區,金華里,201,1,1023,19,1042,1664,3,1,3,0,1,0,62.62
臺中市,北區,金龍里,202,1,868,7,875,1357,3,1,3,0,1,0,64.48
臺中市,北區,金龍里,203,1,863,13,876,1398,3,1,3,0,1,0,62.66
臺中市,北區,金龍里,204,1,810,11,821,1312,3,1,3,0,1,0,62.58
臺中市,北區,邱厝里,205,1,748,10,758,1201,3,1,3,0,1,0,63.11
臺中市,北區,邱厝里,206,1,497,4,501,901,3,1,3,0,1,0,55.60
臺中市,北區,建興里,207,1,834,7,841,1364,3,1,3,0,1,0,61.66
臺中市,北區,建興里,208,1,721,17,738,1134,3,1,3,0,1,0,65.08
臺中市,北區,建興里,209,1,776,11,787,1222,3,1,3,0,1,0,64.40
臺中市,北區,建興里,210,1,794,8,802,1274,3,1,3,0,1,0,62.95
臺中市,北區,頂厝里,211,1,779,8,787,1184,3,1,3,0,1,0,66.47
臺中市,北區,頂厝里,212,1,957,11,968,1515,3,1,3,0,1,0,63.89
臺中市,北區,頂厝里,213,1,931,5,936,1469,3,1,3,0,1,0,63.72
臺中市,北區,頂厝里,214,1,1077,19,1096,1742,3,1,3,0,1,0,62.92
臺中市,北區,賴厝里,215,1,1119,22,1141,1807,3,1,3,0,1,0,63.14
臺中市,北區,賴厝里,216,1,734,9,743,1097,3,1,3,0,1,0,67.73
臺中市,北區,賴厝里,217,1,1248,11,1259,2152,3,1,3,0,1,0,58.50
臺中市,北區,賴明里,218,1,982,11,993,1597,3,1,3,0,1,0,62.18
臺中市,北區,賴明里,219,1,968,17,985,1562,3,1,3,0,1,0,63.06
臺中市,北區,賴明里,220,1,1152,18,1170,1850,3,1,3,0,1,0,63.24
臺中市,北區,賴興里,221,1,856,12,868,1484,3,1,3,0,1,0,58.49
臺中市,北區,賴興里,222,1,942,13,955,1565,3,1,3,0,1,0,61.02
臺中市,北區,賴興里,223,1,913,9,922,1486,3,1,3,0,1,0,62.05
臺中市,北區,賴興里,224,1,988,3,991,1450,3,1,3,0,1,0,68.34
臺中市,北區,賴村里,225,1,828,18,846,1263,3,1,3,0,1,0,66.98
臺中市,北區,賴村里,226,1,803,11,814,1332,3,1,3,0,1,0,61.11
臺中市,北區,賴村里,227,1,798,4,802,1196,3,1,3,0,1,0,67.06
臺中市,北區,育德里,228,1,1023,17,1040,1588,3,1,3,0,1,0,65.49
臺中市,北區,育德里,229,1,1017,10,1027,1573,3,1,3,0,1,0,65.29
臺中市,北區,淡溝里,230,1,890,16,906,1349,3,1,3,0,1,0,67.16
臺中市,北區,淡溝里,231,1,766,18,784,1155,3,1,3,0,1,0,67.88
臺中市,北區,淡溝里,232,1,771,6,777,1116,3,1,3,0,1,0,69.62
臺中市,北區,健行里,233,1,801,11,812,1138,3,1,3,0,1,0,71.35
臺中市,北區,健行里,234,1,893,13,906,1290,3,1,3,0,1,0,70.23
臺中市,北區,健行里,235,1,1034,18,1052,1560,3,1,3,0,1,0,67.44
臺中市,北區,健行里,236,1,908,6,914,1449,3,1,3,0,1,0,63.08
臺中市,北區,明德里,237,1,619,10,629,961,3,1,3,0,1,0,65.45
臺中市,北區,明德里,238,1,1073,14,1087,1607,3,1,3,0,1,0,67.64
臺中市,北區,明德里,239,1,814,14,828,1338,3,1,3,0,1,0,61.88
臺中市,北區,明德里,240,1,873,16,889,1351,3,1,3,0,1,0,65.80
臺中市,北區,明德里,241,1,816,13,829,1231,3,1,3,0,1,0,67.34
臺中市,北區,長青里,242,1,909,17,926,1438,3,1,3,0,1,0,64.39
臺中市,北區,長青里,243,1,1088,21,1109,1773,3,1,3,0,1,0,62.55
臺中市,北區,長青里,244,1,842,12,854,1374,3,1,3,0,1,0,62.15
臺中市,北區,長青里,245,1,1048,18,1066,1578,3,1,3,0,1,0,67.55
臺中市,北區,長青里,246,1,838,11,849,1336,3,1,3,0,1,0,63.55
臺中市,北區,中達里,247,1,844,13,857,1263,3,1,3,0,1,0,67.85
臺中市,北區,中達里,248,1,874,15,889,1256,3,1,3,0,1,0,70.78
臺中市,西屯區,西安里,249,1,1285,14,1299,1923,3,1,3,0,1,0,67.55
臺中市,西屯區,西安里,250,1,871,14,885,1372,3,1,3,0,1,0,64.50
臺中市,西屯區,西安里,251,1,968,15,983,1452,3,1,3,0,1,0,67.70
臺中市,西屯區,西安里,252,1,834,11,845,1321,3,1,3,0,1,0,63.97
臺中市,西屯區,西平里,253,1,934,10,944,1457,3,1,3,0,1,0,64.79
臺中市,西屯區,西平里,254,1,900,19,919,1448,3,1,3,0,1,0,63.47
臺中市,西屯區,西平里,255,1,1027,9,1036,1447,3,1,3,0,1,0,71.60
臺中市,西屯區,西墩里,256,1,1186,23,1209,1865,3,1,3,0,1,0,64.83
臺中市,西屯區,西墩里,257,1,1145,15,1160,1787,3,1,3,0,1,0,64.91
臺中市,西屯區,潮洋里,258,1,1339,11,1350,1886,3,1,3,0,1,0,71.58
臺中市,西屯區,龍潭里,259,1,734,11,745,1001,3,1,3,0,1,0,74.43
臺中市,西屯區,惠來里,260,1,1156,18,1174,1728,3,1,3,0,1,0,67.94
臺中市,西屯區,惠來里,261,1,719,14,733,1080,3,1,3,0,1,0,67.87
臺中市,西屯區,惠來里,262,1,1037,12,1049,1559,3,1,3,0,1,0,67.29
臺中市,西屯區,上石里,263,1,985,10,995,1424,3,1,3,0,1,0,69.87
臺中市,西屯區,上石里,264,1,929,22,951,1576,3,1,3,0,1,0,60.34
臺中市,西屯區,上石里,265,1,1203,23,1226,1991,3,1,3,0,1,0,61.58
臺中市,西屯區,上石里,266,1,1123,19,1142,1865,3,1,3,0,1,0,61.23
臺中市,西屯區,上石里,267,1,1105,19,1124,1676,3,1,3,0,1,0,67.06
臺中市,西屯區,逢甲里、鵬程里,268,1,969,11,980,1527,3,1,3,0,1,0,64.18
臺中市,西屯區,逢甲里、鵬程里,269,1,951,16,967,1459,3,1,3,0,1,0,66.28
臺中市,西屯區,逢甲里、鵬程里,270,1,1047,26,1073,1572,3,1,3,0,1,0,68.26
臺中市,西屯區,逢甲里、鵬程里,271,1,835,12,847,1342,3,1,3,0,1,0,63.11
臺中市,西屯區,逢甲里、鵬程里,272,1,957,14,971,1425,3,1,3,0,1,0,68.14
臺中市,西屯區,何厝里,273,1,688,8,696,1133,3,1,3,0,1,0,61.43
臺中市,西屯區,何厝里,274,1,1027,17,1044,1523,3,1,3,0,1,0,68.55
臺中市,西屯區,何厝里,275,1,941,9,950,1438,3,1,3,0,1,0,66.06
臺中市,西屯區,何厝里,276,1,830,8,838,1346,3,1,3,0,1,0,62.26
臺中市,西屯區,何南里,277,1,1063,13,1076,1598,3,1,3,0,1,0,67.33
臺中市,西屯區,何南里,278,1,969,12,981,1462,3,1,3,0,1,0,67.10
臺中市,西屯區,何南里,279,1,959,8,967,1477,3,1,3,0,1,0,65.47
臺中市,西屯區,何南里,280,1,855,7,862,1263,3,1,3,0,1,0,68.25
臺中市,西屯區,何南里,281,1,1347,21,1368,2096,3,1,3,0,1,0,65.27
臺中市,西屯區,何安里,282,1,775,8,783,1155,3,1,3,0,1,0,67.79
臺中市,西屯區,何安里,283,1,818,4,822,1272,3,1,3,0,1,0,64.62
臺中市,西屯區,何安里,284,1,785,13,798,1219,3,1,3,0,1,0,65.46
臺中市,西屯區,何仁里,285,1,987,18,1005,1555,3,1,3,0,1,0,64.63
臺中市,西屯區,何仁里,286,1,959,10,969,1503,3,1,3,0,1,0,64.47
臺中市,西屯區,何仁里,287,1,951,14,965,1596,3,1,3,0,1,0,60.46
臺中市,西屯區,何德里,288,1,1023,11,1034,1539,3,1,3,0,1,0,67.19
臺中市,西屯區,何德里,289,1,1132,17,1149,1767,3,1,3,0,1,0,65.03
臺中市,西屯區,何德里,290,1,1001,10,1011,1480,3,1,3,0,1,0,68.31
臺中市,西屯區,何德里,291,1,838,17,855,1301,3,1,3,0,1,0,65.72
臺中市,西屯區,何源里,292,1,1085,16,1101,1637,3,1,3,0,1,0,67.26
臺中市,西屯區,何源里,293,1,1022,12,1034,1534,3,1,3,0,1,0,67.41
臺中市,西屯區,何源里,294,1,827,19,846,1306,3,1,3,0,1,0,64.78
臺中市,西屯區,大河里,295,1,1243,25,1268,1840,3,1,3,0,1,0,68.91
臺中市,西屯區,大河里,296,1,878,19,897,1280,3,1,3,0,1,0,70.08
臺中市,西屯區,大石里,297,1,698,7,705,983,3,1,3,0,1,0,71.72
臺中市,西屯區,大福里,298,1,937,19,956,1405,3,1,3,0,1,0,68.04
臺中市,西屯區,大福里,299,1,803,10,813,1264,3,1,3,0,1,0,64.32
臺中市,西屯區,大鵬里,300,1,875,11,886,1253,3,1,3,0,1,0,70.71
臺中市,西屯區,大鵬里,301,1,791,17,808,1214,3,1,3,0,1,0,66.56
臺中市,西屯區,大鵬里,302,1,825,10,835,1304,3,1,3,0,1,0,64.03
臺中市,西屯區,港尾里,303,1,655,13,668,939,3,1,3,0,1,0,71.14
臺中市,西屯區,港尾里,304,1,909,14,923,1379,3,1,3,0,1,0,66.93
臺中市,西屯區,港尾里,305,1,917,11,928,1391,3,1,3,0,1,0,66.71
臺中市,西屯區,港尾里,306,1,588,7,595,772,3,1,3,0,1,0,77.07
臺中市,西屯區,廣福里,307,1,654,13,667,955,3,1,3,0,1,0,69.84
臺中市,西屯區,廣福里,308,1,683,15,698,1011,3,1,3,0,1,0,69.04
臺中市,西屯區,林厝里,309,1,735,22,757,1168,3,1,3,0,1,0,64.81
臺中市,西屯區,林厝里,310,1,757,11,768,1182,3,1,3,0,1,0,64.97
臺中市,西屯區,永安里,311,1,1068,19,1087,1629,3,1,3,0,1,0,66.73
臺中市,西屯區,永安里,312,1,1115,16,1131,1677,3,1,3,0,1,0,67.44
臺中市,西屯區,永安里,313,1,1033,23,1056,1644,3,1,3,0,1,0,64.23
臺中市,西屯區,福安里,314,1,950,18,968,1532,3,1,3,0,1,0,63.19
臺中市,西屯區,福安里,315,1,936,15,951,1491,3,1,3,0,1,0,63.78
臺中市,西屯區,福安里,316,1,900,7,907,1427,3,1,3,0,1,0,63.56
臺中市,西屯區,福安里,317,1,914,20,934,1382,3,1,3,0,1,0,67.58
臺中市,西屯區,福安里,318,1,828,13,841,1297,3,1,3,0,1,0,64.84
臺中市,西屯區,福安里,319,1,876,12,888,1606,3,1,3,0,1,0,55.29
臺中市,西屯區,福安里,320,1,1030,13,1043,1745,3,1,3,0,1,0,59.77
臺中市,西屯區,福安里,321,1,1032,8,1040,1659,3,1,3,0,1,0,62.69
臺中市,西屯區,福安里,322,1,896,14,910,1460,3,1,3,0,1,0,62.33
臺中市,西屯區,福安里,323,1,1017,10,1027,1491,3,1,3,0,1,0,68.88
臺中市,西屯區,福安里,324,1,1017,12,1029,1653,3,1,3,0,1,0,62.25
臺中市,西屯區,福安里,325,1,954,13,967,1524,3,1,3,0,1,0,63.45
臺中市,西屯區,福安里,326,1,797,9,806,1206,3,1,3,0,1,0,66.83
臺中市,西屯區,協和里,327,1,589,11,600,909,3,1,3,0,1,0,66.01
臺中市,西屯區,協和里,328,1,653,15,668,940,3,1,3,0,1,0,71.06
臺中市,西屯區,協和里,329,1,644,16,660,1009,3,1,3,0,1,0,65.41
臺中市,南屯區,南屯里,330,1,943,16,959,1413,3,1,3,0,1,0,67.87
臺中市,南屯區,南屯里,331,1,1049,21,1070,1663,3,1,3,0,1,0,64.34
臺中市,南屯區,南屯里,332,1,1130,20,1150,1682,3,1,3,0,1,0,68.37
臺中市,南屯區,豐樂里,333,1,1113,15,1128,1617,3,1,3,0,1,0,69.76
臺中市,南屯區,豐樂里,334,1,1097,14,1111,1658,3,1,3,0,1,0,67.01
臺中市,南屯區,豐樂里,335,1,1259,19,1278,1932,3,1,3,0,1,0,66.15
臺中市,南屯區,楓樹里,336,1,801,19,820,1186,3,1,3,0,1,0,69.14
臺中市,南屯區,楓樹里,337,1,946,18,964,1344,3,1,3,0,1,0,71.73
臺中市,南屯區,楓樹里,338,1,852,15,867,1224,3,1,3,0,1,0,70.83
臺中市,南屯區,中和里,339,1,751,14,765,1150,3,1,3,0,1,0,66.52
臺中市,南屯區,中和里,340,1,770,13,783,1136,3,1,3,0,1,0,68.93
臺中市,南屯區,中和里,341,1,818,16,834,1176,3,1,3,0,1,0,70.92
臺中市,南屯區,鎮平里,342,1,453,15,468,638,3,1,3,0,1,0,73.35
臺中市,南屯區,鎮平里,343,1,669,15,684,924,3,1,3,0,1,0,74.03
臺中市,南屯區,永定里,344,1,991,14,1005,1525,3,1,3,0,1,0,65.90
臺中市,南屯區,永定里,345,1,885,21,906,1363,3,1,3,0,1,0,66.47
臺中市,南屯區,春社里,346,1,1073,19,1092,1610,3,1,3,0,1,0,67.83
臺中市,南屯區,春社里,347,1,1158,26,1184,1722,3,1,3,0,1,0,68.76
臺中市,南屯區,春社里,348,1,652,18,670,929,3,1,3,0,1,0,72.12
臺中市,南屯區,春社里,349,1,446,8,454,750,3,1,3,0,1,0,60.53
臺中市,南屯區,春安里,350,1,644,11,655,862,3,1,3,0,1,0,75.99
臺中市,南屯區,春安里,351,1,707,9,716,966,3,1,3,0,1,0,74.12
臺中市,南屯區,文山里,352,1,841,12,853,1432,3,1,3,0,1,0,59.57
臺中市,南屯區,文山里,353,1,911,15,926,1447,3,1,3,0,1,0,63.99
臺中市,南屯區,文山里,354,1,1129,13,1142,1754,3,1,3,0,1,0,65.11
臺中市,南屯區,文山里,355,1,803,12,815,1229,3,1,3,0,1,0,66.31
臺中市,南屯區,文山里,356,1,855,19,874,1277,3,1,3,0,1,0,68.44
臺中市,南屯區,新生里,357,1,830,17,847,1217,3,1,3,0,1,0,69.60
臺中市,南屯區,三厝里,358,1,803,15,818,1196,3,1,3,0,1,0,68.39
臺中市,南屯區,三厝里,359,1,678,9,687,1047,3,1,3,0,1,0,65.62
臺中市,南屯區,三厝里,360,1,705,6,711,1067,3,1,3,0,1,0,66.64
臺中市,南屯區,三厝里,361,1,735,12,747,1190,3,1,3,0,1,0,62.77
臺中市,南屯區,三厝里,362,1,674,15,689,1032,3,1,3,0,1,0,66.76
臺中市,南屯區,三厝里,363,1,823,18,841,1252,3,1,3,0,1,0,67.17
臺中市,南屯區,三厝里,364,1,960,10,970,1357,3,1,3,0,1,0,71.48
臺中市,南屯區,三厝里,365,1,801,9,810,1227,3,1,3,0,1,0,66.01
臺中市,南屯區,三厝里,366,1,1029,10,1039,1523,3,1,3,0,1,0,68.22
臺中市,南屯區,黎明里,367,1,939,13,952,1362,3,1,3,0,1,0,69.90
臺中市,南屯區,黎光里,368,1,883,8,891,1277,3,1,3,0,1,0,69.77
臺中市,南屯區,黎光里,369,1,853,18,871,1302,3,1,3,0,1,0,66.90
臺中市,南屯區,田心里,370,1,898,14,912,1349,3,1,3,0,1,0,67.61
臺中市,南屯區,田心里,371,1,786,4,790,1285,3,1,3,0,1,0,61.48
臺中市,南屯區,田心里,372,1,848,15,863,1331,3,1,3,0,1,0,64.84
臺中市,南屯區,田心里,373,1,742,9,751,1059,3,1,3,0,1,0,70.92
臺中市,南屯區,田心里,374,1,979,21,1000,1409,3,1,3,0,1,0,70.97
臺中市,南屯區,田心里,375,1,818,15,833,1321,3,1,3,0,1,0,63.06
臺中市,南屯區,田心里,376,1,912,15,927,1419,3,1,3,0,1,0,65.33
臺中市,南屯區,田心里,377,1,701,14,715,1090,3,1,3,0,1,0,65.60
臺中市,南屯區,田心里,378,1,988,10,998,1606,3,1,3,0,1,0,62.14
臺中市,南屯區,大同里,379,1,794,12,806,1210,3,1,3,0,1,0,66.61
臺中市,南屯區,大同里,380,1,812,11,823,1191,3,1,3,0,1,0,69.10
臺中市,南屯區,大同里,381,1,607,15,622,1034,3,1,3,0,1,0,60.15
臺中市,南屯區,大同里,382,1,840,18,858,1316,3,1,3,0,1,0,65.20
臺中市,南屯區,大同里,383,1,831,9,840,1308,3,1,3,0,1,0,64.22
臺中市,南屯區,大同里,384,1,866,12,878,1327,3,1,3,0,1,0,66.16
臺中市,南屯區,大同里,385,1,706,13,719,1024,3,1,3,0,1,0,70.21
臺中市,南屯區,溝墘里,386,1,962,12,974,1429,3,1,3,0,1,0,68.16
臺中市,南屯區,溝墘里,387,1,884,12,896,1393,3,1,3,0,1,0,64.32
臺中市,南屯區,溝墘里,388,1,912,19,931,1403,3,1,3,0,1,0,66.36
臺中市,南屯區,溝墘里,389,1,715,9,724,1120,3,1,3,0,1,0,64.64
臺中市,南屯區,溝墘里,390,1,817,7,824,1226,3,1,3,0,1,0,67.21
臺中市,南屯區,溝墘里,391,1,1215,6,1221,1683,3,1,3,0,1,0,72.55
臺中市,南屯區,溝墘里,392,1,885,9,894,1323,3,1,3,0,1,0,67.57
臺中市,南屯區,溝墘里,393,1,801,11,812,1225,3,1,3,0,1,0,66.29
臺中市,北屯區,北屯里,394,1,944,15,959,1455,3,1,3,0,1,0,65.91
臺中市,北屯區,北屯里,395,1,767,8,775,1235,3,1,3,0,1,0,62.75
臺中市,北屯區,北屯里,396,1,1037,18,1055,1661,3,1,3,0,1,0,63.52
臺中市,北屯區,北屯里,397,1,1036,9,1045,1558,3,1,3,0,1,0,67.07
臺中市,北屯區,北興里,398,1,1119,17,1136,1832,3,1,3,0,1,0,62.01
臺中市,北屯區,北興里,399,1,999,15,1014,1457,3,1,3,0,1,0,69.60
臺中市,北屯區,三光里,400,1,1076,11,1087,1773,3,1,3,0,1,0,61.31
臺中市,北屯區,三光里,401,1,851,6,857,1312,3,1,3,0,1,0,65.32
臺中市,北屯區,三光里,402,1,734,7,741,1088,3,1,3,0,1,0,68.11
臺中市,北屯區,三光里,403,1,927,16,943,1454,3,1,3,0,1,0,64.86
臺中市,北屯區,三光里,404,1,1090,12,1102,1668,3,1,3,0,1,0,66.07
臺中市,北屯區,三光里,405,1,980,14,994,1517,3,1,3,0,1,0,65.52
臺中市,北屯區,三光里,406,1,918,6,924,1435,3,1,3,0,1,0,64.39
臺中市,北屯區,平田里,407,1,712,10,722,1205,3,1,3,0,1,0,59.92
臺中市,北屯區,平田里,408,1,918,15,933,1406,3,1,3,0,1,0,66.36
臺中市,北屯區,平田里,409,1,1051,13,1064,1618,3,1,3,0,1,0,65.76
臺中市,北屯區,平田里,410,1,912,14,926,1442,3,1,3,0,1,0,64.22
臺中市,北屯區,平田里,411,1,1062,21,1083,1669,3,1,3,0,1,0,64.89
臺中市,北屯區,平田里,412,1,911,6,917,1422,3,1,3,0,1,0,64.49
臺中市,北屯區,平田里,413,1,1044,19,1063,1671,3,1,3,0,1,0,63.61
臺中市,北屯區,平和里,414,1,1203,9,1212,1874,3,1,3,0,1,0,64.67
臺中市,北屯區,平和里,415,1,1126,20,1146,1869,3,1,3,0,1,0,61.32
臺中市,北屯區,平和里,416,1,893,15,908,1442,3,1,3,0,1,0,62.97
臺中市,北屯區,平和里,417,1,922,18,940,1501,3,1,3,0,1,0,62.62
臺中市,北屯區,平安里,418,1,912,14,926,1279,3,1,3,0,1,0,72.40
臺中市,北屯區,平安里,419,1,890,19,909,1369,3,1,3,0,1,0,66.40
臺中市,北屯區,平安里,420,1,967,13,980,1566,3,1,3,0,1,0,62.58
臺中市,北屯區,平順里,421,1,904,14,918,1411,3,1,3,0,1,0,65.06
臺中市,北屯區,平順里,422,1,887,14,901,1522,3,1,3,0,1,0,59.20
臺中市,北屯區,平順里,423,1,926,18,944,1504,3,1,3,0,1,0,62.77
臺中市,北屯區,平順里,424,1,943,13,956,1504,3,1,3,0,1,0,63.56
臺中市,北屯區,平順里,425,1,1063,11,1074,1535,3,1,3,0,1,0,69.97
臺中市,北屯區,平德里,426,1,833,11,844,1341,3,1,3,0,1,0,62.94
臺中市,北屯區,平德里,427,1,947,11,958,1475,3,1,3,0,1,0,64.95
臺中市,北屯區,平德里,428,1,963,16,979,1444,3,1,3,0,1,0,67.80
臺中市,北屯區,東光里,429,1,877,10,887,1354,3,1,3,0,1,0,65.51
臺中市,北屯區,東光里,430,1,927,21,948,1368,3,1,3,0,1,0,69.30
臺中市,北屯區,東光里,431,1,478,11,489,931,3,1,3,0,1,0,52.52
臺中市,北屯區,舊社里,432,1,946,18,964,1332,3,1,3,0,1,0,72.37
臺中市,北屯區,舊社里,433,1,781,11,792,1280,3,1,3,0,1,0,61.88
臺中市,北屯區,舊社里,434,1,595,7,602,940,3,1,3,0,1,0,64.04
臺中市,北屯區,舊社里,435,1,709,11,720,1113,3,1,3,0,1,0,64.69
臺中市,北屯區,水景里,436,1,1134,12,1146,1646,3,1,3,0,1,0,69.62
臺中市,北屯區,水景里,437,1,1212,26,1238,1781,3,1,3,0,1,0,69.51
臺中市,北屯區,水景里,438,1,1121,19,1140,1713,3,1,3,0,1,0,66.55
臺中市,北屯區,軍功里,439,1,1076,10,1086,1537,3,1,3,0,1,0,70.66
臺中市,北屯區,軍功里,440,1,895,23,918,1303,3,1,3,0,1,0,70.45
臺中市,北屯區,軍功里,441,1,950,19,969,1394,3,1,3,0,1,0,69.51
臺中市,北屯區,軍功里,442,1,1036,18,1054,1620,3,1,3,0,1,0,65.06
臺中市,北屯區,和平里,443,1,1262,11,1273,1803,3,1,3,0,1,0,70.60
臺中市,北屯區,和平里,444,1,1121,19,1140,1683,3,1,3,0,1,0,67.74
臺中市,北屯區,和平里,445,1,479,10,489,729,3,1,3,0,1,0,67.08
臺中市,北屯區,東山里,446,1,1089,15,1104,1544,3,1,3,0,1,0,71.50
臺中市,北屯區,廍子里,447,1,476,7,483,724,3,1,3,0,1,0,66.71
臺中市,北屯區,廍子里,448,1,561,8,569,852,3,1,3,0,1,0,66.78
臺中市,北屯區,民政里,449,1,552,15,567,883,3,1,3,0,1,0,64.21
臺中市,北屯區,民德里,450,1,487,2,489,723,3,1,3,0,1,0,67.63
臺中市,北屯區,大坑里,451,1,1060,12,1072,1512,3,1,3,0,1,0,70.90
臺中市,北屯區,松竹里,452,1,723,6,729,1079,3,1,3,0,1,0,67.56
臺中市,北屯區,松竹里,453,1,1315,20,1335,2094,3,1,3,0,1,0,63.75
臺中市,北屯區,松竹里,454,1,1120,16,1136,1666,3,1,3,0,1,0,68.19
臺中市,北屯區,松安里,455,1,790,15,805,1208,3,1,3,0,1,0,66.64
臺中市,北屯區,松安里,456,1,742,15,757,1182,3,1,3,0,1,0,64.04
臺中市,北屯區,松安里,457,1,854,8,862,1407,3,1,3,0,1,0,61.27
臺中市,北屯區,松安里,458,1,856,11,867,1313,3,1,3,0,1,0,66.03
臺中市,北屯區,松安里,459,1,784,9,793,1264,3,1,3,0,1,0,62.74
臺中市,北屯區,松安里,460,1,922,9,931,1460,3,1,3,0,1,0,63.77
臺中市,北屯區,松茂里,461,1,660,9,669,1151,3,1,3,0,1,0,58.12
臺中市,北屯區,松茂里,462,1,854,7,861,1301,3,1,3,0,1,0,66.18
臺中市,北屯區,松茂里,463,1,839,16,855,1322,3,1,3,0,1,0,64.67
臺中市,北屯區,松茂里,464,1,996,14,1010,1470,3,1,3,0,1,0,68.71
臺中市,北屯區,松茂里,465,1,776,10,786,1209,3,1,3,0,1,0,65.01
臺中市,北屯區,松茂里,466,1,824,10,834,1241,3,1,3,0,1,0,67.20
臺中市,北屯區,松茂里,467,1,806,11,817,1261,3,1,3,0,1,0,64.79
臺中市,北屯區,松茂里,468,1,930,14,944,1434,3,1,3,0,1,0,65.83
臺中市,北屯區,仁和里,469,1,1092,21,1113,1644,3,1,3,0,1,0,67.70
臺中市,北屯區,仁和里,470,1,969,19,988,1389,3,1,3,0,1,0,71.13
臺中市,北屯區,仁和里,471,1,1169,20,1189,1669,3,1,3,0,1,0,71.24
臺中市,北屯區,仁和里,472,1,868,17,885,1305,3,1,3,0,1,0,67.82
臺中市,北屯區,仁美里,473,1,516,2,518,739,3,1,3,0,1,0,70.09
臺中市,北屯區,仁美里,474,1,912,11,923,1337,3,1,3,0,1,0,69.04
臺中市,北屯區,仁美里,475,1,1025,18,1043,1472,3,1,3,0,1,0,70.86
臺中市,北屯區,仁美里,476,1,591,12,603,831,3,1,3,0,1,0,72.56
臺中市,北屯區,仁美里,477,1,491,18,509,720,3,1,3,0,1,0,70.69
臺中市,北屯區,四民里,478,1,730,9,739,1018,3,1,3,0,1,0,72.59
臺中市,北屯區,同榮里,479,1,1155,21,1176,1706,3,1,3,0,1,0,68.93
臺中市,北屯區,同榮里,480,1,1009,21,1030,1438,3,1,3,0,1,0,71.63
臺中市,北屯區,同榮里,481,1,1248,16,1264,1946,3,1,3,0,1,0,64.95
臺中市,北屯區,后庄里,482,1,1307,14,1321,1985,3,1,3,0,1,0,66.55
臺中市,北屯區,后庄里,483,1,1007,14,1021,1477,3,1,3,0,1,0,69.13
臺中市,北屯區,后庄里,484,1,1076,21,1097,1573,3,1,3,0,1,0,69.74
臺中市,北屯區,陳平里,485,1,830,10,840,1397,3,1,3,0,1,0,60.13
臺中市,北屯區,陳平里,486,1,904,15,919,1401,3,1,3,0,1,0,65.60
臺中市,北屯區,陳平里,487,1,1129,8,1137,1646,3,1,3,0,1,0,69.08
臺中市,北屯區,陳平里,488,1,820,6,826,1315,3,1,3,0,1,0,62.81
臺中市,北屯區,陳平里,489,1,860,11,871,1320,3,1,3,0,1,0,65.98
臺中市,北屯區,大德里,490,1,854,7,861,1329,3,1,3,0,1,0,64.79
臺中市,北屯區,大德里,491,1,747,12,759,1144,3,1,3,0,1,0,66.35
臺中市,北屯區,大德里,492,1,1050,14,1064,1583,3,1,3,0,1,0,67.21
臺中市,北屯區,新平里,493,1,1111,15,1126,1718,3,1,3,0,1,0,65.54
臺中市,北屯區,新平里,494,1,909,16,925,1325,3,1,3,0,1,0,69.81
臺中市,北屯區,新平里,495,1,803,14,817,1317,3,1,3,0,1,0,62.03
臺中市,北屯區,仁愛里,496,1,574,4,578,778,3,1,3,0,1,0,74.29
臺中市,北屯區,水湳里,497,1,893,16,909,1352,3,1,3,0,1,0,67.23
臺中市,北屯區,水湳里,498,1,829,19,848,1206,3,1,3,0,1,0,70.32
臺中市,北屯區,水湳里,499,1,1220,21,1241,1815,3,1,3,0,1,0,68.37
臺中市,北屯區,水湳里,500,1,946,7,953,1398,3,1,3,0,1,0,68.17
嘉義市,東區,短竹里,1,1,813,12,825,1307,3,1,3,0,1,0,63.12
嘉義市,東區,短竹里,2,1,804,12,816,1291,3,1,3,0,1,0,63.21
嘉義市,東區,短竹里,3,1,834,12,846,1321,3,1,3,0,1,0,64.04
嘉義市,東區,東川里,4,1,598,5,603,842,3,1,3,0,1,0,71.62
嘉義市,東區,東川里,5,1,613,9,622,926,3,1,3,0,1,0,67.17
嘉義市,東區,鹿寮里,6,1,391,9,400,608,3,1,3,0,1,0,65.79
嘉義市,東區,盧厝里,7,1,654,8,662,1033,3,1,3,0,1,0,64.09
嘉義市,東區,盧厝里,8,1,548,2,550,871,3,1,3,0,1,0,63.15
嘉義市,東區,盧厝里,9,1,726,8,734,1215,3,1,3,0,1,0,60.41
嘉義市,東區,東平里,10,1,568,4,572,877,3,1,3,0,1,0,65.22
嘉義市,東區,太平里,11,1,799,10,809,1210,3,1,3,0,1,0,66.86
嘉義市,東區,太平里,12,1,555,10,565,837,3,1,3,0,1,0,67.50
嘉義市,東區,太平里,13,1,431,3,434,667,3,1,3,0,1,0,65.07
嘉義市,東區,太平里,14,1,612,5,617,878,3,1,3,0,1,0,70.27
嘉義市,東區,王田里,15,1,788,7,795,1174,3,1,3,0,1,0,67.72
嘉義市,東區,王田里,16,1,676,8,684,1104,3,1,3,0,1,0,61.96
嘉義市,東區,長竹里,17,1,863,13,876,1268,3,1,3,0,1,0,69.09
嘉義市,東區,長竹里,18,1,810,10,820,1269,3,1,3,0,1,0,64.62
嘉義市,東區,後庄里,19,1,924,17,941,1395,3,1,3,0,1,0,67.46
嘉義市,東區,後庄里,20,1,689,4,693,1032,3,1,3,0,1,0,67.15
嘉義市,東區,後庄里,21,1,683,9,692,1030,3,1,3,0,1,0,67.18
嘉義市,東區,新店里,22,1,811,12,823,1238,3,1,3,0,1,0,66.48
嘉義市,東區,新店里,23,1,570,7,577,908,3,1,3,0,1,0,63.55
嘉義市,東區,新店里,24,1,588,10,598,946,3,1,3,0,1,0,63.21
嘉義市,東區,圳頭里,25,1,526,3,529,830,3,1,3,0,1,0,63.73
嘉義市,東區,圳頭里,26,1,396,5,401,646,3,1,3,0,1,0,62.07
嘉義市,東區,圳頭里,27,1,1017,12,1029,1602,3,1,3,0,1,0,64.23
嘉義市,東區,東噴里,28,1,746,11,757,1161,3,1,3,0,1,0,65.20
嘉義市,東區,希康里,29,1,224,1,225,337,3,1,3,0,1,0,66.77
嘉義市,東區,東山里,30,1,301,3,304,455,3,1,3,0,1,0,66.81
嘉義市,東區,東安里,31,1,364,5,369,542,3,1,3,0,1,0,68.08
嘉義市,東區,大街里,32,1,327,4,331,493,3,1,3,0,1,0,67.14
嘉義市,東區,祐民里,33,1,426,6,432,638,3,1,3,0,1,0,67.71
嘉義市,東區,東仁里,34,1,355,1,356,523,3,1,3,0,1,0,68.07
嘉義市,東區,內安里,35,1,305,2,307,441,3,1,3,0,1,0,69.61
嘉義市,東區,雲霄里,36,1,448,7,455,667,3,1,3,0,1,0,68.22
嘉義市,東區,雲霄里,37,1,420,1,421,649,3,1,3,0,1,0,64.87
嘉義市,東區,建國里,38,1,391,4,395,610,3,1,3,0,1,0,64.75
嘉義市,東區,府路里,39,1,634,6,640,1005,3,1,3,0,1,0,63.68
嘉義市,東區,鎮南里,40,1,255,4,259,384,3,1,3,0,1,0,67.45
嘉義市,東區,神農里,41,1,672,10,682,1023,3,1,3,0,1,0,66.67
嘉義市,東區,崇文里,42,1,433,5,438,629,3,1,3,0,1,0,69.63
嘉義市,東區,龍山里,43,1,483,4,487,736,3,1,3,0,1,0,66.17
嘉義市,東區,安平里,44,1,486,5,491,730,3,1,3,0,1,0,67.26
嘉義市,東區,文昌里,45,1,445,5,450,671,3,1,3,0,1,0,67.06
嘉義市,東區,志航里,46,1,811,9,820,1175,3,1,3,0,1,0,69.79
嘉義市,東區,蘭井里,47,1,398,3,401,630,3,1,3,0,1,0,63.65
嘉義市,東區,光復里,48,1,735,2,737,1095,3,1,3,0,1,0,67.31
嘉義市,東區,初陽里,49,1,843,5,848,1268,3,1,3,0,1,0,66.88
嘉義市,東區,震安里,50,1,572,7,579,852,3,1,3,0,1,0,67.96
嘉義市,東區,新開里,51,1,442,4,446,651,3,1,3,0,1,0,68.51
嘉義市,東區,新開里,52,1,450,7,457,718,3,1,3,0,1,0,63.65
嘉義市,東區,宣信里,53,1,610,11,621,1025,3,1,3,0,1,0,60.59
嘉義市,東區,宣信里,54,1,562,7,569,889,3,1,3,0,1,0,64.00
嘉義市,東區,興南里,55,1,842,10,852,1325,3,1,3,0,1,0,64.30
嘉義市,東區,豐年里,56,1,475,8,483,720,3,1,3,0,1,0,67.08
嘉義市,東區,豐年里,57,1,508,10,518,820,3,1,3,0,1,0,63.17
嘉義市,東區,芳草里,58,1,772,17,789,1192,3,1,3,0,1,0,66.19
嘉義市,東區,芳草里,59,1,557,7,564,918,3,1,3,0,1,0,61.44
嘉義市,東區,芳草里,60,1,671,9,680,1155,3,1,3,0,1,0,58.87
嘉義市,東區,芳安里,61,1,886,9,895,1354,3,1,3,0,1,0,66.10
嘉義市,東區,芳安里,62,1,511,6,517,717,3,1,3,0,1,0,72.11
嘉義市,東區,頂寮里,63,1,629,8,637,985,3,1,3,0,1,0,64.67
嘉義市,東區,頂寮里,64,1,630,5,635,978,3,1,3,0,1,0,64.93
嘉義市,東區,安寮里,65,1,575,6,581,919,3,1,3,0,1,0,63.22
嘉義市,東區,安寮里,66,1,617,7,624,1019,3,1,3,0,1,0,61.24
嘉義市,東區,安寮里,67,1,706,3,709,1164,3,1,3,0,1,0,60.91
嘉義市,東區,安寮里,68,1,882,12,894,1449,3,1,3,0,1,0,61.70
嘉義市,東區,興村里,69,1,857,6,863,1333,3,1,3,0,1,0,64.74
嘉義市,東區,興村里,70,1,949,10,959,1621,3,1,3,0,1,0,59.16
嘉義市,東區,興安里,71,1,666,7,673,1113,3,1,3,0,1,0,60.47
嘉義市,東區,興安里,72,1,634,11,645,981,3,1,3,0,1,0,65.75
嘉義市,東區,興仁里,73,1,968,10,978,1436,3,1,3,0,1,0,68.11
嘉義市,東區,興仁里,74,1,965,12,977,1567,3,1,3,0,1,0,62.35
嘉義市,東區,北城里,75,1,543,3,546,858,3,1,3,0,1,0,63.64
嘉義市,東區,仁武里,76,1,438,9,447,647,3,1,3,0,1,0,69.09
嘉義市,東區,泰安里,77,1,693,6,699,1093,3,1,3,0,1,0,63.95
嘉義市,東區,檜村里,78,1,516,4,520,800,3,1,3,0,1,0,65.00
嘉義市,東區,檜村里,79,1,400,2,402,620,3,1,3,0,1,0,64.84
嘉義市,東區,社口里,80,1,591,4,595,884,3,1,3,0,1,0,67.31
嘉義市,東區,仁和里,81,1,312,4,316,505,3,1,3,0,1,0,62.57
嘉義市,東區,中庄里,82,1,768,11,779,1288,3,1,3,0,1,0,60.48
嘉義市,東區,中庄里,83,1,765,14,779,1279,3,1,3,0,1,0,60.91
嘉義市,東區,仁義里,84,1,716,9,725,1112,3,1,3,0,1,0,65.20
嘉義市,東區,仁義里,85,1,540,8,548,931,3,1,3,0,1,0,58.86
嘉義市,東區,後湖里,86,1,1005,10,1015,1601,3,1,3,0,1,0,63.40
嘉義市,東區,後湖里,87,1,881,14,895,1346,3,1,3,0,1,0,66.49
嘉義市,東區,荖藤里,88,1,632,11,643,874,3,1,3,0,1,0,73.57
嘉義市,東區,荖藤里,89,1,451,5,456,684,3,1,3,0,1,0,66.67
嘉義市,東區,荖藤里,90,1,414,2,416,723,3,1,3,0,1,0,57.54
嘉義市,東區,頂庄里,91,1,758,8,766,1199,3,1,3,0,1,0,63.89
嘉義市,東區,頂庄里,92,1,814,10,824,1281,3,1,3,0,1,0,64.32
嘉義市,東區,頂庄里,93,1,571,5,576,926,3,1,3,0,1,0,62.20
嘉義市,東區,頂庄里,94,1,736,7,743,1109,3,1,3,0,1,0,67.00
嘉義市,西區,書院里,95,1,677,8,685,1007,3,1,3,0,1,0,68.02
嘉義市,西區,驛站里,96,1,426,6,432,654,3,1,3,0,1,0,66.06
嘉義市,西區,民安里,97,1,323,3,326,509,3,1,3,0,1,0,64.05
嘉義市,西區,菜園里,98,1,440,5,445,673,3,1,3,0,1,0,66.12
嘉義市,西區,集英里,99,1,350,6,356,543,3,1,3,0,1,0,65.56
嘉義市,西區,福松里,100,1,587,4,591,827,3,1,3,0,1,0,71.46
嘉義市,西區,義昌里,101,1,373,6,379,577,3,1,3,0,1,0,65.68
嘉義市,西區,自治里,102,1,739,5,744,1115,3,1,3,0,1,0,66.73
嘉義市,西區,大業里,103,1,570,2,572,888,3,1,3,0,1,0,64.41
嘉義市,西區,中庸里,104,1,540,4,544,818,3,1,3,0,1,0,66.50
嘉義市,西區,學圃里,105,1,330,3,333,494,3,1,3,0,1,0,67.41
嘉義市,西區,北杏里,106,1,512,7,519,783,3,1,3,0,1,0,66.28
嘉義市,西區,社內里,107,1,358,5,363,518,3,1,3,0,1,0,70.08
嘉義市,西區,民生里,108,1,372,3,375,523,3,1,3,0,1,0,71.70
嘉義市,西區,慶昇里,109,1,266,6,272,420,3,1,3,0,1,0,64.76
嘉義市,西區,通運里,110,1,243,4,247,404,3,1,3,0,1,0,61.14
嘉義市,西區,榮檜里,111,1,391,6,397,618,3,1,3,0,1,0,64.24
嘉義市,西區,功科里,112,1,491,5,496,723,3,1,3,0,1,0,68.60
嘉義市,西區,康莊里,113,1,420,4,424,628,3,1,3,0,1,0,67.52
嘉義市,西區,福全里,114,1,659,14,673,1035,3,1,3,0,1,0,65.02
嘉義市,西區,福全里,115,1,673,13,686,1103,3,1,3,0,1,0,62.19
嘉義市,西區,福全里,116,1,752,8,760,1196,3,1,3,0,1,0,63.55
嘉義市,西區,福全里,117,1,756,8,764,1186,3,1,3,0,1,0,64.42
嘉義市,西區,福全里,118,1,797,20,817,1310,3,1,3,0,1,0,62.37
嘉義市,西區,力行里,119,1,616,6,622,949,3,1,3,0,1,0,65.54
嘉義市,西區,劉厝里,120,1,682,9,691,1048,3,1,3,0,1,0,65.94
嘉義市,西區,劉厝里,121,1,836,6,842,1428,3,1,3,0,1,0,58.96
嘉義市,西區,劉厝里,122,1,438,6,444,667,3,1,3,0,1,0,66.57
嘉義市,西區,港坪里,123,1,622,7,629,919,3,1,3,0,1,0,68.44
嘉義市,西區,港坪里,124,1,573,8,581,893,3,1,3,0,1,0,65.06
嘉義市,西區,頭港里,125,1,779,10,789,1246,3,1,3,0,1,0,63.32
嘉義市,西區,西平里,126,1,853,10,863,1283,3,1,3,0,1,0,67.26
嘉義市,西區,大溪里,127,1,581,11,592,900,3,1,3,0,1,0,65.78
嘉義市,西區,大溪里,128,1,514,5,519,799,3,1,3,0,1,0,64.96
嘉義市,西區,磚窯里,129,1,813,19,832,1289,3,1,3,0,1,0,64.55
嘉義市,西區,磚窯里,130,1,584,6,590,925,3,1,3,0,1,0,63.78
嘉義市,西區,磚窯里,131,1,550,7,557,880,3,1,3,0,1,0,63.30
嘉義市,西區,新西里,132,1,577,8,585,896,3,1,3,0,1,0,65.29
嘉義市,西區,新西里,133,1,727,23,750,1197,3,1,3,0,1,0,62.66
嘉義市,西區,華明里,134,1,507,5,512,790,3,1,3,0,1,0,64.81
嘉義市,西區,導民里,135,1,354,6,360,566,3,1,3,0,1,0,63.60
嘉義市,西區,導民里,136,1,462,3,465,707,3,1,3,0,1,0,65.77
嘉義市,西區,培元里,137,1,718,5,723,1091,3,1,3,0,1,0,66.27
嘉義市,西區,垂楊里,138,1,518,8,526,879,3,1,3,0,1,0,59.84
嘉義市,西區,垂楊里,139,1,608,9,617,1057,3,1,3,0,1,0,58.37
嘉義市,西區,車店里,140,1,963,9,972,1465,3,1,3,0,1,0,66.35
嘉義市,西區,車店里,141,1,800,11,811,1264,3,1,3,0,1,0,64.16
嘉義市,西區,車店里,142,1,928,9,937,1464,3,1,3,0,1,0,64.00
嘉義市,西區,福民里,143,1,927,9,936,1359,3,1,3,0,1,0,68.87
嘉義市,西區,福民里,144,1,820,9,829,1280,3,1,3,0,1,0,64.77
嘉義市,西區,福民里,145,1,829,7,836,1286,3,1,3,0,1,0,65.01
嘉義市,西區,湖內里,146,1,709,7,716,1107,3,1,3,0,1,0,64.68
嘉義市,西區,湖內里,147,1,860,8,868,1267,3,1,3,0,1,0,68.51
嘉義市,西區,湖內里,148,1,939,12,951,1647,3,1,3,0,1,0,57.74
嘉義市,西區,湖內里,149,1,734,9,743,1227,3,1,3,0,1,0,60.55
嘉義市,西區,湖內里,150,1,781,10,791,1226,3,1,3,0,1,0,64.52
嘉義市,西區,美源里,151,1,648,6,654,1024,3,1,3,0,1,0,63.87
嘉義市,西區,美源里,152,1,838,6,844,1330,3,1,3,0,1,0,63.46
嘉義市,西區,美源里,153,1,528,7,535,904,3,1,3,0,1,0,59.18
嘉義市,西區,光路里,154,1,860,8,868,1274,3,1,3,0,1,0,68.13
嘉義市,西區,光路里,155,1,875,14,889,1346,3,1,3,0,1,0,66.05
嘉義市,西區,光路里,156,1,833,8,841,1359,3,1,3,0,1,0,61.88
嘉義市,西區,育英里,157,1,697,14,711,1115,3,1,3,0,1,0,63.77
嘉義市,西區,育英里,158,1,751,3,754,1138,3,1,3,0,1,0,66.26
嘉義市,西區,自強里,159,1,822,9,831,1253,3,1,3,0,1,0,66.32
嘉義市,西區,長安里,160,1,857,13,870,1267,3,1,3,0,1,0,68.67
嘉義市,西區,北榮里,161,1,619,5,624,911,3,1,3,0,1,0,68.50
嘉義市,西區,北榮里,162,1,643,8,651,973,3,1,3,0,1,0,66.91
嘉義市,西區,重興里,163,1,661,13,674,1144,3,1,3,0,1,0,58.92
嘉義市,西區,重興里,164,1,574,11,585,893,3,1,3,0,1,0,65.51
嘉義市,西區,慶昌里,165,1,350,8,358,525,3,1,3,0,1,0,68.19
嘉義市,西區,小湖里,166,1,419,6,425,655,3,1,3,0,1,0,64.89
嘉義市,西區,竹文里,167,1,457,6,463,719,3,1,3,0,1,0,64.39
嘉義市,西區,竹文里,168,1,416,4,420,651,3,1,3,0,1,0,64.52
嘉義市,西區,香湖里,169,1,861,18,879,1355,3,1,3,0,1,0,64.87
嘉義市,西區,湖邊里,170,1,580,14,594,895,3,1,3,0,1,0,66.37
嘉義市,西區,湖邊里,171,1,607,7,614,910,3,1,3,0,1,0,67.47
嘉義市,西區,竹圍里,172,1,684,11,695,1018,3,1,3,0,1,0,68.27
嘉義市,西區,竹圍里,173,1,678,4,682,1062,3,1,3,0,1,0,64.22
嘉義市,西區,竹圍里,174,1,580,15,595,902,3,1,3,0,1,0,65.96
嘉義市,西區,竹圍里,175,1,654,10,664,1028,3,1,3,0,1,0,64.59
嘉義市,西區,保安里,176,1,923,16,939,1440,3,1,3,0,1,0,65.21
嘉義市,西區,保安里,177,1,952,15,967,1354,3,1,3,0,1,0,71.42
嘉義市,西區,保安里,178,1,919,13,932,1396,3,1,3,0,1,0,66.76
嘉義市,西區,保安里,179,1,1046,13,1059,1538,3,1,3,0,1,0,68.86
嘉義市,西區,保安里,180,1,898,7,905,1427,3,1,3,0,1,0,63.42
嘉義市,西區,保安里,181,1,953,17,970,1551,3,1,3,0,1,0,62.54
嘉義市,西區,新厝里,182,1,714,9,723,1082,3,1,3,0,1,0,66.82
嘉義市,西區,新厝里,183,1,695,8,703,1101,3,1,3,0,1,0,63.85
嘉義市,西區,新厝里,184,1,694,12,706,1080,3,1,3,0,1,0,65.37
嘉義市,西區,北湖里,185,1,735,8,743,1090,3,1,3,0,1,0,68.17
嘉義市,西區,北湖里,186,1,764,7,771,1136,3,1,3,0,1,0,67.87
嘉義市,西區,下埤里,187,1,846,17,863,1231,3,1,3,0,1,0,70.11
嘉義市,西區,竹村里,188,1,823,11,834,1049,3,1,3,0,1,0,79.50
臺南市,東區,崇學里,1,1,890,16,906,1457,3,1,3,0,1,0,62.18
臺南市,東區,崇學里,2,1,812,9,821,1539,3,1,3,0,1,0,53.35
臺南市,東區,崇學里,3,1,849,12,861,1476,3,1,3,0,1,0,58.33
臺南市,東區,崇學里,4,1,923,8,931,1466,3,1,3,0,1,0,63.51
臺南市,東區,崇德里,5,1,935,21,956,1450,3,1,3,0,1,0,65.93
臺南市,東區,崇德里,6,1,781,18,799,1261,3,1,3,0,1,0,63.36
臺南市,東區,崇德里,7,1,745,15,760,1177,3,1,3,0,1,0,64.57
臺南市,東區,崇善里,8,1,861,8,869,1372,3,1,3,0,1,0,63.34
臺南市,東區,崇善里,9,1,1109,15,1124,1883,3,1,3,0,1,0,59.69
臺南市,東區,崇成里,10,1,1005,10,1015,1624,3,1,3,0,1,0,62.50
臺南市,東區,崇成里,11,1,909,8,917,1548,3,1,3,0,1,0,59.24
臺南市,東區,崇成里,12,1,839,11,850,1284,3,1,3,0,1,0,66.20
臺南市,東區,崇成里,13,1,1171,11,1182,1758,3,1,3,0,1,0,67.24
臺南市,東區,東智里,14,1,1273,11,1284,1997,3,1,3,0,1,0,64.30
臺南市,東區,大智里,15,1,918,14,932,1471,3,1,3,0,1,0,63.36
臺南市,東區,大智里,16,1,865,4,869,1405,3,1,3,0,1,0,61.85
臺南市,東區,大智里,17,1,959,5,964,1544,3,1,3,0,1,0,62.44
臺南市,東區,德高里,18,1,657,22,679,1055,3,1,3,0,1,0,64.36
臺南市,東區,德高里,19,1,883,13,896,1442,3,1,3,0,1,0,62.14
臺南市,東區,仁和里,20,1,1225,15,1240,2165,3,1,3,0,1,0,57.27
臺南市,東區,仁和里,21,1,851,10,861,1465,3,1,3,0,1,0,58.77
臺南市,東區,和平里,22,1,707,2,709,1211,3,1,3,0,1,0,58.55
臺南市,東區,和平里,23,1,857,8,865,1309,3,1,3,0,1,0,66.08
臺南市,東區,虎尾里,24,1,956,13,969,1412,3,1,3,0,1,0,68.63
臺南市,東區,虎尾里,25,1,982,11,993,1504,3,1,3,0,1,0,66.02
臺南市,東區,虎尾里,26,1,813,8,821,1393,3,1,3,0,1,0,58.94
臺南市,東區,虎尾里,27,1,1073,7,1080,1760,3,1,3,0,1,0,61.36
臺南市,東區,自強里,28,1,1343,16,1359,2323,3,1,3,0,1,0,58.50
臺南市,東區,自強里,29,1,1232,15,1247,2064,3,1,3,0,1,0,60.42
臺南市,東區,自強里,30,1,1139,13,1152,1885,3,1,3,0,1,0,61.11
臺南市,東區,東聖里,31,1,747,6,753,1158,3,1,3,0,1,0,65.03
臺南市,東區,東聖里,32,1,622,11,633,1004,3,1,3,0,1,0,63.05
臺南市,東區,關聖里,33,1,889,13,902,1388,3,1,3,0,1,0,64.99
臺南市,東區,關聖里,34,1,984,10,994,1527,3,1,3,0,1,0,65.09
臺南市,東區,關聖里,35,1,946,10,956,1476,3,1,3,0,1,0,64.77
臺南市,東區,後甲里,36,1,817,11,828,1227,3,1,3,0,1,0,67.48
臺南市,東區,後甲里,37,1,958,14,972,1456,3,1,3,0,1,0,66.76
臺南市,東區,復國里,38,1,640,11,651,928,3,1,3,0,1,0,70.15
臺南市,東區,復國里,39,1,700,13,713,1003,3,1,3,0,1,0,71.09
臺南市,東區,中興里,40,1,1195,15,1210,1712,3,1,3,0,1,0,70.68
臺南市,東區,東光里,41,1,1294,19,1313,2129,3,1,3,0,1,0,61.67
臺南市,東區,東光里,42,1,1217,19,1236,1814,3,1,3,0,1,0,68.14
臺南市,東區,東明里,43,1,940,10,950,1520,3,1,3,0,1,0,62.50
臺南市,東區,東明里,44,1,992,5,997,1615,3,1,3,0,1,0,61.73
臺南市,東區,莊敬里,45,1,1008,11,1019,1518,3,1,3,0,1,0,67.13
臺南市,東區,莊敬里,46,1,927,8,935,1465,3,1,3,0,1,0,63.82
臺南市,東區,小東里,47,1,815,12,827,1352,3,1,3,0,1,0,61.17
臺南市,東區,小東里,48,1,799,8,807,1249,3,1,3,0,1,0,64.61
臺南市,東區,小東里,49,1,754,2,756,1195,3,1,3,0,1,0,63.26
臺南市,東區,大學里,50,1,963,5,968,1466,3,1,3,0,1,0,66.03
臺南市,東區,育樂里,51,1,520,12,532,852,3,1,3,0,1,0,62.44
臺南市,東區,前鋒里,52,1,454,2,456,734,3,1,3,0,1,0,62.13
臺南市,東區,大廟里,53,1,723,8,731,1128,3,1,3,0,1,0,64.80
臺南市,東區,泉北里,54,1,705,6,711,1132,3,1,3,0,1,0,62.81
臺南市,東區,圍上里,55,1,493,13,506,766,3,1,3,0,1,0,66.06
臺南市,東區,圍下里,56,1,778,5,783,1137,3,1,3,0,1,0,68.87
臺南市,東區,圍下里,57,1,515,6,521,808,3,1,3,0,1,0,64.48
臺南市,東區,中西里,58,1,1006,9,1015,1558,3,1,3,0,1,0,65.15
臺南市,東區,中西里,59,1,803,7,810,1360,3,1,3,0,1,0,59.56
臺南市,東區,東安里,60,1,980,20,1000,1659,3,1,3,0,1,0,60.28
臺南市,東區,新東里,61,1,819,17,836,1330,3,1,3,0,1,0,62.86
臺南市,東區,新東里,62,1,740,10,750,1168,3,1,3,0,1,0,64.21
臺南市,東區,崇誨里,63,1,967,17,984,1479,3,1,3,0,1,0,66.53
臺南市,東區,崇誨里,64,1,763,7,770,1257,3,1,3,0,1,0,61.26
臺南市,東區,衛國里,65,1,965,16,981,1608,3,1,3,0,1,0,61.01
臺南市,東區,裕農里,66,1,961,8,969,1511,3,1,3,0,1,0,64.13
臺南市,東區,裕農里,67,1,821,13,834,1266,3,1,3,0,1,0,65.88
臺南市,東區,富強里,68,1,1388,22,1410,2099,3,1,3,0,1,0,67.17
臺南市,東區,富強里,69,1,1161,18,1179,1775,3,1,3,0,1,0,66.42
臺南市,東區,富裕里,70,1,706,11,717,1115,3,1,3,0,1,0,64.30
臺南市,東區,富裕里,71,1,613,6,619,1002,3,1,3,0,1,0,61.78
臺南市,東區,崇明里,72,1,875,7,882,1413,3,1,3,0,1,0,62.42
臺南市,東區,崇明里,73,1,594,3,597,935,3,1,3,0,1,0,63.85
臺南市,東區,忠孝里,74,1,1322,21,1343,2189,3,1,3,0,1,0,61.35
臺南市,東區,忠孝里,75,1,1129,15,1144,1836,3,1,3,0,1,0,62.31
臺南市,東區,忠孝里,76,1,501,23,524,777,3,1,3,0,1,0,67.44
臺南市,東區,大福里,77,1,1216,18,1234,1856,3,1,3,0,1,0,66.49
臺南市,東區,大德里,78,1,1028,13,1041,1687,3,1,3,0,1,0,61.71
臺南市,東區,路東里,79,1,828,7,835,1392,3,1,3,0,1,0,59.99
臺南市,東區,大興里,80,1,665,9,674,1028,3,1,3,0,1,0,65.56
臺南市,東區,府宅里,81,1,772,10,782,1177,3,1,3,0,1,0,66.44
臺南市,東區,川東里,82,1,488,8,496,766,3,1,3,0,1,0,64.75
臺南市,東區,泉南里,83,1,1268,12,1280,2016,3,1,3,0,1,0,63.49
臺南市,東區,泉南里,84,1,1275,15,1290,2068,3,1,3,0,1,0,62.38
臺南市,東區,龍山里,85,1,1102,13,1115,1720,3,1,3,0,1,0,64.83
臺南市,東區,龍山里,86,1,655,1,656,998,3,1,3,0,1,0,65.73
臺南市,東區,龍山里,87,1,921,7,928,1480,3,1,3,0,1,0,62.70
臺南市,東區,龍山里,88,1,912,13,925,1477,3,1,3,0,1,0,62.63
臺南市,南區,大恩里,89,1,951,6,957,1529,3,1,3,0,1,0,62.59
臺南市,南區,大恩里,90,1,1002,15,1017,1561,3,1,3,0,1,0,65.15
臺南市,南區,大林里,91,1,666,4,670,1050,3,1,3,0,1,0,63.81
臺南市,南區,大林里,92,1,582,16,598,926,3,1,3,0,1,0,64.58
臺南市,南區,大忠里,93,1,677,10,687,1132,3,1,3,0,1,0,60.69
臺南市,南區,大忠里,94,1,864,11,875,1470,3,1,3,0,1,0,59.52
臺南市,南區,大忠里,95,1,973,10,983,1521,3,1,3,0,1,0,64.63
臺南市,南區,新生里,96,1,666,9,675,1006,3,1,3,0,1,0,67.10
臺南市,南區,竹溪里,97,1,840,9,849,1330,3,1,3,0,1,0,63.83
臺南市,南區,明德里,98,1,682,13,695,1033,3,1,3,0,1,0,67.28
臺南市,南區,興中里,99,1,756,7,763,1175,3,1,3,0,1,0,64.94
臺南市,南區,荔宅里,100,1,802,16,818,1322,3,1,3,0,1,0,61.88
臺南市,南區,大成里,101,1,583,7,590,944,3,1,3,0,1,0,62.50
臺南市,南區,田寮里,102,1,478,2,480,750,3,1,3,0,1,0,64.00
臺南市,南區,田寮里,103,1,687,8,695,1072,3,1,3,0,1,0,64.83
臺南市,南區,田寮里,104,1,989,9,998,1483,3,1,3,0,1,0,67.30
臺南市,南區,新興里,105,1,870,8,878,1365,3,1,3,0,1,0,64.32
臺南市,南區,新興里,106,1,791,9,800,1255,3,1,3,0,1,0,63.75
臺南市,南區,再興里,107,1,737,8,745,1145,3,1,3,0,1,0,65.07
臺南市,南區,再興里,108,1,685,5,690,1067,3,1,3,0,1,0,64.67
臺南市,南區,廣州里,109,1,864,6,870,1255,3,1,3,0,1,0,69.32
臺南市,南區,廣州里,110,1,848,13,861,1290,3,1,3,0,1,0,66.74
臺南市,南區,新昌里,111,1,751,7,758,1163,3,1,3,0,1,0,65.18
臺南市,南區,新昌里,112,1,742,6,748,1190,3,1,3,0,1,0,62.86
臺南市,南區,文華里,113,1,906,12,918,1473,3,1,3,0,1,0,62.32
臺南市,南區,文華里,114,1,1035,12,1047,1597,3,1,3,0,1,0,65.56
臺南市,南區,文南里,115,1,1074,13,1087,1604,3,1,3,0,1,0,67.77
臺南市,南區,文南里,116,1,1198,8,1206,1975,3,1,3,0,1,0,61.06
臺南市,南區,金華里,117,1,868,14,882,1383,3,1,3,0,1,0,63.77
臺南市,南區,金華里,118,1,1017,9,1026,1709,3,1,3,0,1,0,60.04
臺南市,南區,金華里,119,1,968,12,980,1531,3,1,3,0,1,0,64.01
臺南市,南區,國宅里,120,1,1025,15,1040,1575,3,1,3,0,1,0,66.03
臺南市,南區,國宅里,121,1,856,11,867,1389,3,1,3,0,1,0,62.42
臺南市,南區,日新里,122,1,624,12,636,921,3,1,3,0,1,0,69.06
臺南市,南區,日新里,123,1,627,11,638,1075,3,1,3,0,1,0,59.35
臺南市,南區,光明里,124,1,997,11,1008,1556,3,1,3,0,1,0,64.78
臺南市,南區,光明里,125,1,774,8,782,1326,3,1,3,0,1,0,58.97
臺南市,南區,光明里,126,1,743,1,744,1214,3,1,3,0,1,0,61.29
臺南市,南區,白雪里,127,1,459,4,463,758,3,1,3,0,1,0,61.08
臺南市,南區,白雪里,128,1,756,12,768,1159,3,1,3,0,1,0,66.26
臺南市,南區,明亮里,129,1,895,10,905,1587,3,1,3,0,1,0,57.03
臺南市,南區,明亮里,130,1,1142,18,1160,1836,3,1,3,0,1,0,63.18
臺南市,南區,府南里,131,1,854,11,865,1429,3,1,3,0,1,0,60.53
臺南市,南區,府南里,132,1,725,11,736,1195,3,1,3,0,1,0,61.59
臺南市,南區,府南里,133,1,780,10,790,1276,3,1,3,0,1,0,61.91
臺南市,南區,明興里,134,1,992,13,1005,1514,3,1,3,0,1,0,66.38
臺南市,南區,明興里,135,1,967,7,974,1598,3,1,3,0,1,0,60.95
臺南市,南區,郡南里,136,1,1080,17,1097,1671,3,1,3,0,1,0,65.65
臺南市,南區,郡南里,137,1,929,19,948,1592,3,1,3,0,1,0,59.55
臺南市,南區,建南里,138,1,1114,16,1130,1747,3,1,3,0,1,0,64.68
臺南市,南區,建南里,139,1,1241,16,1257,1958,3,1,3,0,1,0,64.20
臺南市,南區,南都里,140,1,813,9,822,1523,3,1,3,0,1,0,53.97
臺南市,南區,南都里,141,1,862,8,870,1484,3,1,3,0,1,0,58.63
臺南市,南區,南都里,142,1,811,12,823,1438,3,1,3,0,1,0,57.23
臺南市,南區,開南里,143,1,1037,12,1049,1892,3,1,3,0,1,0,55.44
臺南市,南區,開南里,144,1,1086,17,1103,1962,3,1,3,0,1,0,56.22
臺南市,南區,彰南里,145,1,553,8,561,938,3,1,3,0,1,0,59.81
臺南市,南區,彰南里,146,1,567,14,581,948,3,1,3,0,1,0,61.29
臺南市,南區,清泉里,147,1,675,14,689,1012,3,1,3,0,1,0,68.08
臺南市,南區,龍崗里,148,1,597,7,604,900,3,1,3,0,1,0,67.11
臺南市,南區,喜北里,149,1,667,6,673,1084,3,1,3,0,1,0,62.08
臺南市,南區,喜北里,150,1,722,6,728,1075,3,1,3,0,1,0,67.72
臺南市,南區,喜南里,151,1,907,11,918,1430,3,1,3,0,1,0,64.20
臺南市,南區,喜東里,152,1,947,7,954,1502,3,1,3,0,1,0,63.52
臺南市,南區,省躬里,153,1,845,10,855,1341,3,1,3,0,1,0,63.76
臺南市,南區,省躬里,154,1,779,9,788,1290,3,1,3,0,1,0,61.09
臺南市,南區,覺醒里,155,1,450,10,460,650,3,1,3,0,1,0,70.77
臺南市,南區,海豐里,156,1,407,7,414,605,3,1,3,0,1,0,68.43
臺南市,南區,松山里,157,1,606,6,612,962,3,1,3,0,1,0,63.62
臺南市,南區,南山里,158,1,492,3,495,760,3,1,3,0,1,0,65.13
臺南市,南區,佛壇里,159,1,1116,14,1130,1746,3,1,3,0,1,0,64.72
臺南市,南區,同安里,160,1,1189,16,1205,1937,3,1,3,0,1,0,62.21
臺南市,南區,中和里,161,1,504,7,511,740,3,1,3,0,1,0,69.05
臺南市,南區,興農里,162,1,1163,14,1177,1791,3,1,3,0,1,0,65.72
臺南市,西區,西賢里,163,1,1016,9,1025,1657,3,1,3,0,1,0,61.86
臺南市,西區,西賢里,164,1,939,11,950,1432,3,1,3,0,1,0,66.34
臺南市,西區,西湖里,165,1,587,5,592,916,3,1,3,0,1,0,64.63
臺南市,西區,西湖里,166,1,1140,6,1146,1765,3,1,3,0,1,0,64.93
臺南市,西區,光賢里,167,1,945,8,953,1502,3,1,3,0,1,0,63.45
臺南市,西區,光賢里,168,1,681,12,693,1004,3,1,3,0,1,0,69.02
臺南市,西區,文賢里,169,1,793,13,806,1223,3,1,3,0,1,0,65.90
臺南市,西區,協和里,170,1,702,9,711,1077,3,1,3,0,1,0,66.02
臺南市,西區,協和里,171,1,612,11,623,893,3,1,3,0,1,0,69.76
臺南市,西區,金安里,172,1,377,5,382,589,3,1,3,0,1,0,64.86
臺南市,西區,忠信里,173,1,488,3,491,683,3,1,3,0,1,0,71.89
臺南市,西區,工業里,174,1,494,10,504,735,3,1,3,0,1,0,68.57
臺南市,西區,普濟里,175,1,469,8,477,697,3,1,3,0,1,0,68.44
臺南市,西區,濟同里,176,1,376,9,385,558,3,1,3,0,1,0,69.00
臺南市,西區,水仙里,177,1,614,5,619,959,3,1,3,0,1,0,64.55
臺南市,西區,北勢里,178,1,558,10,568,889,3,1,3,0,1,0,63.89
臺南市,西區,藥王里,179,1,705,5,710,1045,3,1,3,0,1,0,67.94
臺南市,西區,藥王里,180,1,975,8,983,1564,3,1,3,0,1,0,62.85
臺南市,西區,協進里,181,1,668,10,678,1045,3,1,3,0,1,0,64.88
臺南市,西區,西羅里,182,1,560,14,574,805,3,1,3,0,1,0,71.30
臺南市,西區,安新里,183,1,327,3,330,473,3,1,3,0,1,0,69.77
臺南市,西區,中正里,184,1,547,9,556,835,3,1,3,0,1,0,66.59
臺南市,西區,正德里,185,1,370,7,377,569,3,1,3,0,1,0,66.26
臺南市,西區,安海里,186,1,640,8,648,1114,3,1,3,0,1,0,58.17
臺南市,西區,大涼里,187,1,565,8,573,921,3,1,3,0,1,0,62.21
臺南市,西區,大涼里,188,1,800,13,813,1295,3,1,3,0,1,0,62.78
臺南市,西區,民主里,189,1,454,6,460,796,3,1,3,0,1,0,57.79
臺南市,西區,運河里,190,1,326,6,332,520,3,1,3,0,1,0,63.85
臺南市,西區,北頭里,191,1,168,1,169,237,3,1,3,0,1,0,71.31
臺南市,西區,保民里,192,1,280,3,283,406,3,1,3,0,1,0,69.70
臺南市,西區,保良里,193,1,285,3,288,420,3,1,3,0,1,0,68.57
臺南市,西區,天池里,194,1,202,0,202,291,3,1,3,0,1,0,69.42
臺南市,西區,中頭里,195,1,605,13,618,937,3,1,3,0,1,0,65.96
臺南市,西區,民生里,196,1,723,8,731,1068,3,1,3,0,1,0,68.45
臺南市,西區,新安里,197,1,547,8,555,771,3,1,3,0,1,0,71.98
臺南市,西區,元安里,198,1,835,12,847,1364,3,1,3,0,1,0,62.10
臺南市,北區,城隍里,199,1,595,6,601,946,3,1,3,0,1,0,63.53
臺南市,北區,元和里,200,1,589,12,601,1090,3,1,3,0,1,0,55.14
臺南市,北區,城朔里,201,1,619,7,626,1084,3,1,3,0,1,0,57.75
臺南市,北區,共和里,202,1,740,6,746,1243,3,1,3,0,1,0,60.02
臺南市,北區,福德里,203,1,581,7,588,922,3,1,3,0,1,0,63.77
臺南市,北區,花園里,204,1,622,6,628,996,3,1,3,0,1,0,63.05
臺南市,北區,西華里,205,1,684,8,692,1129,3,1,3,0,1,0,61.29
臺南市,北區,北門里,206,1,523,9,532,854,3,1,3,0,1,0,62.30
臺南市,北區,東豐里,207,1,748,15,763,1157,3,1,3,0,1,0,65.95
臺南市,北區,水源里,208,1,572,7,579,913,3,1,3,0,1,0,63.42
臺南市,北區,仁愛里,209,1,479,7,486,758,3,1,3,0,1,0,64.12
臺南市,北區,仁愛里,210,1,609,6,615,962,3,1,3,0,1,0,63.93
臺南市,北區,振興里,211,1,539,6,545,920,3,1,3,0,1,0,59.24
臺南市,北區,振興里,212,1,637,2,639,966,3,1,3,0,1,0,66.15
臺南市,北區,東興里,213,1,584,8,592,922,3,1,3,0,1,0,64.21
臺南市,北區,東興里,214,1,648,8,656,1009,3,1,3,0,1,0,65.01
臺南市,北區,重興里,215,1,900,8,908,1446,3,1,3,0,1,0,62.79
臺南市,北區,重興里,216,1,906,9,915,1347,3,1,3,0,1,0,67.93
臺南市,北區,華興里,217,1,639,6,645,1024,3,1,3,0,1,0,62.99
臺南市,北區,華興里,218,1,654,5,659,1007,3,1,3,0,1,0,65.44
臺南市,北區,力行里,219,1,624,5,629,1023,3,1,3,0,1,0,61.49
臺南市,北區,力行里,220,1,754,9,763,1153,3,1,3,0,1,0,66.18
臺南市,北區,國興里,221,1,937,17,954,1400,3,1,3,0,1,0,68.14
臺南市,北區,新勝里,222,1,525,11,536,870,3,1,3,0,1,0,61.61
臺南市,北區,新勝里,223,1,580,12,592,958,3,1,3,0,1,0,61.80
臺南市,北區,開元里,224,1,887,10,897,1421,3,1,3,0,1,0,63.12
臺南市,北區,開元里,225,1,806,13,819,1290,3,1,3,0,1,0,63.49
臺南市,北區,開元里,226,1,615,9,624,1276,3,1,3,0,1,0,48.90
臺南市,北區,北垣里,227,1,573,7,580,896,3,1,3,0,1,0,64.73
臺南市,北區,勝安里,228,1,763,9,772,1242,3,1,3,0,1,0,62.16
臺南市,北區,大仁里,229,1,685,6,691,1075,3,1,3,0,1,0,64.28
臺南市,北區,大山里,230,1,829,15,844,1300,3,1,3,0,1,0,64.92
臺南市,北區,大道里,231,1,655,4,659,1086,3,1,3,0,1,0,60.68
臺南市,北區,實踐里,232,1,880,12,892,1467,3,1,3,0,1,0,60.80
臺南市,北區,小康里,233,1,781,7,788,1222,3,1,3,0,1,0,64.48
臺南市,北區,小康里,234,1,744,12,756,1154,3,1,3,0,1,0,65.51
臺南市,北區,小康里,235,1,784,9,793,1255,3,1,3,0,1,0,63.19
臺南市,北區,小康里,236,1,828,9,837,1279,3,1,3,0,1,0,65.44
臺南市,北區,正風里,237,1,967,16,983,1533,3,1,3,0,1,0,64.12
臺南市,北區,延平里,238,1,517,6,523,862,3,1,3,0,1,0,60.67
臺南市,北區,延平里,239,1,576,8,584,961,3,1,3,0,1,0,60.77
臺南市,北區,興北里,240,1,996,25,1021,1577,3,1,3,0,1,0,64.74
臺南市,北區,興南里,241,1,796,9,805,1353,3,1,3,0,1,0,59.50
臺南市,北區,國姓里,242,1,1001,9,1010,1550,3,1,3,0,1,0,65.16
臺南市,北區,六甲里,243,1,644,11,655,1114,3,1,3,0,1,0,58.80
臺南市,北區,六甲里,244,1,665,6,671,1157,3,1,3,0,1,0,57.99
臺南市,北區,正覺里,245,1,774,6,780,1216,3,1,3,0,1,0,64.14
臺南市,北區,正覺里,246,1,642,15,657,1026,3,1,3,0,1,0,64.04
臺南市,北區,正覺里,247,1,631,6,637,993,3,1,3,0,1,0,64.15
臺南市,北區,成功里,248,1,774,9,783,1288,3,1,3,0,1,0,60.79
臺南市,北區,成功里,249,1,713,3,716,1241,3,1,3,0,1,0,57.70
臺南市,北區,成功里,250,1,797,11,808,1289,3,1,3,0,1,0,62.68
臺南市,北區,成功里,251,1,654,5,659,1147,3,1,3,0,1,0,57.45
臺南市,北區,成功里,252,1,820,9,829,1342,3,1,3,0,1,0,61.77
臺南市,北區,和順里,253,1,769,8,777,1291,3,1,3,0,1,0,60.19
臺南市,北區,和順里,254,1,795,7,802,1380,3,1,3,0,1,0,58.12
臺南市,北區,和順里,255,1,530,3,533,849,3,1,3,0,1,0,62.78
臺南市,北區,和順里,256,1,733,5,738,1131,3,1,3,0,1,0,65.25
臺南市,北區,安民里,257,1,817,4,821,1195,3,1,3,0,1,0,68.70
臺南市,北區,裕民里,258,1,913,5,918,1412,3,1,3,0,1,0,65.01
臺南市,北區,文元里,259,1,838,10,848,1327,3,1,3,0,1,0,63.90
臺南市,北區,文元里,260,1,944,8,952,1531,3,1,3,0,1,0,62.18
臺南市,北區,文元里,261,1,824,15,839,1242,3,1,3,0,1,0,67.55
臺南市,北區,文元里,262,1,803,8,811,1252,3,1,3,0,1,0,64.78
臺南市,北區,大港里,263,1,915,12,927,1398,3,1,3,0,1,0,66.31
臺南市,北區,大港里,264,1,910,13,923,1436,3,1,3,0,1,0,64.28
臺南市,北區,大港里,265,1,882,13,895,1335,3,1,3,0,1,0,67.04
臺南市,北區,大港里,266,1,961,14,975,1443,3,1,3,0,1,0,67.57
臺南市,北區,大港里,267,1,1041,10,1051,1596,3,1,3,0,1,0,65.85
臺南市,北區,大豐里,268,1,859,11,870,1361,3,1,3,0,1,0,63.92
臺南市,北區,大豐里,269,1,954,6,960,1546,3,1,3,0,1,0,62.10
臺南市,北區,大豐里,270,1,1070,12,1082,1701,3,1,3,0,1,0,63.61
臺南市,北區,大豐里,271,1,816,14,830,1326,3,1,3,0,1,0,62.59
臺南市,中區,萬壽里,272,1,738,7,745,1153,3,1,3,0,1,0,64.61
臺南市,中區,文昌里,273,1,695,9,704,1020,3,1,3,0,1,0,69.02
臺南市,中區,萬鍾里,274,1,703,15,718,1121,3,1,3,0,1,0,64.05
臺南市,中區,銀同里,275,1,846,10,856,1350,3,1,3,0,1,0,63.41
臺南市,中區,清水里,276,1,470,5,475,699,3,1,3,0,1,0,67.95
臺南市,中區,環翠里,277,1,438,10,448,688,3,1,3,0,1,0,65.12
臺南市,中區,公正里,278,1,229,5,234,363,3,1,3,0,1,0,64.46
臺南市,中區,廣慈里,279,1,274,0,274,424,3,1,3,0,1,0,64.62
臺南市,中區,啟智里,280,1,736,13,749,1162,3,1,3,0,1,0,64.46
臺南市,中區,永慶里,281,1,244,3,247,376,3,1,3,0,1,0,65.69
臺南市,中區,天中里,282,1,312,2,314,475,3,1,3,0,1,0,66.11
臺南市,中區,中山里,283,1,313,6,319,498,3,1,3,0,1,0,64.06
臺南市,中區,白金里,284,1,429,4,433,634,3,1,3,0,1,0,68.30
臺南市,中區,武聖里,285,1,487,7,494,716,3,1,3,0,1,0,68.99
臺南市,中區,蓬壺里,286,1,655,9,664,1019,3,1,3,0,1,0,65.16
臺南市,中區,赤嵌里,287,1,293,3,296,482,3,1,3,0,1,0,61.41
臺南市,中區,觀音里,288,1,416,8,424,688,3,1,3,0,1,0,61.63
臺南市,中區,竹翠里,289,1,330,3,333,477,3,1,3,0,1,0,69.81
臺南市,中區,溫陵里,290,1,371,5,376,591,3,1,3,0,1,0,63.62
臺南市,中區,開仙里,291,1,458,4,462,706,3,1,3,0,1,0,65.44
臺南市,中區,保西里,292,1,449,4,453,731,3,1,3,0,1,0,61.97
臺南市,中區,中南里,293,1,370,1,371,533,3,1,3,0,1,0,69.61
臺南市,中區,福安里,294,1,571,9,580,866,3,1,3,0,1,0,66.97
臺南市,中區,昇平里,295,1,310,0,310,469,3,1,3,0,1,0,66.10
臺南市,中區,聖前里,296,1,272,5,277,429,3,1,3,0,1,0,64.57
臺南市,中區,小西里,297,1,650,5,655,1023,3,1,3,0,1,0,64.03
臺南市,中區,仙草里,298,1,753,4,757,1283,3,1,3,0,1,0,59.00
臺南市,中區,仙草里,299,1,676,10,686,1074,3,1,3,0,1,0,63.87
臺南市,中區,五妃里,300,1,709,6,715,1076,3,1,3,0,1,0,66.45
臺南市,中區,大南里,301,1,999,7,1006,1478,3,1,3,0,1,0,68.06
臺南市,中區,進學里,302,1,442,4,446,687,3,1,3,0,1,0,64.92
臺南市,中區,川西里,303,1,485,4,489,734,3,1,3,0,1,0,66.62
臺南市,中區,開山里,304,1,918,9,927,1450,3,1,3,0,1,0,63.93
臺南市,中區,郡王里,305,1,1050,9,1059,1623,3,1,3,0,1,0,65.25
臺南市,中區,法華里,306,1,1084,14,1098,1665,3,1,3,0,1,0,65.95
臺南市,中區,法華里,307,1,996,2,998,1566,3,1,3,0,1,0,63.73
臺南市,安南區,東和里,308,1,399,7,406,533,3,1,3,0,1,0,76.17
臺南市,安南區,塭南里,309,1,1195,16,1211,2002,3,1,3,0,1,0,60.49
臺南市,安南區,塭南里,310,1,858,11,869,1453,3,1,3,0,1,0,59.81
臺南市,安南區,州南里,311,1,1005,6,1011,1568,3,1,3,0,1,0,64.48
臺南市,安南區,州南里,312,1,846,9,855,1339,3,1,3,0,1,0,63.85
臺南市,安南區,州南里,313,1,742,9,751,1229,3,1,3,0,1,0,61.11
臺南市,安南區,安順里,314,1,732,16,748,1100,3,1,3,0,1,0,68.00
臺南市,安南區,安順里,315,1,843,12,855,1279,3,1,3,0,1,0,66.85
臺南市,安南區,州北里,316,1,892,12,904,1333,3,1,3,0,1,0,67.82
臺南市,安南區,州北里,317,1,1023,9,1032,1646,3,1,3,0,1,0,62.70
臺南市,安南區,新順里,318,1,1054,23,1077,1595,3,1,3,0,1,0,67.52
臺南市,安南區,新順里,319,1,841,9,850,1328,3,1,3,0,1,0,64.01
臺南市,安南區,頂安里,320,1,786,9,795,1114,3,1,3,0,1,0,71.36
臺南市,安南區,頂安里,321,1,873,13,886,1412,3,1,3,0,1,0,62.75
臺南市,安南區,安慶里,322,1,1564,18,1582,2481,3,1,3,0,1,0,63.76
臺南市,安南區,安慶里,323,1,906,13,919,1400,3,1,3,0,1,0,65.64
臺南市,安南區,溪北里,324,1,731,6,737,1185,3,1,3,0,1,0,62.19
臺南市,安南區,溪北里,325,1,794,8,802,1243,3,1,3,0,1,0,64.52
臺南市,安南區,安和里,326,1,1201,15,1216,1856,3,1,3,0,1,0,65.52
臺南市,安南區,安西里,327,1,658,6,664,997,3,1,3,0,1,0,66.60
臺南市,安南區,安西里,328,1,728,10,738,1115,3,1,3,0,1,0,66.19
臺南市,安南區,溪頂里,329,1,1134,13,1147,1830,3,1,3,0,1,0,62.68
臺南市,安南區,溪頂里,330,1,1107,22,1129,1747,3,1,3,0,1,0,64.63
臺南市,安南區,安東里,331,1,785,9,794,1155,3,1,3,0,1,0,68.74
臺南市,安南區,安東里,332,1,865,10,875,1378,3,1,3,0,1,0,63.50
臺南市,安南區,鳳凰里,333,1,981,12,993,1741,3,1,3,0,1,0,57.04
臺南市,安南區,鳳凰里,334,1,929,16,945,1583,3,1,3,0,1,0,59.70
臺南市,安南區,梅花里,335,1,852,13,865,1420,3,1,3,0,1,0,60.92
臺南市,安南區,梅花里,336,1,924,9,933,1567,3,1,3,0,1,0,59.54
臺南市,安南區,理想里,337,1,1056,6,1062,1681,3,1,3,0,1,0,63.18
臺南市,安南區,理想里,338,1,871,10,881,1393,3,1,3,0,1,0,63.24
臺南市,安南區,理想里,339,1,1008,14,1022,1609,3,1,3,0,1,0,63.52
臺南市,安南區,理想里,340,1,812,12,824,1360,3,1,3,0,1,0,60.59
臺南市,安南區,原佃里,341,1,958,13,971,1359,3,1,3,0,1,0,71.45
臺南市,安南區,長安里,342,1,947,20,967,1464,3,1,3,0,1,0,66.05
臺南市,安南區,長安里,343,1,1060,17,1077,1639,3,1,3,0,1,0,65.71
臺南市,安南區,公親里,344,1,662,5,667,957,3,1,3,0,1,0,69.70
臺南市,安南區,布袋里,345,1,773,6,779,1197,3,1,3,0,1,0,65.08
臺南市,安南區,總頭里,346,1,1197,23,1220,1671,3,1,3,0,1,0,73.01
臺南市,安南區,南興里,347,1,792,7,799,1341,3,1,3,0,1,0,59.58
臺南市,安南區,學東里,348,1,1057,13,1070,1677,3,1,3,0,1,0,63.80
臺南市,安南區,公塭里,349,1,608,6,614,811,3,1,3,0,1,0,75.71
臺南市,安南區,佃東里,350,1,609,11,620,1044,3,1,3,0,1,0,59.39
臺南市,安南區,佃東里,351,1,672,13,685,1080,3,1,3,0,1,0,63.43
臺南市,安南區,佃西里,352,1,946,9,955,1511,3,1,3,0,1,0,63.20
臺南市,安南區,淵西里,353,1,705,15,720,1143,3,1,3,0,1,0,62.99
臺南市,安南區,淵西里,354,1,737,11,748,1236,3,1,3,0,1,0,60.52
臺南市,安南區,海西里,355,1,791,10,801,1238,3,1,3,0,1,0,64.70
臺南市,安南區,海西里,356,1,690,15,705,993,3,1,3,0,1,0,71.00
臺南市,安南區,海東里,357,1,1083,21,1104,1747,3,1,3,0,1,0,63.19
臺南市,安南區,海東里,358,1,807,12,819,1350,3,1,3,0,1,0,60.67
臺南市,安南區,溪心里,359,1,1360,9,1369,2304,3,1,3,0,1,0,59.42
臺南市,安南區,溪心里,360,1,707,8,715,1119,3,1,3,0,1,0,63.90
臺南市,安南區,淵東里,361,1,939,12,951,1494,3,1,3,0,1,0,63.65
臺南市,安南區,淵東里,362,1,752,12,764,1212,3,1,3,0,1,0,63.04
臺南市,安南區,淵中里,363,1,991,15,1006,1590,3,1,3,0,1,0,63.27
臺南市,安南區,淵中里,364,1,666,11,677,1118,3,1,3,0,1,0,60.55
臺南市,安南區,溪墘里,365,1,859,15,874,1356,3,1,3,0,1,0,64.45
臺南市,安南區,溪墘里,366,1,858,8,866,1381,3,1,3,0,1,0,62.71
臺南市,安南區,海佃里,367,1,1156,11,1167,1847,3,1,3,0,1,0,63.18
臺南市,安南區,海佃里,368,1,1209,18,1227,1899,3,1,3,0,1,0,64.61
臺南市,安南區,國安里,369,1,1035,19,1054,1572,3,1,3,0,1,0,67.05
臺南市,安南區,溪東里,370,1,482,8,490,743,3,1,3,0,1,0,65.95
臺南市,安南區,溪東里,371,1,1120,13,1133,1818,3,1,3,0,1,0,62.32
臺南市,安南區,安富里,372,1,1153,17,1170,1912,3,1,3,0,1,0,61.19
臺南市,安南區,安富里,373,1,1214,14,1228,2019,3,1,3,0,1,0,60.82
臺南市,安南區,幸福里,374,1,1191,15,1206,1870,3,1,3,0,1,0,64.49
臺南市,安南區,幸福里,375,1,923,10,933,1454,3,1,3,0,1,0,64.17
臺南市,安南區,海南里,376,1,594,4,598,975,3,1,3,0,1,0,61.33
臺南市,安南區,海南里,377,1,624,5,629,933,3,1,3,0,1,0,67.42
臺南市,安南區,城東里,378,1,882,13,895,1350,3,1,3,0,1,0,66.30
臺南市,安南區,城南里,379,1,1076,19,1095,1616,3,1,3,0,1,0,67.76
臺南市,安南區,城南里,380,1,501,5,506,694,3,1,3,0,1,0,72.91
臺南市,安南區,青草里,381,1,833,19,852,1170,3,1,3,0,1,0,72.82
臺南市,安南區,城西里,382,1,670,9,679,966,3,1,3,0,1,0,70.29
臺南市,安南區,城北里,383,1,827,9,836,1158,3,1,3,0,1,0,72.19
臺南市,安南區,城中里,384,1,674,7,681,828,3,1,3,0,1,0,82.25
臺南市,安南區,砂崙里,385,1,333,3,336,523,3,1,3,0,1,0,64.24
臺南市,安南區,砂崙里,386,1,307,5,312,436,3,1,3,0,1,0,71.56
臺南市,安南區,顯宮里,387,1,685,7,692,1029,3,1,3,0,1,0,67.25
臺南市,安南區,鹿耳里,388,1,413,8,421,617,3,1,3,0,1,0,68.23
臺南市,安南區,四草里,389,1,969,11,980,1402,3,1,3,0,1,0,69.90
臺南市,安南區,鹽田里,390,1,437,5,442,597,3,1,3,0,1,0,74.04
臺南市,安平區,石門里,391,1,965,6,971,1549,3,1,3,0,1,0,62.69
臺南市,安平區,石門里,392,1,1086,13,1099,1704,3,1,3,0,1,0,64.50
臺南市,安平區,石門里,393,1,1049,12,1061,1688,3,1,3,0,1,0,62.86
臺南市,安平區,校前里,394,1,527,9,536,781,3,1,3,0,1,0,68.63
臺南市,安平區,安中里,395,1,282,5,287,441,3,1,3,0,1,0,65.08
臺南市,安平區,菩薩里,396,1,241,1,242,340,3,1,3,0,1,0,71.18
臺南市,安平區,文朱里,397,1,247,1,248,331,3,1,3,0,1,0,74.92
臺南市,安平區,妙壽里,398,1,244,2,246,373,3,1,3,0,1,0,65.95
臺南市,安平區,海興里,399,1,569,3,572,823,3,1,3,0,1,0,69.50
臺南市,安平區,西門里,400,1,750,9,759,1071,3,1,3,0,1,0,70.87
臺南市,安平區,西門里,401,1,650,4,654,946,3,1,3,0,1,0,69.13
臺南市,安平區,金城里,402,1,913,14,927,1421,3,1,3,0,1,0,65.24
臺南市,安平區,漁光里,403,1,373,9,382,522,3,1,3,0,1,0,73.18
臺南市,安平區,億載里,404,1,703,4,707,1151,3,1,3,0,1,0,61.42
臺南市,安平區,平通里,405,1,981,12,993,1818,3,1,3,0,1,0,54.62
臺南市,安平區,平通里,406,1,998,12,1010,1698,3,1,3,0,1,0,59.48
臺南市,安平區,育平里,407,1,1241,7,1248,2270,3,1,3,0,1,0,54.98
臺南市,安平區,育平里,408,1,1015,13,1028,1915,3,1,3,0,1,0,53.68
臺南市,安平區,華平里,409,1,1005,9,1014,1626,3,1,3,0,1,0,62.36
臺南市,安平區,華平里,410,1,994,18,1012,1669,3,1,3,0,1,0,60.64
臺南市,安平區,國平里,411,1,703,3,706,1208,3,1,3,0,1,0,58.44
臺南市,安平區,國平里,412,1,828,5,833,1590,3,1,3,0,1,0,52.39
臺南市,安平區,怡平里,413,1,604,3,607,1094,3,1,3,0,1,0,55.48
臺南市,安平區,怡平里,414,1,619,9,628,1002,3,1,3,0,1,0,62.67
臺南市,安平區,建平里,415,1,658,8,666,1145,3,1,3,0,1,0,58.17
臺南市,安平區,建平里,416,1,853,9,862,1379,3,1,3,0,1,0,62.51
臺南市,安平區,文平里,417,1,811,5,816,1294,3,1,3,0,1,0,63.06
臺南市,安平區,文平里,418,1,734,12,746,1184,3,1,3,0,1,0,63.01
金門縣,金城鎮,東門里,1,1,1234,24,1258,1886,3,1,3,0,1,0,66.70
金門縣,金城鎮,南門里,2,1,592,18,610,931,3,1,3,0,1,0,65.52
金門縣,金城鎮,南門里,3,1,801,18,819,1235,3,1,3,0,1,0,66.32
金門縣,金城鎮,西門里,4,1,642,11,653,1045,3,1,3,0,1,0,62.49
金門縣,金城鎮,西門里,5,1,731,20,751,1186,3,1,3,0,1,0,63.32
金門縣,金城鎮,西門里,6,1,872,14,886,1328,3,1,3,0,1,0,66.72
金門縣,金城鎮,北門里,7,1,1010,15,1025,1547,3,1,3,0,1,0,66.26
金門縣,金城鎮,賢庵里,8,1,764,23,787,1221,3,1,3,0,1,0,64.46
金門縣,金城鎮,金水里,9,1,443,11,454,664,3,1,3,0,1,0,68.37
金門縣,金城鎮,古城里,10,1,849,23,872,1290,3,1,3,0,1,0,67.60
金門縣,金城鎮,珠沙里,11,1,436,7,443,721,3,1,3,0,1,0,61.44
金門縣,金寧鄉,古寧村,12,1,797,18,815,1227,3,1,3,0,1,0,66.42
金門縣,金寧鄉,安美村,13,1,944,33,977,1512,3,1,3,0,1,0,64.62
金門縣,金寧鄉,湖埔村,14,1,903,22,925,1350,3,1,3,0,1,0,68.52
金門縣,金寧鄉,榜林村,15,1,946,29,975,1485,3,1,3,0,1,0,65.66
金門縣,金寧鄉,盤山村,16,1,692,19,711,1190,3,1,3,0,1,0,59.75
金門縣,金寧鄉,后盤村,17,1,305,11,316,516,3,1,3,0,1,0,61.24
金門縣,金湖鎮,新市里,18,1,574,8,582,858,3,1,3,0,1,0,67.83
金門縣,金湖鎮,新市里,19,1,604,8,612,944,3,1,3,0,1,0,64.83
金門縣,金湖鎮,山外里,20,1,852,19,871,1353,3,1,3,0,1,0,64.38
金門縣,金湖鎮,溪湖里,21,1,354,15,369,564,3,1,3,0,1,0,65.43
金門縣,金湖鎮,蓮庵里,22,1,358,7,365,571,3,1,3,0,1,0,63.92
金門縣,金湖鎮,料羅里,23,1,377,12,389,607,3,1,3,0,1,0,64.09
金門縣,金湖鎮,新湖里,24,1,1037,24,1061,1583,3,1,3,0,1,0,67.02
金門縣,金湖鎮,正義里,25,1,585,28,613,863,3,1,3,0,1,0,71.03
金門縣,金湖鎮,瓊林里,26,1,834,18,852,1193,3,1,3,0,1,0,71.42
金門縣,金沙鎮,汶沙里,27,1,582,12,594,940,3,1,3,0,1,0,63.19
金門縣,金沙鎮,汶沙里,28,1,611,22,633,1010,3,1,3,0,1,0,62.67
金門縣,金沙鎮,何斗里,29,1,486,13,499,772,3,1,3,0,1,0,64.64
金門縣,金沙鎮,浦山里,30,1,555,21,576,862,3,1,3,0,1,0,66.82
金門縣,金沙鎮,西園里,31,1,302,13,315,558,3,1,3,0,1,0,56.45
金門縣,金沙鎮,官嶼里,32,1,438,6,444,723,3,1,3,0,1,0,61.41
金門縣,金沙鎮,三山里,33,1,433,10,443,723,3,1,3,0,1,0,61.27
金門縣,金沙鎮,大洋里,34,1,295,7,302,459,3,1,3,0,1,0,65.80
金門縣,金沙鎮,光前里,35,1,484,13,497,804,3,1,3,0,1,0,61.82
金門縣,烈嶼鄉,林湖村,36,1,707,26,733,1148,3,1,3,0,1,0,63.85
金門縣,烈嶼鄉,黃埔村,37,1,276,6,282,522,3,1,3,0,1,0,54.02
金門縣,烈嶼鄉,西口村,38,1,400,19,419,747,3,1,3,0,1,0,56.09
金門縣,烈嶼鄉,上林村,39,1,284,12,296,515,3,1,3,0,1,0,57.48
金門縣,烈嶼鄉,上歧村,40,1,599,22,621,987,3,1,3,0,1,0,62.92
金門縣,烏坵鄉,大坵村、小坵村,41,1,37,0,37,282,3,1,3,0,1,0,13.12
連江縣,南竿鄉,介壽村,1,1,1026,16,1042,1357,3,1,3,0,1,0,76.79
連江縣,南竿鄉,福沃村、復興村,2,1,467,12,479,578,3,1,3,0,1,0,82.87
連江縣,南竿鄉,仁愛村、馬祖村、津沙村、珠螺村、清水村、四維村,3,1,357,10,367,486,3,1,3,0,1,0,75.51
連江縣,北竿鄉,后沃村、橋仔村、塘岐村,4,1,1021,33,1054,1327,3,1,3,0,1,0,79.43
連江縣,北竿鄉,白沙村、板里村、芹壁村,5,1,598,13,611,846,3,1,3,0,1,0,72.22
連江縣,莒光鄉,青帆村、田沃村、西坵村,6,1,315,9,324,424,3,1,3,0,1,0,76.42
連江縣,莒光鄉,大坪村、福正村,7,1,227,3,230,385,3,1,3,0,1,0,59.74
連江縣,東引鄉,樂華村,8,1,169,6,175,252,3,1,3,0,1,0,69.44
連江縣,東引鄉,中柳村,9,1,372,17,389,554,3,1,3,0,1,0,70.22
