CountyCityName,TownshipName,VillageName,PollStationNo,DistrictName,BallotsAccepted,BallotsRejected,BallotsCast,Voters,CandidateCounts,ElectedCounts,CandidateMaleCounts,CandidateFemaleCounts,ElectedMaleCounts,ElectedFemaleCounts,BallotsRate
全國,,,0,0,9572532,77336,9649868,16258979,368,168,306,62,138,30,59.35
臺北市,,,0,0,1197619,6666,1204285,1965286,52,20,43,9,15,5,61.28
臺北市,,,0,0,609374,3341,612715,1003742,22,10,18,4,8,2,61.04
臺北市,,,0,0,588245,3325,591570,961544,30,10,25,5,7,3,61.52
高雄市,,,0,2,636090,3955,640045,1112501,25,11,22,3,10,1,57.53
高雄市,,,0,2,363585,2186,365771,635837,14,6,12,2,5,1,57.53
高雄市,,,0,2,272505,1769,274274,476664,11,5,10,1,5,0,57.54
臺北縣,,,0,3,1512504,12053,1524557,2679770,53,28,45,8,23,5,56.89
臺北縣,,,0,3,431598,3551,435149,783824,14,8,13,1,7,1,55.52
臺北縣,,,0,3,549524,4594,554118,981318,19,11,16,3,9,2,56.47
臺北縣,,,0,3,531382,3908,535290,914628,20,9,16,4,7,2,58.53
宜蘭縣,,,0,0,184661,1349,186010,329857,4,3,3,1,3,0,56.39
宜蘭縣,,,0,0,184661,1349,186010,329857,4,3,3,1,3,0,56.39
桃園縣,,,0,0,736843,6811,743654,1263071,28,13,21,7,10,3,58.88
桃園縣,,,0,0,736843,6811,743654,1263071,28,13,21,7,10,3,58.88
新竹縣,,,0,0,188287,2032,190319,315470,5,3,4,1,3,0,60.33
苗栗縣,,,0,0,239807,2162,241969,402651,10,4,10,0,4,0,60.09
臺中縣,,,0,0,632372,6949,639321,1068959,22,11,19,3,9,2,59.81
彰化縣,,,0,0,642945,7181,650126,950566,19,10,16,3,9,1,68.39
南投縣,,,0,0,215726,1677,217403,379609,11,4,11,0,4,0,57.27
雲林縣,,,0,0,349862,3451,353313,551467,18,6,14,4,4,2,64.07
嘉義縣,,,0,0,250266,2520,252786,417378,11,4,10,1,3,1,60.57
臺南縣,,,0,0,508166,3874,512040,825961,16,8,12,4,7,1,61.99
高雄縣,,,0,0,545184,4690,549874,910134,16,9,13,3,7,2,60.42
屏東縣,,,0,0,393749,2537,396286,631058,11,6,9,2,5,1,62.80
臺東縣,,,0,0,61988,355,62343,121819,3,1,2,1,1,0,51.18
花蓮縣,,,0,0,95768,822,96590,197038,6,2,6,0,2,0,49.02
澎湖縣,,,0,0,37833,332,38165,69339,3,1,3,0,1,0,55.04
基隆市,,,0,0,150669,1247,151916,285671,5,3,3,2,2,1,53.18
新竹市,,,0,0,147028,1065,148093,272074,9,3,8,1,3,0,54.43
臺中市,,,0,0,398166,2791,400957,712274,18,8,13,5,6,2,56.29
嘉義市,,,0,0,103207,629,103836,193209,4,2,3,1,1,1,53.74
臺南市,,,0,0,316895,1871,318766,550411,12,6,9,3,4,2,57.91
金門縣,,,0,0,22446,270,22716,46449,4,1,4,0,1,0,48.91
連江縣,,,0,0,4451,47,4498,6957,3,1,3,0,1,0,64.65
新竹縣,,,0,0,188287,2032,190319,315470,5,3,4,1,3,0,60.33
苗栗縣,,,0,0,239807,2162,241969,402651,10,4,10,0,4,0,60.09
臺中縣,,,0,0,632372,6949,639321,1068959,22,11,19,3,9,2,59.81
彰化縣,,,0,0,642945,7181,650126,950566,19,10,16,3,9,1,68.39
南投縣,,,0,0,215726,1677,217403,379609,11,4,11,0,4,0,57.27
雲林縣,,,0,0,349862,3451,353313,551467,18,6,14,4,4,2,64.07
嘉義縣,,,0,0,250266,2520,252786,417378,11,4,10,1,3,1,60.57
臺南縣,,,0,0,508166,3874,512040,825961,16,8,12,4,7,1,61.99
高雄縣,,,0,0,545184,4690,549874,910134,16,9,13,3,7,2,60.42
屏東縣,,,0,0,393749,2537,396286,631058,11,6,9,2,5,1,62.80
臺東縣,,,0,0,61988,355,62343,121819,3,1,2,1,1,0,51.18
花蓮縣,,,0,0,95768,822,96590,197038,6,2,6,0,2,0,49.02
澎湖縣,,,0,0,37833,332,38165,69339,3,1,3,0,1,0,55.04
基隆市,,,0,0,150669,1247,151916,285671,5,3,3,2,2,1,53.18
新竹市,,,0,0,147028,1065,148093,272074,9,3,8,1,3,0,54.43
臺中市,,,0,0,398166,2791,400957,712274,18,8,13,5,6,2,56.29
嘉義市,,,0,0,103207,629,103836,193209,4,2,3,1,1,1,53.74
臺南市,,,0,0,316895,1871,318766,550411,12,6,9,3,4,2,57.91
金門縣,,,0,0,22446,270,22716,46449,4,1,4,0,1,0,48.91
連江縣,,,0,0,4451,47,4498,6957,3,1,3,0,1,0,64.65
臺北市,北投區,,0,1,112522,627,113149,185644,3,1,3,0,1,0,60.95
臺北市,士林區,,0,1,131957,751,132708,218248,3,1,3,0,1,0,60.81
臺北市,內湖區,,0,1,112055,601,112656,185409,3,1,3,0,1,0,60.76
臺北市,南港區,,0,1,50487,339,50826,83275,3,1,3,0,1,0,61.03
臺北市,松山區,,0,1,93833,479,94312,152857,3,1,3,0,1,0,61.70
臺北市,信義區,,0,1,108520,544,109064,178309,3,1,3,0,1,0,61.17
臺北市,中山區,,0,2,98874,595,99469,166863,3,1,3,0,1,0,59.61
臺北市,大同區,,0,2,58848,428,59276,98182,3,1,3,0,1,0,60.37
臺北市,中正區,,0,2,72479,395,72874,117025,3,1,3,0,1,0,62.27
臺北市,萬華區,,0,2,94218,613,94831,154400,3,1,3,0,1,0,61.42
臺北市,大安區,,0,2,145272,675,145947,235791,3,1,3,0,1,0,61.90
臺北市,文山區,,0,2,118554,619,119173,189283,3,1,3,0,1,0,62.96
高雄市,鹽埕區,,0,1,14134,77,14211,23352,3,1,3,0,1,0,60.86
高雄市,鼓山區,,0,1,50214,318,50532,83957,3,1,3,0,1,0,60.19
高雄市,旗津區,,0,1,12430,102,12532,22801,3,1,3,0,1,0,54.96
高雄市,左營區,,0,1,73572,399,73971,128397,3,1,3,0,1,0,57.61
高雄市,楠梓區,,0,1,65134,413,65547,113346,3,1,3,0,1,0,57.83
高雄市,三民區,,0,1,148101,877,148978,263984,3,1,3,0,1,0,56.43
高雄市,新興區,,0,2,26541,157,26698,46181,3,1,3,0,1,0,57.81
高雄市,前金區,,0,2,14043,81,14124,24880,3,1,3,0,1,0,56.77
高雄市,苓雅區,,0,2,83992,487,84479,147697,3,1,3,0,1,0,57.20
高雄市,前鎮區,,0,2,87174,678,87852,148997,3,1,3,0,1,0,58.96
高雄市,小港區,,0,2,60755,366,61121,108909,3,1,3,0,1,0,56.12
臺北縣,板橋市,,0,1,221664,1812,223476,396739,3,1,3,0,1,0,56.33
臺北縣,土城市,,0,1,88129,682,88811,162696,3,1,3,0,1,0,54.59
臺北縣,樹林市,,0,1,58022,519,58541,108597,3,1,3,0,1,0,53.91
臺北縣,鶯歌鎮,,0,1,31767,285,32052,57091,3,1,3,0,1,0,56.14
臺北縣,三峽鎮,,0,1,32016,253,32269,58701,3,1,3,0,1,0,54.97
臺北縣,三重市,,0,2,163385,1483,164868,283062,3,1,3,0,1,0,58.24
臺北縣,蘆洲市,,0,2,66222,537,66759,123571,3,1,3,0,1,0,54.02
臺北縣,新莊市,,0,2,148060,1125,149185,268483,3,1,3,0,1,0,55.57
臺北縣,五股鄉,,0,2,28841,222,29063,51348,3,1,3,0,1,0,56.60
臺北縣,泰山鄉,,0,2,27357,226,27583,47532,3,1,3,0,1,0,58.03
臺北縣,林口鄉,,0,2,20716,181,20897,36857,3,1,3,0,1,0,56.70
臺北縣,淡水鎮,,0,2,50047,428,50475,92064,3,1,3,0,1,0,54.83
臺北縣,八里鄉,,0,2,12490,115,12605,22258,3,1,3,0,1,0,56.63
臺北縣,三芝鄉,,0,2,9499,67,9566,17011,3,1,3,0,1,0,56.23
臺北縣,石門鄉,,0,2,4926,50,4976,8511,3,1,3,0,1,0,58.47
臺北縣,金山鄉,,0,2,9642,77,9719,16079,3,1,3,0,1,0,60.45
臺北縣,萬里鄉,,0,2,8339,83,8422,14542,3,1,3,0,1,0,57.92
臺北縣,中和市,,0,3,183200,1403,184603,310099,3,1,3,0,1,0,59.53
臺北縣,永和市,,0,3,104754,702,105456,174459,3,1,3,0,1,0,60.45
臺北縣,新店市,,0,3,126732,752,127484,214686,3,1,3,0,1,0,59.38
臺北縣,深坑鄉,,0,3,8354,67,8421,15589,3,1,3,0,1,0,54.02
臺北縣,石碇鄉,,0,3,3475,30,3505,6000,3,1,3,0,1,0,58.42
臺北縣,坪林鄉,,0,3,2970,22,2992,5133,3,1,3,0,1,0,58.29
臺北縣,烏來鄉,,0,3,1253,9,1262,2153,3,1,3,0,1,0,58.62
臺北縣,汐止市,,0,3,67747,654,68401,128479,3,1,3,0,1,0,53.24
臺北縣,瑞芳鎮,,0,3,18964,145,19109,33746,3,1,3,0,1,0,56.63
臺北縣,平溪鄉,,0,3,2979,26,3005,4894,3,1,3,0,1,0,61.40
臺北縣,雙溪鄉,,0,3,4709,43,4752,8254,3,1,3,0,1,0,57.57
臺北縣,貢寮鄉,,0,3,6245,55,6300,11136,3,1,3,0,1,0,56.57
宜蘭縣,宜蘭市,,0,1,37409,253,37662,66387,3,1,3,0,1,0,56.73
宜蘭縣,羅東鎮,,0,1,27368,199,27567,50152,3,1,3,0,1,0,54.97
宜蘭縣,蘇澳鎮,,0,1,18131,133,18264,33261,3,1,3,0,1,0,54.91
宜蘭縣,頭城鎮,,0,1,13845,100,13945,24030,3,1,3,0,1,0,58.03
宜蘭縣,礁溪鄉,,0,1,15966,126,16092,27513,3,1,3,0,1,0,58.49
宜蘭縣,壯圍鄉,,0,1,11021,62,11083,19258,3,1,3,0,1,0,57.55
宜蘭縣,員山鄉,,0,1,13435,99,13534,24378,3,1,3,0,1,0,55.52
宜蘭縣,冬山鄉,,0,1,21265,153,21418,38037,3,1,3,0,1,0,56.31
宜蘭縣,五結鄉,,0,1,16087,130,16217,28636,3,1,3,0,1,0,56.63
宜蘭縣,三星鄉,,0,1,9312,86,9398,16506,3,1,3,0,1,0,56.94
宜蘭縣,大同鄉,,0,1,516,5,521,1008,3,1,3,0,1,0,51.69
宜蘭縣,南澳鄉,,0,1,306,3,309,691,3,1,3,0,1,0,44.72
桃園縣,桃園市,,0,1,139853,1048,140901,250605,3,1,3,0,1,0,56.22
桃園縣,龜山鄉,,0,1,48488,498,48986,84967,3,1,3,0,1,0,57.65
桃園縣,八德市,,0,1,67672,758,68430,117642,3,1,3,0,1,0,58.17
桃園縣,蘆竹鄉,,0,1,43353,437,43790,77633,3,1,3,0,1,0,56.41
桃園縣,大園鄉,,0,1,32408,322,32730,53405,3,1,3,0,1,0,61.29
桃園縣,大溪鎮,,0,1,35165,354,35519,57873,3,1,3,0,1,0,61.37
桃園縣,復興鄉,,0,1,1536,13,1549,2757,3,1,3,0,1,0,56.18
桃園縣,中壢市,,0,1,144051,1213,145264,241429,3,1,3,0,1,0,60.17
桃園縣,平鎮市,,0,1,78952,750,79702,134742,3,1,3,0,1,0,59.15
桃園縣,楊梅鎮,,0,1,53900,591,54491,92488,3,1,3,0,1,0,58.92
桃園縣,龍潭鄉,,0,1,43803,401,44204,75328,3,1,3,0,1,0,58.68
桃園縣,新屋鄉,,0,1,23239,181,23420,35470,3,1,3,0,1,0,66.03
桃園縣,觀音鄉,,0,1,24423,245,24668,38732,3,1,3,0,1,0,63.69
新竹縣,竹北市,,0,1,41410,366,41776,70140,3,1,3,0,1,0,59.56
新竹縣,竹東鎮,,0,1,36270,370,36640,63278,3,1,3,0,1,0,57.90
新竹縣,新埔鎮,,0,1,17018,204,17222,26931,3,1,3,0,1,0,63.95
新竹縣,關西鎮,,0,1,15004,190,15194,23858,3,1,3,0,1,0,63.69
新竹縣,湖口鄉,,0,1,28525,360,28885,48781,3,1,3,0,1,0,59.21
新竹縣,新豐鄉,,0,1,19069,193,19262,33089,3,1,3,0,1,0,58.21
新竹縣,芎林鄉,,0,1,9248,103,9351,14823,3,1,3,0,1,0,63.08
新竹縣,橫山鄉,,0,1,7070,73,7143,11017,3,1,3,0,1,0,64.84
新竹縣,北埔鄉,,0,1,4883,67,4950,7754,3,1,3,0,1,0,63.84
新竹縣,寶山鄉,,0,1,5786,50,5836,9523,3,1,3,0,1,0,61.28
新竹縣,峨眉鄉,,0,1,3311,45,3356,4906,3,1,3,0,1,0,68.41
新竹縣,尖石鄉,,0,1,510,10,520,982,3,1,3,0,1,0,52.95
新竹縣,五峰鄉,,0,1,183,1,184,388,3,1,3,0,1,0,47.42
苗栗縣,苗栗市,,0,1,38447,340,38787,66119,3,1,3,0,1,0,58.66
苗栗縣,苑裡鎮,,0,1,21398,197,21595,35470,3,1,3,0,1,0,60.88
苗栗縣,通霄鎮,,0,1,18511,158,18669,30002,3,1,3,0,1,0,62.23
苗栗縣,竹南鎮,,0,1,29370,256,29626,50747,3,1,3,0,1,0,58.38
苗栗縣,頭份鎮,,0,1,37364,321,37685,64496,3,1,3,0,1,0,58.43
苗栗縣,後龍鎮,,0,1,18767,139,18906,30782,3,1,3,0,1,0,61.42
苗栗縣,卓蘭鎮,,0,1,9072,99,9171,14429,3,1,3,0,1,0,63.56
苗栗縣,大湖鄉,,0,1,7591,68,7659,12603,3,1,3,0,1,0,60.77
苗栗縣,公館鄉,,0,1,14645,144,14789,25009,3,1,3,0,1,0,59.13
苗栗縣,銅鑼鄉,,0,1,9077,74,9151,15072,3,1,3,0,1,0,60.72
苗栗縣,南庄鄉,,0,1,4387,42,4429,7531,3,1,3,0,1,0,58.81
苗栗縣,頭屋鄉,,0,1,5844,59,5903,9208,3,1,3,0,1,0,64.11
苗栗縣,三義鄉,,0,1,8053,85,8138,12920,3,1,3,0,1,0,62.99
苗栗縣,西湖鄉,,0,1,3899,42,3941,6492,3,1,3,0,1,0,60.71
苗栗縣,造橋鄉,,0,1,6347,55,6402,10437,3,1,3,0,1,0,61.34
苗栗縣,三灣鄉,,0,1,3609,47,3656,5737,3,1,3,0,1,0,63.73
苗栗縣,獅潭鄉,,0,1,2533,29,2562,4160,3,1,3,0,1,0,61.59
苗栗縣,泰安鄉,,0,1,893,7,900,1437,3,1,3,0,1,0,62.63
臺中縣,豐原市,,0,1,65804,717,66521,114878,3,1,3,0,1,0,57.91
臺中縣,大里市,,0,1,70684,640,71324,126058,3,1,3,0,1,0,56.58
臺中縣,太平市,,0,1,69442,665,70107,118524,3,1,3,0,1,0,59.15
臺中縣,東勢鎮,,0,1,24550,294,24844,41726,3,1,3,0,1,0,59.54
臺中縣,大甲鎮,,0,1,33516,388,33904,55282,3,1,3,0,1,0,61.33
臺中縣,清水鎮,,0,1,37962,411,38373,61357,3,1,3,0,1,0,62.54
臺中縣,沙鹿鎮,,0,1,31944,354,32298,52343,3,1,3,0,1,0,61.70
臺中縣,梧棲鎮,,0,1,20895,268,21163,36377,3,1,3,0,1,0,58.18
臺中縣,后里鄉,,0,1,25223,326,25549,39602,3,1,3,0,1,0,64.51
臺中縣,神岡鄉,,0,1,27231,351,27582,45237,3,1,3,0,1,0,60.97
臺中縣,潭子鄉,,0,1,36938,364,37302,65086,3,1,3,0,1,0,57.31
臺中縣,大雅鄉,,0,1,32207,392,32599,56578,3,1,3,0,1,0,57.62
臺中縣,新社鄉,,0,1,12316,113,12429,19709,3,1,3,0,1,0,63.06
臺中縣,石岡鄉,,0,1,7226,114,7340,11731,3,1,3,0,1,0,62.57
臺中縣,外埔鄉,,0,1,13645,192,13837,22557,3,1,3,0,1,0,61.34
臺中縣,大安鄉,,0,1,9636,112,9748,15514,3,1,3,0,1,0,62.83
臺中縣,烏日鄉,,0,1,28437,319,28756,46446,3,1,3,0,1,0,61.91
臺中縣,大肚鄉,,0,1,24421,277,24698,38974,3,1,3,0,1,0,63.37
臺中縣,龍井鄉,,0,1,28450,304,28754,47905,3,1,3,0,1,0,60.02
臺中縣,霧峰鄉,,0,1,28748,329,29077,47065,3,1,3,0,1,0,61.78
臺中縣,和平鄉,,0,1,3097,19,3116,6010,3,1,3,0,1,0,51.85
彰化縣,彰化市,,0,1,109216,1084,110300,165422,3,1,3,0,1,0,66.68
彰化縣,花壇鄉,,0,1,22493,233,22726,33282,3,1,3,0,1,0,68.28
彰化縣,芬園鄉,,0,1,13616,202,13818,19455,3,1,3,0,1,0,71.03
彰化縣,鹿港鎮,,0,1,41694,425,42119,59915,3,1,3,0,1,0,70.30
彰化縣,褔興鄉,,0,1,25384,355,25739,34806,3,1,3,0,1,0,73.95
彰化縣,秀水鄉,,0,1,19108,242,19350,27082,3,1,3,0,1,0,71.45
彰化縣,和美鎮,,0,1,42770,472,43242,62752,3,1,3,0,1,0,68.91
彰化縣,線西鄉,,0,1,8543,114,8657,12230,3,1,3,0,1,0,70.78
彰化縣,伸港鄉,,0,1,16897,211,17108,24515,3,1,3,0,1,0,69.79
彰化縣,員林鎮,,0,1,57535,640,58175,89772,3,1,3,0,1,0,64.80
彰化縣,大村鄉,,0,1,17893,174,18067,26476,3,1,3,0,1,0,68.24
彰化縣,永靖鄉,,0,1,20226,226,20452,29280,3,1,3,0,1,0,69.85
彰化縣,溪湖鎮,,0,1,27137,254,27391,39219,3,1,3,0,1,0,69.84
彰化縣,埔鹽鄉,,0,1,19632,240,19872,25986,3,1,3,0,1,0,76.47
彰化縣,埔心鄉,,0,1,17788,199,17987,25937,3,1,3,0,1,0,69.35
彰化縣,田中鎮,,0,1,22140,239,22379,34016,3,1,3,0,1,0,65.79
彰化縣,社頭鄉,,0,1,22524,253,22777,32875,3,1,3,0,1,0,69.28
彰化縣,二水鄉,,0,1,9679,100,9779,13769,3,1,3,0,1,0,71.02
彰化縣,北斗鎮,,0,1,16003,179,16182,24180,3,1,3,0,1,0,66.92
彰化縣,溪州鄉,,0,1,15792,203,15995,24625,3,1,3,0,1,0,64.95
彰化縣,田尾鄉,,0,1,14632,165,14797,21440,3,1,3,0,1,0,69.02
彰化縣,埤頭鄉,,0,1,15431,193,15624,23957,3,1,3,0,1,0,65.22
彰化縣,二林鎮,,0,1,28714,372,29086,41111,3,1,3,0,1,0,70.75
彰化縣,芳苑鄉,,0,1,19017,202,19219,29317,3,1,3,0,1,0,65.56
彰化縣,大城鄉,,0,1,10179,112,10291,16140,3,1,3,0,1,0,63.76
彰化縣,竹塘鄉,,0,1,8902,92,8994,13007,3,1,3,0,1,0,69.15
南投縣,南投市,,0,1,45053,322,45375,74885,3,1,3,0,1,0,60.59
南投縣,埔里鎮,,0,1,33491,250,33741,62585,3,1,3,0,1,0,53.91
南投縣,草屯鎮,,0,1,42038,323,42361,71485,3,1,3,0,1,0,59.26
南投縣,竹山鎮,,0,1,25098,175,25273,44723,3,1,3,0,1,0,56.51
南投縣,集集鎮,,0,1,5438,38,5476,9350,3,1,3,0,1,0,58.57
南投縣,名間鄉,,0,1,18068,173,18241,31719,3,1,3,0,1,0,57.51
南投縣,鹿谷鄉,,0,1,9169,53,9222,15557,3,1,3,0,1,0,59.28
南投縣,中寮鄉,,0,1,7641,71,7712,13416,3,1,3,0,1,0,57.48
南投縣,魚池鄉,,0,1,7069,65,7134,13399,3,1,3,0,1,0,53.24
南投縣,國姓鄉,,0,1,8868,101,8969,17190,3,1,3,0,1,0,52.18
南投縣,水里鄉,,0,1,9159,66,9225,16547,3,1,3,0,1,0,55.75
南投縣,信義鄉,,0,1,3337,32,3369,6026,3,1,3,0,1,0,55.91
南投縣,仁愛鄉,,0,1,1297,8,1305,2727,3,1,3,0,1,0,47.85
雲林縣,斗六市,,0,1,48167,502,48669,73573,3,1,3,0,1,0,66.15
雲林縣,斗南鎮,,0,1,23068,189,23257,35313,3,1,3,0,1,0,65.86
雲林縣,虎尾鎮,,0,1,31522,332,31854,50182,3,1,3,0,1,0,63.48
雲林縣,西螺鎮,,0,1,23866,232,24098,36423,3,1,3,0,1,0,66.16
雲林縣,土庫鎮,,0,1,15305,163,15468,23967,3,1,3,0,1,0,64.54
雲林縣,北港鎮,,0,1,21223,209,21432,33971,3,1,3,0,1,0,63.09
雲林縣,古坑鄉,,0,1,16794,208,17002,26725,3,1,3,0,1,0,63.62
雲林縣,大埤鄉,,0,1,11005,117,11122,17125,3,1,3,0,1,0,64.95
雲林縣,莿桐鄉,,0,1,15814,147,15961,23561,3,1,3,0,1,0,67.74
雲林縣,林內鄉,,0,1,10392,100,10492,15244,3,1,3,0,1,0,68.83
雲林縣,二崙鄉,,0,1,15433,111,15544,24317,3,1,3,0,1,0,63.92
雲林縣,崙背鄉,,0,1,14052,172,14224,22077,3,1,3,0,1,0,64.43
雲林縣,麥寮鄉,,0,1,14950,146,15096,24104,3,1,3,0,1,0,62.63
雲林縣,東勢鄉,,0,1,8993,77,9070,14452,3,1,3,0,1,0,62.76
雲林縣,褒忠鄉,,0,1,7872,62,7934,11519,3,1,3,0,1,0,68.88
雲林縣,台西鄉,,0,1,13196,123,13319,21837,3,1,3,0,1,0,60.99
雲林縣,元長鄉,,0,1,14975,159,15134,24570,3,1,3,0,1,0,61.60
雲林縣,四湖鄉,,0,1,12598,131,12729,22862,3,1,3,0,1,0,55.68
雲林縣,口湖鄉,,0,1,14897,120,15017,25034,3,1,3,0,1,0,59.99
雲林縣,水林鄉,,0,1,15740,151,15891,24611,3,1,3,0,1,0,64.57
嘉義縣,太保市,,0,1,14350,148,14498,24298,3,1,3,0,1,0,59.67
嘉義縣,朴子市,,0,1,19709,204,19913,32107,3,1,3,0,1,0,62.02
嘉義縣,布袋鎮,,0,1,15164,185,15349,25149,3,1,3,0,1,0,61.03
嘉義縣,大林鎮,,0,1,16190,133,16323,26496,3,1,3,0,1,0,61.61
嘉義縣,民雄鄉,,0,1,30178,305,30483,52454,3,1,3,0,1,0,58.11
嘉義縣,溪口鄉,,0,1,7844,67,7911,13422,3,1,3,0,1,0,58.94
嘉義縣,新港鄉,,0,1,16333,137,16470,26622,3,1,3,0,1,0,61.87
嘉義縣,六腳鄉,,0,1,12947,127,13074,22404,3,1,3,0,1,0,58.36
嘉義縣,東石鄉,,0,1,14172,153,14325,23627,3,1,3,0,1,0,60.63
嘉義縣,義竹鄉,,0,1,12183,146,12329,17744,3,1,3,0,1,0,69.48
嘉義縣,鹿草鄉,,0,1,9270,81,9351,14139,3,1,3,0,1,0,66.14
嘉義縣,水上鄉,,0,1,26017,273,26290,41484,3,1,3,0,1,0,63.37
嘉義縣,中埔鄉,,0,1,20129,200,20329,35638,3,1,3,0,1,0,57.04
嘉義縣,竹崎鄉,,0,1,17778,190,17968,30555,3,1,3,0,1,0,58.81
嘉義縣,梅山鄉,,0,1,10144,106,10250,17345,3,1,3,0,1,0,59.09
嘉義縣,番路鄉,,0,1,5357,47,5404,9173,3,1,3,0,1,0,58.91
嘉義縣,大埔鄉,,0,1,1521,9,1530,2829,3,1,3,0,1,0,54.08
嘉義縣,阿里山鄉,,0,1,980,9,989,1892,3,1,3,0,1,0,52.27
臺南縣,新營市,,0,1,32935,271,33206,56382,3,1,3,0,1,0,58.89
臺南縣,鹽水鎮,,0,1,13623,114,13737,21810,3,1,3,0,1,0,62.98
臺南縣,白河鎮,,0,1,16344,141,16485,26246,3,1,3,0,1,0,62.81
臺南縣,柳營鄉,,0,1,11596,90,11686,18298,3,1,3,0,1,0,63.86
臺南縣,後壁鄉,,0,1,13646,128,13774,21698,3,1,3,0,1,0,63.48
臺南縣,東山鄉,,0,1,10731,91,10822,19242,3,1,3,0,1,0,56.24
臺南縣,麻豆鎮,,0,1,23726,154,23880,35319,3,1,3,0,1,0,67.61
臺南縣,下營鄉,,0,1,13779,83,13862,21000,3,1,3,0,1,0,66.01
臺南縣,六甲鄉,,0,1,11479,106,11585,18319,3,1,3,0,1,0,63.24
臺南縣,官田鄉,,0,1,11564,92,11656,17809,3,1,3,0,1,0,65.45
臺南縣,大內鄉,,0,1,5937,50,5987,9551,3,1,3,0,1,0,62.68
臺南縣,佳里鎮,,0,1,27093,175,27268,43569,3,1,3,0,1,0,62.59
臺南縣,學甲鎮,,0,1,14330,97,14427,22297,3,1,3,0,1,0,64.70
臺南縣,西港鄉,,0,1,12862,128,12990,19202,3,1,3,0,1,0,67.65
臺南縣,七股鄉,,0,1,13153,102,13255,20047,3,1,3,0,1,0,66.12
臺南縣,將軍鄉,,0,1,11790,74,11864,18385,3,1,3,0,1,0,64.53
臺南縣,北門鄉,,0,1,6872,54,6926,10360,3,1,3,0,1,0,66.85
臺南縣,新化鎮,,0,1,20737,156,20893,33505,3,1,3,0,1,0,62.36
臺南縣,善化鎮,,0,1,19417,191,19608,31218,3,1,3,0,1,0,62.81
臺南縣,新市鄉,,0,1,15527,102,15629,25217,3,1,3,0,1,0,61.98
臺南縣,安定鄉,,0,1,14603,146,14749,22334,3,1,3,0,1,0,66.04
臺南縣,山上鄉,,0,1,4110,30,4140,6297,3,1,3,0,1,0,65.75
臺南縣,玉井鄉,,0,1,8092,64,8156,12750,3,1,3,0,1,0,63.97
臺南縣,楠西鄉,,0,1,5535,51,5586,8967,3,1,3,0,1,0,62.30
臺南縣,南化鄉,,0,1,4852,24,4876,7295,3,1,3,0,1,0,66.84
臺南縣,左鎮鄉,,0,1,3155,26,3181,4836,3,1,3,0,1,0,65.78
臺南縣,仁德鄉,,0,1,30850,232,31082,50983,3,1,3,0,1,0,60.97
臺南縣,歸仁鄉,,0,1,28353,185,28538,45953,3,1,3,0,1,0,62.10
臺南縣,關廟鄉,,0,1,18948,163,19111,28840,3,1,3,0,1,0,66.27
臺南縣,龍崎鄉,,0,1,2555,18,2573,3761,3,1,3,0,1,0,68.41
臺南縣,永康市,,0,1,79972,536,80508,144471,3,1,3,0,1,0,55.73
高雄縣,鳳山市,,0,1,137424,980,138404,243247,3,1,3,0,1,0,56.90
高雄縣,林園鄉,,0,1,30646,298,30944,50706,3,1,3,0,1,0,61.03
高雄縣,大寮鄉,,0,1,48515,447,48962,81788,3,1,3,0,1,0,59.86
高雄縣,大樹鄉,,0,1,21467,160,21627,33680,3,1,3,0,1,0,64.21
高雄縣,大社鄉,,0,1,14881,133,15014,24177,3,1,3,0,1,0,62.10
高雄縣,仁武鄉,,0,1,25367,234,25601,43528,3,1,3,0,1,0,58.82
高雄縣,鳥松鄉,,0,1,18349,148,18497,30834,3,1,3,0,1,0,59.99
高雄縣,岡山鎮,,0,1,42315,342,42657,68767,3,1,3,0,1,0,62.03
高雄縣,橋頭鄉,,0,1,18146,163,18309,28283,3,1,3,0,1,0,64.73
高雄縣,燕巢鄉,,0,1,15182,152,15334,23988,3,1,3,0,1,0,63.92
高雄縣,田寮鄉,,0,1,5085,43,5128,7556,3,1,3,0,1,0,67.87
高雄縣,阿蓮鄉,,0,1,13321,141,13462,22371,3,1,3,0,1,0,60.18
高雄縣,路竹鄉,,0,1,24921,310,25231,39481,3,1,3,0,1,0,63.91
高雄縣,湖內鄉,,0,1,13207,125,13332,21651,3,1,3,0,1,0,61.58
高雄縣,茄萣鄉,,0,1,14260,123,14383,24507,3,1,3,0,1,0,58.69
高雄縣,永安鄉,,0,1,6545,72,6617,10669,3,1,3,0,1,0,62.02
高雄縣,彌陀鄉,,0,1,11025,98,11123,15833,3,1,3,0,1,0,70.25
高雄縣,梓官鄉,,0,1,17557,135,17692,28758,3,1,3,0,1,0,61.52
高雄縣,旗山鎮,,0,1,20290,171,20461,32431,3,1,3,0,1,0,63.09
高雄縣,美濃鎮,,0,1,21272,161,21433,34883,3,1,3,0,1,0,61.44
高雄縣,六龜鄉,,0,1,6830,86,6916,12385,3,1,3,0,1,0,55.84
高雄縣,甲仙鄉,,0,1,4094,29,4123,6627,3,1,3,0,1,0,62.22
高雄縣,杉林鄉,,0,1,5560,56,5616,9716,3,1,3,0,1,0,57.80
高雄縣,內門鄉,,0,1,8593,79,8672,13476,3,1,3,0,1,0,64.35
高雄縣,茂林鄉,,0,1,43,0,43,106,3,1,3,0,1,0,40.57
高雄縣,桃源鄉,,0,1,159,2,161,356,3,1,3,0,1,0,45.22
高雄縣,三民鄉,,0,1,130,2,132,330,3,1,3,0,1,0,40.00
屏東縣,屏東市,,0,1,96026,527,96553,156587,3,1,3,0,1,0,61.66
屏東縣,潮州鎮,,0,1,24767,146,24913,41241,3,1,3,0,1,0,60.41
屏東縣,東港鎮,,0,1,20943,115,21058,35741,3,1,3,0,1,0,58.92
屏東縣,恆春鎮,,0,1,12734,118,12852,22807,3,1,3,0,1,0,56.35
屏東縣,萬丹鄉,,0,1,27883,185,28068,39585,3,1,3,0,1,0,70.91
屏東縣,長治鄉,,0,1,14874,89,14963,23033,3,1,3,0,1,0,64.96
屏東縣,麟洛鄉,,0,1,6177,35,6212,9130,3,1,3,0,1,0,68.04
屏東縣,九如鄉,,0,1,11958,66,12024,17286,3,1,3,0,1,0,69.56
屏東縣,里港鄉,,0,1,13439,101,13540,19904,3,1,3,0,1,0,68.03
屏東縣,鹽埔鄉,,0,1,13173,107,13280,20873,3,1,3,0,1,0,63.62
屏東縣,高樹鄉,,0,1,13994,88,14082,22283,3,1,3,0,1,0,63.20
屏東縣,萬巒鄉,,0,1,11362,96,11458,17439,3,1,3,0,1,0,65.70
屏東縣,內埔鄉,,0,1,27430,190,27620,44703,3,1,3,0,1,0,61.79
屏東縣,竹田鄉,,0,1,10134,58,10192,14579,3,1,3,0,1,0,69.91
屏東縣,新埤鄉,,0,1,5552,32,5584,8958,3,1,3,0,1,0,62.34
屏東縣,枋寮鄉,,0,1,12855,79,12934,21643,3,1,3,0,1,0,59.76
屏東縣,新園鄉,,0,1,19393,101,19494,29916,3,1,3,0,1,0,65.16
屏東縣,崁頂鄉,,0,1,7051,50,7101,11098,3,1,3,0,1,0,63.98
屏東縣,林邊鄉,,0,1,10087,63,10150,16838,3,1,3,0,1,0,60.28
屏東縣,南州鄉,,0,1,6278,48,6326,9815,3,1,3,0,1,0,64.45
屏東縣,佳冬鄉,,0,1,11399,62,11461,17484,3,1,3,0,1,0,65.55
屏東縣,琉球鄉,,0,1,4823,31,4854,10004,3,1,3,0,1,0,48.52
屏東縣,車城鄉,,0,1,4900,52,4952,7978,3,1,3,0,1,0,62.07
屏東縣,滿州鄉,,0,1,2690,71,2761,5217,3,1,3,0,1,0,52.92
屏東縣,枋山鄉,,0,1,2817,14,2831,4798,3,1,3,0,1,0,59.00
屏東縣,三地門鄉,,0,1,176,6,182,383,3,1,3,0,1,0,47.52
屏東縣,霧臺鄉,,0,1,23,1,24,60,3,1,3,0,1,0,40.00
屏東縣,瑪家鄉,,0,1,164,2,166,312,3,1,3,0,1,0,53.21
屏東縣,泰武鄉,,0,1,67,0,67,153,3,1,3,0,1,0,43.79
屏東縣,來義鄉,,0,1,130,2,132,266,3,1,3,0,1,0,49.62
屏東縣,春日鄉,,0,1,151,1,152,320,3,1,3,0,1,0,47.50
屏東縣,獅子鄉,,0,1,119,0,119,289,3,1,3,0,1,0,41.18
屏東縣,牡丹鄉,,0,1,180,1,181,335,3,1,3,0,1,0,54.03
臺東縣,台東市,,0,1,35256,187,35443,67084,3,1,3,0,1,0,52.83
臺東縣,成功鎮,,0,1,3087,10,3097,6313,3,1,3,0,1,0,49.06
臺東縣,關山鎮,,0,1,3315,29,3344,6082,3,1,3,0,1,0,54.98
臺東縣,卑南鄉,,0,1,5591,40,5631,10929,3,1,3,0,1,0,51.52
臺東縣,鹿野鄉,,0,1,2704,16,2720,5473,3,1,3,0,1,0,49.70
臺東縣,池上鄉,,0,1,3001,16,3017,6125,3,1,3,0,1,0,49.26
臺東縣,東河鄉,,0,1,1889,13,1902,3963,3,1,3,0,1,0,47.99
臺東縣,長濱鄉,,0,1,1343,9,1352,3126,3,1,3,0,1,0,43.25
臺東縣,太麻里鄉,,0,1,3120,14,3134,6060,3,1,3,0,1,0,51.72
臺東縣,大武鄉,,0,1,1168,11,1179,3054,3,1,3,0,1,0,38.61
臺東縣,綠島鄉,,0,1,928,4,932,2265,3,1,3,0,1,0,41.15
臺東縣,海端鄉,,0,1,153,3,156,306,3,1,3,0,1,0,50.98
臺東縣,延平鄉,,0,1,136,1,137,278,3,1,3,0,1,0,49.28
臺東縣,金峰鄉,,0,1,68,1,69,140,3,1,3,0,1,0,49.29
臺東縣,達仁鄉,,0,1,138,1,139,337,3,1,3,0,1,0,41.25
臺東縣,蘭嶼鄉,,0,1,91,0,91,284,3,1,3,0,1,0,32.04
花蓮縣,花蓮市,,0,1,35699,288,35987,72373,3,1,3,0,1,0,49.72
花蓮縣,新城鄉,,0,1,6094,57,6151,12378,3,1,3,0,1,0,49.69
花蓮縣,秀林鄉,,0,1,766,7,773,1720,3,1,3,0,1,0,44.94
花蓮縣,吉安鄉,,0,1,23898,191,24089,49979,3,1,3,0,1,0,48.20
花蓮縣,壽豐鄉,,0,1,5646,41,5687,11316,3,1,3,0,1,0,50.26
花蓮縣,鳳林鎮,,0,1,4795,38,4833,8936,3,1,3,0,1,0,54.08
花蓮縣,光復鄉,,0,1,3192,32,3224,6238,3,1,3,0,1,0,51.68
花蓮縣,豐濱鄉,,0,1,423,6,429,970,3,1,3,0,1,0,44.23
花蓮縣,萬榮鄉,,0,1,132,2,134,303,3,1,3,0,1,0,44.22
花蓮縣,瑞穗鄉,,0,1,3423,22,3445,6988,3,1,3,0,1,0,49.30
花蓮縣,玉里鎮,,0,1,7654,105,7759,16780,3,1,3,0,1,0,46.24
花蓮縣,富里鄉,,0,1,3893,33,3926,8741,3,1,3,0,1,0,44.91
花蓮縣,卓溪鄉,,0,1,153,0,153,316,3,1,3,0,1,0,48.42
澎湖縣,馬公市,,0,1,22710,172,22882,39610,3,1,3,0,1,0,57.77
澎湖縣,湖西鄉,,0,1,6028,47,6075,10114,3,1,3,0,1,0,60.07
澎湖縣,白沙鄉,,0,1,3642,70,3712,7248,3,1,3,0,1,0,51.21
澎湖縣,西嶼鄉,,0,1,3377,25,3402,6594,3,1,3,0,1,0,51.59
澎湖縣,望安鄉,,0,1,1121,10,1131,3369,3,1,3,0,1,0,33.57
澎湖縣,七美鄉,,0,1,955,8,963,2404,3,1,3,0,1,0,40.06
基隆市,中正區,,0,1,22415,202,22617,41972,3,1,3,0,1,0,53.89
基隆市,信義區,,0,1,20524,159,20683,38036,3,1,3,0,1,0,54.38
基隆市,仁愛區,,0,1,20786,167,20953,37328,3,1,3,0,1,0,56.13
基隆市,中山區,,0,1,21262,205,21467,40233,3,1,3,0,1,0,53.36
基隆市,安樂區,,0,1,31388,224,31612,61041,3,1,3,0,1,0,51.79
基隆市,暖暖區,,0,1,14056,117,14173,27411,3,1,3,0,1,0,51.71
基隆市,七堵區,,0,1,20238,173,20411,39650,3,1,3,0,1,0,51.48
新竹市,東區,,0,1,69943,468,70411,126916,3,1,3,0,1,0,55.48
新竹市,北區,,0,1,52396,393,52789,97311,3,1,3,0,1,0,54.25
新竹市,香山區,,0,1,24689,204,24893,47847,3,1,3,0,1,0,52.03
臺中市,中區,,0,1,8999,67,9066,15908,3,1,3,0,1,0,56.99
臺中市,東區,,0,1,30565,222,30787,52084,3,1,3,0,1,0,59.11
臺中市,西區,,0,1,46455,335,46790,81943,3,1,3,0,1,0,57.10
臺中市,南區,,0,1,41425,309,41734,75103,3,1,3,0,1,0,55.57
臺中市,北區,,0,1,59116,366,59482,107103,3,1,3,0,1,0,55.54
臺中市,西屯區,,0,1,70564,464,71028,127386,3,1,3,0,1,0,55.76
臺中市,南屯區,,0,1,51214,393,51607,92451,3,1,3,0,1,0,55.82
臺中市,北屯區,,0,1,89828,635,90463,160296,3,1,3,0,1,0,56.43
嘉義市,東區,,0,1,50731,272,51003,94367,3,1,3,0,1,0,54.05
嘉義市,西區,,0,1,52476,357,52833,98842,3,1,3,0,1,0,53.45
臺南市,東區,,0,1,75839,422,76261,134193,3,1,3,0,1,0,56.83
臺南市,南區,,0,1,57845,359,58204,99829,3,1,3,0,1,0,58.30
臺南市,中西區,,0,1,37554,218,37772,64031,3,1,3,0,1,0,58.99
臺南市,北區,,0,1,53309,340,53649,93354,3,1,3,0,1,0,57.47
臺南市,安南區,,0,1,71821,427,72248,120244,3,1,3,0,1,0,60.08
臺南市,安平區,,0,1,20527,105,20632,38760,3,1,3,0,1,0,53.23
金門縣,金城鎮,,0,1,7221,88,7309,15396,3,1,3,0,1,0,47.47
金門縣,金寧鄉,,0,1,4044,65,4109,8361,3,1,3,0,1,0,49.14
金門縣,金湖鎮,,0,1,5120,72,5192,10146,3,1,3,0,1,0,51.17
金門縣,金沙鎮,,0,1,3761,34,3795,7812,3,1,3,0,1,0,48.58
金門縣,烈嶼鄉,,0,1,2254,11,2265,4472,3,1,3,0,1,0,50.65
金門縣,烏坵鄉,,0,1,46,0,46,262,3,1,3,0,1,0,17.56
連江縣,南竿鄉,,0,1,2690,27,2717,4078,3,1,3,0,1,0,66.63
連江縣,北竿鄉,,0,1,874,16,890,1371,3,1,3,0,1,0,64.92
連江縣,莒光鄉,,0,1,490,0,490,865,3,1,3,0,1,0,56.65
連江縣,東引鄉,,0,1,397,4,401,643,3,1,3,0,1,0,62.36
臺北市,北投區,建民里,0,1,2362,12,2374,3797,3,1,3,0,1,0,62.52
臺北市,北投區,文林里,0,1,2185,12,2197,3577,3,1,3,0,1,0,61.42
臺北市,北投區,石牌里,0,1,2544,22,2566,4232,3,1,3,0,1,0,60.63
臺北市,北投區,福興里,0,1,3386,24,3410,5309,3,1,3,0,1,0,64.23
臺北市,北投區,榮光里,0,1,3375,10,3385,5627,3,1,3,0,1,0,60.16
臺北市,北投區,榮華里,0,1,3776,11,3787,6048,3,1,3,0,1,0,62.62
臺北市,北投區,裕民里,0,1,3416,18,3434,5415,3,1,3,0,1,0,63.42
臺北市,北投區,振華里,0,1,4117,25,4142,6393,3,1,3,0,1,0,64.79
臺北市,北投區,永和里,0,1,3965,18,3983,6604,3,1,3,0,1,0,60.31
臺北市,北投區,永欣里,0,1,3215,9,3224,5233,3,1,3,0,1,0,61.61
臺北市,北投區,永明里,0,1,2278,10,2288,3548,3,1,3,0,1,0,64.49
臺北市,北投區,東華里,0,1,2418,18,2436,3632,3,1,3,0,1,0,67.07
臺北市,北投區,吉利里,0,1,3170,25,3195,5152,3,1,3,0,1,0,62.01
臺北市,北投區,吉慶里,0,1,2512,15,2527,4059,3,1,3,0,1,0,62.26
臺北市,北投區,尊賢里,0,1,2323,11,2334,3827,3,1,3,0,1,0,60.99
臺北市,北投區,立賢里,0,1,2453,22,2475,4121,3,1,3,0,1,0,60.06
臺北市,北投區,立農里,0,1,4280,22,4302,6788,3,1,3,0,1,0,63.38
臺北市,北投區,八仙里,0,1,2301,9,2310,3886,3,1,3,0,1,0,59.44
臺北市,北投區,洲美里,0,1,899,2,901,1487,3,1,3,0,1,0,60.59
臺北市,北投區,奇岩里,0,1,4641,28,4669,7650,3,1,3,0,1,0,61.03
臺北市,北投區,清江里,0,1,4299,27,4326,7634,3,1,3,0,1,0,56.67
臺北市,北投區,中央里,0,1,3490,16,3506,6002,3,1,3,0,1,0,58.41
臺北市,北投區,長安里,0,1,2695,10,2705,4545,3,1,3,0,1,0,59.52
臺北市,北投區,大同里,0,1,2875,9,2884,4769,3,1,3,0,1,0,60.47
臺北市,北投區,溫泉里,0,1,3052,13,3065,5091,3,1,3,0,1,0,60.20
臺北市,北投區,林泉里,0,1,1563,12,1575,2729,3,1,3,0,1,0,57.71
臺北市,北投區,中心里,0,1,2605,12,2617,4855,3,1,3,0,1,0,53.90
臺北市,北投區,中庸里,0,1,2087,20,2107,3385,3,1,3,0,1,0,62.25
臺北市,北投區,開明里,0,1,3109,18,3127,5151,3,1,3,0,1,0,60.71
臺北市,北投區,中和里,0,1,2503,9,2512,4058,3,1,3,0,1,0,61.90
臺北市,北投區,智仁里,0,1,3021,18,3039,4768,3,1,3,0,1,0,63.74
臺北市,北投區,秀山里,0,1,1758,10,1768,2849,3,1,3,0,1,0,62.06
臺北市,北投區,文化里,0,1,2240,8,2248,3333,3,1,3,0,1,0,67.45
臺北市,北投區,豐年里,0,1,2007,12,2019,3309,3,1,3,0,1,0,61.02
臺北市,北投區,稻香里,0,1,2250,13,2263,3931,3,1,3,0,1,0,57.57
臺北市,北投區,桃源里,0,1,2483,12,2495,4192,3,1,3,0,1,0,59.52
臺北市,北投區,一德里,0,1,2829,23,2852,5054,3,1,3,0,1,0,56.43
臺北市,北投區,關渡里,0,1,4876,38,4914,8248,3,1,3,0,1,0,59.58
臺北市,北投區,泉源里,0,1,1121,8,1129,1954,3,1,3,0,1,0,57.78
臺北市,北投區,湖山里,0,1,1028,7,1035,1678,3,1,3,0,1,0,61.68
臺北市,北投區,大屯里,0,1,564,5,569,985,3,1,3,0,1,0,57.77
臺北市,北投區,湖田里,0,1,451,4,455,739,3,1,3,0,1,0,61.57
臺北市,士林區,仁勇里,0,1,2147,9,2156,3475,3,1,3,0,1,0,62.04
臺北市,士林區,義信里,0,1,1570,9,1579,2672,3,1,3,0,1,0,59.09
臺北市,士林區,福林里,0,1,2095,12,2107,3297,3,1,3,0,1,0,63.91
臺北市,士林區,福德里,0,1,2208,14,2222,4423,3,1,3,0,1,0,50.24
臺北市,士林區,福志里,0,1,3693,23,3716,5789,3,1,3,0,1,0,64.19
臺北市,士林區,舊佳里,0,1,3235,44,3279,5218,3,1,3,0,1,0,62.84
臺北市,士林區,福佳里,0,1,3762,15,3777,6071,3,1,3,0,1,0,62.21
臺北市,士林區,後港里,0,1,3711,18,3729,6347,3,1,3,0,1,0,58.75
臺北市,士林區,福中里,0,1,2674,10,2684,4398,3,1,3,0,1,0,61.03
臺北市,士林區,前港里,0,1,2080,11,2091,3473,3,1,3,0,1,0,60.21
臺北市,士林區,百齡里,0,1,3472,20,3492,5752,3,1,3,0,1,0,60.71
臺北市,士林區,承德里,0,1,2627,17,2644,4479,3,1,3,0,1,0,59.03
臺北市,士林區,福華里,0,1,3176,18,3194,5519,3,1,3,0,1,0,57.87
臺北市,士林區,明勝里,0,1,2297,12,2309,4016,3,1,3,0,1,0,57.50
臺北市,士林區,福順里,0,1,2439,23,2462,4318,3,1,3,0,1,0,57.02
臺北市,士林區,富光里,0,1,2787,18,2805,4830,3,1,3,0,1,0,58.07
臺北市,士林區,葫蘆里,0,1,3644,17,3661,5881,3,1,3,0,1,0,62.25
臺北市,士林區,葫東里,0,1,1838,10,1848,3118,3,1,3,0,1,0,59.27
臺北市,士林區,社子里,0,1,2850,24,2874,5049,3,1,3,0,1,0,56.92
臺北市,士林區,社新里,0,1,3856,22,3878,6687,3,1,3,0,1,0,57.99
臺北市,士林區,社園里,0,1,3438,15,3453,5681,3,1,3,0,1,0,60.78
臺北市,士林區,永倫里,0,1,3513,13,3526,5791,3,1,3,0,1,0,60.89
臺北市,士林區,福安里,0,1,2378,17,2395,3904,3,1,3,0,1,0,61.35
臺北市,士林區,富洲里,0,1,2785,17,2802,4463,3,1,3,0,1,0,62.78
臺北市,士林區,岩山里,0,1,1822,11,1833,3116,3,1,3,0,1,0,58.83
臺北市,士林區,名山里,0,1,3624,13,3637,5753,3,1,3,0,1,0,63.22
臺北市,士林區,德行里,0,1,2003,11,2014,3308,3,1,3,0,1,0,60.88
臺北市,士林區,德華里,0,1,2796,13,2809,4618,3,1,3,0,1,0,60.83
臺北市,士林區,聖山里,0,1,2648,15,2663,4208,3,1,3,0,1,0,63.28
臺北市,士林區,忠誠里,0,1,2980,9,2989,4631,3,1,3,0,1,0,64.54
臺北市,士林區,芝山里,0,1,3478,22,3500,5767,3,1,3,0,1,0,60.69
臺北市,士林區,東山里,0,1,2666,15,2681,4116,3,1,3,0,1,0,65.14
臺北市,士林區,三玉里,0,1,2825,11,2836,4526,3,1,3,0,1,0,62.66
臺北市,士林區,蘭雅里,0,1,4036,20,4056,6788,3,1,3,0,1,0,59.75
臺北市,士林區,蘭興里,0,1,3131,16,3147,4988,3,1,3,0,1,0,63.09
臺北市,士林區,天福里,0,1,3093,21,3114,4990,3,1,3,0,1,0,62.40
臺北市,士林區,天祿里,0,1,2579,14,2593,4130,3,1,3,0,1,0,62.78
臺北市,士林區,天壽里,0,1,2337,13,2350,3810,3,1,3,0,1,0,61.6797900262
臺北市,士林區,天和里,0,1,3637,25,3662,5946,3,1,3,0,1,0,61.5876219307
臺北市,士林區,天山里,0,1,3306,22,3328,5511,3,1,3,0,1,0,60.3883142805
臺北市,士林區,天玉里,0,1,4028,12,4040,6673,3,1,3,0,1,0,60.5424846396
臺北市,士林區,天母里,0,1,3221,21,3242,5110,3,1,3,0,1,0,63.4442270059
臺北市,士林區,永福里,0,1,685,4,689,1148,3,1,3,0,1,0,60.0174216028
臺北市,士林區,公館里,0,1,744,5,749,1234,3,1,3,0,1,0,60.6969205835
臺北市,士林區,新安里,0,1,1036,6,1042,1747,3,1,3,0,1,0,59.6451058958
臺北市,士林區,陽明里,0,1,1616,9,1625,2759,3,1,3,0,1,0,58.8981515042
臺北市,士林區,菁山里,0,1,812,3,815,1367,3,1,3,0,1,0,59.6196049744
臺北市,士林區,平等里,0,1,769,10,779,1189,3,1,3,0,1,0,65.5172413793
臺北市,士林區,溪山里,0,1,710,7,717,1231,3,1,3,0,1,0,58.2453290008
臺北市,士林區,翠山里,0,1,1586,6,1592,2471,3,1,3,0,1,0,64.4273573452
臺北市,士林區,臨溪里,0,1,1514,9,1523,2462,3,1,3,0,1,0,61.8602761982
臺北市,內湖區,西湖里,0,1,3838,16,3854,6197,3,1,3,0,1,0,62.1913829272
臺北市,內湖區,西康里,0,1,3953,21,3974,6372,3,1,3,0,1,0,62.366603892
臺北市,內湖區,西安里,0,1,3116,9,3125,5027,3,1,3,0,1,0,62.1643127114
臺北市,內湖區,港墘里,0,1,2756,15,2771,4409,3,1,3,0,1,0,62.8487185303
臺北市,內湖區,港都里,0,1,2454,9,2463,4011,3,1,3,0,1,0,61.4061331339
臺北市,內湖區,麗山里,0,1,2536,13,2549,4153,3,1,3,0,1,0,61.3773176017
臺北市,內湖區,港富里,0,1,4463,25,4488,7183,3,1,3,0,1,0,62.4808575804
臺北市,內湖區,港華里,0,1,3850,29,3879,6234,3,1,3,0,1,0,62.2232916266
臺北市,內湖區,內湖里,0,1,2755,14,2769,4518,3,1,3,0,1,0,61.2881806109
臺北市,內湖區,湖濱里,0,1,3725,26,3751,5765,3,1,3,0,1,0,65.0650477016
臺北市,內湖區,紫星里,0,1,4031,7,4038,6452,3,1,3,0,1,0,62.5852448853
臺北市,內湖區,大湖里,0,1,2309,10,2319,3926,3,1,3,0,1,0,59.0677534386
臺北市,內湖區,秀湖里,0,1,2897,11,2908,4727,3,1,3,0,1,0,61.5189337846
臺北市,內湖區,金龍里,0,1,2659,13,2672,4529,3,1,3,0,1,0,58.9975712078
臺北市,內湖區,金瑞里,0,1,3152,13,3165,5011,3,1,3,0,1,0,63.1610456995
臺北市,內湖區,碧山里,0,1,3299,12,3311,5298,3,1,3,0,1,0,62.4952812382
臺北市,內湖區,紫雲里,0,1,2911,22,2933,4520,3,1,3,0,1,0,64.889380531
臺北市,內湖區,清白里,0,1,3078,15,3093,5278,3,1,3,0,1,0,58.6017430845
臺北市,內湖區,葫洲里,0,1,4108,20,4128,6991,3,1,3,0,1,0,59.0473465885
臺北市,內湖區,金湖里,0,1,2841,14,2855,4763,3,1,3,0,1,0,59.9412135209
臺北市,內湖區,康寧里,0,1,3362,19,3381,5860,3,1,3,0,1,0,57.6962457338
臺北市,內湖區,明湖里,0,1,2170,9,2179,3597,3,1,3,0,1,0,60.5782596608
臺北市,內湖區,蘆洲里,0,1,453,0,453,792,3,1,3,0,1,0,57.196969697
臺北市,內湖區,紫陽里,0,1,3507,27,3534,5778,3,1,3,0,1,0,61.1630321911
臺北市,內湖區,瑞陽里,0,1,4404,23,4427,6386,3,1,3,0,1,0,69.3235202004
臺北市,內湖區,瑞光里,0,1,2399,11,2410,3702,3,1,3,0,1,0,65.0999459751
臺北市,內湖區,五分里,0,1,3887,26,3913,6974,3,1,3,0,1,0,56.1084026384
臺北市,內湖區,東湖里,0,1,3385,24,3409,5942,3,1,3,0,1,0,57.3712554695
臺北市,內湖區,安湖里,0,1,3084,22,3106,5267,3,1,3,0,1,0,58.9709512056
臺北市,內湖區,樂康里,0,1,3345,22,3367,5902,3,1,3,0,1,0,57.0484581498
臺北市,內湖區,內溝里,0,1,1946,16,1962,3273,3,1,3,0,1,0,59.945004583
臺北市,內湖區,安泰里,0,1,2129,10,2139,3611,3,1,3,0,1,0,59.2356687898
臺北市,內湖區,週美里,0,1,2420,11,2431,3916,3,1,3,0,1,0,62.0786516854
臺北市,內湖區,行善里,0,1,3125,30,3155,5144,3,1,3,0,1,0,61.333592535
臺北市,內湖區,石潭里,0,1,851,5,856,1422,3,1,3,0,1,0,60.1969057665
臺北市,內湖區,湖興里,0,1,4447,21,4468,8456,3,1,3,0,1,0,52.8382213813
臺北市,內湖區,湖元里,0,1,2410,11,2421,4023,3,1,3,0,1,0,60.1789709172
臺北市,南港區,南港里,0,1,2637,9,2646,4810,3,1,3,0,1,0,55.0103950104
臺北市,南港區,中南里,0,1,1910,13,1923,3297,3,1,3,0,1,0,58.3257506824
臺北市,南港區,新富里,0,1,1887,13,1900,3195,3,1,3,0,1,0,59.4679186228
臺北市,南港區,三重里,0,1,1480,10,1490,2581,3,1,3,0,1,0,57.7295621852
臺北市,南港區,東新里,0,1,3408,16,3424,5738,3,1,3,0,1,0,59.6723597072
臺北市,南港區,新光里,0,1,2100,15,2115,3313,3,1,3,0,1,0,63.8394204648
臺北市,南港區,東明里,0,1,2164,15,2179,3635,3,1,3,0,1,0,59.9449793673
臺北市,南港區,西新里,0,1,2106,17,2123,3531,3,1,3,0,1,0,60.1246105919
臺北市,南港區,玉成里,0,1,2246,14,2260,3653,3,1,3,0,1,0,61.8669586641
臺北市,南港區,合成里,0,1,3112,25,3137,5045,3,1,3,0,1,0,62.1803766105
臺北市,南港區,成福里,0,1,3770,31,3801,6118,3,1,3,0,1,0,62.1281464531
臺北市,南港區,萬福里,0,1,2218,12,2230,3341,3,1,3,0,1,0,66.7464830889
臺北市,南港區,鴻福里,0,1,2333,16,2349,3806,3,1,3,0,1,0,61.718339464
臺北市,南港區,百福里,0,1,2448,16,2464,3965,3,1,3,0,1,0,62.1437578815
臺北市,南港區,聯成里,0,1,2709,12,2721,4286,3,1,3,0,1,0,63.4857676155
臺北市,南港區,舊莊里,0,1,3903,32,3935,6786,3,1,3,0,1,0,57.987032125
臺北市,南港區,中研里,0,1,4422,30,4452,7161,3,1,3,0,1,0,62.1700879765
臺北市,南港區,九如里,0,1,2974,22,2996,4652,3,1,3,0,1,0,64.4024075666
臺北市,南港區,仁福里,0,1,2660,21,2681,4362,3,1,3,0,1,0,61.4626318203
臺北市,松山區,莊敬里,0,1,2890,17,2907,4672,3,1,3,0,1,0,62.2217465753
臺北市,松山區,東榮里,0,1,4309,20,4329,6847,3,1,3,0,1,0,63.2247699723
臺北市,松山區,三民里,0,1,3485,19,3504,5585,3,1,3,0,1,0,62.739480752
臺北市,松山區,新益里,0,1,2285,14,2299,3716,3,1,3,0,1,0,61.8675995694
臺北市,松山區,富錦里,0,1,2630,10,2640,4219,3,1,3,0,1,0,62.5740696848
臺北市,松山區,新東里,0,1,2354,11,2365,4010,3,1,3,0,1,0,58.9775561097
臺北市,松山區,富泰里,0,1,2223,5,2228,3708,3,1,3,0,1,0,60.0862998921
臺北市,松山區,介壽里,0,1,2220,8,2228,3624,3,1,3,0,1,0,61.4790286976
臺北市,松山區,精忠里,0,1,2157,11,2168,3579,3,1,3,0,1,0,60.5755797709
臺北市,松山區,東光里,0,1,3664,19,3683,6057,3,1,3,0,1,0,60.8056793792
臺北市,松山區,龍田里,0,1,4488,9,4497,6997,3,1,3,0,1,0,64.2704016007
臺北市,松山區,東昌里,0,1,1322,12,1334,2124,3,1,3,0,1,0,62.8060263653
臺北市,松山區,東勢里,0,1,2224,19,2243,3525,3,1,3,0,1,0,63.6312056738
臺北市,松山區,中華里,0,1,3045,9,3054,4896,3,1,3,0,1,0,62.3774509804
臺北市,松山區,民有里,0,1,4194,20,4214,7081,3,1,3,0,1,0,59.5113684508
臺北市,松山區,民福里,0,1,3437,15,3452,5406,3,1,3,0,1,0,63.8549759526
臺北市,松山區,慈祐里,0,1,2844,10,2854,5614,3,1,3,0,1,0,50.8371927325
臺北市,松山區,安平里,0,1,4289,39,4328,6893,3,1,3,0,1,0,62.788335993
臺北市,松山區,鵬程里,0,1,3029,9,3038,4689,3,1,3,0,1,0,64.7899338878
臺北市,松山區,自強里,0,1,3687,21,3708,5572,3,1,3,0,1,0,66.5470208184
臺北市,松山區,吉祥里,0,1,4072,7,4079,6678,3,1,3,0,1,0,61.0811620246
臺北市,松山區,新聚里,0,1,3699,23,3722,6060,3,1,3,0,1,0,61.4191419142
臺北市,松山區,復盛里,0,1,3313,18,3331,5239,3,1,3,0,1,0,63.5808360374
臺北市,松山區,中正里,0,1,3751,22,3773,6404,3,1,3,0,1,0,58.9163023111
臺北市,松山區,中崙里,0,1,1833,16,1849,3079,3,1,3,0,1,0,60.0519649237
臺北市,松山區,美仁里,0,1,1630,8,1638,2598,3,1,3,0,1,0,63.0484988453
臺北市,松山區,吉仁里,0,1,1909,15,1924,3112,3,1,3,0,1,0,61.8251928021
臺北市,松山區,敦化里,0,1,3429,18,3447,5482,3,1,3,0,1,0,62.8785114922
臺北市,松山區,復源里,0,1,1542,8,1550,2468,3,1,3,0,1,0,62.8038897893
臺北市,松山區,復建里,0,1,1812,5,1817,3059,3,1,3,0,1,0,59.3984962406
臺北市,松山區,復勢里,0,1,2903,17,2920,4702,3,1,3,0,1,0,62.1012335177
臺北市,松山區,福成里,0,1,1309,11,1320,2080,3,1,3,0,1,0,63.4615384615
臺北市,松山區,松基里,0,1,1855,14,1869,3082,3,1,3,0,1,0,60.642439974
臺北市,信義區,西村里,0,1,2647,10,2657,4840,3,1,3,0,1,0,54.8966942149
臺北市,信義區,正和里,0,1,2466,11,2477,3909,3,1,3,0,1,0,63.3665899207
臺北市,信義區,興隆里,0,1,1462,5,1467,2478,3,1,3,0,1,0,59.200968523
臺北市,信義區,中興里,0,1,1440,6,1446,2578,3,1,3,0,1,0,56.089992242
臺北市,信義區,新仁里,0,1,1788,7,1795,2927,3,1,3,0,1,0,61.3255893406
臺北市,信義區,興雅里,0,1,2990,12,3002,4811,3,1,3,0,1,0,62.3986697152
臺北市,信義區,敦厚里,0,1,2226,7,2233,3896,3,1,3,0,1,0,57.3151950719
臺北市,信義區,廣居里,0,1,3578,15,3593,5831,3,1,3,0,1,0,61.6189332876
臺北市,信義區,安康里,0,1,3797,7,3804,6201,3,1,3,0,1,0,61.3449443638
臺北市,信義區,六藝里,0,1,1761,13,1774,2921,3,1,3,0,1,0,60.7326258131
臺北市,信義區,雅祥里,0,1,2391,15,2406,4046,3,1,3,0,1,0,59.4661393969
臺北市,信義區,五常里,0,1,1860,8,1868,3095,3,1,3,0,1,0,60.3554119548
臺北市,信義區,五全里,0,1,2705,18,2723,4267,3,1,3,0,1,0,63.8153269276
臺北市,信義區,永吉里,0,1,2116,14,2130,3765,3,1,3,0,1,0,56.5737051793
臺北市,信義區,長春里,0,1,2155,14,2169,3573,3,1,3,0,1,0,60.7052896725
臺北市,信義區,四育里,0,1,2880,16,2896,4624,3,1,3,0,1,0,62.6297577855
臺北市,信義區,四維里,0,1,2698,19,2717,4589,3,1,3,0,1,0,59.2067988669
臺北市,信義區,永春里,0,1,2606,14,2620,4363,3,1,3,0,1,0,60.0504240202
臺北市,信義區,富臺里,0,1,1934,10,1944,3068,3,1,3,0,1,0,63.3637548892
臺北市,信義區,國業里,0,1,3605,19,3624,5736,3,1,3,0,1,0,63.179916318
臺北市,信義區,松隆里,0,1,1180,10,1190,2067,3,1,3,0,1,0,57.5713594582
臺北市,信義區,松友里,0,1,3127,12,3139,5306,3,1,3,0,1,0,59.159442141
臺北市,信義區,松光里,0,1,2707,6,2713,4456,3,1,3,0,1,0,60.8842010772
臺北市,信義區,中坡里,0,1,2312,11,2323,3766,3,1,3,0,1,0,61.6834838024
臺北市,信義區,中行里,0,1,4033,22,4055,6488,3,1,3,0,1,0,62.5
臺北市,信義區,大道里,0,1,3282,15,3297,5385,3,1,3,0,1,0,61.2256267409
臺北市,信義區,大仁里,0,1,2761,28,2789,4421,3,1,3,0,1,0,63.0852748247
臺北市,信義區,景新里,0,1,2506,16,2522,4042,3,1,3,0,1,0,62.3948540327
臺北市,信義區,惠安里,0,1,3438,16,3454,5459,3,1,3,0,1,0,63.2716614765
臺北市,信義區,三張里,0,1,4744,28,4772,7555,3,1,3,0,1,0,63.1634679021
臺北市,信義區,三犁里,0,1,2499,6,2505,4102,3,1,3,0,1,0,61.0677718186
臺北市,信義區,六合里,0,1,3292,10,3302,5449,3,1,3,0,1,0,60.5982749128
臺北市,信義區,泰和里,0,1,3854,22,3876,6536,3,1,3,0,1,0,59.3023255814
臺北市,信義區,景聯里,0,1,2424,13,2437,3951,3,1,3,0,1,0,61.6805871931
臺北市,信義區,景勤里,0,1,2299,18,2317,3687,3,1,3,0,1,0,62.8424193111
臺北市,信義區,雙和里,0,1,3723,21,3744,5972,3,1,3,0,1,0,62.6925653048
臺北市,信義區,嘉興里,0,1,1633,5,1638,2666,3,1,3,0,1,0,61.44036009
臺北市,信義區,黎順里,0,1,2171,9,2180,3542,3,1,3,0,1,0,61.5471485037
臺北市,信義區,黎平里,0,1,3483,17,3500,5662,3,1,3,0,1,0,61.8156128576
臺北市,信義區,黎忠里,0,1,2539,10,2549,4039,3,1,3,0,1,0,63.109680614
臺北市,信義區,黎安里,0,1,1408,9,1417,2240,3,1,3,0,1,0,63.2589285714
臺北市,中山區,正守里,0,2,1475,15,1490,2439,3,1,3,0,1,0,61.09
臺北市,中山區,正義里,0,2,1912,22,1934,3646,3,1,3,0,1,0,53.04
臺北市,中山區,正得里,0,2,1464,8,1472,2592,3,1,3,0,1,0,56.79
臺北市,中山區,民安里,0,2,2410,9,2419,4072,3,1,3,0,1,0,59.41
臺北市,中山區,康樂里,0,2,975,9,984,1869,3,1,3,0,1,0,52.65
臺北市,中山區,中山里,0,2,2319,12,2331,4280,3,1,3,0,1,0,54.46
臺北市,中山區,聚盛里,0,2,1383,12,1395,2811,3,1,3,0,1,0,49.63
臺北市,中山區,集英里,0,2,2803,18,2821,4774,3,1,3,0,1,0,59.09
臺北市,中山區,聚葉里,0,2,1771,11,1782,3091,3,1,3,0,1,0,57.65
臺北市,中山區,恆安里,0,2,1481,13,1494,2664,3,1,3,0,1,0,56.08
臺北市,中山區,晴光里,0,2,1779,16,1795,3506,3,1,3,0,1,0,51.20
臺北市,中山區,圓山里,0,2,1660,15,1675,3079,3,1,3,0,1,0,54.40
臺北市,中山區,新庄里,0,2,2315,11,2326,3958,3,1,3,0,1,0,58.77
臺北市,中山區,劍潭里,0,2,2120,12,2132,3120,3,1,3,0,1,0,68.33
臺北市,中山區,大直里,0,2,4814,25,4839,7616,3,1,3,0,1,0,63.54
臺北市,中山區,成功里,0,2,1642,10,1652,2633,3,1,3,0,1,0,62.74
臺北市,中山區,永安里,0,2,4100,16,4116,6632,3,1,3,0,1,0,62.06
臺北市,中山區,大佳里,0,2,599,4,603,944,3,1,3,0,1,0,63.88
臺北市,中山區,新喜里,0,2,2400,13,2413,4027,3,1,3,0,1,0,59.92
臺北市,中山區,新福里,0,2,2414,15,2429,4106,3,1,3,0,1,0,59.16
臺北市,中山區,松江里,0,2,3088,24,3112,5017,3,1,3,0,1,0,62.03
臺北市,中山區,新生里,0,2,2343,24,2367,3970,3,1,3,0,1,0,59.62
臺北市,中山區,中庄里,0,2,2687,10,2697,4487,3,1,3,0,1,0,60.11
臺北市,中山區,行政里,0,2,2703,20,2723,5701,3,1,3,0,1,0,47.76
臺北市,中山區,行仁里,0,2,4012,26,4038,6589,3,1,3,0,1,0,61.28
臺北市,中山區,行孝里,0,2,2049,11,2060,3382,3,1,3,0,1,0,60.91
臺北市,中山區,下埤里,0,2,3532,20,3552,5975,3,1,3,0,1,0,59.45
臺北市,中山區,江寧里,0,2,3297,15,3312,5488,3,1,3,0,1,0,60.35
臺北市,中山區,江山里,0,2,3861,14,3875,6284,3,1,3,0,1,0,61.66
臺北市,中山區,中吉里,0,2,2482,6,2488,4072,3,1,3,0,1,0,61.10
臺北市,中山區,中原里,0,2,2279,17,2296,3860,3,1,3,0,1,0,59.48
臺北市,中山區,興亞里,0,2,2443,9,2452,4114,3,1,3,0,1,0,59.60
臺北市,中山區,中央里,0,2,1749,10,1759,2848,3,1,3,0,1,0,61.76
臺北市,中山區,朱馥里,0,2,3025,21,3046,4953,3,1,3,0,1,0,61.50
臺北市,中山區,龍洲里,0,2,2875,16,2891,4251,3,1,3,0,1,0,68.01
臺北市,中山區,朱園里,0,2,2157,14,2171,3544,3,1,3,0,1,0,61.26
臺北市,中山區,埤頭里,0,2,2024,13,2037,3284,3,1,3,0,1,0,62.03
臺北市,中山區,朱崙里,0,2,1495,6,1501,2563,3,1,3,0,1,0,58.56
臺北市,中山區,力行里,0,2,2878,18,2896,4775,3,1,3,0,1,0,60.65
臺北市,中山區,復華里,0,2,1919,10,1929,3214,3,1,3,0,1,0,60.02
臺北市,中山區,金泰里,0,2,2605,17,2622,4290,3,1,3,0,1,0,61.12
臺北市,中山區,北安里,0,2,1535,8,1543,2343,3,1,3,0,1,0,65.86
臺北市,大同區,玉泉里,0,2,1647,15,1662,2866,3,1,3,0,1,0,57.99
臺北市,大同區,建明里,0,2,1678,10,1688,2795,3,1,3,0,1,0,60.39
臺北市,大同區,建功里,0,2,2227,15,2242,3867,3,1,3,0,1,0,57.98
臺北市,大同區,建泰里,0,2,1801,11,1812,3000,3,1,3,0,1,0,60.40
臺北市,大同區,永樂里,0,2,2522,19,2541,4254,3,1,3,0,1,0,59.73
臺北市,大同區,朝陽里,0,2,1911,13,1924,3304,3,1,3,0,1,0,58.23
臺北市,大同區,星明里,0,2,2257,13,2270,3966,3,1,3,0,1,0,57.24
臺北市,大同區,光能里,0,2,2630,23,2653,4198,3,1,3,0,1,0,63.20
臺北市,大同區,大有里,0,2,2465,16,2481,4033,3,1,3,0,1,0,61.52
臺北市,大同區,延平里,0,2,1858,15,1873,3195,3,1,3,0,1,0,58.62
臺北市,大同區,雙連里,0,2,4541,27,4568,7620,3,1,3,0,1,0,59.95
臺北市,大同區,南芳里,0,2,1913,19,1932,3327,3,1,3,0,1,0,58.07
臺北市,大同區,民權里,0,2,3117,27,3144,5121,3,1,3,0,1,0,61.39
臺北市,大同區,景星里,0,2,1442,15,1457,2351,3,1,3,0,1,0,61.97
臺北市,大同區,隆和里,0,2,1614,11,1625,2689,3,1,3,0,1,0,60.43
臺北市,大同區,蓬萊里,0,2,2264,24,2288,3839,3,1,3,0,1,0,59.60
臺北市,大同區,國順里,0,2,1608,11,1619,2637,3,1,3,0,1,0,61.40
臺北市,大同區,國慶里,0,2,1839,7,1846,3089,3,1,3,0,1,0,59.76
臺北市,大同區,揚雅里,0,2,1621,13,1634,3065,3,1,3,0,1,0,53.31
臺北市,大同區,斯文里,0,2,2612,27,2639,4451,3,1,3,0,1,0,59.29
臺北市,大同區,鄰江里,0,2,3220,25,3245,5238,3,1,3,0,1,0,61.95
臺北市,大同區,至聖里,0,2,3920,25,3945,6236,3,1,3,0,1,0,63.26
臺北市,大同區,老師里,0,2,2888,16,2904,4754,3,1,3,0,1,0,61.09
臺北市,大同區,重慶里,0,2,2966,17,2983,4661,3,1,3,0,1,0,64.00
臺北市,大同區,保安里,0,2,2287,14,2301,3626,3,1,3,0,1,0,63.46
臺北市,中正區,水源里,0,2,1554,11,1565,2536,3,1,3,0,1,0,61.71
臺北市,中正區,富水里,0,2,1559,13,1572,2485,3,1,3,0,1,0,63.26
臺北市,中正區,文盛里,0,2,1454,7,1461,2240,3,1,3,0,1,0,65.22
臺北市,中正區,林興里,0,2,2434,14,2448,3946,3,1,3,0,1,0,62.04
臺北市,中正區,河堤里,0,2,2389,14,2403,3808,3,1,3,0,1,0,63.10
臺北市,中正區,頂東里,0,2,3031,17,3048,4695,3,1,3,0,1,0,64.92
臺北市,中正區,網溪里,0,2,2762,17,2779,4435,3,1,3,0,1,0,62.66
臺北市,中正區,板溪里,0,2,1738,7,1745,2808,3,1,3,0,1,0,62.14
臺北市,中正區,螢圃里,0,2,2867,6,2873,4392,3,1,3,0,1,0,65.41
臺北市,中正區,螢雪里,0,2,2223,13,2236,3575,3,1,3,0,1,0,62.55
臺北市,中正區,永功里,0,2,2976,11,2987,4941,3,1,3,0,1,0,60.45
臺北市,中正區,永昌里,0,2,2765,10,2775,4379,3,1,3,0,1,0,63.37
臺北市,中正區,龍興里,0,2,1857,15,1872,3066,3,1,3,0,1,0,61.06
臺北市,中正區,忠勤里,0,2,3454,34,3488,5689,3,1,3,0,1,0,61.31
臺北市,中正區,廈安里,0,2,1788,12,1800,3002,3,1,3,0,1,0,59.96
臺北市,中正區,愛國里,0,2,1577,3,1580,2469,3,1,3,0,1,0,63.99
臺北市,中正區,南門里,0,2,1411,5,1416,2206,3,1,3,0,1,0,64.19
臺北市,中正區,龍光里,0,2,1686,9,1695,2772,3,1,3,0,1,0,61.15
臺北市,中正區,南福里,0,2,4032,21,4053,6228,3,1,3,0,1,0,65.08
臺北市,中正區,龍福里,0,2,3014,21,3035,5423,3,1,3,0,1,0,55.97
臺北市,中正區,新營里,0,2,4100,36,4136,6319,3,1,3,0,1,0,65.45
臺北市,中正區,建國里,0,2,644,3,647,1098,3,1,3,0,1,0,58.93
臺北市,中正區,光復里,0,2,1737,15,1752,3004,3,1,3,0,1,0,58.3222370173
臺北市,中正區,黎明里,0,2,1319,4,1323,2438,3,1,3,0,1,0,54.2657916325
臺北市,中正區,梅花里,0,2,1682,8,1690,2785,3,1,3,0,1,0,60.6822262118
臺北市,中正區,幸福里,0,2,2210,6,2216,3681,3,1,3,0,1,0,60.2010323282
臺北市,中正區,幸市里,0,2,2081,7,2088,3394,3,1,3,0,1,0,61.5203299941
臺北市,中正區,東門里,0,2,2181,11,2192,3549,3,1,3,0,1,0,61.7638771485
臺北市,中正區,文北里,0,2,2590,13,2603,4138,3,1,3,0,1,0,62.9047849203
臺北市,中正區,文祥里,0,2,3473,19,3492,5454,3,1,3,0,1,0,64.0264026403
臺北市,中正區,三愛里,0,2,3891,13,3904,6070,3,1,3,0,1,0,64.3163097199
臺北市,萬華區,福星里,0,2,2457,21,2478,4248,3,1,3,0,1,0,58.3333333333
臺北市,萬華區,萬壽里,0,2,1485,15,1500,2774,3,1,3,0,1,0,54.0735400144
臺北市,萬華區,西門里,0,2,1605,10,1615,2962,3,1,3,0,1,0,54.5239702903
臺北市,萬華區,新起里,0,2,3405,24,3429,5855,3,1,3,0,1,0,58.5653287788
臺北市,萬華區,菜園里,0,2,2892,15,2907,4909,3,1,3,0,1,0,59.2177632919
臺北市,萬華區,青山里,0,2,2607,20,2627,4487,3,1,3,0,1,0,58.5469133051
臺北市,萬華區,富民里,0,2,2547,11,2558,4238,3,1,3,0,1,0,60.3586597452
臺北市,萬華區,福音里,0,2,1914,15,1929,3057,3,1,3,0,1,0,63.1010794897
臺北市,萬華區,仁德里,0,2,2286,14,2300,3557,3,1,3,0,1,0,64.6612313748
臺北市,萬華區,富福里,0,2,2465,15,2480,4183,3,1,3,0,1,0,59.2875926369
臺北市,萬華區,柳鄉里,0,2,2661,21,2682,4464,3,1,3,0,1,0,60.0806451613
臺北市,萬華區,華江里,0,2,4205,30,4235,7004,3,1,3,0,1,0,60.4654483152
臺北市,萬華區,糖部里,0,2,2591,18,2609,4525,3,1,3,0,1,0,57.6574585635
臺北市,萬華區,綠堤里,0,2,2247,19,2266,3903,3,1,3,0,1,0,58.0579041763
臺北市,萬華區,頂碩里,0,2,4093,30,4123,6916,3,1,3,0,1,0,59.6153846154
臺北市,萬華區,雙園里,0,2,2497,13,2510,4052,3,1,3,0,1,0,61.9447186575
臺北市,萬華區,和平里,0,2,3702,27,3729,6043,3,1,3,0,1,0,61.7077610458
臺北市,萬華區,和德里,0,2,3328,21,3349,5864,3,1,3,0,1,0,57.1111869031
臺北市,萬華區,全德里,0,2,2161,18,2179,3548,3,1,3,0,1,0,61.4148816234
臺北市,萬華區,日善里,0,2,2019,13,2032,3233,3,1,3,0,1,0,62.8518403959
臺北市,萬華區,壽德里,0,2,2613,18,2631,4251,3,1,3,0,1,0,61.8913196895
臺北市,萬華區,忠德里,0,2,2283,18,2301,3748,3,1,3,0,1,0,61.3927427962
臺北市,萬華區,錦德里,0,2,2653,18,2671,4410,3,1,3,0,1,0,60.566893424
臺北市,萬華區,銘德里,0,2,2458,18,2476,3952,3,1,3,0,1,0,62.6518218623
臺北市,萬華區,孝德里,0,2,1651,5,1656,2675,3,1,3,0,1,0,61.9065420561
臺北市,萬華區,保德里,0,2,1640,6,1646,2481,3,1,3,0,1,0,66.3442160419
臺北市,萬華區,榮德里,0,2,2040,13,2053,3180,3,1,3,0,1,0,64.5597484277
臺北市,萬華區,華中里,0,2,3209,27,3236,5159,3,1,3,0,1,0,62.7253343671
臺北市,萬華區,興德里,0,2,2452,17,2469,3983,3,1,3,0,1,0,61.9884509164
臺北市,萬華區,日祥里,0,2,2720,12,2732,4322,3,1,3,0,1,0,63.2114761684
臺北市,萬華區,忠貞里,0,2,2899,16,2915,4327,3,1,3,0,1,0,67.367691241
臺北市,萬華區,新忠里,0,2,2191,10,2201,3292,3,1,3,0,1,0,66.8590522479
臺北市,萬華區,新和里,0,2,5023,21,5044,7375,3,1,3,0,1,0,68.393220339
臺北市,萬華區,新安里,0,2,3331,25,3356,5365,3,1,3,0,1,0,62.5535880708
臺北市,萬華區,凌霄里,0,2,2201,12,2213,3425,3,1,3,0,1,0,64.6131386861
臺北市,萬華區,騰雲里,0,2,1687,7,1694,2633,3,1,3,0,1,0,64.3372578807
臺北市,大安區,德安里,0,2,2842,13,2855,4581,3,1,3,0,1,0,62.3226369788
臺北市,大安區,仁慈里,0,2,2342,10,2352,3876,3,1,3,0,1,0,60.6811145511
臺北市,大安區,和安里,0,2,3083,15,3098,4981,3,1,3,0,1,0,62.1963461152
臺北市,大安區,民炤里,0,2,3824,15,3839,6280,3,1,3,0,1,0,61.1305732484
臺北市,大安區,仁愛里,0,2,2520,11,2531,4614,3,1,3,0,1,0,54.8547897703
臺北市,大安區,義村里,0,2,3519,11,3530,5443,3,1,3,0,1,0,64.8539408414
臺北市,大安區,民輝里,0,2,3325,10,3335,5457,3,1,3,0,1,0,61.1141652923
臺北市,大安區,昌隆里,0,2,1733,5,1738,2690,3,1,3,0,1,0,64.6096654275
臺北市,大安區,誠安里,0,2,2269,12,2281,3678,3,1,3,0,1,0,62.0174007613
臺北市,大安區,光武里,0,2,3668,20,3688,6387,3,1,3,0,1,0,57.7422890246
臺北市,大安區,龍坡里,0,2,2961,9,2970,4611,3,1,3,0,1,0,64.4111906311
臺北市,大安區,龍泉里,0,2,2211,8,2219,3595,3,1,3,0,1,0,61.7246175243
臺北市,大安區,古風里,0,2,2047,8,2055,3260,3,1,3,0,1,0,63.036809816
臺北市,大安區,古莊里,0,2,3149,17,3166,5103,3,1,3,0,1,0,62.041936116
臺北市,大安區,龍安里,0,2,2837,18,2855,5742,3,1,3,0,1,0,49.7213514455
臺北市,大安區,錦安里,0,2,2569,9,2578,4007,3,1,3,0,1,0,64.3374095333
臺北市,大安區,福住里,0,2,2714,7,2721,4361,3,1,3,0,1,0,62.3939463426
臺北市,大安區,永康里,0,2,1682,3,1685,2555,3,1,3,0,1,0,65.9491193738
臺北市,大安區,光明里,0,2,1882,13,1895,2924,3,1,3,0,1,0,64.8084815321
臺北市,大安區,錦泰里,0,2,2619,10,2629,3905,3,1,3,0,1,0,67.323943662
臺北市,大安區,錦華里,0,2,2624,14,2638,4042,3,1,3,0,1,0,65.2647204354
臺北市,大安區,龍圖里,0,2,3222,14,3236,5251,3,1,3,0,1,0,61.6263568844
臺北市,大安區,新龍里,0,2,3397,19,3416,5169,3,1,3,0,1,0,66.0862836139
臺北市,大安區,龍陣里,0,2,1850,16,1866,2960,3,1,3,0,1,0,63.0405405405
臺北市,大安區,龍雲里,0,2,2510,10,2520,4066,3,1,3,0,1,0,61.9773733399
臺北市,大安區,龍生里,0,2,3281,17,3298,4979,3,1,3,0,1,0,66.2382004419
臺北市,大安區,住安里,0,2,2623,23,2646,4355,3,1,3,0,1,0,60.757749713
臺北市,大安區,義安里,0,2,2695,10,2705,4454,3,1,3,0,1,0,60.7319263583
臺北市,大安區,通化里,0,2,3033,12,3045,4980,3,1,3,0,1,0,61.1445783133
臺北市,大安區,通安里,0,2,2870,11,2881,4725,3,1,3,0,1,0,60.9735449735
臺北市,大安區,臨江里,0,2,2116,9,2125,3470,3,1,3,0,1,0,61.2391930836
臺北市,大安區,法治里,0,2,2222,13,2235,3568,3,1,3,0,1,0,62.6401345291
臺北市,大安區,全安里,0,2,2151,6,2157,3493,3,1,3,0,1,0,61.7520755797
臺北市,大安區,群賢里,0,2,3040,14,3054,4957,3,1,3,0,1,0,61.6098446641
臺北市,大安區,群英里,0,2,4043,19,4062,5939,3,1,3,0,1,0,68.395352753
臺北市,大安區,虎嘯里,0,2,1674,7,1681,2722,3,1,3,0,1,0,61.7560617193
臺北市,大安區,臥龍里,0,2,1074,5,1079,1774,3,1,3,0,1,0,60.8229988726
臺北市,大安區,龍淵里,0,2,4459,16,4475,6928,3,1,3,0,1,0,64.5929561201
臺北市,大安區,龍門里,0,2,2068,10,2078,3306,3,1,3,0,1,0,62.8554143981
臺北市,大安區,大學里,0,2,3990,21,4011,6473,3,1,3,0,1,0,61.9650857408
臺北市,大安區,芳和里,0,2,3218,17,3235,5071,3,1,3,0,1,0,63.7941234471
臺北市,大安區,黎元里,0,2,2825,14,2839,4498,3,1,3,0,1,0,63.1169408626
臺北市,大安區,黎孝里,0,2,3992,28,4020,6229,3,1,3,0,1,0,64.5368437952
臺北市,大安區,黎和里,0,2,2161,15,2176,3566,3,1,3,0,1,0,61.0207515423
臺北市,大安區,建安里,0,2,2292,16,2308,4089,3,1,3,0,1,0,56.4441183663
臺北市,大安區,建倫里,0,2,2798,13,2811,4870,3,1,3,0,1,0,57.7207392197
臺北市,大安區,敦安里,0,2,3023,12,3035,4969,3,1,3,0,1,0,61.0786878648
臺北市,大安區,正聲里,0,2,2325,8,2333,3970,3,1,3,0,1,0,58.765743073
臺北市,大安區,敦煌里,0,2,2925,12,2937,4769,3,1,3,0,1,0,61.5852379954
臺北市,大安區,華聲里,0,2,2091,12,2103,3499,3,1,3,0,1,0,60.102886539
臺北市,大安區,車層里,0,2,3100,11,3111,5252,3,1,3,0,1,0,59.2345773039
臺北市,大安區,光信里,0,2,3852,20,3872,6285,3,1,3,0,1,0,61.6070007955
臺北市,大安區,學府里,0,2,1932,7,1939,3063,3,1,3,0,1,0,63.3039503754
臺北市,文山區,景行里,0,2,2661,15,2676,4363,3,1,3,0,1,0,61.3339445336
臺北市,文山區,景東里,0,2,3194,14,3208,5225,3,1,3,0,1,0,61.3971291866
臺北市,文山區,景美里,0,2,2252,5,2257,3520,3,1,3,0,1,0,64.1193181818
臺北市,文山區,景慶里,0,2,3082,20,3102,4955,3,1,3,0,1,0,62.6034308779
臺北市,文山區,景仁里,0,2,2302,13,2315,3573,3,1,3,0,1,0,64.7914917436
臺北市,文山區,景華里,0,2,2827,6,2833,4481,3,1,3,0,1,0,63.2224949788
臺北市,文山區,萬有里,0,2,2424,11,2435,3737,3,1,3,0,1,0,65.1592186246
臺北市,文山區,萬祥里,0,2,2328,13,2341,3566,3,1,3,0,1,0,65.6477846326
臺北市,文山區,萬隆里,0,2,3614,21,3635,5625,3,1,3,0,1,0,64.6222222222
臺北市,文山區,萬年里,0,2,2656,15,2671,4274,3,1,3,0,1,0,62.4941506785
臺北市,文山區,萬和里,0,2,1868,11,1879,2758,3,1,3,0,1,0,68.1290790428
臺北市,文山區,萬盛里,0,2,2401,6,2407,3819,3,1,3,0,1,0,63.0269704111
臺北市,文山區,興豐里,0,2,4391,13,4404,6891,3,1,3,0,1,0,63.9094471049
臺北市,文山區,興光里,0,2,1530,10,1540,2536,3,1,3,0,1,0,60.7255520505
臺北市,文山區,興家里,0,2,3695,20,3715,5897,3,1,3,0,1,0,62.9981346447
臺北市,文山區,興得里,0,2,3032,11,3043,5035,3,1,3,0,1,0,60.4369414101
臺北市,文山區,興業里,0,2,2786,13,2799,4824,3,1,3,0,1,0,58.0223880597
臺北市,文山區,興安里,0,2,3263,11,3274,4981,3,1,3,0,1,0,65.7297731379
臺北市,文山區,興福里,0,2,2985,10,2995,4619,3,1,3,0,1,0,64.8408746482
臺北市,文山區,興旺里,0,2,3346,25,3371,5533,3,1,3,0,1,0,60.9253569492
臺北市,文山區,興泰里,0,2,1866,8,1874,3055,3,1,3,0,1,0,61.3420621931
臺北市,文山區,興昌里,0,2,3227,12,3239,5126,3,1,3,0,1,0,63.1876706984
臺北市,文山區,試院里,0,2,3287,14,3301,5008,3,1,3,0,1,0,65.9145367412
臺北市,文山區,華興里,0,2,3789,19,3808,5908,3,1,3,0,1,0,64.4549763033
臺北市,文山區,明義里,0,2,2156,34,2190,3850,3,1,3,0,1,0,56.8831168831
臺北市,文山區,明興里,0,2,3401,13,3414,5559,3,1,3,0,1,0,61.4139233675
臺北市,文山區,木柵里,0,2,3957,22,3979,5950,3,1,3,0,1,0,66.8739495798
臺北市,文山區,木新里,0,2,4195,31,4226,6935,3,1,3,0,1,0,60.9372746936
臺北市,文山區,順興里,0,2,3433,15,3448,5456,3,1,3,0,1,0,63.1964809384
臺北市,文山區,忠順里,0,2,1963,11,1974,3029,3,1,3,0,1,0,65.1700231099
臺北市,文山區,樟林里,0,2,4224,15,4239,6573,3,1,3,0,1,0,64.4910999544
臺北市,文山區,樟新里,0,2,5595,32,5627,8977,3,1,3,0,1,0,62.6824106049
臺北市,文山區,樟腳里,0,2,4522,40,4562,7151,3,1,3,0,1,0,63.7952733883
臺北市,文山區,萬芳里,0,2,3641,11,3652,5743,3,1,3,0,1,0,63.5904579488
臺北市,文山區,萬美里,0,2,3182,23,3205,5245,3,1,3,0,1,0,61.105815062
臺北市,文山區,博嘉里,0,2,2338,16,2354,3814,3,1,3,0,1,0,61.7199790246
臺北市,文山區,萬興里,0,2,5285,25,5310,8630,3,1,3,0,1,0,61.5295480881
臺北市,文山區,指南里,0,2,1452,10,1462,2358,3,1,3,0,1,0,62.0016963528
臺北市,文山區,老泉里,0,2,404,5,409,704,3,1,3,0,1,0,58.0965909091
高雄市,鹽埕區,藍橋里,0,1,815,4,819,1289,3,1,3,0,1,0,63.54
高雄市,鹽埕區,慈愛里,0,1,309,1,310,477,3,1,3,0,1,0,64.99
高雄市,鹽埕區,博愛里,0,1,432,2,434,724,3,1,3,0,1,0,59.94
高雄市,鹽埕區,壽星里,0,1,817,6,823,1329,3,1,3,0,1,0,61.93
高雄市,鹽埕區,中山里,0,1,704,2,706,1185,3,1,3,0,1,0,59.58
高雄市,鹽埕區,教仁里,0,1,1344,11,1355,2219,3,1,3,0,1,0,61.06
高雄市,鹽埕區,新樂里,0,1,612,5,617,940,3,1,3,0,1,0,65.64
高雄市,鹽埕區,中原里,0,1,460,0,460,698,3,1,3,0,1,0,65.90
高雄市,鹽埕區,光明里,0,1,750,5,755,1227,3,1,3,0,1,0,61.53
高雄市,鹽埕區,育仁里,0,1,493,3,496,829,3,1,3,0,1,0,59.83
高雄市,鹽埕區,河濱里,0,1,1084,3,1087,1860,3,1,3,0,1,0,58.44
高雄市,鹽埕區,沙地里,0,1,637,2,639,1095,3,1,3,0,1,0,58.36
高雄市,鹽埕區,南端里,0,1,660,4,664,1101,3,1,3,0,1,0,60.31
高雄市,鹽埕區,港都里,0,1,682,3,685,1175,3,1,3,0,1,0,58.30
高雄市,鹽埕區,江西里,0,1,740,7,747,1200,3,1,3,0,1,0,62.25
高雄市,鹽埕區,新豐里,0,1,392,1,393,599,3,1,3,0,1,0,65.61
高雄市,鹽埕區,府北里,0,1,978,5,983,1802,3,1,3,0,1,0,54.55
高雄市,鹽埕區,陸橋里,0,1,754,8,762,1245,3,1,3,0,1,0,61.20
高雄市,鹽埕區,瀨南里,0,1,449,2,451,718,3,1,3,0,1,0,62.81
高雄市,鹽埕區,新化里,0,1,451,2,453,705,3,1,3,0,1,0,64.26
高雄市,鹽埕區,江南里,0,1,571,1,572,935,3,1,3,0,1,0,61.18
高雄市,鼓山區,鼓峰里,0,1,1278,9,1287,2012,3,1,3,0,1,0,63.97
高雄市,鼓山區,雄峰里,0,1,1248,11,1259,2089,3,1,3,0,1,0,60.27
高雄市,鼓山區,前峰里,0,1,2805,17,2822,4265,3,1,3,0,1,0,66.17
高雄市,鼓山區,光榮里,0,1,2348,13,2361,3874,3,1,3,0,1,0,60.94
高雄市,鼓山區,民族里,0,1,962,0,962,1457,3,1,3,0,1,0,66.03
高雄市,鼓山區,內惟里,0,1,771,6,777,1194,3,1,3,0,1,0,65.08
高雄市,鼓山區,建國里,0,1,1341,4,1345,2084,3,1,3,0,1,0,64.54
高雄市,鼓山區,忠正里,0,1,2337,9,2346,3951,3,1,3,0,1,0,59.38
高雄市,鼓山區,自強里,0,1,586,3,589,830,3,1,3,0,1,0,70.96
高雄市,鼓山區,龍井里,0,1,919,10,929,1480,3,1,3,0,1,0,62.77
高雄市,鼓山區,正德里,0,1,1069,9,1078,1839,3,1,3,0,1,0,58.62
高雄市,鼓山區,平和里,0,1,1945,12,1957,3218,3,1,3,0,1,0,60.81
高雄市,鼓山區,民強里,0,1,1764,13,1777,2800,3,1,3,0,1,0,63.46
高雄市,鼓山區,厚生里,0,1,1594,13,1607,2610,3,1,3,0,1,0,61.57
高雄市,鼓山區,龍子里,0,1,3081,23,3104,5468,3,1,3,0,1,0,56.77
高雄市,鼓山區,龍水里,0,1,1555,3,1558,2784,3,1,3,0,1,0,55.96
高雄市,鼓山區,明誠里,0,1,6087,23,6110,10616,3,1,3,0,1,0,57.55
高雄市,鼓山區,華豐里,0,1,2247,8,2255,3626,3,1,3,0,1,0,62.19
高雄市,鼓山區,裕興里,0,1,1702,6,1708,2857,3,1,3,0,1,0,59.78
高雄市,鼓山區,裕豐里,0,1,1408,2,1410,2333,3,1,3,0,1,0,60.44
高雄市,鼓山區,鼓岩里,0,1,840,10,850,1492,3,1,3,0,1,0,56.97
高雄市,鼓山區,樹德里,0,1,752,14,766,1176,3,1,3,0,1,0,65.14
高雄市,鼓山區,寶樹里,0,1,607,7,614,1240,3,1,3,0,1,0,49.52
高雄市,鼓山區,興宗里,0,1,893,4,897,1488,3,1,3,0,1,0,60.28
高雄市,鼓山區,光化里,0,1,930,12,942,1524,3,1,3,0,1,0,61.81
高雄市,鼓山區,山下里,0,1,775,8,783,1310,3,1,3,0,1,0,59.77
高雄市,鼓山區,河邊里,0,1,957,10,967,1550,3,1,3,0,1,0,62.39
高雄市,鼓山區,綠川里,0,1,922,6,928,1560,3,1,3,0,1,0,59.49
高雄市,鼓山區,登山里,0,1,504,4,508,804,3,1,3,0,1,0,63.18
高雄市,鼓山區,峰南里,0,1,586,9,595,1034,3,1,3,0,1,0,57.54
高雄市,鼓山區,麗興里,0,1,649,7,656,1158,3,1,3,0,1,0,56.65
高雄市,鼓山區,新民里,0,1,676,7,683,1150,3,1,3,0,1,0,59.39
高雄市,鼓山區,延平里,0,1,580,2,582,912,3,1,3,0,1,0,63.82
高雄市,鼓山區,維生里,0,1,843,4,847,1419,3,1,3,0,1,0,59.69
高雄市,鼓山區,惠安里,0,1,769,7,776,1409,3,1,3,0,1,0,55.07
高雄市,鼓山區,壽山里,0,1,873,7,880,1568,3,1,3,0,1,0,56.12
高雄市,鼓山區,哨船頭里,0,1,694,5,699,1174,3,1,3,0,1,0,59.54
高雄市,鼓山區,桃源里,0,1,317,1,318,602,3,1,3,0,1,0,52.82
高雄市,旗津區,旗下里,0,1,699,8,707,1230,3,1,3,0,1,0,57.48
高雄市,旗津區,永安里,0,1,626,6,632,1077,3,1,3,0,1,0,58.68
高雄市,旗津區,振興里,0,1,910,10,920,1682,3,1,3,0,1,0,54.70
高雄市,旗津區,慈愛里,0,1,1126,6,1132,2094,3,1,3,0,1,0,54.06
高雄市,旗津區,復興里,0,1,1445,18,1463,2761,3,1,3,0,1,0,52.99
高雄市,旗津區,中華里,0,1,720,6,726,1264,3,1,3,0,1,0,57.44
高雄市,旗津區,實踐里,0,1,714,13,727,1292,3,1,3,0,1,0,56.27
高雄市,旗津區,北汕里,0,1,1266,7,1273,2431,3,1,3,0,1,0,52.37
高雄市,旗津區,南汕里,0,1,929,7,936,1670,3,1,3,0,1,0,56.05
高雄市,旗津區,上竹里,0,1,1353,6,1359,2557,3,1,3,0,1,0,53.15
高雄市,旗津區,中洲里,0,1,929,6,935,1624,3,1,3,0,1,0,57.57
高雄市,旗津區,安順里,0,1,475,5,480,926,3,1,3,0,1,0,51.84
高雄市,旗津區,中興里,0,1,1238,4,1242,2193,3,1,3,0,1,0,56.63
高雄市,左營區,進學里,0,1,934,10,944,2016,3,1,3,0,1,0,46.83
高雄市,左營區,尾西里,0,1,779,4,783,1194,3,1,3,0,1,0,65.58
高雄市,左營區,頂北里,0,1,363,6,369,591,3,1,3,0,1,0,62.44
高雄市,左營區,中北里,0,1,430,4,434,692,3,1,3,0,1,0,62.72
高雄市,左營區,中南里,0,1,346,6,352,566,3,1,3,0,1,0,62.19
高雄市,左營區,廟東里,0,1,598,1,599,887,3,1,3,0,1,0,67.53
高雄市,左營區,廟北里,0,1,653,3,656,1025,3,1,3,0,1,0,64.00
高雄市,左營區,尾南里,0,1,521,1,522,817,3,1,3,0,1,0,63.89
高雄市,左營區,尾北里,0,1,1802,12,1814,2890,3,1,3,0,1,0,62.77
高雄市,左營區,屏山里,0,1,910,10,920,1436,3,1,3,0,1,0,64.07
高雄市,左營區,祥和里,0,1,436,1,437,586,3,1,3,0,1,0,74.57
高雄市,左營區,永清里,0,1,1260,7,1267,1946,3,1,3,0,1,0,65.11
高雄市,左營區,復興里,0,1,824,2,826,1226,3,1,3,0,1,0,67.37
高雄市,左營區,莒光里,0,1,1044,5,1049,1718,3,1,3,0,1,0,61.06
高雄市,左營區,光輝里,0,1,1504,9,1513,2491,3,1,3,0,1,0,60.74
高雄市,左營區,合群里,0,1,920,2,922,1325,3,1,3,0,1,0,69.58
高雄市,左營區,自治里,0,1,56,0,56,158,3,1,3,0,1,0,35.44
高雄市,左營區,明建里,0,1,981,6,987,1505,3,1,3,0,1,0,65.58
高雄市,左營區,自立里,0,1,19,0,19,46,3,1,3,0,1,0,41.30
高雄市,左營區,頂西里,0,1,766,3,769,1152,3,1,3,0,1,0,66.75
高雄市,左營區,聖后里,0,1,598,4,602,914,3,1,3,0,1,0,65.86
高雄市,左營區,聖西里,0,1,236,0,236,368,3,1,3,0,1,0,64.13
高雄市,左營區,聖南里,0,1,344,0,344,583,3,1,3,0,1,0,59.01
高雄市,左營區,城南里,0,1,370,0,370,568,3,1,3,0,1,0,65.14
高雄市,左營區,路東里,0,1,480,2,482,768,3,1,3,0,1,0,62.76
高雄市,左營區,部北里,0,1,330,14,344,535,3,1,3,0,1,0,64.30
高雄市,左營區,部南里,0,1,458,0,458,713,3,1,3,0,1,0,64.24
高雄市,左營區,埤西里,0,1,709,9,718,1091,3,1,3,0,1,0,65.81
高雄市,左營區,埤北里,0,1,865,7,872,1418,3,1,3,0,1,0,61.50
高雄市,左營區,埤東里,0,1,734,4,738,1184,3,1,3,0,1,0,62.33
高雄市,左營區,海勝里,0,1,3891,13,3904,5654,3,1,3,0,1,0,69.05
高雄市,左營區,自勉里,0,1,15,0,15,59,3,1,3,0,1,0,25.42
高雄市,左營區,崇實里,0,1,783,3,786,1113,3,1,3,0,1,0,70.62
高雄市,左營區,自助里,0,1,1520,9,1529,2292,3,1,3,0,1,0,66.71
高雄市,左營區,果貿里,0,1,1323,6,1329,1895,3,1,3,0,1,0,70.13
高雄市,左營區,果惠里,0,1,960,4,964,1541,3,1,3,0,1,0,62.56
高雄市,左營區,果峰里,0,1,1143,8,1151,1705,3,1,3,0,1,0,67.51
高雄市,左營區,新下里,0,1,5530,34,5564,9892,3,1,3,0,1,0,56.25
高雄市,左營區,新上里,0,1,10476,43,10519,19036,3,1,3,0,1,0,55.26
高雄市,左營區,新中里,0,1,2626,18,2644,4518,3,1,3,0,1,0,58.52
高雄市,左營區,新光里,0,1,5134,25,5159,9288,3,1,3,0,1,0,55.54
高雄市,左營區,菜公里,0,1,9511,49,9560,18155,3,1,3,0,1,0,52.66
高雄市,左營區,福山里,0,1,10390,55,10445,20840,3,1,3,0,1,0,50.12
高雄市,楠梓區,清豐里,0,1,5218,33,5251,9737,3,1,3,0,1,0,53.93
高雄市,楠梓區,東寧里,0,1,1278,9,1287,2239,3,1,3,0,1,0,57.48
高雄市,楠梓區,五常里,0,1,2225,14,2239,4287,3,1,3,0,1,0,52.23
高雄市,楠梓區,享平里,0,1,1506,10,1516,2691,3,1,3,0,1,0,56.34
高雄市,楠梓區,中陽里,0,1,1586,11,1597,2626,3,1,3,0,1,0,60.81
高雄市,楠梓區,惠楠里,0,1,1269,11,1280,2550,3,1,3,0,1,0,50.20
高雄市,楠梓區,惠民里,0,1,1839,12,1851,3231,3,1,3,0,1,0,57.29
高雄市,楠梓區,惠豐里,0,1,1622,9,1631,3051,3,1,3,0,1,0,53.46
高雄市,楠梓區,錦屏里,0,1,1992,10,2002,3362,3,1,3,0,1,0,59.55
高雄市,楠梓區,玉屏里,0,1,1379,4,1383,2296,3,1,3,0,1,0,60.24
高雄市,楠梓區,金田里,0,1,1881,11,1892,3136,3,1,3,0,1,0,60.33
高雄市,楠梓區,稔田里,0,1,951,7,958,1591,3,1,3,0,1,0,60.21
高雄市,楠梓區,瑞屏里,0,1,1709,7,1716,3148,3,1,3,0,1,0,54.51
高雄市,楠梓區,翠屏里,0,1,5855,29,5884,10955,3,1,3,0,1,0,53.71
高雄市,楠梓區,宏南里,0,1,1069,12,1081,1654,3,1,3,0,1,0,65.36
高雄市,楠梓區,宏毅里,0,1,1857,13,1870,2874,3,1,3,0,1,0,65.07
高雄市,楠梓區,宏榮里,0,1,1455,7,1462,2160,3,1,3,0,1,0,67.69
高雄市,楠梓區,廣昌里,0,1,1872,18,1890,3005,3,1,3,0,1,0,62.90
高雄市,楠梓區,久昌里,0,1,1204,8,1212,2236,3,1,3,0,1,0,54.20
高雄市,楠梓區,大昌里,0,1,1232,9,1241,1992,3,1,3,0,1,0,62.30
高雄市,楠梓區,福昌里,0,1,2032,10,2042,3208,3,1,3,0,1,0,63.65
高雄市,楠梓區,盛昌里,0,1,1600,5,1605,2780,3,1,3,0,1,0,57.73
高雄市,楠梓區,泰昌里,0,1,926,7,933,1541,3,1,3,0,1,0,60.55
高雄市,楠梓區,興昌里,0,1,1777,7,1784,3143,3,1,3,0,1,0,56.76
高雄市,楠梓區,建昌里,0,1,1383,6,1389,2403,3,1,3,0,1,0,57.80
高雄市,楠梓區,宏昌里,0,1,1334,10,1344,2354,3,1,3,0,1,0,57.09
高雄市,楠梓區,和昌里,0,1,1320,9,1329,2091,3,1,3,0,1,0,63.56
高雄市,楠梓區,慶昌里,0,1,1981,12,1993,3106,3,1,3,0,1,0,64.17
高雄市,楠梓區,隆昌里,0,1,1925,8,1933,3241,3,1,3,0,1,0,59.64
高雄市,楠梓區,秀昌里,0,1,1164,7,1171,2013,3,1,3,0,1,0,58.17
高雄市,楠梓區,裕昌里,0,1,1737,15,1752,2853,3,1,3,0,1,0,61.41
高雄市,楠梓區,國昌里,0,1,1821,12,1833,3152,3,1,3,0,1,0,58.15
高雄市,楠梓區,加昌里,0,1,3235,14,3249,5803,3,1,3,0,1,0,55.99
高雄市,楠梓區,仁昌里,0,1,1879,9,1888,3468,3,1,3,0,1,0,54.44
高雄市,楠梓區,藍田里,0,1,591,34,625,1035,3,1,3,0,1,0,60.39
高雄市,楠梓區,中興里,0,1,498,2,500,847,3,1,3,0,1,0,59.03
高雄市,楠梓區,中和里,0,1,932,2,934,1487,3,1,3,0,1,0,62.81
高雄市,三民區,鼎金里,0,1,1677,9,1686,3106,3,1,3,0,1,0,54.28
高雄市,三民區,鼎盛里,0,1,3138,29,3167,5867,3,1,3,0,1,0,53.98
高雄市,三民區,鼎強里,0,1,1873,4,1877,3437,3,1,3,0,1,0,54.61
高雄市,三民區,鼎力里,0,1,1907,16,1923,3414,3,1,3,0,1,0,56.33
高雄市,三民區,鼎西里,0,1,2943,21,2964,5523,3,1,3,0,1,0,53.67
高雄市,三民區,鼎中里,0,1,1927,12,1939,3116,3,1,3,0,1,0,62.23
高雄市,三民區,鼎泰里,0,1,8997,42,9039,16308,3,1,3,0,1,0,55.43
高雄市,三民區,本館里,0,1,4302,29,4331,7418,3,1,3,0,1,0,58.39
高雄市,三民區,本和里,0,1,3247,22,3269,5881,3,1,3,0,1,0,55.59
高雄市,三民區,本文里,0,1,1216,9,1225,2029,3,1,3,0,1,0,60.37
高雄市,三民區,本武里,0,1,887,6,893,1508,3,1,3,0,1,0,59.22
高雄市,三民區,本元里,0,1,2442,16,2458,4406,3,1,3,0,1,0,55.79
高雄市,三民區,本安里,0,1,2134,13,2147,3789,3,1,3,0,1,0,56.66
高雄市,三民區,本上里,0,1,2329,11,2340,4109,3,1,3,0,1,0,56.95
高雄市,三民區,本揚里,0,1,3649,18,3667,6516,3,1,3,0,1,0,56.28
高雄市,三民區,寶獅里,0,1,1935,12,1947,3434,3,1,3,0,1,0,56.70
高雄市,三民區,寶德里,0,1,2449,17,2466,4468,3,1,3,0,1,0,55.19
高雄市,三民區,寶泰里,0,1,1561,6,1567,3115,3,1,3,0,1,0,50.30
高雄市,三民區,寶興里,0,1,2964,19,2983,5265,3,1,3,0,1,0,56.66
高雄市,三民區,寶中里,0,1,1597,6,1603,2668,3,1,3,0,1,0,60.08
高雄市,三民區,寶華里,0,1,1637,4,1641,2789,3,1,3,0,1,0,58.84
高雄市,三民區,寶國里,0,1,3415,21,3436,6399,3,1,3,0,1,0,53.70
高雄市,三民區,寶民里,0,1,1477,9,1486,2636,3,1,3,0,1,0,56.37
高雄市,三民區,寶慶里,0,1,1281,5,1286,2433,3,1,3,0,1,0,52.86
高雄市,三民區,寶業里,0,1,2260,10,2270,4177,3,1,3,0,1,0,54.35
高雄市,三民區,寶盛里,0,1,2334,13,2347,3950,3,1,3,0,1,0,59.42
高雄市,三民區,寶安里,0,1,3103,15,3118,5900,3,1,3,0,1,0,52.85
高雄市,三民區,寶龍里,0,1,2238,8,2246,3921,3,1,3,0,1,0,57.28
高雄市,三民區,寶珠里,0,1,2541,17,2558,5230,3,1,3,0,1,0,48.91
高雄市,三民區,寶玉里,0,1,3683,31,3714,7034,3,1,3,0,1,0,52.80
高雄市,三民區,灣子里,0,1,1593,4,1597,3029,3,1,3,0,1,0,52.72
高雄市,三民區,灣愛里,0,1,1490,9,1499,2902,3,1,3,0,1,0,51.65
高雄市,三民區,灣中里,0,1,2274,13,2287,4003,3,1,3,0,1,0,57.13
高雄市,三民區,灣華里,0,1,1448,10,1458,2611,3,1,3,0,1,0,55.84
高雄市,三民區,灣勝里,0,1,1201,7,1208,2018,3,1,3,0,1,0,59.86
高雄市,三民區,灣利里,0,1,1919,13,1932,3229,3,1,3,0,1,0,59.83
高雄市,三民區,灣復里,0,1,1567,20,1587,2951,3,1,3,0,1,0,53.78
高雄市,三民區,正興里,0,1,4667,34,4701,8910,3,1,3,0,1,0,52.76
高雄市,三民區,正順里,0,1,1926,13,1939,3281,3,1,3,0,1,0,59.10
高雄市,三民區,灣興里,0,1,911,4,915,1506,3,1,3,0,1,0,60.76
高雄市,三民區,灣成里,0,1,1074,7,1081,1980,3,1,3,0,1,0,54.60
高雄市,三民區,安康里,0,1,1584,3,1587,2911,3,1,3,0,1,0,54.52
高雄市,三民區,安寧里,0,1,1067,10,1077,2016,3,1,3,0,1,0,53.42
高雄市,三民區,安吉里,0,1,2175,11,2186,4224,3,1,3,0,1,0,51.75
高雄市,三民區,安發里,0,1,2278,21,2299,4133,3,1,3,0,1,0,55.63
高雄市,三民區,安東里,0,1,1897,7,1904,3123,3,1,3,0,1,0,60.97
高雄市,三民區,安和里,0,1,1614,5,1619,2657,3,1,3,0,1,0,60.93
高雄市,三民區,達德里,0,1,875,4,879,1428,3,1,3,0,1,0,61.55
高雄市,三民區,達明里,0,1,1034,7,1041,1666,3,1,3,0,1,0,62.48
高雄市,三民區,達仁里,0,1,900,6,906,1443,3,1,3,0,1,0,62.79
高雄市,三民區,達勇里,0,1,616,3,619,1056,3,1,3,0,1,0,58.62
高雄市,三民區,同德里,0,1,1623,9,1632,2752,3,1,3,0,1,0,59.30
高雄市,三民區,德智里,0,1,1465,9,1474,2415,3,1,3,0,1,0,61.04
高雄市,三民區,德仁里,0,1,1078,4,1082,1915,3,1,3,0,1,0,56.50
高雄市,三民區,安生里,0,1,1035,8,1043,1667,3,1,3,0,1,0,62.57
高雄市,三民區,德東里,0,1,527,6,533,874,3,1,3,0,1,0,60.98
高雄市,三民區,德行里,0,1,653,0,653,1102,3,1,3,0,1,0,59.26
高雄市,三民區,精華里,0,1,994,5,999,1586,3,1,3,0,1,0,62.99
高雄市,三民區,民享里,0,1,1262,5,1267,2029,3,1,3,0,1,0,62.44
高雄市,三民區,安宜里,0,1,1878,15,1893,3162,3,1,3,0,1,0,59.87
高雄市,三民區,安泰里,0,1,2217,19,2236,3925,3,1,3,0,1,0,56.97
高雄市,三民區,安邦里,0,1,2141,13,2154,3946,3,1,3,0,1,0,54.59
高雄市,三民區,十全里,0,1,905,3,908,1557,3,1,3,0,1,0,58.32
高雄市,三民區,十美里,0,1,1018,7,1025,1767,3,1,3,0,1,0,58.01
高雄市,三民區,德北里,0,1,1140,4,1144,2039,3,1,3,0,1,0,56.11
高雄市,三民區,立誠里,0,1,581,7,588,918,3,1,3,0,1,0,64.05
高雄市,三民區,立業里,0,1,666,0,666,1069,3,1,3,0,1,0,62.30
高雄市,三民區,港東里,0,1,758,3,761,1416,3,1,3,0,1,0,53.74
高雄市,三民區,港新里,0,1,762,1,763,1393,3,1,3,0,1,0,54.77
高雄市,三民區,港西里,0,1,460,5,465,827,3,1,3,0,1,0,56.23
高雄市,三民區,港北里,0,1,277,0,277,403,3,1,3,0,1,0,68.73
高雄市,三民區,博愛里,0,1,656,3,659,1163,3,1,3,0,1,0,56.66
高雄市,三民區,博惠里,0,1,2310,7,2317,3977,3,1,3,0,1,0,58.26
高雄市,三民區,長明里,0,1,653,1,654,1143,3,1,3,0,1,0,57.22
高雄市,三民區,建東里,0,1,537,5,542,1109,3,1,3,0,1,0,48.87
高雄市,三民區,興德里,0,1,925,8,933,1674,3,1,3,0,1,0,55.73
高雄市,三民區,鳳南里,0,1,698,2,700,1114,3,1,3,0,1,0,62.84
高雄市,三民區,鳳北里,0,1,1099,6,1105,1861,3,1,3,0,1,0,59.38
高雄市,三民區,德西里,0,1,698,7,705,1209,3,1,3,0,1,0,58.31
高雄市,三民區,九如里,0,1,255,4,259,398,3,1,3,0,1,0,65.08
高雄市,三民區,豐裕里,0,1,1511,7,1518,2637,3,1,3,0,1,0,57.57
高雄市,三民區,川東里,0,1,1132,10,1142,1900,3,1,3,0,1,0,60.11
高雄市,三民區,裕民里,0,1,536,6,542,844,3,1,3,0,1,0,64.22
高雄市,三民區,力行里,0,1,777,5,782,1139,3,1,3,0,1,0,68.66
高雄市,三民區,千歲里,0,1,718,7,725,1176,3,1,3,0,1,0,61.65
高雄市,三民區,立德里,0,1,788,2,790,1326,3,1,3,0,1,0,59.58
高雄市,三民區,千北里,0,1,749,7,756,1275,3,1,3,0,1,0,59.29
高雄市,三民區,千秋里,0,1,1366,6,1372,2354,3,1,3,0,1,0,58.28
高雄市,新興區,浩然里,0,2,1126,5,1131,1928,3,1,3,0,1,0,58.66
高雄市,新興區,振成里,0,2,668,1,669,1253,3,1,3,0,1,0,53.39
高雄市,新興區,德生里,0,2,1369,6,1375,2560,3,1,3,0,1,0,53.71
高雄市,新興區,振華里,0,2,761,6,767,1294,3,1,3,0,1,0,59.27
高雄市,新興區,正氣里,0,2,988,7,995,1588,3,1,3,0,1,0,62.66
高雄市,新興區,德政里,0,2,413,8,421,735,3,1,3,0,1,0,57.28
高雄市,新興區,仁聲里,0,2,453,1,454,863,3,1,3,0,1,0,52.61
高雄市,新興區,德望里,0,2,1085,5,1090,2023,3,1,3,0,1,0,53.88
高雄市,新興區,華聲里,0,2,610,6,616,1028,3,1,3,0,1,0,59.92
高雄市,新興區,蕉園里,0,2,489,3,492,798,3,1,3,0,1,0,61.65
高雄市,新興區,永寧里,0,2,780,7,787,1456,3,1,3,0,1,0,54.05
高雄市,新興區,玉衡里,0,2,624,8,632,1077,3,1,3,0,1,0,58.68
高雄市,新興區,順昌里,0,2,1286,4,1290,2077,3,1,3,0,1,0,62.11
高雄市,新興區,文昌里,0,2,1487,8,1495,2606,3,1,3,0,1,0,57.37
高雄市,新興區,光耀里,0,2,1409,7,1416,2400,3,1,3,0,1,0,59.00
高雄市,新興區,興昌里,0,2,1082,4,1086,1786,3,1,3,0,1,0,60.81
高雄市,新興區,開平里,0,2,1773,13,1786,2995,3,1,3,0,1,0,59.63
高雄市,新興區,成功里,0,2,698,5,703,1136,3,1,3,0,1,0,61.88
高雄市,新興區,新江里,0,2,631,2,633,1129,3,1,3,0,1,0,56.07
高雄市,新興區,黎明里,0,2,501,3,504,922,3,1,3,0,1,0,54.66
高雄市,新興區,愛平里,0,2,535,4,539,887,3,1,3,0,1,0,60.77
高雄市,新興區,南港里,0,2,1347,8,1355,2205,3,1,3,0,1,0,61.45
高雄市,新興區,中東里,0,2,1337,10,1347,2693,3,1,3,0,1,0,50.02
高雄市,新興區,明莊里,0,2,486,2,488,826,3,1,3,0,1,0,59.08
高雄市,新興區,大明里,0,2,676,0,676,1169,3,1,3,0,1,0,57.83
高雄市,新興區,秋山里,0,2,543,4,547,948,3,1,3,0,1,0,57.70
高雄市,新興區,長驛里,0,2,522,4,526,948,3,1,3,0,1,0,55.49
高雄市,新興區,建興里,0,2,545,2,547,908,3,1,3,0,1,0,60.24
高雄市,新興區,建華里,0,2,545,3,548,968,3,1,3,0,1,0,56.61
高雄市,新興區,漢民里,0,2,525,2,527,842,3,1,3,0,1,0,62.59
高雄市,新興區,榮治里,0,2,465,1,466,784,3,1,3,0,1,0,59.44
高雄市,新興區,東坡里,0,2,782,8,790,1349,3,1,3,0,1,0,58.56
高雄市,前金區,三川里,0,2,469,2,471,784,3,1,3,0,1,0,60.08
高雄市,前金區,草江里,0,2,643,5,648,1151,3,1,3,0,1,0,56.30
高雄市,前金區,長城里,0,2,811,6,817,1417,3,1,3,0,1,0,57.66
高雄市,前金區,北金里,0,2,527,2,529,904,3,1,3,0,1,0,58.52
高雄市,前金區,東金里,0,2,525,4,529,911,3,1,3,0,1,0,58.07
高雄市,前金區,新生里,0,2,1681,11,1692,3029,3,1,3,0,1,0,55.86
高雄市,前金區,後金里,0,2,548,3,551,926,3,1,3,0,1,0,59.50
高雄市,前金區,長興里,0,2,613,5,618,1148,3,1,3,0,1,0,53.83
高雄市,前金區,青山里,0,2,793,3,796,1416,3,1,3,0,1,0,56.21
高雄市,前金區,民生里,0,2,417,2,419,745,3,1,3,0,1,0,56.24
高雄市,前金區,復元里,0,2,603,3,606,1044,3,1,3,0,1,0,58.05
高雄市,前金區,林投里,0,2,684,2,686,1257,3,1,3,0,1,0,54.57
高雄市,前金區,國民里,0,2,596,2,598,1080,3,1,3,0,1,0,55.37
高雄市,前金區,社東里,0,2,1017,5,1022,1711,3,1,3,0,1,0,59.73
高雄市,前金區,社西里,0,2,605,5,610,1163,3,1,3,0,1,0,52.45
高雄市,前金區,博孝里,0,2,507,5,512,949,3,1,3,0,1,0,53.95
高雄市,前金區,長生里,0,2,825,3,828,1536,3,1,3,0,1,0,53.91
高雄市,前金區,榮復里,0,2,747,8,755,1263,3,1,3,0,1,0,59.78
高雄市,前金區,文西里,0,2,657,2,659,1085,3,1,3,0,1,0,60.74
高雄市,前金區,文東里,0,2,775,3,778,1361,3,1,3,0,1,0,57.16
高雄市,苓雅區,博仁里,0,2,339,1,340,584,3,1,3,0,1,0,58.22
高雄市,苓雅區,苓洲里,0,2,805,3,808,1333,3,1,3,0,1,0,60.62
高雄市,苓雅區,苓昇里,0,2,859,6,865,1423,3,1,3,0,1,0,60.79
高雄市,苓雅區,苓中里,0,2,966,7,973,1664,3,1,3,0,1,0,58.47
高雄市,苓雅區,苓雅里,0,2,836,2,838,1460,3,1,3,0,1,0,57.40
高雄市,苓雅區,苓東里,0,2,865,8,873,1530,3,1,3,0,1,0,57.06
高雄市,苓雅區,城北里,0,2,821,6,827,1560,3,1,3,0,1,0,53.01
高雄市,苓雅區,城西里,0,2,395,3,398,692,3,1,3,0,1,0,57.51
高雄市,苓雅區,城東里,0,2,1004,6,1010,1840,3,1,3,0,1,0,54.89
高雄市,苓雅區,意誠里,0,2,1297,9,1306,2707,3,1,3,0,1,0,48.25
高雄市,苓雅區,鼓中里,0,2,691,4,695,1154,3,1,3,0,1,0,60.23
高雄市,苓雅區,田西里,0,2,888,7,895,1437,3,1,3,0,1,0,62.28
高雄市,苓雅區,人和里,0,2,1043,2,1045,1868,3,1,3,0,1,0,55.94
高雄市,苓雅區,仁政里,0,2,748,7,755,1415,3,1,3,0,1,0,53.36
高雄市,苓雅區,廣澤里,0,2,1257,6,1263,1971,3,1,3,0,1,0,64.08
高雄市,苓雅區,美田里,0,2,744,2,746,1258,3,1,3,0,1,0,59.30
高雄市,苓雅區,華堂里,0,2,1631,7,1638,3031,3,1,3,0,1,0,54.04
高雄市,苓雅區,日中里,0,2,1274,4,1278,2285,3,1,3,0,1,0,55.93
高雄市,苓雅區,普照里,0,2,1528,8,1536,2639,3,1,3,0,1,0,58.20
高雄市,苓雅區,和煦里,0,2,1338,5,1343,2153,3,1,3,0,1,0,62.38
高雄市,苓雅區,晴朗里,0,2,706,3,709,1715,3,1,3,0,1,0,41.34
高雄市,苓雅區,普天里,0,2,1625,4,1629,2831,3,1,3,0,1,0,57.54
高雄市,苓雅區,林富里,0,2,1025,4,1029,1797,3,1,3,0,1,0,57.26
高雄市,苓雅區,林圍里,0,2,1169,8,1177,2164,3,1,3,0,1,0,54.39
高雄市,苓雅區,林安里,0,2,947,6,953,1556,3,1,3,0,1,0,61.25
高雄市,苓雅區,光華里,0,2,472,3,475,780,3,1,3,0,1,0,60.90
高雄市,苓雅區,林興里,0,2,810,5,815,1444,3,1,3,0,1,0,56.44
高雄市,苓雅區,林華里,0,2,1745,11,1756,3013,3,1,3,0,1,0,58.28
高雄市,苓雅區,林西里,0,2,970,13,983,1795,3,1,3,0,1,0,54.76
高雄市,苓雅區,林中里,0,2,1825,10,1835,3262,3,1,3,0,1,0,56.25
高雄市,苓雅區,林泉里,0,2,1067,3,1070,1832,3,1,3,0,1,0,58.41
高雄市,苓雅區,林南里,0,2,1604,8,1612,2844,3,1,3,0,1,0,56.68
高雄市,苓雅區,中正里,0,2,1413,5,1418,2559,3,1,3,0,1,0,55.41
高雄市,苓雅區,尚義里,0,2,721,2,723,1414,3,1,3,0,1,0,51.13
高雄市,苓雅區,同慶里,0,2,945,6,951,1547,3,1,3,0,1,0,61.47
高雄市,苓雅區,凱旋里,0,2,1219,7,1226,1902,3,1,3,0,1,0,64.46
高雄市,苓雅區,安祥里,0,2,1321,7,1328,2379,3,1,3,0,1,0,55.82
高雄市,苓雅區,奏捷里,0,2,1006,4,1010,1622,3,1,3,0,1,0,62.27
高雄市,苓雅區,福壽里,0,2,963,5,968,1535,3,1,3,0,1,0,63.06
高雄市,苓雅區,福南里,0,2,1417,10,1427,2347,3,1,3,0,1,0,60.80
高雄市,苓雅區,五權里,0,2,1157,2,1159,1979,3,1,3,0,1,0,58.56
高雄市,苓雅區,民主里,0,2,2201,8,2209,3874,3,1,3,0,1,0,57.02
高雄市,苓雅區,林德里,0,2,980,7,987,1687,3,1,3,0,1,0,58.51
高雄市,苓雅區,林貴里,0,2,800,3,803,1361,3,1,3,0,1,0,59.00
高雄市,苓雅區,林榮里,0,2,2299,10,2309,3951,3,1,3,0,1,0,58.44
高雄市,苓雅區,英明里,0,2,1164,8,1172,2036,3,1,3,0,1,0,57.56
高雄市,苓雅區,林靖里,0,2,913,6,919,1547,3,1,3,0,1,0,59.41
高雄市,苓雅區,朝陽里,0,2,890,2,892,1501,3,1,3,0,1,0,59.43
高雄市,苓雅區,福隆里,0,2,1564,7,1571,2741,3,1,3,0,1,0,57.31
高雄市,苓雅區,福祥里,0,2,817,6,823,1335,3,1,3,0,1,0,61.65
高雄市,苓雅區,福海里,0,2,607,9,616,1019,3,1,3,0,1,0,60.45
高雄市,苓雅區,福康里,0,2,1154,4,1158,1943,3,1,3,0,1,0,59.60
高雄市,苓雅區,福人里,0,2,1243,11,1254,2175,3,1,3,0,1,0,57.66
高雄市,苓雅區,福地里,0,2,1773,18,1791,2899,3,1,3,0,1,0,61.78
高雄市,苓雅區,福居里,0,2,1659,11,1670,2835,3,1,3,0,1,0,58.91
高雄市,苓雅區,福東里,0,2,1404,10,1414,2555,3,1,3,0,1,0,55.34
高雄市,苓雅區,福西里,0,2,1138,6,1144,2003,3,1,3,0,1,0,57.11
高雄市,苓雅區,永康里,0,2,1381,11,1392,2354,3,1,3,0,1,0,59.13
高雄市,苓雅區,正文里,0,2,954,4,958,1782,3,1,3,0,1,0,53.76
高雄市,苓雅區,正言里,0,2,1445,15,1460,2721,3,1,3,0,1,0,53.66
高雄市,苓雅區,正大里,0,2,2291,15,2306,4595,3,1,3,0,1,0,50.18
高雄市,苓雅區,五福里,0,2,2174,15,2189,3899,3,1,3,0,1,0,56.14
高雄市,苓雅區,正心里,0,2,2017,8,2025,3610,3,1,3,0,1,0,56.09
高雄市,苓雅區,正道里,0,2,2304,15,2319,4135,3,1,3,0,1,0,56.08
高雄市,苓雅區,正義里,0,2,1415,9,1424,2349,3,1,3,0,1,0,60.62
高雄市,苓雅區,正仁里,0,2,1265,7,1272,2425,3,1,3,0,1,0,52.45
高雄市,苓雅區,文昌里,0,2,2251,12,2263,3850,3,1,3,0,1,0,58.78
高雄市,苓雅區,建軍里,0,2,1208,10,1218,2066,3,1,3,0,1,0,58.95
高雄市,苓雅區,衛武里,0,2,1225,11,1236,2128,3,1,3,0,1,0,58.08
高雄市,前鎮區,草衙里,0,2,4314,28,4342,8072,3,1,3,0,1,0,53.79
高雄市,前鎮區,明孝里,0,2,1406,12,1418,2405,3,1,3,0,1,0,58.96
高雄市,前鎮區,明正里,0,2,1870,9,1879,3171,3,1,3,0,1,0,59.26
高雄市,前鎮區,明義里,0,2,1114,9,1123,1816,3,1,3,0,1,0,61.84
高雄市,前鎮區,仁愛里,0,2,864,3,867,1434,3,1,3,0,1,0,60.46
高雄市,前鎮區,德昌里,0,2,1156,7,1163,1870,3,1,3,0,1,0,62.19
高雄市,前鎮區,平等里,0,2,1081,5,1086,2226,3,1,3,0,1,0,48.79
高雄市,前鎮區,平昌里,0,2,427,3,430,707,3,1,3,0,1,0,60.82
高雄市,前鎮區,明禮里,0,2,1040,8,1048,1727,3,1,3,0,1,0,60.68
高雄市,前鎮區,信義里,0,2,992,10,1002,1554,3,1,3,0,1,0,64.48
高雄市,前鎮區,信德里,0,2,1434,15,1449,2436,3,1,3,0,1,0,59.48
高雄市,前鎮區,明道里,0,2,777,7,784,1274,3,1,3,0,1,0,61.54
高雄市,前鎮區,興化里,0,2,481,1,482,766,3,1,3,0,1,0,62.92
高雄市,前鎮區,興仁里,0,2,497,6,503,875,3,1,3,0,1,0,57.49
高雄市,前鎮區,前鎮里,0,2,882,6,888,1479,3,1,3,0,1,0,60.04
高雄市,前鎮區,鎮東里,0,2,1201,10,1211,1919,3,1,3,0,1,0,63.11
高雄市,前鎮區,鎮榮里,0,2,1429,8,1437,2296,3,1,3,0,1,0,62.59
高雄市,前鎮區,鎮昌里,0,2,1282,39,1321,2050,3,1,3,0,1,0,64.44
高雄市,前鎮區,鎮海里,0,2,2251,9,2260,3868,3,1,3,0,1,0,58.43
高雄市,前鎮區,鎮陽里,0,2,758,8,766,1140,3,1,3,0,1,0,67.19
高雄市,前鎮區,興邦里,0,2,1172,7,1179,2010,3,1,3,0,1,0,58.66
高雄市,前鎮區,鎮中里,0,2,553,6,559,856,3,1,3,0,1,0,65.30
高雄市,前鎮區,鎮北里,0,2,706,5,711,1033,3,1,3,0,1,0,68.83
高雄市,前鎮區,忠純里,0,2,2806,17,2823,4338,3,1,3,0,1,0,65.08
高雄市,前鎮區,忠誠里,0,2,1459,4,1463,2066,3,1,3,0,1,0,70.81
高雄市,前鎮區,西山里,0,2,1948,14,1962,3323,3,1,3,0,1,0,59.04
高雄市,前鎮區,民權里,0,2,2275,19,2294,3802,3,1,3,0,1,0,60.34
高雄市,前鎮區,建隆里,0,2,485,0,485,841,3,1,3,0,1,0,57.67
高雄市,前鎮區,振興里,0,2,1073,9,1082,1928,3,1,3,0,1,0,56.12
高雄市,前鎮區,良和里,0,2,1495,11,1506,2603,3,1,3,0,1,0,57.86
高雄市,前鎮區,西甲里,0,2,1146,51,1197,1940,3,1,3,0,1,0,61.70
高雄市,前鎮區,盛興里,0,2,1350,9,1359,2512,3,1,3,0,1,0,54.10
高雄市,前鎮區,盛豐里,0,2,1600,10,1610,2845,3,1,3,0,1,0,56.59
高雄市,前鎮區,興中里,0,2,1681,14,1695,3098,3,1,3,0,1,0,54.71
高雄市,前鎮區,興東里,0,2,2616,13,2629,4621,3,1,3,0,1,0,56.89
高雄市,前鎮區,忠孝里,0,2,1416,14,1430,2347,3,1,3,0,1,0,60.93
高雄市,前鎮區,復國里,0,2,1717,6,1723,2850,3,1,3,0,1,0,60.46
高雄市,前鎮區,竹內里,0,2,1622,12,1634,2593,3,1,3,0,1,0,63.02
高雄市,前鎮區,竹東里,0,2,1136,7,1143,2115,3,1,3,0,1,0,54.04
高雄市,前鎮區,竹南里,0,2,1521,9,1530,2706,3,1,3,0,1,0,56.54
高雄市,前鎮區,竹北里,0,2,1123,6,1129,2012,3,1,3,0,1,0,56.11
高雄市,前鎮區,竹西里,0,2,2333,19,2352,3820,3,1,3,0,1,0,61.57
高雄市,前鎮區,竹中里,0,2,1642,3,1645,2804,3,1,3,0,1,0,58.67
高雄市,前鎮區,瑞竹里,0,2,733,6,739,1278,3,1,3,0,1,0,57.82
高雄市,前鎮區,瑞南里,0,2,2684,20,2704,4550,3,1,3,0,1,0,59.43
高雄市,前鎮區,瑞豐里,0,2,1442,8,1450,2301,3,1,3,0,1,0,63.02
高雄市,前鎮區,瑞祥里,0,2,2731,14,2745,4716,3,1,3,0,1,0,58.21
高雄市,前鎮區,瑞東里,0,2,1447,6,1453,2409,3,1,3,0,1,0,60.32
高雄市,前鎮區,瑞和里,0,2,1164,24,1188,2028,3,1,3,0,1,0,58.58
高雄市,前鎮區,瑞平里,0,2,2173,15,2188,3641,3,1,3,0,1,0,60.09
高雄市,前鎮區,瑞隆里,0,2,1941,11,1952,3524,3,1,3,0,1,0,55.39
高雄市,前鎮區,瑞北里,0,2,1627,10,1637,2878,3,1,3,0,1,0,56.88
高雄市,前鎮區,瑞西里,0,2,1633,6,1639,2599,3,1,3,0,1,0,63.06
高雄市,前鎮區,瑞崗里,0,2,1510,6,1516,2516,3,1,3,0,1,0,60.25
高雄市,前鎮區,瑞興里,0,2,1476,11,1487,2610,3,1,3,0,1,0,56.97
高雄市,前鎮區,瑞誠里,0,2,1322,22,1344,2421,3,1,3,0,1,0,55.51
高雄市,前鎮區,瑞文里,0,2,1309,7,1316,2394,3,1,3,0,1,0,54.97
高雄市,前鎮區,瑞華里,0,2,2339,37,2376,4261,3,1,3,0,1,0,55.76
高雄市,前鎮區,瑞昌里,0,2,1512,7,1519,2723,3,1,3,0,1,0,55.78
高雄市,小港區,小港里,0,2,1022,5,1027,1732,3,1,3,0,1,0,59.30
高雄市,小港區,港口里,0,2,1925,10,1935,3214,3,1,3,0,1,0,60.21
高雄市,小港區,港正里,0,2,1391,10,1401,2422,3,1,3,0,1,0,57.84
高雄市,小港區,港墘里,0,2,929,9,938,1560,3,1,3,0,1,0,60.13
高雄市,小港區,港明里,0,2,1594,11,1605,2844,3,1,3,0,1,0,56.43
高雄市,小港區,港后里,0,2,1084,5,1089,1877,3,1,3,0,1,0,58.02
高雄市,小港區,港南里,0,2,885,4,889,1650,3,1,3,0,1,0,53.88
高雄市,小港區,港興里,0,2,1237,6,1243,2020,3,1,3,0,1,0,61.53
高雄市,小港區,鳳宮里,0,2,1027,7,1034,1867,3,1,3,0,1,0,55.38
高雄市,小港區,店鎮里,0,2,2498,20,2518,4560,3,1,3,0,1,0,55.22
高雄市,小港區,大苓里,0,2,1298,8,1306,2199,3,1,3,0,1,0,59.39
高雄市,小港區,二苓里,0,2,1726,7,1733,3031,3,1,3,0,1,0,57.18
高雄市,小港區,三苓里,0,2,1429,8,1437,2440,3,1,3,0,1,0,58.89
高雄市,小港區,正苓里,0,2,1764,9,1773,3266,3,1,3,0,1,0,54.29
高雄市,小港區,順苓里,0,2,1924,11,1935,3553,3,1,3,0,1,0,54.46
高雄市,小港區,六苓里,0,2,936,4,940,1620,3,1,3,0,1,0,58.02
高雄市,小港區,宏亮里,0,2,1340,14,1354,2523,3,1,3,0,1,0,53.67
高雄市,小港區,山東里,0,2,1291,6,1297,2180,3,1,3,0,1,0,59.50
高雄市,小港區,青島里,0,2,1120,2,1122,1844,3,1,3,0,1,0,60.85
高雄市,小港區,濟南里,0,2,1804,11,1815,3101,3,1,3,0,1,0,58.53
高雄市,小港區,泰山里,0,2,1216,9,1225,2122,3,1,3,0,1,0,57.73
高雄市,小港區,山明里,0,2,3042,18,3060,5450,3,1,3,0,1,0,56.15
高雄市,小港區,高松里,0,2,1705,9,1714,3106,3,1,3,0,1,0,55.18
高雄市,小港區,松金里,0,2,1201,17,1218,1971,3,1,3,0,1,0,61.80
高雄市,小港區,松山里,0,2,1069,9,1078,1903,3,1,3,0,1,0,56.65
高雄市,小港區,大坪里,0,2,802,9,811,1302,3,1,3,0,1,0,62.29
高雄市,小港區,坪頂里,0,2,787,3,790,1397,3,1,3,0,1,0,56.55
高雄市,小港區,孔宅里,0,2,1708,9,1717,3107,3,1,3,0,1,0,55.26
高雄市,小港區,廈莊里,0,2,1064,3,1067,1813,3,1,3,0,1,0,58.85
高雄市,小港區,合作里,0,2,1272,8,1280,2187,3,1,3,0,1,0,58.53
高雄市,小港區,桂林里,0,2,3239,17,3256,6111,3,1,3,0,1,0,53.28
高雄市,小港區,中厝里,0,2,1469,2,1471,2798,3,1,3,0,1,0,52.57
高雄市,小港區,鳳鳴里,0,2,1400,9,1409,2234,3,1,3,0,1,0,63.07
高雄市,小港區,龍鳳里,0,2,1295,11,1306,2049,3,1,3,0,1,0,63.74
高雄市,小港區,鳳森里,0,2,954,7,961,1470,3,1,3,0,1,0,65.37
高雄市,小港區,鳳林里,0,2,1198,5,1203,2002,3,1,3,0,1,0,60.09
高雄市,小港區,鳳興里,0,2,915,1,916,1557,3,1,3,0,1,0,58.83
高雄市,小港區,鳳源里,0,2,1298,13,1311,2251,3,1,3,0,1,0,58.24
高雄市,小港區,海澄里,0,2,2153,14,2167,4455,3,1,3,0,1,0,48.64
高雄市,小港區,海昌里,0,2,1082,4,1086,2287,3,1,3,0,1,0,47.49
高雄市,小港區,海豐里,0,2,1161,4,1165,2357,3,1,3,0,1,0,49.43
高雄市,小港區,海原里,0,2,1261,10,1271,2713,3,1,3,0,1,0,46.85
高雄市,小港區,海城里,0,2,1240,8,1248,2764,3,1,3,0,1,0,45.15
臺北縣,板橋市,留侯里,0,1,682,1,683,1183,3,1,3,0,1,0,57.73
臺北縣,板橋市,流芳里,0,1,684,6,690,1223,3,1,3,0,1,0,56.42
臺北縣,板橋市,赤松里,0,1,390,1,391,656,3,1,3,0,1,0,59.60
臺北縣,板橋市,黃石里,0,1,597,6,603,1028,3,1,3,0,1,0,58.66
臺北縣,板橋市,挹秀里,0,1,846,6,852,1445,3,1,3,0,1,0,58.96
臺北縣,板橋市,湳興里,0,1,2116,27,2143,3726,3,1,3,0,1,0,57.51
臺北縣,板橋市,新興里,0,1,1348,16,1364,2548,3,1,3,0,1,0,53.53
臺北縣,板橋市,社後里,0,1,2790,15,2805,5549,3,1,3,0,1,0,50.55
臺北縣,板橋市,香社里,0,1,1994,9,2003,3555,3,1,3,0,1,0,56.34
臺北縣,板橋市,香雅里,0,1,1237,6,1243,2204,3,1,3,0,1,0,56.3974591652
臺北縣,板橋市,中正里,0,1,1893,18,1911,3520,3,1,3,0,1,0,54.29
臺北縣,板橋市,自強里,0,1,2698,21,2719,4465,3,1,3,0,1,0,60.90
臺北縣,板橋市,自立里,0,1,1481,14,1495,2384,3,1,3,0,1,0,62.71
臺北縣,板橋市,光華里,0,1,1350,9,1359,2276,3,1,3,0,1,0,59.71
臺北縣,板橋市,光榮里,0,1,1249,19,1268,2165,3,1,3,0,1,0,58.5681293303
臺北縣,板橋市,國光里,0,1,2159,26,2185,3269,3,1,3,0,1,0,66.84
臺北縣,板橋市,港尾里,0,1,1307,7,1314,2141,3,1,3,0,1,0,61.37
臺北縣,板橋市,新生里,0,1,2043,16,2059,3728,3,1,3,0,1,0,55.2306866953
臺北縣,板橋市,金華里,0,1,1842,16,1858,3382,3,1,3,0,1,0,54.94
臺北縣,板橋市,港德里,0,1,2260,25,2285,4156,3,1,3,0,1,0,54.98
臺北縣,板橋市,民權里,0,1,1534,18,1552,2467,3,1,3,0,1,0,62.91
臺北縣,板橋市,民安里,0,1,1120,8,1128,1768,3,1,3,0,1,0,63.8009049774
臺北縣,板橋市,建國里,0,1,1917,14,1931,3141,3,1,3,0,1,0,61.48
臺北縣,板橋市,漢生里,0,1,2266,10,2276,3725,3,1,3,0,1,0,61.10
臺北縣,板橋市,新民里,0,1,2028,8,2036,3593,3,1,3,0,1,0,56.67
臺北縣,板橋市,公館里,0,1,1794,18,1812,3196,3,1,3,0,1,0,56.70
臺北縣,板橋市,幸福里,0,1,1829,7,1836,3359,3,1,3,0,1,0,54.66
臺北縣,板橋市,文德里,0,1,1416,6,1422,2539,3,1,3,0,1,0,56.0063016936
臺北縣,板橋市,忠誠里,0,1,1476,5,1481,2341,3,1,3,0,1,0,63.26
臺北縣,板橋市,陽明里,0,1,1395,6,1401,2418,3,1,3,0,1,0,57.9404466501
臺北縣,板橋市,百壽里,0,1,1202,10,1212,2093,3,1,3,0,1,0,57.91
臺北縣,板橋市,介壽里,0,1,1403,8,1411,2532,3,1,3,0,1,0,55.73
臺北縣,板橋市,新埔里,0,1,1120,9,1129,2017,3,1,3,0,1,0,55.97
臺北縣,板橋市,華江里,0,1,2273,23,2296,4148,3,1,3,0,1,0,55.35
臺北縣,板橋市,江翠里,0,1,2167,17,2184,4005,3,1,3,0,1,0,54.53
臺北縣,板橋市,純翠里,0,1,2248,7,2255,4202,3,1,3,0,1,0,53.66
臺北縣,板橋市,溪頭里,0,1,2605,15,2620,4898,3,1,3,0,1,0,53.49
臺北縣,板橋市,聯翠里,0,1,1746,15,1761,3254,3,1,3,0,1,0,54.12
臺北縣,板橋市,文化里,0,1,1484,9,1493,2637,3,1,3,0,1,0,56.6173682215
臺北縣,板橋市,宏翠里,0,1,1467,14,1481,2638,3,1,3,0,1,0,56.14
臺北縣,板橋市,仁翠里,0,1,1538,15,1553,2744,3,1,3,0,1,0,56.60
臺北縣,板橋市,新翠里,0,1,3309,28,3337,6188,3,1,3,0,1,0,53.93
臺北縣,板橋市,朝陽里,0,1,1584,10,1594,2898,3,1,3,0,1,0,55.0034506556
臺北縣,板橋市,吉翠里,0,1,1737,12,1749,3024,3,1,3,0,1,0,57.84
臺北縣,板橋市,德翠里,0,1,2727,21,2748,4871,3,1,3,0,1,0,56.42
臺北縣,板橋市,新海里,0,1,1480,13,1493,2913,3,1,3,0,1,0,51.2530037762
臺北縣,板橋市,滿翠里,0,1,1484,5,1489,2692,3,1,3,0,1,0,55.31
臺北縣,板橋市,明翠里,0,1,2271,23,2294,4084,3,1,3,0,1,0,56.17
臺北縣,板橋市,松翠里,0,1,1552,10,1562,3057,3,1,3,0,1,0,51.10
臺北縣,板橋市,柏翠里,0,1,1644,10,1654,2945,3,1,3,0,1,0,56.16
臺北縣,板橋市,龍翠里,0,1,2011,9,2020,3662,3,1,3,0,1,0,55.16
臺北縣,板橋市,松柏里,0,1,1018,6,1024,1839,3,1,3,0,1,0,55.6824361066
臺北縣,板橋市,華翠里,0,1,1519,8,1527,2666,3,1,3,0,1,0,57.28
臺北縣,板橋市,莒光里,0,1,1336,10,1346,2517,3,1,3,0,1,0,53.4763607469
臺北縣,板橋市,忠翠里,0,1,3965,36,4001,6930,3,1,3,0,1,0,57.73
臺北縣,板橋市,嵐翠里,0,1,1250,12,1262,2161,3,1,3,0,1,0,58.40
臺北縣,板橋市,文聖里,0,1,2435,18,2453,4220,3,1,3,0,1,0,58.1279620853
臺北縣,板橋市,文翠里,0,1,1303,8,1311,2298,3,1,3,0,1,0,57.05
臺北縣,板橋市,青翠里,0,1,1282,8,1290,2533,3,1,3,0,1,0,50.93
臺北縣,板橋市,懷翠里,0,1,2457,20,2477,4774,3,1,3,0,1,0,51.89
臺北縣,板橋市,福翠里,0,1,827,7,834,1474,3,1,3,0,1,0,56.58
臺北縣,板橋市,港嘴里,0,1,2527,32,2559,4466,3,1,3,0,1,0,57.30
臺北縣,板橋市,振興里,0,1,2126,24,2150,3496,3,1,3,0,1,0,61.50
臺北縣,板橋市,振義里,0,1,1994,12,2006,3468,3,1,3,0,1,0,57.84
臺北縣,板橋市,光復里,0,1,1402,18,1420,2519,3,1,3,0,1,0,56.37
臺北縣,板橋市,埔墘里,0,1,2421,14,2435,4165,3,1,3,0,1,0,58.46
臺北縣,板橋市,富貴里,0,1,1085,7,1092,1878,3,1,3,0,1,0,58.1469648562
臺北縣,板橋市,長壽里,0,1,1359,8,1367,2403,3,1,3,0,1,0,56.89
臺北縣,板橋市,福壽里,0,1,1470,11,1481,2636,3,1,3,0,1,0,56.18
臺北縣,板橋市,居仁里,0,1,1341,4,1345,2477,3,1,3,0,1,0,54.2995559144
臺北縣,板橋市,海山里,0,1,3032,23,3055,5593,3,1,3,0,1,0,54.62
臺北縣,板橋市,九如里,0,1,1279,14,1293,2344,3,1,3,0,1,0,55.16
臺北縣,板橋市,正泰里,0,1,1473,10,1483,2442,3,1,3,0,1,0,60.7289107289
臺北縣,板橋市,玉光里,0,1,2138,15,2153,4044,3,1,3,0,1,0,53.24
臺北縣,板橋市,光仁里,0,1,1398,14,1412,2409,3,1,3,0,1,0,58.61
臺北縣,板橋市,埤墘里,0,1,1660,8,1668,3028,3,1,3,0,1,0,55.09
臺北縣,板橋市,莊敬里,0,1,1697,12,1709,2895,3,1,3,0,1,0,59.0328151986
臺北縣,板橋市,永安里,0,1,1465,9,1474,2675,3,1,3,0,1,0,55.10
臺北縣,板橋市,雙玉里,0,1,1705,14,1719,2994,3,1,3,0,1,0,57.41
臺北縣,板橋市,廣新里,0,1,1573,19,1592,2930,3,1,3,0,1,0,54.33
臺北縣,板橋市,深丘里,0,1,2461,16,2477,4287,3,1,3,0,1,0,57.78
臺北縣,板橋市,香丘里,0,1,1737,12,1749,3032,3,1,3,0,1,0,57.68
臺北縣,板橋市,西安里,0,1,1296,11,1307,2197,3,1,3,0,1,0,59.49
臺北縣,板橋市,東丘里,0,1,1931,13,1944,3418,3,1,3,0,1,0,56.88
臺北縣,板橋市,民生里,0,1,922,4,926,1599,3,1,3,0,1,0,57.9111944966
臺北縣,板橋市,長安里,0,1,1724,14,1738,2995,3,1,3,0,1,0,58.03
臺北縣,板橋市,東安里,0,1,1222,11,1233,2761,3,1,3,0,1,0,44.6577327055
臺北縣,板橋市,福丘里,0,1,1002,8,1010,1628,3,1,3,0,1,0,62.04
臺北縣,板橋市,福祿里,0,1,1628,16,1644,3005,3,1,3,0,1,0,54.71
臺北縣,板橋市,民族里,0,1,1767,9,1776,3042,3,1,3,0,1,0,58.38
臺北縣,板橋市,國泰里,0,1,1464,4,1468,2528,3,1,3,0,1,0,58.07
臺北縣,板橋市,後埔里,0,1,1706,25,1731,2888,3,1,3,0,1,0,59.9376731302
臺北縣,板橋市,福德里,0,1,2482,21,2503,4154,3,1,3,0,1,0,60.26
臺北縣,板橋市,景星里,0,1,1548,11,1559,2708,3,1,3,0,1,0,57.57
臺北縣,板橋市,福星里,0,1,1642,16,1658,2757,3,1,3,0,1,0,60.14
臺北縣,板橋市,鄉雲里,0,1,1675,18,1693,2912,3,1,3,0,1,0,58.14
臺北縣,板橋市,廣德里,0,1,2735,17,2752,4801,3,1,3,0,1,0,57.32
臺北縣,板橋市,大豐里,0,1,2220,18,2238,3807,3,1,3,0,1,0,58.79
臺北縣,板橋市,重慶里,0,1,3348,35,3383,6412,3,1,3,0,1,0,52.76
臺北縣,板橋市,仁愛里,0,1,1653,13,1666,2707,3,1,3,0,1,0,61.54
臺北縣,板橋市,和平里,0,1,498,5,503,910,3,1,3,0,1,0,55.27
臺北縣,板橋市,廣福里,0,1,1447,13,1460,2754,3,1,3,0,1,0,53.01
臺北縣,板橋市,五權里,0,1,1993,16,2009,3580,3,1,3,0,1,0,56.1173184358
臺北縣,板橋市,華興里,0,1,1869,16,1885,3272,3,1,3,0,1,0,57.61
臺北縣,板橋市,華貴里,0,1,1446,21,1467,2366,3,1,3,0,1,0,62.00
臺北縣,板橋市,華福里,0,1,1098,10,1108,1780,3,1,3,0,1,0,62.2471910112
臺北縣,板橋市,華德里,0,1,2718,25,2743,5189,3,1,3,0,1,0,52.86
臺北縣,板橋市,華東里,0,1,2688,19,2707,4488,3,1,3,0,1,0,60.316399287
臺北縣,板橋市,信義里,0,1,1936,19,1955,3340,3,1,3,0,1,0,58.5329341317
臺北縣,板橋市,浮洲里,0,1,1729,11,1740,3561,3,1,3,0,1,0,48.8626790227
臺北縣,板橋市,華中里,0,1,2304,17,2321,4269,3,1,3,0,1,0,54.3687046147
臺北縣,板橋市,僑中里,0,1,1600,12,1612,3020,3,1,3,0,1,0,53.3774834437
臺北縣,板橋市,大觀里,0,1,1516,15,1531,2757,3,1,3,0,1,0,55.5313746826
臺北縣,板橋市,歡園里,0,1,610,5,615,1013,3,1,3,0,1,0,60.7107601185
臺北縣,板橋市,中山里,0,1,2175,22,2197,3907,3,1,3,0,1,0,56.2324033786
臺北縣,板橋市,復興里,0,1,1055,38,1093,1780,3,1,3,0,1,0,61.404494382
臺北縣,板橋市,大安里,0,1,1995,13,2008,3438,3,1,3,0,1,0,58.4060500291
臺北縣,板橋市,福安里,0,1,1354,22,1376,2236,3,1,3,0,1,0,61.5384615385
臺北縣,板橋市,聚安里,0,1,2246,25,2271,4080,3,1,3,0,1,0,55.6617647059
臺北縣,板橋市,龍安里,0,1,1393,21,1414,2371,3,1,3,0,1,0,59.6372838465
臺北縣,板橋市,崑崙里,0,1,3137,29,3166,6070,3,1,3,0,1,0,52.15815486
臺北縣,板橋市,成和里,0,1,1812,13,1825,3648,3,1,3,0,1,0,50.0274122807
臺北縣,板橋市,溪洲里,0,1,2299,21,2320,4397,3,1,3,0,1,0,52.7632476689
臺北縣,板橋市,溪福里,0,1,4120,32,4152,8328,3,1,3,0,1,0,49.855907781
臺北縣,板橋市,溪北里,0,1,1486,17,1503,2636,3,1,3,0,1,0,57.0182094082
臺北縣,板橋市,堂春里,0,1,1647,15,1662,2985,3,1,3,0,1,0,55.6783919598
臺北縣,土城市,祖田里,0,1,728,8,736,1235,3,1,3,0,1,0,59.5951417004
臺北縣,土城市,頂新里,0,1,359,0,359,623,3,1,3,0,1,0,57.6243980738
臺北縣,土城市,頂福里,0,1,2034,15,2049,3468,3,1,3,0,1,0,59.0830449827
臺北縣,土城市,頂埔里,0,1,2012,21,2033,3676,3,1,3,0,1,0,55.3046789989
臺北縣,土城市,沛陂里,0,1,1526,15,1541,2871,3,1,3,0,1,0,53.6746778126
臺北縣,土城市,永寧里,0,1,2830,22,2852,5432,3,1,3,0,1,0,52.5036818851
臺北縣,土城市,大安里,0,1,1952,17,1969,3618,3,1,3,0,1,0,54.4223327805
臺北縣,土城市,員仁里,0,1,2168,17,2185,4174,3,1,3,0,1,0,52.3478677528
臺北縣,土城市,埤塘里,0,1,1335,10,1345,3255,3,1,3,0,1,0,41.3210445469
臺北縣,土城市,土城里,0,1,945,10,955,1641,3,1,3,0,1,0,58.196221816
臺北縣,土城市,長風里,0,1,1078,7,1085,1565,3,1,3,0,1,0,69.3290734824
臺北縣,土城市,員信里,0,1,1698,11,1709,3206,3,1,3,0,1,0,53.3063006862
臺北縣,土城市,員林里,0,1,2405,20,2425,4293,3,1,3,0,1,0,56.487304915
臺北縣,土城市,員福里,0,1,2335,15,2350,4146,3,1,3,0,1,0,56.6811384467
臺北縣,土城市,日和里,0,1,2297,14,2311,4143,3,1,3,0,1,0,55.7808351436
臺北縣,土城市,日新里,0,1,2083,20,2103,3741,3,1,3,0,1,0,56.2149157979
臺北縣,土城市,裕生里,0,1,2277,19,2296,4431,3,1,3,0,1,0,51.8167456556
臺北縣,土城市,貨饒里,0,1,1778,17,1795,3153,3,1,3,0,1,0,56.9299080241
臺北縣,土城市,瑞興里,0,1,1472,11,1483,2603,3,1,3,0,1,0,56.9727237803
臺北縣,土城市,復興里,0,1,1922,16,1938,3562,3,1,3,0,1,0,54.4076361595
臺北縣,土城市,廣福里,0,1,2355,22,2377,4063,3,1,3,0,1,0,58.5035687915
臺北縣,土城市,學成里,0,1,1475,8,1483,2540,3,1,3,0,1,0,58.3858267717
臺北縣,土城市,埤林里,0,1,3454,19,3473,5948,3,1,3,0,1,0,58.3893745797
臺北縣,土城市,廣興里,0,1,1339,7,1346,2503,3,1,3,0,1,0,53.7754694367
臺北縣,土城市,樂利里,0,1,2169,20,2189,4119,3,1,3,0,1,0,53.1439669823
臺北縣,土城市,學府里,0,1,1443,10,1453,2714,3,1,3,0,1,0,53.5372144436
臺北縣,土城市,明德里,0,1,1776,8,1784,3336,3,1,3,0,1,0,53.4772182254
臺北縣,土城市,學士里,0,1,1894,14,1908,3335,3,1,3,0,1,0,57.2113943028
臺北縣,土城市,柑林里,0,1,1308,14,1322,2383,3,1,3,0,1,0,55.4762903903
臺北縣,土城市,中正里,0,1,1284,8,1292,2242,3,1,3,0,1,0,57.6271186441
臺北縣,土城市,青雲里,0,1,1265,10,1275,2212,3,1,3,0,1,0,57.6401446655
臺北縣,土城市,清和里,0,1,2529,19,2548,4838,3,1,3,0,1,0,52.6663910707
臺北縣,土城市,清化里,0,1,739,11,750,1321,3,1,3,0,1,0,56.7751703255
臺北縣,土城市,清溪里,0,1,2876,19,2895,5238,3,1,3,0,1,0,55.2691867125
臺北縣,土城市,青山里,0,1,1328,7,1335,2386,3,1,3,0,1,0,55.9513830679
臺北縣,土城市,清水里,0,1,3020,20,3040,5601,3,1,3,0,1,0,54.2760221389
臺北縣,土城市,永豐里,0,1,1284,18,1302,2418,3,1,3,0,1,0,53.8461538462
臺北縣,土城市,永富里,0,1,1994,17,2011,3982,3,1,3,0,1,0,50.5022601708
臺北縣,土城市,廷寮里,0,1,1845,15,1860,3376,3,1,3,0,1,0,55.0947867299
臺北縣,土城市,金城里,0,1,2229,10,2239,4151,3,1,3,0,1,0,53.9388099253
臺北縣,土城市,峰廷里,0,1,2797,18,2815,5512,3,1,3,0,1,0,51.0703918723
臺北縣,土城市,延吉里,0,1,1868,10,1878,3462,3,1,3,0,1,0,54.2461005199
臺北縣,土城市,延壽里,0,1,1833,11,1844,3428,3,1,3,0,1,0,53.7922987165
臺北縣,土城市,延祿里,0,1,1735,13,1748,3229,3,1,3,0,1,0,54.1344069371
臺北縣,土城市,平和里,0,1,2798,26,2824,5168,3,1,3,0,1,0,54.6439628483
臺北縣,土城市,安和里,0,1,1985,21,2006,3779,3,1,3,0,1,0,53.0828261445
臺北縣,土城市,延和里,0,1,2273,22,2295,4576,3,1,3,0,1,0,50.152972028
臺北縣,樹林市,三興里,0,1,1781,23,1804,3546,3,1,3,0,1,0,50.8742244783
臺北縣,樹林市,三福里,0,1,1771,16,1787,3257,3,1,3,0,1,0,54.8664415106
臺北縣,樹林市,三多里,0,1,1576,18,1594,2948,3,1,3,0,1,0,54.0705563094
臺北縣,樹林市,三龍里,0,1,821,8,829,1496,3,1,3,0,1,0,55.4144385027
臺北縣,樹林市,羌寮里,0,1,1744,13,1757,3494,3,1,3,0,1,0,50.2862049227
臺北縣,樹林市,光興里,0,1,1331,14,1345,2757,3,1,3,0,1,0,48.7849111353
臺北縣,樹林市,金寮里,0,1,1506,18,1524,2947,3,1,3,0,1,0,51.713607058
臺北縣,樹林市,潭底里,0,1,1766,13,1779,3554,3,1,3,0,1,0,50.0562746201
臺北縣,樹林市,文林里,0,1,1871,19,1890,3725,3,1,3,0,1,0,50.7382550336
臺北縣,樹林市,保安里,0,1,2760,24,2784,4910,3,1,3,0,1,0,56.700610998
臺北縣,樹林市,圳安里,0,1,1228,9,1237,2535,3,1,3,0,1,0,48.7968441815
臺北縣,樹林市,圳福里,0,1,1611,12,1623,2988,3,1,3,0,1,0,54.3172690763
臺北縣,樹林市,圳民里,0,1,978,8,986,1943,3,1,3,0,1,0,50.7462686567
臺北縣,樹林市,圳生里,0,1,720,4,724,1275,3,1,3,0,1,0,56.7843137255
臺北縣,樹林市,樹德里,0,1,1700,7,1707,2941,3,1,3,0,1,0,58.0414824889
臺北縣,樹林市,樹福里,0,1,1095,12,1107,1892,3,1,3,0,1,0,58.5095137421
臺北縣,樹林市,樹西里,0,1,2374,25,2399,4077,3,1,3,0,1,0,58.8422859946
臺北縣,樹林市,樹興里,0,1,1522,13,1535,2874,3,1,3,0,1,0,53.409881698
臺北縣,樹林市,樹人里,0,1,1444,16,1460,2494,3,1,3,0,1,0,58.5404971933
臺北縣,樹林市,育英里,0,1,1373,5,1378,2382,3,1,3,0,1,0,57.8505457599
臺北縣,樹林市,樹南里,0,1,1828,20,1848,3220,3,1,3,0,1,0,57.3913043478
臺北縣,樹林市,坡內里,0,1,676,6,682,1285,3,1,3,0,1,0,53.0739299611
臺北縣,樹林市,樹東里,0,1,645,6,651,1064,3,1,3,0,1,0,61.1842105263
臺北縣,樹林市,樹北里,0,1,639,2,641,990,3,1,3,0,1,0,64.7474747475
臺北縣,樹林市,彭福里,0,1,1834,15,1849,3679,3,1,3,0,1,0,50.258222343
臺北縣,樹林市,和平里,0,1,1702,21,1723,3107,3,1,3,0,1,0,55.4554232379
臺北縣,樹林市,彭興里,0,1,1973,14,1987,4138,3,1,3,0,1,0,48.0183663606
臺北縣,樹林市,彭厝里,0,1,1785,11,1796,3439,3,1,3,0,1,0,52.2244838616
臺北縣,樹林市,大同里,0,1,1260,11,1271,2319,3,1,3,0,1,0,54.8081069426
臺北縣,樹林市,中華里,0,1,1105,9,1114,2176,3,1,3,0,1,0,51.1948529412
臺北縣,樹林市,太順里,0,1,965,6,971,2034,3,1,3,0,1,0,47.738446411
臺北縣,樹林市,東昇里,0,1,1646,10,1656,2969,3,1,3,0,1,0,55.7763556753
臺北縣,樹林市,東陽里,0,1,2115,19,2134,4091,3,1,3,0,1,0,52.1632852603
臺北縣,樹林市,東山里,0,1,1461,15,1476,2620,3,1,3,0,1,0,56.3358778626
臺北縣,樹林市,山佳里,0,1,1555,14,1569,2980,3,1,3,0,1,0,52.6510067114
臺北縣,樹林市,中山里,0,1,1606,17,1623,2944,3,1,3,0,1,0,55.129076087
臺北縣,樹林市,樂山里,0,1,707,5,712,1335,3,1,3,0,1,0,53.3333333333
臺北縣,樹林市,柑園里,0,1,752,12,764,1268,3,1,3,0,1,0,60.2523659306
臺北縣,樹林市,西園里,0,1,707,7,714,1338,3,1,3,0,1,0,53.3632286996
臺北縣,樹林市,南園里,0,1,414,4,418,647,3,1,3,0,1,0,64.6058732612
臺北縣,樹林市,東園里,0,1,764,10,774,1328,3,1,3,0,1,0,58.2831325301
臺北縣,樹林市,北園里,0,1,911,8,919,1591,3,1,3,0,1,0,57.7624135764
臺北縣,鶯歌鎮,建德里,0,1,258,1,259,448,3,1,3,0,1,0,57.8125
臺北縣,鶯歌鎮,東鶯里,0,1,529,5,534,892,3,1,3,0,1,0,59.865470852
臺北縣,鶯歌鎮,北鶯里,0,1,794,15,809,1439,3,1,3,0,1,0,56.2195969423
臺北縣,鶯歌鎮,西鶯里,0,1,1125,16,1141,1826,3,1,3,0,1,0,62.4863088719
臺北縣,鶯歌鎮,中鶯里,0,1,527,4,531,845,3,1,3,0,1,0,62.8402366864
臺北縣,鶯歌鎮,南鶯里,0,1,2404,11,2415,4138,3,1,3,0,1,0,58.3615273079
臺北縣,鶯歌鎮,建國里,0,1,2253,17,2270,4304,3,1,3,0,1,0,52.7416356877
臺北縣,鶯歌鎮,二甲里,0,1,493,4,497,762,3,1,3,0,1,0,65.2230971129
臺北縣,鶯歌鎮,二橋里,0,1,2776,34,2810,5061,3,1,3,0,1,0,55.5226239874
臺北縣,鶯歌鎮,尖山里,0,1,2379,18,2397,4397,3,1,3,0,1,0,54.5144416648
臺北縣,鶯歌鎮,南靖里,0,1,1564,12,1576,2652,3,1,3,0,1,0,59.4268476621
臺北縣,鶯歌鎮,同慶里,0,1,807,4,811,1352,3,1,3,0,1,0,59.9852071006
臺北縣,鶯歌鎮,永昌里,0,1,3331,28,3359,6172,3,1,3,0,1,0,54.4232015554
臺北縣,鶯歌鎮,永吉里,0,1,2063,12,2075,3670,3,1,3,0,1,0,56.5395095368
臺北縣,鶯歌鎮,鳳祥里,0,1,1757,21,1778,3482,3,1,3,0,1,0,51.0626076967
臺北縣,鶯歌鎮,鳳鳴里,0,1,1938,28,1966,3539,3,1,3,0,1,0,55.5524159367
臺北縣,鶯歌鎮,鳳福里,0,1,1919,15,1934,3486,3,1,3,0,1,0,55.4790590935
臺北縣,鶯歌鎮,大湖里,0,1,2372,15,2387,4063,3,1,3,0,1,0,58.7496923456
臺北縣,鶯歌鎮,中湖里,0,1,2338,24,2362,4358,3,1,3,0,1,0,54.199173933
臺北縣,鶯歌鎮,東湖里,0,1,140,1,141,205,3,1,3,0,1,0,68.7804878049
臺北縣,三峽鎮,三峽里,0,1,195,4,199,317,3,1,3,0,1,0,62.7760252366
臺北縣,三峽鎮,秀川里,0,1,237,4,241,402,3,1,3,0,1,0,59.9502487562
臺北縣,三峽鎮,八張里,0,1,1443,12,1455,2576,3,1,3,0,1,0,56.4829192547
臺北縣,三峽鎮,中埔里,0,1,818,6,824,1478,3,1,3,0,1,0,55.751014885
臺北縣,三峽鎮,弘道里,0,1,495,7,502,926,3,1,3,0,1,0,54.211663067
臺北縣,三峽鎮,永館里,0,1,2739,15,2754,5023,3,1,3,0,1,0,54.8277921561
臺北縣,三峽鎮,鳶山里,0,1,2899,23,2922,5732,3,1,3,0,1,0,50.9769713887
臺北縣,三峽鎮,龍埔里,0,1,2924,23,2947,5459,3,1,3,0,1,0,53.9842461989
臺北縣,三峽鎮,礁溪里,0,1,1703,5,1708,3142,3,1,3,0,1,0,54.3602800764
臺北縣,三峽鎮,安溪里,0,1,2718,11,2729,5119,3,1,3,0,1,0,53.3111935925
臺北縣,三峽鎮,介壽里,0,1,1931,14,1945,3822,3,1,3,0,1,0,50.8895866039
臺北縣,三峽鎮,中正里,0,1,1874,16,1890,3510,3,1,3,0,1,0,53.8461538462
臺北縣,三峽鎮,大埔里,0,1,1804,13,1817,3185,3,1,3,0,1,0,57.0486656201
臺北縣,三峽鎮,嘉添里,0,1,1459,24,1483,2511,3,1,3,0,1,0,59.0601354042
臺北縣,三峽鎮,添福里,0,1,555,2,557,940,3,1,3,0,1,0,59.2553191489
臺北縣,三峽鎮,金圳里,0,1,262,4,266,466,3,1,3,0,1,0,57.0815450644
臺北縣,三峽鎮,五寮里,0,1,549,4,553,873,3,1,3,0,1,0,63.3447880871
臺北縣,三峽鎮,插角里,0,1,445,3,448,796,3,1,3,0,1,0,56.2814070352
臺北縣,三峽鎮,有木里,0,1,439,2,441,783,3,1,3,0,1,0,56.3218390805
臺北縣,三峽鎮,二鬮里,0,1,1238,9,1247,2396,3,1,3,0,1,0,52.0450751252
臺北縣,三峽鎮,溪南里,0,1,733,4,737,1246,3,1,3,0,1,0,59.1492776886
臺北縣,三峽鎮,溪北里,0,1,1128,4,1132,1841,3,1,3,0,1,0,61.4883215644
臺北縣,三峽鎮,溪東里,0,1,1226,18,1244,2311,3,1,3,0,1,0,53.8295110342
臺北縣,三峽鎮,成福里,0,1,544,4,548,842,3,1,3,0,1,0,65.0831353919
臺北縣,三峽鎮,竹崙里,0,1,967,12,979,1732,3,1,3,0,1,0,56.5242494226
臺北縣,三峽鎮,安坑里,0,1,691,10,701,1273,3,1,3,0,1,0,55.0667714061
臺北縣,三重市,大有里,0,2,1967,17,1984,3572,3,1,3,0,1,0,55.54
臺北縣,三重市,博愛里,0,2,2268,16,2284,3662,3,1,3,0,1,0,62.37
臺北縣,三重市,二重里,0,2,922,1,923,1722,3,1,3,0,1,0,53.60
臺北縣,三重市,頂崁里,0,2,1036,13,1049,1772,3,1,3,0,1,0,59.20
臺北縣,三重市,谷王里,0,2,725,2,727,1098,3,1,3,0,1,0,66.21
臺北縣,三重市,五谷里,0,2,1109,10,1119,1825,3,1,3,0,1,0,61.32
臺北縣,三重市,中興里,0,2,1856,25,1881,3031,3,1,3,0,1,0,62.06
臺北縣,三重市,德厚里,0,2,234,6,240,376,3,1,3,0,1,0,63.83
臺北縣,三重市,成功里,0,2,2445,11,2456,4282,3,1,3,0,1,0,57.36
臺北縣,三重市,福祉里,0,2,1892,17,1909,3196,3,1,3,0,1,0,59.73
臺北縣,三重市,福德里,0,2,1690,12,1702,3114,3,1,3,0,1,0,54.66
臺北縣,三重市,福民里,0,2,1564,19,1583,2657,3,1,3,0,1,0,59.58
臺北縣,三重市,過田里,0,2,2508,16,2524,4933,3,1,3,0,1,0,51.17
臺北縣,三重市,錦田里,0,2,1025,10,1035,1743,3,1,3,0,1,0,59.38
臺北縣,三重市,重明里,0,2,1755,10,1765,2567,3,1,3,0,1,0,68.76
臺北縣,三重市,光田里,0,2,2095,12,2107,3506,3,1,3,0,1,0,60.10
臺北縣,三重市,光陽里,0,2,3022,16,3038,5002,3,1,3,0,1,0,60.74
臺北縣,三重市,田心里,0,2,2048,19,2067,3373,3,1,3,0,1,0,61.28
臺北縣,三重市,福田里,0,2,1626,11,1637,2810,3,1,3,0,1,0,58.26
臺北縣,三重市,田中里,0,2,2794,18,2812,4603,3,1,3,0,1,0,61.09
臺北縣,三重市,田安里,0,2,2864,19,2883,4901,3,1,3,0,1,0,58.82
臺北縣,三重市,三民里,0,2,1473,4,1477,2579,3,1,3,0,1,0,57.27
臺北縣,三重市,光明里,0,2,2745,16,2761,5060,3,1,3,0,1,0,54.57
臺北縣,三重市,光正里,0,2,848,10,858,1528,3,1,3,0,1,0,56.15
臺北縣,三重市,同安里,0,2,801,6,807,1481,3,1,3,0,1,0,54.49
臺北縣,三重市,同慶里,0,2,858,10,868,1437,3,1,3,0,1,0,60.40
臺北縣,三重市,菜寮里,0,2,1008,9,1017,1748,3,1,3,0,1,0,58.18
臺北縣,三重市,永春里,0,2,888,8,896,1489,3,1,3,0,1,0,60.17
臺北縣,三重市,中正里,0,2,741,11,752,1189,3,1,3,0,1,0,63.25
臺北縣,三重市,吉利里,0,2,723,13,736,1246,3,1,3,0,1,0,59.07
臺北縣,三重市,大同里,0,2,845,8,853,1557,3,1,3,0,1,0,54.78
臺北縣,三重市,中民里,0,2,700,10,710,1151,3,1,3,0,1,0,61.69
臺北縣,三重市,平和里,0,2,847,7,854,1431,3,1,3,0,1,0,59.68
臺北縣,三重市,大安里,0,2,833,8,841,1427,3,1,3,0,1,0,58.93
臺北縣,三重市,仁德里,0,2,1073,15,1088,1860,3,1,3,0,1,0,58.49
臺北縣,三重市,忠孝里,0,2,943,10,953,1590,3,1,3,0,1,0,59.94
臺北縣,三重市,仁義里,0,2,670,6,676,1090,3,1,3,0,1,0,62.02
臺北縣,三重市,光榮里,0,2,657,7,664,1091,3,1,3,0,1,0,60.86
臺北縣,三重市,光輝里,0,2,1004,9,1013,1545,3,1,3,0,1,0,65.57
臺北縣,三重市,福星里,0,2,529,9,538,769,3,1,3,0,1,0,69.96
臺北縣,三重市,福利里,0,2,862,11,873,1596,3,1,3,0,1,0,54.70
臺北縣,三重市,清和里,0,2,1751,13,1764,3085,3,1,3,0,1,0,57.18
臺北縣,三重市,永興里,0,2,667,9,676,1194,3,1,3,0,1,0,56.62
臺北縣,三重市,中山里,0,2,1219,14,1233,2090,3,1,3,0,1,0,59.00
臺北縣,三重市,大園里,0,2,1199,10,1209,2110,3,1,3,0,1,0,57.30
臺北縣,三重市,國隆里,0,2,1322,12,1334,2148,3,1,3,0,1,0,62.10
臺北縣,三重市,重陽里,0,2,1682,10,1692,2908,3,1,3,0,1,0,58.18
臺北縣,三重市,民生里,0,2,2110,14,2124,3653,3,1,3,0,1,0,58.14
臺北縣,三重市,重新里,0,2,824,8,832,1317,3,1,3,0,1,0,63.17
臺北縣,三重市,正德里,0,2,658,5,663,1019,3,1,3,0,1,0,65.06
臺北縣,三重市,正義里,0,2,899,5,904,1498,3,1,3,0,1,0,60.35
臺北縣,三重市,正安里,0,2,1019,13,1032,1676,3,1,3,0,1,0,61.58
臺北縣,三重市,自強里,0,2,967,8,975,1615,3,1,3,0,1,0,60.37
臺北縣,三重市,文化里,0,2,1295,8,1303,2110,3,1,3,0,1,0,61.75
臺北縣,三重市,中央里,0,2,907,10,917,1513,3,1,3,0,1,0,60.61
臺北縣,三重市,雙園里,0,2,514,2,516,836,3,1,3,0,1,0,61.72
臺北縣,三重市,錦通里,0,2,890,10,900,1451,3,1,3,0,1,0,62.03
臺北縣,三重市,錦安里,0,2,1071,9,1080,1724,3,1,3,0,1,0,62.65
臺北縣,三重市,長安里,0,2,1139,9,1148,1956,3,1,3,0,1,0,58.69
臺北縣,三重市,光華里,0,2,912,5,917,1671,3,1,3,0,1,0,54.88
臺北縣,三重市,長生里,0,2,404,1,405,752,3,1,3,0,1,0,53.86
臺北縣,三重市,開元里,0,2,852,15,867,1317,3,1,3,0,1,0,65.83
臺北縣,三重市,大德里,0,2,388,1,389,659,3,1,3,0,1,0,59.03
臺北縣,三重市,長元里,0,2,1233,16,1249,2118,3,1,3,0,1,0,58.97
臺北縣,三重市,長江里,0,2,980,8,988,1701,3,1,3,0,1,0,58.08
臺北縣,三重市,長泰里,0,2,1133,4,1137,2059,3,1,3,0,1,0,55.22
臺北縣,三重市,長福里,0,2,838,6,844,1405,3,1,3,0,1,0,60.07
臺北縣,三重市,介壽里,0,2,615,28,643,1084,3,1,3,0,1,0,59.32
臺北縣,三重市,萬壽里,0,2,1007,10,1017,1712,3,1,3,0,1,0,59.40
臺北縣,三重市,錦江里,0,2,1096,9,1105,2056,3,1,3,0,1,0,53.75
臺北縣,三重市,龍濱里,0,2,1530,17,1547,2588,3,1,3,0,1,0,59.78
臺北縣,三重市,龍門里,0,2,920,8,928,1656,3,1,3,0,1,0,56.04
臺北縣,三重市,秀江里,0,2,710,8,718,1154,3,1,3,0,1,0,62.22
臺北縣,三重市,奕壽里,0,2,755,8,763,1303,3,1,3,0,1,0,58.56
臺北縣,三重市,三安里,0,2,1291,11,1302,2250,3,1,3,0,1,0,57.87
臺北縣,三重市,福安里,0,2,1521,20,1541,2571,3,1,3,0,1,0,59.94
臺北縣,三重市,信安里,0,2,926,15,941,1582,3,1,3,0,1,0,59.48
臺北縣,三重市,安慶里,0,2,1095,5,1100,1833,3,1,3,0,1,0,60.01
臺北縣,三重市,幸福里,0,2,2182,19,2201,3753,3,1,3,0,1,0,58.65
臺北縣,三重市,六合里,0,2,1823,21,1844,3143,3,1,3,0,1,0,58.67
臺北縣,三重市,六福里,0,2,2351,24,2375,4270,3,1,3,0,1,0,55.62
臺北縣,三重市,順德里,0,2,1102,22,1124,1872,3,1,3,0,1,0,60.04
臺北縣,三重市,承德里,0,2,1011,14,1025,1633,3,1,3,0,1,0,62.77
臺北縣,三重市,瑞德里,0,2,1269,12,1281,2074,3,1,3,0,1,0,61.76
臺北縣,三重市,崇德里,0,2,1976,19,1995,3391,3,1,3,0,1,0,58.83
臺北縣,三重市,厚德里,0,2,1767,15,1782,2838,3,1,3,0,1,0,62.79
臺北縣,三重市,維德里,0,2,1467,15,1482,2423,3,1,3,0,1,0,61.16
臺北縣,三重市,尚德里,0,2,1586,17,1603,2735,3,1,3,0,1,0,58.61
臺北縣,三重市,培德里,0,2,1682,13,1695,2805,3,1,3,0,1,0,60.43
臺北縣,三重市,立德里,0,2,1632,12,1644,2745,3,1,3,0,1,0,59.89
臺北縣,三重市,永德里,0,2,2453,30,2483,4070,3,1,3,0,1,0,61.01
臺北縣,三重市,永輝里,0,2,1282,8,1290,2178,3,1,3,0,1,0,59.23
臺北縣,三重市,永發里,0,2,2143,17,2160,3608,3,1,3,0,1,0,59.87
臺北縣,三重市,永盛里,0,2,1618,18,1636,2857,3,1,3,0,1,0,57.26
臺北縣,三重市,永吉里,0,2,1283,10,1293,2417,3,1,3,0,1,0,53.50
臺北縣,三重市,永安里,0,2,1486,8,1494,2744,3,1,3,0,1,0,54.45
臺北縣,三重市,永豐里,0,2,2190,23,2213,3974,3,1,3,0,1,0,55.69
臺北縣,三重市,永福里,0,2,2279,15,2294,4133,3,1,3,0,1,0,55.50
臺北縣,三重市,永清里,0,2,2387,21,2408,4484,3,1,3,0,1,0,53.70
臺北縣,三重市,永順里,0,2,1970,9,1979,3756,3,1,3,0,1,0,52.69
臺北縣,三重市,溪美里,0,2,3148,23,3171,5931,3,1,3,0,1,0,53.46
臺北縣,三重市,福隆里,0,2,1560,10,1570,3109,3,1,3,0,1,0,50.50
臺北縣,三重市,五常里,0,2,1973,18,1991,3325,3,1,3,0,1,0,59.88
臺北縣,三重市,五福里,0,2,1193,9,1202,2268,3,1,3,0,1,0,53.00
臺北縣,三重市,仁忠里,0,2,1445,13,1458,2667,3,1,3,0,1,0,54.67
臺北縣,三重市,慈福里,0,2,1125,15,1140,1979,3,1,3,0,1,0,57.60
臺北縣,三重市,慈生里,0,2,1204,10,1214,2007,3,1,3,0,1,0,60.49
臺北縣,三重市,慈惠里,0,2,1191,16,1207,1987,3,1,3,0,1,0,60.74
臺北縣,三重市,慈愛里,0,2,1846,28,1874,3161,3,1,3,0,1,0,59.29
臺北縣,三重市,慈化里,0,2,1126,19,1145,2058,3,1,3,0,1,0,55.64
臺北縣,三重市,慈祐里,0,2,2007,21,2028,3667,3,1,3,0,1,0,55.30
臺北縣,三重市,富華里,0,2,1204,12,1216,2228,3,1,3,0,1,0,54.58
臺北縣,三重市,富貴里,0,2,1446,14,1460,2668,3,1,3,0,1,0,54.72
臺北縣,三重市,富福里,0,2,966,13,979,1778,3,1,3,0,1,0,55.06
臺北縣,三重市,五華里,0,2,1669,9,1678,2901,3,1,3,0,1,0,57.84
臺北縣,三重市,碧華里,0,2,1228,12,1240,2165,3,1,3,0,1,0,57.27
臺北縣,三重市,福樂里,0,2,1791,12,1803,3001,3,1,3,0,1,0,60.08
臺北縣,三重市,仁華里,0,2,1800,17,1817,3191,3,1,3,0,1,0,56.94
臺北縣,三重市,五順里,0,2,1692,19,1711,3085,3,1,3,0,1,0,55.46
臺北縣,蘆洲市,光華里,0,2,2166,17,2183,3899,3,1,3,0,1,0,55.9887150551
臺北縣,蘆洲市,光明里,0,2,1768,12,1780,3340,3,1,3,0,1,0,53.2934131737
臺北縣,蘆洲市,中路里,0,2,1550,14,1564,2688,3,1,3,0,1,0,58.1845238095
臺北縣,蘆洲市,永安里,0,2,1841,21,1862,3268,3,1,3,0,1,0,56.976744186
臺北縣,蘆洲市,九芎里,0,2,2046,17,2063,3679,3,1,3,0,1,0,56.075020386
臺北縣,蘆洲市,延平里,0,2,1563,12,1575,2822,3,1,3,0,1,0,55.811481219
臺北縣,蘆洲市,中華里,0,2,1418,6,1424,2446,3,1,3,0,1,0,58.2174979558
臺北縣,蘆洲市,中原里,0,2,1677,15,1692,3163,3,1,3,0,1,0,53.4935188113
臺北縣,蘆洲市,長安里,0,2,1768,9,1777,3581,3,1,3,0,1,0,49.6230103323
臺北縣,蘆洲市,忠義里,0,2,952,16,968,1766,3,1,3,0,1,0,54.8131370328
臺北縣,蘆洲市,正義里,0,2,595,5,600,1151,3,1,3,0,1,0,52.1285838401
臺北縣,蘆洲市,南港里,0,2,2147,15,2162,4136,3,1,3,0,1,0,52.2727272727
臺北縣,蘆洲市,永樂里,0,2,2206,18,2224,4368,3,1,3,0,1,0,50.9157509158
臺北縣,蘆洲市,成功里,0,2,2315,15,2330,4574,3,1,3,0,1,0,50.9400961959
臺北縣,蘆洲市,永康里,0,2,2128,31,2159,4303,3,1,3,0,1,0,50.1742970021
臺北縣,蘆洲市,永德里,0,2,1499,8,1507,3043,3,1,3,0,1,0,49.5234965495
臺北縣,蘆洲市,樓厝里,0,2,2286,15,2301,4213,3,1,3,0,1,0,54.6166627107
臺北縣,蘆洲市,信義里,0,2,1781,13,1794,3104,3,1,3,0,1,0,57.7963917526
臺北縣,蘆洲市,玉清里,0,2,1982,29,2011,3725,3,1,3,0,1,0,53.9865771812
臺北縣,蘆洲市,復興里,0,2,1591,16,1607,2717,3,1,3,0,1,0,59.1461170409
臺北縣,蘆洲市,福安里,0,2,1269,18,1287,2313,3,1,3,0,1,0,55.6420233463
臺北縣,蘆洲市,鷺江里,0,2,2178,15,2193,4059,3,1,3,0,1,0,54.0280857354
臺北縣,蘆洲市,恆德里,0,2,2441,12,2453,4701,3,1,3,0,1,0,52.1803871517
臺北縣,蘆洲市,溪墘里,0,2,1471,16,1487,2615,3,1,3,0,1,0,56.8642447419
臺北縣,蘆洲市,仁復里,0,2,976,7,983,1728,3,1,3,0,1,0,56.8865740741
臺北縣,蘆洲市,仁德里,0,2,2138,4,2142,3996,3,1,3,0,1,0,53.6036036036
臺北縣,蘆洲市,仁義里,0,2,1178,15,1193,2768,3,1,3,0,1,0,43.0997109827
臺北縣,蘆洲市,得勝里,0,2,1677,12,1689,2766,3,1,3,0,1,0,61.0629067245
臺北縣,蘆洲市,得仁里,0,2,1251,11,1262,2199,3,1,3,0,1,0,57.3897226012
臺北縣,蘆洲市,保和里,0,2,1189,12,1201,2070,3,1,3,0,1,0,58.0193236715
臺北縣,蘆洲市,樹德里,0,2,1440,7,1447,2602,3,1,3,0,1,0,55.6110684089
臺北縣,蘆洲市,民和里,0,2,1402,21,1423,2357,3,1,3,0,1,0,60.373355961
臺北縣,蘆洲市,水湳里,0,2,3368,16,3384,6437,3,1,3,0,1,0,52.5710734814
臺北縣,蘆洲市,水河里,0,2,3200,22,3222,6260,3,1,3,0,1,0,51.4696485623
臺北縣,蘆洲市,仁愛里,0,2,2021,18,2039,3906,3,1,3,0,1,0,52.2017409114
臺北縣,蘆洲市,忠孝里,0,2,909,10,919,1740,3,1,3,0,1,0,52.816091954
臺北縣,蘆洲市,保佑里,0,2,1576,10,1586,2975,3,1,3,0,1,0,53.3109243697
臺北縣,蘆洲市,保新里,0,2,1259,7,1266,2093,3,1,3,0,1,0,60.4873387482
臺北縣,新莊市,海山里,0,2,2596,30,2626,4443,3,1,3,0,1,0,59.1042088679
臺北縣,新莊市,全安里,0,2,2060,14,2074,3420,3,1,3,0,1,0,60.6432748538
臺北縣,新莊市,全泰里,0,2,2664,15,2679,4278,3,1,3,0,1,0,62.6227208976
臺北縣,新莊市,忠孝里,0,2,2239,19,2258,3689,3,1,3,0,1,0,61.2089997289
臺北縣,新莊市,文衡里,0,2,1098,10,1108,1738,3,1,3,0,1,0,63.751438435
臺北縣,新莊市,文聖里,0,2,1855,19,1874,3046,3,1,3,0,1,0,61.523309258
臺北縣,新莊市,興漢里,0,2,1846,17,1863,3076,3,1,3,0,1,0,60.5656697009
臺北縣,新莊市,榮和里,0,2,1518,14,1532,3336,3,1,3,0,1,0,45.9232613909
臺北縣,新莊市,文德里,0,2,893,2,895,1438,3,1,3,0,1,0,62.2392211405
臺北縣,新莊市,文明里,0,2,992,9,1001,1574,3,1,3,0,1,0,63.5959339263
臺北縣,新莊市,化成里,0,2,1302,8,1310,2204,3,1,3,0,1,0,59.4373865699
臺北縣,新莊市,頭前里,0,2,1860,17,1877,3232,3,1,3,0,1,0,58.0754950495
臺北縣,新莊市,福基里,0,2,1253,9,1262,2102,3,1,3,0,1,0,60.0380589914
臺北縣,新莊市,福興里,0,2,1657,7,1664,3125,3,1,3,0,1,0,53.248
臺北縣,新莊市,昌平里,0,2,1413,13,1426,2780,3,1,3,0,1,0,51.2949640288
臺北縣,新莊市,和平里,0,2,2188,17,2205,3944,3,1,3,0,1,0,55.9077079108
臺北縣,新莊市,幸福里,0,2,2013,17,2030,3660,3,1,3,0,1,0,55.4644808743
臺北縣,新莊市,昌隆里,0,2,1517,9,1526,2839,3,1,3,0,1,0,53.7513208876
臺北縣,新莊市,信義里,0,2,2328,26,2354,4310,3,1,3,0,1,0,54.6171693735
臺北縣,新莊市,昌信里,0,2,1282,8,1290,2344,3,1,3,0,1,0,55.0341296928
臺北縣,新莊市,昌明里,0,2,1594,8,1602,2718,3,1,3,0,1,0,58.940397351
臺北縣,新莊市,仁義里,0,2,1564,15,1579,2865,3,1,3,0,1,0,55.1134380454
臺北縣,新莊市,仁愛里,0,2,1380,7,1387,2355,3,1,3,0,1,0,58.8959660297
臺北縣,新莊市,自信里,0,2,1136,10,1146,2057,3,1,3,0,1,0,55.7122022363
臺北縣,新莊市,自立里,0,2,2299,32,2331,3968,3,1,3,0,1,0,58.7449596774
臺北縣,新莊市,自強里,0,2,1329,27,1356,2400,3,1,3,0,1,0,56.5
臺北縣,新莊市,思源里,0,2,2374,9,2383,4332,3,1,3,0,1,0,55.0092336103
臺北縣,新莊市,思賢里,0,2,1864,17,1881,3220,3,1,3,0,1,0,58.4161490683
臺北縣,新莊市,中華里,0,2,903,6,909,1585,3,1,3,0,1,0,57.3501577287
臺北縣,新莊市,中美里,0,2,2737,20,2757,4700,3,1,3,0,1,0,58.6595744681
臺北縣,新莊市,恆安里,0,2,2159,11,2170,3692,3,1,3,0,1,0,58.7757313109
臺北縣,新莊市,立人里,0,2,1074,9,1083,1754,3,1,3,0,1,0,61.7445838084
臺北縣,新莊市,立德里,0,2,1313,4,1317,2228,3,1,3,0,1,0,59.1113105925
臺北縣,新莊市,中和里,0,2,2138,18,2156,3737,3,1,3,0,1,0,57.6933369013
臺北縣,新莊市,中泰里,0,2,2234,16,2250,3872,3,1,3,0,1,0,58.1095041322
臺北縣,新莊市,中宏里,0,2,1604,14,1618,2704,3,1,3,0,1,0,59.8372781065
臺北縣,新莊市,中全里,0,2,1544,16,1560,2881,3,1,3,0,1,0,54.1478653245
臺北縣,新莊市,立志里,0,2,1734,12,1746,3061,3,1,3,0,1,0,57.0401829467
臺北縣,新莊市,立廷里,0,2,1438,5,1443,2771,3,1,3,0,1,0,52.0750631541
臺北縣,新莊市,立基里,0,2,2608,18,2626,4578,3,1,3,0,1,0,57.3612931411
臺北縣,新莊市,中誠里,0,2,944,8,952,1755,3,1,3,0,1,0,54.245014245
臺北縣,新莊市,中港里,0,2,2611,10,2621,4686,3,1,3,0,1,0,55.9325650875
臺北縣,新莊市,中信里,0,2,3250,19,3269,6054,3,1,3,0,1,0,53.9973571193
臺北縣,新莊市,中平里,0,2,2907,16,2923,5607,3,1,3,0,1,0,52.1312644908
臺北縣,新莊市,中原里,0,2,3147,24,3171,5817,3,1,3,0,1,0,54.5126353791
臺北縣,新莊市,中隆里,0,2,1539,14,1553,2710,3,1,3,0,1,0,57.3062730627
臺北縣,新莊市,立功里,0,2,1696,12,1708,3119,3,1,3,0,1,0,54.7611413915
臺北縣,新莊市,立泰里,0,2,2077,14,2091,3796,3,1,3,0,1,0,55.0842992624
臺北縣,新莊市,立言里,0,2,2245,12,2257,3952,3,1,3,0,1,0,57.1103238866
臺北縣,新莊市,豐年里,0,2,1659,11,1670,3048,3,1,3,0,1,0,54.7900262467
臺北縣,新莊市,國泰里,0,2,923,9,932,1429,3,1,3,0,1,0,65.2204338698
臺北縣,新莊市,泰豐里,0,2,1190,11,1201,2000,3,1,3,0,1,0,60.05
臺北縣,新莊市,瓊林里,0,2,2658,21,2679,4607,3,1,3,0,1,0,58.1506403299
臺北縣,新莊市,福營里,0,2,1241,13,1254,1973,3,1,3,0,1,0,63.5580334516
臺北縣,新莊市,營盤里,0,2,1156,8,1164,1937,3,1,3,0,1,0,60.092927207
臺北縣,新莊市,丹鳳里,0,2,2773,14,2787,5359,3,1,3,0,1,0,52.0059712633
臺北縣,新莊市,合鳳里,0,2,1819,13,1832,3607,3,1,3,0,1,0,50.7901303022
臺北縣,新莊市,祥鳳里,0,2,964,3,967,1759,3,1,3,0,1,0,54.9744172825
臺北縣,新莊市,雙鳳里,0,2,2439,18,2457,4690,3,1,3,0,1,0,52.3880597015
臺北縣,新莊市,龍福里,0,2,790,12,802,1516,3,1,3,0,1,0,52.9023746702
臺北縣,新莊市,龍鳳里,0,2,2258,14,2272,4399,3,1,3,0,1,0,51.6481018413
臺北縣,新莊市,裕民里,0,2,2753,15,2768,5004,3,1,3,0,1,0,55.3157474021
臺北縣,新莊市,龍安里,0,2,1045,14,1059,1955,3,1,3,0,1,0,54.168797954
臺北縣,新莊市,富國里,0,2,1158,8,1166,2055,3,1,3,0,1,0,56.7396593674
臺北縣,新莊市,富民里,0,2,1462,13,1475,2689,3,1,3,0,1,0,54.8531052436
臺北縣,新莊市,後德里,0,2,1265,4,1269,2216,3,1,3,0,1,0,57.2653429603
臺北縣,新莊市,萬安里,0,2,1425,11,1436,2650,3,1,3,0,1,0,54.1886792453
臺北縣,新莊市,建福里,0,2,1097,9,1106,2009,3,1,3,0,1,0,55.0522648084
臺北縣,新莊市,後港里,0,2,2821,15,2836,5048,3,1,3,0,1,0,56.1806656101
臺北縣,新莊市,四維里,0,2,1960,15,1975,3825,3,1,3,0,1,0,51.6339869281
臺北縣,新莊市,南港里,0,2,1990,8,1998,3862,3,1,3,0,1,0,51.7348524081
臺北縣,新莊市,建安里,0,2,2284,14,2298,4450,3,1,3,0,1,0,51.6404494382
臺北縣,新莊市,民全里,0,2,1302,6,1308,2387,3,1,3,0,1,0,54.7968160871
臺北縣,新莊市,民本里,0,2,1326,12,1338,2491,3,1,3,0,1,0,53.7133681253
臺北縣,新莊市,八德里,0,2,1254,12,1266,2508,3,1,3,0,1,0,50.4784688995
臺北縣,新莊市,民安里,0,2,1967,23,1990,3772,3,1,3,0,1,0,52.7571580064
臺北縣,新莊市,成德里,0,2,1722,10,1732,3618,3,1,3,0,1,0,47.8717523494
臺北縣,新莊市,光明里,0,2,1470,12,1482,2884,3,1,3,0,1,0,51.386962552
臺北縣,新莊市,光華里,0,2,2148,15,2163,4483,3,1,3,0,1,0,48.2489404417
臺北縣,新莊市,光榮里,0,2,1522,13,1535,2926,3,1,3,0,1,0,52.4606971975
臺北縣,新莊市,光正里,0,2,1493,17,1510,2753,3,1,3,0,1,0,54.8492553578
臺北縣,新莊市,光和里,0,2,987,5,992,1973,3,1,3,0,1,0,50.2787633046
臺北縣,新莊市,民有里,0,2,1485,13,1498,2778,3,1,3,0,1,0,53.9236861051
臺北縣,新莊市,西盛里,0,2,2238,31,2269,4271,3,1,3,0,1,0,53.1257316788
臺北縣,五股鄉,興珍村,0,2,2205,18,2223,3801,3,1,3,0,1,0,58.4846093133
臺北縣,五股鄉,更寮村,0,2,667,3,670,1116,3,1,3,0,1,0,60.0358422939
臺北縣,五股鄉,集福村,0,2,1410,15,1425,2508,3,1,3,0,1,0,56.8181818182
臺北縣,五股鄉,集賢村,0,2,1506,18,1524,2746,3,1,3,0,1,0,55.4989075018
臺北縣,五股鄉,觀音村,0,2,750,6,756,1270,3,1,3,0,1,0,59.5275590551
臺北縣,五股鄉,成州村,0,2,2310,19,2329,4177,3,1,3,0,1,0,55.7577208523
臺北縣,五股鄉,成德村,0,2,1187,11,1198,2257,3,1,3,0,1,0,53.079308817
臺北縣,五股鄉,成功村,0,2,1548,15,1563,3051,3,1,3,0,1,0,51.2291052114
臺北縣,五股鄉,成泰村,0,2,1550,15,1565,2693,3,1,3,0,1,0,58.1136279242
臺北縣,五股鄉,五龍村,0,2,735,5,740,1168,3,1,3,0,1,0,63.3561643836
臺北縣,五股鄉,五福村,0,2,1692,11,1703,2830,3,1,3,0,1,0,60.1766784452
臺北縣,五股鄉,六福村,0,2,1494,7,1501,2600,3,1,3,0,1,0,57.7307692308
臺北縣,五股鄉,五股村,0,2,1736,14,1750,3218,3,1,3,0,1,0,54.3816034804
臺北縣,五股鄉,民義村,0,2,1564,8,1572,2563,3,1,3,0,1,0,61.3343737807
臺北縣,五股鄉,德音村,0,2,2094,14,2108,3621,3,1,3,0,1,0,58.2159624413
臺北縣,五股鄉,水碓村,0,2,2759,23,2782,5128,3,1,3,0,1,0,54.2511700468
臺北縣,五股鄉,德泰村,0,2,2342,12,2354,4754,3,1,3,0,1,0,49.5161968868
臺北縣,五股鄉,貿商村,0,2,1292,8,1300,1847,3,1,3,0,1,0,70.3844071467
臺北縣,泰山鄉,大科村,0,2,547,7,554,866,3,1,3,0,1,0,63.9722863741
臺北縣,泰山鄉,黎明村,0,2,1615,15,1630,2829,3,1,3,0,1,0,57.6175326971
臺北縣,泰山鄉,山腳村,0,2,2427,19,2446,4398,3,1,3,0,1,0,55.6161891769
臺北縣,泰山鄉,福泰村,0,2,2660,14,2674,4645,3,1,3,0,1,0,57.5672766416
臺北縣,泰山鄉,楓樹村,0,2,1615,8,1623,2652,3,1,3,0,1,0,61.1990950226
臺北縣,泰山鄉,同榮村,0,2,1891,24,1915,3146,3,1,3,0,1,0,60.8709472346
臺北縣,泰山鄉,同興村,0,2,2152,16,2168,4131,3,1,3,0,1,0,52.4812394093
臺北縣,泰山鄉,義學村,0,2,1827,19,1846,3205,3,1,3,0,1,0,57.5975039002
臺北縣,泰山鄉,義仁村,0,2,2359,17,2376,4181,3,1,3,0,1,0,56.8285099259
臺北縣,泰山鄉,明志村,0,2,1741,15,1756,2949,3,1,3,0,1,0,59.5456086809
臺北縣,泰山鄉,泰友村,0,2,1079,12,1091,1812,3,1,3,0,1,0,60.2097130243
臺北縣,泰山鄉,新明村,0,2,1592,16,1608,2712,3,1,3,0,1,0,59.2920353982
臺北縣,泰山鄉,貴子村,0,2,1798,13,1811,3097,3,1,3,0,1,0,58.4759444624
臺北縣,泰山鄉,貴賢村,0,2,1858,14,1872,3034,3,1,3,0,1,0,61.7007251154
臺北縣,泰山鄉,貴和村,0,2,2196,17,2213,3875,3,1,3,0,1,0,57.1096774194
臺北縣,林口鄉,東林村,0,2,1917,19,1936,3426,3,1,3,0,1,0,56.509048453
臺北縣,林口鄉,林口村,0,2,1877,21,1898,3480,3,1,3,0,1,0,54.5402298851
臺北縣,林口鄉,西林村,0,2,1913,10,1923,3308,3,1,3,0,1,0,58.1318016929
臺北縣,林口鄉,菁湖村,0,2,1948,15,1963,3261,3,1,3,0,1,0,60.1962588163
臺北縣,林口鄉,中湖村,0,2,1351,10,1361,2332,3,1,3,0,1,0,58.3619210978
臺北縣,林口鄉,湖北村,0,2,697,16,713,1101,3,1,3,0,1,0,64.7593097184
臺北縣,林口鄉,湖南村,0,2,749,11,760,1267,3,1,3,0,1,0,59.9842146803
臺北縣,林口鄉,南勢村,0,2,469,6,475,746,3,1,3,0,1,0,63.672922252
臺北縣,林口鄉,仁愛村,0,2,1751,12,1763,3361,3,1,3,0,1,0,52.4546265992
臺北縣,林口鄉,麗林村,0,2,2044,11,2055,4015,3,1,3,0,1,0,51.1830635118
臺北縣,林口鄉,東勢村,0,2,2173,15,2188,3960,3,1,3,0,1,0,55.2525252525
臺北縣,林口鄉,麗園村,0,2,1439,15,1454,2760,3,1,3,0,1,0,52.6811594203
臺北縣,林口鄉,頂福村,0,2,579,7,586,949,3,1,3,0,1,0,61.7492096944
臺北縣,林口鄉,下福村,0,2,594,4,598,933,3,1,3,0,1,0,64.0943193998
臺北縣,林口鄉,嘉寶村,0,2,452,1,453,637,3,1,3,0,1,0,71.114599686
臺北縣,林口鄉,瑞平村,0,2,283,2,285,446,3,1,3,0,1,0,63.9013452915
臺北縣,林口鄉,太平村,0,2,480,6,486,875,3,1,3,0,1,0,55.5428571429
臺北縣,淡水鎮,中和里,0,2,345,5,350,571,3,1,3,0,1,0,61.295971979
臺北縣,淡水鎮,屯山里,0,2,612,4,616,946,3,1,3,0,1,0,65.1162790698
臺北縣,淡水鎮,賢孝里,0,2,760,9,769,1339,3,1,3,0,1,0,57.430918596
臺北縣,淡水鎮,興仁里,0,2,848,9,857,1373,3,1,3,0,1,0,62.4180626366
臺北縣,淡水鎮,蕃薯里,0,2,401,0,401,786,3,1,3,0,1,0,51.0178117048
臺北縣,淡水鎮,忠山里,0,2,485,5,490,811,3,1,3,0,1,0,60.4192355117
臺北縣,淡水鎮,義山里,0,2,1161,10,1171,2152,3,1,3,0,1,0,54.4144981413
臺北縣,淡水鎮,水源里,0,2,1000,18,1018,1823,3,1,3,0,1,0,55.8420186506
臺北縣,淡水鎮,忠寮里,0,2,604,3,607,1008,3,1,3,0,1,0,60.2182539683
臺北縣,淡水鎮,樹興里,0,2,480,2,482,781,3,1,3,0,1,0,61.7157490397
臺北縣,淡水鎮,坪頂里,0,2,575,9,584,1053,3,1,3,0,1,0,55.4605887939
臺北縣,淡水鎮,福德里,0,2,2674,18,2692,4727,3,1,3,0,1,0,56.9494393907
臺北縣,淡水鎮,竹圍里,0,2,3689,27,3716,6750,3,1,3,0,1,0,55.0518518519
臺北縣,淡水鎮,民生里,0,2,2193,14,2207,4231,3,1,3,0,1,0,52.1626093122
臺北縣,淡水鎮,八勢里,0,2,1126,11,1137,2119,3,1,3,0,1,0,53.6573855592
臺北縣,淡水鎮,竿蓁里,0,2,1688,10,1698,3445,3,1,3,0,1,0,49.2888243832
臺北縣,淡水鎮,崁頂里,0,2,758,6,764,1290,3,1,3,0,1,0,59.2248062016
臺北縣,淡水鎮,埤島里,0,2,643,2,645,1060,3,1,3,0,1,0,60.8490566038
臺北縣,淡水鎮,水碓里,0,2,4698,26,4724,9083,3,1,3,0,1,0,52.0092480458
臺北縣,淡水鎮,新興里,0,2,7272,48,7320,14277,3,1,3,0,1,0,51.271275478
臺北縣,淡水鎮,北投里,0,2,902,9,911,1679,3,1,3,0,1,0,54.2584871948
臺北縣,淡水鎮,鄧公里,0,2,5469,57,5526,10307,3,1,3,0,1,0,53.6140487048
臺北縣,淡水鎮,中興里,0,2,1997,26,2023,3540,3,1,3,0,1,0,57.1468926554
臺北縣,淡水鎮,長庚里,0,2,840,8,848,1472,3,1,3,0,1,0,57.6086956522
臺北縣,淡水鎮,清文里,0,2,583,11,594,1038,3,1,3,0,1,0,57.225433526
臺北縣,淡水鎮,草東里,0,2,522,6,528,798,3,1,3,0,1,0,66.1654135338
臺北縣,淡水鎮,協元里,0,2,744,8,752,1341,3,1,3,0,1,0,56.0775540641
臺北縣,淡水鎮,永吉里,0,2,482,6,488,733,3,1,3,0,1,0,66.5757162347
臺北縣,淡水鎮,民安里,0,2,458,3,461,728,3,1,3,0,1,0,63.3241758242
臺北縣,淡水鎮,新生里,0,2,289,3,292,674,3,1,3,0,1,0,43.3234421365
臺北縣,淡水鎮,文化里,0,2,861,9,870,1477,3,1,3,0,1,0,58.9031821259
臺北縣,淡水鎮,油車里,0,2,2165,19,2184,3755,3,1,3,0,1,0,58.1624500666
臺北縣,淡水鎮,沙崙里,0,2,2723,27,2750,4897,3,1,3,0,1,0,56.1568307127
臺北縣,八里鄉,龍源村,0,2,2438,18,2456,4420,3,1,3,0,1,0,55.5656108597
臺北縣,八里鄉,米倉村,0,2,1262,14,1276,2269,3,1,3,0,1,0,56.236227413
臺北縣,八里鄉,大崁村,0,2,901,10,911,1511,3,1,3,0,1,0,60.2911978822
臺北縣,八里鄉,埤頭村,0,2,1346,11,1357,2469,3,1,3,0,1,0,54.9615228838
臺北縣,八里鄉,頂罟村,0,2,653,6,659,1133,3,1,3,0,1,0,58.1641659312
臺北縣,八里鄉,舊城村,0,2,2270,23,2293,4445,3,1,3,0,1,0,51.5860517435
臺北縣,八里鄉,訊塘村,0,2,1406,9,1415,2541,3,1,3,0,1,0,55.6867375049
臺北縣,八里鄉,荖阡村,0,2,741,8,749,1296,3,1,3,0,1,0,57.7932098765
臺北縣,八里鄉,長坑村,0,2,761,3,764,1109,3,1,3,0,1,0,68.8908926961
臺北縣,八里鄉,下罟村,0,2,712,13,725,1065,3,1,3,0,1,0,68.0751173709
臺北縣,三芝鄉,八賢村,0,2,217,1,218,353,3,1,3,0,1,0,61.7563739377
臺北縣,三芝鄉,埔頭村,0,2,2075,10,2085,3678,3,1,3,0,1,0,56.6884176183
臺北縣,三芝鄉,古庄村,0,2,468,4,472,884,3,1,3,0,1,0,53.3936651584
臺北縣,三芝鄉,新庄村,0,2,487,4,491,800,3,1,3,0,1,0,61.375
臺北縣,三芝鄉,埔坪村,0,2,2637,20,2657,5076,3,1,3,0,1,0,52.3443656422
臺北縣,三芝鄉,茂長村,0,2,261,4,265,459,3,1,3,0,1,0,57.734204793
臺北縣,三芝鄉,橫山村,0,2,354,4,358,529,3,1,3,0,1,0,67.6748582231
臺北縣,三芝鄉,錫板村,0,2,466,4,470,764,3,1,3,0,1,0,61.5183246073
臺北縣,三芝鄉,後厝村,0,2,851,7,858,1599,3,1,3,0,1,0,53.6585365854
臺北縣,三芝鄉,福德村,0,2,367,2,369,648,3,1,3,0,1,0,56.9444444444
臺北縣,三芝鄉,圓山村,0,2,313,2,315,492,3,1,3,0,1,0,64.0243902439
臺北縣,三芝鄉,店子村,0,2,390,3,393,620,3,1,3,0,1,0,63.3870967742
臺北縣,三芝鄉,興華村,0,2,613,2,615,1109,3,1,3,0,1,0,55.4553651939
臺北縣,石門鄉,德茂村,0,2,524,4,528,895,3,1,3,0,1,0,58.9944134078
臺北縣,石門鄉,富基村,0,2,682,6,688,1085,3,1,3,0,1,0,63.4101382488
臺北縣,石門鄉,老梅村,0,2,985,10,995,1790,3,1,3,0,1,0,55.5865921788
臺北縣,石門鄉,山溪村,0,2,411,2,413,726,3,1,3,0,1,0,56.8870523416
臺北縣,石門鄉,石門村,0,2,729,9,738,1213,3,1,3,0,1,0,60.8408903545
臺北縣,石門鄉,尖鹿村,0,2,675,7,682,1240,3,1,3,0,1,0,55
臺北縣,石門鄉,乾華村,0,2,155,1,156,300,3,1,3,0,1,0,52
臺北縣,石門鄉,茂林村,0,2,301,3,304,499,3,1,3,0,1,0,60.9218436874
臺北縣,石門鄉,草里村,0,2,464,8,472,763,3,1,3,0,1,0,61.8610747051
臺北縣,金山鄉,和平村,0,2,304,0,304,443,3,1,3,0,1,0,68.6230248307
臺北縣,金山鄉,大同村,0,2,406,6,412,635,3,1,3,0,1,0,64.8818897638
臺北縣,金山鄉,豐漁村,0,2,292,0,292,470,3,1,3,0,1,0,62.1276595745
臺北縣,金山鄉,磺港村,0,2,915,3,918,1594,3,1,3,0,1,0,57.590966123
臺北縣,金山鄉,美田村,0,2,4032,31,4063,6916,3,1,3,0,1,0,58.7478311163
臺北縣,金山鄉,五湖村,0,2,886,12,898,1428,3,1,3,0,1,0,62.8851540616
臺北縣,金山鄉,重和村,0,2,570,6,576,995,3,1,3,0,1,0,57.8894472362
臺北縣,金山鄉,兩湖村,0,2,233,3,236,377,3,1,3,0,1,0,62.599469496
臺北縣,金山鄉,六股村,0,2,353,4,357,544,3,1,3,0,1,0,65.625
臺北縣,金山鄉,三界村,0,2,367,5,372,601,3,1,3,0,1,0,61.8968386023
臺北縣,金山鄉,清泉村,0,2,512,5,517,835,3,1,3,0,1,0,61.9161676647
臺北縣,金山鄉,西湖村,0,2,120,1,121,191,3,1,3,0,1,0,63.3507853403
臺北縣,金山鄉,萬壽村,0,2,294,1,295,467,3,1,3,0,1,0,63.1691648822
臺北縣,金山鄉,永興村,0,2,358,0,358,583,3,1,3,0,1,0,61.4065180103
臺北縣,萬里鄉,萬里村,0,2,1864,10,1874,3137,3,1,3,0,1,0,59.7386037616
臺北縣,萬里鄉,北基村,0,2,1033,15,1048,1949,3,1,3,0,1,0,53.7711646998
臺北縣,萬里鄉,龜吼村,0,2,898,18,916,1721,3,1,3,0,1,0,53.2248692621
臺北縣,萬里鄉,野柳村,0,2,1364,8,1372,2403,3,1,3,0,1,0,57.0952975447
臺北縣,萬里鄉,大鵬村,0,2,1347,14,1361,2195,3,1,3,0,1,0,62.0045558087
臺北縣,萬里鄉,磺潭村,0,2,307,4,311,469,3,1,3,0,1,0,66.3113006397
臺北縣,萬里鄉,雙興村,0,2,464,5,469,779,3,1,3,0,1,0,60.2053915276
臺北縣,萬里鄉,溪底村,0,2,301,1,302,528,3,1,3,0,1,0,57.196969697
臺北縣,萬里鄉,崁腳村,0,2,298,4,302,554,3,1,3,0,1,0,54.5126353791
臺北縣,萬里鄉,中幅村,0,2,463,4,467,807,3,1,3,0,1,0,57.8686493185
臺北縣,中和市,中原里,0,3,2064,21,2085,3867,3,1,3,0,1,0,53.92
臺北縣,中和市,連和里,0,3,671,3,674,1154,3,1,3,0,1,0,58.41
臺北縣,中和市,連城里,0,3,3008,15,3023,5022,3,1,3,0,1,0,60.20
臺北縣,中和市,力行里,0,3,2641,13,2654,4348,3,1,3,0,1,0,61.04
臺北縣,中和市,正行里,0,3,1276,9,1285,2211,3,1,3,0,1,0,58.12
臺北縣,中和市,德行里,0,3,2179,12,2191,3767,3,1,3,0,1,0,58.16
臺北縣,中和市,枋寮里,0,3,1787,12,1799,3027,3,1,3,0,1,0,59.43
臺北縣,中和市,漳和里,0,3,1718,4,1722,2799,3,1,3,0,1,0,61.52
臺北縣,中和市,廟美里,0,3,2188,25,2213,3843,3,1,3,0,1,0,57.59
臺北縣,中和市,福真里,0,3,1915,16,1931,3382,3,1,3,0,1,0,57.10
臺北縣,中和市,福善里,0,3,2096,20,2116,3555,3,1,3,0,1,0,59.52
臺北縣,中和市,福美里,0,3,2420,19,2439,3914,3,1,3,0,1,0,62.31
臺北縣,中和市,福祥里,0,3,2297,16,2313,3901,3,1,3,0,1,0,59.29
臺北縣,中和市,瓦窯里,0,3,2379,23,2402,4190,3,1,3,0,1,0,57.33
臺北縣,中和市,福和里,0,3,1912,12,1924,3242,3,1,3,0,1,0,59.35
臺北縣,中和市,佳和里,0,3,2419,22,2441,4091,3,1,3,0,1,0,59.67
臺北縣,中和市,新南里,0,3,3701,18,3719,6397,3,1,3,0,1,0,58.14
臺北縣,中和市,南山里,0,3,2387,16,2403,4105,3,1,3,0,1,0,58.54
臺北縣,中和市,平河里,0,3,3804,23,3827,6713,3,1,3,0,1,0,57.01
臺北縣,中和市,信和里,0,3,2201,17,2218,3602,3,1,3,0,1,0,61.58
臺北縣,中和市,仁和里,0,3,2029,20,2049,3538,3,1,3,0,1,0,57.91
臺北縣,中和市,中正里,0,3,2010,14,2024,3383,3,1,3,0,1,0,59.83
臺北縣,中和市,中山里,0,3,1315,13,1328,2161,3,1,3,0,1,0,61.45
臺北縣,中和市,建和里,0,3,2099,10,2109,3273,3,1,3,0,1,0,64.44
臺北縣,中和市,碧河里,0,3,1545,22,1567,2679,3,1,3,0,1,0,58.49
臺北縣,中和市,宜安里,0,3,1026,6,1032,1570,3,1,3,0,1,0,65.73
臺北縣,中和市,安樂里,0,3,1957,13,1970,3101,3,1,3,0,1,0,63.53
臺北縣,中和市,安和里,0,3,1548,9,1557,2510,3,1,3,0,1,0,62.03
臺北縣,中和市,安順里,0,3,2249,12,2261,3509,3,1,3,0,1,0,64.43
臺北縣,中和市,安平里,0,3,2581,19,2600,4022,3,1,3,0,1,0,64.64
臺北縣,中和市,中安里,0,3,2247,5,2252,3457,3,1,3,0,1,0,65.14
臺北縣,中和市,泰安里,0,3,2017,15,2032,3267,3,1,3,0,1,0,62.20
臺北縣,中和市,秀山里,0,3,2176,16,2192,3700,3,1,3,0,1,0,59.24
臺北縣,中和市,秀成里,0,3,1746,11,1757,2944,3,1,3,0,1,0,59.68
臺北縣,中和市,秀義里,0,3,1504,13,1517,2340,3,1,3,0,1,0,64.83
臺北縣,中和市,秀福里,0,3,2589,23,2612,4075,3,1,3,0,1,0,64.10
臺北縣,中和市,秀景里,0,3,3166,24,3190,5304,3,1,3,0,1,0,60.14
臺北縣,中和市,秀明里,0,3,2399,14,2413,4085,3,1,3,0,1,0,59.07
臺北縣,中和市,秀峰里,0,3,2068,15,2083,3403,3,1,3,0,1,0,61.21
臺北縣,中和市,秀士里,0,3,1311,13,1324,2175,3,1,3,0,1,0,60.87
臺北縣,中和市,秀水里,0,3,2084,15,2099,3430,3,1,3,0,1,0,61.20
臺北縣,中和市,秀仁里,0,3,1414,14,1428,2373,3,1,3,0,1,0,60.18
臺北縣,中和市,正南里,0,3,1870,19,1889,3196,3,1,3,0,1,0,59.11
臺北縣,中和市,頂南里,0,3,1623,9,1632,2617,3,1,3,0,1,0,62.36
臺北縣,中和市,華新里,0,3,2994,23,3017,5615,3,1,3,0,1,0,53.73
臺北縣,中和市,東南里,0,3,2541,12,2553,3887,3,1,3,0,1,0,65.68
臺北縣,中和市,華南里,0,3,2073,21,2094,3367,3,1,3,0,1,0,62.19
臺北縣,中和市,忠孝里,0,3,2599,27,2626,4403,3,1,3,0,1,0,59.64
臺北縣,中和市,崇南里,0,3,1895,8,1903,3084,3,1,3,0,1,0,61.71
臺北縣,中和市,興南里,0,3,1728,15,1743,2849,3,1,3,0,1,0,61.18
臺北縣,中和市,景南里,0,3,1679,7,1686,2738,3,1,3,0,1,0,61.58
臺北縣,中和市,景本里,0,3,1251,6,1257,1944,3,1,3,0,1,0,64.66
臺北縣,中和市,橫路里,0,3,214,3,217,329,3,1,3,0,1,0,65.96
臺北縣,中和市,內南里,0,3,2422,21,2443,4167,3,1,3,0,1,0,58.63
臺北縣,中和市,壽南里,0,3,1379,10,1389,2163,3,1,3,0,1,0,64.22
臺北縣,中和市,福南里,0,3,1939,18,1957,3187,3,1,3,0,1,0,61.41
臺北縣,中和市,外南里,0,3,1904,14,1918,4054,3,1,3,0,1,0,47.31
臺北縣,中和市,中興里,0,3,2213,14,2227,3897,3,1,3,0,1,0,57.15
臺北縣,中和市,吉興里,0,3,1228,13,1241,2020,3,1,3,0,1,0,61.44
臺北縣,中和市,復興里,0,3,2684,19,2703,4602,3,1,3,0,1,0,58.74
臺北縣,中和市,和興里,0,3,2253,20,2273,3730,3,1,3,0,1,0,60.94
臺北縣,中和市,景平里,0,3,2358,25,2383,3961,3,1,3,0,1,0,60.16
臺北縣,中和市,景新里,0,3,1942,15,1957,3165,3,1,3,0,1,0,61.83
臺北縣,中和市,景福里,0,3,2559,31,2590,4236,3,1,3,0,1,0,61.14
臺北縣,中和市,景安里,0,3,2596,13,2609,4188,3,1,3,0,1,0,62.30
臺北縣,中和市,景文里,0,3,1608,10,1618,2654,3,1,3,0,1,0,60.96
臺北縣,中和市,錦和里,0,3,1646,8,1654,2815,3,1,3,0,1,0,58.76
臺北縣,中和市,錦中里,0,3,2360,16,2376,4238,3,1,3,0,1,0,56.06
臺北縣,中和市,錦昌里,0,3,840,11,851,1423,3,1,3,0,1,0,59.80
臺北縣,中和市,錦盛里,0,3,1889,15,1904,3201,3,1,3,0,1,0,59.48
臺北縣,中和市,灰窯里,0,3,322,1,323,518,3,1,3,0,1,0,62.36
臺北縣,中和市,積穗里,0,3,2685,26,2711,4563,3,1,3,0,1,0,59.41
臺北縣,中和市,民享里,0,3,1504,9,1513,2240,3,1,3,0,1,0,67.54
臺北縣,中和市,民有里,0,3,1506,10,1516,2558,3,1,3,0,1,0,59.27
臺北縣,中和市,員山里,0,3,2039,18,2057,3602,3,1,3,0,1,0,57.11
臺北縣,中和市,員富里,0,3,1088,24,1112,2557,3,1,3,0,1,0,43.49
臺北縣,中和市,嘉穗里,0,3,1302,10,1312,2199,3,1,3,0,1,0,59.66
臺北縣,中和市,嘉慶里,0,3,1749,12,1761,3323,3,1,3,0,1,0,52.99
臺北縣,中和市,文元里,0,3,2626,12,2638,4633,3,1,3,0,1,0,56.94
臺北縣,中和市,嘉新里,0,3,1755,17,1772,3110,3,1,3,0,1,0,56.98
臺北縣,中和市,民安里,0,3,2245,23,2268,3897,3,1,3,0,1,0,58.20
臺北縣,中和市,安穗里,0,3,1846,19,1865,3024,3,1,3,0,1,0,61.67
臺北縣,中和市,瑞穗里,0,3,1126,5,1131,1827,3,1,3,0,1,0,61.90
臺北縣,中和市,冠穗里,0,3,1772,16,1788,2957,3,1,3,0,1,0,60.47
臺北縣,中和市,明穗里,0,3,2003,14,2017,3341,3,1,3,0,1,0,60.37
臺北縣,中和市,清穗里,0,3,1565,17,1582,2777,3,1,3,0,1,0,56.97
臺北縣,中和市,自強里,0,3,2146,24,2170,3997,3,1,3,0,1,0,54.29
臺北縣,中和市,德穗里,0,3,2086,12,2098,3694,3,1,3,0,1,0,56.79
臺北縣,中和市,民生里,0,3,2041,16,2057,3546,3,1,3,0,1,0,58.01
臺北縣,中和市,國光里,0,3,1801,17,1818,3158,3,1,3,0,1,0,57.57
臺北縣,中和市,國華里,0,3,1421,14,1435,2599,3,1,3,0,1,0,55.21
臺北縣,中和市,壽德里,0,3,2235,8,2243,3471,3,1,3,0,1,0,64.62
臺北縣,中和市,明德里,0,3,1907,24,1931,3349,3,1,3,0,1,0,57.66
臺北縣,永和市,光復里,0,3,910,3,913,1472,3,1,3,0,1,0,62.02
臺北縣,永和市,網溪里,0,3,636,9,645,1054,3,1,3,0,1,0,61.20
臺北縣,永和市,復興里,0,3,1293,10,1303,2150,3,1,3,0,1,0,60.60
臺北縣,永和市,竹林里,0,3,2026,17,2043,3365,3,1,3,0,1,0,60.71
臺北縣,永和市,桂林里,0,3,1876,14,1890,3181,3,1,3,0,1,0,59.42
臺北縣,永和市,上林里,0,3,1956,13,1969,3163,3,1,3,0,1,0,62.25
臺北縣,永和市,福林里,0,3,1854,11,1865,3063,3,1,3,0,1,0,60.89
臺北縣,永和市,勵行里,0,3,688,7,695,1079,3,1,3,0,1,0,64.41
臺北縣,永和市,中興里,0,3,1565,3,1568,2560,3,1,3,0,1,0,61.25
臺北縣,永和市,永興里,0,3,1729,8,1737,2936,3,1,3,0,1,0,59.16
臺北縣,永和市,正興里,0,3,1214,12,1226,2042,3,1,3,0,1,0,60.04
臺北縣,永和市,豫溪里,0,3,1834,12,1846,3904,3,1,3,0,1,0,47.28
臺北縣,永和市,光明里,0,3,1692,3,1695,2675,3,1,3,0,1,0,63.36
臺北縣,永和市,福和里,0,3,2338,12,2350,4059,3,1,3,0,1,0,57.90
臺北縣,永和市,得和里,0,3,2347,18,2365,3764,3,1,3,0,1,0,62.83
臺北縣,永和市,永貞里,0,3,1811,16,1827,3096,3,1,3,0,1,0,59.01
臺北縣,永和市,永福里,0,3,1579,12,1591,2568,3,1,3,0,1,0,61.95
臺北縣,永和市,河濱里,0,3,1564,6,1570,2548,3,1,3,0,1,0,61.62
臺北縣,永和市,秀和里,0,3,2385,15,2400,3967,3,1,3,0,1,0,60.50
臺北縣,永和市,永元里,0,3,2443,19,2462,4048,3,1,3,0,1,0,60.82
臺北縣,永和市,民權里,0,3,2268,17,2285,3863,3,1,3,0,1,0,59.15
臺北縣,永和市,民族里,0,3,2327,11,2338,3781,3,1,3,0,1,0,61.84
臺北縣,永和市,秀朗里,0,3,1922,20,1942,3333,3,1,3,0,1,0,58.27
臺北縣,永和市,秀成里,0,3,1516,10,1526,2513,3,1,3,0,1,0,60.72
臺北縣,永和市,秀林里,0,3,1847,12,1859,2953,3,1,3,0,1,0,62.95
臺北縣,永和市,秀得里,0,3,1355,6,1361,2293,3,1,3,0,1,0,59.35
臺北縣,永和市,秀元里,0,3,1658,3,1661,2726,3,1,3,0,1,0,60.93
臺北縣,永和市,民生里,0,3,2108,13,2121,3421,3,1,3,0,1,0,62.00
臺北縣,永和市,民本里,0,3,1422,7,1429,2526,3,1,3,0,1,0,56.57
臺北縣,永和市,民富里,0,3,1524,7,1531,2505,3,1,3,0,1,0,61.12
臺北縣,永和市,民樂里,0,3,2362,17,2379,3837,3,1,3,0,1,0,62.00
臺北縣,永和市,民治里,0,3,1513,13,1526,2623,3,1,3,0,1,0,58.18
臺北縣,永和市,智光里,0,3,1763,11,1774,2936,3,1,3,0,1,0,60.42
臺北縣,永和市,潭安里,0,3,2444,17,2461,4023,3,1,3,0,1,0,61.17
臺北縣,永和市,潭墘里,0,3,2114,11,2125,3545,3,1,3,0,1,0,59.94
臺北縣,永和市,店街里,0,3,1871,9,1880,3200,3,1,3,0,1,0,58.75
臺北縣,永和市,大新里,0,3,1337,6,1343,2165,3,1,3,0,1,0,62.03
臺北縣,永和市,永安里,0,3,2111,11,2122,3531,3,1,3,0,1,0,60.10
臺北縣,永和市,永樂里,0,3,1246,7,1253,2078,3,1,3,0,1,0,60.30
臺北縣,永和市,水源里,0,3,2129,18,2147,3464,3,1,3,0,1,0,61.98
臺北縣,永和市,協和里,0,3,1562,14,1576,2603,3,1,3,0,1,0,60.55
臺北縣,永和市,雙和里,0,3,2012,10,2022,3290,3,1,3,0,1,0,61.46
臺北縣,永和市,安和里,0,3,1932,16,1948,3123,3,1,3,0,1,0,62.38
臺北縣,永和市,前溪里,0,3,1066,7,1073,1750,3,1,3,0,1,0,61.31
臺北縣,永和市,和平里,0,3,2252,14,2266,3678,3,1,3,0,1,0,61.61
臺北縣,永和市,保平里,0,3,2356,20,2376,3906,3,1,3,0,1,0,60.83
臺北縣,永和市,中溪里,0,3,2571,25,2596,4195,3,1,3,0,1,0,61.88
臺北縣,永和市,保安里,0,3,3305,17,3322,5430,3,1,3,0,1,0,61.18
臺北縣,永和市,保順里,0,3,2947,12,2959,5348,3,1,3,0,1,0,55.33
臺北縣,永和市,下溪里,0,3,1989,14,2003,3287,3,1,3,0,1,0,60.94
臺北縣,永和市,大同里,0,3,603,7,610,891,3,1,3,0,1,0,68.46
臺北縣,永和市,新生里,0,3,467,6,473,766,3,1,3,0,1,0,61.75
臺北縣,永和市,永成里,0,3,582,8,590,923,3,1,3,0,1,0,63.92
臺北縣,永和市,忠義里,0,3,460,3,463,696,3,1,3,0,1,0,66.52
臺北縣,永和市,文化里,0,3,1474,14,1488,2377,3,1,3,0,1,0,62.60
臺北縣,永和市,仁愛里,0,3,1296,11,1307,2202,3,1,3,0,1,0,59.36
臺北縣,永和市,信義里,0,3,1333,11,1344,2136,3,1,3,0,1,0,62.92
臺北縣,永和市,後溪里,0,3,936,11,947,1606,3,1,3,0,1,0,58.97
臺北縣,永和市,上溪里,0,3,1011,7,1018,1750,3,1,3,0,1,0,58.17
臺北縣,永和市,頂溪里,0,3,1364,10,1374,2173,3,1,3,0,1,0,63.23
臺北縣,永和市,河堤里,0,3,1329,8,1337,2192,3,1,3,0,1,0,60.99
臺北縣,永和市,新部里,0,3,1330,11,1341,2127,3,1,3,0,1,0,63.05
臺北縣,新店市,新店里,0,3,852,7,859,1465,3,1,3,0,1,0,58.63
臺北縣,新店市,張南里,0,3,659,3,662,1126,3,1,3,0,1,0,58.79
臺北縣,新店市,國校里,0,3,1249,11,1260,2244,3,1,3,0,1,0,56.15
臺北縣,新店市,文中里,0,3,839,9,848,1392,3,1,3,0,1,0,60.92
臺北縣,新店市,廣明里,0,3,450,5,455,691,3,1,3,0,1,0,65.85
臺北縣,新店市,文明里,0,3,1397,4,1401,2091,3,1,3,0,1,0,67.00
臺北縣,新店市,中興里,0,3,2821,11,2832,5600,3,1,3,0,1,0,50.57
臺北縣,新店市,新生里,0,3,3118,11,3129,4895,3,1,3,0,1,0,63.92
臺北縣,新店市,新德里,0,3,1372,14,1386,2276,3,1,3,0,1,0,60.90
臺北縣,新店市,張北里,0,3,3192,19,3211,5483,3,1,3,0,1,0,58.56
臺北縣,新店市,五峰里,0,3,3449,25,3474,5794,3,1,3,0,1,0,59.96
臺北縣,新店市,長春里,0,3,1183,15,1198,1972,3,1,3,0,1,0,60.75
臺北縣,新店市,新安里,0,3,1779,14,1793,2989,3,1,3,0,1,0,59.99
臺北縣,新店市,忠誠里,0,3,1361,9,1370,2209,3,1,3,0,1,0,62.02
臺北縣,新店市,中正里,0,3,3267,15,3282,5549,3,1,3,0,1,0,59.15
臺北縣,新店市,中華里,0,3,1889,11,1900,3158,3,1,3,0,1,0,60.16
臺北縣,新店市,仁愛里,0,3,1244,8,1252,2058,3,1,3,0,1,0,60.84
臺北縣,新店市,建國里,0,3,1549,11,1560,2512,3,1,3,0,1,0,62.10
臺北縣,新店市,百忍里,0,3,2114,7,2121,3349,3,1,3,0,1,0,63.33
臺北縣,新店市,百和里,0,3,1720,7,1727,2829,3,1,3,0,1,0,61.05
臺北縣,新店市,福德里,0,3,1966,16,1982,3334,3,1,3,0,1,0,59.45
臺北縣,新店市,百福里,0,3,1548,7,1555,2496,3,1,3,0,1,0,62.30
臺北縣,新店市,福民里,0,3,2093,8,2101,3414,3,1,3,0,1,0,61.54
臺北縣,新店市,中山里,0,3,1896,6,1902,3336,3,1,3,0,1,0,57.01
臺北縣,新店市,和平里,0,3,523,2,525,802,3,1,3,0,1,0,65.46
臺北縣,新店市,中央里,0,3,2258,6,2264,3618,3,1,3,0,1,0,62.58
臺北縣,新店市,國豐里,0,3,1825,5,1830,2968,3,1,3,0,1,0,61.66
臺北縣,新店市,明德里,0,3,2178,15,2193,3570,3,1,3,0,1,0,61.43
臺北縣,新店市,大豐里,0,3,1900,7,1907,3183,3,1,3,0,1,0,59.91
臺北縣,新店市,大同里,0,3,2121,11,2132,3318,3,1,3,0,1,0,64.26
臺北縣,新店市,江陵里,0,3,2369,6,2375,3815,3,1,3,0,1,0,62.25
臺北縣,新店市,復興里,0,3,1669,9,1678,3037,3,1,3,0,1,0,55.25
臺北縣,新店市,寶興里,0,3,2242,14,2256,3794,3,1,3,0,1,0,59.46
臺北縣,新店市,寶福里,0,3,2638,15,2653,4480,3,1,3,0,1,0,59.22
臺北縣,新店市,寶安里,0,3,2788,13,2801,4555,3,1,3,0,1,0,61.49
臺北縣,新店市,信義里,0,3,3264,21,3285,5489,3,1,3,0,1,0,59.85
臺北縣,新店市,忠孝里,0,3,1593,11,1604,2629,3,1,3,0,1,0,61.01
臺北縣,新店市,大鵬里,0,3,1296,4,1300,1906,3,1,3,0,1,0,68.21
臺北縣,新店市,太平里,0,3,1452,19,1471,2525,3,1,3,0,1,0,58.26
臺北縣,新店市,美城里,0,3,1339,10,1349,2109,3,1,3,0,1,0,63.96
臺北縣,新店市,頂城里,0,3,727,4,731,1301,3,1,3,0,1,0,56.19
臺北縣,新店市,下城里,0,3,1074,10,1084,1803,3,1,3,0,1,0,60.12
臺北縣,新店市,柴埕里,0,3,3420,22,3442,6025,3,1,3,0,1,0,57.13
臺北縣,新店市,安和里,0,3,2541,20,2561,4393,3,1,3,0,1,0,58.30
臺北縣,新店市,永安里,0,3,2338,13,2351,4058,3,1,3,0,1,0,57.93
臺北縣,新店市,新和里,0,3,1858,16,1874,3118,3,1,3,0,1,0,60.10
臺北縣,新店市,永平里,0,3,2345,12,2357,3982,3,1,3,0,1,0,59.19
臺北縣,新店市,公崙里,0,3,3818,19,3837,6954,3,1,3,0,1,0,55.18
臺北縣,新店市,安昌里,0,3,1852,7,1859,3109,3,1,3,0,1,0,59.79
臺北縣,新店市,德安里,0,3,2701,23,2724,4742,3,1,3,0,1,0,57.44
臺北縣,新店市,達觀里,0,3,1452,4,1456,2682,3,1,3,0,1,0,54.29
臺北縣,新店市,明城里,0,3,1511,5,1516,2544,3,1,3,0,1,0,59.59
臺北縣,新店市,小城里,0,3,1793,9,1802,2767,3,1,3,0,1,0,65.12
臺北縣,新店市,雙城里,0,3,2622,19,2641,4635,3,1,3,0,1,0,56.98
臺北縣,新店市,香坡里,0,3,2406,7,2413,4594,3,1,3,0,1,0,52.53
臺北縣,新店市,日興里,0,3,2407,25,2432,4271,3,1,3,0,1,0,56.94
臺北縣,新店市,玫瑰里,0,3,2637,16,2653,4445,3,1,3,0,1,0,59.69
臺北縣,新店市,吉祥里,0,3,2109,7,2116,3475,3,1,3,0,1,0,60.89
臺北縣,新店市,塗潭里,0,3,457,3,460,730,3,1,3,0,1,0,63.01
臺北縣,新店市,華城里,0,3,896,4,900,1520,3,1,3,0,1,0,59.21
臺北縣,新店市,青潭里,0,3,2245,13,2258,3962,3,1,3,0,1,0,56.99
臺北縣,新店市,美潭里,0,3,2366,18,2384,4036,3,1,3,0,1,0,59.07
臺北縣,新店市,員潭里,0,3,1805,10,1815,3177,3,1,3,0,1,0,57.13
臺北縣,新店市,雙坑里,0,3,426,3,429,754,3,1,3,0,1,0,56.90
臺北縣,新店市,粗坑里,0,3,1280,9,1289,2115,3,1,3,0,1,0,60.95
臺北縣,新店市,屈尺里,0,3,1307,18,1325,2238,3,1,3,0,1,0,59.20
臺北縣,新店市,龜山里,0,3,768,7,775,1346,3,1,3,0,1,0,57.58
臺北縣,新店市,廣興里,0,3,644,6,650,1090,3,1,3,0,1,0,59.63
臺北縣,新店市,直潭里,0,3,465,2,467,760,3,1,3,0,1,0,61.45
臺北縣,深坑鄉,萬順村,0,3,1030,8,1038,1881,3,1,3,0,1,0,55.18
臺北縣,深坑鄉,萬福村,0,3,986,9,995,1855,3,1,3,0,1,0,53.64
臺北縣,深坑鄉,土庫村,0,3,1138,14,1152,2094,3,1,3,0,1,0,55.01
臺北縣,深坑鄉,賴仲村,0,3,787,3,790,1547,3,1,3,0,1,0,51.07
臺北縣,深坑鄉,深坑村,0,3,1368,9,1377,2467,3,1,3,0,1,0,55.82
臺北縣,深坑鄉,埔新村,0,3,1901,11,1912,3694,3,1,3,0,1,0,51.76
臺北縣,深坑鄉,昇高村,0,3,833,9,842,1563,3,1,3,0,1,0,53.87
臺北縣,深坑鄉,阿柔村,0,3,311,4,315,488,3,1,3,0,1,0,64.55
臺北縣,石碇鄉,石碇村,0,3,263,1,264,395,3,1,3,0,1,0,66.84
臺北縣,石碇鄉,潭邊村,0,3,394,4,398,670,3,1,3,0,1,0,59.40
臺北縣,石碇鄉,烏塗村,0,3,385,5,390,600,3,1,3,0,1,0,65.00
臺北縣,石碇鄉,彭山村,0,3,162,2,164,294,3,1,3,0,1,0,55.78
臺北縣,石碇鄉,豐田村,0,3,265,4,269,437,3,1,3,0,1,0,61.56
臺北縣,石碇鄉,隆盛村,0,3,381,3,384,697,3,1,3,0,1,0,55.09
臺北縣,石碇鄉,豐林村,0,3,118,1,119,231,3,1,3,0,1,0,51.52
臺北縣,石碇鄉,中民村,0,3,410,5,415,756,3,1,3,0,1,0,54.89
臺北縣,石碇鄉,永定村,0,3,266,1,267,567,3,1,3,0,1,0,47.09
臺北縣,石碇鄉,光明村,0,3,139,1,140,241,3,1,3,0,1,0,58.09
臺北縣,石碇鄉,永安村,0,3,274,0,274,432,3,1,3,0,1,0,63.43
臺北縣,石碇鄉,格頭村,0,3,418,3,421,680,3,1,3,0,1,0,61.91
臺北縣,坪林鄉,坪林村,0,3,637,3,640,1024,3,1,3,0,1,0,62.50
臺北縣,坪林鄉,水德村,0,3,346,6,352,564,3,1,3,0,1,0,62.41
臺北縣,坪林鄉,大林村,0,3,530,3,533,964,3,1,3,0,1,0,55.29
臺北縣,坪林鄉,石曹村,0,3,210,1,211,381,3,1,3,0,1,0,55.38
臺北縣,坪林鄉,粗窟村,0,3,408,5,413,711,3,1,3,0,1,0,58.09
臺北縣,坪林鄉,上德村,0,3,428,2,430,713,3,1,3,0,1,0,60.31
臺北縣,坪林鄉,漁光村,0,3,411,2,413,776,3,1,3,0,1,0,53.22
臺北縣,烏來鄉,忠治村,0,3,368,2,370,626,3,1,3,0,1,0,59.11
臺北縣,烏來鄉,烏來村,0,3,603,7,610,1075,3,1,3,0,1,0,56.74
臺北縣,烏來鄉,孝義村,0,3,95,0,95,147,3,1,3,0,1,0,64.63
臺北縣,烏來鄉,信賢村,0,3,135,0,135,215,3,1,3,0,1,0,62.79
臺北縣,烏來鄉,福山村,0,3,52,0,52,90,3,1,3,0,1,0,57.78
臺北縣,汐止市,仁德里,0,3,852,9,861,1527,3,1,3,0,1,0,56.39
臺北縣,汐止市,義民里,0,3,672,6,678,1207,3,1,3,0,1,0,56.17
臺北縣,汐止市,禮門里,0,3,513,1,514,928,3,1,3,0,1,0,55.39
臺北縣,汐止市,智慧里,0,3,1506,8,1514,2810,3,1,3,0,1,0,53.88
臺北縣,汐止市,大同里,0,3,1047,3,1050,1927,3,1,3,0,1,0,54.49
臺北縣,汐止市,信望里,0,3,212,2,214,370,3,1,3,0,1,0,57.84
臺北縣,汐止市,新昌里,0,3,2357,15,2372,4317,3,1,3,0,1,0,54.95
臺北縣,汐止市,福安里,0,3,1220,27,1247,2371,3,1,3,0,1,0,52.59
臺北縣,汐止市,秀峰里,0,3,1613,9,1622,3010,3,1,3,0,1,0,53.89
臺北縣,汐止市,秀山里,0,3,1574,11,1585,2844,3,1,3,0,1,0,55.73
臺北縣,汐止市,復興里,0,3,2689,18,2707,5243,3,1,3,0,1,0,51.63
臺北縣,汐止市,自強里,0,3,1743,16,1759,3395,3,1,3,0,1,0,51.81
臺北縣,汐止市,文化里,0,3,1446,17,1463,2670,3,1,3,0,1,0,54.79
臺北縣,汐止市,白雲里,0,3,1712,11,1723,3126,3,1,3,0,1,0,55.12
臺北縣,汐止市,茄苳里,0,3,1616,17,1633,3086,3,1,3,0,1,0,52.92
臺北縣,汐止市,崇德里,0,3,1684,12,1696,3266,3,1,3,0,1,0,51.93
臺北縣,汐止市,橋東里,0,3,4525,27,4552,8303,3,1,3,0,1,0,54.82
臺北縣,汐止市,長安里,0,3,757,6,763,1376,3,1,3,0,1,0,55.45
臺北縣,汐止市,保安里,0,3,664,3,667,1245,3,1,3,0,1,0,53.57
臺北縣,汐止市,東山里,0,3,280,0,280,490,3,1,3,0,1,0,57.14
臺北縣,汐止市,保長里,0,3,1885,25,1910,3732,3,1,3,0,1,0,51.18
臺北縣,汐止市,鄉長里,0,3,1014,16,1030,1663,3,1,3,0,1,0,61.94
臺北縣,汐止市,江北里,0,3,2092,142,2234,4159,3,1,3,0,1,0,53.71
臺北縣,汐止市,拱北里,0,3,1697,6,1703,3492,3,1,3,0,1,0,48.77
臺北縣,汐止市,烘內里,0,3,670,6,676,1164,3,1,3,0,1,0,58.08
臺北縣,汐止市,八連里,0,3,471,2,473,781,3,1,3,0,1,0,60.56
臺北縣,汐止市,長青里,0,3,516,8,524,866,3,1,3,0,1,0,60.51
臺北縣,汐止市,北峰里,0,3,1649,12,1661,3228,3,1,3,0,1,0,51.46
臺北縣,汐止市,金龍里,0,3,1813,12,1825,3753,3,1,3,0,1,0,48.63
臺北縣,汐止市,樟樹里,0,3,833,8,841,1628,3,1,3,0,1,0,51.66
臺北縣,汐止市,忠孝里,0,3,2556,31,2587,5064,3,1,3,0,1,0,51.09
臺北縣,汐止市,厚德里,0,3,1987,12,1999,4148,3,1,3,0,1,0,48.19
臺北縣,汐止市,山光里,0,3,713,5,718,1569,3,1,3,0,1,0,45.76
臺北縣,汐止市,中興里,0,3,2470,19,2489,5054,3,1,3,0,1,0,49.25
臺北縣,汐止市,福德里,0,3,1084,4,1088,2223,3,1,3,0,1,0,48.94
臺北縣,汐止市,興福里,0,3,1086,22,1108,2101,3,1,3,0,1,0,52.74
臺北縣,汐止市,康福里,0,3,1132,6,1138,2367,3,1,3,0,1,0,48.08
臺北縣,汐止市,湖光里,0,3,2320,15,2335,4595,3,1,3,0,1,0,50.82
臺北縣,汐止市,湖興里,0,3,2151,10,2161,4048,3,1,3,0,1,0,53.38
臺北縣,汐止市,北山里,0,3,2181,14,2195,4043,3,1,3,0,1,0,54.29
臺北縣,汐止市,忠山里,0,3,1513,6,1519,2578,3,1,3,0,1,0,58.92
臺北縣,汐止市,環河里,0,3,548,5,553,955,3,1,3,0,1,0,57.91
臺北縣,汐止市,橫科里,0,3,2226,20,2246,3893,3,1,3,0,1,0,57.69
臺北縣,汐止市,福山里,0,3,1515,6,1521,2840,3,1,3,0,1,0,53.56
臺北縣,汐止市,宜興里,0,3,1424,12,1436,2382,3,1,3,0,1,0,60.29
臺北縣,汐止市,東勢里,0,3,1519,12,1531,2642,3,1,3,0,1,0,57.95
臺北縣,瑞芳鎮,龍潭里,0,3,457,3,460,777,3,1,3,0,1,0,59.20
臺北縣,瑞芳鎮,龍興里,0,3,1022,6,1028,1672,3,1,3,0,1,0,61.48
臺北縣,瑞芳鎮,龍鎮里,0,3,764,2,766,1277,3,1,3,0,1,0,59.98
臺北縣,瑞芳鎮,龍安里,0,3,375,5,380,596,3,1,3,0,1,0,63.76
臺北縣,瑞芳鎮,龍川里,0,3,901,9,910,1562,3,1,3,0,1,0,58.26
臺北縣,瑞芳鎮,龍山里,0,3,685,7,692,1264,3,1,3,0,1,0,54.75
臺北縣,瑞芳鎮,爪峰里,0,3,1999,11,2010,3538,3,1,3,0,1,0,56.81
臺北縣,瑞芳鎮,新峰里,0,3,1156,6,1162,2361,3,1,3,0,1,0,49.22
臺北縣,瑞芳鎮,東和里,0,3,979,8,987,1762,3,1,3,0,1,0,56.02
臺北縣,瑞芳鎮,柑坪里,0,3,580,6,586,1064,3,1,3,0,1,0,55.08
臺北縣,瑞芳鎮,弓橋里,0,3,160,2,162,288,3,1,3,0,1,0,56.25
臺北縣,瑞芳鎮,侯硐里,0,3,296,4,300,484,3,1,3,0,1,0,61.98
臺北縣,瑞芳鎮,光復里,0,3,225,1,226,340,3,1,3,0,1,0,66.47
臺北縣,瑞芳鎮,碩仁里,0,3,83,0,83,109,3,1,3,0,1,0,76.15
臺北縣,瑞芳鎮,吉慶里,0,3,833,8,841,1613,3,1,3,0,1,0,52.14
臺北縣,瑞芳鎮,吉安里,0,3,1528,12,1540,2782,3,1,3,0,1,0,55.36
臺北縣,瑞芳鎮,上天里,0,3,695,1,696,1273,3,1,3,0,1,0,54.67
臺北縣,瑞芳鎮,傑魚里,0,3,908,7,915,1830,3,1,3,0,1,0,50.00
臺北縣,瑞芳鎮,基山里,0,3,282,1,283,540,3,1,3,0,1,0,52.41
臺北縣,瑞芳鎮,永慶里,0,3,304,2,306,559,3,1,3,0,1,0,54.74
臺北縣,瑞芳鎮,崇文里,0,3,197,0,197,403,3,1,3,0,1,0,48.88
臺北縣,瑞芳鎮,福住里,0,3,137,0,137,240,3,1,3,0,1,0,57.08
臺北縣,瑞芳鎮,頌德里,0,3,204,3,207,376,3,1,3,0,1,0,55.05
臺北縣,瑞芳鎮,瓜山里,0,3,146,0,146,255,3,1,3,0,1,0,57.25
臺北縣,瑞芳鎮,銅山里,0,3,161,2,163,267,3,1,3,0,1,0,61.05
臺北縣,瑞芳鎮,新山里,0,3,245,5,250,430,3,1,3,0,1,0,58.14
臺北縣,瑞芳鎮,石山里,0,3,232,3,235,417,3,1,3,0,1,0,56.35
臺北縣,瑞芳鎮,濂洞里,0,3,382,4,386,579,3,1,3,0,1,0,66.67
臺北縣,瑞芳鎮,濂新里,0,3,193,0,193,318,3,1,3,0,1,0,60.69
臺北縣,瑞芳鎮,南雅里,0,3,175,1,176,254,3,1,3,0,1,0,69.29
臺北縣,瑞芳鎮,鼻頭里,0,3,394,7,401,753,3,1,3,0,1,0,53.25
臺北縣,瑞芳鎮,海濱里,0,3,589,5,594,960,3,1,3,0,1,0,61.88
臺北縣,瑞芳鎮,瑞濱里,0,3,995,10,1005,1694,3,1,3,0,1,0,59.33
臺北縣,瑞芳鎮,深澳里,0,3,682,4,686,1109,3,1,3,0,1,0,61.86
臺北縣,平溪鄉,薯榔村,0,3,262,3,265,436,3,1,3,0,1,0,60.78
臺北縣,平溪鄉,菁桐村,0,3,179,3,182,305,3,1,3,0,1,0,59.67
臺北縣,平溪鄉,白石村,0,3,181,1,182,272,3,1,3,0,1,0,66.91
臺北縣,平溪鄉,石底村,0,3,355,8,363,555,3,1,3,0,1,0,65.41
臺北縣,平溪鄉,平溪村,0,3,177,3,180,271,3,1,3,0,1,0,66.42
臺北縣,平溪鄉,嶺腳村,0,3,423,1,424,677,3,1,3,0,1,0,62.63
臺北縣,平溪鄉,東勢村,0,3,280,2,282,421,3,1,3,0,1,0,66.98
臺北縣,平溪鄉,十分村,0,3,601,5,606,988,3,1,3,0,1,0,61.34
臺北縣,平溪鄉,望古村,0,3,73,0,73,147,3,1,3,0,1,0,49.66
臺北縣,平溪鄉,南山村,0,3,254,0,254,479,3,1,3,0,1,0,53.03
臺北縣,平溪鄉,新寮村,0,3,105,0,105,183,3,1,3,0,1,0,57.38
臺北縣,平溪鄉,平湖村,0,3,89,0,89,160,3,1,3,0,1,0,55.63
臺北縣,雙溪鄉,雙溪村,0,3,313,4,317,544,3,1,3,0,1,0,58.27
臺北縣,雙溪鄉,新基村,0,3,536,7,543,896,3,1,3,0,1,0,60.60
臺北縣,雙溪鄉,三港村,0,3,252,2,254,466,3,1,3,0,1,0,54.51
臺北縣,雙溪鄉,牡丹村,0,3,995,9,1004,1807,3,1,3,0,1,0,55.56
臺北縣,雙溪鄉,三貂村,0,3,201,1,202,343,3,1,3,0,1,0,58.89
臺北縣,雙溪鄉,平林村,0,3,569,4,573,947,3,1,3,0,1,0,60.51
臺北縣,雙溪鄉,上林村,0,3,385,4,389,710,3,1,3,0,1,0,54.79
臺北縣,雙溪鄉,外柑村,0,3,279,1,280,486,3,1,3,0,1,0,57.61
臺北縣,雙溪鄉,長源村,0,3,257,5,262,406,3,1,3,0,1,0,64.53
臺北縣,雙溪鄉,共和村,0,3,272,3,275,470,3,1,3,0,1,0,58.51
臺北縣,雙溪鄉,魚行村,0,3,371,3,374,641,3,1,3,0,1,0,58.35
臺北縣,雙溪鄉,泰平村,0,3,279,0,279,538,3,1,3,0,1,0,51.86
臺北縣,貢寮鄉,貢寮村,0,3,555,8,563,919,3,1,3,0,1,0,61.26
臺北縣,貢寮鄉,龍崗村,0,3,256,4,260,439,3,1,3,0,1,0,59.23
臺北縣,貢寮鄉,吉林村,0,3,272,3,275,494,3,1,3,0,1,0,55.67
臺北縣,貢寮鄉,雙玉村,0,3,404,0,404,755,3,1,3,0,1,0,53.51
臺北縣,貢寮鄉,福隆村,0,3,902,5,907,1636,3,1,3,0,1,0,55.44
臺北縣,貢寮鄉,福連村,0,3,435,5,440,884,3,1,3,0,1,0,49.77
臺北縣,貢寮鄉,龍門村,0,3,397,3,400,679,3,1,3,0,1,0,58.91
臺北縣,貢寮鄉,仁里村,0,3,960,13,973,1613,3,1,3,0,1,0,60.32
臺北縣,貢寮鄉,真理村,0,3,1043,4,1047,1977,3,1,3,0,1,0,52.96
臺北縣,貢寮鄉,美豐村,0,3,455,6,461,810,3,1,3,0,1,0,56.91
臺北縣,貢寮鄉,和美村,0,3,566,4,570,930,3,1,3,0,1,0,61.29
宜蘭縣,宜蘭市,南門里,0,1,370,4,374,629,3,1,3,0,1,0,59.46
宜蘭縣,宜蘭市,負郭里,0,1,870,6,876,1628,3,1,3,0,1,0,53.81
宜蘭縣,宜蘭市,民族里,0,1,714,3,717,1128,3,1,3,0,1,0,63.56
宜蘭縣,宜蘭市,建軍里,0,1,679,4,683,1167,3,1,3,0,1,0,58.53
宜蘭縣,宜蘭市,復興里,0,1,1844,17,1861,3346,3,1,3,0,1,0,55.62
宜蘭縣,宜蘭市,思源里,0,1,2328,13,2341,4120,3,1,3,0,1,0,56.82
宜蘭縣,宜蘭市,文化里,0,1,1044,8,1052,1855,3,1,3,0,1,0,56.71
宜蘭縣,宜蘭市,神農里,0,1,594,7,601,1073,3,1,3,0,1,0,56.01
宜蘭縣,宜蘭市,民生里,0,1,778,8,786,1291,3,1,3,0,1,0,60.88
宜蘭縣,宜蘭市,昇平里,0,1,567,2,569,951,3,1,3,0,1,0,59.83
宜蘭縣,宜蘭市,大東里,0,1,664,0,664,1254,3,1,3,0,1,0,52.95
宜蘭縣,宜蘭市,新興里,0,1,815,4,819,1508,3,1,3,0,1,0,54.31
宜蘭縣,宜蘭市,和睦里,0,1,1526,8,1534,2729,3,1,3,0,1,0,56.21
宜蘭縣,宜蘭市,民權里,0,1,1291,22,1313,2361,3,1,3,0,1,0,55.61
宜蘭縣,宜蘭市,進士里,0,1,2529,20,2549,4695,3,1,3,0,1,0,54.29
宜蘭縣,宜蘭市,南橋里,0,1,309,0,309,534,3,1,3,0,1,0,57.87
宜蘭縣,宜蘭市,建業里,0,1,360,2,362,596,3,1,3,0,1,0,60.74
宜蘭縣,宜蘭市,南津里,0,1,761,3,764,1276,3,1,3,0,1,0,59.87
宜蘭縣,宜蘭市,凱旋里,0,1,790,5,795,1340,3,1,3,0,1,0,59.33
宜蘭縣,宜蘭市,黎明里,0,1,583,2,585,995,3,1,3,0,1,0,58.79
宜蘭縣,宜蘭市,東村里,0,1,1661,8,1669,3040,3,1,3,0,1,0,54.90
宜蘭縣,宜蘭市,延平里,0,1,2171,17,2188,3919,3,1,3,0,1,0,55.83
宜蘭縣,宜蘭市,七張里,0,1,687,1,688,1143,3,1,3,0,1,0,60.19
宜蘭縣,宜蘭市,慈安里,0,1,1362,8,1370,2379,3,1,3,0,1,0,57.59
宜蘭縣,宜蘭市,新民里,0,1,412,3,415,768,3,1,3,0,1,0,54.04
宜蘭縣,宜蘭市,東門里,0,1,717,6,723,1207,3,1,3,0,1,0,59.90
宜蘭縣,宜蘭市,中正里,0,1,757,5,762,1373,3,1,3,0,1,0,55.50
宜蘭縣,宜蘭市,小東里,0,1,336,1,337,590,3,1,3,0,1,0,57.12
宜蘭縣,宜蘭市,菜園里,0,1,460,6,466,781,3,1,3,0,1,0,59.67
宜蘭縣,宜蘭市,孝廉里,0,1,812,8,820,1453,3,1,3,0,1,0,56.43
宜蘭縣,宜蘭市,新生里,0,1,1337,5,1342,2278,3,1,3,0,1,0,58.91
宜蘭縣,宜蘭市,茭白里,0,1,1363,9,1372,2553,3,1,3,0,1,0,53.74
宜蘭縣,宜蘭市,北津里,0,1,700,5,705,1216,3,1,3,0,1,0,57.98
宜蘭縣,宜蘭市,梅洲里,0,1,1461,12,1473,2564,3,1,3,0,1,0,57.45
宜蘭縣,宜蘭市,北門里,0,1,475,3,478,925,3,1,3,0,1,0,51.68
宜蘭縣,宜蘭市,慶和里,0,1,808,5,813,1438,3,1,3,0,1,0,56.54
宜蘭縣,宜蘭市,鄂王里,0,1,801,3,804,1444,3,1,3,0,1,0,55.68
宜蘭縣,宜蘭市,西門里,0,1,617,1,618,1019,3,1,3,0,1,0,60.65
宜蘭縣,宜蘭市,中山里,0,1,467,4,471,795,3,1,3,0,1,0,59.25
宜蘭縣,宜蘭市,大道里,0,1,589,5,594,1026,3,1,3,0,1,0,57.89
宜蘭縣,羅東鎮,開羅里,0,1,280,2,282,491,3,1,3,0,1,0,57.43
宜蘭縣,羅東鎮,開元里,0,1,329,3,332,535,3,1,3,0,1,0,62.06
宜蘭縣,羅東鎮,東明里,0,1,257,2,259,494,3,1,3,0,1,0,52.43
宜蘭縣,羅東鎮,大新里,0,1,704,7,711,1273,3,1,3,0,1,0,55.85
宜蘭縣,羅東鎮,東安里,0,1,1309,12,1321,2469,3,1,3,0,1,0,53.50
宜蘭縣,羅東鎮,新群里,0,1,1113,8,1121,2080,3,1,3,0,1,0,53.89
宜蘭縣,羅東鎮,羅莊里,0,1,1042,7,1049,2077,3,1,3,0,1,0,50.51
宜蘭縣,羅東鎮,南昌里,0,1,1281,6,1287,2248,3,1,3,0,1,0,57.25
宜蘭縣,羅東鎮,南豪里,0,1,754,18,772,1335,3,1,3,0,1,0,57.83
宜蘭縣,羅東鎮,成功里,0,1,820,2,822,1320,3,1,3,0,1,0,62.27
宜蘭縣,羅東鎮,仁德里,0,1,476,5,481,829,3,1,3,0,1,0,58.02
宜蘭縣,羅東鎮,居仁里,0,1,375,4,379,710,3,1,3,0,1,0,53.38
宜蘭縣,羅東鎮,義和里,0,1,471,1,472,829,3,1,3,0,1,0,56.94
宜蘭縣,羅東鎮,羅東里,0,1,379,0,379,604,3,1,3,0,1,0,62.75
宜蘭縣,羅東鎮,浮崙里,0,1,412,1,413,702,3,1,3,0,1,0,58.83
宜蘭縣,羅東鎮,漢民里,0,1,1957,19,1976,3526,3,1,3,0,1,0,56.04
宜蘭縣,羅東鎮,西安里,0,1,2642,15,2657,4896,3,1,3,0,1,0,54.27
宜蘭縣,羅東鎮,北成里,0,1,2981,18,2999,5562,3,1,3,0,1,0,53.92
宜蘭縣,羅東鎮,賢文里,0,1,1874,15,1889,3428,3,1,3,0,1,0,55.11
宜蘭縣,羅東鎮,公正里,0,1,1053,5,1058,1878,3,1,3,0,1,0,56.34
宜蘭縣,羅東鎮,集祥里,0,1,517,5,522,1074,3,1,3,0,1,0,48.60
宜蘭縣,羅東鎮,信義里,0,1,1561,7,1568,2992,3,1,3,0,1,0,52.41
宜蘭縣,羅東鎮,樹林里,0,1,2212,17,2229,4083,3,1,3,0,1,0,54.59
宜蘭縣,羅東鎮,竹林里,0,1,1318,11,1329,2380,3,1,3,0,1,0,55.84
宜蘭縣,羅東鎮,仁愛里,0,1,1251,9,1260,2337,3,1,3,0,1,0,53.92
宜蘭縣,蘇澳鎮,龍德里,0,1,1671,12,1683,3006,3,1,3,0,1,0,55.99
宜蘭縣,蘇澳鎮,頂寮里,0,1,462,6,468,778,3,1,3,0,1,0,60.15
宜蘭縣,蘇澳鎮,永榮里,0,1,1573,6,1579,2948,3,1,3,0,1,0,53.56
宜蘭縣,蘇澳鎮,存仁里,0,1,600,2,602,948,3,1,3,0,1,0,63.50
宜蘭縣,蘇澳鎮,港邊里,0,1,631,7,638,1189,3,1,3,0,1,0,53.66
宜蘭縣,蘇澳鎮,岳明里,0,1,115,3,118,237,3,1,3,0,1,0,49.79
宜蘭縣,蘇澳鎮,隘丁里,0,1,1079,10,1089,2121,3,1,3,0,1,0,51.34
宜蘭縣,蘇澳鎮,新城里,0,1,623,7,630,1084,3,1,3,0,1,0,58.12
宜蘭縣,蘇澳鎮,聖湖里,0,1,2508,14,2522,4961,3,1,3,0,1,0,50.84
宜蘭縣,蘇澳鎮,蘇西里,0,1,1311,12,1323,2330,3,1,3,0,1,0,56.78
宜蘭縣,蘇澳鎮,蘇北里,0,1,711,4,715,1193,3,1,3,0,1,0,59.93
宜蘭縣,蘇澳鎮,蘇南里,0,1,334,2,336,566,3,1,3,0,1,0,59.36
宜蘭縣,蘇澳鎮,蘇東里,0,1,266,1,267,524,3,1,3,0,1,0,50.95
宜蘭縣,蘇澳鎮,長安里,0,1,334,0,334,609,3,1,3,0,1,0,54.84
宜蘭縣,蘇澳鎮,永光里,0,1,286,1,287,464,3,1,3,0,1,0,61.85
宜蘭縣,蘇澳鎮,永春里,0,1,347,6,353,633,3,1,3,0,1,0,55.77
宜蘭縣,蘇澳鎮,永樂里,0,1,322,0,322,502,3,1,3,0,1,0,64.14
宜蘭縣,蘇澳鎮,南安里,0,1,635,3,638,1055,3,1,3,0,1,0,60.47
宜蘭縣,蘇澳鎮,南正里,0,1,572,3,575,1045,3,1,3,0,1,0,55.02
宜蘭縣,蘇澳鎮,南成里,0,1,673,4,677,1189,3,1,3,0,1,0,56.94
宜蘭縣,蘇澳鎮,南興里,0,1,801,5,806,1611,3,1,3,0,1,0,50.03
宜蘭縣,蘇澳鎮,南寧里,0,1,635,4,639,1148,3,1,3,0,1,0,55.66
宜蘭縣,蘇澳鎮,南建里,0,1,698,3,701,1313,3,1,3,0,1,0,53.39
宜蘭縣,蘇澳鎮,東澳里,0,1,161,5,166,301,3,1,3,0,1,0,55.15
宜蘭縣,蘇澳鎮,南強里,0,1,408,4,412,785,3,1,3,0,1,0,52.48
宜蘭縣,蘇澳鎮,朝陽里,0,1,375,9,384,721,3,1,3,0,1,0,53.26
宜蘭縣,頭城鎮,石城里,0,1,190,0,190,366,3,1,3,0,1,0,51.91
宜蘭縣,頭城鎮,大里里,0,1,394,2,396,735,3,1,3,0,1,0,53.88
宜蘭縣,頭城鎮,龜山里,0,1,495,3,498,910,3,1,3,0,1,0,54.73
宜蘭縣,頭城鎮,大溪里,0,1,223,0,223,391,3,1,3,0,1,0,57.03
宜蘭縣,頭城鎮,合興里,0,1,939,5,944,1400,3,1,3,0,1,0,67.43
宜蘭縣,頭城鎮,更新里,0,1,506,4,510,932,3,1,3,0,1,0,54.72
宜蘭縣,頭城鎮,外澳里,0,1,360,4,364,625,3,1,3,0,1,0,58.24
宜蘭縣,頭城鎮,港口里,0,1,771,7,778,1431,3,1,3,0,1,0,54.37
宜蘭縣,頭城鎮,武營里,0,1,711,6,717,1223,3,1,3,0,1,0,58.63
宜蘭縣,頭城鎮,大坑里,0,1,505,3,508,751,3,1,3,0,1,0,67.64
宜蘭縣,頭城鎮,城東里,0,1,343,0,343,543,3,1,3,0,1,0,63.17
宜蘭縣,頭城鎮,城北里,0,1,401,3,404,622,3,1,3,0,1,0,64.95
宜蘭縣,頭城鎮,城西里,0,1,376,6,382,622,3,1,3,0,1,0,61.41
宜蘭縣,頭城鎮,城南里,0,1,538,3,541,993,3,1,3,0,1,0,54.48
宜蘭縣,頭城鎮,竹安里,0,1,1087,5,1092,1803,3,1,3,0,1,0,60.57
宜蘭縣,頭城鎮,新建里,0,1,1312,8,1320,2410,3,1,3,0,1,0,54.77
宜蘭縣,頭城鎮,拔雅里,0,1,512,7,519,999,3,1,3,0,1,0,51.95
宜蘭縣,頭城鎮,福成里,0,1,873,5,878,1666,3,1,3,0,1,0,52.70
宜蘭縣,頭城鎮,金面里,0,1,384,2,386,693,3,1,3,0,1,0,55.70
宜蘭縣,頭城鎮,金盈里,0,1,754,8,762,1277,3,1,3,0,1,0,59.67
宜蘭縣,頭城鎮,頂埔里,0,1,585,5,590,942,3,1,3,0,1,0,62.63
宜蘭縣,頭城鎮,下埔里,0,1,596,5,601,974,3,1,3,0,1,0,61.70
宜蘭縣,頭城鎮,中崙里,0,1,626,7,633,1085,3,1,3,0,1,0,58.34
宜蘭縣,頭城鎮,二城里,0,1,364,2,366,637,3,1,3,0,1,0,57.46
宜蘭縣,礁溪鄉,白雲村,0,1,810,9,819,1402,3,1,3,0,1,0,58.42
宜蘭縣,礁溪鄉,玉石村,0,1,979,7,986,1643,3,1,3,0,1,0,60.01
宜蘭縣,礁溪鄉,德陽村,0,1,1871,17,1888,3451,3,1,3,0,1,0,54.71
宜蘭縣,礁溪鄉,大忠村,0,1,1235,7,1242,2163,3,1,3,0,1,0,57.42
宜蘭縣,礁溪鄉,大義村,0,1,416,3,419,681,3,1,3,0,1,0,61.53
宜蘭縣,礁溪鄉,六結村,0,1,851,1,852,1407,3,1,3,0,1,0,60.55
宜蘭縣,礁溪鄉,二龍村,0,1,670,7,677,1095,3,1,3,0,1,0,61.83
宜蘭縣,礁溪鄉,時潮村,0,1,840,10,850,1377,3,1,3,0,1,0,61.73
宜蘭縣,礁溪鄉,玉田村,0,1,1065,10,1075,1872,3,1,3,0,1,0,57.43
宜蘭縣,礁溪鄉,三民村,0,1,1315,11,1326,2289,3,1,3,0,1,0,57.93
宜蘭縣,礁溪鄉,林美村,0,1,640,7,647,1071,3,1,3,0,1,0,60.41
宜蘭縣,礁溪鄉,白鵝村,0,1,437,2,439,726,3,1,3,0,1,0,60.47
宜蘭縣,礁溪鄉,玉光村,0,1,537,3,540,908,3,1,3,0,1,0,59.47
宜蘭縣,礁溪鄉,光武村,0,1,655,4,659,1113,3,1,3,0,1,0,59.21
宜蘭縣,礁溪鄉,吳沙村,0,1,1339,5,1344,2213,3,1,3,0,1,0,60.73
宜蘭縣,礁溪鄉,龍潭村,0,1,1544,19,1563,2763,3,1,3,0,1,0,56.57
宜蘭縣,礁溪鄉,匏崙村,0,1,510,1,511,931,3,1,3,0,1,0,54.89
宜蘭縣,礁溪鄉,二結村,0,1,252,3,255,408,3,1,3,0,1,0,62.50
宜蘭縣,壯圍鄉,吉祥村,0,1,1075,13,1088,1849,3,1,3,0,1,0,58.84
宜蘭縣,壯圍鄉,古結村,0,1,450,1,451,815,3,1,3,0,1,0,55.34
宜蘭縣,壯圍鄉,美福村,0,1,1003,7,1010,1666,3,1,3,0,1,0,60.62
宜蘭縣,壯圍鄉,新南村,0,1,508,5,513,975,3,1,3,0,1,0,52.62
宜蘭縣,壯圍鄉,東港村,0,1,448,3,451,798,3,1,3,0,1,0,56.52
宜蘭縣,壯圍鄉,復興村,0,1,915,4,919,1711,3,1,3,0,1,0,53.71
宜蘭縣,壯圍鄉,過嶺村,0,1,835,3,838,1542,3,1,3,0,1,0,54.35
宜蘭縣,壯圍鄉,永鎮村,0,1,489,1,490,820,3,1,3,0,1,0,59.76
宜蘭縣,壯圍鄉,忠孝村,0,1,1444,6,1450,2544,3,1,3,0,1,0,57.00
宜蘭縣,壯圍鄉,古亭村,0,1,567,2,569,973,3,1,3,0,1,0,58.48
宜蘭縣,壯圍鄉,功勞村,0,1,542,4,546,937,3,1,3,0,1,0,58.27
宜蘭縣,壯圍鄉,美城村,0,1,1259,6,1265,2054,3,1,3,0,1,0,61.59
宜蘭縣,壯圍鄉,新社村,0,1,488,2,490,882,3,1,3,0,1,0,55.56
宜蘭縣,壯圍鄉,大福村,0,1,998,5,1003,1692,3,1,3,0,1,0,59.28
宜蘭縣,員山鄉,員山村,0,1,2255,11,2266,4255,3,1,3,0,1,0,53.25
宜蘭縣,員山鄉,尚德村,0,1,941,8,949,1829,3,1,3,0,1,0,51.89
宜蘭縣,員山鄉,惠好村,0,1,729,4,733,1222,3,1,3,0,1,0,59.98
宜蘭縣,員山鄉,七賢村,0,1,543,1,544,969,3,1,3,0,1,0,56.14
宜蘭縣,員山鄉,深溝村,0,1,783,9,792,1449,3,1,3,0,1,0,54.66
宜蘭縣,員山鄉,蓁巷村,0,1,621,8,629,1198,3,1,3,0,1,0,52.50
宜蘭縣,員山鄉,內城村,0,1,794,7,801,1400,3,1,3,0,1,0,57.21
宜蘭縣,員山鄉,中華村,0,1,376,2,378,711,3,1,3,0,1,0,53.16
宜蘭縣,員山鄉,永和村,0,1,885,2,887,1601,3,1,3,0,1,0,55.40
宜蘭縣,員山鄉,頭分村,0,1,624,5,629,1093,3,1,3,0,1,0,57.55
宜蘭縣,員山鄉,枕山村,0,1,1202,4,1206,2098,3,1,3,0,1,0,57.48
宜蘭縣,員山鄉,同樂村,0,1,1366,13,1379,2466,3,1,3,0,1,0,55.92
宜蘭縣,員山鄉,湖東村,0,1,475,2,477,840,3,1,3,0,1,0,56.79
宜蘭縣,員山鄉,逸仙村,0,1,460,1,461,815,3,1,3,0,1,0,56.56
宜蘭縣,員山鄉,湖北村,0,1,553,14,567,972,3,1,3,0,1,0,58.33
宜蘭縣,員山鄉,湖西村,0,1,828,8,836,1460,3,1,3,0,1,0,57.26
宜蘭縣,冬山鄉,珍珠村,0,1,636,6,642,1050,3,1,3,0,1,0,61.14
宜蘭縣,冬山鄉,補城村,0,1,787,7,794,1344,3,1,3,0,1,0,59.08
宜蘭縣,冬山鄉,三奇村,0,1,574,3,577,1000,3,1,3,0,1,0,57.70
宜蘭縣,冬山鄉,大興村,0,1,481,3,484,812,3,1,3,0,1,0,59.61
宜蘭縣,冬山鄉,東城村,0,1,562,3,565,924,3,1,3,0,1,0,61.15
宜蘭縣,冬山鄉,香和村,0,1,1243,7,1250,2165,3,1,3,0,1,0,57.74
宜蘭縣,冬山鄉,南興村,0,1,1112,10,1122,1897,3,1,3,0,1,0,59.15
宜蘭縣,冬山鄉,安平村,0,1,607,7,614,1109,3,1,3,0,1,0,55.37
宜蘭縣,冬山鄉,冬山村,0,1,496,3,499,821,3,1,3,0,1,0,60.78
宜蘭縣,冬山鄉,太和村,0,1,387,3,390,694,3,1,3,0,1,0,56.20
宜蘭縣,冬山鄉,八寶村,0,1,840,9,849,1331,3,1,3,0,1,0,63.79
宜蘭縣,冬山鄉,丸山村,0,1,475,3,478,799,3,1,3,0,1,0,59.82
宜蘭縣,冬山鄉,中山村,0,1,707,6,713,1232,3,1,3,0,1,0,57.87
宜蘭縣,冬山鄉,順安村,0,1,1686,9,1695,3287,3,1,3,0,1,0,51.57
宜蘭縣,冬山鄉,永美村,0,1,1299,4,1303,2385,3,1,3,0,1,0,54.63
宜蘭縣,冬山鄉,武淵村,0,1,646,7,653,1197,3,1,3,0,1,0,54.55
宜蘭縣,冬山鄉,群英村,0,1,2540,18,2558,4487,3,1,3,0,1,0,57.01
宜蘭縣,冬山鄉,清溝村,0,1,1481,11,1492,2697,3,1,3,0,1,0,55.32
宜蘭縣,冬山鄉,鹿埔村,0,1,1196,6,1202,2194,3,1,3,0,1,0,54.79
宜蘭縣,冬山鄉,得安村,0,1,533,6,539,1062,3,1,3,0,1,0,50.75
宜蘭縣,冬山鄉,廣興村,0,1,1186,7,1193,2244,3,1,3,0,1,0,53.16
宜蘭縣,冬山鄉,廣安村,0,1,697,4,701,1347,3,1,3,0,1,0,52.04
宜蘭縣,冬山鄉,柯林村,0,1,615,7,622,1121,3,1,3,0,1,0,55.49
宜蘭縣,冬山鄉,大進村,0,1,479,4,483,838,3,1,3,0,1,0,57.64
宜蘭縣,五結鄉,三興村,0,1,935,6,941,1563,3,1,3,0,1,0,60.20
宜蘭縣,五結鄉,二結村,0,1,893,9,902,1465,3,1,3,0,1,0,61.57
宜蘭縣,五結鄉,鎮安村,0,1,1179,17,1196,2087,3,1,3,0,1,0,57.31
宜蘭縣,五結鄉,上四村,0,1,829,0,829,1470,3,1,3,0,1,0,56.39
宜蘭縣,五結鄉,中興村,0,1,521,7,528,1027,3,1,3,0,1,0,51.41
宜蘭縣,五結鄉,四結村,0,1,1164,8,1172,2095,3,1,3,0,1,0,55.94
宜蘭縣,五結鄉,福興村,0,1,859,6,865,1480,3,1,3,0,1,0,58.45
宜蘭縣,五結鄉,五結村,0,1,1584,8,1592,2762,3,1,3,0,1,0,57.64
宜蘭縣,五結鄉,大吉村,0,1,1589,17,1606,2758,3,1,3,0,1,0,58.23
宜蘭縣,五結鄉,協和村,0,1,1298,9,1307,2397,3,1,3,0,1,0,54.53
宜蘭縣,五結鄉,孝威村,0,1,733,2,735,1352,3,1,3,0,1,0,54.36
宜蘭縣,五結鄉,錦眾村,0,1,787,9,796,1449,3,1,3,0,1,0,54.93
宜蘭縣,五結鄉,利澤村,0,1,1094,11,1105,1937,3,1,3,0,1,0,57.05
宜蘭縣,五結鄉,成興村,0,1,1295,13,1308,2332,3,1,3,0,1,0,56.09
宜蘭縣,五結鄉,季新村,0,1,1327,8,1335,2462,3,1,3,0,1,0,54.22
宜蘭縣,三星鄉,員山村,0,1,140,1,141,236,3,1,3,0,1,0,59.75
宜蘭縣,三星鄉,天山村,0,1,309,5,314,562,3,1,3,0,1,0,55.87
宜蘭縣,三星鄉,天福村,0,1,402,5,407,782,3,1,3,0,1,0,52.05
宜蘭縣,三星鄉,雙賢村,0,1,375,9,384,653,3,1,3,0,1,0,58.81
宜蘭縣,三星鄉,人和村,0,1,254,4,258,456,3,1,3,0,1,0,56.58
宜蘭縣,三星鄉,義德村,0,1,644,5,649,1097,3,1,3,0,1,0,59.16
宜蘭縣,三星鄉,集慶村,0,1,632,2,634,1142,3,1,3,0,1,0,55.52
宜蘭縣,三星鄉,月眉村,0,1,479,5,484,789,3,1,3,0,1,0,61.34
宜蘭縣,三星鄉,拱照村,0,1,550,3,553,992,3,1,3,0,1,0,55.75
宜蘭縣,三星鄉,大隱村,0,1,1656,15,1671,3148,3,1,3,0,1,0,53.08
宜蘭縣,三星鄉,行健村,0,1,393,1,394,679,3,1,3,0,1,0,58.03
宜蘭縣,三星鄉,萬德村,0,1,271,2,273,559,3,1,3,0,1,0,48.84
宜蘭縣,三星鄉,貴林村,0,1,238,1,239,470,3,1,3,0,1,0,50.85
宜蘭縣,三星鄉,萬富村,0,1,409,5,414,670,3,1,3,0,1,0,61.79
宜蘭縣,三星鄉,大義村,0,1,623,7,630,1095,3,1,3,0,1,0,57.53
宜蘭縣,三星鄉,尚武村,0,1,471,5,476,778,3,1,3,0,1,0,61.18
宜蘭縣,三星鄉,大洲村,0,1,774,5,779,1258,3,1,3,0,1,0,61.92
宜蘭縣,三星鄉,尾塹村,0,1,692,6,698,1140,3,1,3,0,1,0,61.23
宜蘭縣,大同鄉,寒溪村,0,1,49,1,50,109,3,1,3,0,1,0,45.87
宜蘭縣,大同鄉,崙埤村,0,1,49,2,51,93,3,1,3,0,1,0,54.84
宜蘭縣,大同鄉,松羅村,0,1,128,0,128,247,3,1,3,0,1,0,51.82
宜蘭縣,大同鄉,復興村,0,1,130,1,131,232,3,1,3,0,1,0,56.47
宜蘭縣,大同鄉,英士村,0,1,39,0,39,80,3,1,3,0,1,0,48.75
宜蘭縣,大同鄉,樂水村,0,1,26,0,26,45,3,1,3,0,1,0,57.78
宜蘭縣,大同鄉,太平村,0,1,32,1,33,64,3,1,3,0,1,0,51.56
宜蘭縣,大同鄉,茂安村,0,1,18,0,18,49,3,1,3,0,1,0,36.73
宜蘭縣,大同鄉,四季村,0,1,34,0,34,73,3,1,3,0,1,0,46.58
宜蘭縣,大同鄉,南山村,0,1,11,0,11,16,3,1,3,0,1,0,68.75
宜蘭縣,南澳鄉,東岳村,0,1,93,0,93,210,3,1,3,0,1,0,44.29
宜蘭縣,南澳鄉,南澳村,0,1,33,0,33,81,3,1,3,0,1,0,40.74
宜蘭縣,南澳鄉,碧候村,0,1,34,0,34,62,3,1,3,0,1,0,54.84
宜蘭縣,南澳鄉,金岳村,0,1,32,1,33,60,3,1,3,0,1,0,55.00
宜蘭縣,南澳鄉,武塔村,0,1,39,1,40,110,3,1,3,0,1,0,36.36
宜蘭縣,南澳鄉,金洋村,0,1,11,0,11,30,3,1,3,0,1,0,36.67
宜蘭縣,南澳鄉,澳花村,0,1,64,1,65,138,3,1,3,0,1,0,47.10
桃園縣,桃園市,大林里,0,1,3168,24,3192,5318,3,1,3,0,1,0,60.02
桃園縣,桃園市,雲林里,0,1,2740,24,2764,4821,3,1,3,0,1,0,57.33
桃園縣,桃園市,大豐里,0,1,2431,29,2460,4207,3,1,3,0,1,0,58.47
桃園縣,桃園市,福林里,0,1,2652,10,2662,4405,3,1,3,0,1,0,60.43
桃園縣,桃園市,福安里,0,1,1935,5,1940,3386,3,1,3,0,1,0,57.29
桃園縣,桃園市,豐林里,0,1,3169,21,3190,5280,3,1,3,0,1,0,60.42
桃園縣,桃園市,建國里,0,1,2484,18,2502,4354,3,1,3,0,1,0,57.46
桃園縣,桃園市,東門里,0,1,1445,8,1453,2604,3,1,3,0,1,0,55.80
桃園縣,桃園市,東山里,0,1,1066,6,1072,1800,3,1,3,0,1,0,59.56
桃園縣,桃園市,萬壽里,0,1,570,5,575,900,3,1,3,0,1,0,63.89
桃園縣,桃園市,武陵里,0,1,826,3,829,1500,3,1,3,0,1,0,55.27
桃園縣,桃園市,民生里,0,1,880,7,887,1387,3,1,3,0,1,0,63.95
桃園縣,桃園市,文化里,0,1,454,0,454,747,3,1,3,0,1,0,60.78
桃園縣,桃園市,文明里,0,1,822,9,831,1384,3,1,3,0,1,0,60.04
桃園縣,桃園市,文昌里,0,1,591,7,598,928,3,1,3,0,1,0,64.44
桃園縣,桃園市,南門里,0,1,2726,15,2741,4782,3,1,3,0,1,0,57.32
桃園縣,桃園市,南華里,0,1,868,9,877,1349,3,1,3,0,1,0,65.01
桃園縣,桃園市,西門里,0,1,807,9,816,1344,3,1,3,0,1,0,60.71
桃園縣,桃園市,西湖里,0,1,758,9,767,1297,3,1,3,0,1,0,59.14
桃園縣,桃園市,長美里,0,1,577,3,580,909,3,1,3,0,1,0,63.81
桃園縣,桃園市,永興里,0,1,1033,3,1036,1695,3,1,3,0,1,0,61.12
桃園縣,桃園市,中興里,0,1,2806,20,2826,4753,3,1,3,0,1,0,59.46
桃園縣,桃園市,光興里,0,1,2654,11,2665,4865,3,1,3,0,1,0,54.78
桃園縣,桃園市,中路里,0,1,1635,12,1647,3006,3,1,3,0,1,0,54.79
桃園縣,桃園市,中信里,0,1,2016,15,2031,3668,3,1,3,0,1,0,55.37
桃園縣,桃園市,中山里,0,1,2418,16,2434,4439,3,1,3,0,1,0,54.83
桃園縣,桃園市,中平里,0,1,1896,17,1913,3465,3,1,3,0,1,0,55.21
桃園縣,桃園市,中原里,0,1,1595,14,1609,2784,3,1,3,0,1,0,57.79
桃園縣,桃園市,中泰里,0,1,3115,15,3130,6086,3,1,3,0,1,0,51.43
桃園縣,桃園市,中德里,0,1,2497,20,2517,4374,3,1,3,0,1,0,57.54
桃園縣,桃園市,中正里,0,1,2605,16,2621,4387,3,1,3,0,1,0,59.74
桃園縣,桃園市,文中里,0,1,1559,10,1569,2463,3,1,3,0,1,0,63.70
桃園縣,桃園市,中成里,0,1,2254,16,2270,3812,3,1,3,0,1,0,59.55
桃園縣,桃園市,玉山里,0,1,2403,14,2417,4226,3,1,3,0,1,0,57.19
桃園縣,桃園市,泰山里,0,1,1790,22,1812,3016,3,1,3,0,1,0,60.08
桃園縣,桃園市,龍岡里,0,1,2081,29,2110,3784,3,1,3,0,1,0,55.76
桃園縣,桃園市,龍安里,0,1,1599,15,1614,3102,3,1,3,0,1,0,52.03
桃園縣,桃園市,龍鳳里,0,1,2308,17,2325,4441,3,1,3,0,1,0,52.35
桃園縣,桃園市,龍祥里,0,1,3086,16,3102,5836,3,1,3,0,1,0,53.15
桃園縣,桃園市,龍山里,0,1,1893,19,1912,3296,3,1,3,0,1,0,58.01
桃園縣,桃園市,東埔里,0,1,2397,21,2418,4009,3,1,3,0,1,0,60.31
桃園縣,桃園市,信光里,0,1,2332,13,2345,4155,3,1,3,0,1,0,56.44
桃園縣,桃園市,永安里,0,1,2314,13,2327,3829,3,1,3,0,1,0,60.77
桃園縣,桃園市,中寧里,0,1,3960,20,3980,7789,3,1,3,0,1,0,51.10
桃園縣,桃園市,中埔里,0,1,1187,12,1199,1931,3,1,3,0,1,0,62.09
桃園縣,桃園市,南埔里,0,1,1658,12,1670,2948,3,1,3,0,1,0,56.65
桃園縣,桃園市,寶慶里,0,1,3010,17,3027,6231,3,1,3,0,1,0,48.58
桃園縣,桃園市,北埔里,0,1,3418,14,3432,6991,3,1,3,0,1,0,49.09
桃園縣,桃園市,西埔里,0,1,1571,25,1596,2431,3,1,3,0,1,0,65.65
桃園縣,桃園市,慈文里,0,1,2466,26,2492,4446,3,1,3,0,1,0,56.05
桃園縣,桃園市,新埔里,0,1,3302,36,3338,5558,3,1,3,0,1,0,60.06
桃園縣,桃園市,同安里,0,1,2873,19,2892,5171,3,1,3,0,1,0,55.93
桃園縣,桃園市,莊敬里,0,1,2550,14,2564,5215,3,1,3,0,1,0,49.17
桃園縣,桃園市,自強里,0,1,2660,16,2676,4721,3,1,3,0,1,0,56.68
桃園縣,桃園市,長安里,0,1,1573,12,1585,2862,3,1,3,0,1,0,55.38
桃園縣,桃園市,長德里,0,1,1899,11,1910,3291,3,1,3,0,1,0,58.04
桃園縣,桃園市,中和里,0,1,928,6,934,1393,3,1,3,0,1,0,67.05
桃園縣,桃園市,北門里,0,1,939,13,952,1572,3,1,3,0,1,0,60.56
桃園縣,桃園市,朝陽里,0,1,1080,12,1092,1840,3,1,3,0,1,0,59.35
桃園縣,桃園市,青溪里,0,1,2509,20,2529,4246,3,1,3,0,1,0,59.56
桃園縣,桃園市,成功里,0,1,2013,12,2025,3370,3,1,3,0,1,0,60.09
桃園縣,桃園市,三民里,0,1,2121,10,2131,3555,3,1,3,0,1,0,59.94
桃園縣,桃園市,忠義里,0,1,3587,27,3614,6817,3,1,3,0,1,0,53.01
桃園縣,桃園市,大興里,0,1,3167,27,3194,5973,3,1,3,0,1,0,53.47
桃園縣,桃園市,會稽里,0,1,2349,25,2374,4932,3,1,3,0,1,0,48.13
桃園縣,桃園市,大有里,0,1,1252,14,1266,2600,3,1,3,0,1,0,48.69
桃園縣,桃園市,寶山里,0,1,2234,19,2253,4684,3,1,3,0,1,0,48.10
桃園縣,桃園市,春日里,0,1,2241,27,2268,4473,3,1,3,0,1,0,50.70
桃園縣,桃園市,汴洲里,0,1,2051,17,2068,3372,3,1,3,0,1,0,61.33
桃園縣,龜山鄉,龜山村,0,1,2854,28,2882,4614,3,1,3,0,1,0,62.46
桃園縣,龜山鄉,新路村,0,1,3305,27,3332,5151,3,1,3,0,1,0,64.69
桃園縣,龜山鄉,大同村,0,1,2590,15,2605,4347,3,1,3,0,1,0,59.93
桃園縣,龜山鄉,中興村,0,1,2314,12,2326,3803,3,1,3,0,1,0,61.16
桃園縣,龜山鄉,新興村,0,1,1060,7,1067,1904,3,1,3,0,1,0,56.04
桃園縣,龜山鄉,陸光村,0,1,426,0,426,641,3,1,3,0,1,0,66.46
桃園縣,龜山鄉,精忠村,0,1,1798,14,1812,2527,3,1,3,0,1,0,71.71
桃園縣,龜山鄉,福源村,0,1,1069,16,1085,1754,3,1,3,0,1,0,61.86
桃園縣,龜山鄉,兔坑村,0,1,1361,12,1373,2609,3,1,3,0,1,0,52.63
桃園縣,龜山鄉,迴龍村,0,1,2293,40,2333,4359,3,1,3,0,1,0,53.52
桃園縣,龜山鄉,龍華村,0,1,1374,18,1392,2644,3,1,3,0,1,0,52.65
桃園縣,龜山鄉,龍壽村,0,1,877,10,887,1505,3,1,3,0,1,0,58.94
桃園縣,龜山鄉,嶺頂村,0,1,1780,19,1799,3150,3,1,3,0,1,0,57.11
桃園縣,龜山鄉,新嶺村,0,1,1659,17,1676,2960,3,1,3,0,1,0,56.62
桃園縣,龜山鄉,舊路村,0,1,1249,11,1260,1963,3,1,3,0,1,0,64.19
桃園縣,龜山鄉,山德村,0,1,2786,25,2811,4719,3,1,3,0,1,0,59.57
桃園縣,龜山鄉,山頂村,0,1,2114,19,2133,3965,3,1,3,0,1,0,53.80
桃園縣,龜山鄉,山福村,0,1,1669,16,1685,2834,3,1,3,0,1,0,59.46
桃園縣,龜山鄉,幸福村,0,1,2169,31,2200,4122,3,1,3,0,1,0,53.37
桃園縣,龜山鄉,大湖村,0,1,1177,8,1185,2537,3,1,3,0,1,0,46.71
桃園縣,龜山鄉,大華村,0,1,1672,11,1683,3279,3,1,3,0,1,0,51.33
桃園縣,龜山鄉,大崗村,0,1,1845,15,1860,2903,3,1,3,0,1,0,64.07
桃園縣,龜山鄉,公西村,0,1,742,6,748,1141,3,1,3,0,1,0,65.56
桃園縣,龜山鄉,文化村,0,1,1418,6,1424,2851,3,1,3,0,1,0,49.95
桃園縣,龜山鄉,樂善村,0,1,1298,66,1364,2755,3,1,3,0,1,0,49.51
桃園縣,龜山鄉,長庚村,0,1,1164,13,1177,2642,3,1,3,0,1,0,44.55
桃園縣,龜山鄉,大坑村,0,1,818,13,831,1333,3,1,3,0,1,0,62.34
桃園縣,龜山鄉,南上村,0,1,797,5,802,1307,3,1,3,0,1,0,61.36
桃園縣,龜山鄉,南美村,0,1,810,8,818,1399,3,1,3,0,1,0,58.47
桃園縣,龜山鄉,楓樹村,0,1,2000,10,2010,3249,3,1,3,0,1,0,61.87
桃園縣,八德市,興仁里,0,1,1744,11,1755,3561,3,1,3,0,1,0,49.28
桃園縣,八德市,福興里,0,1,1677,16,1693,2905,3,1,3,0,1,0,58.28
桃園縣,八德市,瑞豐里,0,1,812,11,823,1335,3,1,3,0,1,0,61.65
桃園縣,八德市,瑞興里,0,1,1261,11,1272,2160,3,1,3,0,1,0,58.89
桃園縣,八德市,瑞泰里,0,1,1698,21,1719,3055,3,1,3,0,1,0,56.27
桃園縣,八德市,瑞發里,0,1,1763,27,1790,3105,3,1,3,0,1,0,57.65
桃園縣,八德市,瑞德里,0,1,1848,14,1862,2955,3,1,3,0,1,0,63.01
桃園縣,八德市,瑞祥里,0,1,1710,27,1737,2818,3,1,3,0,1,0,61.64
桃園縣,八德市,廣興里,0,1,2840,49,2889,4970,3,1,3,0,1,0,58.13
桃園縣,八德市,廣隆里,0,1,1891,18,1909,3050,3,1,3,0,1,0,62.59
桃園縣,八德市,竹園里,0,1,1693,17,1710,2913,3,1,3,0,1,0,58.70
桃園縣,八德市,霄裡里,0,1,2473,28,2501,3939,3,1,3,0,1,0,63.49
桃園縣,八德市,茄明里,0,1,1523,17,1540,3024,3,1,3,0,1,0,50.93
桃園縣,八德市,茄苳里,0,1,2387,29,2416,4176,3,1,3,0,1,0,57.85
桃園縣,八德市,高明里,0,1,1640,29,1669,3084,3,1,3,0,1,0,54.12
桃園縣,八德市,高城里,0,1,1221,12,1233,2059,3,1,3,0,1,0,59.88
桃園縣,八德市,白鷺里,0,1,1458,13,1471,2428,3,1,3,0,1,0,60.58
桃園縣,八德市,大湳里,0,1,1455,21,1476,2708,3,1,3,0,1,0,54.51
桃園縣,八德市,大發里,0,1,959,13,972,1722,3,1,3,0,1,0,56.45
桃園縣,八德市,大仁里,0,1,1807,13,1820,3163,3,1,3,0,1,0,57.54
桃園縣,八德市,大明里,0,1,1205,7,1212,2253,3,1,3,0,1,0,53.79
桃園縣,八德市,大安里,0,1,1487,17,1504,2541,3,1,3,0,1,0,59.19
桃園縣,八德市,大竹里,0,1,824,5,829,1451,3,1,3,0,1,0,57.13
桃園縣,八德市,大興里,0,1,1317,18,1335,2202,3,1,3,0,1,0,60.63
桃園縣,八德市,大愛里,0,1,1042,18,1060,1821,3,1,3,0,1,0,58.21
桃園縣,八德市,大華里,0,1,2152,12,2164,3967,3,1,3,0,1,0,54.55
桃園縣,八德市,大和里,0,1,1814,17,1831,3320,3,1,3,0,1,0,55.15
桃園縣,八德市,大昌里,0,1,1562,12,1574,2601,3,1,3,0,1,0,60.52
桃園縣,八德市,大信里,0,1,2432,33,2465,4530,3,1,3,0,1,0,54.42
桃園縣,八德市,大同里,0,1,2516,31,2547,3707,3,1,3,0,1,0,68.71
桃園縣,八德市,大慶里,0,1,777,11,788,1370,3,1,3,0,1,0,57.52
桃園縣,八德市,大成里,0,1,2066,24,2090,3372,3,1,3,0,1,0,61.98
桃園縣,八德市,大義里,0,1,1808,21,1829,3138,3,1,3,0,1,0,58.29
桃園縣,八德市,大忠里,0,1,1072,11,1083,1814,3,1,3,0,1,0,59.70
桃園縣,八德市,大智里,0,1,1479,13,1492,2373,3,1,3,0,1,0,62.87
桃園縣,八德市,大宏里,0,1,1228,16,1244,2070,3,1,3,0,1,0,60.10
桃園縣,八德市,大正里,0,1,1262,15,1277,2116,3,1,3,0,1,0,60.35
桃園縣,八德市,大福里,0,1,2023,11,2034,3505,3,1,3,0,1,0,58.03
桃園縣,八德市,大強里,0,1,1495,23,1518,2614,3,1,3,0,1,0,58.07
桃園縣,八德市,大勇里,0,1,1240,13,1253,2201,3,1,3,0,1,0,56.93
桃園縣,八德市,大榮里,0,1,818,11,829,1520,3,1,3,0,1,0,54.54
桃園縣,八德市,大千里,0,1,864,6,870,1556,3,1,3,0,1,0,55.91
桃園縣,八德市,大漢里,0,1,1329,16,1345,2470,3,1,3,0,1,0,54.45
桃園縣,蘆竹鄉,新興村,0,1,1986,22,2008,3322,3,1,3,0,1,0,60.45
桃園縣,蘆竹鄉,中福村,0,1,2068,24,2092,3489,3,1,3,0,1,0,59.96
桃園縣,蘆竹鄉,新莊村,0,1,1744,61,1805,3099,3,1,3,0,1,0,58.24
桃園縣,蘆竹鄉,上竹村,0,1,1282,11,1293,2185,3,1,3,0,1,0,59.18
桃園縣,蘆竹鄉,宏竹村,0,1,1390,11,1401,2236,3,1,3,0,1,0,62.66
桃園縣,蘆竹鄉,大竹村,0,1,1696,12,1708,2962,3,1,3,0,1,0,57.66
桃園縣,蘆竹鄉,富竹村,0,1,745,6,751,1164,3,1,3,0,1,0,64.52
桃園縣,蘆竹鄉,大華村,0,1,886,5,891,1348,3,1,3,0,1,0,66.10
桃園縣,蘆竹鄉,蘆竹村,0,1,1929,17,1946,2938,3,1,3,0,1,0,66.24
桃園縣,蘆竹鄉,南興村,0,1,5057,42,5099,10525,3,1,3,0,1,0,48.45
桃園縣,蘆竹鄉,南榮村,0,1,1570,9,1579,3005,3,1,3,0,1,0,52.55
桃園縣,蘆竹鄉,南崁村,0,1,1480,14,1494,2751,3,1,3,0,1,0,54.31
桃園縣,蘆竹鄉,錦興村,0,1,1802,13,1815,3212,3,1,3,0,1,0,56.51
桃園縣,蘆竹鄉,錦中村,0,1,1133,7,1140,1820,3,1,3,0,1,0,62.64
桃園縣,蘆竹鄉,長興村,0,1,942,15,957,1776,3,1,3,0,1,0,53.89
桃園縣,蘆竹鄉,五福村,0,1,2175,13,2188,4577,3,1,3,0,1,0,47.80
桃園縣,蘆竹鄉,羊稠村,0,1,3178,22,3200,6123,3,1,3,0,1,0,52.26
桃園縣,蘆竹鄉,營盤村,0,1,1956,18,1974,3829,3,1,3,0,1,0,51.55
桃園縣,蘆竹鄉,瓦窯村,0,1,865,11,876,1832,3,1,3,0,1,0,47.82
桃園縣,蘆竹鄉,內厝村,0,1,1219,14,1233,1890,3,1,3,0,1,0,65.24
桃園縣,蘆竹鄉,山鼻村,0,1,842,9,851,1455,3,1,3,0,1,0,58.49
桃園縣,蘆竹鄉,山腳村,0,1,1969,14,1983,3200,3,1,3,0,1,0,61.97
桃園縣,蘆竹鄉,外社村,0,1,831,7,838,1242,3,1,3,0,1,0,67.47
桃園縣,蘆竹鄉,坑子村,0,1,1026,11,1037,1552,3,1,3,0,1,0,66.82
桃園縣,蘆竹鄉,坑口村,0,1,1422,22,1444,2195,3,1,3,0,1,0,65.79
桃園縣,蘆竹鄉,海湖村,0,1,2160,27,2187,3906,3,1,3,0,1,0,55.99
桃園縣,大園鄉,大園村,0,1,3405,23,3428,5212,3,1,3,0,1,0,65.77
桃園縣,大園鄉,田心村,0,1,2716,18,2734,4398,3,1,3,0,1,0,62.16
桃園縣,大園鄉,溪海村,0,1,1848,23,1871,3281,3,1,3,0,1,0,57.03
桃園縣,大園鄉,和平村,0,1,894,10,904,1442,3,1,3,0,1,0,62.69
桃園縣,大園鄉,橫峰村,0,1,2989,42,3031,5102,3,1,3,0,1,0,59.41
桃園縣,大園鄉,五權村,0,1,2427,23,2450,3769,3,1,3,0,1,0,65.00
桃園縣,大園鄉,埔心村,0,1,2740,30,2770,4405,3,1,3,0,1,0,62.88
桃園縣,大園鄉,大海村,0,1,929,13,942,1341,3,1,3,0,1,0,70.25
桃園縣,大園鄉,建華村,0,1,477,4,481,694,3,1,3,0,1,0,69.31
桃園縣,大園鄉,三石村,0,1,1680,24,1704,2535,3,1,3,0,1,0,67.22
桃園縣,大園鄉,果林村,0,1,2475,24,2499,4502,3,1,3,0,1,0,55.51
桃園縣,大園鄉,竹圍村,0,1,1478,11,1489,2352,3,1,3,0,1,0,63.31
桃園縣,大園鄉,海口村,0,1,823,4,827,1414,3,1,3,0,1,0,58.49
桃園縣,大園鄉,沙崙村,0,1,1482,17,1499,2539,3,1,3,0,1,0,59.04
桃園縣,大園鄉,後厝村,0,1,1102,8,1110,1764,3,1,3,0,1,0,62.93
桃園縣,大園鄉,圳頭村,0,1,1254,10,1264,2017,3,1,3,0,1,0,62.67
桃園縣,大園鄉,內海村,0,1,1062,12,1074,1738,3,1,3,0,1,0,61.80
桃園縣,大園鄉,北港村,0,1,1370,10,1380,2354,3,1,3,0,1,0,58.62
桃園縣,大園鄉,南港村,0,1,1257,16,1273,2546,3,1,3,0,1,0,50.00
桃園縣,大溪鎮,興和里,0,1,1061,12,1073,1624,3,1,3,0,1,0,66.07
桃園縣,大溪鎮,福仁里,0,1,675,5,680,1039,3,1,3,0,1,0,65.45
桃園縣,大溪鎮,田心里,0,1,2232,12,2244,3769,3,1,3,0,1,0,59.54
桃園縣,大溪鎮,一心里,0,1,2020,23,2043,3371,3,1,3,0,1,0,60.61
桃園縣,大溪鎮,一德里,0,1,2366,19,2385,3997,3,1,3,0,1,0,59.67
桃園縣,大溪鎮,月眉里,0,1,670,8,678,1078,3,1,3,0,1,0,62.89
桃園縣,大溪鎮,永福里,0,1,588,2,590,944,3,1,3,0,1,0,62.50
桃園縣,大溪鎮,康安里,0,1,723,9,732,1063,3,1,3,0,1,0,68.86
桃園縣,大溪鎮,義和里,0,1,949,13,962,1536,3,1,3,0,1,0,62.63
桃園縣,大溪鎮,美華里,0,1,1707,19,1726,2744,3,1,3,0,1,0,62.90
桃園縣,大溪鎮,福安里,0,1,1274,13,1287,2146,3,1,3,0,1,0,59.97
桃園縣,大溪鎮,復興里,0,1,592,6,598,951,3,1,3,0,1,0,62.88
桃園縣,大溪鎮,新峰里,0,1,519,3,522,876,3,1,3,0,1,0,59.59
桃園縣,大溪鎮,中新里,0,1,1020,14,1034,1546,3,1,3,0,1,0,66.88
桃園縣,大溪鎮,瑞興里,0,1,1270,17,1287,2047,3,1,3,0,1,0,62.87
桃園縣,大溪鎮,仁善里,0,1,1691,20,1711,3025,3,1,3,0,1,0,56.56
桃園縣,大溪鎮,僑愛里,0,1,1240,15,1255,1794,3,1,3,0,1,0,69.96
桃園縣,大溪鎮,仁義里,0,1,1678,19,1697,2588,3,1,3,0,1,0,65.57
桃園縣,大溪鎮,仁和里,0,1,1326,11,1337,2353,3,1,3,0,1,0,56.82
桃園縣,大溪鎮,仁愛里,0,1,1236,10,1246,2074,3,1,3,0,1,0,60.08
桃園縣,大溪鎮,仁武里,0,1,1235,12,1247,2085,3,1,3,0,1,0,59.81
桃園縣,大溪鎮,仁文里,0,1,1668,28,1696,2889,3,1,3,0,1,0,58.71
桃園縣,大溪鎮,南興里,0,1,2382,19,2401,3915,3,1,3,0,1,0,61.33
桃園縣,大溪鎮,員林里,0,1,692,5,697,1129,3,1,3,0,1,0,61.74
桃園縣,大溪鎮,光明里,0,1,1085,15,1100,1856,3,1,3,0,1,0,59.27
桃園縣,大溪鎮,瑞源里,0,1,1784,10,1794,2976,3,1,3,0,1,0,60.28
桃園縣,大溪鎮,三元里,0,1,1482,15,1497,2458,3,1,3,0,1,0,60.90
桃園縣,復興鄉,三民村,0,1,714,7,721,1205,3,1,3,0,1,0,59.83
桃園縣,復興鄉,澤仁村,0,1,373,1,374,618,3,1,3,0,1,0,60.52
桃園縣,復興鄉,霞雲村,0,1,29,0,29,49,3,1,3,0,1,0,59.18
桃園縣,復興鄉,義盛村,0,1,15,1,16,38,3,1,3,0,1,0,42.11
桃園縣,復興鄉,羅浮村,0,1,156,2,158,290,3,1,3,0,1,0,54.48
桃園縣,復興鄉,長興村,0,1,68,0,68,103,3,1,3,0,1,0,66.02
桃園縣,復興鄉,奎輝村,0,1,14,0,14,40,3,1,3,0,1,0,35.00
桃園縣,復興鄉,高義村,0,1,16,0,16,51,3,1,3,0,1,0,31.37
桃園縣,復興鄉,三光村,0,1,13,0,13,37,3,1,3,0,1,0,35.14
桃園縣,復興鄉,華陵村,0,1,138,2,140,326,3,1,3,0,1,0,42.94
桃園縣,中壢市,後寮里,0,1,1758,17,1775,3398,3,1,3,0,1,0,52.24
桃園縣,中壢市,明德里,0,1,2020,13,2033,3515,3,1,3,0,1,0,57.84
桃園縣,中壢市,至善里,0,1,2945,18,2963,5526,3,1,3,0,1,0,53.62
桃園縣,中壢市,龍興里,0,1,2075,14,2089,3445,3,1,3,0,1,0,60.64
桃園縣,中壢市,龍德里,0,1,1525,13,1538,2480,3,1,3,0,1,0,62.02
桃園縣,中壢市,龍岡里,0,1,2432,31,2463,3852,3,1,3,0,1,0,63.94
桃園縣,中壢市,龍東里,0,1,2681,28,2709,4139,3,1,3,0,1,0,65.45
桃園縣,中壢市,龍昌里,0,1,2808,31,2839,4527,3,1,3,0,1,0,62.71
桃園縣,中壢市,龍平里,0,1,1929,17,1946,2839,3,1,3,0,1,0,68.55
桃園縣,中壢市,龍安里,0,1,1372,11,1383,2015,3,1,3,0,1,0,68.64
桃園縣,中壢市,仁美里,0,1,2131,16,2147,3628,3,1,3,0,1,0,59.18
桃園縣,中壢市,仁福里,0,1,1981,14,1995,3535,3,1,3,0,1,0,56.44
桃園縣,中壢市,仁愛里,0,1,1265,11,1276,2090,3,1,3,0,1,0,61.05
桃園縣,中壢市,華愛里,0,1,1272,18,1290,2189,3,1,3,0,1,0,58.93
桃園縣,中壢市,仁德里,0,1,1532,23,1555,2409,3,1,3,0,1,0,64.55
桃園縣,中壢市,仁和里,0,1,1305,14,1319,2334,3,1,3,0,1,0,56.51
桃園縣,中壢市,仁祥里,0,1,1600,14,1614,2602,3,1,3,0,1,0,62.03
桃園縣,中壢市,華勛里,0,1,1794,21,1815,2795,3,1,3,0,1,0,64.94
桃園縣,中壢市,中堅里,0,1,1301,17,1318,2255,3,1,3,0,1,0,58.45
桃園縣,中壢市,普仁里,0,1,1924,18,1942,3424,3,1,3,0,1,0,56.72
桃園縣,中壢市,普忠里,0,1,1440,10,1450,2527,3,1,3,0,1,0,57.38
桃園縣,中壢市,普強里,0,1,1794,11,1805,2902,3,1,3,0,1,0,62.20
桃園縣,中壢市,信義里,0,1,1978,14,1992,3256,3,1,3,0,1,0,61.18
桃園縣,中壢市,正義里,0,1,2007,13,2020,3449,3,1,3,0,1,0,58.57
桃園縣,中壢市,普慶里,0,1,1461,10,1471,2319,3,1,3,0,1,0,63.43
桃園縣,中壢市,普義里,0,1,1128,12,1140,1858,3,1,3,0,1,0,61.36
桃園縣,中壢市,德義里,0,1,1368,5,1373,2276,3,1,3,0,1,0,60.33
桃園縣,中壢市,仁義里,0,1,1426,16,1442,2446,3,1,3,0,1,0,58.95
桃園縣,中壢市,忠義里,0,1,912,11,923,1511,3,1,3,0,1,0,61.09
桃園縣,中壢市,興仁里,0,1,1648,6,1654,2810,3,1,3,0,1,0,58.86
桃園縣,中壢市,中正里,0,1,1969,21,1990,3454,3,1,3,0,1,0,57.61
桃園縣,中壢市,中山里,0,1,2809,20,2829,5388,3,1,3,0,1,0,52.51
桃園縣,中壢市,篤行里,0,1,594,3,597,1094,3,1,3,0,1,0,54.57
桃園縣,中壢市,自立里,0,1,3752,33,3785,5897,3,1,3,0,1,0,64.19
桃園縣,中壢市,自強里,0,1,1620,6,1626,2715,3,1,3,0,1,0,59.89
桃園縣,中壢市,自治里,0,1,1775,17,1792,2712,3,1,3,0,1,0,66.08
桃園縣,中壢市,莊敬里,0,1,2291,22,2313,3433,3,1,3,0,1,0,67.38
桃園縣,中壢市,內壢里,0,1,1365,23,1388,2301,3,1,3,0,1,0,60.32
桃園縣,中壢市,成功里,0,1,1735,16,1751,3010,3,1,3,0,1,0,58.17
桃園縣,中壢市,福德里,0,1,1460,16,1476,2415,3,1,3,0,1,0,61.12
桃園縣,中壢市,中原里,0,1,2146,15,2161,3474,3,1,3,0,1,0,62.20
桃園縣,中壢市,忠孝里,0,1,1382,18,1400,2417,3,1,3,0,1,0,57.92
桃園縣,中壢市,復興里,0,1,2487,25,2512,4465,3,1,3,0,1,0,56.26
桃園縣,中壢市,復華里,0,1,2103,17,2120,3379,3,1,3,0,1,0,62.74
桃園縣,中壢市,文化里,0,1,3212,27,3239,5423,3,1,3,0,1,0,59.73
桃園縣,中壢市,和平里,0,1,1284,13,1297,2020,3,1,3,0,1,0,64.21
桃園縣,中壢市,內定里,0,1,2222,22,2244,3723,3,1,3,0,1,0,60.27
桃園縣,中壢市,石頭里,0,1,1036,7,1043,2411,3,1,3,0,1,0,43.26
桃園縣,中壢市,中央里,0,1,1991,14,2005,3180,3,1,3,0,1,0,63.05
桃園縣,中壢市,新興里,0,1,3440,36,3476,6125,3,1,3,0,1,0,56.75
桃園縣,中壢市,振興里,0,1,2464,15,2479,4078,3,1,3,0,1,0,60.79
桃園縣,中壢市,東興里,0,1,1512,14,1526,2604,3,1,3,0,1,0,58.60
桃園縣,中壢市,健行里,0,1,2079,11,2090,3626,3,1,3,0,1,0,57.64
桃園縣,中壢市,水尾里,0,1,3089,20,3109,5088,3,1,3,0,1,0,61.10
桃園縣,中壢市,忠福里,0,1,3295,21,3316,5444,3,1,3,0,1,0,60.91
桃園縣,中壢市,幸福里,0,1,2377,17,2394,4262,3,1,3,0,1,0,56.17
桃園縣,中壢市,永福里,0,1,2537,16,2553,4253,3,1,3,0,1,0,60.03
桃園縣,中壢市,青埔里,0,1,696,6,702,1080,3,1,3,0,1,0,65.00
桃園縣,中壢市,新街里,0,1,1055,5,1060,1898,3,1,3,0,1,0,55.85
桃園縣,中壢市,興南里,0,1,1193,11,1204,2134,3,1,3,0,1,0,56.42
桃園縣,中壢市,興國里,0,1,2656,24,2680,4454,3,1,3,0,1,0,60.17
桃園縣,中壢市,興和里,0,1,1577,14,1591,2519,3,1,3,0,1,0,63.16
桃園縣,中壢市,永興里,0,1,607,3,610,1022,3,1,3,0,1,0,59.69
桃園縣,中壢市,中壢里,0,1,516,3,519,830,3,1,3,0,1,0,62.53
桃園縣,中壢市,中榮里,0,1,592,6,598,972,3,1,3,0,1,0,61.52
桃園縣,中壢市,中建里,0,1,643,3,646,1052,3,1,3,0,1,0,61.41
桃園縣,中壢市,舊明里,0,1,1327,15,1342,2065,3,1,3,0,1,0,64.99
桃園縣,中壢市,新明里,0,1,2203,23,2226,3551,3,1,3,0,1,0,62.69
桃園縣,中壢市,光明里,0,1,2524,18,2542,4392,3,1,3,0,1,0,57.88
桃園縣,中壢市,永光里,0,1,1959,11,1970,3265,3,1,3,0,1,0,60.34
桃園縣,中壢市,三民里,0,1,1602,13,1615,2656,3,1,3,0,1,0,60.81
桃園縣,中壢市,五權里,0,1,2395,17,2412,4134,3,1,3,0,1,0,58.35
桃園縣,中壢市,五福里,0,1,1948,12,1960,3304,3,1,3,0,1,0,59.32
桃園縣,中壢市,芝芭里,0,1,1261,11,1272,2011,3,1,3,0,1,0,63.25
桃園縣,中壢市,洽溪里,0,1,779,7,786,1260,3,1,3,0,1,0,62.38
桃園縣,中壢市,內厝里,0,1,2170,13,2183,3509,3,1,3,0,1,0,62.21
桃園縣,中壢市,月眉里,0,1,2021,14,2035,3164,3,1,3,0,1,0,64.32
桃園縣,中壢市,山東里,0,1,1902,15,1917,2868,3,1,3,0,1,0,66.84
桃園縣,中壢市,過嶺里,0,1,1587,17,1604,2547,3,1,3,0,1,0,62.98
桃園縣,平鎮市,平鎮里,0,1,1869,21,1890,3218,3,1,3,0,1,0,58.73
桃園縣,平鎮市,鎮興里,0,1,1564,25,1589,2604,3,1,3,0,1,0,61.02
桃園縣,平鎮市,南勢里,0,1,2153,17,2170,3845,3,1,3,0,1,0,56.44
桃園縣,平鎮市,金星里,0,1,1238,18,1256,2349,3,1,3,0,1,0,53.47
桃園縣,平鎮市,平安里,0,1,1835,15,1850,3100,3,1,3,0,1,0,59.68
桃園縣,平鎮市,平南里,0,1,1916,11,1927,3445,3,1,3,0,1,0,55.94
桃園縣,平鎮市,山峰里,0,1,1350,20,1370,2237,3,1,3,0,1,0,61.24
桃園縣,平鎮市,福林里,0,1,1332,14,1346,2126,3,1,3,0,1,0,63.31
桃園縣,平鎮市,湧光里,0,1,2452,21,2473,4100,3,1,3,0,1,0,60.32
桃園縣,平鎮市,莊敬里,0,1,2444,18,2462,3860,3,1,3,0,1,0,63.78
桃園縣,平鎮市,湧豐里,0,1,908,13,921,1508,3,1,3,0,1,0,61.07
桃園縣,平鎮市,湧安里,0,1,1655,17,1672,2913,3,1,3,0,1,0,57.40
桃園縣,平鎮市,宋屋里,0,1,1584,9,1593,2969,3,1,3,0,1,0,53.65
桃園縣,平鎮市,平興里,0,1,1375,14,1389,2717,3,1,3,0,1,0,51.12
桃園縣,平鎮市,廣興里,0,1,2407,17,2424,4212,3,1,3,0,1,0,57.55
桃園縣,平鎮市,廣達里,0,1,1847,20,1867,3086,3,1,3,0,1,0,60.50
桃園縣,平鎮市,廣仁里,0,1,1840,23,1863,3510,3,1,3,0,1,0,53.08
桃園縣,平鎮市,復旦里,0,1,1846,11,1857,3475,3,1,3,0,1,0,53.44
桃園縣,平鎮市,復興里,0,1,2109,17,2126,3586,3,1,3,0,1,0,59.29
桃園縣,平鎮市,義民里,0,1,1985,16,2001,3472,3,1,3,0,1,0,57.63
桃園縣,平鎮市,義興里,0,1,2959,27,2986,4943,3,1,3,0,1,0,60.41
桃園縣,平鎮市,雙連里,0,1,2308,22,2330,3747,3,1,3,0,1,0,62.18
桃園縣,平鎮市,高雙里,0,1,1778,14,1792,2915,3,1,3,0,1,0,61.48
桃園縣,平鎮市,北勢里,0,1,1423,12,1435,2275,3,1,3,0,1,0,63.08
桃園縣,平鎮市,北華里,0,1,1459,12,1471,2447,3,1,3,0,1,0,60.11
桃園縣,平鎮市,新勢里,0,1,2093,16,2109,3495,3,1,3,0,1,0,60.34
桃園縣,平鎮市,北安里,0,1,964,11,975,1554,3,1,3,0,1,0,62.74
桃園縣,平鎮市,新榮里,0,1,2260,22,2282,3976,3,1,3,0,1,0,57.39
桃園縣,平鎮市,新富里,0,1,1822,9,1831,3322,3,1,3,0,1,0,55.12
桃園縣,平鎮市,新英里,0,1,1177,10,1187,2148,3,1,3,0,1,0,55.26
桃園縣,平鎮市,北興里,0,1,2073,18,2091,3511,3,1,3,0,1,0,59.56
桃園縣,平鎮市,金陵里,0,1,1179,13,1192,1812,3,1,3,0,1,0,65.78
桃園縣,平鎮市,新貴里,0,1,1672,24,1696,2691,3,1,3,0,1,0,63.02
桃園縣,平鎮市,建安里,0,1,2082,20,2102,3499,3,1,3,0,1,0,60.07
桃園縣,平鎮市,華安里,0,1,1918,16,1934,3286,3,1,3,0,1,0,58.86
桃園縣,平鎮市,東安里,0,1,1342,12,1354,2210,3,1,3,0,1,0,61.27
桃園縣,平鎮市,新安里,0,1,1711,19,1730,2989,3,1,3,0,1,0,57.88
桃園縣,平鎮市,東勢里,0,1,2422,22,2444,4014,3,1,3,0,1,0,60.89
桃園縣,平鎮市,北貴里,0,1,1782,12,1794,3143,3,1,3,0,1,0,57.08
桃園縣,平鎮市,北富里,0,1,1892,18,1910,3213,3,1,3,0,1,0,59.45
桃園縣,平鎮市,龍恩里,0,1,1540,26,1566,2561,3,1,3,0,1,0,61.15
桃園縣,平鎮市,東社里,0,1,1846,16,1862,3014,3,1,3,0,1,0,61.78
桃園縣,平鎮市,忠貞里,0,1,527,8,535,881,3,1,3,0,1,0,60.73
桃園縣,平鎮市,貿易里,0,1,983,16,999,1498,3,1,3,0,1,0,66.69
桃園縣,平鎮市,龍興里,0,1,1395,12,1407,2221,3,1,3,0,1,0,63.35
桃園縣,平鎮市,中正里,0,1,636,6,642,1045,3,1,3,0,1,0,61.44
桃園縣,楊梅鎮,仁美里,0,1,2264,28,2292,3826,3,1,3,0,1,0,59.91
桃園縣,楊梅鎮,埔心里,0,1,951,6,957,1496,3,1,3,0,1,0,63.97
桃園縣,楊梅鎮,光華里,0,1,1982,16,1998,3025,3,1,3,0,1,0,66.05
桃園縣,楊梅鎮,金龍里,0,1,449,5,454,685,3,1,3,0,1,0,66.28
桃園縣,楊梅鎮,四維里,0,1,657,5,662,1111,3,1,3,0,1,0,59.59
桃園縣,楊梅鎮,永平里,0,1,796,14,810,1387,3,1,3,0,1,0,58.40
桃園縣,楊梅鎮,瑞塘里,0,1,2172,25,2197,3909,3,1,3,0,1,0,56.20
桃園縣,楊梅鎮,瑞坪里,0,1,1427,14,1441,2550,3,1,3,0,1,0,56.51
桃園縣,楊梅鎮,梅溪里,0,1,1662,23,1685,3223,3,1,3,0,1,0,52.28
桃園縣,楊梅鎮,金溪里,0,1,1931,11,1942,3773,3,1,3,0,1,0,51.47
桃園縣,楊梅鎮,楊明里,0,1,1507,12,1519,2669,3,1,3,0,1,0,56.91
桃園縣,楊梅鎮,裕成里,0,1,1820,16,1836,3683,3,1,3,0,1,0,49.85
桃園縣,楊梅鎮,大同里,0,1,1857,11,1868,2857,3,1,3,0,1,0,65.38
桃園縣,楊梅鎮,中山里,0,1,1246,12,1258,2189,3,1,3,0,1,0,57.47
桃園縣,楊梅鎮,楊梅里,0,1,1879,15,1894,2973,3,1,3,0,1,0,63.71
桃園縣,楊梅鎮,楊江里,0,1,755,9,764,1164,3,1,3,0,1,0,65.64
桃園縣,楊梅鎮,梅新里,0,1,937,12,949,1574,3,1,3,0,1,0,60.29
桃園縣,楊梅鎮,紅梅里,0,1,1259,6,1265,2017,3,1,3,0,1,0,62.72
桃園縣,楊梅鎮,永寧里,0,1,2217,23,2240,3912,3,1,3,0,1,0,57.26
桃園縣,楊梅鎮,大平里,0,1,1783,22,1805,2935,3,1,3,0,1,0,61.50
桃園縣,楊梅鎮,秀才里,0,1,1734,19,1753,2776,3,1,3,0,1,0,63.15
桃園縣,楊梅鎮,東流里,0,1,1335,18,1353,2261,3,1,3,0,1,0,59.84
桃園縣,楊梅鎮,豐野里,0,1,1860,23,1883,3041,3,1,3,0,1,0,61.92
桃園縣,楊梅鎮,富岡里,0,1,2520,28,2548,4068,3,1,3,0,1,0,62.64
桃園縣,楊梅鎮,員本里,0,1,1154,16,1170,1882,3,1,3,0,1,0,62.17
桃園縣,楊梅鎮,三湖里,0,1,1727,20,1747,3282,3,1,3,0,1,0,53.23
桃園縣,楊梅鎮,上湖里,0,1,1735,41,1776,3289,3,1,3,0,1,0,54.00
桃園縣,楊梅鎮,上田里,0,1,1419,8,1427,2285,3,1,3,0,1,0,62.45
桃園縣,楊梅鎮,高山里,0,1,2364,44,2408,4198,3,1,3,0,1,0,57.36
桃園縣,楊梅鎮,青山里,0,1,847,10,857,1787,3,1,3,0,1,0,47.96
桃園縣,楊梅鎮,高榮里,0,1,1306,21,1327,2088,3,1,3,0,1,0,63.55
桃園縣,楊梅鎮,雙榮里,0,1,1140,8,1148,1863,3,1,3,0,1,0,61.62
桃園縣,楊梅鎮,新榮里,0,1,1361,15,1376,2397,3,1,3,0,1,0,57.41
桃園縣,楊梅鎮,水美里,0,1,2021,16,2037,3185,3,1,3,0,1,0,63.96
桃園縣,楊梅鎮,瑞原里,0,1,1826,19,1845,3128,3,1,3,0,1,0,58.98
桃園縣,龍潭鄉,黃唐村,0,1,1979,17,1996,3534,3,1,3,0,1,0,56.48
桃園縣,龍潭鄉,永興村,0,1,1473,18,1491,2481,3,1,3,0,1,0,60.10
桃園縣,龍潭鄉,中山村,0,1,2433,12,2445,3876,3,1,3,0,1,0,63.08
桃園縣,龍潭鄉,烏樹林村,0,1,1061,11,1072,1952,3,1,3,0,1,0,54.92
桃園縣,龍潭鄉,烏林村,0,1,1779,32,1811,3205,3,1,3,0,1,0,56.51
桃園縣,龍潭鄉,百年村,0,1,1369,6,1375,2450,3,1,3,0,1,0,56.12
桃園縣,龍潭鄉,凌雲村,0,1,1668,13,1681,2887,3,1,3,0,1,0,58.23
桃園縣,龍潭鄉,龍祥村,0,1,1437,24,1461,2437,3,1,3,0,1,0,59.95
桃園縣,龍潭鄉,八德村,0,1,1820,16,1836,3110,3,1,3,0,1,0,59.04
桃園縣,龍潭鄉,聖德村,0,1,1249,8,1257,2255,3,1,3,0,1,0,55.74
桃園縣,龍潭鄉,上林村,0,1,1634,19,1653,2968,3,1,3,0,1,0,55.69
桃園縣,龍潭鄉,龍潭村,0,1,1242,7,1249,1934,3,1,3,0,1,0,64.58
桃園縣,龍潭鄉,龍星村,0,1,1695,13,1708,2909,3,1,3,0,1,0,58.71
桃園縣,龍潭鄉,中正村,0,1,1621,11,1632,2840,3,1,3,0,1,0,57.46
桃園縣,龍潭鄉,上華村,0,1,1265,16,1281,2197,3,1,3,0,1,0,58.31
桃園縣,龍潭鄉,九龍村,0,1,1552,19,1571,2824,3,1,3,0,1,0,55.63
桃園縣,龍潭鄉,武漢村,0,1,1051,5,1056,1933,3,1,3,0,1,0,54.63
桃園縣,龍潭鄉,東興村,0,1,2050,21,2071,3290,3,1,3,0,1,0,62.95
桃園縣,龍潭鄉,中興村,0,1,1866,21,1887,3301,3,1,3,0,1,0,57.16
桃園縣,龍潭鄉,北興村,0,1,1081,17,1098,1905,3,1,3,0,1,0,57.64
桃園縣,龍潭鄉,佳安村,0,1,1963,18,1981,3113,3,1,3,0,1,0,63.64
桃園縣,龍潭鄉,三坑村,0,1,748,10,758,1295,3,1,3,0,1,0,58.53
桃園縣,龍潭鄉,大平村,0,1,631,4,635,1144,3,1,3,0,1,0,55.51
桃園縣,龍潭鄉,三林村,0,1,1301,5,1306,2142,3,1,3,0,1,0,60.97
桃園縣,龍潭鄉,建林村,0,1,1941,8,1949,3094,3,1,3,0,1,0,62.99
桃園縣,龍潭鄉,富林村,0,1,1725,12,1737,2780,3,1,3,0,1,0,62.48
桃園縣,龍潭鄉,高平村,0,1,1414,14,1428,2562,3,1,3,0,1,0,55.74
桃園縣,龍潭鄉,高原村,0,1,1541,19,1560,2889,3,1,3,0,1,0,54.00
桃園縣,龍潭鄉,三和村,0,1,763,2,765,1340,3,1,3,0,1,0,57.09
桃園縣,龍潭鄉,三水村,0,1,451,3,454,681,3,1,3,0,1,0,66.67
桃園縣,新屋鄉,新屋村,0,1,1626,6,1632,2416,3,1,3,0,1,0,67.55
桃園縣,新屋鄉,新生村,0,1,2014,16,2030,3033,3,1,3,0,1,0,66.93
桃園縣,新屋鄉,後湖村,0,1,814,7,821,1246,3,1,3,0,1,0,65.89
桃園縣,新屋鄉,清華村,0,1,1878,14,1892,3016,3,1,3,0,1,0,62.73
桃園縣,新屋鄉,石磊村,0,1,1122,15,1137,1689,3,1,3,0,1,0,67.32
桃園縣,新屋鄉,東明村,0,1,765,2,767,1193,3,1,3,0,1,0,64.29
桃園縣,新屋鄉,社子村,0,1,958,5,963,1326,3,1,3,0,1,0,72.62
桃園縣,新屋鄉,埔頂村,0,1,1359,12,1371,2099,3,1,3,0,1,0,65.32
桃園縣,新屋鄉,九斗村,0,1,1188,11,1199,1835,3,1,3,0,1,0,65.34
桃園縣,新屋鄉,頭洲村,0,1,1754,12,1766,2916,3,1,3,0,1,0,60.56
桃園縣,新屋鄉,大坡村,0,1,847,6,853,1318,3,1,3,0,1,0,64.72
桃園縣,新屋鄉,望間村,0,1,999,7,1006,1446,3,1,3,0,1,0,69.57
桃園縣,新屋鄉,後庄村,0,1,704,8,712,1087,3,1,3,0,1,0,65.50
桃園縣,新屋鄉,蚵間村,0,1,507,4,511,858,3,1,3,0,1,0,59.56
桃園縣,新屋鄉,深圳村,0,1,434,2,436,653,3,1,3,0,1,0,66.77
桃園縣,新屋鄉,康榔村,0,1,700,5,705,1042,3,1,3,0,1,0,67.66
桃園縣,新屋鄉,笨港村,0,1,676,7,683,1017,3,1,3,0,1,0,67.16
桃園縣,新屋鄉,永安村,0,1,1544,14,1558,2225,3,1,3,0,1,0,70.02
桃園縣,新屋鄉,永興村,0,1,619,3,622,937,3,1,3,0,1,0,66.38
桃園縣,新屋鄉,下埔村,0,1,435,5,440,690,3,1,3,0,1,0,63.77
桃園縣,新屋鄉,石牌村,0,1,574,2,576,799,3,1,3,0,1,0,72.09
桃園縣,新屋鄉,下田村,0,1,1017,8,1025,1556,3,1,3,0,1,0,65.87
桃園縣,新屋鄉,赤欄村,0,1,705,10,715,1073,3,1,3,0,1,0,66.64
桃園縣,觀音鄉,觀音村,0,1,1505,9,1514,2354,3,1,3,0,1,0,64.32
桃園縣,觀音鄉,白玉村,0,1,769,14,783,1094,3,1,3,0,1,0,71.57
桃園縣,觀音鄉,廣興村,0,1,816,8,824,1292,3,1,3,0,1,0,63.78
桃園縣,觀音鄉,大潭村,0,1,769,5,774,1179,3,1,3,0,1,0,65.65
桃園縣,觀音鄉,保生村,0,1,1055,5,1060,1570,3,1,3,0,1,0,67.52
桃園縣,觀音鄉,武威村,0,1,499,4,503,688,3,1,3,0,1,0,73.11
桃園縣,觀音鄉,三和村,0,1,520,9,529,746,3,1,3,0,1,0,70.91
桃園縣,觀音鄉,新興村,0,1,443,4,447,660,3,1,3,0,1,0,67.73
桃園縣,觀音鄉,坑尾村,0,1,738,9,747,1228,3,1,3,0,1,0,60.83
桃園縣,觀音鄉,金湖村,0,1,1134,3,1137,1905,3,1,3,0,1,0,59.69
桃園縣,觀音鄉,藍埔村,0,1,1261,8,1269,1947,3,1,3,0,1,0,65.18
桃園縣,觀音鄉,大同村,0,1,1123,13,1136,1796,3,1,3,0,1,0,63.25
桃園縣,觀音鄉,大堀村,0,1,702,13,715,1075,3,1,3,0,1,0,66.51
桃園縣,觀音鄉,崙坪村,0,1,2231,26,2257,3631,3,1,3,0,1,0,62.16
桃園縣,觀音鄉,富源村,0,1,1152,14,1166,1960,3,1,3,0,1,0,59.49
桃園縣,觀音鄉,上大村,0,1,1046,11,1057,1731,3,1,3,0,1,0,61.06
桃園縣,觀音鄉,新坡村,0,1,1632,11,1643,2574,3,1,3,0,1,0,63.83
桃園縣,觀音鄉,廣福村,0,1,1196,6,1202,1831,3,1,3,0,1,0,65.65
桃園縣,觀音鄉,塔腳村,0,1,636,3,639,967,3,1,3,0,1,0,66.08
桃園縣,觀音鄉,保障村,0,1,1161,27,1188,1871,3,1,3,0,1,0,63.50
桃園縣,觀音鄉,草漯村,0,1,2158,23,2181,3557,3,1,3,0,1,0,61.32
桃園縣,觀音鄉,樹林村,0,1,996,6,1002,1682,3,1,3,0,1,0,59.57
桃園縣,觀音鄉,富林村,0,1,881,14,895,1394,3,1,3,0,1,0,64.20
新竹縣,竹北市,鹿場里,0,1,906,6,912,1485,3,1,3,0,1,0,61.41
新竹縣,竹北市,東平里,0,1,183,0,183,254,3,1,3,0,1,0,72.05
新竹縣,竹北市,中興里,0,1,955,17,972,1680,3,1,3,0,1,0,57.86
新竹縣,竹北市,隘口里,0,1,398,4,402,571,3,1,3,0,1,0,70.40
新竹縣,竹北市,東海里,0,1,1596,15,1611,2523,3,1,3,0,1,0,63.85
新竹縣,竹北市,十興里,0,1,3607,35,3642,6385,3,1,3,0,1,0,57.04
新竹縣,竹北市,斗崙里,0,1,2817,22,2839,5049,3,1,3,0,1,0,56.23
新竹縣,竹北市,北崙里,0,1,1553,5,1558,2612,3,1,3,0,1,0,59.65
新竹縣,竹北市,新崙里,0,1,2173,12,2185,3667,3,1,3,0,1,0,59.59
新竹縣,竹北市,竹北里,0,1,1991,10,2001,3552,3,1,3,0,1,0,56.33
新竹縣,竹北市,竹仁里,0,1,3906,32,3938,6842,3,1,3,0,1,0,57.56
新竹縣,竹北市,福德里,0,1,1720,16,1736,2882,3,1,3,0,1,0,60.24
新竹縣,竹北市,竹義里,0,1,2205,21,2226,3894,3,1,3,0,1,0,57.16
新竹縣,竹北市,泰和里,0,1,2107,31,2138,3746,3,1,3,0,1,0,57.07
新竹縣,竹北市,新社里,0,1,3018,25,3043,5333,3,1,3,0,1,0,57.06
新竹縣,竹北市,新國里,0,1,2103,23,2126,3635,3,1,3,0,1,0,58.49
新竹縣,竹北市,聯興里,0,1,1997,27,2024,3344,3,1,3,0,1,0,60.53
新竹縣,竹北市,麻園里,0,1,812,6,818,1229,3,1,3,0,1,0,66.56
新竹縣,竹北市,溪州里,0,1,1180,12,1192,1836,3,1,3,0,1,0,64.92
新竹縣,竹北市,新庄里,0,1,620,3,623,919,3,1,3,0,1,0,67.79
新竹縣,竹北市,白地里,0,1,1127,10,1137,1726,3,1,3,0,1,0,65.87
新竹縣,竹北市,新港里,0,1,710,7,717,1094,3,1,3,0,1,0,65.54
新竹縣,竹北市,大眉里,0,1,780,6,786,1425,3,1,3,0,1,0,55.16
新竹縣,竹北市,大義里,0,1,908,6,914,1435,3,1,3,0,1,0,63.69
新竹縣,竹北市,尚義里,0,1,892,4,896,1314,3,1,3,0,1,0,68.19
新竹縣,竹北市,崇義里,0,1,1146,11,1157,1708,3,1,3,0,1,0,67.74
新竹縣,竹東鎮,上坪里,0,1,221,2,223,379,3,1,3,0,1,0,58.84
新竹縣,竹東鎮,瑞峰里,0,1,217,1,218,344,3,1,3,0,1,0,63.37
新竹縣,竹東鎮,軟橋里,0,1,216,5,221,368,3,1,3,0,1,0,60.05
新竹縣,竹東鎮,員崠里,0,1,1061,15,1076,1866,3,1,3,0,1,0,57.66
新竹縣,竹東鎮,上館里,0,1,3618,35,3653,6630,3,1,3,0,1,0,55.10
新竹縣,竹東鎮,東寧里,0,1,1680,20,1700,2810,3,1,3,0,1,0,60.50
新竹縣,竹東鎮,中正里,0,1,906,15,921,1554,3,1,3,0,1,0,59.27
新竹縣,竹東鎮,大鄉里,0,1,2040,20,2060,3681,3,1,3,0,1,0,55.96
新竹縣,竹東鎮,中山里,0,1,1123,3,1126,1758,3,1,3,0,1,0,64.05
新竹縣,竹東鎮,南華里,0,1,752,9,761,1132,3,1,3,0,1,0,67.23
新竹縣,竹東鎮,東華里,0,1,516,5,521,785,3,1,3,0,1,0,66.37
新竹縣,竹東鎮,商華里,0,1,1361,7,1368,2408,3,1,3,0,1,0,56.81
新竹縣,竹東鎮,雞林里,0,1,1876,21,1897,3215,3,1,3,0,1,0,59.00
新竹縣,竹東鎮,仁愛里,0,1,1649,17,1666,2800,3,1,3,0,1,0,59.50
新竹縣,竹東鎮,竹東里,0,1,941,10,951,1417,3,1,3,0,1,0,67.11
新竹縣,竹東鎮,忠孝里,0,1,808,7,815,1416,3,1,3,0,1,0,57.56
新竹縣,竹東鎮,榮樂里,0,1,900,8,908,1401,3,1,3,0,1,0,64.81
新竹縣,竹東鎮,榮華里,0,1,3296,36,3332,5509,3,1,3,0,1,0,60.48
新竹縣,竹東鎮,五豐里,0,1,3068,38,3106,5689,3,1,3,0,1,0,54.60
新竹縣,竹東鎮,陸豐里,0,1,311,1,312,511,3,1,3,0,1,0,61.06
新竹縣,竹東鎮,三重里,0,1,2769,35,2804,4967,3,1,3,0,1,0,56.45
新竹縣,竹東鎮,二重里,0,1,3736,39,3775,6897,3,1,3,0,1,0,54.73
新竹縣,竹東鎮,頭重里,0,1,1976,10,1986,3582,3,1,3,0,1,0,55.44
新竹縣,竹東鎮,員山里,0,1,863,7,870,1508,3,1,3,0,1,0,57.69
新竹縣,竹東鎮,柯湖里,0,1,366,4,370,651,3,1,3,0,1,0,56.84
新竹縣,新埔鎮,新埔里,0,1,709,5,714,1033,3,1,3,0,1,0,69.12
新竹縣,新埔鎮,新生里,0,1,425,6,431,679,3,1,3,0,1,0,63.48
新竹縣,新埔鎮,新民里,0,1,673,18,691,1059,3,1,3,0,1,0,65.25
新竹縣,新埔鎮,田新里,0,1,1527,18,1545,2373,3,1,3,0,1,0,65.11
新竹縣,新埔鎮,旱坑里,0,1,972,9,981,1746,3,1,3,0,1,0,56.19
新竹縣,新埔鎮,五埔里,0,1,1158,12,1170,1857,3,1,3,0,1,0,63.00
新竹縣,新埔鎮,四座里,0,1,1835,22,1857,2921,3,1,3,0,1,0,63.57
新竹縣,新埔鎮,照門里,0,1,893,13,906,1374,3,1,3,0,1,0,65.94
新竹縣,新埔鎮,清水里,0,1,314,0,314,451,3,1,3,0,1,0,69.62
新竹縣,新埔鎮,鹿鳴里,0,1,469,6,475,716,3,1,3,0,1,0,66.34
新竹縣,新埔鎮,新北里,0,1,394,1,395,605,3,1,3,0,1,0,65.29
新竹縣,新埔鎮,巨埔里,0,1,777,10,787,1083,3,1,3,0,1,0,72.67
新竹縣,新埔鎮,內立里,0,1,728,8,736,1112,3,1,3,0,1,0,66.19
新竹縣,新埔鎮,寶石里,0,1,567,3,570,801,3,1,3,0,1,0,71.16
新竹縣,新埔鎮,文山里,0,1,2268,24,2292,3922,3,1,3,0,1,0,58.44
新竹縣,新埔鎮,上寮里,0,1,1063,29,1092,1714,3,1,3,0,1,0,63.71
新竹縣,新埔鎮,下寮里,0,1,1134,13,1147,1807,3,1,3,0,1,0,63.48
新竹縣,新埔鎮,南平里,0,1,652,5,657,1012,3,1,3,0,1,0,64.92
新竹縣,新埔鎮,北平里,0,1,460,2,462,666,3,1,3,0,1,0,69.37
新竹縣,關西鎮,東興里,0,1,386,5,391,544,3,1,3,0,1,0,71.88
新竹縣,關西鎮,西安里,0,1,1045,11,1056,1750,3,1,3,0,1,0,60.34
新竹縣,關西鎮,南雄里,0,1,519,7,526,750,3,1,3,0,1,0,70.13
新竹縣,關西鎮,北斗里,0,1,2189,19,2208,3616,3,1,3,0,1,0,61.06
新竹縣,關西鎮,北山里,0,1,481,5,486,740,3,1,3,0,1,0,65.68
新竹縣,關西鎮,仁安里,0,1,674,9,683,1080,3,1,3,0,1,0,63.24
新竹縣,關西鎮,南山里,0,1,633,12,645,1029,3,1,3,0,1,0,62.68
新竹縣,關西鎮,東安里,0,1,1748,20,1768,2949,3,1,3,0,1,0,59.95
新竹縣,關西鎮,東山里,0,1,485,3,488,775,3,1,3,0,1,0,62.97
新竹縣,關西鎮,東光里,0,1,741,18,759,1212,3,1,3,0,1,0,62.62
新竹縣,關西鎮,南新里,0,1,600,8,608,974,3,1,3,0,1,0,62.42
新竹縣,關西鎮,新富里,0,1,410,5,415,602,3,1,3,0,1,0,68.94
新竹縣,關西鎮,玉山里,0,1,330,4,334,530,3,1,3,0,1,0,63.02
新竹縣,關西鎮,金山里,0,1,380,4,384,638,3,1,3,0,1,0,60.19
新竹縣,關西鎮,錦山里,0,1,514,7,521,890,3,1,3,0,1,0,58.54
新竹縣,關西鎮,大同里,0,1,495,3,498,735,3,1,3,0,1,0,67.76
新竹縣,關西鎮,石光里,0,1,1171,19,1190,1830,3,1,3,0,1,0,65.03
新竹縣,關西鎮,東平里,0,1,657,14,671,968,3,1,3,0,1,0,69.32
新竹縣,關西鎮,上林里,0,1,576,5,581,843,3,1,3,0,1,0,68.92
新竹縣,關西鎮,新力里,0,1,424,4,428,607,3,1,3,0,1,0,70.51
新竹縣,關西鎮,南和里,0,1,546,8,554,796,3,1,3,0,1,0,69.60
新竹縣,湖口鄉,和興村,0,1,1549,16,1565,2404,3,1,3,0,1,0,65.10
新竹縣,湖口鄉,東興村,0,1,1668,21,1689,3052,3,1,3,0,1,0,55.34
新竹縣,湖口鄉,德盛村,0,1,2100,29,2129,3561,3,1,3,0,1,0,59.79
新竹縣,湖口鄉,愛勢村,0,1,2258,32,2290,3861,3,1,3,0,1,0,59.31
新竹縣,湖口鄉,仁勢村,0,1,552,5,557,827,3,1,3,0,1,0,67.35
新竹縣,湖口鄉,孝勢村,0,1,775,10,785,1323,3,1,3,0,1,0,59.33
新竹縣,湖口鄉,中勢村,0,1,1476,16,1492,2376,3,1,3,0,1,0,62.79
新竹縣,湖口鄉,中正村,0,1,1397,9,1406,2143,3,1,3,0,1,0,65.61
新竹縣,湖口鄉,信勢村,0,1,2106,24,2130,3513,3,1,3,0,1,0,60.63
新竹縣,湖口鄉,信義村,0,1,1315,14,1329,2187,3,1,3,0,1,0,60.77
新竹縣,湖口鄉,波羅村,0,1,899,12,911,1787,3,1,3,0,1,0,50.98
新竹縣,湖口鄉,長嶺村,0,1,1543,20,1563,2582,3,1,3,0,1,0,60.53
新竹縣,湖口鄉,長安村,0,1,648,7,655,1017,3,1,3,0,1,0,64.41
新竹縣,湖口鄉,湖口村,0,1,1377,12,1389,2346,3,1,3,0,1,0,59.21
新竹縣,湖口鄉,湖鏡村,0,1,1304,12,1316,2171,3,1,3,0,1,0,60.62
新竹縣,湖口鄉,湖南村,0,1,758,12,770,1342,3,1,3,0,1,0,57.38
新竹縣,湖口鄉,中興村,0,1,2079,37,2116,3743,3,1,3,0,1,0,56.53
新竹縣,湖口鄉,鳳凰村,0,1,1853,24,1877,3441,3,1,3,0,1,0,54.55
新竹縣,湖口鄉,勝利村,0,1,1412,18,1430,2466,3,1,3,0,1,0,57.99
新竹縣,湖口鄉,鳳山村,0,1,1456,30,1486,2639,3,1,3,0,1,0,56.31
新竹縣,新豐鄉,福興村,0,1,611,6,617,885,3,1,3,0,1,0,69.72
新竹縣,新豐鄉,後湖村,0,1,1034,16,1050,1687,3,1,3,0,1,0,62.24
新竹縣,新豐鄉,青埔村,0,1,884,6,890,1375,3,1,3,0,1,0,64.73
新竹縣,新豐鄉,埔和村,0,1,1303,14,1317,2259,3,1,3,0,1,0,58.30
新竹縣,新豐鄉,坡頭村,0,1,487,7,494,786,3,1,3,0,1,0,62.85
新竹縣,新豐鄉,新豐村,0,1,1279,22,1301,2066,3,1,3,0,1,0,62.97
新竹縣,新豐鄉,瑞興村,0,1,819,12,831,1370,3,1,3,0,1,0,60.66
新竹縣,新豐鄉,中崙村,0,1,1393,15,1408,2381,3,1,3,0,1,0,59.13
新竹縣,新豐鄉,重興村,0,1,3247,24,3271,5860,3,1,3,0,1,0,55.82
新竹縣,新豐鄉,上坑村,0,1,800,9,809,1492,3,1,3,0,1,0,54.22
新竹縣,新豐鄉,鳳坑村,0,1,612,9,621,972,3,1,3,0,1,0,63.89
新竹縣,新豐鄉,員山村,0,1,4097,31,4128,7324,3,1,3,0,1,0,56.36
新竹縣,新豐鄉,松林村,0,1,2503,22,2525,4632,3,1,3,0,1,0,54.51
新竹縣,芎林鄉,華龍村,0,1,279,3,282,429,3,1,3,0,1,0,65.73
新竹縣,芎林鄉,五龍村,0,1,323,4,327,486,3,1,3,0,1,0,67.28
新竹縣,芎林鄉,秀湖村,0,1,548,7,555,858,3,1,3,0,1,0,64.69
新竹縣,芎林鄉,永興村,0,1,249,1,250,390,3,1,3,0,1,0,64.10
新竹縣,芎林鄉,石潭村,0,1,1458,17,1475,2329,3,1,3,0,1,0,63.33
新竹縣,芎林鄉,新鳳村,0,1,929,9,938,1428,3,1,3,0,1,0,65.69
新竹縣,芎林鄉,中坑村,0,1,357,0,357,535,3,1,3,0,1,0,66.73
新竹縣,芎林鄉,水坑村,0,1,380,4,384,647,3,1,3,0,1,0,59.35
新竹縣,芎林鄉,文林村,0,1,1308,16,1324,2121,3,1,3,0,1,0,62.42
新竹縣,芎林鄉,芎林村,0,1,938,12,950,1468,3,1,3,0,1,0,64.71
新竹縣,芎林鄉,上山村,0,1,1783,21,1804,3066,3,1,3,0,1,0,58.84
新竹縣,芎林鄉,下山村,0,1,696,9,705,1066,3,1,3,0,1,0,66.14
新竹縣,橫山鄉,橫山村,0,1,1957,14,1971,3211,3,1,3,0,1,0,61.38
新竹縣,橫山鄉,田寮村,0,1,560,4,564,843,3,1,3,0,1,0,66.90
新竹縣,橫山鄉,南昌村,0,1,108,2,110,157,3,1,3,0,1,0,70.06
新竹縣,橫山鄉,豐鄉村,0,1,110,1,111,165,3,1,3,0,1,0,67.27
新竹縣,橫山鄉,豐田村,0,1,217,3,220,333,3,1,3,0,1,0,66.07
新竹縣,橫山鄉,內灣村,0,1,639,11,650,1048,3,1,3,0,1,0,62.02
新竹縣,橫山鄉,力行村,0,1,552,7,559,846,3,1,3,0,1,0,66.08
新竹縣,橫山鄉,福興村,0,1,301,6,307,467,3,1,3,0,1,0,65.74
新竹縣,橫山鄉,沙坑村,0,1,736,6,742,1077,3,1,3,0,1,0,68.90
新竹縣,橫山鄉,新興村,0,1,1013,7,1020,1532,3,1,3,0,1,0,66.58
新竹縣,橫山鄉,大肚村,0,1,877,12,889,1338,3,1,3,0,1,0,66.44
新竹縣,北埔鄉,北埔村,0,1,734,8,742,1143,3,1,3,0,1,0,64.92
新竹縣,北埔鄉,南興村,0,1,799,16,815,1249,3,1,3,0,1,0,65.25
新竹縣,北埔鄉,大湖村,0,1,313,3,316,508,3,1,3,0,1,0,62.20
新竹縣,北埔鄉,埔尾村,0,1,1490,23,1513,2360,3,1,3,0,1,0,64.11
新竹縣,北埔鄉,水際村,0,1,452,2,454,780,3,1,3,0,1,0,58.21
新竹縣,北埔鄉,南埔村,0,1,250,2,252,387,3,1,3,0,1,0,65.12
新竹縣,北埔鄉,大林村,0,1,453,6,459,664,3,1,3,0,1,0,69.13
新竹縣,北埔鄉,南坑村,0,1,205,4,209,362,3,1,3,0,1,0,57.73
新竹縣,北埔鄉,外坪村,0,1,187,3,190,301,3,1,3,0,1,0,63.12
新竹縣,寶山鄉,雙溪村,0,1,2021,16,2037,3703,3,1,3,0,1,0,55.01
新竹縣,寶山鄉,大崎村,0,1,597,4,601,1013,3,1,3,0,1,0,59.33
新竹縣,寶山鄉,三峰村,0,1,504,4,508,756,3,1,3,0,1,0,67.20
新竹縣,寶山鄉,新城村,0,1,696,4,700,1069,3,1,3,0,1,0,65.48
新竹縣,寶山鄉,寶斗村,0,1,425,6,431,638,3,1,3,0,1,0,67.55
新竹縣,寶山鄉,深井村,0,1,499,7,506,707,3,1,3,0,1,0,71.57
新竹縣,寶山鄉,寶山村,0,1,415,6,421,632,3,1,3,0,1,0,66.61
新竹縣,寶山鄉,油田村,0,1,361,1,362,557,3,1,3,0,1,0,64.99
新竹縣,寶山鄉,山湖村,0,1,268,2,270,448,3,1,3,0,1,0,60.27
新竹縣,峨眉鄉,峨眉村,0,1,606,9,615,865,3,1,3,0,1,0,71.10
新竹縣,峨眉鄉,中盛村,0,1,494,1,495,708,3,1,3,0,1,0,69.92
新竹縣,峨眉鄉,石井村,0,1,437,3,440,615,3,1,3,0,1,0,71.54
新竹縣,峨眉鄉,七星村,0,1,430,6,436,609,3,1,3,0,1,0,71.59
新竹縣,峨眉鄉,富興村,0,1,765,10,775,1209,3,1,3,0,1,0,64.10
新竹縣,峨眉鄉,湖光村,0,1,579,16,595,900,3,1,3,0,1,0,66.11
新竹縣,尖石鄉,義興村,0,1,244,9,253,445,3,1,3,0,1,0,56.85
新竹縣,尖石鄉,嘉樂村,0,1,67,0,67,122,3,1,3,0,1,0,54.92
新竹縣,尖石鄉,新樂村,0,1,76,1,77,165,3,1,3,0,1,0,46.67
新竹縣,尖石鄉,錦屏村,0,1,62,0,62,128,3,1,3,0,1,0,48.44
新竹縣,尖石鄉,梅花村,0,1,27,0,27,40,3,1,3,0,1,0,67.50
新竹縣,尖石鄉,玉峰村,0,1,8,0,8,25,3,1,3,0,1,0,32.00
新竹縣,尖石鄉,秀巒村,0,1,24,0,24,55,3,1,3,0,1,0,43.64
新竹縣,尖石鄉,玉峰村,0,1,2,0,2,2,3,1,3,0,1,0,100.00
新竹縣,五峰鄉,大隘村,0,1,80,1,81,143,3,1,3,0,1,0,56.64
新竹縣,五峰鄉,花園村,0,1,31,0,31,59,3,1,3,0,1,0,52.54
新竹縣,五峰鄉,竹林村,0,1,10,0,10,21,3,1,3,0,1,0,47.62
新竹縣,五峰鄉,桃山村,0,1,62,0,62,165,3,1,3,0,1,0,37.58
苗栗縣,苗栗市,中苗里,0,1,596,4,600,1015,3,1,3,0,1,0,59.11
苗栗縣,苗栗市,青苗里,0,1,602,5,607,1051,3,1,3,0,1,0,57.75
苗栗縣,苗栗市,維祥里,0,1,1830,18,1848,3101,3,1,3,0,1,0,59.59
苗栗縣,苗栗市,維新里,0,1,2223,22,2245,3790,3,1,3,0,1,0,59.23
苗栗縣,苗栗市,玉清里,0,1,1345,12,1357,2303,3,1,3,0,1,0,58.92
苗栗縣,苗栗市,玉華里,0,1,1973,17,1990,3339,3,1,3,0,1,0,59.60
苗栗縣,苗栗市,綠苗里,0,1,524,6,530,894,3,1,3,0,1,0,59.28
苗栗縣,苗栗市,高苗里,0,1,1459,13,1472,2727,3,1,3,0,1,0,53.98
苗栗縣,苗栗市,新苗里,0,1,594,10,604,960,3,1,3,0,1,0,62.92
苗栗縣,苗栗市,玉苗里,0,1,599,4,603,983,3,1,3,0,1,0,61.34
苗栗縣,苗栗市,大同里,0,1,383,7,390,647,3,1,3,0,1,0,60.28
苗栗縣,苗栗市,恭敬里,0,1,874,11,885,1475,3,1,3,0,1,0,60
苗栗縣,苗栗市,水源里,0,1,1370,15,1385,2322,3,1,3,0,1,0,59.65
苗栗縣,苗栗市,勝利里,0,1,2086,9,2095,3566,3,1,3,0,1,0,58.75
苗栗縣,苗栗市,清華里,0,1,1813,15,1828,3010,3,1,3,0,1,0,60.73
苗栗縣,苗栗市,上苗里,0,1,1086,5,1091,1764,3,1,3,0,1,0,61.85
苗栗縣,苗栗市,北苗里,0,1,2587,21,2608,4356,3,1,3,0,1,0,59.8714416896
苗栗縣,苗栗市,嘉盛里,0,1,1810,18,1828,3131,3,1,3,0,1,0,58.38
苗栗縣,苗栗市,嘉新里,0,1,1630,13,1643,2568,3,1,3,0,1,0,63.98
苗栗縣,苗栗市,福星里,0,1,1850,12,1862,3310,3,1,3,0,1,0,56.253776435
苗栗縣,苗栗市,福安里,0,1,1501,17,1518,2641,3,1,3,0,1,0,57.478227944
苗栗縣,苗栗市,建功里,0,1,2072,16,2088,3543,3,1,3,0,1,0,58.93
苗栗縣,苗栗市,福麗里,0,1,2379,19,2398,4272,3,1,3,0,1,0,56.13
苗栗縣,苗栗市,文山里,0,1,2768,28,2796,4969,3,1,3,0,1,0,56.2688669752
苗栗縣,苗栗市,新川里,0,1,615,6,621,1087,3,1,3,0,1,0,57.1297148114
苗栗縣,苗栗市,新英里,0,1,825,4,829,1504,3,1,3,0,1,0,55.12
苗栗縣,苗栗市,南勢里,0,1,1053,13,1066,1791,3,1,3,0,1,0,59.52
苗栗縣,苑裡鎮,苑東里,0,1,1056,8,1064,1767,3,1,3,0,1,0,60.22
苗栗縣,苑裡鎮,苑南里,0,1,996,2,998,1663,3,1,3,0,1,0,60.01
苗栗縣,苑裡鎮,苑北里,0,1,512,7,519,896,3,1,3,0,1,0,57.92
苗栗縣,苑裡鎮,西平里,0,1,833,9,842,1328,3,1,3,0,1,0,63.40
苗栗縣,苑裡鎮,苑港里,0,1,709,9,718,1124,3,1,3,0,1,0,63.88
苗栗縣,苑裡鎮,西勢里,0,1,994,9,1003,1690,3,1,3,0,1,0,59.35
苗栗縣,苑裡鎮,海岸里,0,1,587,4,591,1029,3,1,3,0,1,0,57.43
苗栗縣,苑裡鎮,房裡里,0,1,1268,7,1275,2164,3,1,3,0,1,0,58.92
苗栗縣,苑裡鎮,客庄里,0,1,2039,20,2059,3380,3,1,3,0,1,0,60.92
苗栗縣,苑裡鎮,中正里,0,1,1152,9,1161,1808,3,1,3,0,1,0,64.2146017699
苗栗縣,苑裡鎮,苑坑里,0,1,602,7,609,1002,3,1,3,0,1,0,60.7784431138
苗栗縣,苑裡鎮,水坡里,0,1,390,2,392,602,3,1,3,0,1,0,65.12
苗栗縣,苑裡鎮,新復里,0,1,683,3,686,1117,3,1,3,0,1,0,61.41
苗栗縣,苑裡鎮,山腳里,0,1,921,5,926,1485,3,1,3,0,1,0,62.36
苗栗縣,苑裡鎮,舊社里,0,1,1025,9,1034,1712,3,1,3,0,1,0,60.40
苗栗縣,苑裡鎮,福田里,0,1,731,7,738,1236,3,1,3,0,1,0,59.71
苗栗縣,苑裡鎮,石鎮里,0,1,430,4,434,607,3,1,3,0,1,0,71.50
苗栗縣,苑裡鎮,蕉埔里,0,1,575,3,578,882,3,1,3,0,1,0,65.53
苗栗縣,苑裡鎮,南勢里,0,1,428,9,437,713,3,1,3,0,1,0,61.29
苗栗縣,苑裡鎮,泰田里,0,1,861,7,868,1469,3,1,3,0,1,0,59.09
苗栗縣,苑裡鎮,上館里,0,1,902,20,922,1542,3,1,3,0,1,0,59.79
苗栗縣,苑裡鎮,玉田里,0,1,912,13,925,1633,3,1,3,0,1,0,56.64
苗栗縣,苑裡鎮,社苓里,0,1,1216,14,1230,2033,3,1,3,0,1,0,60.50
苗栗縣,苑裡鎮,山柑里,0,1,772,4,776,1216,3,1,3,0,1,0,63.82
苗栗縣,苑裡鎮,田心里,0,1,804,6,810,1372,3,1,3,0,1,0,59.04
苗栗縣,通霄鎮,通東里,0,1,768,2,770,1251,3,1,3,0,1,0,61.55
苗栗縣,通霄鎮,通西里,0,1,1365,18,1383,2137,3,1,3,0,1,0,64.7168928404
苗栗縣,通霄鎮,平元里,0,1,2228,11,2239,3786,3,1,3,0,1,0,59.14
苗栗縣,通霄鎮,圳頭里,0,1,521,1,522,752,3,1,3,0,1,0,69.41
苗栗縣,通霄鎮,梅南里,0,1,933,6,939,1505,3,1,3,0,1,0,62.39
苗栗縣,通霄鎮,通南里,0,1,1479,20,1499,2573,3,1,3,0,1,0,58.26
苗栗縣,通霄鎮,內湖里,0,1,1124,6,1130,1765,3,1,3,0,1,0,64.0226628895
苗栗縣,通霄鎮,楓樹里,0,1,353,1,354,535,3,1,3,0,1,0,66.1682242991
苗栗縣,通霄鎮,烏眉里,0,1,624,5,629,943,3,1,3,0,1,0,66.70
苗栗縣,通霄鎮,福龍里,0,1,297,2,299,468,3,1,3,0,1,0,63.89
苗栗縣,通霄鎮,福源里,0,1,515,7,522,789,3,1,3,0,1,0,66.16
苗栗縣,通霄鎮,城北里,0,1,419,3,422,689,3,1,3,0,1,0,61.25
苗栗縣,通霄鎮,城南里,0,1,625,2,627,988,3,1,3,0,1,0,63.46
苗栗縣,通霄鎮,南和里,0,1,535,5,540,825,3,1,3,0,1,0,65.45
苗栗縣,通霄鎮,福興里,0,1,411,3,414,643,3,1,3,0,1,0,64.3856920684
苗栗縣,通霄鎮,坪頂里,0,1,766,9,775,1170,3,1,3,0,1,0,66.2393162393
苗栗縣,通霄鎮,五南里,0,1,797,7,804,1330,3,1,3,0,1,0,60.4511278195
苗栗縣,通霄鎮,五北里,0,1,943,7,950,1470,3,1,3,0,1,0,64.63
苗栗縣,通霄鎮,通灣里,0,1,1371,15,1386,2213,3,1,3,0,1,0,62.63
苗栗縣,通霄鎮,新埔里,0,1,747,8,755,1249,3,1,3,0,1,0,60.45
苗栗縣,通霄鎮,內島里,0,1,439,7,446,747,3,1,3,0,1,0,59.71
苗栗縣,通霄鎮,白東里,0,1,795,8,803,1378,3,1,3,0,1,0,58.27
苗栗縣,通霄鎮,白西里,0,1,456,5,461,796,3,1,3,0,1,0,57.91
苗栗縣,竹南鎮,竹南里,0,1,1176,6,1182,1909,3,1,3,0,1,0,61.92
苗栗縣,竹南鎮,照南里,0,1,1478,12,1490,2383,3,1,3,0,1,0,62.53
苗栗縣,竹南鎮,正南里,0,1,1365,12,1377,2313,3,1,3,0,1,0,59.53307393
苗栗縣,竹南鎮,新南里,0,1,1689,7,1696,2869,3,1,3,0,1,0,59.11
苗栗縣,竹南鎮,大厝里,0,1,1882,22,1904,3140,3,1,3,0,1,0,60.64
苗栗縣,竹南鎮,營盤里,0,1,1575,19,1594,2711,3,1,3,0,1,0,58.80
苗栗縣,竹南鎮,聖福里,0,1,1308,10,1318,2299,3,1,3,0,1,0,57.33
苗栗縣,竹南鎮,竹興里,0,1,1583,16,1599,2838,3,1,3,0,1,0,56.3424947146
苗栗縣,竹南鎮,龍鳳里,0,1,2799,15,2814,4518,3,1,3,0,1,0,62.28
苗栗縣,竹南鎮,山佳里,0,1,1569,14,1583,3043,3,1,3,0,1,0,52.02
苗栗縣,竹南鎮,佳興里,0,1,1254,11,1265,2150,3,1,3,0,1,0,58.84
苗栗縣,竹南鎮,中港里,0,1,565,7,572,968,3,1,3,0,1,0,59.09
苗栗縣,竹南鎮,中華里,0,1,1340,12,1352,2298,3,1,3,0,1,0,58.83
苗栗縣,竹南鎮,中英里,0,1,688,7,695,1257,3,1,3,0,1,0,55.29
苗栗縣,竹南鎮,中美里,0,1,956,9,965,1673,3,1,3,0,1,0,57.68
苗栗縣,竹南鎮,開元里,0,1,331,3,334,544,3,1,3,0,1,0,61.40
苗栗縣,竹南鎮,海口里,0,1,1318,8,1326,2329,3,1,3,0,1,0,56.93
苗栗縣,竹南鎮,港墘里,0,1,953,17,970,1472,3,1,3,0,1,0,65.90
苗栗縣,竹南鎮,公館里,0,1,622,8,630,1125,3,1,3,0,1,0,56.00
苗栗縣,竹南鎮,大埔里,0,1,1744,19,1763,3142,3,1,3,0,1,0,56.11
苗栗縣,竹南鎮,頂埔里,0,1,1165,6,1171,2140,3,1,3,0,1,0,54.72
苗栗縣,竹南鎮,崎頂里,0,1,1481,14,1495,2693,3,1,3,0,1,0,55.51
苗栗縣,竹南鎮,公義里,0,1,529,2,531,933,3,1,3,0,1,0,56.9131832797
苗栗縣,頭份鎮,流東里,0,1,1259,8,1267,2073,3,1,3,0,1,0,61.12
苗栗縣,頭份鎮,珊湖里,0,1,1146,8,1154,1776,3,1,3,0,1,0,64.98
苗栗縣,頭份鎮,斗煥里,0,1,1662,13,1675,2805,3,1,3,0,1,0,59.7147950089
苗栗縣,頭份鎮,新華里,0,1,2067,14,2081,3475,3,1,3,0,1,0,59.88
苗栗縣,頭份鎮,興隆里,0,1,1720,13,1733,2912,3,1,3,0,1,0,59.51
苗栗縣,頭份鎮,上埔里,0,1,1404,10,1414,2393,3,1,3,0,1,0,59.0890096114
苗栗縣,頭份鎮,土牛里,0,1,486,5,491,788,3,1,3,0,1,0,62.31
苗栗縣,頭份鎮,頭份里,0,1,1546,15,1561,2774,3,1,3,0,1,0,56.27
苗栗縣,頭份鎮,忠孝里,0,1,2532,16,2548,4353,3,1,3,0,1,0,58.53
苗栗縣,頭份鎮,仁愛里,0,1,934,5,939,1528,3,1,3,0,1,0,61.4528795812
苗栗縣,頭份鎮,信義里,0,1,506,3,509,798,3,1,3,0,1,0,63.78
苗栗縣,頭份鎮,和平里,0,1,614,6,620,976,3,1,3,0,1,0,63.52
苗栗縣,頭份鎮,上興里,0,1,722,9,731,1237,3,1,3,0,1,0,59.09
苗栗縣,頭份鎮,下興里,0,1,1185,8,1193,2105,3,1,3,0,1,0,56.67
苗栗縣,頭份鎮,山下里,0,1,1428,12,1440,2539,3,1,3,0,1,0,56.72
苗栗縣,頭份鎮,後庄里,0,1,3079,25,3104,5501,3,1,3,0,1,0,56.43
苗栗縣,頭份鎮,建國里,0,1,1487,14,1501,2755,3,1,3,0,1,0,54.48
苗栗縣,頭份鎮,成功里,0,1,1556,18,1574,2836,3,1,3,0,1,0,55.50
苗栗縣,頭份鎮,蟠桃里,0,1,1395,13,1408,2609,3,1,3,0,1,0,53.97
苗栗縣,頭份鎮,東庄里,0,1,1297,11,1308,2385,3,1,3,0,1,0,54.8427672956
苗栗縣,頭份鎮,民族里,0,1,924,10,934,1631,3,1,3,0,1,0,57.27
苗栗縣,頭份鎮,民權里,0,1,950,10,960,1646,3,1,3,0,1,0,58.3232077764
苗栗縣,頭份鎮,民生里,0,1,1000,11,1011,1924,3,1,3,0,1,0,52.55
苗栗縣,頭份鎮,田寮里,0,1,1582,17,1599,2754,3,1,3,0,1,0,58.06
苗栗縣,頭份鎮,蘆竹里,0,1,857,7,864,1319,3,1,3,0,1,0,65.50
苗栗縣,頭份鎮,尖山里,0,1,827,11,838,1316,3,1,3,0,1,0,63.68
苗栗縣,頭份鎮,廣興里,0,1,586,5,591,867,3,1,3,0,1,0,68.17
苗栗縣,頭份鎮,尖下里,0,1,1459,16,1475,2460,3,1,3,0,1,0,59.96
苗栗縣,頭份鎮,濫坑里,0,1,1154,8,1162,1961,3,1,3,0,1,0,59.255481897
苗栗縣,後龍鎮,南龍里,0,1,894,4,898,1377,3,1,3,0,1,0,65.21
苗栗縣,後龍鎮,中龍里,0,1,660,4,664,956,3,1,3,0,1,0,69.46
苗栗縣,後龍鎮,北龍里,0,1,881,5,886,1422,3,1,3,0,1,0,62.31
苗栗縣,後龍鎮,大庄里,0,1,2120,16,2136,3462,3,1,3,0,1,0,61.70
苗栗縣,後龍鎮,溪洲里,0,1,1349,8,1357,2222,3,1,3,0,1,0,61.07
苗栗縣,後龍鎮,豐富里,0,1,832,1,833,1272,3,1,3,0,1,0,65.49
苗栗縣,後龍鎮,校椅里,0,1,796,5,801,1220,3,1,3,0,1,0,65.66
苗栗縣,後龍鎮,埔頂里,0,1,1471,12,1483,2414,3,1,3,0,1,0,61.43
苗栗縣,後龍鎮,新民里,0,1,921,9,930,1321,3,1,3,0,1,0,70.40
苗栗縣,後龍鎮,復興里,0,1,420,4,424,641,3,1,3,0,1,0,66.15
苗栗縣,後龍鎮,東明里,0,1,829,4,833,1381,3,1,3,0,1,0,60.32
苗栗縣,後龍鎮,大山里,0,1,912,5,917,1563,3,1,3,0,1,0,58.67
苗栗縣,後龍鎮,灣寶里,0,1,750,5,755,1302,3,1,3,0,1,0,57.99
苗栗縣,後龍鎮,海寶里,0,1,557,6,563,1010,3,1,3,0,1,0,55.74
苗栗縣,後龍鎮,外埔里,0,1,619,10,629,1134,3,1,3,0,1,0,55.47
苗栗縣,後龍鎮,海埔里,0,1,544,5,549,993,3,1,3,0,1,0,55.29
苗栗縣,後龍鎮,秀水里,0,1,470,2,472,721,3,1,3,0,1,0,65.46
苗栗縣,後龍鎮,水尾里,0,1,653,5,658,1097,3,1,3,0,1,0,59.98
苗栗縣,後龍鎮,龍津里,0,1,409,4,413,644,3,1,3,0,1,0,64.13
苗栗縣,後龍鎮,龍坑里,0,1,797,11,808,1311,3,1,3,0,1,0,61.63
苗栗縣,後龍鎮,福寧里,0,1,488,4,492,813,3,1,3,0,1,0,60.52
苗栗縣,後龍鎮,中和里,0,1,651,5,656,1221,3,1,3,0,1,0,53.7264537265
苗栗縣,後龍鎮,南港里,0,1,744,5,749,1285,3,1,3,0,1,0,58.2879377432
苗栗縣,卓蘭鎮,老庄里,0,1,1424,15,1439,2160,3,1,3,0,1,0,66.62
苗栗縣,卓蘭鎮,新榮里,0,1,776,3,779,1168,3,1,3,0,1,0,66.70
苗栗縣,卓蘭鎮,中街里,0,1,544,2,546,814,3,1,3,0,1,0,67.08
苗栗縣,卓蘭鎮,新厝里,0,1,983,5,988,1604,3,1,3,0,1,0,61.5960099751
苗栗縣,卓蘭鎮,豐田里,0,1,656,11,667,1033,3,1,3,0,1,0,64.5692158761
苗栗縣,卓蘭鎮,西坪里,0,1,351,7,358,555,3,1,3,0,1,0,64.50
苗栗縣,卓蘭鎮,苗豐里,0,1,471,17,488,756,3,1,3,0,1,0,64.55
苗栗縣,卓蘭鎮,上新里,0,1,1225,10,1235,2073,3,1,3,0,1,0,59.58
苗栗縣,卓蘭鎮,內灣里,0,1,1296,16,1312,2142,3,1,3,0,1,0,61.2511671335
苗栗縣,卓蘭鎮,坪林里,0,1,922,9,931,1423,3,1,3,0,1,0,65.4251581167
苗栗縣,卓蘭鎮,景山里,0,1,424,4,428,701,3,1,3,0,1,0,61.0556348074
苗栗縣,大湖鄉,大湖村,0,1,1054,5,1059,1693,3,1,3,0,1,0,62.5516834022
苗栗縣,大湖鄉,明湖村,0,1,484,5,489,666,3,1,3,0,1,0,73.4234234234
苗栗縣,大湖鄉,大寮村,0,1,728,5,733,1255,3,1,3,0,1,0,58.406374502
苗栗縣,大湖鄉,靜湖村,0,1,1005,5,1010,1684,3,1,3,0,1,0,59.9762470309
苗栗縣,大湖鄉,富興村,0,1,761,7,768,1365,3,1,3,0,1,0,56.2637362637
苗栗縣,大湖鄉,大南村,0,1,351,7,358,623,3,1,3,0,1,0,57.4638844302
苗栗縣,大湖鄉,南湖村,0,1,453,8,461,733,3,1,3,0,1,0,62.8922237381
苗栗縣,大湖鄉,東興村,0,1,458,1,459,720,3,1,3,0,1,0,63.75
苗栗縣,大湖鄉,武榮村,0,1,330,4,334,512,3,1,3,0,1,0,65.234375
苗栗縣,大湖鄉,義和村,0,1,892,6,898,1588,3,1,3,0,1,0,56.5491183879
苗栗縣,大湖鄉,栗林村,0,1,555,9,564,920,3,1,3,0,1,0,61.3043478261
苗栗縣,大湖鄉,新開村,0,1,520,6,526,844,3,1,3,0,1,0,62.3222748815
苗栗縣,公館鄉,館中村,0,1,983,12,995,1577,3,1,3,0,1,0,63.0944831959
苗栗縣,公館鄉,館東村,0,1,1292,11,1303,2168,3,1,3,0,1,0,60.1014760148
苗栗縣,公館鄉,館南村,0,1,1574,12,1586,2837,3,1,3,0,1,0,55.9041240747
苗栗縣,公館鄉,中義村,0,1,1133,8,1141,1985,3,1,3,0,1,0,57.4811083123
苗栗縣,公館鄉,玉泉村,0,1,976,10,986,1743,3,1,3,0,1,0,56.5691336776
苗栗縣,公館鄉,大坑村,0,1,560,10,570,983,3,1,3,0,1,0,57.985757884
苗栗縣,公館鄉,福基村,0,1,664,6,670,1069,3,1,3,0,1,0,62.6753975678
苗栗縣,公館鄉,福德村,0,1,269,2,271,396,3,1,3,0,1,0,68.4343434343
苗栗縣,公館鄉,福星村,0,1,974,8,982,1690,3,1,3,0,1,0,58.1065088757
苗栗縣,公館鄉,石墻村,0,1,807,13,820,1444,3,1,3,0,1,0,56.7867036011
苗栗縣,公館鄉,開礦村,0,1,218,1,219,308,3,1,3,0,1,0,71.1038961039
苗栗縣,公館鄉,五穀村,0,1,1072,9,1081,1810,3,1,3,0,1,0,59.7237569061
苗栗縣,公館鄉,玉穀村,0,1,671,12,683,1139,3,1,3,0,1,0,59.964881475
苗栗縣,公館鄉,鶴岡村,0,1,816,7,823,1359,3,1,3,0,1,0,60.5592347314
苗栗縣,公館鄉,鶴山村,0,1,809,7,816,1375,3,1,3,0,1,0,59.3454545455
苗栗縣,公館鄉,尖山村,0,1,781,8,789,1381,3,1,3,0,1,0,57.132512672
苗栗縣,公館鄉,仁安村,0,1,699,4,703,1180,3,1,3,0,1,0,59.5762711864
苗栗縣,公館鄉,南河村,0,1,147,3,150,252,3,1,3,0,1,0,59.5238095238
苗栗縣,公館鄉,北河村,0,1,200,1,201,313,3,1,3,0,1,0,64.2172523962
苗栗縣,銅鑼鄉,銅鑼村,0,1,2565,20,2585,4187,3,1,3,0,1,0,61.7387150705
苗栗縣,銅鑼鄉,樟樹村,0,1,769,8,777,1268,3,1,3,0,1,0,61.2776025237
苗栗縣,銅鑼鄉,九湖村,0,1,757,5,762,1241,3,1,3,0,1,0,61.4020950846
苗栗縣,銅鑼鄉,朝陽村,0,1,1064,13,1077,1733,3,1,3,0,1,0,62.1465666474
苗栗縣,銅鑼鄉,竹森村,0,1,642,5,647,1099,3,1,3,0,1,0,58.8717015469
苗栗縣,銅鑼鄉,福興村,0,1,658,4,662,1059,3,1,3,0,1,0,62.5118035883
苗栗縣,銅鑼鄉,中平村,0,1,1604,9,1613,2824,3,1,3,0,1,0,57.1175637394
苗栗縣,銅鑼鄉,興隆村,0,1,416,3,419,628,3,1,3,0,1,0,66.7197452229
苗栗縣,銅鑼鄉,盛隆村,0,1,275,5,280,494,3,1,3,0,1,0,56.6801619433
苗栗縣,銅鑼鄉,新隆村,0,1,327,2,329,539,3,1,3,0,1,0,61.038961039
苗栗縣,南庄鄉,東村,0,1,705,8,713,1196,3,1,3,0,1,0,59.6153846154
苗栗縣,南庄鄉,西村,0,1,399,9,408,651,3,1,3,0,1,0,62.6728110599
苗栗縣,南庄鄉,南江村,0,1,600,3,603,1033,3,1,3,0,1,0,58.3736689255
苗栗縣,南庄鄉,田美村,0,1,505,5,510,851,3,1,3,0,1,0,59.9294947121
苗栗縣,南庄鄉,獅山村,0,1,514,2,516,961,3,1,3,0,1,0,53.6940686785
苗栗縣,南庄鄉,南富村,0,1,670,5,675,1054,3,1,3,0,1,0,64.0417457306
苗栗縣,南庄鄉,員林村,0,1,612,9,621,1031,3,1,3,0,1,0,60.2327837051
苗栗縣,南庄鄉,蓬萊村,0,1,234,1,235,473,3,1,3,0,1,0,49.6828752643
苗栗縣,南庄鄉,東河村,0,1,148,0,148,281,3,1,3,0,1,0,52.6690391459
苗栗縣,頭屋鄉,頭屋村,0,1,1562,10,1572,2419,3,1,3,0,1,0,64.9855312112
苗栗縣,頭屋鄉,獅潭村,0,1,1005,13,1018,1581,3,1,3,0,1,0,64.3896268185
苗栗縣,頭屋鄉,北坑村,0,1,426,4,430,683,3,1,3,0,1,0,62.9575402635
苗栗縣,頭屋鄉,曲洞村,0,1,588,8,596,866,3,1,3,0,1,0,68.8221709007
苗栗縣,頭屋鄉,飛鳳村,0,1,234,4,238,353,3,1,3,0,1,0,67.4220963173
苗栗縣,頭屋鄉,象山村,0,1,1088,14,1102,1868,3,1,3,0,1,0,58.9935760171
苗栗縣,頭屋鄉,明德村,0,1,719,4,723,1092,3,1,3,0,1,0,66.2087912088
苗栗縣,頭屋鄉,鳴鳳村,0,1,222,2,224,346,3,1,3,0,1,0,64.7398843931
苗栗縣,三義鄉,廣盛村,0,1,2503,17,2520,3968,3,1,3,0,1,0,63.5080645161
苗栗縣,三義鄉,勝興村,0,1,1700,27,1727,3026,3,1,3,0,1,0,57.0720423001
苗栗縣,三義鄉,雙湖村,0,1,1044,13,1057,1650,3,1,3,0,1,0,64.0606060606
苗栗縣,三義鄉,雙潭村,0,1,904,8,912,1366,3,1,3,0,1,0,66.7642752562
苗栗縣,三義鄉,西湖村,0,1,842,5,847,1339,3,1,3,0,1,0,63.2561613144
苗栗縣,三義鄉,龍騰村,0,1,274,5,279,399,3,1,3,0,1,0,69.9248120301
苗栗縣,三義鄉,鯉魚潭村,0,1,786,10,796,1172,3,1,3,0,1,0,67.9180887372
苗栗縣,西湖鄉,高埔村,0,1,372,7,379,603,3,1,3,0,1,0,62.8524046434
苗栗縣,西湖鄉,下埔村,0,1,364,7,371,565,3,1,3,0,1,0,65.6637168142
苗栗縣,西湖鄉,五湖村,0,1,521,6,527,883,3,1,3,0,1,0,59.6828992072
苗栗縣,西湖鄉,四湖村,0,1,393,1,394,647,3,1,3,0,1,0,60.8964451314
苗栗縣,西湖鄉,三湖村,0,1,537,7,544,945,3,1,3,0,1,0,57.5661375661
苗栗縣,西湖鄉,龍洞村,0,1,309,2,311,511,3,1,3,0,1,0,60.8610567515
苗栗縣,西湖鄉,金獅村,0,1,325,3,328,525,3,1,3,0,1,0,62.4761904762
苗栗縣,西湖鄉,湖東村,0,1,652,4,656,1127,3,1,3,0,1,0,58.2076308784
苗栗縣,西湖鄉,二湖村,0,1,426,5,431,686,3,1,3,0,1,0,62.8279883382
苗栗縣,造橋鄉,造橋村,0,1,1057,7,1064,1787,3,1,3,0,1,0,59.5411303861
苗栗縣,造橋鄉,平興村,0,1,310,2,312,478,3,1,3,0,1,0,65.2719665272
苗栗縣,造橋鄉,豐湖村,0,1,577,0,577,960,3,1,3,0,1,0,60.1041666667
苗栗縣,造橋鄉,大西村,0,1,1888,16,1904,3106,3,1,3,0,1,0,61.3007083065
苗栗縣,造橋鄉,錦水村,0,1,338,4,342,539,3,1,3,0,1,0,63.4508348794
苗栗縣,造橋鄉,大龍村,0,1,298,1,299,496,3,1,3,0,1,0,60.2822580645
苗栗縣,造橋鄉,朝陽村,0,1,804,13,817,1356,3,1,3,0,1,0,60.2507374631
苗栗縣,造橋鄉,談文村,0,1,461,3,464,712,3,1,3,0,1,0,65.1685393258
苗栗縣,造橋鄉,龍昇村,0,1,614,9,623,1003,3,1,3,0,1,0,62.1136590229
苗栗縣,三灣鄉,三灣村,0,1,1382,13,1395,2127,3,1,3,0,1,0,65.5853314528
苗栗縣,三灣鄉,內灣村,0,1,365,5,370,580,3,1,3,0,1,0,63.7931034483
苗栗縣,三灣鄉,銅鏡村,0,1,510,8,518,849,3,1,3,0,1,0,61.0129564193
苗栗縣,三灣鄉,頂寮村,0,1,148,2,150,230,3,1,3,0,1,0,65.2173913043
苗栗縣,三灣鄉,北埔村,0,1,320,6,326,519,3,1,3,0,1,0,62.8131021195
苗栗縣,三灣鄉,大河村,0,1,380,6,386,604,3,1,3,0,1,0,63.9072847682
苗栗縣,三灣鄉,大坪村,0,1,278,2,280,462,3,1,3,0,1,0,60.6060606061
苗栗縣,三灣鄉,永和村,0,1,226,5,231,366,3,1,3,0,1,0,63.1147540984
苗栗縣,獅潭鄉,竹木村,0,1,448,5,453,755,3,1,3,0,1,0,60
苗栗縣,獅潭鄉,新豐村,0,1,246,1,247,358,3,1,3,0,1,0,68.9944134078
苗栗縣,獅潭鄉,豐林村,0,1,387,3,390,629,3,1,3,0,1,0,62.0031796502
苗栗縣,獅潭鄉,和興村,0,1,357,6,363,592,3,1,3,0,1,0,61.3175675676
苗栗縣,獅潭鄉,新店村,0,1,555,10,565,928,3,1,3,0,1,0,60.8836206897
苗栗縣,獅潭鄉,永興村,0,1,363,2,365,627,3,1,3,0,1,0,58.2137161085
苗栗縣,獅潭鄉,百壽村,0,1,177,2,179,271,3,1,3,0,1,0,66.0516605166
苗栗縣,泰安鄉,八卦村,0,1,91,2,93,139,3,1,3,0,1,0,66.9064748201
苗栗縣,泰安鄉,錦水村,0,1,216,0,216,358,3,1,3,0,1,0,60.3351955307
苗栗縣,泰安鄉,清安村,0,1,410,5,415,621,3,1,3,0,1,0,66.8276972625
苗栗縣,泰安鄉,大興村,0,1,50,0,50,91,3,1,3,0,1,0,54.9450549451
苗栗縣,泰安鄉,中興村,0,1,74,0,74,123,3,1,3,0,1,0,60.162601626
苗栗縣,泰安鄉,梅園村,0,1,18,0,18,27,3,1,3,0,1,0,66.6666666667
苗栗縣,泰安鄉,象鼻村,0,1,20,0,20,51,3,1,3,0,1,0,39.2156862745
苗栗縣,泰安鄉,士林村,0,1,14,0,14,27,3,1,3,0,1,0,51.8518518519
臺中縣,豐原市,豐原里,0,1,1173,19,1192,1981,3,1,3,0,1,0,60.17
臺中縣,豐原市,豐榮里,0,1,590,5,595,1025,3,1,3,0,1,0,58.05
臺中縣,豐原市,頂街里,0,1,541,5,546,885,3,1,3,0,1,0,61.69
臺中縣,豐原市,中山里,0,1,609,3,612,916,3,1,3,0,1,0,66.81
臺中縣,豐原市,下街里,0,1,491,4,495,795,3,1,3,0,1,0,62.26
臺中縣,豐原市,中陽里,0,1,2720,31,2751,4527,3,1,3,0,1,0,60.77
臺中縣,豐原市,大湳里,0,1,1309,15,1324,2264,3,1,3,0,1,0,58.48
臺中縣,豐原市,北湳里,0,1,1339,25,1364,2502,3,1,3,0,1,0,54.52
臺中縣,豐原市,東湳里,0,1,2256,31,2287,3729,3,1,3,0,1,0,61.33
臺中縣,豐原市,西湳里,0,1,3688,41,3729,6701,3,1,3,0,1,0,55.65
臺中縣,豐原市,豐西里,0,1,1070,6,1076,1728,3,1,3,0,1,0,62.27
臺中縣,豐原市,圳寮里,0,1,733,2,735,1138,3,1,3,0,1,0,64.59
臺中縣,豐原市,豐圳里,0,1,1662,12,1674,2779,3,1,3,0,1,0,60.24
臺中縣,豐原市,富春里,0,1,563,7,570,833,3,1,3,0,1,0,68.43
臺中縣,豐原市,葫蘆里,0,1,493,5,498,792,3,1,3,0,1,0,62.88
臺中縣,豐原市,西安里,0,1,2822,19,2841,4834,3,1,3,0,1,0,58.77
臺中縣,豐原市,西勢里,0,1,1291,7,1298,2278,3,1,3,0,1,0,56.98
臺中縣,豐原市,中興里,0,1,1614,19,1633,2751,3,1,3,0,1,0,59.36
臺中縣,豐原市,社皮里,0,1,3979,39,4018,7659,3,1,3,0,1,0,52.46
臺中縣,豐原市,三村里,0,1,2723,24,2747,4995,3,1,3,0,1,0,54.99
臺中縣,豐原市,東勢里,0,1,802,4,806,1362,3,1,3,0,1,0,59.18
臺中縣,豐原市,民生里,0,1,589,5,594,1037,3,1,3,0,1,0,57.28
臺中縣,豐原市,田心里,0,1,2650,32,2682,4701,3,1,3,0,1,0,57.05
臺中縣,豐原市,豐田里,0,1,4847,61,4908,8797,3,1,3,0,1,0,55.79
臺中縣,豐原市,鎌村里,0,1,2114,27,2141,3559,3,1,3,0,1,0,60.16
臺中縣,豐原市,陽明里,0,1,1429,18,1447,2450,3,1,3,0,1,0,59.06
臺中縣,豐原市,南陽里,0,1,4127,37,4164,7530,3,1,3,0,1,0,55.30
臺中縣,豐原市,北陽里,0,1,5537,62,5599,10053,3,1,3,0,1,0,55.69
臺中縣,豐原市,東陽里,0,1,958,6,964,1495,3,1,3,0,1,0,64.48
臺中縣,豐原市,南村里,0,1,2335,20,2355,4072,3,1,3,0,1,0,57.83
臺中縣,豐原市,南田里,0,1,1742,20,1762,2972,3,1,3,0,1,0,59.29
臺中縣,豐原市,南嵩里,0,1,1680,27,1707,2848,3,1,3,0,1,0,59.94
臺中縣,豐原市,翁明里,0,1,1048,14,1062,1728,3,1,3,0,1,0,61.46
臺中縣,豐原市,翁子里,0,1,1408,16,1424,2384,3,1,3,0,1,0,59.73
臺中縣,豐原市,翁社里,0,1,1122,21,1143,1841,3,1,3,0,1,0,62.09
臺中縣,豐原市,朴子里,0,1,1750,28,1778,2937,3,1,3,0,1,0,60.54
臺中縣,大里市,大里里,0,1,1850,18,1868,2997,3,1,3,0,1,0,62.33
臺中縣,大里市,新里里,0,1,3594,31,3625,6835,3,1,3,0,1,0,53.04
臺中縣,大里市,國光里,0,1,2251,24,2275,3816,3,1,3,0,1,0,59.62
臺中縣,大里市,樹王里,0,1,1728,32,1760,2829,3,1,3,0,1,0,62.21
臺中縣,大里市,祥興里,0,1,2922,29,2951,5523,3,1,3,0,1,0,53.43
臺中縣,大里市,內新里,0,1,2968,19,2987,5470,3,1,3,0,1,0,54.61
臺中縣,大里市,中新里,0,1,1977,18,1995,3548,3,1,3,0,1,0,56.23
臺中縣,大里市,東昇里,0,1,1555,22,1577,2614,3,1,3,0,1,0,60.33
臺中縣,大里市,大元里,0,1,2071,32,2103,3415,3,1,3,0,1,0,61.58
臺中縣,大里市,西湖里,0,1,1381,3,1384,2158,3,1,3,0,1,0,64.13
臺中縣,大里市,夏田里,0,1,622,9,631,940,3,1,3,0,1,0,67.13
臺中縣,大里市,仁化里,0,1,2954,18,2972,5543,3,1,3,0,1,0,53.62
臺中縣,大里市,仁德里,0,1,2622,26,2648,4803,3,1,3,0,1,0,55.13
臺中縣,大里市,健民里,0,1,2491,24,2515,4275,3,1,3,0,1,0,58.83
臺中縣,大里市,塗城里,0,1,3648,31,3679,6746,3,1,3,0,1,0,54.54
臺中縣,大里市,東湖里,0,1,3471,33,3504,6365,3,1,3,0,1,0,55.05
臺中縣,大里市,東興里,0,1,3227,24,3251,5696,3,1,3,0,1,0,57.08
臺中縣,大里市,大明里,0,1,1840,24,1864,3299,3,1,3,0,1,0,56.50
臺中縣,大里市,永隆里,0,1,2490,14,2504,4398,3,1,3,0,1,0,56.93
臺中縣,大里市,日新里,0,1,1958,19,1977,3242,3,1,3,0,1,0,60.98
臺中縣,大里市,西榮里,0,1,2540,23,2563,4584,3,1,3,0,1,0,55.91
臺中縣,大里市,長榮里,0,1,3331,25,3356,5916,3,1,3,0,1,0,56.73
臺中縣,大里市,金城里,0,1,4295,29,4324,7863,3,1,3,0,1,0,54.99
臺中縣,大里市,立仁里,0,1,2075,17,2092,3935,3,1,3,0,1,0,53.16
臺中縣,大里市,立德里,0,1,2302,23,2325,4139,3,1,3,0,1,0,56.17
臺中縣,大里市,新仁里,0,1,3521,34,3555,6117,3,1,3,0,1,0,58.12
臺中縣,大里市,瑞城里,0,1,5000,39,5039,8992,3,1,3,0,1,0,56.04
臺中縣,太平市,太平里,0,1,3309,30,3339,5237,3,1,3,0,1,0,63.76
臺中縣,太平市,長億里,0,1,4492,45,4537,7950,3,1,3,0,1,0,57.07
臺中縣,太平市,中平里,0,1,3565,28,3593,6191,3,1,3,0,1,0,58.04
臺中縣,太平市,中興里,0,1,3898,35,3933,6804,3,1,3,0,1,0,57.80
臺中縣,太平市,東平里,0,1,5652,52,5704,9310,3,1,3,0,1,0,61.27
臺中縣,太平市,建國里,0,1,2989,35,3024,5018,3,1,3,0,1,0,60.26
臺中縣,太平市,坪林里,0,1,4415,38,4453,7003,3,1,3,0,1,0,63.59
臺中縣,太平市,光華里,0,1,4232,48,4280,6987,3,1,3,0,1,0,61.26
臺中縣,太平市,中山里,0,1,3930,36,3966,6881,3,1,3,0,1,0,57.64
臺中縣,太平市,宜欣里,0,1,7002,75,7077,12574,3,1,3,0,1,0,56.28
臺中縣,太平市,新坪里,0,1,6118,60,6178,11733,3,1,3,0,1,0,52.65
臺中縣,太平市,新光里,0,1,5341,55,5396,9329,3,1,3,0,1,0,57.84
臺中縣,太平市,新福里,0,1,2529,26,2555,4246,3,1,3,0,1,0,60.17
臺中縣,太平市,頭汴里,0,1,2093,29,2122,3271,3,1,3,0,1,0,64.87
臺中縣,太平市,東汴里,0,1,776,4,780,1176,3,1,3,0,1,0,66.33
臺中縣,太平市,興隆里,0,1,3599,19,3618,5762,3,1,3,0,1,0,62.79
臺中縣,太平市,黃竹里,0,1,586,4,590,810,3,1,3,0,1,0,72.84
臺中縣,太平市,光隆里,0,1,2790,24,2814,4660,3,1,3,0,1,0,60.39
臺中縣,太平市,德隆里,0,1,2126,22,2148,3582,3,1,3,0,1,0,59.97
臺中縣,東勢鎮,北興里,0,1,762,10,772,1229,3,1,3,0,1,0,62.82
臺中縣,東勢鎮,中寧里,0,1,505,5,510,810,3,1,3,0,1,0,62.96
臺中縣,東勢鎮,東安里,0,1,741,10,751,1268,3,1,3,0,1,0,59.23
臺中縣,東勢鎮,南平里,0,1,1151,16,1167,1889,3,1,3,0,1,0,61.78
臺中縣,東勢鎮,延平里,0,1,1315,10,1325,2188,3,1,3,0,1,0,60.56
臺中縣,東勢鎮,上新里,0,1,623,4,627,954,3,1,3,0,1,0,65.72
臺中縣,東勢鎮,廣興里,0,1,868,5,873,1460,3,1,3,0,1,0,59.79
臺中縣,東勢鎮,泰昌里,0,1,1904,18,1922,3232,3,1,3,0,1,0,59.47
臺中縣,東勢鎮,中嵙里,0,1,1059,10,1069,1842,3,1,3,0,1,0,58.03
臺中縣,東勢鎮,福隆里,0,1,1802,31,1833,3148,3,1,3,0,1,0,58.23
臺中縣,東勢鎮,隆興里,0,1,777,9,786,1422,3,1,3,0,1,0,55.27
臺中縣,東勢鎮,新盛里,0,1,2675,48,2723,4591,3,1,3,0,1,0,59.31
臺中縣,東勢鎮,詒福里,0,1,880,12,892,1468,3,1,3,0,1,0,60.76
臺中縣,東勢鎮,上城里,0,1,629,6,635,965,3,1,3,0,1,0,65.80
臺中縣,東勢鎮,下城里,0,1,578,3,581,888,3,1,3,0,1,0,65.43
臺中縣,東勢鎮,慶東里,0,1,1204,9,1213,1910,3,1,3,0,1,0,63.51
臺中縣,東勢鎮,慶福里,0,1,728,10,738,1397,3,1,3,0,1,0,52.83
臺中縣,東勢鎮,東新里,0,1,1091,14,1105,1899,3,1,3,0,1,0,58.19
臺中縣,東勢鎮,粵寧里,0,1,1018,12,1030,1746,3,1,3,0,1,0,58.99
臺中縣,東勢鎮,下新里,0,1,969,15,984,1647,3,1,3,0,1,0,59.74
臺中縣,東勢鎮,興隆里,0,1,691,5,696,1218,3,1,3,0,1,0,57.14
臺中縣,東勢鎮,茂興里,0,1,950,17,967,1757,3,1,3,0,1,0,55.04
臺中縣,東勢鎮,泰興里,0,1,433,4,437,746,3,1,3,0,1,0,58.58
臺中縣,東勢鎮,埤頭里,0,1,439,3,442,653,3,1,3,0,1,0,67.69
臺中縣,東勢鎮,明正里,0,1,758,8,766,1399,3,1,3,0,1,0,54.75
臺中縣,大甲鎮,朝陽里,0,1,811,8,819,1287,3,1,3,0,1,0,63.64
臺中縣,大甲鎮,大甲里,0,1,713,6,719,1203,3,1,3,0,1,0,59.77
臺中縣,大甲鎮,順天里,0,1,985,12,997,1646,3,1,3,0,1,0,60.57
臺中縣,大甲鎮,孔門里,0,1,497,6,503,779,3,1,3,0,1,0,64.57
臺中縣,大甲鎮,平安里,0,1,1239,10,1249,1988,3,1,3,0,1,0,62.83
臺中縣,大甲鎮,庄美里,0,1,1237,13,1250,1986,3,1,3,0,1,0,62.94
臺中縣,大甲鎮,新美里,0,1,1931,23,1954,3131,3,1,3,0,1,0,62.41
臺中縣,大甲鎮,岷山里,0,1,1165,4,1169,1862,3,1,3,0,1,0,62.78
臺中縣,大甲鎮,中山里,0,1,2009,28,2037,3477,3,1,3,0,1,0,58.58
臺中縣,大甲鎮,南陽里,0,1,544,9,553,863,3,1,3,0,1,0,64.08
臺中縣,大甲鎮,薰風里,0,1,585,2,587,936,3,1,3,0,1,0,62.71
臺中縣,大甲鎮,義和里,0,1,1535,23,1558,2651,3,1,3,0,1,0,58.77
臺中縣,大甲鎮,武陵里,0,1,838,9,847,1110,3,1,3,0,1,0,76.31
臺中縣,大甲鎮,文曲里,0,1,715,4,719,1096,3,1,3,0,1,0,65.60
臺中縣,大甲鎮,武曲里,0,1,1024,15,1039,1589,3,1,3,0,1,0,65.39
臺中縣,大甲鎮,文武里,0,1,2770,31,2801,4627,3,1,3,0,1,0,60.54
臺中縣,大甲鎮,奉化里,0,1,871,11,882,1469,3,1,3,0,1,0,60.04
臺中縣,大甲鎮,德化里,0,1,918,6,924,1586,3,1,3,0,1,0,58.26
臺中縣,大甲鎮,江南里,0,1,619,13,632,1066,3,1,3,0,1,0,59.29
臺中縣,大甲鎮,頂店里,0,1,2078,22,2100,3420,3,1,3,0,1,0,61.40
臺中縣,大甲鎮,太白里,0,1,716,5,721,1231,3,1,3,0,1,0,58.57
臺中縣,大甲鎮,孟春里,0,1,1968,27,1995,3255,3,1,3,0,1,0,61.29
臺中縣,大甲鎮,幸福里,0,1,1431,25,1456,2376,3,1,3,0,1,0,61.28
臺中縣,大甲鎮,日南里,0,1,2202,30,2232,4122,3,1,3,0,1,0,54.15
臺中縣,大甲鎮,龍泉里,0,1,889,13,902,1386,3,1,3,0,1,0,65.08
臺中縣,大甲鎮,西岐里,0,1,928,9,937,1495,3,1,3,0,1,0,62.68
臺中縣,大甲鎮,銅安里,0,1,720,6,726,1244,3,1,3,0,1,0,58.36
臺中縣,大甲鎮,福德里,0,1,722,10,732,1081,3,1,3,0,1,0,67.72
臺中縣,大甲鎮,建興里,0,1,856,8,864,1320,3,1,3,0,1,0,65.45
臺中縣,清水鎮,鰲峰里,0,1,810,10,820,1202,3,1,3,0,1,0,68.22
臺中縣,清水鎮,靈泉里,0,1,707,4,711,1075,3,1,3,0,1,0,66.14
臺中縣,清水鎮,清水里,0,1,1249,10,1259,2042,3,1,3,0,1,0,61.66
臺中縣,清水鎮,文昌里,0,1,465,5,470,730,3,1,3,0,1,0,64.38
臺中縣,清水鎮,南寧里,0,1,1181,7,1188,1784,3,1,3,0,1,0,66.59
臺中縣,清水鎮,西寧里,0,1,945,6,951,1478,3,1,3,0,1,0,64.34
臺中縣,清水鎮,北寧里,0,1,508,4,512,724,3,1,3,0,1,0,70.72
臺中縣,清水鎮,中興里,0,1,329,2,331,449,3,1,3,0,1,0,73.72
臺中縣,清水鎮,西社里,0,1,1539,24,1563,2410,3,1,3,0,1,0,64.85
臺中縣,清水鎮,南社里,0,1,3356,28,3384,5464,3,1,3,0,1,0,61.93
臺中縣,清水鎮,裕嘉里,0,1,755,12,767,1296,3,1,3,0,1,0,59.18
臺中縣,清水鎮,臨江里,0,1,946,9,955,1488,3,1,3,0,1,0,64.18
臺中縣,清水鎮,秀水里,0,1,2059,21,2080,3622,3,1,3,0,1,0,57.43
臺中縣,清水鎮,武鹿里,0,1,1715,18,1733,2770,3,1,3,0,1,0,62.56
臺中縣,清水鎮,海濱里,0,1,1177,18,1195,1861,3,1,3,0,1,0,64.21
臺中縣,清水鎮,康榔里,0,1,2109,26,2135,3665,3,1,3,0,1,0,58.25
臺中縣,清水鎮,中社里,0,1,977,9,986,1518,3,1,3,0,1,0,64.95
臺中縣,清水鎮,高西里,0,1,800,15,815,1312,3,1,3,0,1,0,62.12
臺中縣,清水鎮,高南里,0,1,894,8,902,1317,3,1,3,0,1,0,68.49
臺中縣,清水鎮,高東里,0,1,728,12,740,1275,3,1,3,0,1,0,58.04
臺中縣,清水鎮,高北里,0,1,691,12,703,1117,3,1,3,0,1,0,62.94
臺中縣,清水鎮,高美里,0,1,853,5,858,1285,3,1,3,0,1,0,66.77
臺中縣,清水鎮,國姓里,0,1,1087,7,1094,1993,3,1,3,0,1,0,54.89
臺中縣,清水鎮,菁埔里,0,1,1284,8,1292,2186,3,1,3,0,1,0,59.10
臺中縣,清水鎮,頂湳里,0,1,1055,12,1067,1742,3,1,3,0,1,0,61.25
臺中縣,清水鎮,田寮里,0,1,1182,18,1200,2155,3,1,3,0,1,0,55.68
臺中縣,清水鎮,橋頭里,0,1,3559,35,3594,5845,3,1,3,0,1,0,61.49
臺中縣,清水鎮,下湳里,0,1,1753,22,1775,2871,3,1,3,0,1,0,61.83
臺中縣,清水鎮,東山里,0,1,806,12,818,1103,3,1,3,0,1,0,74.16
臺中縣,清水鎮,楊厝里,0,1,1024,14,1038,1328,3,1,3,0,1,0,78.16
臺中縣,清水鎮,海風里,0,1,669,11,680,1031,3,1,3,0,1,0,65.96
臺中縣,清水鎮,吳厝里,0,1,750,7,757,1219,3,1,3,0,1,0,62.10
臺中縣,沙鹿鎮,居仁里,0,1,806,10,816,1361,3,1,3,0,1,0,59.96
臺中縣,沙鹿鎮,洛泉里,0,1,1470,12,1482,2178,3,1,3,0,1,0,68.04
臺中縣,沙鹿鎮,沙鹿里,0,1,706,7,713,1160,3,1,3,0,1,0,61.47
臺中縣,沙鹿鎮,美仁里,0,1,382,2,384,540,3,1,3,0,1,0,71.11
臺中縣,沙鹿鎮,興仁里,0,1,1388,25,1413,2390,3,1,3,0,1,0,59.12
臺中縣,沙鹿鎮,興安里,0,1,1610,17,1627,2643,3,1,3,0,1,0,61.56
臺中縣,沙鹿鎮,斗抵里,0,1,2240,18,2258,3652,3,1,3,0,1,0,61.83
臺中縣,沙鹿鎮,鹿峰里,0,1,2229,19,2248,3871,3,1,3,0,1,0,58.07
臺中縣,沙鹿鎮,鹿寮里,0,1,3094,34,3128,5128,3,1,3,0,1,0,61.00
臺中縣,沙鹿鎮,竹林里,0,1,3376,46,3422,5545,3,1,3,0,1,0,61.71
臺中縣,沙鹿鎮,犁分里,0,1,543,5,548,844,3,1,3,0,1,0,64.93
臺中縣,沙鹿鎮,福興里,0,1,1344,8,1352,2300,3,1,3,0,1,0,58.78
臺中縣,沙鹿鎮,北勢里,0,1,1938,19,1957,3385,3,1,3,0,1,0,57.81
臺中縣,沙鹿鎮,晉江里,0,1,809,8,817,1244,3,1,3,0,1,0,65.68
臺中縣,沙鹿鎮,六路里,0,1,1386,14,1400,2381,3,1,3,0,1,0,58.80
臺中縣,沙鹿鎮,南勢里,0,1,1185,22,1207,1870,3,1,3,0,1,0,64.55
臺中縣,沙鹿鎮,埔子里,0,1,1426,16,1442,2171,3,1,3,0,1,0,66.42
臺中縣,沙鹿鎮,三鹿里,0,1,1606,16,1622,2428,3,1,3,0,1,0,66.80
臺中縣,沙鹿鎮,公明里,0,1,2117,19,2136,3417,3,1,3,0,1,0,62.51
臺中縣,沙鹿鎮,清泉里,0,1,1099,13,1112,1845,3,1,3,0,1,0,60.27
臺中縣,沙鹿鎮,西勢里,0,1,1190,24,1214,1990,3,1,3,0,1,0,61.01
臺中縣,梧棲鎮,頂寮里,0,1,1472,23,1495,2615,3,1,3,0,1,0,57.17
臺中縣,梧棲鎮,下寮里,0,1,1219,31,1250,1983,3,1,3,0,1,0,63.04
臺中縣,梧棲鎮,中正里,0,1,1859,22,1881,3330,3,1,3,0,1,0,56.49
臺中縣,梧棲鎮,中和里,0,1,330,4,334,552,3,1,3,0,1,0,60.51
臺中縣,梧棲鎮,文化里,0,1,694,7,701,1120,3,1,3,0,1,0,62.59
臺中縣,梧棲鎮,安仁里,0,1,442,4,446,728,3,1,3,0,1,0,61.26
臺中縣,梧棲鎮,草湳里,0,1,3121,55,3176,5226,3,1,3,0,1,0,60.77
臺中縣,梧棲鎮,南簡里,0,1,1493,12,1505,2698,3,1,3,0,1,0,55.78
臺中縣,梧棲鎮,福德里,0,1,1636,18,1654,2914,3,1,3,0,1,0,56.76
臺中縣,梧棲鎮,大庄里,0,1,2894,33,2927,5130,3,1,3,0,1,0,57.06
臺中縣,梧棲鎮,大村里,0,1,2073,22,2095,3833,3,1,3,0,1,0,54.66
臺中縣,梧棲鎮,興農里,0,1,1072,13,1085,1793,3,1,3,0,1,0,60.51
臺中縣,梧棲鎮,永寧里,0,1,1232,7,1239,2181,3,1,3,0,1,0,56.81
臺中縣,梧棲鎮,永安里,0,1,1358,17,1375,2274,3,1,3,0,1,0,60.47
臺中縣,后里鄉,廣福村,0,1,1216,24,1240,1847,3,1,3,0,1,0,67.14
臺中縣,后里鄉,仁里村,0,1,877,11,888,1455,3,1,3,0,1,0,61.03
臺中縣,后里鄉,義里村,0,1,1731,16,1747,2699,3,1,3,0,1,0,64.73
臺中縣,后里鄉,義德村,0,1,1558,24,1582,2540,3,1,3,0,1,0,62.28
臺中縣,后里鄉,后里村,0,1,2129,25,2154,3330,3,1,3,0,1,0,64.68
臺中縣,后里鄉,厚里村,0,1,1265,15,1280,1926,3,1,3,0,1,0,66.46
臺中縣,后里鄉,墩東村,0,1,2576,28,2604,4095,3,1,3,0,1,0,63.59
臺中縣,后里鄉,墩西村,0,1,1164,26,1190,1819,3,1,3,0,1,0,65.42
臺中縣,后里鄉,墩南村,0,1,1725,14,1739,2641,3,1,3,0,1,0,65.85
臺中縣,后里鄉,墩北村,0,1,1805,21,1826,2841,3,1,3,0,1,0,64.27
臺中縣,后里鄉,中和村,0,1,1319,14,1333,2063,3,1,3,0,1,0,64.61
臺中縣,后里鄉,舊社村,0,1,877,17,894,1370,3,1,3,0,1,0,65.26
臺中縣,后里鄉,聯合村,0,1,950,12,962,1515,3,1,3,0,1,0,63.50
臺中縣,后里鄉,太平村,0,1,1316,22,1338,2018,3,1,3,0,1,0,66.30
臺中縣,后里鄉,眉山村,0,1,1744,17,1761,2835,3,1,3,0,1,0,62.12
臺中縣,后里鄉,月眉村,0,1,1002,11,1013,1546,3,1,3,0,1,0,65.52
臺中縣,后里鄉,公館村,0,1,1143,17,1160,1788,3,1,3,0,1,0,64.88
臺中縣,后里鄉,泰安村,0,1,826,12,838,1274,3,1,3,0,1,0,65.78
臺中縣,神岡鄉,神岡村,0,1,1583,20,1603,2556,3,1,3,0,1,0,62.72
臺中縣,神岡鄉,庄前村,0,1,966,4,970,1604,3,1,3,0,1,0,60.47
臺中縣,神岡鄉,北庄村,0,1,1350,19,1369,2156,3,1,3,0,1,0,63.50
臺中縣,神岡鄉,庄後村,0,1,1292,11,1303,1996,3,1,3,0,1,0,65.28
臺中縣,神岡鄉,圳前村,0,1,1346,17,1363,2108,3,1,3,0,1,0,64.66
臺中縣,神岡鄉,圳堵村,0,1,1211,20,1231,1892,3,1,3,0,1,0,65.06
臺中縣,神岡鄉,新庄村,0,1,2181,28,2209,3537,3,1,3,0,1,0,62.45
臺中縣,神岡鄉,山皮村,0,1,603,9,612,919,3,1,3,0,1,0,66.59
臺中縣,神岡鄉,社口村,0,1,3150,28,3178,5443,3,1,3,0,1,0,58.39
臺中縣,神岡鄉,社南村,0,1,2353,36,2389,4112,3,1,3,0,1,0,58.10
臺中縣,神岡鄉,三角村,0,1,1323,13,1336,2111,3,1,3,0,1,0,63.29
臺中縣,神岡鄉,大社村,0,1,1777,25,1802,3266,3,1,3,0,1,0,55.17
臺中縣,神岡鄉,岸裡村,0,1,1534,17,1551,2581,3,1,3,0,1,0,60.09
臺中縣,神岡鄉,豐洲村,0,1,3493,46,3539,6213,3,1,3,0,1,0,56.96
臺中縣,神岡鄉,神洲村,0,1,1408,18,1426,2260,3,1,3,0,1,0,63.10
臺中縣,神岡鄉,溪洲村,0,1,1661,40,1701,2483,3,1,3,0,1,0,68.51
臺中縣,潭子鄉,潭秀村,0,1,849,8,857,1377,3,1,3,0,1,0,62.24
臺中縣,潭子鄉,潭北村,0,1,1221,16,1237,2066,3,1,3,0,1,0,59.87
臺中縣,潭子鄉,潭陽村,0,1,4810,41,4851,8758,3,1,3,0,1,0,55.39
臺中縣,潭子鄉,福仁村,0,1,4059,32,4091,7344,3,1,3,0,1,0,55.71
臺中縣,潭子鄉,頭家村,0,1,1931,18,1949,3522,3,1,3,0,1,0,55.34
臺中縣,潭子鄉,頭家東村,0,1,1739,16,1755,3021,3,1,3,0,1,0,58.09
臺中縣,潭子鄉,家興村,0,1,1931,18,1949,3832,3,1,3,0,1,0,50.86
臺中縣,潭子鄉,家福村,0,1,1664,17,1681,2844,3,1,3,0,1,0,59.11
臺中縣,潭子鄉,甘蔗村,0,1,3645,33,3678,6591,3,1,3,0,1,0,55.80
臺中縣,潭子鄉,東寶村,0,1,5234,61,5295,8897,3,1,3,0,1,0,59.51
臺中縣,潭子鄉,大富村,0,1,1022,10,1032,1783,3,1,3,0,1,0,57.88
臺中縣,潭子鄉,大豐村,0,1,1951,21,1972,3527,3,1,3,0,1,0,55.91
臺中縣,潭子鄉,栗林村,0,1,2459,26,2485,4059,3,1,3,0,1,0,61.22
臺中縣,潭子鄉,嘉仁村,0,1,1918,23,1941,3216,3,1,3,0,1,0,60.35
臺中縣,潭子鄉,新田村,0,1,856,7,863,1422,3,1,3,0,1,0,60.69
臺中縣,潭子鄉,聚興村,0,1,1649,17,1666,2827,3,1,3,0,1,0,58.93
臺中縣,大雅鄉,上雅村,0,1,2088,41,2129,3760,3,1,3,0,1,0,56.62
臺中縣,大雅鄉,大雅村,0,1,2082,23,2105,3769,3,1,3,0,1,0,55.85
臺中縣,大雅鄉,文雅村,0,1,2397,15,2412,4404,3,1,3,0,1,0,54.77
臺中縣,大雅鄉,三和村,0,1,2074,19,2093,3801,3,1,3,0,1,0,55.06
臺中縣,大雅鄉,二和村,0,1,2059,17,2076,3782,3,1,3,0,1,0,54.89
臺中縣,大雅鄉,四德村,0,1,1696,14,1710,3182,3,1,3,0,1,0,53.74
臺中縣,大雅鄉,西寶村,0,1,1712,27,1739,3090,3,1,3,0,1,0,56.28
臺中縣,大雅鄉,上楓村,0,1,5547,79,5626,10213,3,1,3,0,1,0,55.09
臺中縣,大雅鄉,員林村,0,1,3556,37,3593,6126,3,1,3,0,1,0,58.65
臺中縣,大雅鄉,六寶村,0,1,3089,49,3138,5237,3,1,3,0,1,0,59.92
臺中縣,大雅鄉,秀山村,0,1,1786,20,1806,2715,3,1,3,0,1,0,66.52
臺中縣,大雅鄉,橫山村,0,1,2136,38,2174,3349,3,1,3,0,1,0,64.91
臺中縣,大雅鄉,忠義村,0,1,1985,13,1998,3150,3,1,3,0,1,0,63.43
臺中縣,新社鄉,新社村,0,1,1726,12,1738,2826,3,1,3,0,1,0,61.50
臺中縣,新社鄉,復盛村,0,1,1017,12,1029,1701,3,1,3,0,1,0,60.49
臺中縣,新社鄉,中正村,0,1,821,7,828,1261,3,1,3,0,1,0,65.66
臺中縣,新社鄉,月湖村,0,1,552,4,556,909,3,1,3,0,1,0,61.17
臺中縣,新社鄉,崑山村,0,1,724,11,735,1185,3,1,3,0,1,0,62.03
臺中縣,新社鄉,大南村,0,1,1192,9,1201,1922,3,1,3,0,1,0,62.49
臺中縣,新社鄉,永源村,0,1,1705,26,1731,2625,3,1,3,0,1,0,65.94
臺中縣,新社鄉,中興村,0,1,442,4,446,693,3,1,3,0,1,0,64.36
臺中縣,新社鄉,協成村,0,1,1651,14,1665,2572,3,1,3,0,1,0,64.74
臺中縣,新社鄉,東興村,0,1,791,3,794,1265,3,1,3,0,1,0,62.77
臺中縣,新社鄉,慶西村,0,1,550,4,554,890,3,1,3,0,1,0,62.25
臺中縣,新社鄉,中和村,0,1,363,2,365,586,3,1,3,0,1,0,62.29
臺中縣,新社鄉,福興村,0,1,782,5,787,1274,3,1,3,0,1,0,61.77
臺中縣,石岡鄉,石岡村,0,1,645,12,657,1052,3,1,3,0,1,0,62.45
臺中縣,石岡鄉,萬安村,0,1,729,8,737,1171,3,1,3,0,1,0,62.94
臺中縣,石岡鄉,九房村,0,1,655,16,671,1056,3,1,3,0,1,0,63.54
臺中縣,石岡鄉,金星村,0,1,733,15,748,1219,3,1,3,0,1,0,61.36
臺中縣,石岡鄉,龍興村,0,1,436,11,447,684,3,1,3,0,1,0,65.35
臺中縣,石岡鄉,萬興村,0,1,858,26,884,1386,3,1,3,0,1,0,63.78
臺中縣,石岡鄉,梅子村,0,1,1065,11,1076,1720,3,1,3,0,1,0,62.56
臺中縣,石岡鄉,土牛村,0,1,558,5,563,945,3,1,3,0,1,0,59.58
臺中縣,石岡鄉,德興村,0,1,768,9,777,1274,3,1,3,0,1,0,60.99
臺中縣,石岡鄉,和盛村,0,1,779,1,780,1224,3,1,3,0,1,0,63.73
臺中縣,外埔鄉,永豐村,0,1,632,13,645,991,3,1,3,0,1,0,65.09
臺中縣,外埔鄉,六分村,0,1,942,12,954,1544,3,1,3,0,1,0,61.79
臺中縣,外埔鄉,大同村,0,1,2119,10,2129,3549,3,1,3,0,1,0,59.99
臺中縣,外埔鄉,大東村,0,1,2739,54,2793,4708,3,1,3,0,1,0,59.32
臺中縣,外埔鄉,三崁村,0,1,983,12,995,1703,3,1,3,0,1,0,58.43
臺中縣,外埔鄉,水美村,0,1,1680,20,1700,2882,3,1,3,0,1,0,58.99
臺中縣,外埔鄉,鐵山村,0,1,1274,22,1296,2069,3,1,3,0,1,0,62.64
臺中縣,外埔鄉,中山村,0,1,649,9,658,1050,3,1,3,0,1,0,62.67
臺中縣,外埔鄉,馬鳴村,0,1,875,8,883,1342,3,1,3,0,1,0,65.80
臺中縣,外埔鄉,土城村,0,1,1014,13,1027,1543,3,1,3,0,1,0,66.56
臺中縣,外埔鄉,部子村,0,1,738,19,757,1176,3,1,3,0,1,0,64.37
臺中縣,大安鄉,南埔村,0,1,662,6,668,1067,3,1,3,0,1,0,62.61
臺中縣,大安鄉,南庄村,0,1,697,13,710,1106,3,1,3,0,1,0,64.20
臺中縣,大安鄉,中庄村,0,1,1348,17,1365,2408,3,1,3,0,1,0,56.69
臺中縣,大安鄉,東安村,0,1,763,6,769,1196,3,1,3,0,1,0,64.30
臺中縣,大安鄉,福興村,0,1,723,12,735,1144,3,1,3,0,1,0,64.25
臺中縣,大安鄉,龜殼村,0,1,1113,12,1125,1577,3,1,3,0,1,0,71.34
臺中縣,大安鄉,頂安村,0,1,531,4,535,877,3,1,3,0,1,0,61.00
臺中縣,大安鄉,永安村,0,1,1018,10,1028,1631,3,1,3,0,1,0,63.03
臺中縣,大安鄉,福住村,0,1,538,5,543,981,3,1,3,0,1,0,55.35
臺中縣,大安鄉,海墘村,0,1,852,14,866,1370,3,1,3,0,1,0,63.21
臺中縣,大安鄉,西安村,0,1,826,8,834,1379,3,1,3,0,1,0,60.48
臺中縣,大安鄉,松雅村,0,1,565,5,570,778,3,1,3,0,1,0,73.26
臺中縣,烏日鄉,烏日村,0,1,3654,28,3682,5936,3,1,3,0,1,0,62.03
臺中縣,烏日鄉,湖日村,0,1,1253,12,1265,2111,3,1,3,0,1,0,59.92
臺中縣,烏日鄉,三和村,0,1,2110,33,2143,3314,3,1,3,0,1,0,64.67
臺中縣,烏日鄉,榮泉村,0,1,1684,22,1706,2541,3,1,3,0,1,0,67.14
臺中縣,烏日鄉,學田村,0,1,1178,13,1191,1938,3,1,3,0,1,0,61.46
臺中縣,烏日鄉,九德村,0,1,5464,48,5512,9579,3,1,3,0,1,0,57.54
臺中縣,烏日鄉,仁德村,0,1,3089,30,3119,5397,3,1,3,0,1,0,57.79
臺中縣,烏日鄉,前竹村,0,1,1375,20,1395,2073,3,1,3,0,1,0,67.29
臺中縣,烏日鄉,五光村,0,1,988,9,997,1464,3,1,3,0,1,0,68.10
臺中縣,烏日鄉,光明村,0,1,1305,10,1315,1999,3,1,3,0,1,0,65.78
臺中縣,烏日鄉,東園村,0,1,1113,11,1124,1635,3,1,3,0,1,0,68.75
臺中縣,烏日鄉,溪埧村,0,1,2221,37,2258,3652,3,1,3,0,1,0,61.83
臺中縣,烏日鄉,螺潭村,0,1,950,20,970,1495,3,1,3,0,1,0,64.88
臺中縣,烏日鄉,北里村,0,1,864,12,876,1412,3,1,3,0,1,0,62.04
臺中縣,烏日鄉,南里村,0,1,693,8,701,1093,3,1,3,0,1,0,64.14
臺中縣,烏日鄉,溪尾村,0,1,496,6,502,807,3,1,3,0,1,0,62.21
臺中縣,大肚鄉,王田村,0,1,2371,23,2394,3700,3,1,3,0,1,0,64.70
臺中縣,大肚鄉,中和村,0,1,557,4,561,802,3,1,3,0,1,0,69.95
臺中縣,大肚鄉,福山村,0,1,2033,23,2056,3257,3,1,3,0,1,0,63.13
臺中縣,大肚鄉,營埔村,0,1,881,13,894,1292,3,1,3,0,1,0,69.20
臺中縣,大肚鄉,社腳村,0,1,1470,22,1492,2240,3,1,3,0,1,0,66.61
臺中縣,大肚鄉,新興村,0,1,1317,10,1327,2244,3,1,3,0,1,0,59.14
臺中縣,大肚鄉,大東村,0,1,1577,9,1586,2593,3,1,3,0,1,0,61.16
臺中縣,大肚鄉,大肚村,0,1,1199,11,1210,1821,3,1,3,0,1,0,66.45
臺中縣,大肚鄉,永和村,0,1,529,8,537,832,3,1,3,0,1,0,64.54
臺中縣,大肚鄉,磺溪村,0,1,922,12,934,1336,3,1,3,0,1,0,69.91
臺中縣,大肚鄉,永順村,0,1,1013,10,1023,1471,3,1,3,0,1,0,69.54
臺中縣,大肚鄉,成功村,0,1,608,9,617,885,3,1,3,0,1,0,69.72
臺中縣,大肚鄉,山陽村,0,1,842,8,850,1324,3,1,3,0,1,0,64.20
臺中縣,大肚鄉,頂街村,0,1,2941,29,2970,4952,3,1,3,0,1,0,59.98
臺中縣,大肚鄉,瑞井村,0,1,2381,32,2413,3820,3,1,3,0,1,0,63.17
臺中縣,大肚鄉,蔗部村,0,1,1943,28,1971,3461,3,1,3,0,1,0,56.95
臺中縣,大肚鄉,自強村,0,1,1837,26,1863,2944,3,1,3,0,1,0,63.28
臺中縣,龍井鄉,竹坑村,0,1,1372,13,1385,2272,3,1,3,0,1,0,60.96
臺中縣,龍井鄉,龍東村,0,1,1422,10,1432,2403,3,1,3,0,1,0,59.59
臺中縣,龍井鄉,龍西村,0,1,1062,14,1076,1612,3,1,3,0,1,0,66.75
臺中縣,龍井鄉,田中村,0,1,1534,18,1552,2603,3,1,3,0,1,0,59.62
臺中縣,龍井鄉,福田村,0,1,639,6,645,994,3,1,3,0,1,0,64.89
臺中縣,龍井鄉,麗水村,0,1,1373,11,1384,1973,3,1,3,0,1,0,70.15
臺中縣,龍井鄉,龍津村,0,1,2770,29,2799,4317,3,1,3,0,1,0,64.84
臺中縣,龍井鄉,三德村,0,1,1498,37,1535,2538,3,1,3,0,1,0,60.48
臺中縣,龍井鄉,忠和村,0,1,2468,30,2498,3917,3,1,3,0,1,0,63.77
臺中縣,龍井鄉,山腳村,0,1,2232,19,2251,3933,3,1,3,0,1,0,57.23
臺中縣,龍井鄉,龍泉村,0,1,2564,30,2594,4453,3,1,3,0,1,0,58.25
臺中縣,龍井鄉,龍崗村,0,1,1188,15,1203,2059,3,1,3,0,1,0,58.43
臺中縣,龍井鄉,新庄村,0,1,2635,24,2659,4657,3,1,3,0,1,0,57.10
臺中縣,龍井鄉,南寮村,0,1,900,8,908,1364,3,1,3,0,1,0,66.57
臺中縣,龍井鄉,東海村,0,1,3045,24,3069,5609,3,1,3,0,1,0,54.72
臺中縣,龍井鄉,新東村,0,1,1748,16,1764,3201,3,1,3,0,1,0,55.11
臺中縣,霧峰鄉,桐林村,0,1,732,7,739,1121,3,1,3,0,1,0,65.92
臺中縣,霧峰鄉,吉峰村,0,1,4259,46,4305,7476,3,1,3,0,1,0,57.58
臺中縣,霧峰鄉,甲寅村,0,1,2304,27,2331,3990,3,1,3,0,1,0,58.42
臺中縣,霧峰鄉,本鄉村,0,1,1158,14,1172,1809,3,1,3,0,1,0,64.79
臺中縣,霧峰鄉,中正村,0,1,1027,9,1036,1586,3,1,3,0,1,0,65.32
臺中縣,霧峰鄉,錦榮村,0,1,583,8,591,937,3,1,3,0,1,0,63.07
臺中縣,霧峰鄉,萊園村,0,1,653,4,657,1077,3,1,3,0,1,0,61.00
臺中縣,霧峰鄉,本堂村,0,1,2822,30,2852,4866,3,1,3,0,1,0,58.61
臺中縣,霧峰鄉,北柳村,0,1,1863,19,1882,3073,3,1,3,0,1,0,61.24
臺中縣,霧峰鄉,南柳村,0,1,896,12,908,1458,3,1,3,0,1,0,62.28
臺中縣,霧峰鄉,四德村,0,1,1241,9,1250,2000,3,1,3,0,1,0,62.50
臺中縣,霧峰鄉,五福村,0,1,1593,23,1616,2388,3,1,3,0,1,0,67.67
臺中縣,霧峰鄉,丁臺村,0,1,1236,12,1248,1982,3,1,3,0,1,0,62.97
臺中縣,霧峰鄉,北勢村,0,1,1038,14,1052,1685,3,1,3,0,1,0,62.43
臺中縣,霧峰鄉,南勢村,0,1,721,6,727,1163,3,1,3,0,1,0,62.51
臺中縣,霧峰鄉,萬豐村,0,1,1463,23,1486,2400,3,1,3,0,1,0,61.92
臺中縣,霧峰鄉,舊正村,0,1,1236,17,1253,1967,3,1,3,0,1,0,63.70
臺中縣,霧峰鄉,坑口村,0,1,1826,17,1843,2850,3,1,3,0,1,0,64.67
臺中縣,霧峰鄉,峰谷村,0,1,650,2,652,1039,3,1,3,0,1,0,62.75
臺中縣,霧峰鄉,六股村,0,1,1447,30,1477,2198,3,1,3,0,1,0,67.20
臺中縣,和平鄉,南勢村,0,1,851,5,856,1405,3,1,3,0,1,0,60.93
臺中縣,和平鄉,天輪村,0,1,249,1,250,459,3,1,3,0,1,0,54.47
臺中縣,和平鄉,博愛村,0,1,580,7,587,1031,3,1,3,0,1,0,56.94
臺中縣,和平鄉,自由村,0,1,279,1,280,526,3,1,3,0,1,0,53.23
臺中縣,和平鄉,達觀村,0,1,294,1,295,541,3,1,3,0,1,0,54.53
臺中縣,和平鄉,中坑村,0,1,226,1,227,371,3,1,3,0,1,0,61.19
臺中縣,和平鄉,梨山村,0,1,474,3,477,1304,3,1,3,0,1,0,36.58
臺中縣,和平鄉,平等村,0,1,144,0,144,373,3,1,3,0,1,0,38.61
彰化縣,彰化市,桃源里,0,1,1763,15,1778,2734,3,1,3,0,1,0,65.03
彰化縣,彰化市,東興里,0,1,1045,7,1052,1591,3,1,3,0,1,0,66.12
彰化縣,彰化市,華北里,0,1,957,6,963,1519,3,1,3,0,1,0,63.40
彰化縣,彰化市,華陽里,0,1,1357,9,1366,2060,3,1,3,0,1,0,66.31
彰化縣,彰化市,大同里,0,1,692,6,698,1002,3,1,3,0,1,0,69.66
彰化縣,彰化市,永生里,0,1,1001,11,1012,1381,3,1,3,0,1,0,73.28
彰化縣,彰化市,卦山里,0,1,1505,14,1519,2344,3,1,3,0,1,0,64.80
彰化縣,彰化市,光復里,0,1,493,6,499,758,3,1,3,0,1,0,65.83
彰化縣,彰化市,永福里,0,1,623,8,631,930,3,1,3,0,1,0,67.85
彰化縣,彰化市,光華里,0,1,533,0,533,799,3,1,3,0,1,0,66.71
彰化縣,彰化市,中正里,0,1,910,14,924,1423,3,1,3,0,1,0,64.93
彰化縣,彰化市,中山里,0,1,508,6,514,792,3,1,3,0,1,0,64.90
彰化縣,彰化市,龍山里,0,1,1460,7,1467,2232,3,1,3,0,1,0,65.73
彰化縣,彰化市,建寶里,0,1,1624,9,1633,2323,3,1,3,0,1,0,70.30
彰化縣,彰化市,光南里,0,1,1000,13,1013,1397,3,1,3,0,1,0,72.51
彰化縣,彰化市,介壽里,0,1,1288,17,1305,2144,3,1,3,0,1,0,60.87
彰化縣,彰化市,延平里,0,1,3918,36,3954,6248,3,1,3,0,1,0,63.28
彰化縣,彰化市,延和里,0,1,2485,22,2507,3629,3,1,3,0,1,0,69.08
彰化縣,彰化市,南興里,0,1,3345,24,3369,5255,3,1,3,0,1,0,64.11
彰化縣,彰化市,南瑤里,0,1,4104,46,4150,6512,3,1,3,0,1,0,63.73
彰化縣,彰化市,成功里,0,1,1012,9,1021,1500,3,1,3,0,1,0,68.07
彰化縣,彰化市,福安里,0,1,746,6,752,1062,3,1,3,0,1,0,70.81
彰化縣,彰化市,西安里,0,1,1890,23,1913,2783,3,1,3,0,1,0,68.74
彰化縣,彰化市,彰安里,0,1,1996,16,2012,3067,3,1,3,0,1,0,65.60
彰化縣,彰化市,中央里,0,1,626,6,632,884,3,1,3,0,1,0,71.49
彰化縣,彰化市,富貴里,0,1,647,6,653,972,3,1,3,0,1,0,67.18
彰化縣,彰化市,民權里,0,1,839,13,852,1198,3,1,3,0,1,0,71.12
彰化縣,彰化市,萬壽里,0,1,657,7,664,968,3,1,3,0,1,0,68.60
彰化縣,彰化市,西興里,0,1,1642,18,1660,2469,3,1,3,0,1,0,67.23
彰化縣,彰化市,長樂里,0,1,845,7,852,1229,3,1,3,0,1,0,69.32
彰化縣,彰化市,西勢里,0,1,1810,19,1829,2662,3,1,3,0,1,0,68.71
彰化縣,彰化市,忠權里,0,1,1783,16,1799,2769,3,1,3,0,1,0,64.97
彰化縣,彰化市,忠孝里,0,1,777,10,787,1178,3,1,3,0,1,0,66.81
彰化縣,彰化市,五權里,0,1,2065,22,2087,3327,3,1,3,0,1,0,62.73
彰化縣,彰化市,平和里,0,1,2249,18,2267,3539,3,1,3,0,1,0,64.06
彰化縣,彰化市,崙平里,0,1,2922,31,2953,4468,3,1,3,0,1,0,66.09
彰化縣,彰化市,向陽里,0,1,1996,19,2015,3048,3,1,3,0,1,0,66.11
彰化縣,彰化市,莿桐里,0,1,1674,17,1691,2511,3,1,3,0,1,0,67.34
彰化縣,彰化市,南美里,0,1,1056,14,1070,1511,3,1,3,0,1,0,70.81
彰化縣,彰化市,南安里,0,1,1173,7,1180,1781,3,1,3,0,1,0,66.25
彰化縣,彰化市,東芳里,0,1,1918,22,1940,2855,3,1,3,0,1,0,67.95
彰化縣,彰化市,磚窯里,0,1,1815,23,1838,2747,3,1,3,0,1,0,66.91
彰化縣,彰化市,新興里,0,1,2592,38,2630,3998,3,1,3,0,1,0,65.78
彰化縣,彰化市,新華里,0,1,1171,11,1182,1792,3,1,3,0,1,0,65.96
彰化縣,彰化市,興北里,0,1,1019,9,1028,1589,3,1,3,0,1,0,64.69
彰化縣,彰化市,信義里,0,1,641,8,649,951,3,1,3,0,1,0,68.24
彰化縣,彰化市,民生里,0,1,964,9,973,1496,3,1,3,0,1,0,65.04
彰化縣,彰化市,文化里,0,1,940,5,945,1445,3,1,3,0,1,0,65.40
彰化縣,彰化市,陽明里,0,1,1172,7,1179,1727,3,1,3,0,1,0,68.27
彰化縣,彰化市,萬安里,0,1,2502,17,2519,3780,3,1,3,0,1,0,66.64
彰化縣,彰化市,下部里,0,1,2499,16,2515,3747,3,1,3,0,1,0,67.12
彰化縣,彰化市,茄苳里,0,1,580,9,589,818,3,1,3,0,1,0,72.00
彰化縣,彰化市,茄南里,0,1,1565,10,1575,2224,3,1,3,0,1,0,70.82
彰化縣,彰化市,寶部里,0,1,746,6,752,1042,3,1,3,0,1,0,72.17
彰化縣,彰化市,古夷里,0,1,1457,16,1473,2258,3,1,3,0,1,0,65.23
彰化縣,彰化市,阿夷里,0,1,3723,45,3768,5828,3,1,3,0,1,0,64.65
彰化縣,彰化市,和調里,0,1,1438,17,1455,2288,3,1,3,0,1,0,63.59
彰化縣,彰化市,復興里,0,1,2649,29,2678,3982,3,1,3,0,1,0,67.25
彰化縣,彰化市,中庄里,0,1,1389,19,1408,2145,3,1,3,0,1,0,65.64
彰化縣,彰化市,竹中里,0,1,1065,18,1083,1631,3,1,3,0,1,0,66.40
彰化縣,彰化市,香山里,0,1,1783,19,1802,2626,3,1,3,0,1,0,68.62
彰化縣,彰化市,牛埔里,0,1,1993,18,2011,2820,3,1,3,0,1,0,71.31
彰化縣,彰化市,台鳳里,0,1,2321,17,2338,3654,3,1,3,0,1,0,63.98
彰化縣,彰化市,國聖里,0,1,1627,12,1639,2242,3,1,3,0,1,0,73.10
彰化縣,彰化市,福山里,0,1,3761,43,3804,6011,3,1,3,0,1,0,63.28
彰化縣,彰化市,安溪里,0,1,716,26,742,1109,3,1,3,0,1,0,66.91
彰化縣,彰化市,三村里,0,1,731,4,735,987,3,1,3,0,1,0,74.47
彰化縣,彰化市,大竹里,0,1,1821,20,1841,2719,3,1,3,0,1,0,67.71
彰化縣,彰化市,田中里,0,1,652,3,655,803,3,1,3,0,1,0,81.57
彰化縣,彰化市,快官里,0,1,686,7,693,993,3,1,3,0,1,0,69.79
彰化縣,彰化市,竹巷里,0,1,570,3,573,782,3,1,3,0,1,0,73.27
彰化縣,彰化市,福田里,0,1,882,6,888,1201,3,1,3,0,1,0,73.94
彰化縣,彰化市,石牌里,0,1,812,12,824,1133,3,1,3,0,1,0,72.73
彰化縣,花壇鄉,花壇村,0,1,1997,12,2009,2805,3,1,3,0,1,0,71.62
彰化縣,花壇鄉,金墩村,0,1,1124,15,1139,1611,3,1,3,0,1,0,70.70
彰化縣,花壇鄉,中庄村,0,1,1511,14,1525,2216,3,1,3,0,1,0,68.82
彰化縣,花壇鄉,劉厝村,0,1,712,11,723,1015,3,1,3,0,1,0,71.23
彰化縣,花壇鄉,崙雅村,0,1,964,9,973,1332,3,1,3,0,1,0,73.05
彰化縣,花壇鄉,南口村,0,1,1018,15,1033,1472,3,1,3,0,1,0,70.18
彰化縣,花壇鄉,中口村,0,1,498,2,500,681,3,1,3,0,1,0,73.42
彰化縣,花壇鄉,北口村,0,1,1144,11,1155,1568,3,1,3,0,1,0,73.66
彰化縣,花壇鄉,長沙村,0,1,2725,30,2755,3957,3,1,3,0,1,0,69.62
彰化縣,花壇鄉,文德村,0,1,1561,19,1580,2349,3,1,3,0,1,0,67.26
彰化縣,花壇鄉,白沙村,0,1,2381,23,2404,3694,3,1,3,0,1,0,65.08
彰化縣,花壇鄉,岩竹村,0,1,900,10,910,1299,3,1,3,0,1,0,70.05
彰化縣,花壇鄉,橋頭村,0,1,1944,28,1972,2944,3,1,3,0,1,0,66.98
彰化縣,花壇鄉,灣雅村,0,1,561,5,566,832,3,1,3,0,1,0,68.03
彰化縣,花壇鄉,灣東村,0,1,592,5,597,952,3,1,3,0,1,0,62.71
彰化縣,花壇鄉,三春村,0,1,1026,7,1033,1623,3,1,3,0,1,0,63.65
彰化縣,花壇鄉,永春村,0,1,882,9,891,1472,3,1,3,0,1,0,60.53
彰化縣,花壇鄉,長春村,0,1,953,8,961,1460,3,1,3,0,1,0,65.82
彰化縣,芬園鄉,舊社村,0,1,1201,21,1222,1692,3,1,3,0,1,0,72.22
彰化縣,芬園鄉,大埔村,0,1,981,12,993,1339,3,1,3,0,1,0,74.16
彰化縣,芬園鄉,竹林村,0,1,1155,23,1178,1616,3,1,3,0,1,0,72.90
彰化縣,芬園鄉,楓坑村,0,1,429,3,432,561,3,1,3,0,1,0,77.01
彰化縣,芬園鄉,社口村,0,1,1608,16,1624,2251,3,1,3,0,1,0,72.15
彰化縣,芬園鄉,茄荖村,0,1,1473,23,1496,2178,3,1,3,0,1,0,68.69
彰化縣,芬園鄉,嘉興村,0,1,1045,24,1069,1539,3,1,3,0,1,0,69.46
彰化縣,芬園鄉,芬園村,0,1,621,19,640,887,3,1,3,0,1,0,72.15
彰化縣,芬園鄉,進芬村,0,1,673,9,682,937,3,1,3,0,1,0,72.79
彰化縣,芬園鄉,縣庄村,0,1,726,9,735,1054,3,1,3,0,1,0,69.73
彰化縣,芬園鄉,圳墘村,0,1,468,5,473,672,3,1,3,0,1,0,70.39
彰化縣,芬園鄉,溪頭村,0,1,1036,11,1047,1470,3,1,3,0,1,0,71.22
彰化縣,芬園鄉,同安村,0,1,871,9,880,1240,3,1,3,0,1,0,70.97
彰化縣,芬園鄉,中崙村,0,1,651,8,659,973,3,1,3,0,1,0,67.73
彰化縣,芬園鄉,大竹村,0,1,678,10,688,1046,3,1,3,0,1,0,65.77
彰化縣,鹿港鎮,大有里,0,1,805,7,812,1167,3,1,3,0,1,0,69.58
彰化縣,鹿港鎮,中興里,0,1,373,4,377,556,3,1,3,0,1,0,67.81
彰化縣,鹿港鎮,洛津里,0,1,662,7,669,976,3,1,3,0,1,0,68.55
彰化縣,鹿港鎮,順興里,0,1,611,6,617,856,3,1,3,0,1,0,72.08
彰化縣,鹿港鎮,菜園里,0,1,679,6,685,978,3,1,3,0,1,0,70.04
彰化縣,鹿港鎮,街尾里,0,1,1265,14,1279,1919,3,1,3,0,1,0,66.65
彰化縣,鹿港鎮,泰興里,0,1,761,15,776,1176,3,1,3,0,1,0,65.99
彰化縣,鹿港鎮,長興里,0,1,209,2,211,322,3,1,3,0,1,0,65.53
彰化縣,鹿港鎮,興化里,0,1,497,5,502,648,3,1,3,0,1,0,77.47
彰化縣,鹿港鎮,龍山里,0,1,548,4,552,753,3,1,3,0,1,0,73.31
彰化縣,鹿港鎮,景福里,0,1,824,15,839,1125,3,1,3,0,1,0,74.58
彰化縣,鹿港鎮,郭厝里,0,1,398,4,402,595,3,1,3,0,1,0,67.56
彰化縣,鹿港鎮,新宮里,0,1,665,1,666,925,3,1,3,0,1,0,72.00
彰化縣,鹿港鎮,玉順里,0,1,864,11,875,1268,3,1,3,0,1,0,69.01
彰化縣,鹿港鎮,東石里,0,1,2262,16,2278,3357,3,1,3,0,1,0,67.86
彰化縣,鹿港鎮,永安里,0,1,2552,18,2570,3718,3,1,3,0,1,0,69.12
彰化縣,鹿港鎮,埔崙里,0,1,2210,24,2234,3385,3,1,3,0,1,0,66.00
彰化縣,鹿港鎮,頂厝里,0,1,3817,38,3855,5534,3,1,3,0,1,0,69.66
彰化縣,鹿港鎮,東崎里,0,1,2778,32,2810,4202,3,1,3,0,1,0,66.87
彰化縣,鹿港鎮,廖厝里,0,1,2271,29,2300,3187,3,1,3,0,1,0,72.17
彰化縣,鹿港鎮,詔安里,0,1,1142,14,1156,1651,3,1,3,0,1,0,70.02
彰化縣,鹿港鎮,海埔里,0,1,2104,24,2128,2905,3,1,3,0,1,0,73.25
彰化縣,鹿港鎮,洋厝里,0,1,1687,11,1698,2333,3,1,3,0,1,0,72.78
彰化縣,鹿港鎮,草中里,0,1,2023,21,2044,2873,3,1,3,0,1,0,71.15
彰化縣,鹿港鎮,山崙里,0,1,2099,21,2120,2887,3,1,3,0,1,0,73.43
彰化縣,鹿港鎮,頭南里,0,1,1260,17,1277,1807,3,1,3,0,1,0,70.67
彰化縣,鹿港鎮,頭崙里,0,1,1667,12,1679,2218,3,1,3,0,1,0,75.70
彰化縣,鹿港鎮,頂番里,0,1,2133,18,2151,3119,3,1,3,0,1,0,68.96
彰化縣,鹿港鎮,溝墘里,0,1,2528,29,2557,3475,3,1,3,0,1,0,73.58
彰化縣,褔興鄉,番婆村,0,1,1456,20,1476,2082,3,1,3,0,1,0,70.89
彰化縣,褔興鄉,大崙村,0,1,804,7,811,1099,3,1,3,0,1,0,73.79
彰化縣,褔興鄉,外埔村,0,1,796,21,817,1077,3,1,3,0,1,0,75.86
彰化縣,褔興鄉,三汴村,0,1,920,17,937,1242,3,1,3,0,1,0,75.44
彰化縣,褔興鄉,萬豐村,0,1,517,10,527,727,3,1,3,0,1,0,72.49
彰化縣,褔興鄉,外中村,0,1,887,14,901,1159,3,1,3,0,1,0,77.74
彰化縣,褔興鄉,元中村,0,1,795,14,809,1081,3,1,3,0,1,0,74.84
彰化縣,褔興鄉,橋頭村,0,1,1575,17,1592,2201,3,1,3,0,1,0,72.33
彰化縣,褔興鄉,社尾村,0,1,1021,26,1047,1342,3,1,3,0,1,0,78.02
彰化縣,褔興鄉,番社村,0,1,975,14,989,1273,3,1,3,0,1,0,77.69
彰化縣,褔興鄉,同安村,0,1,1526,19,1545,2093,3,1,3,0,1,0,73.82
彰化縣,褔興鄉,西勢村,0,1,1207,11,1218,1686,3,1,3,0,1,0,72.24
彰化縣,褔興鄉,秀厝村,0,1,1460,21,1481,2092,3,1,3,0,1,0,70.79
彰化縣,褔興鄉,鎮平村,0,1,817,10,827,1100,3,1,3,0,1,0,75.18
彰化縣,褔興鄉,三和村,0,1,782,7,789,1033,3,1,3,0,1,0,76.38
彰化縣,褔興鄉,麥厝村,0,1,1518,22,1540,2102,3,1,3,0,1,0,73.26
彰化縣,褔興鄉,廈粘村,0,1,1359,16,1375,1826,3,1,3,0,1,0,75.30
彰化縣,褔興鄉,頂粘村,0,1,1561,24,1585,2088,3,1,3,0,1,0,75.91
彰化縣,褔興鄉,福寶村,0,1,872,11,883,1192,3,1,3,0,1,0,74.08
彰化縣,褔興鄉,二港村,0,1,958,14,972,1272,3,1,3,0,1,0,76.42
彰化縣,褔興鄉,福興村,0,1,1972,23,1995,2862,3,1,3,0,1,0,69.71
彰化縣,褔興鄉,福南村,0,1,1606,17,1623,2177,3,1,3,0,1,0,74.55
彰化縣,秀水鄉,秀水村,0,1,1118,13,1131,1616,3,1,3,0,1,0,69.99
彰化縣,秀水鄉,安溪村,0,1,1037,18,1055,1480,3,1,3,0,1,0,71.28
彰化縣,秀水鄉,莊雅村,0,1,1413,12,1425,2069,3,1,3,0,1,0,68.87
彰化縣,秀水鄉,陝西村,0,1,877,11,888,1186,3,1,3,0,1,0,74.87
彰化縣,秀水鄉,金興村,0,1,1169,18,1187,1658,3,1,3,0,1,0,71.59
彰化縣,秀水鄉,安東村,0,1,2201,38,2239,3262,3,1,3,0,1,0,68.64
彰化縣,秀水鄉,鶴鳴村,0,1,1891,19,1910,2652,3,1,3,0,1,0,72.02
彰化縣,秀水鄉,馬興村,0,1,1464,15,1479,1999,3,1,3,0,1,0,73.99
彰化縣,秀水鄉,義興村,0,1,847,8,855,1129,3,1,3,0,1,0,75.73
彰化縣,秀水鄉,福安村,0,1,2438,35,2473,3573,3,1,3,0,1,0,69.21
彰化縣,秀水鄉,埔崙村,0,1,1185,13,1198,1756,3,1,3,0,1,0,68.22
彰化縣,秀水鄉,曾厝村,0,1,1035,15,1050,1366,3,1,3,0,1,0,76.87
彰化縣,秀水鄉,金陵村,0,1,1022,10,1032,1428,3,1,3,0,1,0,72.27
彰化縣,秀水鄉,下崙村,0,1,1411,17,1428,1908,3,1,3,0,1,0,74.84
彰化縣,和美鎮,竹營里,0,1,2725,33,2758,4182,3,1,3,0,1,0,65.95
彰化縣,和美鎮,和東里,0,1,2271,17,2288,3557,3,1,3,0,1,0,64.32
彰化縣,和美鎮,和南里,0,1,351,2,353,444,3,1,3,0,1,0,79.50
彰化縣,和美鎮,和北里,0,1,934,10,944,1401,3,1,3,0,1,0,67.38
彰化縣,和美鎮,和西里,0,1,1991,17,2008,3115,3,1,3,0,1,0,64.46
彰化縣,和美鎮,四張里,0,1,1565,15,1580,2426,3,1,3,0,1,0,65.13
彰化縣,和美鎮,頭前里,0,1,990,17,1007,1389,3,1,3,0,1,0,72.50
彰化縣,和美鎮,還社里,0,1,609,1,610,778,3,1,3,0,1,0,78.41
彰化縣,和美鎮,面前里,0,1,1238,19,1257,1726,3,1,3,0,1,0,72.83
彰化縣,和美鎮,鎮平里,0,1,1665,19,1684,2446,3,1,3,0,1,0,68.85
彰化縣,和美鎮,大霞里,0,1,917,6,923,1246,3,1,3,0,1,0,74.08
彰化縣,和美鎮,源埤里,0,1,1141,14,1155,1543,3,1,3,0,1,0,74.85
彰化縣,和美鎮,南佃里,0,1,1198,13,1211,1760,3,1,3,0,1,0,68.81
彰化縣,和美鎮,雅溝里,0,1,872,11,883,1238,3,1,3,0,1,0,71.32
彰化縣,和美鎮,山犁里,0,1,3641,29,3670,5672,3,1,3,0,1,0,64.70
彰化縣,和美鎮,嘉犁里,0,1,1027,15,1042,1544,3,1,3,0,1,0,67.49
彰化縣,和美鎮,詔安里,0,1,1120,9,1129,1715,3,1,3,0,1,0,65.83
彰化縣,和美鎮,鐵山里,0,1,1649,20,1669,2417,3,1,3,0,1,0,69.05
彰化縣,和美鎮,柑井里,0,1,1941,18,1959,2661,3,1,3,0,1,0,73.62
彰化縣,和美鎮,竹園里,0,1,620,10,630,793,3,1,3,0,1,0,79.45
彰化縣,和美鎮,新庄里,0,1,1483,20,1503,2271,3,1,3,0,1,0,66.18
彰化縣,和美鎮,犁盛里,0,1,1477,19,1496,2070,3,1,3,0,1,0,72.27
彰化縣,和美鎮,中寮里,0,1,802,10,812,1083,3,1,3,0,1,0,74.98
彰化縣,和美鎮,中圍里,0,1,1714,26,1740,2578,3,1,3,0,1,0,67.49
彰化縣,和美鎮,糖友里,0,1,1929,17,1946,2772,3,1,3,0,1,0,70.20
彰化縣,和美鎮,塗厝里,0,1,1118,10,1128,1652,3,1,3,0,1,0,68.28
彰化縣,和美鎮,地潭里,0,1,584,9,593,856,3,1,3,0,1,0,69.28
彰化縣,和美鎮,湖內里,0,1,833,8,841,1205,3,1,3,0,1,0,69.79
彰化縣,和美鎮,嘉寶里,0,1,1259,26,1285,1714,3,1,3,0,1,0,74.97
彰化縣,和美鎮,月眉里,0,1,1905,22,1927,2855,3,1,3,0,1,0,67.50
彰化縣,和美鎮,好修里,0,1,1201,10,1211,1643,3,1,3,0,1,0,73.71
彰化縣,線西鄉,線西村,0,1,1332,22,1354,1930,3,1,3,0,1,0,70.16
彰化縣,線西鄉,頂庄村,0,1,780,15,795,1148,3,1,3,0,1,0,69.25
彰化縣,線西鄉,寓埔村,0,1,1336,26,1362,2019,3,1,3,0,1,0,67.46
彰化縣,線西鄉,塭仔村,0,1,872,10,882,1157,3,1,3,0,1,0,76.23
彰化縣,線西鄉,溝內村,0,1,710,6,716,1034,3,1,3,0,1,0,69.25
彰化縣,線西鄉,下犁村,0,1,1188,13,1201,1679,3,1,3,0,1,0,71.53
彰化縣,線西鄉,頂犁村,0,1,1531,15,1546,2167,3,1,3,0,1,0,71.34
彰化縣,線西鄉,德興村,0,1,794,7,801,1096,3,1,3,0,1,0,73.08
彰化縣,伸港鄉,新港村,0,1,2740,35,2775,4280,3,1,3,0,1,0,64.84
彰化縣,伸港鄉,什股村,0,1,1074,16,1090,1545,3,1,3,0,1,0,70.55
彰化縣,伸港鄉,大同村,0,1,873,10,883,1224,3,1,3,0,1,0,72.14
彰化縣,伸港鄉,海尾村,0,1,1210,19,1229,1630,3,1,3,0,1,0,75.40
彰化縣,伸港鄉,全興村,0,1,1109,9,1118,1550,3,1,3,0,1,0,72.13
彰化縣,伸港鄉,溪底村,0,1,1100,12,1112,1582,3,1,3,0,1,0,70.29
彰化縣,伸港鄉,定興村,0,1,1418,13,1431,2217,3,1,3,0,1,0,64.55
彰化縣,伸港鄉,泉州村,0,1,1214,18,1232,1692,3,1,3,0,1,0,72.81
彰化縣,伸港鄉,泉厝村,0,1,823,9,832,1200,3,1,3,0,1,0,69.33
彰化縣,伸港鄉,曾家村,0,1,1010,18,1028,1491,3,1,3,0,1,0,68.95
彰化縣,伸港鄉,蚵寮村,0,1,814,11,825,1144,3,1,3,0,1,0,72.12
彰化縣,伸港鄉,埤墘村,0,1,651,7,658,974,3,1,3,0,1,0,67.56
彰化縣,伸港鄉,七嘉村,0,1,1428,13,1441,2000,3,1,3,0,1,0,72.05
彰化縣,伸港鄉,汴頭村,0,1,1433,21,1454,1986,3,1,3,0,1,0,73.21
彰化縣,員林鎮,東和里,0,1,709,12,721,1105,3,1,3,0,1,0,65.25
彰化縣,員林鎮,民生里,0,1,1704,17,1721,2611,3,1,3,0,1,0,65.91
彰化縣,員林鎮,中正里,0,1,1779,24,1803,2902,3,1,3,0,1,0,62.13
彰化縣,員林鎮,仁美里,0,1,1735,11,1746,2667,3,1,3,0,1,0,65.47
彰化縣,員林鎮,新興里,0,1,544,6,550,799,3,1,3,0,1,0,68.84
彰化縣,員林鎮,和平里,0,1,1711,21,1732,2707,3,1,3,0,1,0,63.98
彰化縣,員林鎮,光明里,0,1,636,4,640,933,3,1,3,0,1,0,68.60
彰化縣,員林鎮,中山里,0,1,497,3,500,695,3,1,3,0,1,0,71.94
彰化縣,員林鎮,黎明里,0,1,1176,11,1187,1723,3,1,3,0,1,0,68.89
彰化縣,員林鎮,惠來里,0,1,2832,35,2867,4597,3,1,3,0,1,0,62.37
彰化縣,員林鎮,三義里,0,1,1451,18,1469,2283,3,1,3,0,1,0,64.35
彰化縣,員林鎮,新生里,0,1,2499,27,2526,3766,3,1,3,0,1,0,67.07
彰化縣,員林鎮,南平里,0,1,2306,23,2329,3573,3,1,3,0,1,0,65.18
彰化縣,員林鎮,南興里,0,1,2697,30,2727,4195,3,1,3,0,1,0,65.01
彰化縣,員林鎮,源潭里,0,1,1013,6,1019,1525,3,1,3,0,1,0,66.82
彰化縣,員林鎮,大埔里,0,1,1207,18,1225,1796,3,1,3,0,1,0,68.21
彰化縣,員林鎮,仁愛里,0,1,889,6,895,1304,3,1,3,0,1,0,68.63
彰化縣,員林鎮,忠孝里,0,1,1211,14,1225,1862,3,1,3,0,1,0,65.79
彰化縣,員林鎮,三條里,0,1,1298,12,1310,2078,3,1,3,0,1,0,63.04
彰化縣,員林鎮,三和里,0,1,2981,35,3016,5130,3,1,3,0,1,0,58.79
彰化縣,員林鎮,三橋里,0,1,1621,19,1640,2545,3,1,3,0,1,0,64.44
彰化縣,員林鎮,三愛里,0,1,1526,12,1538,2474,3,1,3,0,1,0,62.17
彰化縣,員林鎮,三信里,0,1,1205,14,1219,1909,3,1,3,0,1,0,63.86
彰化縣,員林鎮,三多里,0,1,1230,19,1249,2011,3,1,3,0,1,0,62.11
彰化縣,員林鎮,中央里,0,1,968,18,986,1576,3,1,3,0,1,0,62.56
彰化縣,員林鎮,溝皂里,0,1,1384,11,1395,2110,3,1,3,0,1,0,66.11
彰化縣,員林鎮,大饒里,0,1,1642,22,1664,2507,3,1,3,0,1,0,66.37
彰化縣,員林鎮,大明里,0,1,1359,13,1372,2018,3,1,3,0,1,0,67.99
彰化縣,員林鎮,萬年里,0,1,2066,14,2080,3117,3,1,3,0,1,0,66.73
彰化縣,員林鎮,崙雅里,0,1,1602,17,1619,2249,3,1,3,0,1,0,71.99
彰化縣,員林鎮,振興里,0,1,1439,23,1462,2254,3,1,3,0,1,0,64.86
彰化縣,員林鎮,林厝里,0,1,1420,10,1430,2278,3,1,3,0,1,0,62.77
彰化縣,員林鎮,出水里,0,1,1141,14,1155,1695,3,1,3,0,1,0,68.14
彰化縣,員林鎮,湖水里,0,1,774,8,782,1264,3,1,3,0,1,0,61.87
彰化縣,員林鎮,大峰里,0,1,451,6,457,733,3,1,3,0,1,0,62.35
彰化縣,員林鎮,鎮興里,0,1,1204,12,1216,1853,3,1,3,0,1,0,65.62
彰化縣,員林鎮,浮圳里,0,1,1277,14,1291,2040,3,1,3,0,1,0,63.28
彰化縣,員林鎮,西東里,0,1,1043,12,1055,1685,3,1,3,0,1,0,62.61
彰化縣,員林鎮,南東里,0,1,1076,11,1087,1643,3,1,3,0,1,0,66.16
彰化縣,員林鎮,中東里,0,1,917,17,934,1527,3,1,3,0,1,0,61.17
彰化縣,員林鎮,東北里,0,1,1315,21,1336,2033,3,1,3,0,1,0,65.72
彰化縣,大村鄉,大村村,0,1,1487,15,1502,2125,3,1,3,0,1,0,70.68
彰化縣,大村鄉,茄苳村,0,1,1055,14,1069,1553,3,1,3,0,1,0,68.83
彰化縣,大村鄉,田洋村,0,1,655,9,664,925,3,1,3,0,1,0,71.78
彰化縣,大村鄉,貢旗村,0,1,946,7,953,1373,3,1,3,0,1,0,69.41
彰化縣,大村鄉,加錫村,0,1,908,11,919,1281,3,1,3,0,1,0,71.74
彰化縣,大村鄉,大崙村,0,1,953,7,960,1453,3,1,3,0,1,0,66.07
彰化縣,大村鄉,新興村,0,1,732,6,738,1099,3,1,3,0,1,0,67.15
彰化縣,大村鄉,南勢村,0,1,836,7,843,1187,3,1,3,0,1,0,71.02
彰化縣,大村鄉,擺塘村,0,1,1452,9,1461,2163,3,1,3,0,1,0,67.55
彰化縣,大村鄉,過溝村,0,1,1458,12,1470,2159,3,1,3,0,1,0,68.09
彰化縣,大村鄉,大橋村,0,1,1201,17,1218,1800,3,1,3,0,1,0,67.67
彰化縣,大村鄉,村上村,0,1,922,5,927,1243,3,1,3,0,1,0,74.58
彰化縣,大村鄉,美港村,0,1,1662,8,1670,2540,3,1,3,0,1,0,65.75
彰化縣,大村鄉,黃厝村,0,1,1164,15,1179,1791,3,1,3,0,1,0,65.83
彰化縣,大村鄉,福興村,0,1,1123,11,1134,1760,3,1,3,0,1,0,64.43
彰化縣,大村鄉,平和村,0,1,1339,21,1360,2024,3,1,3,0,1,0,67.19
彰化縣,永靖鄉,永東村,0,1,588,5,593,794,3,1,3,0,1,0,74.69
彰化縣,永靖鄉,永西村,0,1,975,4,979,1469,3,1,3,0,1,0,66.64
彰化縣,永靖鄉,永南村,0,1,1228,13,1241,1846,3,1,3,0,1,0,67.23
彰化縣,永靖鄉,永北村,0,1,1276,6,1282,1910,3,1,3,0,1,0,67.12
彰化縣,永靖鄉,港西村,0,1,1091,12,1103,1634,3,1,3,0,1,0,67.50
彰化縣,永靖鄉,五福村,0,1,870,17,887,1374,3,1,3,0,1,0,64.56
彰化縣,永靖鄉,湳港村,0,1,693,7,700,955,3,1,3,0,1,0,73.30
彰化縣,永靖鄉,新莊村,0,1,628,13,641,875,3,1,3,0,1,0,73.26
彰化縣,永靖鄉,瑚璉村,0,1,1432,18,1450,2107,3,1,3,0,1,0,68.82
彰化縣,永靖鄉,五汴村,0,1,912,8,920,1356,3,1,3,0,1,0,67.85
彰化縣,永靖鄉,浮圳村,0,1,802,12,814,1065,3,1,3,0,1,0,76.43
彰化縣,永靖鄉,光雲村,0,1,1070,20,1090,1550,3,1,3,0,1,0,70.32
彰化縣,永靖鄉,東寧村,0,1,1156,17,1173,1657,3,1,3,0,1,0,70.79
彰化縣,永靖鄉,永興村,0,1,1077,9,1086,1524,3,1,3,0,1,0,71.26
彰化縣,永靖鄉,崙子村,0,1,805,7,812,1206,3,1,3,0,1,0,67.33
彰化縣,永靖鄉,獨鰲村,0,1,612,3,615,866,3,1,3,0,1,0,71.02
彰化縣,永靖鄉,敦厚村,0,1,497,10,507,720,3,1,3,0,1,0,70.42
彰化縣,永靖鄉,崙美村,0,1,532,3,535,740,3,1,3,0,1,0,72.30
彰化縣,永靖鄉,同安村,0,1,477,8,485,687,3,1,3,0,1,0,70.60
彰化縣,永靖鄉,同仁村,0,1,651,8,659,951,3,1,3,0,1,0,69.30
彰化縣,永靖鄉,湳墘村,0,1,614,8,622,835,3,1,3,0,1,0,74.49
彰化縣,永靖鄉,四芳村,0,1,462,3,465,681,3,1,3,0,1,0,68.28
彰化縣,永靖鄉,福興村,0,1,809,10,819,1130,3,1,3,0,1,0,72.48
彰化縣,永靖鄉,竹子村,0,1,969,5,974,1348,3,1,3,0,1,0,72.26
彰化縣,溪湖鎮,光平里,0,1,866,4,870,1245,3,1,3,0,1,0,69.88
彰化縣,溪湖鎮,平和里,0,1,562,5,567,748,3,1,3,0,1,0,75.80
彰化縣,溪湖鎮,太平里,0,1,978,14,992,1404,3,1,3,0,1,0,70.66
彰化縣,溪湖鎮,光華里,0,1,350,1,351,479,3,1,3,0,1,0,73.28
彰化縣,溪湖鎮,東寮里,0,1,1868,19,1887,2855,3,1,3,0,1,0,66.09
彰化縣,溪湖鎮,西寮里,0,1,1317,11,1328,1851,3,1,3,0,1,0,71.75
彰化縣,溪湖鎮,大突里,0,1,1564,20,1584,2255,3,1,3,0,1,0,70.24
彰化縣,溪湖鎮,北勢里,0,1,901,5,906,1255,3,1,3,0,1,0,72.19
彰化縣,溪湖鎮,汴頭里,0,1,1666,9,1675,2371,3,1,3,0,1,0,70.65
彰化縣,溪湖鎮,大竹里,0,1,1565,14,1579,2255,3,1,3,0,1,0,70.02
彰化縣,溪湖鎮,湖西里,0,1,1330,7,1337,1969,3,1,3,0,1,0,67.90
彰化縣,溪湖鎮,田中里,0,1,567,6,573,755,3,1,3,0,1,0,75.89
彰化縣,溪湖鎮,河東里,0,1,1123,11,1134,1650,3,1,3,0,1,0,68.73
彰化縣,溪湖鎮,中山里,0,1,1545,19,1564,2220,3,1,3,0,1,0,70.45
彰化縣,溪湖鎮,中竹里,0,1,542,4,546,777,3,1,3,0,1,0,70.27
彰化縣,溪湖鎮,東溪里,0,1,850,11,861,1262,3,1,3,0,1,0,68.23
彰化縣,溪湖鎮,西溪里,0,1,1029,10,1039,1553,3,1,3,0,1,0,66.90
彰化縣,溪湖鎮,湖東里,0,1,2456,16,2472,3643,3,1,3,0,1,0,67.86
彰化縣,溪湖鎮,頂庄里,0,1,463,10,473,640,3,1,3,0,1,0,73.91
彰化縣,溪湖鎮,忠覺里,0,1,927,7,934,1254,3,1,3,0,1,0,74.48
彰化縣,溪湖鎮,湳底里,0,1,522,9,531,721,3,1,3,0,1,0,73.65
彰化縣,溪湖鎮,大庭里,0,1,866,11,877,1271,3,1,3,0,1,0,69.00
彰化縣,溪湖鎮,媽厝里,0,1,942,8,950,1325,3,1,3,0,1,0,71.70
彰化縣,溪湖鎮,西勢里,0,1,1317,15,1332,1921,3,1,3,0,1,0,69.34
彰化縣,溪湖鎮,番婆里,0,1,1021,8,1029,1540,3,1,3,0,1,0,66.82
彰化縣,埔鹽鄉,埔鹽村,0,1,1074,17,1091,1520,3,1,3,0,1,0,71.78
彰化縣,埔鹽鄉,埔南村,0,1,1072,14,1086,1473,3,1,3,0,1,0,73.73
彰化縣,埔鹽鄉,部子村,0,1,907,9,916,1168,3,1,3,0,1,0,78.42
彰化縣,埔鹽鄉,出水村,0,1,650,10,660,834,3,1,3,0,1,0,79.14
彰化縣,埔鹽鄉,南港村,0,1,1251,13,1264,1631,3,1,3,0,1,0,77.50
彰化縣,埔鹽鄉,打廉村,0,1,726,7,733,924,3,1,3,0,1,0,79.33
彰化縣,埔鹽鄉,豐澤村,0,1,902,23,925,1283,3,1,3,0,1,0,72.10
彰化縣,埔鹽鄉,崑崙村,0,1,780,10,790,1036,3,1,3,0,1,0,76.25
彰化縣,埔鹽鄉,角樹村,0,1,558,6,564,702,3,1,3,0,1,0,80.34
彰化縣,埔鹽鄉,瓦窯村,0,1,889,9,898,1158,3,1,3,0,1,0,77.55
彰化縣,埔鹽鄉,好修村,0,1,1000,25,1025,1365,3,1,3,0,1,0,75.09
彰化縣,埔鹽鄉,西湖村,0,1,1506,10,1516,1949,3,1,3,0,1,0,77.78
彰化縣,埔鹽鄉,大有村,0,1,956,9,965,1241,3,1,3,0,1,0,77.76
彰化縣,埔鹽鄉,新興村,0,1,298,3,301,393,3,1,3,0,1,0,76.59
彰化縣,埔鹽鄉,永平村,0,1,762,9,771,1058,3,1,3,0,1,0,72.87
彰化縣,埔鹽鄉,永樂村,0,1,609,7,616,770,3,1,3,0,1,0,80.00
彰化縣,埔鹽鄉,石埤村,0,1,978,12,990,1315,3,1,3,0,1,0,75.29
彰化縣,埔鹽鄉,天盛村,0,1,666,3,669,826,3,1,3,0,1,0,80.99
彰化縣,埔鹽鄉,太平村,0,1,1056,10,1066,1463,3,1,3,0,1,0,72.86
彰化縣,埔鹽鄉,新水村,0,1,1053,9,1062,1369,3,1,3,0,1,0,77.57
彰化縣,埔鹽鄉,三省村,0,1,1003,11,1014,1264,3,1,3,0,1,0,80.22
彰化縣,埔鹽鄉,南新村,0,1,936,14,950,1244,3,1,3,0,1,0,76.37
彰化縣,埔心鄉,東門村,0,1,1827,22,1849,2725,3,1,3,0,1,0,67.85
彰化縣,埔心鄉,埔心村,0,1,831,7,838,1211,3,1,3,0,1,0,69.20
彰化縣,埔心鄉,義民村,0,1,996,10,1006,1450,3,1,3,0,1,0,69.38
彰化縣,埔心鄉,油車村,0,1,817,12,829,1132,3,1,3,0,1,0,73.23
彰化縣,埔心鄉,瓦北村,0,1,1093,21,1114,1621,3,1,3,0,1,0,68.72
彰化縣,埔心鄉,瓦中村,0,1,1144,11,1155,1733,3,1,3,0,1,0,66.65
彰化縣,埔心鄉,瓦南村,0,1,910,7,917,1329,3,1,3,0,1,0,69.00
彰化縣,埔心鄉,經口村,0,1,1089,7,1096,1688,3,1,3,0,1,0,64.93
彰化縣,埔心鄉,太平村,0,1,1240,17,1257,1794,3,1,3,0,1,0,70.07
彰化縣,埔心鄉,大華村,0,1,430,7,437,589,3,1,3,0,1,0,74.19
彰化縣,埔心鄉,仁里村,0,1,714,9,723,1070,3,1,3,0,1,0,67.57
彰化縣,埔心鄉,舊館村,0,1,792,7,799,1159,3,1,3,0,1,0,68.94
彰化縣,埔心鄉,南館村,0,1,530,5,535,839,3,1,3,0,1,0,63.77
彰化縣,埔心鄉,新館村,0,1,597,8,605,891,3,1,3,0,1,0,67.90
彰化縣,埔心鄉,芎蕉村,0,1,1168,12,1180,1704,3,1,3,0,1,0,69.25
彰化縣,埔心鄉,羅厝村,0,1,932,9,941,1322,3,1,3,0,1,0,71.18
彰化縣,埔心鄉,梧鳳村,0,1,634,5,639,868,3,1,3,0,1,0,73.62
彰化縣,埔心鄉,二重村,0,1,891,9,900,1202,3,1,3,0,1,0,74.88
彰化縣,埔心鄉,埤霞村,0,1,545,4,549,766,3,1,3,0,1,0,71.67
彰化縣,埔心鄉,埤腳村,0,1,608,10,618,844,3,1,3,0,1,0,73.22
彰化縣,田中鎮,香山里,0,1,579,7,586,868,3,1,3,0,1,0,67.51
彰化縣,田中鎮,碧峰里,0,1,1048,16,1064,1998,3,1,3,0,1,0,53.25
彰化縣,田中鎮,東源里,0,1,397,3,400,624,3,1,3,0,1,0,64.10
彰化縣,田中鎮,復興里,0,1,997,15,1012,1487,3,1,3,0,1,0,68.06
彰化縣,田中鎮,平和里,0,1,979,11,990,1468,3,1,3,0,1,0,67.44
彰化縣,田中鎮,頂潭里,0,1,804,6,810,1232,3,1,3,0,1,0,65.75
彰化縣,田中鎮,中潭里,0,1,1069,9,1078,1691,3,1,3,0,1,0,63.75
彰化縣,田中鎮,龍潭里,0,1,454,6,460,646,3,1,3,0,1,0,71.21
彰化縣,田中鎮,北路里,0,1,1900,16,1916,2848,3,1,3,0,1,0,67.28
彰化縣,田中鎮,西路里,0,1,1436,15,1451,2152,3,1,3,0,1,0,67.43
彰化縣,田中鎮,東路里,0,1,718,6,724,1100,3,1,3,0,1,0,65.82
彰化縣,田中鎮,南路里,0,1,869,9,878,1282,3,1,3,0,1,0,68.49
彰化縣,田中鎮,中路里,0,1,1321,12,1333,1979,3,1,3,0,1,0,67.36
彰化縣,田中鎮,新庄里,0,1,1310,18,1328,2069,3,1,3,0,1,0,64.19
彰化縣,田中鎮,三安里,0,1,1090,19,1109,1609,3,1,3,0,1,0,68.92
彰化縣,田中鎮,大崙里,0,1,897,7,904,1316,3,1,3,0,1,0,68.69
彰化縣,田中鎮,沙崙里,0,1,998,20,1018,1644,3,1,3,0,1,0,61.92
彰化縣,田中鎮,新民里,0,1,2232,17,2249,3457,3,1,3,0,1,0,65.06
彰化縣,田中鎮,梅州里,0,1,884,8,892,1323,3,1,3,0,1,0,67.42
彰化縣,田中鎮,三民里,0,1,987,11,998,1520,3,1,3,0,1,0,65.66
彰化縣,田中鎮,三光里,0,1,611,7,618,888,3,1,3,0,1,0,69.59
彰化縣,田中鎮,大社里,0,1,560,1,561,815,3,1,3,0,1,0,68.83
彰化縣,社頭鄉,社頭村,0,1,1749,8,1757,2581,3,1,3,0,1,0,68.07
彰化縣,社頭鄉,廣興村,0,1,2565,36,2601,3832,3,1,3,0,1,0,67.88
彰化縣,社頭鄉,仁雅村,0,1,1615,8,1623,2478,3,1,3,0,1,0,65.50
彰化縣,社頭鄉,崙雅村,0,1,509,10,519,785,3,1,3,0,1,0,66.11
彰化縣,社頭鄉,美雅村,0,1,724,6,730,1041,3,1,3,0,1,0,70.12
彰化縣,社頭鄉,里仁村,0,1,754,6,760,1079,3,1,3,0,1,0,70.44
彰化縣,社頭鄉,舊社村,0,1,962,13,975,1433,3,1,3,0,1,0,68.04
彰化縣,社頭鄉,松竹村,0,1,673,12,685,986,3,1,3,0,1,0,69.47
彰化縣,社頭鄉,東興村,0,1,816,14,830,1243,3,1,3,0,1,0,66.77
彰化縣,社頭鄉,廣福村,0,1,582,10,592,829,3,1,3,0,1,0,71.41
彰化縣,社頭鄉,橋頭村,0,1,1281,14,1295,1905,3,1,3,0,1,0,67.98
彰化縣,社頭鄉,湳底村,0,1,1015,11,1026,1473,3,1,3,0,1,0,69.65
彰化縣,社頭鄉,新厝村,0,1,980,13,993,1398,3,1,3,0,1,0,71.03
彰化縣,社頭鄉,張厝村,0,1,822,13,835,1114,3,1,3,0,1,0,74.96
彰化縣,社頭鄉,埤斗村,0,1,684,2,686,980,3,1,3,0,1,0,70.00
彰化縣,社頭鄉,清水村,0,1,745,8,753,1061,3,1,3,0,1,0,70.97
彰化縣,社頭鄉,山湖村,0,1,700,7,707,998,3,1,3,0,1,0,70.84
彰化縣,社頭鄉,朝興村,0,1,730,11,741,1032,3,1,3,0,1,0,71.80
彰化縣,社頭鄉,仁和村,0,1,498,3,501,684,3,1,3,0,1,0,73.25
彰化縣,社頭鄉,泰安村,0,1,640,2,642,887,3,1,3,0,1,0,72.38
彰化縣,社頭鄉,平和村,0,1,668,9,677,945,3,1,3,0,1,0,71.64
彰化縣,社頭鄉,龍井村,0,1,554,6,560,808,3,1,3,0,1,0,69.31
彰化縣,社頭鄉,湳雅村,0,1,952,14,966,1354,3,1,3,0,1,0,71.34
彰化縣,社頭鄉,協和村,0,1,1306,17,1323,1949,3,1,3,0,1,0,67.88
彰化縣,二水鄉,復興村,0,1,717,10,727,1022,3,1,3,0,1,0,71.14
彰化縣,二水鄉,十五村,0,1,507,4,511,718,3,1,3,0,1,0,71.17
彰化縣,二水鄉,合和村,0,1,575,10,585,874,3,1,3,0,1,0,66.93
彰化縣,二水鄉,上豊村,0,1,710,7,717,1026,3,1,3,0,1,0,69.88
彰化縣,二水鄉,過圳村,0,1,442,2,444,647,3,1,3,0,1,0,68.62
彰化縣,二水鄉,五伯村,0,1,486,6,492,660,3,1,3,0,1,0,74.55
彰化縣,二水鄉,光化村,0,1,702,6,708,999,3,1,3,0,1,0,70.87
彰化縣,二水鄉,文化村,0,1,714,5,719,1038,3,1,3,0,1,0,69.27
彰化縣,二水鄉,二水村,0,1,631,7,638,880,3,1,3,0,1,0,72.50
彰化縣,二水鄉,聖化村,0,1,363,1,364,489,3,1,3,0,1,0,74.44
彰化縣,二水鄉,裕民村,0,1,620,9,629,951,3,1,3,0,1,0,66.14
彰化縣,二水鄉,惠民村,0,1,576,11,587,863,3,1,3,0,1,0,68.02
彰化縣,二水鄉,大園村,0,1,585,6,591,798,3,1,3,0,1,0,74.06
彰化縣,二水鄉,修仁村,0,1,574,4,578,792,3,1,3,0,1,0,72.98
彰化縣,二水鄉,合興村,0,1,533,2,535,729,3,1,3,0,1,0,73.39
彰化縣,二水鄉,源泉村,0,1,477,6,483,666,3,1,3,0,1,0,72.52
彰化縣,二水鄉,倡和村,0,1,467,4,471,617,3,1,3,0,1,0,76.34
彰化縣,北斗鎮,中寮里,0,1,1592,17,1609,2325,3,1,3,0,1,0,69.20
彰化縣,北斗鎮,大道里,0,1,1212,4,1216,1725,3,1,3,0,1,0,70.49
彰化縣,北斗鎮,西德里,0,1,2683,33,2716,3902,3,1,3,0,1,0,69.61
彰化縣,北斗鎮,西安里,0,1,1040,17,1057,1590,3,1,3,0,1,0,66.48
彰化縣,北斗鎮,光復里,0,1,923,11,934,1400,3,1,3,0,1,0,66.71
彰化縣,北斗鎮,新政里,0,1,531,7,538,807,3,1,3,0,1,0,66.67
彰化縣,北斗鎮,重慶里,0,1,446,4,450,629,3,1,3,0,1,0,71.54
彰化縣,北斗鎮,五權里,0,1,515,2,517,743,3,1,3,0,1,0,69.58
彰化縣,北斗鎮,七星里,0,1,909,8,917,1395,3,1,3,0,1,0,65.73
彰化縣,北斗鎮,居仁里,0,1,845,8,853,1287,3,1,3,0,1,0,66.28
彰化縣,北斗鎮,東光里,0,1,1066,8,1074,1729,3,1,3,0,1,0,62.12
彰化縣,北斗鎮,文昌里,0,1,1469,25,1494,2309,3,1,3,0,1,0,64.70
彰化縣,北斗鎮,中和里,0,1,720,10,730,1058,3,1,3,0,1,0,69.00
彰化縣,北斗鎮,新生里,0,1,1099,15,1114,1741,3,1,3,0,1,0,63.99
彰化縣,北斗鎮,大新里,0,1,953,10,963,1540,3,1,3,0,1,0,62.53
彰化縣,溪州鄉,溪厝村,0,1,1047,19,1066,1752,3,1,3,0,1,0,60.84
彰化縣,溪州鄉,坑厝村,0,1,423,4,427,677,3,1,3,0,1,0,63.07
彰化縣,溪州鄉,瓦厝村,0,1,605,4,609,942,3,1,3,0,1,0,64.65
彰化縣,溪州鄉,溪州村,0,1,1030,11,1041,1624,3,1,3,0,1,0,64.10
彰化縣,溪州鄉,尾厝村,0,1,931,17,948,1429,3,1,3,0,1,0,66.34
彰化縣,溪州鄉,東州村,0,1,1105,19,1124,1708,3,1,3,0,1,0,65.81
彰化縣,溪州鄉,舊眉村,0,1,893,16,909,1316,3,1,3,0,1,0,69.07
彰化縣,溪州鄉,圳寮村,0,1,885,12,897,1462,3,1,3,0,1,0,61.35
彰化縣,溪州鄉,西畔村,0,1,1326,26,1352,2064,3,1,3,0,1,0,65.50
彰化縣,溪州鄉,成功村,0,1,1196,10,1206,1848,3,1,3,0,1,0,65.26
彰化縣,溪州鄉,大庄村,0,1,1228,10,1238,1916,3,1,3,0,1,0,64.61
彰化縣,溪州鄉,榮光村,0,1,507,9,516,802,3,1,3,0,1,0,64.34
彰化縣,溪州鄉,柑園村,0,1,744,3,747,1119,3,1,3,0,1,0,66.76
彰化縣,溪州鄉,潮洋村,0,1,571,10,581,970,3,1,3,0,1,0,59.90
彰化縣,溪州鄉,張厝村,0,1,458,9,467,737,3,1,3,0,1,0,63.36
彰化縣,溪州鄉,菜公村,0,1,605,2,607,896,3,1,3,0,1,0,67.75
彰化縣,溪州鄉,三圳村,0,1,837,8,845,1199,3,1,3,0,1,0,70.48
彰化縣,溪州鄉,三條村,0,1,600,8,608,883,3,1,3,0,1,0,68.86
彰化縣,溪州鄉,水尾村,0,1,801,6,807,1281,3,1,3,0,1,0,63.00
彰化縣,田尾鄉,田尾村,0,1,817,9,826,1233,3,1,3,0,1,0,66.99
彰化縣,田尾鄉,豐田村,0,1,504,3,507,669,3,1,3,0,1,0,75.78
彰化縣,田尾鄉,饒平村,0,1,1389,18,1407,2063,3,1,3,0,1,0,68.20
彰化縣,田尾鄉,北曾村,0,1,860,5,865,1283,3,1,3,0,1,0,67.42
彰化縣,田尾鄉,南曾村,0,1,827,6,833,1206,3,1,3,0,1,0,69.07
彰化縣,田尾鄉,睦宜村,0,1,687,6,693,1000,3,1,3,0,1,0,69.30
彰化縣,田尾鄉,新生村,0,1,782,10,792,1140,3,1,3,0,1,0,69.47
彰化縣,田尾鄉,北鎮村,0,1,671,5,676,1024,3,1,3,0,1,0,66.02
彰化縣,田尾鄉,南鎮村,0,1,451,9,460,653,3,1,3,0,1,0,70.44
彰化縣,田尾鄉,福田村,0,1,609,7,616,851,3,1,3,0,1,0,72.39
彰化縣,田尾鄉,新興村,0,1,737,6,743,1014,3,1,3,0,1,0,73.27
彰化縣,田尾鄉,溪畔村,0,1,832,14,846,1235,3,1,3,0,1,0,68.50
彰化縣,田尾鄉,打簾村,0,1,1050,11,1061,1697,3,1,3,0,1,0,62.52
彰化縣,田尾鄉,柳鳳村,0,1,609,11,620,826,3,1,3,0,1,0,75.06
彰化縣,田尾鄉,陸豐村,0,1,635,6,641,861,3,1,3,0,1,0,74.45
彰化縣,田尾鄉,海豐村,0,1,985,9,994,1457,3,1,3,0,1,0,68.22
彰化縣,田尾鄉,仁里村,0,1,1061,10,1071,1553,3,1,3,0,1,0,68.96
彰化縣,田尾鄉,新厝村,0,1,200,1,201,287,3,1,3,0,1,0,70.03
彰化縣,田尾鄉,溪頂村,0,1,407,12,419,637,3,1,3,0,1,0,65.78
彰化縣,田尾鄉,正義村,0,1,519,7,526,751,3,1,3,0,1,0,70.04
彰化縣,埤頭鄉,和豊村,0,1,1438,21,1459,2286,3,1,3,0,1,0,63.82
彰化縣,埤頭鄉,興農村,0,1,964,10,974,1583,3,1,3,0,1,0,61.53
彰化縣,埤頭鄉,埤頭村,0,1,1056,7,1063,1597,3,1,3,0,1,0,66.56
彰化縣,埤頭鄉,豊崙村,0,1,1442,14,1456,2154,3,1,3,0,1,0,67.60
彰化縣,埤頭鄉,崙子村,0,1,789,12,801,1168,3,1,3,0,1,0,68.58
彰化縣,埤頭鄉,永豊村,0,1,942,22,964,1459,3,1,3,0,1,0,66.07
彰化縣,埤頭鄉,合興村,0,1,1964,24,1988,2986,3,1,3,0,1,0,66.58
彰化縣,埤頭鄉,平原村,0,1,1074,13,1087,1618,3,1,3,0,1,0,67.18
彰化縣,埤頭鄉,崙腳村,0,1,474,8,482,701,3,1,3,0,1,0,68.76
彰化縣,埤頭鄉,元埔村,0,1,370,2,372,594,3,1,3,0,1,0,62.63
彰化縣,埤頭鄉,芙朝村,0,1,1025,17,1042,1627,3,1,3,0,1,0,64.04
彰化縣,埤頭鄉,新庄村,0,1,692,9,701,1161,3,1,3,0,1,0,60.38
彰化縣,埤頭鄉,陸嘉村,0,1,518,14,532,809,3,1,3,0,1,0,65.76
彰化縣,埤頭鄉,竹圍村,0,1,590,6,596,900,3,1,3,0,1,0,66.22
彰化縣,埤頭鄉,中和村,0,1,812,5,817,1353,3,1,3,0,1,0,60.38
彰化縣,埤頭鄉,庄內村,0,1,610,4,614,969,3,1,3,0,1,0,63.36
彰化縣,埤頭鄉,大湖村,0,1,671,5,676,992,3,1,3,0,1,0,68.15
彰化縣,二林鎮,東和里,0,1,1436,16,1452,2071,3,1,3,0,1,0,70.11
彰化縣,二林鎮,南光里,0,1,1953,21,1974,2873,3,1,3,0,1,0,68.71
彰化縣,二林鎮,西平里,0,1,933,21,954,1324,3,1,3,0,1,0,72.05
彰化縣,二林鎮,北平里,0,1,1782,20,1802,2762,3,1,3,0,1,0,65.24
彰化縣,二林鎮,中西里,0,1,1143,15,1158,1636,3,1,3,0,1,0,70.78
彰化縣,二林鎮,廣興里,0,1,974,12,986,1462,3,1,3,0,1,0,67.44
彰化縣,二林鎮,香田里,0,1,823,6,829,1202,3,1,3,0,1,0,68.97
彰化縣,二林鎮,外竹里,0,1,805,11,816,1077,3,1,3,0,1,0,75.77
彰化縣,二林鎮,興華里,0,1,765,8,773,1105,3,1,3,0,1,0,69.95
彰化縣,二林鎮,東興里,0,1,845,7,852,1205,3,1,3,0,1,0,70.71
彰化縣,二林鎮,後厝里,0,1,1624,19,1643,2445,3,1,3,0,1,0,67.20
彰化縣,二林鎮,豐田里,0,1,1437,20,1457,2095,3,1,3,0,1,0,69.55
彰化縣,二林鎮,頂厝里,0,1,930,17,947,1407,3,1,3,0,1,0,67.31
彰化縣,二林鎮,趙甲里,0,1,1192,19,1211,1659,3,1,3,0,1,0,73.00
彰化縣,二林鎮,振興里,0,1,921,14,935,1293,3,1,3,0,1,0,72.31
彰化縣,二林鎮,萬興里,0,1,593,2,595,817,3,1,3,0,1,0,72.83
彰化縣,二林鎮,永興里,0,1,1083,30,1113,1545,3,1,3,0,1,0,72.04
彰化縣,二林鎮,西庄里,0,1,928,11,939,1275,3,1,3,0,1,0,73.65
彰化縣,二林鎮,梅芳里,0,1,774,11,785,1090,3,1,3,0,1,0,72.02
彰化縣,二林鎮,華崙里,0,1,2541,28,2569,3527,3,1,3,0,1,0,72.84
彰化縣,二林鎮,萬合里,0,1,933,12,945,1320,3,1,3,0,1,0,71.59
彰化縣,二林鎮,東勢里,0,1,738,10,748,1015,3,1,3,0,1,0,73.69
彰化縣,二林鎮,大永里,0,1,637,5,642,875,3,1,3,0,1,0,73.37
彰化縣,二林鎮,原斗里,0,1,913,10,923,1232,3,1,3,0,1,0,74.92
彰化縣,二林鎮,西斗里,0,1,717,14,731,1036,3,1,3,0,1,0,70.56
彰化縣,二林鎮,東華里,0,1,753,5,758,1030,3,1,3,0,1,0,73.59
彰化縣,二林鎮,復豐里,0,1,541,8,549,733,3,1,3,0,1,0,74.90
彰化縣,芳苑鄉,芳苑村,0,1,628,4,632,1033,3,1,3,0,1,0,61.18
彰化縣,芳苑鄉,芳中村,0,1,286,4,290,510,3,1,3,0,1,0,56.86
彰化縣,芳苑鄉,仁愛村,0,1,523,6,529,870,3,1,3,0,1,0,60.80
彰化縣,芳苑鄉,信義村,0,1,350,6,356,637,3,1,3,0,1,0,55.89
彰化縣,芳苑鄉,後寮村,0,1,654,7,661,947,3,1,3,0,1,0,69.80
彰化縣,芳苑鄉,三合村,0,1,1264,13,1277,1867,3,1,3,0,1,0,68.40
彰化縣,芳苑鄉,永興村,0,1,871,15,886,1392,3,1,3,0,1,0,63.65
彰化縣,芳苑鄉,新街村,0,1,497,7,504,994,3,1,3,0,1,0,50.70
彰化縣,芳苑鄉,路上村,0,1,479,7,486,729,3,1,3,0,1,0,66.67
彰化縣,芳苑鄉,路平村,0,1,509,7,516,725,3,1,3,0,1,0,71.17
彰化縣,芳苑鄉,三成村,0,1,678,6,684,996,3,1,3,0,1,0,68.67
彰化縣,芳苑鄉,福榮村,0,1,450,6,456,675,3,1,3,0,1,0,67.56
彰化縣,芳苑鄉,頂部村,0,1,367,4,371,606,3,1,3,0,1,0,61.22
彰化縣,芳苑鄉,王功村,0,1,1295,20,1315,2089,3,1,3,0,1,0,62.95
彰化縣,芳苑鄉,博愛村,0,1,547,6,553,795,3,1,3,0,1,0,69.56
彰化縣,芳苑鄉,和平村,0,1,507,4,511,804,3,1,3,0,1,0,63.56
彰化縣,芳苑鄉,興仁村,0,1,871,12,883,1389,3,1,3,0,1,0,63.57
彰化縣,芳苑鄉,民生村,0,1,470,3,473,782,3,1,3,0,1,0,60.49
彰化縣,芳苑鄉,新寶村,0,1,960,10,970,1368,3,1,3,0,1,0,70.91
彰化縣,芳苑鄉,五俊村,0,1,294,5,299,547,3,1,3,0,1,0,54.66
彰化縣,芳苑鄉,草湖村,0,1,1016,7,1023,1438,3,1,3,0,1,0,71.14
彰化縣,芳苑鄉,建平村,0,1,1380,14,1394,2079,3,1,3,0,1,0,67.05
彰化縣,芳苑鄉,崙腳村,0,1,505,0,505,721,3,1,3,0,1,0,70.04
彰化縣,芳苑鄉,文津村,0,1,738,5,743,1042,3,1,3,0,1,0,71.31
彰化縣,芳苑鄉,新生村,0,1,883,4,887,1349,3,1,3,0,1,0,65.75
彰化縣,芳苑鄉,漢寶村,0,1,1995,20,2015,2933,3,1,3,0,1,0,68.70
彰化縣,大城鄉,潭墘村,0,1,833,10,843,1313,3,1,3,0,1,0,64.20
彰化縣,大城鄉,山腳村,0,1,892,18,910,1426,3,1,3,0,1,0,63.81
彰化縣,大城鄉,西城村,0,1,573,6,579,869,3,1,3,0,1,0,66.63
彰化縣,大城鄉,東城村,0,1,803,8,811,1265,3,1,3,0,1,0,64.11
彰化縣,大城鄉,大城村,0,1,689,8,697,1062,3,1,3,0,1,0,65.63
彰化縣,大城鄉,上山村,0,1,817,7,824,1205,3,1,3,0,1,0,68.38
彰化縣,大城鄉,永和村,0,1,509,4,513,767,3,1,3,0,1,0,66.88
彰化縣,大城鄉,公館村,0,1,727,6,733,1215,3,1,3,0,1,0,60.33
彰化縣,大城鄉,豐美村,0,1,610,7,617,904,3,1,3,0,1,0,68.25
彰化縣,大城鄉,三豐村,0,1,433,5,438,747,3,1,3,0,1,0,58.63
彰化縣,大城鄉,菜寮村,0,1,792,9,801,1168,3,1,3,0,1,0,68.58
彰化縣,大城鄉,東港村,0,1,843,7,850,1328,3,1,3,0,1,0,64.01
彰化縣,大城鄉,西港村,0,1,610,9,619,1067,3,1,3,0,1,0,58.01
彰化縣,大城鄉,頂庄村,0,1,455,2,457,803,3,1,3,0,1,0,56.91
彰化縣,大城鄉,臺西村,0,1,593,6,599,1001,3,1,3,0,1,0,59.84
彰化縣,竹塘鄉,竹元村,0,1,749,9,758,1100,3,1,3,0,1,0,68.91
彰化縣,竹塘鄉,竹塘村,0,1,1205,25,1230,1725,3,1,3,0,1,0,71.30
彰化縣,竹塘鄉,小西村,0,1,564,3,567,804,3,1,3,0,1,0,70.52
彰化縣,竹塘鄉,民靖村,0,1,522,5,527,798,3,1,3,0,1,0,66.04
彰化縣,竹塘鄉,五庄村,0,1,1081,14,1095,1512,3,1,3,0,1,0,72.42
彰化縣,竹塘鄉,樹腳村,0,1,465,6,471,655,3,1,3,0,1,0,71.91
彰化縣,竹塘鄉,田頭村,0,1,685,2,687,971,3,1,3,0,1,0,70.75
彰化縣,竹塘鄉,新廣村,0,1,803,13,816,1163,3,1,3,0,1,0,70.16
彰化縣,竹塘鄉,溪墘村,0,1,356,2,358,555,3,1,3,0,1,0,64.50
彰化縣,竹塘鄉,竹林村,0,1,611,5,616,889,3,1,3,0,1,0,69.29
彰化縣,竹塘鄉,土庫村,0,1,460,2,462,719,3,1,3,0,1,0,64.26
彰化縣,竹塘鄉,內新村,0,1,423,3,426,655,3,1,3,0,1,0,65.04
彰化縣,竹塘鄉,長安村,0,1,537,3,540,784,3,1,3,0,1,0,68.88
彰化縣,竹塘鄉,永安村,0,1,441,0,441,677,3,1,3,0,1,0,65.14
南投縣,南投市,龍泉里,0,1,564,4,568,942,3,1,3,0,1,0,60.30
南投縣,南投市,康壽里,0,1,849,4,853,1377,3,1,3,0,1,0,61.95
南投縣,南投市,三民里,0,1,557,2,559,813,3,1,3,0,1,0,68.76
南投縣,南投市,仁和里,0,1,378,0,378,547,3,1,3,0,1,0,69.10
南投縣,南投市,南投里,0,1,424,2,426,677,3,1,3,0,1,0,62.92
南投縣,南投市,彰仁里,0,1,306,0,306,440,3,1,3,0,1,0,69.55
南投縣,南投市,崇文里,0,1,654,1,655,1036,3,1,3,0,1,0,63.22
南投縣,南投市,三興里,0,1,2504,21,2525,4344,3,1,3,0,1,0,58.13
南投縣,南投市,三和里,0,1,1714,15,1729,2767,3,1,3,0,1,0,62.49
南投縣,南投市,嘉興里,0,1,1178,12,1190,1799,3,1,3,0,1,0,66.15
南投縣,南投市,嘉和里,0,1,1948,22,1970,3317,3,1,3,0,1,0,59.39
南投縣,南投市,平和里,0,1,3043,11,3054,5166,3,1,3,0,1,0,59.12
南投縣,南投市,振興里,0,1,1235,5,1240,1988,3,1,3,0,1,0,62.3742454728
南投縣,南投市,千秋里,0,1,517,2,519,884,3,1,3,0,1,0,58.71
南投縣,南投市,軍功里,0,1,2280,21,2301,3881,3,1,3,0,1,0,59.29
南投縣,南投市,東山里,0,1,234,3,237,406,3,1,3,0,1,0,58.37
南投縣,南投市,營南里,0,1,1259,5,1264,1986,3,1,3,0,1,0,63.65
南投縣,南投市,營北里,0,1,3069,19,3088,4858,3,1,3,0,1,0,63.57
南投縣,南投市,內興里,0,1,3039,17,3056,5042,3,1,3,0,1,0,60.61
南投縣,南投市,內新里,0,1,863,9,872,1361,3,1,3,0,1,0,64.07
南投縣,南投市,光輝里,0,1,334,3,337,575,3,1,3,0,1,0,58.61
南投縣,南投市,光榮里,0,1,1132,4,1136,1756,3,1,3,0,1,0,64.69
南投縣,南投市,光明里,0,1,1235,5,1240,1799,3,1,3,0,1,0,68.9271817676
南投縣,南投市,光華里,0,1,981,8,989,1457,3,1,3,0,1,0,67.88
南投縣,南投市,漳興里,0,1,1425,8,1433,2338,3,1,3,0,1,0,61.29
南投縣,南投市,漳和里,0,1,3467,27,3494,5879,3,1,3,0,1,0,59.43
南投縣,南投市,平山里,0,1,2304,28,2332,4153,3,1,3,0,1,0,56.1521791476
南投縣,南投市,新興里,0,1,2137,19,2156,3849,3,1,3,0,1,0,56.01
南投縣,南投市,永豐里,0,1,1405,12,1417,2464,3,1,3,0,1,0,57.51
南投縣,南投市,福興里,0,1,1477,14,1491,2507,3,1,3,0,1,0,59.47
南投縣,南投市,鳳山里,0,1,665,3,668,1234,3,1,3,0,1,0,54.13
南投縣,南投市,永興里,0,1,473,9,482,744,3,1,3,0,1,0,64.78
南投縣,南投市,鳳鳴里,0,1,422,4,426,719,3,1,3,0,1,0,59.25
南投縣,南投市,福山里,0,1,981,3,984,1780,3,1,3,0,1,0,55.28
南投縣,埔里鎮,東門里,0,1,1590,9,1599,2920,3,1,3,0,1,0,54.76
南投縣,埔里鎮,西門里,0,1,1630,8,1638,3077,3,1,3,0,1,0,53.23
南投縣,埔里鎮,南門里,0,1,538,8,546,909,3,1,3,0,1,0,60.0660066007
南投縣,埔里鎮,北門里,0,1,1249,11,1260,2375,3,1,3,0,1,0,53.05
南投縣,埔里鎮,北安里,0,1,1737,11,1748,3133,3,1,3,0,1,0,55.7931694861
南投縣,埔里鎮,泰安里,0,1,1055,7,1062,1925,3,1,3,0,1,0,55.17
南投縣,埔里鎮,北梅里,0,1,1113,10,1123,2164,3,1,3,0,1,0,51.89
南投縣,埔里鎮,同聲里,0,1,1231,8,1239,2246,3,1,3,0,1,0,55.16
南投縣,埔里鎮,清新里,0,1,1764,11,1775,3454,3,1,3,0,1,0,51.39
南投縣,埔里鎮,薰化里,0,1,728,4,732,1181,3,1,3,0,1,0,61.98
南投縣,埔里鎮,大城里,0,1,2936,20,2956,5631,3,1,3,0,1,0,52.50
南投縣,埔里鎮,籃城里,0,1,554,1,555,940,3,1,3,0,1,0,59.04
南投縣,埔里鎮,杷城里,0,1,1212,8,1220,2282,3,1,3,0,1,0,53.46
南投縣,埔里鎮,枇杷里,0,1,2902,25,2927,5797,3,1,3,0,1,0,50.49
南投縣,埔里鎮,水頭里,0,1,1477,14,1491,3051,3,1,3,0,1,0,48.87
南投縣,埔里鎮,麒麟里,0,1,522,6,528,996,3,1,3,0,1,0,53.01
南投縣,埔里鎮,珠格里,0,1,528,6,534,972,3,1,3,0,1,0,54.94
南投縣,埔里鎮,溪南里,0,1,535,9,544,904,3,1,3,0,1,0,60.18
南投縣,埔里鎮,桃米里,0,1,542,3,545,1023,3,1,3,0,1,0,53.27
南投縣,埔里鎮,成功里,0,1,205,1,206,372,3,1,3,0,1,0,55.38
南投縣,埔里鎮,南村里,0,1,619,4,623,1277,3,1,3,0,1,0,48.79
南投縣,埔里鎮,愛蘭里,0,1,708,5,713,1313,3,1,3,0,1,0,54.30
南投縣,埔里鎮,鐵山里,0,1,808,5,813,1542,3,1,3,0,1,0,52.7237354086
南投縣,埔里鎮,房里里,0,1,663,3,666,1212,3,1,3,0,1,0,54.9504950495
南投縣,埔里鎮,向善里,0,1,419,2,421,659,3,1,3,0,1,0,63.88
南投縣,埔里鎮,一新里,0,1,434,2,436,794,3,1,3,0,1,0,54.91
南投縣,埔里鎮,合成里,0,1,891,3,894,1547,3,1,3,0,1,0,57.79
南投縣,埔里鎮,廣成里,0,1,676,10,686,1195,3,1,3,0,1,0,57.41
南投縣,埔里鎮,史港里,0,1,415,0,415,674,3,1,3,0,1,0,61.57
南投縣,埔里鎮,福興里,0,1,477,7,484,973,3,1,3,0,1,0,49.7430626927
南投縣,埔里鎮,牛眠里,0,1,1360,15,1375,2422,3,1,3,0,1,0,56.7712634187
南投縣,埔里鎮,大湳里,0,1,633,4,637,1154,3,1,3,0,1,0,55.20
南投縣,埔里鎮,蜈蚣里,0,1,1340,10,1350,2471,3,1,3,0,1,0,54.63
南投縣,草屯鎮,玉峰里,0,1,1196,11,1207,1986,3,1,3,0,1,0,60.78
南投縣,草屯鎮,明正里,0,1,2079,14,2093,3475,3,1,3,0,1,0,60.23
南投縣,草屯鎮,炎峰里,0,1,1284,8,1292,2033,3,1,3,0,1,0,63.55
南投縣,草屯鎮,中正里,0,1,458,7,465,717,3,1,3,0,1,0,64.85
南投縣,草屯鎮,和平里,0,1,773,4,777,1256,3,1,3,0,1,0,61.86
南投縣,草屯鎮,中山里,0,1,1374,9,1383,2249,3,1,3,0,1,0,61.49
南投縣,草屯鎮,敦和里,0,1,3118,26,3144,5423,3,1,3,0,1,0,57.98
南投縣,草屯鎮,山腳里,0,1,3667,14,3681,6153,3,1,3,0,1,0,59.82
南投縣,草屯鎮,新厝里,0,1,1664,9,1673,2751,3,1,3,0,1,0,60.81
南投縣,草屯鎮,上林里,0,1,1481,12,1493,2477,3,1,3,0,1,0,60.27
南投縣,草屯鎮,碧峰里,0,1,1959,16,1975,3504,3,1,3,0,1,0,56.3641552511
南投縣,草屯鎮,碧洲里,0,1,1140,6,1146,1821,3,1,3,0,1,0,62.93
南投縣,草屯鎮,復興里,0,1,1597,19,1616,2811,3,1,3,0,1,0,57.49
南投縣,草屯鎮,御史里,0,1,2825,26,2851,5118,3,1,3,0,1,0,55.71
南投縣,草屯鎮,新豐里,0,1,1991,10,2001,3379,3,1,3,0,1,0,59.22
南投縣,草屯鎮,新庄里,0,1,1689,13,1702,2922,3,1,3,0,1,0,58.25
南投縣,草屯鎮,加老里,0,1,1284,11,1295,2045,3,1,3,0,1,0,63.33
南投縣,草屯鎮,石川里,0,1,748,12,760,1240,3,1,3,0,1,0,61.29
南投縣,草屯鎮,北投里,0,1,1431,12,1443,2407,3,1,3,0,1,0,59.95
南投縣,草屯鎮,富寮里,0,1,2631,12,2643,4525,3,1,3,0,1,0,58.41
南投縣,草屯鎮,北勢里,0,1,1141,8,1149,1909,3,1,3,0,1,0,60.19
南投縣,草屯鎮,中原里,0,1,1097,13,1110,1910,3,1,3,0,1,0,58.1151832461
南投縣,草屯鎮,南埔里,0,1,2056,13,2069,3479,3,1,3,0,1,0,59.47
南投縣,草屯鎮,坪頂里,0,1,580,4,584,923,3,1,3,0,1,0,63.27
南投縣,草屯鎮,土城里,0,1,903,17,920,1661,3,1,3,0,1,0,55.388320289
南投縣,草屯鎮,平林里,0,1,601,3,604,1019,3,1,3,0,1,0,59.27
南投縣,草屯鎮,雙冬里,0,1,1271,14,1285,2292,3,1,3,0,1,0,56.06
南投縣,竹山鎮,竹山里,0,1,1281,3,1284,2106,3,1,3,0,1,0,60.97
南投縣,竹山鎮,中正里,0,1,446,2,448,689,3,1,3,0,1,0,65.02
南投縣,竹山鎮,中山里,0,1,2372,18,2390,4423,3,1,3,0,1,0,54.04
南投縣,竹山鎮,雲林里,0,1,1852,12,1864,3179,3,1,3,0,1,0,58.63
南投縣,竹山鎮,竹圍里,0,1,1183,14,1197,2188,3,1,3,0,1,0,54.71
南投縣,竹山鎮,桂林里,0,1,1873,20,1893,3392,3,1,3,0,1,0,55.81
南投縣,竹山鎮,下坪里,0,1,623,3,626,1051,3,1,3,0,1,0,59.5623215985
南投縣,竹山鎮,中和里,0,1,663,1,664,1087,3,1,3,0,1,0,61.09
南投縣,竹山鎮,中崎里,0,1,752,4,756,1312,3,1,3,0,1,0,57.62
南投縣,竹山鎮,秀林里,0,1,448,2,450,748,3,1,3,0,1,0,60.16
南投縣,竹山鎮,大鞍里,0,1,261,0,261,425,3,1,3,0,1,0,61.41
南投縣,竹山鎮,延和里,0,1,2307,9,2316,4277,3,1,3,0,1,0,54.15
南投縣,竹山鎮,延祥里,0,1,1732,13,1745,3291,3,1,3,0,1,0,53.02
南投縣,竹山鎮,延正里,0,1,946,6,952,1643,3,1,3,0,1,0,57.94
南投縣,竹山鎮,延平里,0,1,1538,11,1549,2705,3,1,3,0,1,0,57.26
南投縣,竹山鎮,延山里,0,1,363,6,369,661,3,1,3,0,1,0,55.82
南投縣,竹山鎮,山崇里,0,1,954,7,961,1830,3,1,3,0,1,0,52.51
南投縣,竹山鎮,社寮里,0,1,563,4,567,992,3,1,3,0,1,0,57.16
南投縣,竹山鎮,中央里,0,1,769,9,778,1322,3,1,3,0,1,0,58.8502269289
南投縣,竹山鎮,富州里,0,1,399,4,403,715,3,1,3,0,1,0,56.3636363636
南投縣,竹山鎮,田子里,0,1,365,3,368,618,3,1,3,0,1,0,59.55
南投縣,竹山鎮,回窯里,0,1,814,7,821,1459,3,1,3,0,1,0,56.27141878
南投縣,竹山鎮,德興里,0,1,567,3,570,889,3,1,3,0,1,0,64.12
南投縣,竹山鎮,福興里,0,1,345,1,346,575,3,1,3,0,1,0,60.17
南投縣,竹山鎮,鯉魚里,0,1,476,0,476,867,3,1,3,0,1,0,54.90
南投縣,竹山鎮,坪頂里,0,1,275,4,279,532,3,1,3,0,1,0,52.44
南投縣,竹山鎮,瑞竹里,0,1,401,3,404,710,3,1,3,0,1,0,56.90
南投縣,竹山鎮,桶頭里,0,1,530,6,536,1037,3,1,3,0,1,0,51.69
南投縣,集集鎮,集集里,0,1,587,7,594,951,3,1,3,0,1,0,62.4605678233
南投縣,集集鎮,和平里,0,1,542,4,546,932,3,1,3,0,1,0,58.5836909871
南投縣,集集鎮,林尾里,0,1,339,1,340,558,3,1,3,0,1,0,60.93
南投縣,集集鎮,田寮里,0,1,644,11,655,1219,3,1,3,0,1,0,53.73
南投縣,集集鎮,隘寮里,0,1,365,1,366,562,3,1,3,0,1,0,65.12
南投縣,集集鎮,玉映里,0,1,288,1,289,448,3,1,3,0,1,0,64.51
南投縣,集集鎮,吳厝里,0,1,601,3,604,894,3,1,3,0,1,0,67.56
南投縣,集集鎮,八張里,0,1,766,6,772,1401,3,1,3,0,1,0,55.10
南投縣,集集鎮,永昌里,0,1,542,1,543,907,3,1,3,0,1,0,59.87
南投縣,集集鎮,廣明里,0,1,553,2,555,1064,3,1,3,0,1,0,52.16
南投縣,集集鎮,富山里,0,1,211,1,212,414,3,1,3,0,1,0,51.21
南投縣,名間鄉,南雅村,0,1,557,4,561,1018,3,1,3,0,1,0,55.11
南投縣,名間鄉,中正村,0,1,1596,14,1610,2953,3,1,3,0,1,0,54.52
南投縣,名間鄉,中山村,0,1,1113,8,1121,2024,3,1,3,0,1,0,55.39
南投縣,名間鄉,濁水村,0,1,860,5,865,1557,3,1,3,0,1,0,55.56
南投縣,名間鄉,新民村,0,1,607,4,611,1031,3,1,3,0,1,0,59.26
南投縣,名間鄉,炭寮村,0,1,605,3,608,1003,3,1,3,0,1,0,60.62
南投縣,名間鄉,新街村,0,1,2067,11,2078,3646,3,1,3,0,1,0,56.99
南投縣,名間鄉,東湖村,0,1,898,7,905,1629,3,1,3,0,1,0,55.56
南投縣,名間鄉,仁和村,0,1,497,8,505,850,3,1,3,0,1,0,59.41
南投縣,名間鄉,萬丹村,0,1,611,12,623,988,3,1,3,0,1,0,63.06
南投縣,名間鄉,田仔村,0,1,1096,10,1106,1880,3,1,3,0,1,0,58.829787234
南投縣,名間鄉,大庄村,0,1,1137,12,1149,1954,3,1,3,0,1,0,58.8024564995
南投縣,名間鄉,部下村,0,1,431,5,436,757,3,1,3,0,1,0,57.60
南投縣,名間鄉,赤水村,0,1,758,7,765,1243,3,1,3,0,1,0,61.54
南投縣,名間鄉,竹圍村,0,1,549,9,558,932,3,1,3,0,1,0,59.87
南投縣,名間鄉,三崙村,0,1,855,14,869,1486,3,1,3,0,1,0,58.4791386272
南投縣,名間鄉,松山村,0,1,766,4,770,1497,3,1,3,0,1,0,51.44
南投縣,名間鄉,松柏村,0,1,641,9,650,1132,3,1,3,0,1,0,57.42
南投縣,名間鄉,崁腳村,0,1,469,6,475,808,3,1,3,0,1,0,58.79
南投縣,名間鄉,埔中村,0,1,516,6,522,880,3,1,3,0,1,0,59.32
南投縣,名間鄉,新厝村,0,1,459,3,462,814,3,1,3,0,1,0,56.76
南投縣,名間鄉,新光村,0,1,980,12,992,1637,3,1,3,0,1,0,60.5986560782
南投縣,鹿谷鄉,初鄉村,0,1,812,7,819,1573,3,1,3,0,1,0,52.0661157025
南投縣,鹿谷鄉,鹿谷村,0,1,990,6,996,1672,3,1,3,0,1,0,59.5693779904
南投縣,鹿谷鄉,彰雅村,0,1,749,3,752,1180,3,1,3,0,1,0,63.7288135593
南投縣,鹿谷鄉,廣興村,0,1,1226,11,1237,1846,3,1,3,0,1,0,67.0097508126
南投縣,鹿谷鄉,內湖村,0,1,592,3,595,1017,3,1,3,0,1,0,58.5054080629
南投縣,鹿谷鄉,和雅村,0,1,382,1,383,603,3,1,3,0,1,0,63.5157545605
南投縣,鹿谷鄉,竹林村,0,1,861,3,864,1524,3,1,3,0,1,0,56.6929133858
南投縣,鹿谷鄉,竹豐村,0,1,539,5,544,895,3,1,3,0,1,0,60.782122905
南投縣,鹿谷鄉,鳳凰村,0,1,804,5,809,1352,3,1,3,0,1,0,59.8372781065
南投縣,鹿谷鄉,永隆村,0,1,847,3,850,1343,3,1,3,0,1,0,63.2911392405
南投縣,鹿谷鄉,秀峰村,0,1,553,3,556,1070,3,1,3,0,1,0,51.9626168224
南投縣,鹿谷鄉,清水村,0,1,417,3,420,714,3,1,3,0,1,0,58.8235294118
南投縣,鹿谷鄉,瑞田村,0,1,397,0,397,768,3,1,3,0,1,0,51.6927083333
南投縣,中寮鄉,廣興村,0,1,473,7,480,840,3,1,3,0,1,0,57.1428571429
南投縣,中寮鄉,崁頂村,0,1,284,6,290,516,3,1,3,0,1,0,56.2015503876
南投縣,中寮鄉,八仙村,0,1,430,1,431,734,3,1,3,0,1,0,58.719346049
南投縣,中寮鄉,福盛村,0,1,427,3,430,792,3,1,3,0,1,0,54.2929292929
南投縣,中寮鄉,和興村,0,1,369,5,374,683,3,1,3,0,1,0,54.7584187408
南投縣,中寮鄉,永平村,0,1,990,7,997,1755,3,1,3,0,1,0,56.8091168091
南投縣,中寮鄉,復興村,0,1,145,0,145,263,3,1,3,0,1,0,55.1330798479
南投縣,中寮鄉,中寮村,0,1,425,2,427,711,3,1,3,0,1,0,60.0562587904
南投縣,中寮鄉,廣福村,0,1,303,3,306,545,3,1,3,0,1,0,56.1467889908
南投縣,中寮鄉,永福村,0,1,657,7,664,1156,3,1,3,0,1,0,57.4394463668
南投縣,中寮鄉,義和村,0,1,643,10,653,1110,3,1,3,0,1,0,58.8288288288
南投縣,中寮鄉,清水村,0,1,534,4,538,945,3,1,3,0,1,0,56.9312169312
南投縣,中寮鄉,內城村,0,1,253,4,257,470,3,1,3,0,1,0,54.6808510638
南投縣,中寮鄉,龍安村,0,1,430,1,431,706,3,1,3,0,1,0,61.0481586402
南投縣,中寮鄉,爽文村,0,1,314,4,318,538,3,1,3,0,1,0,59.1078066914
南投縣,中寮鄉,龍岩村,0,1,357,3,360,673,3,1,3,0,1,0,53.4918276374
南投縣,中寮鄉,永芳村,0,1,283,1,284,436,3,1,3,0,1,0,65.1376146789
南投縣,中寮鄉,永和村,0,1,324,3,327,543,3,1,3,0,1,0,60.2209944751
南投縣,魚池鄉,魚池村,0,1,970,13,983,1894,3,1,3,0,1,0,51.9007391763
南投縣,魚池鄉,東池村,0,1,785,10,795,1514,3,1,3,0,1,0,52.5099075297
南投縣,魚池鄉,大林村,0,1,555,5,560,1069,3,1,3,0,1,0,52.3854069224
南投縣,魚池鄉,東光村,0,1,614,5,619,1224,3,1,3,0,1,0,50.5718954248
南投縣,魚池鄉,共和村,0,1,492,5,497,947,3,1,3,0,1,0,52.4815205913
南投縣,魚池鄉,新城村,0,1,710,6,716,1322,3,1,3,0,1,0,54.1603630862
南投縣,魚池鄉,大雁村,0,1,361,4,365,665,3,1,3,0,1,0,54.8872180451
南投縣,魚池鄉,五城村,0,1,426,2,428,721,3,1,3,0,1,0,59.3619972261
南投縣,魚池鄉,中明村,0,1,548,3,551,1020,3,1,3,0,1,0,54.0196078431
南投縣,魚池鄉,水社村,0,1,405,4,409,809,3,1,3,0,1,0,50.5562422744
南投縣,魚池鄉,日月村,0,1,257,1,258,522,3,1,3,0,1,0,49.4252873563
南投縣,魚池鄉,頭社村,0,1,533,6,539,953,3,1,3,0,1,0,56.5582371459
南投縣,魚池鄉,武登村,0,1,413,1,414,739,3,1,3,0,1,0,56.0216508796
南投縣,國姓鄉,國姓村,0,1,868,5,873,1630,3,1,3,0,1,0,53.5582822086
南投縣,國姓鄉,石門村,0,1,887,5,892,1681,3,1,3,0,1,0,53.0636525877
南投縣,國姓鄉,大旗村,0,1,408,3,411,756,3,1,3,0,1,0,54.3650793651
南投縣,國姓鄉,長流村,0,1,720,7,727,1503,3,1,3,0,1,0,48.369926813
南投縣,國姓鄉,長福村,0,1,337,7,344,694,3,1,3,0,1,0,49.5677233429
南投縣,國姓鄉,長豐村,0,1,405,8,413,824,3,1,3,0,1,0,50.1213592233
南投縣,國姓鄉,北港村,0,1,955,11,966,1977,3,1,3,0,1,0,48.8619119879
南投縣,國姓鄉,福龜村,0,1,987,17,1004,1844,3,1,3,0,1,0,54.4468546638
南投縣,國姓鄉,乾溝村,0,1,462,3,465,854,3,1,3,0,1,0,54.4496487119
南投縣,國姓鄉,柑林村,0,1,678,10,688,1198,3,1,3,0,1,0,57.429048414
南投縣,國姓鄉,大石村,0,1,390,5,395,754,3,1,3,0,1,0,52.3872679045
南投縣,國姓鄉,北山村,0,1,857,5,862,1605,3,1,3,0,1,0,53.707165109
南投縣,國姓鄉,南港村,0,1,914,15,929,1870,3,1,3,0,1,0,49.679144385
南投縣,水里鄉,水里村,0,1,485,4,489,895,3,1,3,0,1,0,54.6368715084
南投縣,水里鄉,新城村,0,1,864,7,871,1624,3,1,3,0,1,0,53.6330049261
南投縣,水里鄉,中央村,0,1,441,2,443,720,3,1,3,0,1,0,61.5277777778
南投縣,水里鄉,城中村,0,1,602,3,605,1029,3,1,3,0,1,0,58.79494655
南投縣,水里鄉,農富村,0,1,298,3,301,529,3,1,3,0,1,0,56.8998109641
南投縣,水里鄉,北埔村,0,1,560,2,562,990,3,1,3,0,1,0,56.7676767677
南投縣,水里鄉,南光村,0,1,769,5,774,1391,3,1,3,0,1,0,55.6434219986
南投縣,水里鄉,鉅工村,0,1,667,5,672,1061,3,1,3,0,1,0,63.3364750236
南投縣,水里鄉,永豐村,0,1,797,4,801,1367,3,1,3,0,1,0,58.5954645208
南投縣,水里鄉,民和村,0,1,518,7,525,1041,3,1,3,0,1,0,50.4322766571
南投縣,水里鄉,頂崁村,0,1,582,4,586,1151,3,1,3,0,1,0,50.9122502172
南投縣,水里鄉,新山村,0,1,182,2,184,370,3,1,3,0,1,0,49.7297297297
南投縣,水里鄉,郡坑村,0,1,209,2,211,365,3,1,3,0,1,0,57.8082191781
南投縣,水里鄉,上安村,0,1,592,3,595,1161,3,1,3,0,1,0,51.2489233419
南投縣,水里鄉,興隆村,0,1,189,4,193,347,3,1,3,0,1,0,55.6195965418
南投縣,水里鄉,永興村,0,1,213,2,215,361,3,1,3,0,1,0,59.5567867036
南投縣,水里鄉,玉峰村,0,1,517,1,518,914,3,1,3,0,1,0,56.6739606127
南投縣,水里鄉,車埕村,0,1,307,3,310,541,3,1,3,0,1,0,57.3012939002
南投縣,水里鄉,新興村,0,1,367,3,370,690,3,1,3,0,1,0,53.6231884058
南投縣,信義鄉,雙龍村,0,1,8,0,8,16,3,1,3,0,1,0,50
南投縣,信義鄉,地利村,0,1,40,0,40,76,3,1,3,0,1,0,52.6315789474
南投縣,信義鄉,潭南村,0,1,13,0,13,33,3,1,3,0,1,0,39.3939393939
南投縣,信義鄉,人和村,0,1,89,0,89,222,3,1,3,0,1,0,40.0900900901
南投縣,信義鄉,明德村,0,1,641,6,647,1100,3,1,3,0,1,0,58.8181818182
南投縣,信義鄉,自強村,0,1,452,5,457,745,3,1,3,0,1,0,61.3422818792
南投縣,信義鄉,愛國村,0,1,311,7,318,530,3,1,3,0,1,0,60
南投縣,信義鄉,豐丘村,0,1,181,2,183,327,3,1,3,0,1,0,55.9633027523
南投縣,信義鄉,新鄉村,0,1,32,0,32,63,3,1,3,0,1,0,50.7936507937
南投縣,信義鄉,羅娜村,0,1,109,0,109,230,3,1,3,0,1,0,47.3913043478
南投縣,信義鄉,望美村,0,1,151,1,152,300,3,1,3,0,1,0,50.6666666667
南投縣,信義鄉,同富村,0,1,775,4,779,1365,3,1,3,0,1,0,57.0695970696
南投縣,信義鄉,神木村,0,1,380,5,385,734,3,1,3,0,1,0,52.4523160763
南投縣,信義鄉,東埔村,0,1,155,2,157,285,3,1,3,0,1,0,55.0877192982
南投縣,仁愛鄉,南豐村,0,1,279,1,280,541,3,1,3,0,1,0,51.7560073937
南投縣,仁愛鄉,大同村,0,1,590,3,593,1107,3,1,3,0,1,0,53.5682023487
南投縣,仁愛鄉,榮興村,0,1,46,0,46,76,3,1,3,0,1,0,60.5263157895
南投縣,仁愛鄉,春陽村,0,1,34,0,34,66,3,1,3,0,1,0,51.5151515152
南投縣,仁愛鄉,精英村,0,1,76,0,76,166,3,1,3,0,1,0,45.7831325301
南投縣,仁愛鄉,合作村,0,1,10,0,10,26,3,1,3,0,1,0,38.4615384615
南投縣,仁愛鄉,發祥村,0,1,26,1,27,59,3,1,3,0,1,0,45.7627118644
南投縣,仁愛鄉,力行村,0,1,7,0,7,13,3,1,3,0,1,0,53.8461538462
南投縣,仁愛鄉,翠華村,0,1,73,2,75,251,3,1,3,0,1,0,29.8804780876
南投縣,仁愛鄉,親愛村,0,1,30,0,30,90,3,1,3,0,1,0,33.3333333333
南投縣,仁愛鄉,萬豐村,0,1,19,0,19,50,3,1,3,0,1,0,38
南投縣,仁愛鄉,法治村,0,1,10,0,10,29,3,1,3,0,1,0,34.4827586207
南投縣,仁愛鄉,中正村,0,1,34,0,34,85,3,1,3,0,1,0,40
南投縣,仁愛鄉,互助村,0,1,43,0,43,121,3,1,3,0,1,0,35.5371900826
南投縣,仁愛鄉,新生村,0,1,20,1,21,47,3,1,3,0,1,0,44.6808510638
雲林縣,斗六市,信義里,0,1,524,0,524,761,3,1,3,0,1,0,68.86
雲林縣,斗六市,四維里,0,1,485,5,490,695,3,1,3,0,1,0,70.50
雲林縣,斗六市,太平里,0,1,522,3,525,753,3,1,3,0,1,0,69.72
雲林縣,斗六市,中和里,0,1,666,8,674,914,3,1,3,0,1,0,73.74
雲林縣,斗六市,光興里,0,1,588,5,593,908,3,1,3,0,1,0,65.31
雲林縣,斗六市,鎮西里,0,1,1844,20,1864,2941,3,1,3,0,1,0,63.38
雲林縣,斗六市,鎮東里,0,1,2355,25,2380,3652,3,1,3,0,1,0,65.17
雲林縣,斗六市,三平里,0,1,2007,21,2028,3083,3,1,3,0,1,0,65.78
雲林縣,斗六市,明德里,0,1,1433,19,1452,2381,3,1,3,0,1,0,60.98
雲林縣,斗六市,鎮北里,0,1,1557,27,1584,2358,3,1,3,0,1,0,67.18
雲林縣,斗六市,公誠里,0,1,1132,8,1140,1817,3,1,3,0,1,0,62.74
雲林縣,斗六市,忠孝里,0,1,970,15,985,1443,3,1,3,0,1,0,68.26
雲林縣,斗六市,仁愛里,0,1,713,5,718,1125,3,1,3,0,1,0,63.82
雲林縣,斗六市,八德里,0,1,1756,13,1769,2709,3,1,3,0,1,0,65.30
雲林縣,斗六市,公正里,0,1,1540,20,1560,2351,3,1,3,0,1,0,66.35
雲林縣,斗六市,重光里,0,1,1278,17,1295,2026,3,1,3,0,1,0,63.92
雲林縣,斗六市,林頭里,0,1,2244,24,2268,3546,3,1,3,0,1,0,63.96
雲林縣,斗六市,成功里,0,1,1341,13,1354,2029,3,1,3,0,1,0,66.73
雲林縣,斗六市,鎮南里,0,1,2066,8,2074,3250,3,1,3,0,1,0,63.82
雲林縣,斗六市,社口里,0,1,1404,9,1413,2120,3,1,3,0,1,0,66.65
雲林縣,斗六市,龍潭里,0,1,804,8,812,1169,3,1,3,0,1,0,69.46
雲林縣,斗六市,嘉東里,0,1,507,22,529,752,3,1,3,0,1,0,70.35
雲林縣,斗六市,崙峰里,0,1,1170,12,1182,1780,3,1,3,0,1,0,66.40
雲林縣,斗六市,溝埧里,0,1,416,4,420,598,3,1,3,0,1,0,70.23
雲林縣,斗六市,江厝里,0,1,991,19,1010,1622,3,1,3,0,1,0,62.27
雲林縣,斗六市,三光里,0,1,397,5,402,565,3,1,3,0,1,0,71.15
雲林縣,斗六市,久安里,0,1,1284,11,1295,1912,3,1,3,0,1,0,67.73
雲林縣,斗六市,虎溪里,0,1,3014,27,3041,4479,3,1,3,0,1,0,67.89
雲林縣,斗六市,保庄里,0,1,2093,12,2105,3146,3,1,3,0,1,0,66.91
雲林縣,斗六市,長平里,0,1,1065,6,1071,1565,3,1,3,0,1,0,68.43
雲林縣,斗六市,榴中里,0,1,2445,30,2475,3806,3,1,3,0,1,0,65.03
雲林縣,斗六市,榴北里,0,1,626,6,632,944,3,1,3,0,1,0,66.95
雲林縣,斗六市,榴南里,0,1,770,11,781,1239,3,1,3,0,1,0,63.03
雲林縣,斗六市,梅林里,0,1,1208,11,1219,1708,3,1,3,0,1,0,71.37
雲林縣,斗六市,湖山里,0,1,883,14,897,1258,3,1,3,0,1,0,71.30
雲林縣,斗六市,長安里,0,1,1625,17,1642,2566,3,1,3,0,1,0,63.99
雲林縣,斗六市,溪洲里,0,1,1643,18,1661,2471,3,1,3,0,1,0,67.22
雲林縣,斗六市,十三里,0,1,801,4,805,1131,3,1,3,0,1,0,71.18
雲林縣,斗南鎮,東仁里,0,1,726,8,734,1131,3,1,3,0,1,0,64.90
雲林縣,斗南鎮,西岐里,0,1,2835,15,2850,4560,3,1,3,0,1,0,62.50
雲林縣,斗南鎮,南昌里,0,1,1220,3,1223,2020,3,1,3,0,1,0,60.54
雲林縣,斗南鎮,北銘里,0,1,846,6,852,1315,3,1,3,0,1,0,64.79
雲林縣,斗南鎮,中天里,0,1,814,4,818,1249,3,1,3,0,1,0,65.49
雲林縣,斗南鎮,林子里,0,1,826,1,827,1258,3,1,3,0,1,0,65.74
雲林縣,斗南鎮,石龜里,0,1,618,2,620,871,3,1,3,0,1,0,71.18
雲林縣,斗南鎮,石溪里,0,1,604,5,609,924,3,1,3,0,1,0,65.91
雲林縣,斗南鎮,靖興里,0,1,665,5,670,911,3,1,3,0,1,0,73.55
雲林縣,斗南鎮,新南里,0,1,480,6,486,736,3,1,3,0,1,0,66.03
雲林縣,斗南鎮,阿丹里,0,1,878,9,887,1175,3,1,3,0,1,0,75.49
雲林縣,斗南鎮,將軍里,0,1,963,9,972,1472,3,1,3,0,1,0,66.03
雲林縣,斗南鎮,舊社里,0,1,1199,17,1216,2010,3,1,3,0,1,0,60.50
雲林縣,斗南鎮,明昌里,0,1,2788,22,2810,4359,3,1,3,0,1,0,64.46
雲林縣,斗南鎮,大東里,0,1,611,10,621,913,3,1,3,0,1,0,68.02
雲林縣,斗南鎮,埤麻里,0,1,575,4,579,828,3,1,3,0,1,0,69.93
雲林縣,斗南鎮,西伯里,0,1,672,3,675,940,3,1,3,0,1,0,71.81
雲林縣,斗南鎮,新崙里,0,1,1030,12,1042,1585,3,1,3,0,1,0,65.74
雲林縣,斗南鎮,東明里,0,1,643,13,656,968,3,1,3,0,1,0,67.77
雲林縣,斗南鎮,新光里,0,1,1631,11,1642,2448,3,1,3,0,1,0,67.08
雲林縣,斗南鎮,田頭里,0,1,1424,16,1440,2062,3,1,3,0,1,0,69.84
雲林縣,斗南鎮,小東里,0,1,1020,8,1028,1578,3,1,3,0,1,0,65.15
雲林縣,虎尾鎮,東仁里,0,1,1423,16,1439,2303,3,1,3,0,1,0,62.48
雲林縣,虎尾鎮,新興里,0,1,1066,5,1071,1695,3,1,3,0,1,0,63.19
雲林縣,虎尾鎮,公安里,0,1,1682,15,1697,2652,3,1,3,0,1,0,63.99
雲林縣,虎尾鎮,德興里,0,1,1377,9,1386,2410,3,1,3,0,1,0,57.51
雲林縣,虎尾鎮,中山里,0,1,657,5,662,1045,3,1,3,0,1,0,63.35
雲林縣,虎尾鎮,西安里,0,1,1801,16,1817,2968,3,1,3,0,1,0,61.22
雲林縣,虎尾鎮,立仁里,0,1,2126,15,2141,3502,3,1,3,0,1,0,61.14
雲林縣,虎尾鎮,安慶里,0,1,875,13,888,1349,3,1,3,0,1,0,65.83
雲林縣,虎尾鎮,平和里,0,1,995,7,1002,1632,3,1,3,0,1,0,61.40
雲林縣,虎尾鎮,興南里,0,1,1085,14,1099,1782,3,1,3,0,1,0,61.67
雲林縣,虎尾鎮,新吉里,0,1,1541,23,1564,2626,3,1,3,0,1,0,59.56
雲林縣,虎尾鎮,穎川里,0,1,1055,9,1064,1663,3,1,3,0,1,0,63.98
雲林縣,虎尾鎮,延平里,0,1,604,10,614,942,3,1,3,0,1,0,65.18
雲林縣,虎尾鎮,建國里,0,1,365,2,367,631,3,1,3,0,1,0,58.16
雲林縣,虎尾鎮,埒內里,0,1,1497,15,1512,2351,3,1,3,0,1,0,64.31
雲林縣,虎尾鎮,堀頭里,0,1,552,9,561,789,3,1,3,0,1,0,71.10
雲林縣,虎尾鎮,安溪里,0,1,1073,21,1094,1727,3,1,3,0,1,0,63.35
雲林縣,虎尾鎮,興中里,0,1,1058,6,1064,1575,3,1,3,0,1,0,67.56
雲林縣,虎尾鎮,廉使里,0,1,1809,23,1832,2838,3,1,3,0,1,0,64.55
雲林縣,虎尾鎮,惠來里,0,1,1415,24,1439,2271,3,1,3,0,1,0,63.36
雲林縣,虎尾鎮,頂溪里,0,1,1634,17,1651,2467,3,1,3,0,1,0,66.92
雲林縣,虎尾鎮,中溪里,0,1,839,7,846,1307,3,1,3,0,1,0,64.73
雲林縣,虎尾鎮,下溪里,0,1,967,5,972,1319,3,1,3,0,1,0,73.69
雲林縣,虎尾鎮,東屯里,0,1,724,4,728,1181,3,1,3,0,1,0,61.64
雲林縣,虎尾鎮,西屯里,0,1,973,15,988,1497,3,1,3,0,1,0,66.00
雲林縣,虎尾鎮,芳草里,0,1,521,9,530,870,3,1,3,0,1,0,60.92
雲林縣,虎尾鎮,墾地里,0,1,588,6,594,976,3,1,3,0,1,0,60.86
雲林縣,虎尾鎮,北溪里,0,1,532,9,541,773,3,1,3,0,1,0,69.99
雲林縣,虎尾鎮,三合里,0,1,688,3,691,1041,3,1,3,0,1,0,66.38
雲林縣,西螺鎮,振興里,0,1,1075,6,1081,1603,3,1,3,0,1,0,67.44
雲林縣,西螺鎮,大園里,0,1,1002,10,1012,1509,3,1,3,0,1,0,67.06
雲林縣,西螺鎮,廣福里,0,1,1088,5,1093,1672,3,1,3,0,1,0,65.37
雲林縣,西螺鎮,正興里,0,1,1798,12,1810,2896,3,1,3,0,1,0,62.50
雲林縣,西螺鎮,永安里,0,1,294,3,297,441,3,1,3,0,1,0,67.35
雲林縣,西螺鎮,中和里,0,1,463,7,470,684,3,1,3,0,1,0,68.71
雲林縣,西螺鎮,福興里,0,1,409,1,410,632,3,1,3,0,1,0,64.87
雲林縣,西螺鎮,光華里,0,1,635,5,640,994,3,1,3,0,1,0,64.39
雲林縣,西螺鎮,中興里,0,1,1448,11,1459,2274,3,1,3,0,1,0,64.16
雲林縣,西螺鎮,漢光里,0,1,2133,24,2157,3477,3,1,3,0,1,0,62.04
雲林縣,西螺鎮,新安里,0,1,870,5,875,1294,3,1,3,0,1,0,67.62
雲林縣,西螺鎮,新豐里,0,1,1003,15,1018,1501,3,1,3,0,1,0,67.82
雲林縣,西螺鎮,大新里,0,1,1206,12,1218,1735,3,1,3,0,1,0,70.20
雲林縣,西螺鎮,埤頭里,0,1,601,6,607,891,3,1,3,0,1,0,68.13
雲林縣,西螺鎮,東興里,0,1,698,9,707,1105,3,1,3,0,1,0,63.98
雲林縣,西螺鎮,鹿場里,0,1,1003,10,1013,1499,3,1,3,0,1,0,67.58
雲林縣,西螺鎮,廣興里,0,1,628,6,634,859,3,1,3,0,1,0,73.81
雲林縣,西螺鎮,頂湳里,0,1,709,9,718,974,3,1,3,0,1,0,73.72
雲林縣,西螺鎮,吳厝里,0,1,872,9,881,1360,3,1,3,0,1,0,64.78
雲林縣,西螺鎮,九隆里,0,1,544,4,548,760,3,1,3,0,1,0,72.11
雲林縣,西螺鎮,下湳里,0,1,584,1,585,813,3,1,3,0,1,0,71.96
雲林縣,西螺鎮,七座里,0,1,652,10,662,965,3,1,3,0,1,0,68.60
雲林縣,西螺鎮,公館里,0,1,863,13,876,1371,3,1,3,0,1,0,63.89
雲林縣,西螺鎮,詔安里,0,1,634,5,639,970,3,1,3,0,1,0,65.88
雲林縣,西螺鎮,河南里,0,1,573,6,579,916,3,1,3,0,1,0,63.21
雲林縣,西螺鎮,安定里,0,1,1116,13,1129,1790,3,1,3,0,1,0,63.07
雲林縣,西螺鎮,福田里,0,1,965,15,980,1438,3,1,3,0,1,0,68.15
雲林縣,土庫鎮,忠正里,0,1,624,5,629,917,3,1,3,0,1,0,68.59
雲林縣,土庫鎮,順天里,0,1,711,12,723,1018,3,1,3,0,1,0,71.02
雲林縣,土庫鎮,宮北里,0,1,922,11,933,1390,3,1,3,0,1,0,67.12
雲林縣,土庫鎮,越港里,0,1,649,8,657,922,3,1,3,0,1,0,71.26
雲林縣,土庫鎮,溪邊里,0,1,797,14,811,1155,3,1,3,0,1,0,70.22
雲林縣,土庫鎮,石廟里,0,1,1071,14,1085,1659,3,1,3,0,1,0,65.40
雲林縣,土庫鎮,興新里,0,1,843,7,850,1334,3,1,3,0,1,0,63.72
雲林縣,土庫鎮,奮起里,0,1,856,10,866,1414,3,1,3,0,1,0,61.24
雲林縣,土庫鎮,埤腳里,0,1,937,13,950,1439,3,1,3,0,1,0,66.02
雲林縣,土庫鎮,後埔里,0,1,1435,9,1444,2352,3,1,3,0,1,0,61.39
雲林縣,土庫鎮,崙內里,0,1,961,12,973,1525,3,1,3,0,1,0,63.80
雲林縣,土庫鎮,大荖里,0,1,578,13,591,883,3,1,3,0,1,0,66.93
雲林縣,土庫鎮,東平里,0,1,1129,9,1138,1882,3,1,3,0,1,0,60.47
雲林縣,土庫鎮,南平里,0,1,1137,8,1145,1821,3,1,3,0,1,0,62.88
雲林縣,土庫鎮,西平里,0,1,1131,6,1137,1788,3,1,3,0,1,0,63.59
雲林縣,土庫鎮,北平里,0,1,626,3,629,993,3,1,3,0,1,0,63.34
雲林縣,土庫鎮,新庄里,0,1,898,9,907,1475,3,1,3,0,1,0,61.49
雲林縣,北港鎮,東陽里,0,1,545,7,552,789,3,1,3,0,1,0,69.96
雲林縣,北港鎮,光民里,0,1,510,3,513,749,3,1,3,0,1,0,68.49
雲林縣,北港鎮,東華里,0,1,337,4,341,512,3,1,3,0,1,0,66.60
雲林縣,北港鎮,南安里,0,1,702,6,708,998,3,1,3,0,1,0,70.94
雲林縣,北港鎮,中和里,0,1,267,4,271,430,3,1,3,0,1,0,63.02
雲林縣,北港鎮,義民里,0,1,305,3,308,452,3,1,3,0,1,0,68.14
雲林縣,北港鎮,共榮里,0,1,292,1,293,417,3,1,3,0,1,0,70.26
雲林縣,北港鎮,西勢里,0,1,616,6,622,949,3,1,3,0,1,0,65.54
雲林縣,北港鎮,仁和里,0,1,374,0,374,551,3,1,3,0,1,0,67.88
雲林縣,北港鎮,賜福里,0,1,247,0,247,382,3,1,3,0,1,0,64.66
雲林縣,北港鎮,公館里,0,1,421,6,427,669,3,1,3,0,1,0,63.83
雲林縣,北港鎮,大同里,0,1,838,10,848,1356,3,1,3,0,1,0,62.54
雲林縣,北港鎮,仁安里,0,1,341,3,344,528,3,1,3,0,1,0,65.15
雲林縣,北港鎮,華勝里,0,1,3049,36,3085,4855,3,1,3,0,1,0,63.54
雲林縣,北港鎮,光復里,0,1,898,8,906,1448,3,1,3,0,1,0,62.57
雲林縣,北港鎮,新街里,0,1,3116,30,3146,5098,3,1,3,0,1,0,61.71
雲林縣,北港鎮,劉厝里,0,1,746,6,752,1190,3,1,3,0,1,0,63.19
雲林縣,北港鎮,後溝里,0,1,622,7,629,977,3,1,3,0,1,0,64.38
雲林縣,北港鎮,新厝里,0,1,264,4,268,436,3,1,3,0,1,0,61.47
雲林縣,北港鎮,府番里,0,1,537,2,539,853,3,1,3,0,1,0,63.19
雲林縣,北港鎮,草湖里,0,1,830,12,842,1427,3,1,3,0,1,0,59.00
雲林縣,北港鎮,溝皂里,0,1,722,5,727,1213,3,1,3,0,1,0,59.93
雲林縣,北港鎮,番溝里,0,1,550,3,553,1013,3,1,3,0,1,0,54.59
雲林縣,北港鎮,大北里,0,1,339,6,345,644,3,1,3,0,1,0,53.57
雲林縣,北港鎮,好收里,0,1,1091,14,1105,1650,3,1,3,0,1,0,66.97
雲林縣,北港鎮,樹腳里,0,1,1669,19,1688,2798,3,1,3,0,1,0,60.33
雲林縣,北港鎮,扶朝里,0,1,647,4,651,1025,3,1,3,0,1,0,63.51
雲林縣,北港鎮,水埔里,0,1,348,0,348,562,3,1,3,0,1,0,61.92
雲林縣,古坑鄉,棋盤村,0,1,1376,17,1393,2089,3,1,3,0,1,0,66.68
雲林縣,古坑鄉,新庄村,0,1,963,12,975,1545,3,1,3,0,1,0,63.11
雲林縣,古坑鄉,東和村,0,1,1682,25,1707,2845,3,1,3,0,1,0,60.00
雲林縣,古坑鄉,荷苞村,0,1,900,7,907,1436,3,1,3,0,1,0,63.16
雲林縣,古坑鄉,高林村,0,1,789,10,799,1167,3,1,3,0,1,0,68.47
雲林縣,古坑鄉,水碓村,0,1,788,10,798,1212,3,1,3,0,1,0,65.84
雲林縣,古坑鄉,田心村,0,1,644,6,650,979,3,1,3,0,1,0,66.39
雲林縣,古坑鄉,古坑村,0,1,1279,13,1292,2057,3,1,3,0,1,0,62.81
雲林縣,古坑鄉,朝陽村,0,1,1300,12,1312,1952,3,1,3,0,1,0,67.21
雲林縣,古坑鄉,西平村,0,1,926,5,931,1399,3,1,3,0,1,0,66.55
雲林縣,古坑鄉,湳仔村,0,1,504,6,510,688,3,1,3,0,1,0,74.13
雲林縣,古坑鄉,永光村,0,1,1111,31,1142,1924,3,1,3,0,1,0,59.36
雲林縣,古坑鄉,永昌村,0,1,1169,13,1182,2018,3,1,3,0,1,0,58.57
雲林縣,古坑鄉,麻園村,0,1,465,11,476,660,3,1,3,0,1,0,72.12
雲林縣,古坑鄉,崁腳村,0,1,785,10,795,1266,3,1,3,0,1,0,62.80
雲林縣,古坑鄉,華南村,0,1,219,2,221,321,3,1,3,0,1,0,68.85
雲林縣,古坑鄉,華山村,0,1,434,9,443,788,3,1,3,0,1,0,56.22
雲林縣,古坑鄉,桂林村,0,1,676,3,679,1167,3,1,3,0,1,0,58.18
雲林縣,古坑鄉,樟湖村,0,1,328,2,330,537,3,1,3,0,1,0,61.45
雲林縣,古坑鄉,草嶺村,0,1,456,4,460,675,3,1,3,0,1,0,68.15
雲林縣,大埤鄉,北和村,0,1,521,3,524,785,3,1,3,0,1,0,66.75
雲林縣,大埤鄉,南和村,0,1,1363,17,1380,2086,3,1,3,0,1,0,66.16
雲林縣,大埤鄉,大德村,0,1,719,7,726,1096,3,1,3,0,1,0,66.24
雲林縣,大埤鄉,松竹村,0,1,659,4,663,990,3,1,3,0,1,0,66.97
雲林縣,大埤鄉,尚義村,0,1,1184,13,1197,1882,3,1,3,0,1,0,63.60
雲林縣,大埤鄉,嘉興村,0,1,1172,16,1188,1815,3,1,3,0,1,0,65.45
雲林縣,大埤鄉,豐田村,0,1,833,10,843,1385,3,1,3,0,1,0,60.87
雲林縣,大埤鄉,三結村,0,1,786,5,791,1254,3,1,3,0,1,0,63.08
雲林縣,大埤鄉,吉田村,0,1,495,5,500,804,3,1,3,0,1,0,62.19
雲林縣,大埤鄉,豐岡村,0,1,429,8,437,684,3,1,3,0,1,0,63.89
雲林縣,大埤鄉,聯美村,0,1,777,6,783,1227,3,1,3,0,1,0,63.81
雲林縣,大埤鄉,怡然村,0,1,573,8,581,832,3,1,3,0,1,0,69.83
雲林縣,大埤鄉,北鎮村,0,1,443,5,448,716,3,1,3,0,1,0,62.57
雲林縣,大埤鄉,興安村,0,1,518,5,523,781,3,1,3,0,1,0,66.97
雲林縣,大埤鄉,西鎮村,0,1,533,5,538,788,3,1,3,0,1,0,68.27
雲林縣,莿桐鄉,莿桐村,0,1,2324,26,2350,3550,3,1,3,0,1,0,66.20
雲林縣,莿桐鄉,甘厝村,0,1,614,6,620,917,3,1,3,0,1,0,67.61
雲林縣,莿桐鄉,甘西村,0,1,995,9,1004,1619,3,1,3,0,1,0,62.01
雲林縣,莿桐鄉,興桐村,0,1,864,6,870,1269,3,1,3,0,1,0,68.56
雲林縣,莿桐鄉,義和村,0,1,798,9,807,1149,3,1,3,0,1,0,70.23
雲林縣,莿桐鄉,埔子村,0,1,1173,13,1186,1749,3,1,3,0,1,0,67.81
雲林縣,莿桐鄉,大美村,0,1,1664,3,1667,2517,3,1,3,0,1,0,66.23
雲林縣,莿桐鄉,埔尾村,0,1,892,10,902,1282,3,1,3,0,1,0,70.36
雲林縣,莿桐鄉,興貴村,0,1,1250,6,1256,1894,3,1,3,0,1,0,66.31
雲林縣,莿桐鄉,饒平村,0,1,782,11,793,1170,3,1,3,0,1,0,67.78
雲林縣,莿桐鄉,四合村,0,1,1221,17,1238,1759,3,1,3,0,1,0,70.38
雲林縣,莿桐鄉,麻園村,0,1,1141,9,1150,1588,3,1,3,0,1,0,72.42
雲林縣,莿桐鄉,五華村,0,1,937,16,953,1335,3,1,3,0,1,0,71.39
雲林縣,莿桐鄉,六合村,0,1,1159,6,1165,1763,3,1,3,0,1,0,66.08
雲林縣,林內鄉,林南村,0,1,730,8,738,1054,3,1,3,0,1,0,70.02
雲林縣,林內鄉,林中村,0,1,2179,21,2200,3420,3,1,3,0,1,0,64.33
雲林縣,林內鄉,林北村,0,1,1367,15,1382,2125,3,1,3,0,1,0,65.04
雲林縣,林內鄉,坪頂村,0,1,437,4,441,594,3,1,3,0,1,0,74.24
雲林縣,林內鄉,林茂村,0,1,649,7,656,927,3,1,3,0,1,0,70.77
雲林縣,林內鄉,九芎村,0,1,1762,16,1778,2539,3,1,3,0,1,0,70.03
雲林縣,林內鄉,湖本村,0,1,473,8,481,654,3,1,3,0,1,0,73.55
雲林縣,林內鄉,烏塗村,0,1,791,3,794,1111,3,1,3,0,1,0,71.47
雲林縣,林內鄉,烏麻村,0,1,734,9,743,1044,3,1,3,0,1,0,71.17
雲林縣,林內鄉,重興村,0,1,1270,9,1279,1776,3,1,3,0,1,0,72.02
雲林縣,二崙鄉,崙東村,0,1,940,10,950,1446,3,1,3,0,1,0,65.70
雲林縣,二崙鄉,崙西村,0,1,1054,3,1057,1654,3,1,3,0,1,0,63.91
雲林縣,二崙鄉,來惠村,0,1,1149,8,1157,1772,3,1,3,0,1,0,65.29
雲林縣,二崙鄉,三和村,0,1,1041,6,1047,1626,3,1,3,0,1,0,64.39
雲林縣,二崙鄉,湳仔村,0,1,863,4,867,1244,3,1,3,0,1,0,69.69
雲林縣,二崙鄉,田尾村,0,1,1278,5,1283,1987,3,1,3,0,1,0,64.57
雲林縣,二崙鄉,定安村,0,1,597,5,602,969,3,1,3,0,1,0,62.13
雲林縣,二崙鄉,永定村,0,1,854,7,861,1373,3,1,3,0,1,0,62.71
雲林縣,二崙鄉,大華村,0,1,592,3,595,918,3,1,3,0,1,0,64.81
雲林縣,二崙鄉,義庄村,0,1,505,0,505,769,3,1,3,0,1,0,65.67
雲林縣,二崙鄉,楊賢村,0,1,979,11,990,1528,3,1,3,0,1,0,64.79
雲林縣,二崙鄉,港後村,0,1,1227,12,1239,1953,3,1,3,0,1,0,63.44
雲林縣,二崙鄉,大義村,0,1,599,5,604,928,3,1,3,0,1,0,65.09
雲林縣,二崙鄉,油車村,0,1,1099,10,1109,1794,3,1,3,0,1,0,61.82
雲林縣,二崙鄉,大庄村,0,1,856,6,862,1426,3,1,3,0,1,0,60.45
雲林縣,二崙鄉,庄西村,0,1,558,2,560,1001,3,1,3,0,1,0,55.94
雲林縣,二崙鄉,大同村,0,1,543,6,549,862,3,1,3,0,1,0,63.69
雲林縣,二崙鄉,復興村,0,1,699,8,707,1067,3,1,3,0,1,0,66.26
雲林縣,崙背鄉,東明村,0,1,841,10,851,1274,3,1,3,0,1,0,66.80
雲林縣,崙背鄉,西榮村,0,1,888,8,896,1408,3,1,3,0,1,0,63.64
雲林縣,崙背鄉,南陽村,0,1,1457,13,1470,2277,3,1,3,0,1,0,64.56
雲林縣,崙背鄉,崙前村,0,1,1314,12,1326,2063,3,1,3,0,1,0,64.28
雲林縣,崙背鄉,羅厝村,0,1,1260,16,1276,2044,3,1,3,0,1,0,62.43
雲林縣,崙背鄉,港尾村,0,1,870,10,880,1370,3,1,3,0,1,0,64.23
雲林縣,崙背鄉,阿勸村,0,1,1392,22,1414,2052,3,1,3,0,1,0,68.91
雲林縣,崙背鄉,五魁村,0,1,595,5,600,913,3,1,3,0,1,0,65.72
雲林縣,崙背鄉,大有村,0,1,1082,23,1105,1748,3,1,3,0,1,0,63.22
雲林縣,崙背鄉,豐榮村,0,1,1209,11,1220,2060,3,1,3,0,1,0,59.22
雲林縣,崙背鄉,草湖村,0,1,954,7,961,1518,3,1,3,0,1,0,63.31
雲林縣,崙背鄉,舊庄村,0,1,761,21,782,1214,3,1,3,0,1,0,64.42
雲林縣,崙背鄉,水尾村,0,1,838,10,848,1282,3,1,3,0,1,0,66.15
雲林縣,崙背鄉,枋南村,0,1,591,4,595,854,3,1,3,0,1,0,69.67
雲林縣,麥寮鄉,麥豐村,0,1,2225,22,2247,3449,3,1,3,0,1,0,65.15
雲林縣,麥寮鄉,麥津村,0,1,1685,24,1709,2611,3,1,3,0,1,0,65.45
雲林縣,麥寮鄉,瓦窯村,0,1,860,6,866,1356,3,1,3,0,1,0,63.86
雲林縣,麥寮鄉,興華村,0,1,1170,9,1179,1821,3,1,3,0,1,0,64.74
雲林縣,麥寮鄉,海豐村,0,1,878,4,882,1467,3,1,3,0,1,0,60.12
雲林縣,麥寮鄉,後安村,0,1,1314,9,1323,2145,3,1,3,0,1,0,61.68
雲林縣,麥寮鄉,三盛村,0,1,1438,17,1455,2295,3,1,3,0,1,0,63.40
雲林縣,麥寮鄉,崙後村,0,1,1089,3,1092,1852,3,1,3,0,1,0,58.96
雲林縣,麥寮鄉,橋頭村,0,1,1613,15,1628,2609,3,1,3,0,1,0,62.40
雲林縣,麥寮鄉,新吉村,0,1,487,6,493,789,3,1,3,0,1,0,62.48
雲林縣,麥寮鄉,施厝村,0,1,1377,19,1396,2231,3,1,3,0,1,0,62.57
雲林縣,麥寮鄉,雷厝村,0,1,814,12,826,1479,3,1,3,0,1,0,55.85
雲林縣,東勢鄉,月眉村,0,1,772,8,780,1280,3,1,3,0,1,0,60.94
雲林縣,東勢鄉,復興村,0,1,325,4,329,501,3,1,3,0,1,0,65.67
雲林縣,東勢鄉,嘉隆村,0,1,1082,14,1096,1794,3,1,3,0,1,0,61.09
雲林縣,東勢鄉,東南村,0,1,990,6,996,1466,3,1,3,0,1,0,67.94
雲林縣,東勢鄉,東北村,0,1,769,8,777,1213,3,1,3,0,1,0,64.06
雲林縣,東勢鄉,龍潭村,0,1,519,3,522,995,3,1,3,0,1,0,52.46
雲林縣,東勢鄉,程海村,0,1,384,6,390,611,3,1,3,0,1,0,63.83
雲林縣,東勢鄉,昌南村,0,1,645,4,649,966,3,1,3,0,1,0,67.18
雲林縣,東勢鄉,安南村,0,1,527,8,535,923,3,1,3,0,1,0,57.96
雲林縣,東勢鄉,同安村,0,1,1439,8,1447,2174,3,1,3,0,1,0,66.56
雲林縣,東勢鄉,四美村,0,1,777,5,782,1277,3,1,3,0,1,0,61.24
雲林縣,東勢鄉,新坤村,0,1,764,3,767,1252,3,1,3,0,1,0,61.26
雲林縣,褒忠鄉,中民村,0,1,1371,12,1383,1914,3,1,3,0,1,0,72.26
雲林縣,褒忠鄉,埔姜村,0,1,987,6,993,1411,3,1,3,0,1,0,70.38
雲林縣,褒忠鄉,中勝村,0,1,968,9,977,1446,3,1,3,0,1,0,67.57
雲林縣,褒忠鄉,馬鳴村,0,1,1026,11,1037,1411,3,1,3,0,1,0,73.49
雲林縣,褒忠鄉,新湖村,0,1,933,7,940,1303,3,1,3,0,1,0,72.14
雲林縣,褒忠鄉,有才村,0,1,636,2,638,970,3,1,3,0,1,0,65.77
雲林縣,褒忠鄉,田洋村,0,1,549,2,551,804,3,1,3,0,1,0,68.53
雲林縣,褒忠鄉,龍岩村,0,1,793,8,801,1281,3,1,3,0,1,0,62.53
雲林縣,褒忠鄉,潮厝村,0,1,609,5,614,979,3,1,3,0,1,0,62.72
雲林縣,台西鄉,臺西村,0,1,822,10,832,1251,3,1,3,0,1,0,66.51
雲林縣,台西鄉,海南村,0,1,669,9,678,1051,3,1,3,0,1,0,64.51
雲林縣,台西鄉,海北村,0,1,663,3,666,1059,3,1,3,0,1,0,62.89
雲林縣,台西鄉,海口村,0,1,1203,10,1213,1975,3,1,3,0,1,0,61.42
雲林縣,台西鄉,山寮村,0,1,487,11,498,903,3,1,3,0,1,0,55.15
雲林縣,台西鄉,溪頂村,0,1,809,7,816,1525,3,1,3,0,1,0,53.51
雲林縣,台西鄉,牛厝村,0,1,1129,13,1142,1949,3,1,3,0,1,0,58.59
雲林縣,台西鄉,泉州村,0,1,365,4,369,659,3,1,3,0,1,0,55.99
雲林縣,台西鄉,五榔村,0,1,250,2,252,487,3,1,3,0,1,0,51.75
雲林縣,台西鄉,光華村,0,1,405,6,411,699,3,1,3,0,1,0,58.80
雲林縣,台西鄉,五港村,0,1,1162,8,1170,1926,3,1,3,0,1,0,60.75
雲林縣,台西鄉,富琦村,0,1,985,10,995,1579,3,1,3,0,1,0,63.01
雲林縣,台西鄉,永豐村,0,1,930,6,936,1473,3,1,3,0,1,0,63.54
雲林縣,台西鄉,和豐村,0,1,1939,11,1950,3260,3,1,3,0,1,0,59.82
雲林縣,台西鄉,蚊港村,0,1,1378,13,1391,2041,3,1,3,0,1,0,68.15
雲林縣,元長鄉,長南村,0,1,2008,25,2033,3222,3,1,3,0,1,0,63.10
雲林縣,元長鄉,長北村,0,1,988,11,999,1657,3,1,3,0,1,0,60.29
雲林縣,元長鄉,子茂村,0,1,912,10,922,1503,3,1,3,0,1,0,61.34
雲林縣,元長鄉,後湖村,0,1,521,4,525,809,3,1,3,0,1,0,64.89
雲林縣,元長鄉,山內村,0,1,696,7,703,1066,3,1,3,0,1,0,65.95
雲林縣,元長鄉,合和村,0,1,681,5,686,1216,3,1,3,0,1,0,56.41
雲林縣,元長鄉,五塊村,0,1,626,3,629,1054,3,1,3,0,1,0,59.68
雲林縣,元長鄉,潭西村,0,1,468,1,469,921,3,1,3,0,1,0,50.92
雲林縣,元長鄉,潭東村,0,1,383,3,386,669,3,1,3,0,1,0,57.70
雲林縣,元長鄉,客厝村,0,1,542,6,548,877,3,1,3,0,1,0,62.49
雲林縣,元長鄉,卓運村,0,1,255,3,258,459,3,1,3,0,1,0,56.21
雲林縣,元長鄉,頂寮村,0,1,718,7,725,1223,3,1,3,0,1,0,59.28
雲林縣,元長鄉,下寮村,0,1,952,14,966,1533,3,1,3,0,1,0,63.01
雲林縣,元長鄉,龍岩村,0,1,691,5,696,1102,3,1,3,0,1,0,63.16
雲林縣,元長鄉,西莊村,0,1,532,9,541,923,3,1,3,0,1,0,58.61
雲林縣,元長鄉,鹿北村,0,1,820,9,829,1329,3,1,3,0,1,0,62.38
雲林縣,元長鄉,鹿南村,0,1,625,12,637,1023,3,1,3,0,1,0,62.27
雲林縣,元長鄉,瓦窯村,0,1,1034,11,1045,1659,3,1,3,0,1,0,62.99
雲林縣,元長鄉,內寮村,0,1,432,3,435,667,3,1,3,0,1,0,65.22
雲林縣,元長鄉,崙仔村,0,1,576,7,583,918,3,1,3,0,1,0,63.51
雲林縣,元長鄉,新吉村,0,1,515,4,519,740,3,1,3,0,1,0,70.14
雲林縣,四湖鄉,四湖村,0,1,1089,16,1105,1757,3,1,3,0,1,0,62.89
雲林縣,四湖鄉,湖西村,0,1,1393,18,1411,2159,3,1,3,0,1,0,65.35
雲林縣,四湖鄉,新庄村,0,1,443,2,445,716,3,1,3,0,1,0,62.15
雲林縣,四湖鄉,溪底村,0,1,638,5,643,1080,3,1,3,0,1,0,59.54
雲林縣,四湖鄉,鹿場村,0,1,633,3,636,1094,3,1,3,0,1,0,58.14
雲林縣,四湖鄉,蔡厝村,0,1,520,9,529,969,3,1,3,0,1,0,54.59
雲林縣,四湖鄉,湖寮村,0,1,451,6,457,874,3,1,3,0,1,0,52.29
雲林縣,四湖鄉,施湖村,0,1,721,9,730,1209,3,1,3,0,1,0,60.38
雲林縣,四湖鄉,羊調村,0,1,601,4,605,1141,3,1,3,0,1,0,53.02
雲林縣,四湖鄉,內湖村,0,1,462,2,464,953,3,1,3,0,1,0,48.69
雲林縣,四湖鄉,飛東村,0,1,337,6,343,647,3,1,3,0,1,0,53.01
雲林縣,四湖鄉,飛沙村,0,1,514,4,518,986,3,1,3,0,1,0,52.54
雲林縣,四湖鄉,三姓村,0,1,228,4,232,414,3,1,3,0,1,0,56.04
雲林縣,四湖鄉,崙北村,0,1,1036,10,1046,1794,3,1,3,0,1,0,58.31
雲林縣,四湖鄉,崙南村,0,1,486,5,491,895,3,1,3,0,1,0,54.86
雲林縣,四湖鄉,廣溝村,0,1,386,5,391,814,3,1,3,0,1,0,48.03
雲林縣,四湖鄉,箔子村,0,1,488,7,495,1021,3,1,3,0,1,0,48.48
雲林縣,四湖鄉,箔東村,0,1,552,6,558,1141,3,1,3,0,1,0,48.90
雲林縣,四湖鄉,林厝村,0,1,677,3,680,1283,3,1,3,0,1,0,53.00
雲林縣,四湖鄉,林東村,0,1,534,6,540,1086,3,1,3,0,1,0,49.72
雲林縣,四湖鄉,溪尾村,0,1,409,1,410,829,3,1,3,0,1,0,49.46
雲林縣,口湖鄉,口湖村,0,1,712,5,717,1084,3,1,3,0,1,0,66.14
雲林縣,口湖鄉,湖東村,0,1,868,10,878,1319,3,1,3,0,1,0,66.57
雲林縣,口湖鄉,頂湖村,0,1,411,0,411,693,3,1,3,0,1,0,59.31
雲林縣,口湖鄉,埔南村,0,1,430,3,433,678,3,1,3,0,1,0,63.86
雲林縣,口湖鄉,埔北村,0,1,449,7,456,931,3,1,3,0,1,0,48.98
雲林縣,口湖鄉,謝厝村,0,1,605,11,616,1001,3,1,3,0,1,0,61.54
雲林縣,口湖鄉,蚵寮村,0,1,927,6,933,1472,3,1,3,0,1,0,63.38
雲林縣,口湖鄉,下崙村,0,1,1096,5,1101,2095,3,1,3,0,1,0,52.55
雲林縣,口湖鄉,崙中村,0,1,924,5,929,1753,3,1,3,0,1,0,52.99
雲林縣,口湖鄉,崙東村,0,1,848,9,857,1525,3,1,3,0,1,0,56.20
雲林縣,口湖鄉,青蚶村,0,1,281,4,285,572,3,1,3,0,1,0,49.83
雲林縣,口湖鄉,港東村,0,1,876,8,884,1530,3,1,3,0,1,0,57.78
雲林縣,口湖鄉,港西村,0,1,464,8,472,803,3,1,3,0,1,0,58.78
雲林縣,口湖鄉,臺子村,0,1,1098,9,1107,1702,3,1,3,0,1,0,65.04
雲林縣,口湖鄉,成龍村,0,1,675,0,675,1033,3,1,3,0,1,0,65.34
雲林縣,口湖鄉,梧南村,0,1,1170,7,1177,1866,3,1,3,0,1,0,63.08
雲林縣,口湖鄉,梧北村,0,1,776,3,779,1317,3,1,3,0,1,0,59.15
雲林縣,口湖鄉,水井村,0,1,686,6,692,1060,3,1,3,0,1,0,65.28
雲林縣,口湖鄉,後厝村,0,1,513,3,516,789,3,1,3,0,1,0,65.40
雲林縣,口湖鄉,湖口村,0,1,641,7,648,1057,3,1,3,0,1,0,61.31
雲林縣,口湖鄉,過港村,0,1,447,4,451,754,3,1,3,0,1,0,59.81
雲林縣,水林鄉,水北村,0,1,1503,9,1512,2278,3,1,3,0,1,0,66.37
雲林縣,水林鄉,水南村,0,1,1323,12,1335,1943,3,1,3,0,1,0,68.71
雲林縣,水林鄉,萬興村,0,1,495,3,498,762,3,1,3,0,1,0,65.35
雲林縣,水林鄉,尖山村,0,1,473,5,478,745,3,1,3,0,1,0,64.16
雲林縣,水林鄉,大溝村,0,1,712,5,717,1080,3,1,3,0,1,0,66.39
雲林縣,水林鄉,順興村,0,1,567,6,573,927,3,1,3,0,1,0,61.81
雲林縣,水林鄉,大山村,0,1,774,8,782,1173,3,1,3,0,1,0,66.67
雲林縣,水林鄉,後寮村,0,1,496,3,499,794,3,1,3,0,1,0,62.85
雲林縣,水林鄉,春埔村,0,1,644,5,649,1068,3,1,3,0,1,0,60.77
雲林縣,水林鄉,西井村,0,1,442,9,451,751,3,1,3,0,1,0,60.05
雲林縣,水林鄉,車港村,0,1,410,2,412,683,3,1,3,0,1,0,60.32
雲林縣,水林鄉,蘇秦村,0,1,673,9,682,1204,3,1,3,0,1,0,56.64
雲林縣,水林鄉,灣東村,0,1,459,5,464,753,3,1,3,0,1,0,61.62
雲林縣,水林鄉,灣西村,0,1,650,8,658,1060,3,1,3,0,1,0,62.08
雲林縣,水林鄉,蕃薯村,0,1,644,10,654,1039,3,1,3,0,1,0,62.95
雲林縣,水林鄉,山腳村,0,1,536,5,541,892,3,1,3,0,1,0,60.65
雲林縣,水林鄉,松北村,0,1,887,6,893,1228,3,1,3,0,1,0,72.72
雲林縣,水林鄉,松中村,0,1,410,4,414,608,3,1,3,0,1,0,68.09
雲林縣,水林鄉,松西村,0,1,521,8,529,786,3,1,3,0,1,0,67.30
雲林縣,水林鄉,舊埔村,0,1,516,8,524,854,3,1,3,0,1,0,61.36
雲林縣,水林鄉,塭底村,0,1,523,5,528,838,3,1,3,0,1,0,63.01
雲林縣,水林鄉,海埔村,0,1,701,8,709,1060,3,1,3,0,1,0,66.89
雲林縣,水林鄉,土厝村,0,1,807,6,813,1257,3,1,3,0,1,0,64.68
雲林縣,水林鄉,溪墘村,0,1,574,2,576,828,3,1,3,0,1,0,69.57
嘉義縣,太保市,太保里,0,1,993,9,1002,1791,3,1,3,0,1,0,55.95
嘉義縣,太保市,後庄里,0,1,293,3,296,499,3,1,3,0,1,0,59.32
嘉義縣,太保市,前潭里,0,1,832,9,841,1372,3,1,3,0,1,0,61.30
嘉義縣,太保市,後潭里,0,1,980,8,988,1516,3,1,3,0,1,0,65.17
嘉義縣,太保市,梅埔里,0,1,733,5,738,1100,3,1,3,0,1,0,67.09
嘉義縣,太保市,春珠里,0,1,502,9,511,868,3,1,3,0,1,0,58.87
嘉義縣,太保市,崙頂里,0,1,557,10,567,822,3,1,3,0,1,0,68.98
嘉義縣,太保市,安仁里,0,1,758,10,768,1208,3,1,3,0,1,0,63.58
嘉義縣,太保市,東勢里,0,1,575,5,580,894,3,1,3,0,1,0,64.88
嘉義縣,太保市,新埤里,0,1,746,5,751,1206,3,1,3,0,1,0,62.27
嘉義縣,太保市,舊埤里,0,1,966,8,974,1855,3,1,3,0,1,0,52.51
嘉義縣,太保市,田尾里,0,1,423,4,427,716,3,1,3,0,1,0,59.64
嘉義縣,太保市,港尾里,0,1,390,4,394,564,3,1,3,0,1,0,69.86
嘉義縣,太保市,過溝里,0,1,1346,7,1353,2189,3,1,3,0,1,0,61.8090452261
嘉義縣,太保市,麻寮里,0,1,1568,26,1594,2947,3,1,3,0,1,0,54.09
嘉義縣,太保市,南新里,0,1,1012,9,1021,1770,3,1,3,0,1,0,57.68
嘉義縣,太保市,北新里,0,1,1252,14,1266,2269,3,1,3,0,1,0,55.80
嘉義縣,太保市,埤鄉里,0,1,424,3,427,712,3,1,3,0,1,0,59.97
嘉義縣,朴子市,安福里,0,1,1099,10,1109,1812,3,1,3,0,1,0,61.20
嘉義縣,朴子市,平和里,0,1,1133,13,1146,1866,3,1,3,0,1,0,61.41
嘉義縣,朴子市,內厝里,0,1,673,4,677,1107,3,1,3,0,1,0,61.16
嘉義縣,朴子市,開元里,0,1,305,1,306,481,3,1,3,0,1,0,63.62
嘉義縣,朴子市,順天里,0,1,438,6,444,710,3,1,3,0,1,0,62.5352112676
嘉義縣,朴子市,中正里,0,1,428,4,432,699,3,1,3,0,1,0,61.8025751073
嘉義縣,朴子市,博厚里,0,1,510,4,514,781,3,1,3,0,1,0,65.81
嘉義縣,朴子市,文化里,0,1,1150,7,1157,1842,3,1,3,0,1,0,62.81
嘉義縣,朴子市,永和里,0,1,1439,22,1461,2444,3,1,3,0,1,0,59.78
嘉義縣,朴子市,竹圍里,0,1,2209,21,2230,3786,3,1,3,0,1,0,58.9012150026
嘉義縣,朴子市,新寮里,0,1,429,7,436,667,3,1,3,0,1,0,65.3673163418
嘉義縣,朴子市,雙溪里,0,1,428,1,429,694,3,1,3,0,1,0,61.82
嘉義縣,朴子市,溪口里,0,1,510,7,517,814,3,1,3,0,1,0,63.51
嘉義縣,朴子市,德興里,0,1,692,4,696,1069,3,1,3,0,1,0,65.11
嘉義縣,朴子市,仁和里,0,1,423,3,426,641,3,1,3,0,1,0,66.46
嘉義縣,朴子市,大鄉里,0,1,1653,22,1675,2660,3,1,3,0,1,0,62.97
嘉義縣,朴子市,大葛里,0,1,1129,18,1147,1838,3,1,3,0,1,0,62.40
嘉義縣,朴子市,佳禾里,0,1,389,1,390,626,3,1,3,0,1,0,62.30
嘉義縣,朴子市,竹村里,0,1,558,1,559,988,3,1,3,0,1,0,56.58
嘉義縣,朴子市,崁前里,0,1,668,8,676,971,3,1,3,0,1,0,69.6189495366
嘉義縣,朴子市,崁後里,0,1,494,4,498,815,3,1,3,0,1,0,61.1042944785
嘉義縣,朴子市,順安里,0,1,191,1,192,278,3,1,3,0,1,0,69.06
嘉義縣,朴子市,德家里,0,1,502,6,508,792,3,1,3,0,1,0,64.14
嘉義縣,朴子市,新庄里,0,1,379,5,384,617,3,1,3,0,1,0,62.24
嘉義縣,朴子市,梅華里,0,1,653,10,663,1127,3,1,3,0,1,0,58.83
嘉義縣,朴子市,松華里,0,1,891,12,903,1426,3,1,3,0,1,0,63.32
嘉義縣,朴子市,南竹里,0,1,336,2,338,556,3,1,3,0,1,0,60.79
嘉義縣,布袋鎮,岱江里,0,1,452,9,461,717,3,1,3,0,1,0,64.30
嘉義縣,布袋鎮,九龍里,0,1,249,3,252,442,3,1,3,0,1,0,57.01
嘉義縣,布袋鎮,岑海里,0,1,1103,9,1112,1706,3,1,3,0,1,0,65.18
嘉義縣,布袋鎮,興中里,0,1,735,11,746,1203,3,1,3,0,1,0,62.01
嘉義縣,布袋鎮,光復里,0,1,1116,22,1138,1809,3,1,3,0,1,0,62.91
嘉義縣,布袋鎮,見龍里,0,1,545,3,548,982,3,1,3,0,1,0,55.80
嘉義縣,布袋鎮,新厝里,0,1,472,4,476,783,3,1,3,0,1,0,60.79
嘉義縣,布袋鎮,龍江里,0,1,503,13,516,818,3,1,3,0,1,0,63.0806845966
嘉義縣,布袋鎮,西安里,0,1,863,6,869,1371,3,1,3,0,1,0,63.3843909555
嘉義縣,布袋鎮,中安里,0,1,993,11,1004,1607,3,1,3,0,1,0,62.48
嘉義縣,布袋鎮,東安里,0,1,929,11,940,1521,3,1,3,0,1,0,61.80
嘉義縣,布袋鎮,樹林里,0,1,399,4,403,565,3,1,3,0,1,0,71.3274336283
嘉義縣,布袋鎮,貴舍里,0,1,511,3,514,763,3,1,3,0,1,0,67.37
嘉義縣,布袋鎮,永安里,0,1,648,13,661,1166,3,1,3,0,1,0,56.69
嘉義縣,布袋鎮,東港里,0,1,1180,11,1191,1944,3,1,3,0,1,0,61.27
嘉義縣,布袋鎮,江山里,0,1,215,1,216,326,3,1,3,0,1,0,66.26
嘉義縣,布袋鎮,菜舖里,0,1,263,4,267,442,3,1,3,0,1,0,60.41
嘉義縣,布袋鎮,考試里,0,1,206,1,207,338,3,1,3,0,1,0,61.24
嘉義縣,布袋鎮,振寮里,0,1,508,4,512,808,3,1,3,0,1,0,63.37
嘉義縣,布袋鎮,新岑里,0,1,617,9,626,1050,3,1,3,0,1,0,59.62
嘉義縣,布袋鎮,新民里,0,1,657,4,661,1239,3,1,3,0,1,0,53.35
嘉義縣,布袋鎮,復興里,0,1,1404,19,1423,2439,3,1,3,0,1,0,58.34
嘉義縣,布袋鎮,好美里,0,1,596,10,606,1110,3,1,3,0,1,0,54.59
嘉義縣,大林鎮,東林里,0,1,338,4,342,494,3,1,3,0,1,0,69.23
嘉義縣,大林鎮,西林里,0,1,1183,9,1192,1988,3,1,3,0,1,0,59.96
嘉義縣,大林鎮,吉林里,0,1,610,5,615,1012,3,1,3,0,1,0,60.77
嘉義縣,大林鎮,平林里,0,1,2885,20,2905,4980,3,1,3,0,1,0,58.3333333333
嘉義縣,大林鎮,明華里,0,1,697,11,708,1132,3,1,3,0,1,0,62.5441696113
嘉義縣,大林鎮,明和里,0,1,860,5,865,1414,3,1,3,0,1,0,61.17
嘉義縣,大林鎮,排路里,0,1,437,2,439,682,3,1,3,0,1,0,64.37
嘉義縣,大林鎮,西結里,0,1,466,3,469,808,3,1,3,0,1,0,58.04
嘉義縣,大林鎮,湖北里,0,1,436,2,438,666,3,1,3,0,1,0,65.77
嘉義縣,大林鎮,大糖里,0,1,179,1,180,303,3,1,3,0,1,0,59.41
嘉義縣,大林鎮,大美里,0,1,1126,14,1140,1751,3,1,3,0,1,0,65.11
嘉義縣,大林鎮,過溪里,0,1,907,11,918,1458,3,1,3,0,1,0,62.96
嘉義縣,大林鎮,中坑里,0,1,907,8,915,1496,3,1,3,0,1,0,61.1631016043
嘉義縣,大林鎮,上林里,0,1,510,3,513,837,3,1,3,0,1,0,61.2903225806
嘉義縣,大林鎮,中林里,0,1,900,10,910,1529,3,1,3,0,1,0,59.5160235448
嘉義縣,大林鎮,三和里,0,1,1137,10,1147,1920,3,1,3,0,1,0,59.74
嘉義縣,大林鎮,溝背里,0,1,617,5,622,972,3,1,3,0,1,0,63.99
嘉義縣,大林鎮,義和里,0,1,473,0,473,689,3,1,3,0,1,0,68.65
嘉義縣,大林鎮,內林里,0,1,489,1,490,735,3,1,3,0,1,0,66.67
嘉義縣,大林鎮,三角里,0,1,531,6,537,848,3,1,3,0,1,0,63.33
嘉義縣,大林鎮,三村里,0,1,502,3,505,782,3,1,3,0,1,0,64.58
嘉義縣,民雄鄉,東榮村,0,1,1183,9,1192,2073,3,1,3,0,1,0,57.5012059817
嘉義縣,民雄鄉,中樂村,0,1,999,7,1006,1594,3,1,3,0,1,0,63.1116687578
嘉義縣,民雄鄉,西安村,0,1,1770,17,1787,2996,3,1,3,0,1,0,59.65
嘉義縣,民雄鄉,寮頂村,0,1,1180,8,1188,2081,3,1,3,0,1,0,57.09
嘉義縣,民雄鄉,福權村,0,1,827,9,836,1357,3,1,3,0,1,0,61.61
嘉義縣,民雄鄉,東湖村,0,1,1110,8,1118,1791,3,1,3,0,1,0,62.42
嘉義縣,民雄鄉,頂崙村,0,1,812,7,819,1368,3,1,3,0,1,0,59.87
嘉義縣,民雄鄉,菁埔村,0,1,1072,12,1084,1669,3,1,3,0,1,0,64.95
嘉義縣,民雄鄉,中和村,0,1,470,2,472,755,3,1,3,0,1,0,62.52
嘉義縣,民雄鄉,平和村,0,1,412,9,421,721,3,1,3,0,1,0,58.39
嘉義縣,民雄鄉,西昌村,0,1,451,11,462,770,3,1,3,0,1,0,60.00
嘉義縣,民雄鄉,豊收村,0,1,1139,9,1148,1898,3,1,3,0,1,0,60.48
嘉義縣,民雄鄉,三興村,0,1,537,4,541,908,3,1,3,0,1,0,59.58
嘉義縣,民雄鄉,東興村,0,1,342,3,345,568,3,1,3,0,1,0,60.7394366197
嘉義縣,民雄鄉,鎮北村,0,1,532,6,538,912,3,1,3,0,1,0,58.9912280702
嘉義縣,民雄鄉,北斗村,0,1,2070,17,2087,3664,3,1,3,0,1,0,56.9596069869
嘉義縣,民雄鄉,雙福村,0,1,995,10,1005,1787,3,1,3,0,1,0,56.2395075546
嘉義縣,民雄鄉,福樂村,0,1,2403,21,2424,4385,3,1,3,0,1,0,55.28
嘉義縣,民雄鄉,大崎村,0,1,1222,10,1232,2168,3,1,3,0,1,0,56.83
嘉義縣,民雄鄉,秀林村,0,1,1213,14,1227,2231,3,1,3,0,1,0,54.9977588525
嘉義縣,民雄鄉,松山村,0,1,895,17,912,1629,3,1,3,0,1,0,55.985267035
嘉義縣,民雄鄉,興中村,0,1,1016,7,1023,1754,3,1,3,0,1,0,58.3238312429
嘉義縣,民雄鄉,興南村,0,1,1204,14,1218,2268,3,1,3,0,1,0,53.70
嘉義縣,民雄鄉,金興村,0,1,1486,32,1518,2614,3,1,3,0,1,0,58.07
嘉義縣,民雄鄉,福興村,0,1,1017,12,1029,1764,3,1,3,0,1,0,58.33
嘉義縣,民雄鄉,文隆村,0,1,1167,10,1177,2015,3,1,3,0,1,0,58.41
嘉義縣,民雄鄉,山中村,0,1,1888,15,1903,3471,3,1,3,0,1,0,54.83
嘉義縣,民雄鄉,中央村,0,1,766,5,771,1243,3,1,3,0,1,0,62.03
嘉義縣,溪口鄉,溪東村,0,1,846,10,856,1410,3,1,3,0,1,0,60.71
嘉義縣,溪口鄉,溪西村,0,1,423,5,428,725,3,1,3,0,1,0,59.03
嘉義縣,溪口鄉,溪北村,0,1,395,1,396,682,3,1,3,0,1,0,58.06
嘉義縣,溪口鄉,柴林村,0,1,469,4,473,817,3,1,3,0,1,0,57.89
嘉義縣,溪口鄉,林腳村,0,1,512,6,518,872,3,1,3,0,1,0,59.40
嘉義縣,溪口鄉,美南村,0,1,709,2,711,1236,3,1,3,0,1,0,57.52
嘉義縣,溪口鄉,美北村,0,1,533,4,537,930,3,1,3,0,1,0,57.74
嘉義縣,溪口鄉,本厝村,0,1,596,7,603,989,3,1,3,0,1,0,60.97
嘉義縣,溪口鄉,游東村,0,1,607,5,612,1080,3,1,3,0,1,0,56.67
嘉義縣,溪口鄉,游西村,0,1,435,4,439,786,3,1,3,0,1,0,55.85
嘉義縣,溪口鄉,柳溝村,0,1,758,8,766,1275,3,1,3,0,1,0,60.08
嘉義縣,溪口鄉,疊溪村,0,1,585,2,587,1013,3,1,3,0,1,0,57.95
嘉義縣,溪口鄉,妙崙村,0,1,428,3,431,739,3,1,3,0,1,0,58.3220568336
嘉義縣,溪口鄉,坪頂村,0,1,548,6,554,868,3,1,3,0,1,0,63.8248847926
嘉義縣,新港鄉,宮前村,0,1,1155,9,1164,1775,3,1,3,0,1,0,65.58
嘉義縣,新港鄉,宮後村,0,1,980,8,988,1632,3,1,3,0,1,0,60.54
嘉義縣,新港鄉,大興村,0,1,879,9,888,1448,3,1,3,0,1,0,61.3259668508
嘉義縣,新港鄉,福德村,0,1,911,3,914,1532,3,1,3,0,1,0,59.6605744125
嘉義縣,新港鄉,古民村,0,1,716,6,722,1170,3,1,3,0,1,0,61.71
嘉義縣,新港鄉,中庄村,0,1,919,10,929,1515,3,1,3,0,1,0,61.32
嘉義縣,新港鄉,大潭村,0,1,980,5,985,1614,3,1,3,0,1,0,61.03
嘉義縣,新港鄉,西庄村,0,1,581,4,585,970,3,1,3,0,1,0,60.31
嘉義縣,新港鄉,月眉村,0,1,1040,5,1045,1719,3,1,3,0,1,0,60.7911576498
嘉義縣,新港鄉,月潭村,0,1,921,7,928,1436,3,1,3,0,1,0,64.62
嘉義縣,新港鄉,溪北村,0,1,847,8,855,1429,3,1,3,0,1,0,59.83
嘉義縣,新港鄉,菜公村,0,1,576,3,579,963,3,1,3,0,1,0,60.12
嘉義縣,新港鄉,中洋村,0,1,660,12,672,988,3,1,3,0,1,0,68.02
嘉義縣,新港鄉,三間村,0,1,615,9,624,983,3,1,3,0,1,0,63.48
嘉義縣,新港鄉,安和村,0,1,698,6,704,1120,3,1,3,0,1,0,62.86
嘉義縣,新港鄉,潭大村,0,1,672,3,675,1148,3,1,3,0,1,0,58.80
嘉義縣,新港鄉,南港村,0,1,645,5,650,1116,3,1,3,0,1,0,58.2437275986
嘉義縣,新港鄉,板頭村,0,1,363,8,371,596,3,1,3,0,1,0,62.2483221477
嘉義縣,新港鄉,共和村,0,1,498,3,501,848,3,1,3,0,1,0,59.08
嘉義縣,新港鄉,埤子村,0,1,388,1,389,598,3,1,3,0,1,0,65.05
嘉義縣,新港鄉,南崙村,0,1,588,4,592,942,3,1,3,0,1,0,62.85
嘉義縣,新港鄉,北崙村,0,1,350,7,357,580,3,1,3,0,1,0,61.55
嘉義縣,新港鄉,海瀛村,0,1,351,2,353,500,3,1,3,0,1,0,70.60
嘉義縣,六腳鄉,蒜頭村,0,1,743,10,753,1291,3,1,3,0,1,0,58.33
嘉義縣,六腳鄉,蒜東村,0,1,505,5,510,940,3,1,3,0,1,0,54.26
嘉義縣,六腳鄉,蒜南村,0,1,521,3,524,903,3,1,3,0,1,0,58.03
嘉義縣,六腳鄉,工廠村,0,1,187,5,192,294,3,1,3,0,1,0,65.31
嘉義縣,六腳鄉,灣南村,0,1,729,6,735,1233,3,1,3,0,1,0,59.61
嘉義縣,六腳鄉,灣北村,0,1,760,5,765,1287,3,1,3,0,1,0,59.44
嘉義縣,六腳鄉,雙涵村,0,1,528,2,530,895,3,1,3,0,1,0,59.22
嘉義縣,六腳鄉,塗師村,0,1,422,2,424,745,3,1,3,0,1,0,56.91
嘉義縣,六腳鄉,三義村,0,1,430,7,437,779,3,1,3,0,1,0,56.10
嘉義縣,六腳鄉,正義村,0,1,849,7,856,1431,3,1,3,0,1,0,59.82
嘉義縣,六腳鄉,溪厝村,0,1,343,2,345,628,3,1,3,0,1,0,54.9363057325
嘉義縣,六腳鄉,港美村,0,1,505,7,512,791,3,1,3,0,1,0,64.7281921618
嘉義縣,六腳鄉,豐美村,0,1,671,6,677,1085,3,1,3,0,1,0,62.40
嘉義縣,六腳鄉,六斗村,0,1,562,6,568,919,3,1,3,0,1,0,61.81
嘉義縣,六腳鄉,崙陽村,0,1,582,6,588,991,3,1,3,0,1,0,59.3340060545
嘉義縣,六腳鄉,蘇厝村,0,1,896,6,902,1453,3,1,3,0,1,0,62.078458362
嘉義縣,六腳鄉,竹本村,0,1,399,6,405,719,3,1,3,0,1,0,56.33
嘉義縣,六腳鄉,永賢村,0,1,274,10,284,561,3,1,3,0,1,0,50.62
嘉義縣,六腳鄉,魚寮村,0,1,434,3,437,758,3,1,3,0,1,0,57.65
嘉義縣,六腳鄉,潭墘村,0,1,492,6,498,954,3,1,3,0,1,0,52.20
嘉義縣,六腳鄉,六腳村,0,1,488,4,492,879,3,1,3,0,1,0,55.97
嘉義縣,六腳鄉,六南村,0,1,328,3,331,630,3,1,3,0,1,0,52.54
嘉義縣,六腳鄉,崩山村,0,1,460,4,464,787,3,1,3,0,1,0,58.96
嘉義縣,六腳鄉,古林村,0,1,505,3,508,838,3,1,3,0,1,0,60.62
嘉義縣,六腳鄉,更寮村,0,1,334,3,337,613,3,1,3,0,1,0,54.9755301794
嘉義縣,東石鄉,東石村,0,1,1053,10,1063,1822,3,1,3,0,1,0,58.3424807903
嘉義縣,東石鄉,猿樹村,0,1,602,8,610,1016,3,1,3,0,1,0,60.04
嘉義縣,東石鄉,塭港村,0,1,996,7,1003,1623,3,1,3,0,1,0,61.80
嘉義縣,東石鄉,型厝村,0,1,888,9,897,1475,3,1,3,0,1,0,60.81
嘉義縣,東石鄉,三家村,0,1,755,4,759,1267,3,1,3,0,1,0,59.91
嘉義縣,東石鄉,永屯村,0,1,457,0,457,712,3,1,3,0,1,0,64.19
嘉義縣,東石鄉,海埔村,0,1,285,1,286,455,3,1,3,0,1,0,62.86
嘉義縣,東石鄉,龍港村,0,1,591,4,595,976,3,1,3,0,1,0,60.96
嘉義縣,東石鄉,副瀨村,0,1,625,3,628,1145,3,1,3,0,1,0,54.85
嘉義縣,東石鄉,下揖村,0,1,502,4,506,871,3,1,3,0,1,0,58.09
嘉義縣,東石鄉,頂揖村,0,1,273,0,273,431,3,1,3,0,1,0,63.34
嘉義縣,東石鄉,溪下村,0,1,641,8,649,1076,3,1,3,0,1,0,60.32
嘉義縣,東石鄉,港口村,0,1,215,2,217,381,3,1,3,0,1,0,56.96
嘉義縣,東石鄉,鰲鼓村,0,1,832,7,839,1370,3,1,3,0,1,0,61.24
嘉義縣,東石鄉,港墘村,0,1,889,15,904,1310,3,1,3,0,1,0,69.01
嘉義縣,東石鄉,蔦松村,0,1,556,9,565,902,3,1,3,0,1,0,62.64
嘉義縣,東石鄉,圍潭村,0,1,413,9,422,772,3,1,3,0,1,0,54.66
嘉義縣,東石鄉,洲仔村,0,1,547,11,558,958,3,1,3,0,1,0,58.25
嘉義縣,東石鄉,東崙村,0,1,466,4,470,815,3,1,3,0,1,0,57.67
嘉義縣,東石鄉,西崙村,0,1,677,11,688,1138,3,1,3,0,1,0,60.46
嘉義縣,東石鄉,塭仔村,0,1,619,4,623,995,3,1,3,0,1,0,62.61
嘉義縣,東石鄉,網寮村,0,1,769,18,787,1311,3,1,3,0,1,0,60.03
嘉義縣,東石鄉,掌潭村,0,1,521,5,526,806,3,1,3,0,1,0,65.26
嘉義縣,義竹鄉,岸腳村,0,1,563,10,573,790,3,1,3,0,1,0,72.5316455696
嘉義縣,義竹鄉,義竹村,0,1,1041,17,1058,1532,3,1,3,0,1,0,69.0600522193
嘉義縣,義竹鄉,六桂村,0,1,888,11,899,1291,3,1,3,0,1,0,69.64
嘉義縣,義竹鄉,仁里村,0,1,653,6,659,903,3,1,3,0,1,0,72.98
嘉義縣,義竹鄉,傳芳村,0,1,502,9,511,714,3,1,3,0,1,0,71.57
嘉義縣,義竹鄉,頭竹村,0,1,949,9,958,1305,3,1,3,0,1,0,73.41
嘉義縣,義竹鄉,五厝村,0,1,277,1,278,429,3,1,3,0,1,0,64.8018648019
嘉義縣,義竹鄉,中平村,0,1,341,2,343,472,3,1,3,0,1,0,72.67
嘉義縣,義竹鄉,埤前村,0,1,572,13,585,803,3,1,3,0,1,0,72.85
嘉義縣,義竹鄉,平溪村,0,1,291,3,294,445,3,1,3,0,1,0,66.07
嘉義縣,義竹鄉,後鎮村,0,1,328,3,331,483,3,1,3,0,1,0,68.53
嘉義縣,義竹鄉,北華村,0,1,400,8,408,595,3,1,3,0,1,0,68.57
嘉義縣,義竹鄉,新店村,0,1,1031,11,1042,1534,3,1,3,0,1,0,67.93
嘉義縣,義竹鄉,東過村,0,1,573,5,578,862,3,1,3,0,1,0,67.0533642691
嘉義縣,義竹鄉,西過村,0,1,633,5,638,891,3,1,3,0,1,0,71.6049382716
嘉義縣,義竹鄉,官和村,0,1,567,9,576,860,3,1,3,0,1,0,66.976744186
嘉義縣,義竹鄉,官順村,0,1,331,5,336,524,3,1,3,0,1,0,64.1221374046
嘉義縣,義竹鄉,新富村,0,1,421,2,423,585,3,1,3,0,1,0,72.3076923077
嘉義縣,義竹鄉,東光村,0,1,579,3,582,828,3,1,3,0,1,0,70.2898550725
嘉義縣,義竹鄉,東榮村,0,1,312,2,314,475,3,1,3,0,1,0,66.1052631579
嘉義縣,義竹鄉,龍蛟村,0,1,456,6,462,673,3,1,3,0,1,0,68.6478454681
嘉義縣,義竹鄉,溪洲村,0,1,475,6,481,750,3,1,3,0,1,0,64.1333333333
嘉義縣,鹿草鄉,後寮村,0,1,328,5,333,512,3,1,3,0,1,0,65.0390625
嘉義縣,鹿草鄉,鹿東村,0,1,449,2,451,652,3,1,3,0,1,0,69.1717791411
嘉義縣,鹿草鄉,鹿草村,0,1,858,11,869,1334,3,1,3,0,1,0,65.1424287856
嘉義縣,鹿草鄉,西井村,0,1,788,6,794,1163,3,1,3,0,1,0,68.271711092
嘉義縣,鹿草鄉,豊稠村,0,1,308,2,310,464,3,1,3,0,1,0,66.8103448276
嘉義縣,鹿草鄉,重寮村,0,1,735,9,744,1155,3,1,3,0,1,0,64.4155844156
嘉義縣,鹿草鄉,施家村,0,1,334,3,337,517,3,1,3,0,1,0,65.1837524178
嘉義縣,鹿草鄉,下潭村,0,1,561,0,561,903,3,1,3,0,1,0,62.1262458472
嘉義縣,鹿草鄉,光潭村,0,1,710,7,717,1116,3,1,3,0,1,0,64.247311828
嘉義縣,鹿草鄉,碧潭村,0,1,679,7,686,1078,3,1,3,0,1,0,63.6363636364
嘉義縣,鹿草鄉,松竹村,0,1,557,1,558,922,3,1,3,0,1,0,60.5206073753
嘉義縣,鹿草鄉,竹山村,0,1,600,9,609,925,3,1,3,0,1,0,65.8378378378
嘉義縣,鹿草鄉,後堀村,0,1,914,8,922,1302,3,1,3,0,1,0,70.8141321045
嘉義縣,鹿草鄉,三角村,0,1,1046,7,1053,1528,3,1,3,0,1,0,68.9136125654
嘉義縣,鹿草鄉,下麻村,0,1,403,4,407,568,3,1,3,0,1,0,71.6549295775
嘉義縣,水上鄉,水上村,0,1,1991,17,2008,3149,3,1,3,0,1,0,63.7662750079
嘉義縣,水上鄉,水頭村,0,1,1429,6,1435,2160,3,1,3,0,1,0,66.4351851852
嘉義縣,水上鄉,粗溪村,0,1,1005,10,1015,1485,3,1,3,0,1,0,68.3501683502
嘉義縣,水上鄉,下寮村,0,1,1003,11,1014,1628,3,1,3,0,1,0,62.285012285
嘉義縣,水上鄉,三和村,0,1,1145,13,1158,1796,3,1,3,0,1,0,64.4766146993
嘉義縣,水上鄉,回歸村,0,1,406,10,416,642,3,1,3,0,1,0,64.7975077882
嘉義縣,水上鄉,大堀村,0,1,1092,8,1100,1485,3,1,3,0,1,0,74.0740740741
嘉義縣,水上鄉,大崙村,0,1,1217,13,1230,1954,3,1,3,0,1,0,62.9477993859
嘉義縣,水上鄉,塗溝村,0,1,557,4,561,839,3,1,3,0,1,0,66.8653158522
嘉義縣,水上鄉,龍德村,0,1,1304,12,1316,1835,3,1,3,0,1,0,71.7166212534
嘉義縣,水上鄉,溪洲村,0,1,702,4,706,1104,3,1,3,0,1,0,63.9492753623
嘉義縣,水上鄉,三鎮村,0,1,463,3,466,681,3,1,3,0,1,0,68.4287812041
嘉義縣,水上鄉,靖和村,0,1,392,1,393,529,3,1,3,0,1,0,74.2911153119
嘉義縣,水上鄉,南和村,0,1,813,12,825,1302,3,1,3,0,1,0,63.3640552995
嘉義縣,水上鄉,柳新村,0,1,1341,16,1357,2199,3,1,3,0,1,0,61.7098681219
嘉義縣,水上鄉,柳林村,0,1,1101,17,1118,1727,3,1,3,0,1,0,64.736537348
嘉義縣,水上鄉,柳鄉村,0,1,1161,10,1171,1863,3,1,3,0,1,0,62.8556092324
嘉義縣,水上鄉,內溪村,0,1,612,11,623,996,3,1,3,0,1,0,62.5502008032
嘉義縣,水上鄉,寬士村,0,1,1926,20,1946,3623,3,1,3,0,1,0,53.7123930444
嘉義縣,水上鄉,民生村,0,1,1656,23,1679,2880,3,1,3,0,1,0,58.2986111111
嘉義縣,水上鄉,義興村,0,1,545,8,553,778,3,1,3,0,1,0,71.0796915167
嘉義縣,水上鄉,中庄村,0,1,1115,16,1131,1848,3,1,3,0,1,0,61.2012987013
嘉義縣,水上鄉,忠和村,0,1,1065,12,1077,1847,3,1,3,0,1,0,58.3107742285
嘉義縣,水上鄉,南鄉村,0,1,532,4,536,796,3,1,3,0,1,0,67.3366834171
嘉義縣,水上鄉,三界村,0,1,665,5,670,1023,3,1,3,0,1,0,65.4936461388
嘉義縣,水上鄉,國姓村,0,1,779,7,786,1315,3,1,3,0,1,0,59.7718631179
嘉義縣,中埔鄉,中埔村,0,1,1003,7,1010,1635,3,1,3,0,1,0,61.7737003058
嘉義縣,中埔鄉,鹽館村,0,1,522,7,529,857,3,1,3,0,1,0,61.7269544924
嘉義縣,中埔鄉,龍門村,0,1,475,3,478,749,3,1,3,0,1,0,63.8184245661
嘉義縣,中埔鄉,裕民村,0,1,503,6,509,882,3,1,3,0,1,0,57.7097505669
嘉義縣,中埔鄉,金蘭村,0,1,762,4,766,1353,3,1,3,0,1,0,56.6149297857
嘉義縣,中埔鄉,富收村,0,1,1410,15,1425,2629,3,1,3,0,1,0,54.2031190567
嘉義縣,中埔鄉,和睦村,0,1,1481,7,1488,2709,3,1,3,0,1,0,54.9280177187
嘉義縣,中埔鄉,和美村,0,1,2949,29,2978,5582,3,1,3,0,1,0,53.3500537442
嘉義縣,中埔鄉,和興村,0,1,2427,28,2455,4978,3,1,3,0,1,0,49.316994777
嘉義縣,中埔鄉,隆興村,0,1,1031,11,1042,1690,3,1,3,0,1,0,61.6568047337
嘉義縣,中埔鄉,義仁村,0,1,790,9,799,1348,3,1,3,0,1,0,59.2729970326
嘉義縣,中埔鄉,社口村,0,1,1154,20,1174,2092,3,1,3,0,1,0,56.1185468451
嘉義縣,中埔鄉,灣潭村,0,1,644,7,651,1084,3,1,3,0,1,0,60.0553505535
嘉義縣,中埔鄉,石弄村,0,1,736,4,740,1218,3,1,3,0,1,0,60.7553366174
嘉義縣,中埔鄉,頂埔村,0,1,579,6,585,963,3,1,3,0,1,0,60.7476635514
嘉義縣,中埔鄉,同仁村,0,1,1210,14,1224,2011,3,1,3,0,1,0,60.8652411735
嘉義縣,中埔鄉,深坑村,0,1,506,7,513,738,3,1,3,0,1,0,69.512195122
嘉義縣,中埔鄉,三層村,0,1,355,2,357,636,3,1,3,0,1,0,56.1320754717
嘉義縣,中埔鄉,瑞豐村,0,1,454,3,457,721,3,1,3,0,1,0,63.3841886269
嘉義縣,中埔鄉,沄水村,0,1,676,8,684,1104,3,1,3,0,1,0,61.9565217391
嘉義縣,中埔鄉,東興村,0,1,246,0,246,332,3,1,3,0,1,0,74.0963855422
嘉義縣,中埔鄉,中崙村,0,1,216,3,219,327,3,1,3,0,1,0,66.9724770642
嘉義縣,竹崎鄉,竹崎村,0,1,1271,9,1280,2324,3,1,3,0,1,0,55.0774526678
嘉義縣,竹崎鄉,和平村,0,1,1079,11,1090,1910,3,1,3,0,1,0,57.0680628272
嘉義縣,竹崎鄉,坑頭村,0,1,452,5,457,784,3,1,3,0,1,0,58.2908163265
嘉義縣,竹崎鄉,沙坑村,0,1,532,9,541,872,3,1,3,0,1,0,62.0412844037
嘉義縣,竹崎鄉,獅埜村,0,1,825,15,840,1303,3,1,3,0,1,0,64.4666155027
嘉義縣,竹崎鄉,義和村,0,1,378,2,380,553,3,1,3,0,1,0,68.7160940325
嘉義縣,竹崎鄉,義仁村,0,1,581,5,586,1054,3,1,3,0,1,0,55.5977229602
嘉義縣,竹崎鄉,灣橋村,0,1,2617,25,2642,4793,3,1,3,0,1,0,55.1220529939
嘉義縣,竹崎鄉,鹿滿村,0,1,762,9,771,1270,3,1,3,0,1,0,60.7086614173
嘉義縣,竹崎鄉,紫雲村,0,1,752,10,762,1342,3,1,3,0,1,0,56.780923994
嘉義縣,竹崎鄉,內埔村,0,1,960,7,967,1597,3,1,3,0,1,0,60.5510331872
嘉義縣,竹崎鄉,昇平村,0,1,1085,9,1094,1735,3,1,3,0,1,0,63.0547550432
嘉義縣,竹崎鄉,桃源村,0,1,620,1,621,1052,3,1,3,0,1,0,59.030418251
嘉義縣,竹崎鄉,白杞村,0,1,451,8,459,777,3,1,3,0,1,0,59.0733590734
嘉義縣,竹崎鄉,塘興村,0,1,566,3,569,913,3,1,3,0,1,0,62.3220153341
嘉義縣,竹崎鄉,義隆村,0,1,349,3,352,560,3,1,3,0,1,0,62.8571428571
嘉義縣,竹崎鄉,龍山村,0,1,1028,10,1038,1719,3,1,3,0,1,0,60.3839441536
嘉義縣,竹崎鄉,文峰村,0,1,432,12,444,755,3,1,3,0,1,0,58.8079470199
嘉義縣,竹崎鄉,金獅村,0,1,288,0,288,473,3,1,3,0,1,0,60.88794926
嘉義縣,竹崎鄉,復金村,0,1,1147,19,1166,1896,3,1,3,0,1,0,61.4978902954
嘉義縣,竹崎鄉,緞繻村,0,1,552,11,563,1002,3,1,3,0,1,0,56.1876247505
嘉義縣,竹崎鄉,仁壽村,0,1,138,2,140,281,3,1,3,0,1,0,49.8220640569
嘉義縣,竹崎鄉,中和村,0,1,453,3,456,814,3,1,3,0,1,0,56.0196560197
嘉義縣,竹崎鄉,光華村,0,1,460,2,462,776,3,1,3,0,1,0,59.5360824742
嘉義縣,梅山鄉,梅東村,0,1,1282,16,1298,2347,3,1,3,0,1,0,55.3046442267
嘉義縣,梅山鄉,梅南村,0,1,600,2,602,1006,3,1,3,0,1,0,59.8409542744
嘉義縣,梅山鄉,梅北村,0,1,2257,19,2276,3907,3,1,3,0,1,0,58.2544151523
嘉義縣,梅山鄉,過山村,0,1,360,4,364,580,3,1,3,0,1,0,62.7586206897
嘉義縣,梅山鄉,圳南村,0,1,312,0,312,498,3,1,3,0,1,0,62.6506024096
嘉義縣,梅山鄉,圳北村,0,1,385,4,389,673,3,1,3,0,1,0,57.8008915305
嘉義縣,梅山鄉,雙溪村,0,1,398,2,400,572,3,1,3,0,1,0,69.9300699301
嘉義縣,梅山鄉,大南村,0,1,963,11,974,1698,3,1,3,0,1,0,57.3616018846
嘉義縣,梅山鄉,安靖村,0,1,513,4,517,941,3,1,3,0,1,0,54.9415515409
嘉義縣,梅山鄉,永興村,0,1,292,5,297,519,3,1,3,0,1,0,57.225433526
嘉義縣,梅山鄉,半天村,0,1,267,3,270,440,3,1,3,0,1,0,61.3636363636
嘉義縣,梅山鄉,太平村,0,1,279,1,280,494,3,1,3,0,1,0,56.6801619433
嘉義縣,梅山鄉,太興村,0,1,284,1,285,392,3,1,3,0,1,0,72.7040816327
嘉義縣,梅山鄉,龍眼村,0,1,263,3,266,465,3,1,3,0,1,0,57.2043010753
嘉義縣,梅山鄉,碧湖村,0,1,162,3,165,285,3,1,3,0,1,0,57.8947368421
嘉義縣,梅山鄉,瑞峰村,0,1,456,4,460,759,3,1,3,0,1,0,60.6060606061
嘉義縣,梅山鄉,瑞里村,0,1,447,17,464,729,3,1,3,0,1,0,63.6488340192
嘉義縣,梅山鄉,太和村,0,1,624,7,631,1040,3,1,3,0,1,0,60.6730769231
嘉義縣,番路鄉,江西村,0,1,637,9,646,1066,3,1,3,0,1,0,60.6003752345
嘉義縣,番路鄉,內甕村,0,1,214,1,215,410,3,1,3,0,1,0,52.4390243902
嘉義縣,番路鄉,新福村,0,1,470,0,470,821,3,1,3,0,1,0,57.2472594397
嘉義縣,番路鄉,下坑村,0,1,943,10,953,1675,3,1,3,0,1,0,56.8955223881
嘉義縣,番路鄉,番路村,0,1,482,5,487,831,3,1,3,0,1,0,58.6040914561
嘉義縣,番路鄉,民和村,0,1,512,5,517,807,3,1,3,0,1,0,64.0644361834
嘉義縣,番路鄉,觸口村,0,1,587,4,591,830,3,1,3,0,1,0,71.2048192771
嘉義縣,番路鄉,大湖村,0,1,461,4,465,830,3,1,3,0,1,0,56.0240963855
嘉義縣,番路鄉,公田村,0,1,528,6,534,953,3,1,3,0,1,0,56.0335781742
嘉義縣,番路鄉,公興村,0,1,292,1,293,542,3,1,3,0,1,0,54.0590405904
嘉義縣,番路鄉,草山村,0,1,231,2,233,408,3,1,3,0,1,0,57.1078431373
嘉義縣,大埔鄉,大埔村,0,1,512,3,515,976,3,1,3,0,1,0,52.7663934426
嘉義縣,大埔鄉,和平村,0,1,253,0,253,469,3,1,3,0,1,0,53.9445628998
嘉義縣,大埔鄉,永樂村,0,1,179,3,182,300,3,1,3,0,1,0,60.6666666667
嘉義縣,大埔鄉,茄苳村,0,1,378,2,380,708,3,1,3,0,1,0,53.6723163842
嘉義縣,大埔鄉,西興村,0,1,199,1,200,376,3,1,3,0,1,0,53.1914893617
嘉義縣,阿里山鄉,中山村,0,1,188,0,188,335,3,1,3,0,1,0,56.1194029851
嘉義縣,阿里山鄉,中正村,0,1,92,0,92,170,3,1,3,0,1,0,54.1176470588
嘉義縣,阿里山鄉,香林村,0,1,85,1,86,210,3,1,3,0,1,0,40.9523809524
嘉義縣,阿里山鄉,十字村,0,1,174,2,176,307,3,1,3,0,1,0,57.328990228
嘉義縣,阿里山鄉,豐山村,0,1,172,4,176,307,3,1,3,0,1,0,57.328990228
嘉義縣,阿里山鄉,來吉村,0,1,5,0,5,19,3,1,3,0,1,0,26.3157894737
嘉義縣,阿里山鄉,樂野村,0,1,153,1,154,275,3,1,3,0,1,0,56
嘉義縣,阿里山鄉,達邦村,0,1,40,0,40,115,3,1,3,0,1,0,34.7826086957
嘉義縣,阿里山鄉,里佳村,0,1,5,0,5,14,3,1,3,0,1,0,35.7142857143
嘉義縣,阿里山鄉,山美村,0,1,8,0,8,30,3,1,3,0,1,0,26.6666666667
嘉義縣,阿里山鄉,新美村,0,1,9,0,9,21,3,1,3,0,1,0,42.8571428571
嘉義縣,阿里山鄉,茶山村,0,1,49,1,50,89,3,1,3,0,1,0,56.1797752809
臺南縣,新營市,忠政里,0,1,2538,13,2551,4451,3,1,3,0,1,0,57.31
臺南縣,新營市,民權里,0,1,1451,7,1458,2399,3,1,3,0,1,0,60.78
臺南縣,新營市,三仙里,0,1,1536,36,1572,2708,3,1,3,0,1,0,58.05
臺南縣,新營市,好平里,0,1,505,2,507,863,3,1,3,0,1,0,58.75
臺南縣,新營市,延平里,0,1,795,6,801,1253,3,1,3,0,1,0,63.93
臺南縣,新營市,永生里,0,1,647,5,652,986,3,1,3,0,1,0,66.13
臺南縣,新營市,大宏里,0,1,1797,15,1812,3135,3,1,3,0,1,0,57.80
臺南縣,新營市,王公里,0,1,3827,27,3854,6647,3,1,3,0,1,0,57.98
臺南縣,新營市,中營里,0,1,627,3,630,1078,3,1,3,0,1,0,58.44
臺南縣,新營市,土庫里,0,1,840,8,848,1434,3,1,3,0,1,0,59.14
臺南縣,新營市,興安里,0,1,270,3,273,444,3,1,3,0,1,0,61.49
臺南縣,新營市,南興里,0,1,1408,9,1417,2371,3,1,3,0,1,0,59.76
臺南縣,新營市,興業里,0,1,883,7,890,1509,3,1,3,0,1,0,58.98
臺南縣,新營市,民生里,0,1,1728,13,1741,3082,3,1,3,0,1,0,56.49
臺南縣,新營市,新北里,0,1,1895,16,1911,3483,3,1,3,0,1,0,54.87
臺南縣,新營市,新南里,0,1,1570,15,1585,2855,3,1,3,0,1,0,55.52
臺南縣,新營市,民榮里,0,1,2222,16,2238,4018,3,1,3,0,1,0,55.70
臺南縣,新營市,埤寮里,0,1,971,5,976,1594,3,1,3,0,1,0,61.23
臺南縣,新營市,護鎮里,0,1,798,10,808,1296,3,1,3,0,1,0,62.35
臺南縣,新營市,太南里,0,1,915,5,920,1482,3,1,3,0,1,0,62.08
臺南縣,新營市,太北里,0,1,1001,6,1007,1594,3,1,3,0,1,0,63.17
臺南縣,新營市,南紙里,0,1,1808,11,1819,3080,3,1,3,0,1,0,59.06
臺南縣,新營市,嘉芳里,0,1,851,9,860,1499,3,1,3,0,1,0,57.37
臺南縣,新營市,舊埔里,0,1,205,1,206,359,3,1,3,0,1,0,57.38
臺南縣,新營市,角帶里,0,1,331,2,333,444,3,1,3,0,1,0,75.00
臺南縣,新營市,鐵線里,0,1,480,4,484,734,3,1,3,0,1,0,65.94
臺南縣,新營市,五興里,0,1,647,9,656,997,3,1,3,0,1,0,65.80
臺南縣,新營市,姑爺里,0,1,389,8,397,587,3,1,3,0,1,0,67.63
臺南縣,鹽水鎮,水秀里,0,1,908,2,910,1411,3,1,3,0,1,0,64.49
臺南縣,鹽水鎮,福得里,0,1,389,3,392,619,3,1,3,0,1,0,63.33
臺南縣,鹽水鎮,三生里,0,1,275,3,278,379,3,1,3,0,1,0,73.35
臺南縣,鹽水鎮,武廟里,0,1,374,4,378,551,3,1,3,0,1,0,68.60
臺南縣,鹽水鎮,中境里,0,1,341,4,345,532,3,1,3,0,1,0,64.85
臺南縣,鹽水鎮,水仙里,0,1,246,3,249,391,3,1,3,0,1,0,63.68
臺南縣,鹽水鎮,水正里,0,1,503,2,505,784,3,1,3,0,1,0,64.41
臺南縣,鹽水鎮,橋南里,0,1,1760,13,1773,3262,3,1,3,0,1,0,54.35
臺南縣,鹽水鎮,舊營里,0,1,517,6,523,768,3,1,3,0,1,0,68.10
臺南縣,鹽水鎮,汫水里,0,1,588,8,596,968,3,1,3,0,1,0,61.57
臺南縣,鹽水鎮,岸內里,0,1,1943,19,1962,3283,3,1,3,0,1,0,59.76
臺南縣,鹽水鎮,義稠里,0,1,500,2,502,777,3,1,3,0,1,0,64.61
臺南縣,鹽水鎮,下中里,0,1,488,5,493,769,3,1,3,0,1,0,64.11
臺南縣,鹽水鎮,歡雅里,0,1,1036,9,1045,1633,3,1,3,0,1,0,63.99
臺南縣,鹽水鎮,大莊里,0,1,302,3,305,490,3,1,3,0,1,0,62.24
臺南縣,鹽水鎮,桐寮里,0,1,221,4,225,297,3,1,3,0,1,0,75.76
臺南縣,鹽水鎮,後宅里,0,1,431,4,435,670,3,1,3,0,1,0,64.93
臺南縣,鹽水鎮,孫厝里,0,1,274,1,275,474,3,1,3,0,1,0,58.02
臺南縣,鹽水鎮,竹埔里,0,1,533,3,536,785,3,1,3,0,1,0,68.28
臺南縣,鹽水鎮,下林里,0,1,284,3,287,416,3,1,3,0,1,0,68.99
臺南縣,鹽水鎮,田寮里,0,1,181,3,184,272,3,1,3,0,1,0,67.65
臺南縣,鹽水鎮,大豐里,0,1,273,0,273,374,3,1,3,0,1,0,72.99
臺南縣,鹽水鎮,飯店里,0,1,261,1,262,411,3,1,3,0,1,0,63.75
臺南縣,鹽水鎮,河南里,0,1,359,2,361,545,3,1,3,0,1,0,66.24
臺南縣,鹽水鎮,南港里,0,1,636,7,643,949,3,1,3,0,1,0,67.76
臺南縣,白河鎮,白河里,0,1,1077,13,1090,1801,3,1,3,0,1,0,60.52
臺南縣,白河鎮,永安里,0,1,1732,11,1743,2819,3,1,3,0,1,0,61.83
臺南縣,白河鎮,外角里,0,1,934,6,940,1471,3,1,3,0,1,0,63.90
臺南縣,白河鎮,庄內里,0,1,968,7,975,1558,3,1,3,0,1,0,62.58
臺南縣,白河鎮,秀祐里,0,1,575,2,577,859,3,1,3,0,1,0,67.17
臺南縣,白河鎮,河東里,0,1,785,9,794,1360,3,1,3,0,1,0,58.38
臺南縣,白河鎮,虎山里,0,1,315,3,318,455,3,1,3,0,1,0,69.89
臺南縣,白河鎮,大林里,0,1,365,6,371,622,3,1,3,0,1,0,59.65
臺南縣,白河鎮,崁頭里,0,1,298,5,303,460,3,1,3,0,1,0,65.87
臺南縣,白河鎮,六溪里,0,1,335,0,335,646,3,1,3,0,1,0,51.86
臺南縣,白河鎮,關嶺里,0,1,739,7,746,1227,3,1,3,0,1,0,60.80
臺南縣,白河鎮,仙草里,0,1,1089,17,1106,1873,3,1,3,0,1,0,59.05
臺南縣,白河鎮,玉豐里,0,1,792,6,798,1235,3,1,3,0,1,0,64.62
臺南縣,白河鎮,大竹里,0,1,927,5,932,1406,3,1,3,0,1,0,66.29
臺南縣,白河鎮,詔安里,0,1,581,4,585,870,3,1,3,0,1,0,67.24
臺南縣,白河鎮,廣安里,0,1,462,5,467,681,3,1,3,0,1,0,68.58
臺南縣,白河鎮,蓮潭里,0,1,581,9,590,883,3,1,3,0,1,0,66.82
臺南縣,白河鎮,竹門里,0,1,579,4,583,932,3,1,3,0,1,0,62.55
臺南縣,白河鎮,崎內里,0,1,500,2,502,782,3,1,3,0,1,0,64.19
臺南縣,白河鎮,昇安里,0,1,784,7,791,1257,3,1,3,0,1,0,62.93
臺南縣,白河鎮,汴頭里,0,1,474,5,479,704,3,1,3,0,1,0,68.04
臺南縣,白河鎮,內角里,0,1,515,2,517,774,3,1,3,0,1,0,66.80
臺南縣,白河鎮,草店里,0,1,557,1,558,913,3,1,3,0,1,0,61.12
臺南縣,白河鎮,甘宅里,0,1,380,5,385,658,3,1,3,0,1,0,58.51
臺南縣,柳營鄉,士林村,0,1,920,9,929,1545,3,1,3,0,1,0,60.13
臺南縣,柳營鄉,光福村,0,1,1161,10,1171,1815,3,1,3,0,1,0,64.52
臺南縣,柳營鄉,中埕村,0,1,494,4,498,717,3,1,3,0,1,0,69.46
臺南縣,柳營鄉,東昇村,0,1,1540,8,1548,2494,3,1,3,0,1,0,62.07
臺南縣,柳營鄉,八翁村,0,1,850,5,855,1291,3,1,3,0,1,0,66.23
臺南縣,柳營鄉,人和村,0,1,474,4,478,771,3,1,3,0,1,0,62.00
臺南縣,柳營鄉,太康村,0,1,959,10,969,1510,3,1,3,0,1,0,64.17
臺南縣,柳營鄉,重溪村,0,1,1170,10,1180,1784,3,1,3,0,1,0,66.14
臺南縣,柳營鄉,篤農村,0,1,905,4,909,1409,3,1,3,0,1,0,64.51
臺南縣,柳營鄉,大農村,0,1,431,4,435,666,3,1,3,0,1,0,65.32
臺南縣,柳營鄉,神農村,0,1,883,6,889,1391,3,1,3,0,1,0,63.91
臺南縣,柳營鄉,果毅村,0,1,763,4,767,1255,3,1,3,0,1,0,61.12
臺南縣,柳營鄉,旭山村,0,1,1046,12,1058,1650,3,1,3,0,1,0,64.12
臺南縣,後壁鄉,後壁村,0,1,1005,10,1015,1526,3,1,3,0,1,0,66.51
臺南縣,後壁鄉,侯伯村,0,1,809,8,817,1295,3,1,3,0,1,0,63.09
臺南縣,後壁鄉,嘉苳村,0,1,798,5,803,1253,3,1,3,0,1,0,64.09
臺南縣,後壁鄉,土溝村,0,1,858,5,863,1333,3,1,3,0,1,0,64.74
臺南縣,後壁鄉,嘉田村,0,1,711,5,716,1180,3,1,3,0,1,0,60.68
臺南縣,後壁鄉,嘉民村,0,1,747,9,756,1278,3,1,3,0,1,0,59.15
臺南縣,後壁鄉,菁豊村,0,1,475,3,478,800,3,1,3,0,1,0,59.75
臺南縣,後壁鄉,崁頂村,0,1,333,4,337,479,3,1,3,0,1,0,70.35
臺南縣,後壁鄉,後部村,0,1,298,8,306,550,3,1,3,0,1,0,55.64
臺南縣,後壁鄉,墨林村,0,1,489,7,496,777,3,1,3,0,1,0,63.84
臺南縣,後壁鄉,菁寮村,0,1,282,2,284,448,3,1,3,0,1,0,63.39
臺南縣,後壁鄉,新嘉村,0,1,697,4,701,1129,3,1,3,0,1,0,62.09
臺南縣,後壁鄉,頂長村,0,1,372,1,373,545,3,1,3,0,1,0,68.44
臺南縣,後壁鄉,平安村,0,1,632,5,637,1048,3,1,3,0,1,0,60.78
臺南縣,後壁鄉,仕安村,0,1,400,5,405,569,3,1,3,0,1,0,71.18
臺南縣,後壁鄉,竹新村,0,1,981,7,988,1437,3,1,3,0,1,0,68.75
臺南縣,後壁鄉,新東村,0,1,969,10,979,1514,3,1,3,0,1,0,64.66
臺南縣,後壁鄉,頂安村,0,1,757,6,763,1228,3,1,3,0,1,0,62.13
臺南縣,後壁鄉,長安村,0,1,818,5,823,1333,3,1,3,0,1,0,61.74
臺南縣,後壁鄉,福安村,0,1,731,13,744,1163,3,1,3,0,1,0,63.97
臺南縣,後壁鄉,烏樹村,0,1,484,6,490,813,3,1,3,0,1,0,60.27
臺南縣,東山鄉,東山村,0,1,783,6,789,1455,3,1,3,0,1,0,54.23
臺南縣,東山鄉,東中村,0,1,1358,12,1370,2354,3,1,3,0,1,0,58.20
臺南縣,東山鄉,東正村,0,1,874,10,884,1542,3,1,3,0,1,0,57.33
臺南縣,東山鄉,大客村,0,1,589,6,595,1166,3,1,3,0,1,0,51.03
臺南縣,東山鄉,三榮村,0,1,565,3,568,923,3,1,3,0,1,0,61.54
臺南縣,東山鄉,科里村,0,1,851,8,859,1336,3,1,3,0,1,0,64.30
臺南縣,東山鄉,東河村,0,1,520,5,525,902,3,1,3,0,1,0,58.20
臺南縣,東山鄉,聖賢村,0,1,1248,13,1261,1875,3,1,3,0,1,0,67.25
臺南縣,東山鄉,南溪村,0,1,294,6,300,500,3,1,3,0,1,0,60.00
臺南縣,東山鄉,水雲村,0,1,252,1,253,467,3,1,3,0,1,0,54.18
臺南縣,東山鄉,林安村,0,1,246,5,251,403,3,1,3,0,1,0,62.28
臺南縣,東山鄉,東原村,0,1,1245,6,1251,2301,3,1,3,0,1,0,54.37
臺南縣,東山鄉,嶺南村,0,1,108,0,108,773,3,1,3,0,1,0,13.97
臺南縣,東山鄉,南勢村,0,1,625,5,630,1161,3,1,3,0,1,0,54.26
臺南縣,東山鄉,青山村,0,1,609,2,611,1129,3,1,3,0,1,0,54.12
臺南縣,東山鄉,高原村,0,1,564,3,567,955,3,1,3,0,1,0,59.37
臺南縣,麻豆鎮,穀興里,0,1,448,0,448,617,3,1,3,0,1,0,72.61
臺南縣,麻豆鎮,保安里,0,1,403,1,404,585,3,1,3,0,1,0,69.06
臺南縣,麻豆鎮,東角里,0,1,1376,6,1382,2116,3,1,3,0,1,0,65.31
臺南縣,麻豆鎮,晉江里,0,1,1519,12,1531,2311,3,1,3,0,1,0,66.25
臺南縣,麻豆鎮,巷口里,0,1,912,7,919,1408,3,1,3,0,1,0,65.27
臺南縣,麻豆鎮,中興里,0,1,1201,5,1206,1907,3,1,3,0,1,0,63.24
臺南縣,麻豆鎮,興農里,0,1,886,10,896,1330,3,1,3,0,1,0,67.37
臺南縣,麻豆鎮,新建里,0,1,680,2,682,1002,3,1,3,0,1,0,68.06
臺南縣,麻豆鎮,油車里,0,1,1993,18,2011,2978,3,1,3,0,1,0,67.53
臺南縣,麻豆鎮,北勢里,0,1,773,2,775,1145,3,1,3,0,1,0,67.69
臺南縣,麻豆鎮,大埕里,0,1,1677,15,1692,2531,3,1,3,0,1,0,66.85
臺南縣,麻豆鎮,總榮里,0,1,459,5,464,660,3,1,3,0,1,0,70.30
臺南縣,麻豆鎮,龍泉里,0,1,510,2,512,738,3,1,3,0,1,0,69.38
臺南縣,麻豆鎮,南勢里,0,1,1473,8,1481,2241,3,1,3,0,1,0,66.09
臺南縣,麻豆鎮,寮部里,0,1,1051,11,1062,1555,3,1,3,0,1,0,68.30
臺南縣,麻豆鎮,小埤里,0,1,635,2,637,952,3,1,3,0,1,0,66.91
臺南縣,麻豆鎮,埤頭里,0,1,911,3,914,1322,3,1,3,0,1,0,69.14
臺南縣,麻豆鎮,大山里,0,1,397,3,400,531,3,1,3,0,1,0,75.33
臺南縣,麻豆鎮,海埔里,0,1,655,9,664,959,3,1,3,0,1,0,69.24
臺南縣,麻豆鎮,莊禮里,0,1,376,3,379,528,3,1,3,0,1,0,71.78
臺南縣,麻豆鎮,港尾里,0,1,796,9,805,1078,3,1,3,0,1,0,74.68
臺南縣,麻豆鎮,麻口里,0,1,705,4,709,1037,3,1,3,0,1,0,68.37
臺南縣,麻豆鎮,安東里,0,1,394,0,394,627,3,1,3,0,1,0,62.84
臺南縣,麻豆鎮,安業里,0,1,440,0,440,666,3,1,3,0,1,0,66.07
臺南縣,麻豆鎮,安西里,0,1,516,2,518,741,3,1,3,0,1,0,69.91
臺南縣,麻豆鎮,謝安里,0,1,643,5,648,935,3,1,3,0,1,0,69.30
臺南縣,麻豆鎮,中民里,0,1,581,2,583,842,3,1,3,0,1,0,69.24
臺南縣,麻豆鎮,安正里,0,1,564,3,567,839,3,1,3,0,1,0,67.58
臺南縣,麻豆鎮,磚井里,0,1,752,5,757,1138,3,1,3,0,1,0,66.52
臺南縣,下營鄉,下營村,0,1,641,4,645,958,3,1,3,0,1,0,67.33
臺南縣,下營鄉,仁里村,0,1,1719,4,1723,2633,3,1,3,0,1,0,65.44
臺南縣,下營鄉,宅內村,0,1,725,6,731,1138,3,1,3,0,1,0,64.24
臺南縣,下營鄉,後街村,0,1,1023,8,1031,1539,3,1,3,0,1,0,66.99
臺南縣,下營鄉,新興村,0,1,1385,12,1397,2180,3,1,3,0,1,0,64.08
臺南縣,下營鄉,營前村,0,1,1378,4,1382,2126,3,1,3,0,1,0,65.00
臺南縣,下營鄉,大屯村,0,1,560,2,562,802,3,1,3,0,1,0,70.07
臺南縣,下營鄉,大埤村,0,1,543,1,544,766,3,1,3,0,1,0,71.02
臺南縣,下營鄉,茅港村,0,1,805,9,814,1220,3,1,3,0,1,0,66.72
臺南縣,下營鄉,中營村,0,1,726,3,729,1140,3,1,3,0,1,0,63.95
臺南縣,下營鄉,開化村,0,1,1205,5,1210,1858,3,1,3,0,1,0,65.12
臺南縣,下營鄉,西連村,0,1,602,9,611,872,3,1,3,0,1,0,70.07
臺南縣,下營鄉,賀建村,0,1,860,4,864,1334,3,1,3,0,1,0,64.77
臺南縣,下營鄉,甲中村,0,1,761,4,765,1173,3,1,3,0,1,0,65.22
臺南縣,下營鄉,紅厝村,0,1,846,8,854,1261,3,1,3,0,1,0,67.72
臺南縣,六甲鄉,六甲村,0,1,1747,16,1763,2810,3,1,3,0,1,0,62.74
臺南縣,六甲鄉,甲東村,0,1,1550,17,1567,2581,3,1,3,0,1,0,60.71
臺南縣,六甲鄉,甲南村,0,1,825,4,829,1300,3,1,3,0,1,0,63.77
臺南縣,六甲鄉,龍湖村,0,1,617,8,625,1023,3,1,3,0,1,0,61.09
臺南縣,六甲鄉,七甲村,0,1,574,6,580,889,3,1,3,0,1,0,65.24
臺南縣,六甲鄉,二甲村,0,1,1778,15,1793,2936,3,1,3,0,1,0,61.07
臺南縣,六甲鄉,水林村,0,1,1269,11,1280,1946,3,1,3,0,1,0,65.78
臺南縣,六甲鄉,中社村,0,1,1045,8,1053,1585,3,1,3,0,1,0,66.44
臺南縣,六甲鄉,龜港村,0,1,666,9,675,1088,3,1,3,0,1,0,62.04
臺南縣,六甲鄉,菁埔村,0,1,420,4,424,600,3,1,3,0,1,0,70.67
臺南縣,六甲鄉,王爺村,0,1,521,6,527,830,3,1,3,0,1,0,63.49
臺南縣,六甲鄉,大丘村,0,1,467,2,469,731,3,1,3,0,1,0,64.16
臺南縣,官田鄉,官田村,0,1,1242,12,1254,1919,3,1,3,0,1,0,65.35
臺南縣,官田鄉,二鎮村,0,1,1573,14,1587,2488,3,1,3,0,1,0,63.79
臺南縣,官田鄉,湖山村,0,1,644,4,648,989,3,1,3,0,1,0,65.52
臺南縣,官田鄉,嘉南村,0,1,178,2,180,305,3,1,3,0,1,0,59.02
臺南縣,官田鄉,大崎村,0,1,316,0,316,476,3,1,3,0,1,0,66.39
臺南縣,官田鄉,隆田村,0,1,1179,11,1190,1862,3,1,3,0,1,0,63.91
臺南縣,官田鄉,隆本村,0,1,1874,12,1886,2901,3,1,3,0,1,0,65.01
臺南縣,官田鄉,南部村,0,1,624,11,635,1110,3,1,3,0,1,0,57.21
臺南縣,官田鄉,東庄村,0,1,982,6,988,1396,3,1,3,0,1,0,70.77
臺南縣,官田鄉,西庄村,0,1,484,4,488,693,3,1,3,0,1,0,70.42
臺南縣,官田鄉,拔林村,0,1,415,2,417,592,3,1,3,0,1,0,70.44
臺南縣,官田鄉,渡頭村,0,1,1496,9,1505,2172,3,1,3,0,1,0,69.29
臺南縣,官田鄉,社子村,0,1,557,5,562,906,3,1,3,0,1,0,62.03
臺南縣,大內鄉,石湖村,0,1,712,5,717,1115,3,1,3,0,1,0,64.30
臺南縣,大內鄉,石林村,0,1,509,5,514,782,3,1,3,0,1,0,65.73
臺南縣,大內鄉,石城村,0,1,894,10,904,1525,3,1,3,0,1,0,59.28
臺南縣,大內鄉,內江村,0,1,662,8,670,1072,3,1,3,0,1,0,62.50
臺南縣,大內鄉,大內村,0,1,552,2,554,843,3,1,3,0,1,0,65.72
臺南縣,大內鄉,內郭村,0,1,421,4,425,688,3,1,3,0,1,0,61.77
臺南縣,大內鄉,頭社村,0,1,616,7,623,1050,3,1,3,0,1,0,59.33
臺南縣,大內鄉,環湖村,0,1,535,2,537,901,3,1,3,0,1,0,59.60
臺南縣,大內鄉,二溪村,0,1,580,3,583,937,3,1,3,0,1,0,62.22
臺南縣,大內鄉,曲溪村,0,1,456,4,460,638,3,1,3,0,1,0,72.10
臺南縣,佳里鎮,東寧里,0,1,1106,11,1117,1760,3,1,3,0,1,0,63.47
臺南縣,佳里鎮,忠仁里,0,1,1680,11,1691,2786,3,1,3,0,1,0,60.70
臺南縣,佳里鎮,鎮山里,0,1,2988,19,3007,4793,3,1,3,0,1,0,62.74
臺南縣,佳里鎮,建南里,0,1,3700,24,3724,6056,3,1,3,0,1,0,61.49
臺南縣,佳里鎮,安西里,0,1,5362,25,5387,9139,3,1,3,0,1,0,58.95
臺南縣,佳里鎮,六安里,0,1,2030,16,2046,3299,3,1,3,0,1,0,62.02
臺南縣,佳里鎮,佳化里,0,1,1238,4,1242,1965,3,1,3,0,1,0,63.21
臺南縣,佳里鎮,禮化里,0,1,605,6,611,861,3,1,3,0,1,0,70.96
臺南縣,佳里鎮,興化里,0,1,867,3,870,1349,3,1,3,0,1,0,64.49
臺南縣,佳里鎮,營頂里,0,1,423,4,427,685,3,1,3,0,1,0,62.34
臺南縣,佳里鎮,溪洲里,0,1,256,1,257,392,3,1,3,0,1,0,65.56
臺南縣,佳里鎮,海澄里,0,1,840,8,848,1371,3,1,3,0,1,0,61.85
臺南縣,佳里鎮,漳洲里,0,1,431,4,435,693,3,1,3,0,1,0,62.77
臺南縣,佳里鎮,頂部里,0,1,570,3,573,855,3,1,3,0,1,0,67.02
臺南縣,佳里鎮,嘉福里,0,1,598,3,601,958,3,1,3,0,1,0,62.73
臺南縣,佳里鎮,通興里,0,1,699,6,705,1062,3,1,3,0,1,0,66.38
臺南縣,佳里鎮,蚶寮里,0,1,574,5,579,843,3,1,3,0,1,0,68.68
臺南縣,佳里鎮,龍安里,0,1,670,10,680,978,3,1,3,0,1,0,69.53
臺南縣,佳里鎮,民安里,0,1,848,6,854,1291,3,1,3,0,1,0,66.15
臺南縣,佳里鎮,子龍里,0,1,1020,2,1022,1544,3,1,3,0,1,0,66.19
臺南縣,佳里鎮,三協里,0,1,588,4,592,889,3,1,3,0,1,0,66.59
臺南縣,學甲鎮,一秀里,0,1,856,4,860,1293,3,1,3,0,1,0,66.51
臺南縣,學甲鎮,西明里,0,1,786,5,791,1299,3,1,3,0,1,0,60.89
臺南縣,學甲鎮,宜民里,0,1,329,3,332,510,3,1,3,0,1,0,65.10
臺南縣,學甲鎮,煥昌里,0,1,564,3,567,911,3,1,3,0,1,0,62.24
臺南縣,學甲鎮,慈生里,0,1,391,3,394,581,3,1,3,0,1,0,67.81
臺南縣,學甲鎮,仁得里,0,1,2291,13,2304,3628,3,1,3,0,1,0,63.51
臺南縣,學甲鎮,新生里,0,1,918,6,924,1491,3,1,3,0,1,0,61.97
臺南縣,學甲鎮,百福里,0,1,873,8,881,1350,3,1,3,0,1,0,65.26
臺南縣,學甲鎮,新榮里,0,1,968,5,973,1541,3,1,3,0,1,0,63.14
臺南縣,學甲鎮,文化里,0,1,391,2,393,569,3,1,3,0,1,0,69.07
臺南縣,學甲鎮,大安里,0,1,334,3,337,528,3,1,3,0,1,0,63.83
臺南縣,學甲鎮,美豐里,0,1,538,10,548,873,3,1,3,0,1,0,62.77
臺南縣,學甲鎮,美和里,0,1,206,2,208,335,3,1,3,0,1,0,62.09
臺南縣,學甲鎮,達明里,0,1,437,1,438,644,3,1,3,0,1,0,68.01
臺南縣,學甲鎮,光明里,0,1,220,2,222,336,3,1,3,0,1,0,66.07
臺南縣,學甲鎮,民吉里,0,1,296,1,297,424,3,1,3,0,1,0,70.05
臺南縣,學甲鎮,西進里,0,1,303,2,305,472,3,1,3,0,1,0,64.62
臺南縣,學甲鎮,白渚里,0,1,208,1,209,330,3,1,3,0,1,0,63.33
臺南縣,學甲鎮,光華里,0,1,568,4,572,898,3,1,3,0,1,0,63.70
臺南縣,學甲鎮,頭港里,0,1,269,2,271,440,3,1,3,0,1,0,61.59
臺南縣,學甲鎮,宅港里,0,1,679,3,682,1088,3,1,3,0,1,0,62.68
臺南縣,學甲鎮,平東里,0,1,312,2,314,478,3,1,3,0,1,0,65.69
臺南縣,學甲鎮,平西里,0,1,477,1,478,676,3,1,3,0,1,0,70.71
臺南縣,學甲鎮,頂洲里,0,1,508,4,512,673,3,1,3,0,1,0,76.08
臺南縣,學甲鎮,紅茄里,0,1,314,3,317,479,3,1,3,0,1,0,66.18
臺南縣,學甲鎮,新芳里,0,1,294,4,298,450,3,1,3,0,1,0,66.22
臺南縣,西港鄉,西港村,0,1,1859,26,1885,2806,3,1,3,0,1,0,67.18
臺南縣,西港鄉,慶安村,0,1,2338,24,2362,3640,3,1,3,0,1,0,64.89
臺南縣,西港鄉,南海村,0,1,1329,16,1345,1967,3,1,3,0,1,0,68.38
臺南縣,西港鄉,港東村,0,1,929,7,936,1383,3,1,3,0,1,0,67.68
臺南縣,西港鄉,檨林村,0,1,1024,9,1033,1538,3,1,3,0,1,0,67.17
臺南縣,西港鄉,後營村,0,1,909,10,919,1329,3,1,3,0,1,0,69.15
臺南縣,西港鄉,營西村,0,1,850,8,858,1327,3,1,3,0,1,0,64.66
臺南縣,西港鄉,金砂村,0,1,603,8,611,817,3,1,3,0,1,0,74.79
臺南縣,西港鄉,劉厝村,0,1,798,4,802,1196,3,1,3,0,1,0,67.06
臺南縣,西港鄉,竹林村,0,1,818,6,824,1176,3,1,3,0,1,0,70.07
臺南縣,西港鄉,永樂村,0,1,605,6,611,886,3,1,3,0,1,0,68.96
臺南縣,西港鄉,新復村,0,1,297,3,300,389,3,1,3,0,1,0,77.12
臺南縣,西港鄉,永樂村、南海村、新復村,0,1,503,1,504,748,3,1,3,0,1,0,67.38
臺南縣,七股鄉,後港村,0,1,354,0,354,547,3,1,3,0,1,0,64.72
臺南縣,七股鄉,大潭村,0,1,457,6,463,714,3,1,3,0,1,0,64.85
臺南縣,七股鄉,城內村,0,1,349,3,352,498,3,1,3,0,1,0,70.68
臺南縣,七股鄉,篤加村,0,1,561,4,565,841,3,1,3,0,1,0,67.18
臺南縣,七股鄉,頂山村,0,1,686,4,690,940,3,1,3,0,1,0,73.40
臺南縣,七股鄉,西寮村,0,1,381,1,382,564,3,1,3,0,1,0,67.73
臺南縣,七股鄉,鹽埕村,0,1,314,3,317,435,3,1,3,0,1,0,72.87
臺南縣,七股鄉,中寮村,0,1,543,2,545,785,3,1,3,0,1,0,69.43
臺南縣,七股鄉,龍山村,0,1,1132,5,1137,1707,3,1,3,0,1,0,66.61
臺南縣,七股鄉,溪南村,0,1,249,0,249,356,3,1,3,0,1,0,69.94
臺南縣,七股鄉,七股村,0,1,548,4,552,880,3,1,3,0,1,0,62.73
臺南縣,七股鄉,玉成村,0,1,527,3,530,842,3,1,3,0,1,0,62.95
臺南縣,七股鄉,大埕村,0,1,869,13,882,1428,3,1,3,0,1,0,61.76
臺南縣,七股鄉,大寮村,0,1,587,4,591,959,3,1,3,0,1,0,61.63
臺南縣,七股鄉,看坪村,0,1,418,2,420,615,3,1,3,0,1,0,68.29
臺南縣,七股鄉,樹林村,0,1,687,6,693,1045,3,1,3,0,1,0,66.32
臺南縣,七股鄉,竹港村,0,1,392,4,396,570,3,1,3,0,1,0,69.47
臺南縣,七股鄉,竹橋村,0,1,517,8,525,724,3,1,3,0,1,0,72.51
臺南縣,七股鄉,義合村,0,1,694,5,699,1067,3,1,3,0,1,0,65.51
臺南縣,七股鄉,康榔村,0,1,488,3,491,690,3,1,3,0,1,0,71.16
臺南縣,七股鄉,永吉村,0,1,610,2,612,912,3,1,3,0,1,0,67.11
臺南縣,七股鄉,三股村,0,1,934,15,949,1609,3,1,3,0,1,0,58.98
臺南縣,七股鄉,十份村,0,1,856,5,861,1319,3,1,3,0,1,0,65.28
臺南縣,將軍鄉,長榮村,0,1,670,7,677,970,3,1,3,0,1,0,69.79
臺南縣,將軍鄉,西華村,0,1,850,5,855,1342,3,1,3,0,1,0,63.71
臺南縣,將軍鄉,西和村,0,1,691,8,699,1032,3,1,3,0,1,0,67.73
臺南縣,將軍鄉,忠興村,0,1,1005,5,1010,1489,3,1,3,0,1,0,67.83
臺南縣,將軍鄉,嘉昌村,0,1,626,7,633,912,3,1,3,0,1,0,69.41
臺南縣,將軍鄉,保源村,0,1,721,6,727,1031,3,1,3,0,1,0,70.51
臺南縣,將軍鄉,苓和村,0,1,684,6,690,1078,3,1,3,0,1,0,64.01
臺南縣,將軍鄉,仁和村,0,1,446,2,448,743,3,1,3,0,1,0,60.30
臺南縣,將軍鄉,北埔村,0,1,461,1,462,634,3,1,3,0,1,0,72.87
臺南縣,將軍鄉,將富村,0,1,440,2,442,719,3,1,3,0,1,0,61.47
臺南縣,將軍鄉,將貴村,0,1,427,2,429,619,3,1,3,0,1,0,69.31
臺南縣,將軍鄉,三吉村,0,1,279,1,280,438,3,1,3,0,1,0,63.93
臺南縣,將軍鄉,玉山村,0,1,587,1,588,909,3,1,3,0,1,0,64.69
臺南縣,將軍鄉,廣山村,0,1,423,4,427,692,3,1,3,0,1,0,61.71
臺南縣,將軍鄉,長沙村,0,1,910,2,912,1466,3,1,3,0,1,0,62.21
臺南縣,將軍鄉,平沙村,0,1,787,5,792,1268,3,1,3,0,1,0,62.46
臺南縣,將軍鄉,鯤鯓村,0,1,1174,9,1183,2034,3,1,3,0,1,0,58.16
臺南縣,將軍鄉,鯤溟村,0,1,609,1,610,1009,3,1,3,0,1,0,60.46
臺南縣,北門鄉,北門村,0,1,632,11,643,891,3,1,3,0,1,0,72.17
臺南縣,北門鄉,永隆村,0,1,359,2,361,532,3,1,3,0,1,0,67.86
臺南縣,北門鄉,永華村,0,1,246,4,250,379,3,1,3,0,1,0,65.96
臺南縣,北門鄉,玉港村,0,1,518,4,522,780,3,1,3,0,1,0,66.92
臺南縣,北門鄉,保吉村,0,1,872,10,882,1348,3,1,3,0,1,0,65.43
臺南縣,北門鄉,東壁村,0,1,520,5,525,774,3,1,3,0,1,0,67.83
臺南縣,北門鄉,鯤江村,0,1,520,2,522,771,3,1,3,0,1,0,67.70
臺南縣,北門鄉,雙春村,0,1,421,1,422,600,3,1,3,0,1,0,70.33
臺南縣,北門鄉,錦湖村,0,1,663,0,663,1055,3,1,3,0,1,0,62.84
臺南縣,北門鄉,慈安村,0,1,441,2,443,675,3,1,3,0,1,0,65.63
臺南縣,北門鄉,三光村,0,1,781,8,789,1170,3,1,3,0,1,0,67.44
臺南縣,北門鄉,中樞村,0,1,440,1,441,696,3,1,3,0,1,0,63.36
臺南縣,北門鄉,仁里村,0,1,459,4,463,689,3,1,3,0,1,0,67.20
臺南縣,新化鎮,武安里,0,1,1005,9,1014,1635,3,1,3,0,1,0,62.02
臺南縣,新化鎮,東榮里,0,1,2263,10,2273,3801,3,1,3,0,1,0,59.80
臺南縣,新化鎮,護國里,0,1,900,2,902,1663,3,1,3,0,1,0,54.24
臺南縣,新化鎮,太平里,0,1,2294,21,2315,3814,3,1,3,0,1,0,60.70
臺南縣,新化鎮,中央里,0,1,285,1,286,437,3,1,3,0,1,0,65.45
臺南縣,新化鎮,觀音里,0,1,365,0,365,614,3,1,3,0,1,0,59.45
臺南縣,新化鎮,竹林里,0,1,287,4,291,441,3,1,3,0,1,0,65.99
臺南縣,新化鎮,清水里,0,1,622,4,626,983,3,1,3,0,1,0,63.68
臺南縣,新化鎮,協興里,0,1,1831,19,1850,3021,3,1,3,0,1,0,61.24
臺南縣,新化鎮,唪口里,0,1,1104,6,1110,1711,3,1,3,0,1,0,64.87
臺南縣,新化鎮,北勢里,0,1,736,8,744,1175,3,1,3,0,1,0,63.32
臺南縣,新化鎮,豐榮里,0,1,1578,10,1588,2495,3,1,3,0,1,0,63.65
臺南縣,新化鎮,全興里,0,1,1303,6,1309,2068,3,1,3,0,1,0,63.30
臺南縣,新化鎮,崙頂里,0,1,1177,11,1188,1747,3,1,3,0,1,0,68.00
臺南縣,新化鎮,知義里,0,1,1372,15,1387,2136,3,1,3,0,1,0,64.93
臺南縣,新化鎮,山腳里,0,1,858,8,866,1318,3,1,3,0,1,0,65.71
臺南縣,新化鎮,大坑里,0,1,315,4,319,477,3,1,3,0,1,0,66.88
臺南縣,新化鎮,那拔里,0,1,1269,10,1279,2090,3,1,3,0,1,0,61.20
臺南縣,新化鎮,羊林里,0,1,509,5,514,847,3,1,3,0,1,0,60.68
臺南縣,新化鎮,礁坑里,0,1,664,3,667,1032,3,1,3,0,1,0,64.63
臺南縣,善化鎮,東關里,0,1,599,3,602,921,3,1,3,0,1,0,65.36
臺南縣,善化鎮,坐駕里,0,1,1702,16,1718,2757,3,1,3,0,1,0,62.31
臺南縣,善化鎮,光文里,0,1,2522,25,2547,4239,3,1,3,0,1,0,60.08
臺南縣,善化鎮,文昌里,0,1,1321,11,1332,2152,3,1,3,0,1,0,61.90
臺南縣,善化鎮,南關里,0,1,785,7,792,1282,3,1,3,0,1,0,61.78
臺南縣,善化鎮,西關里,0,1,419,2,421,676,3,1,3,0,1,0,62.28
臺南縣,善化鎮,北關里,0,1,283,1,284,445,3,1,3,0,1,0,63.82
臺南縣,善化鎮,文正里,0,1,724,11,735,1171,3,1,3,0,1,0,62.77
臺南縣,善化鎮,胡家里,0,1,873,3,876,1248,3,1,3,0,1,0,70.19
臺南縣,善化鎮,胡厝里,0,1,1204,18,1222,1883,3,1,3,0,1,0,64.90
臺南縣,善化鎮,什乃里,0,1,602,7,609,916,3,1,3,0,1,0,66.48
臺南縣,善化鎮,溪美里,0,1,986,10,996,1580,3,1,3,0,1,0,63.04
臺南縣,善化鎮,六分里,0,1,422,5,427,664,3,1,3,0,1,0,64.31
臺南縣,善化鎮,六德里,0,1,650,9,659,1054,3,1,3,0,1,0,62.52
臺南縣,善化鎮,田寮里,0,1,1095,18,1113,1760,3,1,3,0,1,0,63.24
臺南縣,善化鎮,東隆里,0,1,573,4,577,861,3,1,3,0,1,0,67.02
臺南縣,善化鎮,東昌里,0,1,615,9,624,999,3,1,3,0,1,0,62.46
臺南縣,善化鎮,牛庄里,0,1,883,8,891,1389,3,1,3,0,1,0,64.15
臺南縣,善化鎮,嘉北里,0,1,898,9,907,1392,3,1,3,0,1,0,65.16
臺南縣,善化鎮,嘉南里,0,1,611,5,616,1027,3,1,3,0,1,0,59.98
臺南縣,善化鎮,小新里,0,1,1650,10,1660,2802,3,1,3,0,1,0,59.24
臺南縣,新市鄉,新市村,0,1,1413,16,1429,2463,3,1,3,0,1,0,58.02
臺南縣,新市鄉,新和村,0,1,3201,20,3221,5352,3,1,3,0,1,0,60.18
臺南縣,新市鄉,社內村,0,1,1243,6,1249,2011,3,1,3,0,1,0,62.11
臺南縣,新市鄉,大洲村,0,1,467,1,468,653,3,1,3,0,1,0,71.67
臺南縣,新市鄉,豊華村,0,1,542,3,545,920,3,1,3,0,1,0,59.24
臺南縣,新市鄉,三舍村,0,1,799,5,804,1221,3,1,3,0,1,0,65.85
臺南縣,新市鄉,大營村,0,1,1591,8,1599,2428,3,1,3,0,1,0,65.86
臺南縣,新市鄉,大社村,0,1,2093,17,2110,3435,3,1,3,0,1,0,61.43
臺南縣,新市鄉,潭頂村,0,1,969,5,974,1535,3,1,3,0,1,0,63.45
臺南縣,新市鄉,港墘村,0,1,1854,11,1865,2945,3,1,3,0,1,0,63.33
臺南縣,新市鄉,永就村,0,1,1355,10,1365,2254,3,1,3,0,1,0,60.56
臺南縣,安定鄉,蘇林村,0,1,1336,15,1351,2052,3,1,3,0,1,0,65.84
臺南縣,安定鄉,蘇厝村,0,1,1118,18,1136,1798,3,1,3,0,1,0,63.18
臺南縣,安定鄉,安定村,0,1,888,5,893,1375,3,1,3,0,1,0,64.95
臺南縣,安定鄉,安加村,0,1,773,11,784,1138,3,1,3,0,1,0,68.89
臺南縣,安定鄉,保西村,0,1,532,3,535,764,3,1,3,0,1,0,70.03
臺南縣,安定鄉,港尾村,0,1,1188,10,1198,1522,3,1,3,0,1,0,78.71
臺南縣,安定鄉,中榮村,0,1,609,16,625,1025,3,1,3,0,1,0,60.98
臺南縣,安定鄉,港口村,0,1,1451,6,1457,2206,3,1,3,0,1,0,66.05
臺南縣,安定鄉,港南村,0,1,1399,11,1410,2209,3,1,3,0,1,0,63.83
臺南縣,安定鄉,大同村,0,1,427,3,430,636,3,1,3,0,1,0,67.61
臺南縣,安定鄉,六嘉村,0,1,871,8,879,1390,3,1,3,0,1,0,63.24
臺南縣,安定鄉,中沙村,0,1,475,2,477,695,3,1,3,0,1,0,68.63
臺南縣,安定鄉,新吉村,0,1,1114,12,1126,1860,3,1,3,0,1,0,60.54
臺南縣,安定鄉,海寮村,0,1,1408,18,1426,2251,3,1,3,0,1,0,63.35
臺南縣,安定鄉,管寮村,0,1,646,2,648,909,3,1,3,0,1,0,71.29
臺南縣,安定鄉,南安村,0,1,368,6,374,504,3,1,3,0,1,0,74.21
臺南縣,山上鄉,明和村,0,1,1137,10,1147,1803,3,1,3,0,1,0,63.62
臺南縣,山上鄉,南洲村,0,1,1055,5,1060,1558,3,1,3,0,1,0,68.04
臺南縣,山上鄉,山上村,0,1,559,9,568,873,3,1,3,0,1,0,65.06
臺南縣,山上鄉,新莊村,0,1,508,2,510,775,3,1,3,0,1,0,65.81
臺南縣,山上鄉,玉峰村,0,1,378,0,378,559,3,1,3,0,1,0,67.62
臺南縣,山上鄉,平陽村,0,1,255,2,257,358,3,1,3,0,1,0,71.79
臺南縣,山上鄉,豐德村,0,1,218,2,220,371,3,1,3,0,1,0,59.30
臺南縣,玉井鄉,玉井村,0,1,599,4,603,903,3,1,3,0,1,0,66.78
臺南縣,玉井鄉,玉田村,0,1,2470,20,2490,4109,3,1,3,0,1,0,60.60
臺南縣,玉井鄉,中正村,0,1,854,7,861,1284,3,1,3,0,1,0,67.06
臺南縣,玉井鄉,竹圍村,0,1,886,5,891,1421,3,1,3,0,1,0,62.70
臺南縣,玉井鄉,沙田村,0,1,326,3,329,502,3,1,3,0,1,0,65.54
臺南縣,玉井鄉,三埔村,0,1,312,1,313,512,3,1,3,0,1,0,61.13
臺南縣,玉井鄉,三和村,0,1,526,4,530,770,3,1,3,0,1,0,68.83
臺南縣,玉井鄉,望明村,0,1,1061,12,1073,1560,3,1,3,0,1,0,68.78
臺南縣,玉井鄉,層林村,0,1,443,2,445,688,3,1,3,0,1,0,64.68
臺南縣,玉井鄉,豐里村,0,1,615,6,621,1001,3,1,3,0,1,0,62.04
臺南縣,楠西鄉,楠西村,0,1,1165,12,1177,1886,3,1,3,0,1,0,62.41
臺南縣,楠西鄉,灣丘村,0,1,723,6,729,1265,3,1,3,0,1,0,57.63
臺南縣,楠西鄉,密枝村,0,1,482,2,484,808,3,1,3,0,1,0,59.90
臺南縣,楠西鄉,照興村,0,1,646,10,656,1046,3,1,3,0,1,0,62.72
臺南縣,楠西鄉,鹿田村,0,1,644,2,646,1000,3,1,3,0,1,0,64.60
臺南縣,楠西鄉,龜丹村,0,1,464,3,467,712,3,1,3,0,1,0,65.59
臺南縣,楠西鄉,東勢村,0,1,1411,16,1427,2250,3,1,3,0,1,0,63.42
臺南縣,南化鄉,南化村,0,1,942,5,947,1363,3,1,3,0,1,0,69.48
臺南縣,南化鄉,小崙村,0,1,562,4,566,796,3,1,3,0,1,0,71.11
臺南縣,南化鄉,東和村,0,1,450,0,450,656,3,1,3,0,1,0,68.60
臺南縣,南化鄉,中坑村,0,1,334,2,336,481,3,1,3,0,1,0,69.85
臺南縣,南化鄉,北平村,0,1,424,0,424,600,3,1,3,0,1,0,70.67
臺南縣,南化鄉,西埔村,0,1,514,4,518,792,3,1,3,0,1,0,65.40
臺南縣,南化鄉,北寮村,0,1,753,4,757,1173,3,1,3,0,1,0,64.54
臺南縣,南化鄉,玉山村,0,1,602,2,604,880,3,1,3,0,1,0,68.64
臺南縣,南化鄉,關山村,0,1,271,3,274,554,3,1,3,0,1,0,49.46
臺南縣,左鎮鄉,光和村,0,1,262,5,267,426,3,1,3,0,1,0,62.68
臺南縣,左鎮鄉,榮和村,0,1,448,3,451,677,3,1,3,0,1,0,66.62
臺南縣,左鎮鄉,左鎮村,0,1,351,3,354,514,3,1,3,0,1,0,68.87
臺南縣,左鎮鄉,中正村,0,1,577,2,579,858,3,1,3,0,1,0,67.48
臺南縣,左鎮鄉,睦光村,0,1,253,6,259,381,3,1,3,0,1,0,67.98
臺南縣,左鎮鄉,內庄村,0,1,307,3,310,454,3,1,3,0,1,0,68.28
臺南縣,左鎮鄉,岡林村,0,1,289,1,290,440,3,1,3,0,1,0,65.91
臺南縣,左鎮鄉,草山村,0,1,204,1,205,314,3,1,3,0,1,0,65.29
臺南縣,左鎮鄉,二寮村,0,1,132,0,132,225,3,1,3,0,1,0,58.67
臺南縣,左鎮鄉,澄山村,0,1,332,2,334,547,3,1,3,0,1,0,61.06
臺南縣,仁德鄉,太子村,0,1,2524,17,2541,4094,3,1,3,0,1,0,62.07
臺南縣,仁德鄉,土庫村,0,1,1462,10,1472,2253,3,1,3,0,1,0,65.34
臺南縣,仁德鄉,一甲村,0,1,1188,4,1192,1950,3,1,3,0,1,0,61.13
臺南縣,仁德鄉,仁德村,0,1,2404,16,2420,4585,3,1,3,0,1,0,52.78
臺南縣,仁德鄉,仁義村,0,1,4177,25,4202,7034,3,1,3,0,1,0,59.74
臺南縣,仁德鄉,新田村,0,1,1536,12,1548,2636,3,1,3,0,1,0,58.73
臺南縣,仁德鄉,後壁村,0,1,3852,33,3885,6628,3,1,3,0,1,0,58.61
臺南縣,仁德鄉,上崙村,0,1,2467,17,2484,4151,3,1,3,0,1,0,59.84
臺南縣,仁德鄉,田厝村,0,1,914,5,919,1323,3,1,3,0,1,0,69.46
臺南縣,仁德鄉,三甲村,0,1,483,3,486,699,3,1,3,0,1,0,69.53
臺南縣,仁德鄉,保安村,0,1,1369,10,1379,2226,3,1,3,0,1,0,61.95
臺南縣,仁德鄉,成功村,0,1,2196,16,2212,3657,3,1,3,0,1,0,60.49
臺南縣,仁德鄉,仁和村,0,1,724,13,737,1080,3,1,3,0,1,0,68.24
臺南縣,仁德鄉,仁愛村,0,1,1224,10,1234,1998,3,1,3,0,1,0,61.76
臺南縣,仁德鄉,二行村,0,1,1233,17,1250,2037,3,1,3,0,1,0,61.36
臺南縣,仁德鄉,大甲村,0,1,1291,15,1306,1978,3,1,3,0,1,0,66.03
臺南縣,仁德鄉,中洲村,0,1,867,4,871,1270,3,1,3,0,1,0,68.58
臺南縣,仁德鄉,中生村,0,1,939,5,944,1384,3,1,3,0,1,0,68.21
臺南縣,歸仁鄉,南保村,0,1,2878,24,2902,4870,3,1,3,0,1,0,59.59
臺南縣,歸仁鄉,南興村,0,1,1759,12,1771,2922,3,1,3,0,1,0,60.61
臺南縣,歸仁鄉,六甲村,0,1,1894,8,1902,3094,3,1,3,0,1,0,61.47
臺南縣,歸仁鄉,歸南村,0,1,1246,15,1261,2061,3,1,3,0,1,0,61.18
臺南縣,歸仁鄉,後市村,0,1,1908,10,1918,2995,3,1,3,0,1,0,64.04
臺南縣,歸仁鄉,文化村,0,1,1404,10,1414,2355,3,1,3,0,1,0,60.04
臺南縣,歸仁鄉,辜厝村,0,1,1688,10,1698,2756,3,1,3,0,1,0,61.61
臺南縣,歸仁鄉,新厝村,0,1,1333,5,1338,2102,3,1,3,0,1,0,63.65
臺南縣,歸仁鄉,許厝村,0,1,1669,5,1674,2804,3,1,3,0,1,0,59.70
臺南縣,歸仁鄉,看西村,0,1,920,8,928,1383,3,1,3,0,1,0,67.10
臺南縣,歸仁鄉,看東村,0,1,838,3,841,1325,3,1,3,0,1,0,63.47
臺南縣,歸仁鄉,崙頂村,0,1,1305,10,1315,2022,3,1,3,0,1,0,65.03
臺南縣,歸仁鄉,沙崙村,0,1,383,4,387,607,3,1,3,0,1,0,63.76
臺南縣,歸仁鄉,大潭村,0,1,1094,4,1098,1672,3,1,3,0,1,0,65.67
臺南縣,歸仁鄉,武東村,0,1,739,7,746,1196,3,1,3,0,1,0,62.37
臺南縣,歸仁鄉,歸仁村,0,1,1202,5,1207,1966,3,1,3,0,1,0,61.39
臺南縣,歸仁鄉,八甲村,0,1,1318,6,1324,2117,3,1,3,0,1,0,62.54
臺南縣,歸仁鄉,七甲村,0,1,1392,9,1401,2190,3,1,3,0,1,0,63.97
臺南縣,歸仁鄉,媽廟村,0,1,1182,8,1190,1930,3,1,3,0,1,0,61.66
臺南縣,歸仁鄉,西埔村,0,1,855,9,864,1354,3,1,3,0,1,0,63.81
臺南縣,歸仁鄉,大廟村,0,1,1346,13,1359,2232,3,1,3,0,1,0,60.89
臺南縣,關廟鄉,關廟村,0,1,1277,5,1282,1947,3,1,3,0,1,0,65.84
臺南縣,關廟鄉,山西村,0,1,1242,9,1251,1892,3,1,3,0,1,0,66.12
臺南縣,關廟鄉,香洋村,0,1,2179,26,2205,3390,3,1,3,0,1,0,65.04
臺南縣,關廟鄉,北勢村,0,1,1677,11,1688,2470,3,1,3,0,1,0,68.34
臺南縣,關廟鄉,新埔村,0,1,608,2,610,882,3,1,3,0,1,0,69.16
臺南縣,關廟鄉,新光村,0,1,495,5,500,758,3,1,3,0,1,0,65.96
臺南縣,關廟鄉,五甲村,0,1,1739,16,1755,2741,3,1,3,0,1,0,64.03
臺南縣,關廟鄉,東勢村,0,1,1930,13,1943,3021,3,1,3,0,1,0,64.32
臺南縣,關廟鄉,松腳村,0,1,1232,10,1242,1916,3,1,3,0,1,0,64.82
臺南縣,關廟鄉,南花村,0,1,953,9,962,1448,3,1,3,0,1,0,66.44
臺南縣,關廟鄉,北花村,0,1,1331,13,1344,2119,3,1,3,0,1,0,63.43
臺南縣,關廟鄉,深坑村,0,1,1043,10,1053,1536,3,1,3,0,1,0,68.55
臺南縣,關廟鄉,布袋村,0,1,850,10,860,1219,3,1,3,0,1,0,70.55
臺南縣,關廟鄉,田中村,0,1,524,5,529,767,3,1,3,0,1,0,68.97
臺南縣,關廟鄉,龜洞村,0,1,573,4,577,775,3,1,3,0,1,0,74.45
臺南縣,關廟鄉,埤頭村,0,1,1007,9,1016,1555,3,1,3,0,1,0,65.34
臺南縣,關廟鄉,下湖村,0,1,288,6,294,404,3,1,3,0,1,0,72.77
臺南縣,龍崎鄉,崎頂村,0,1,829,6,835,1185,3,1,3,0,1,0,70.46
臺南縣,龍崎鄉,土崎村,0,1,452,3,455,690,3,1,3,0,1,0,65.94
臺南縣,龍崎鄉,中坑村,0,1,103,1,104,201,3,1,3,0,1,0,51.74
臺南縣,龍崎鄉,楠坑村,0,1,217,3,220,311,3,1,3,0,1,0,70.74
臺南縣,龍崎鄉,牛埔村,0,1,187,1,188,271,3,1,3,0,1,0,69.37
臺南縣,龍崎鄉,大坪村,0,1,203,1,204,297,3,1,3,0,1,0,68.69
臺南縣,龍崎鄉,龍船村,0,1,308,2,310,423,3,1,3,0,1,0,73.29
臺南縣,龍崎鄉,石曹村,0,1,256,1,257,383,3,1,3,0,1,0,67.10
臺南縣,永康市,五王里,0,1,2157,9,2166,4310,3,1,3,0,1,0,50.26
臺南縣,永康市,三合里,0,1,1620,11,1631,2963,3,1,3,0,1,0,55.05
臺南縣,永康市,六合里,0,1,1826,11,1837,3624,3,1,3,0,1,0,50.69
臺南縣,永康市,網寮里,0,1,2368,17,2385,4393,3,1,3,0,1,0,54.29
臺南縣,永康市,二王里,0,1,3360,23,3383,6003,3,1,3,0,1,0,56.36
臺南縣,永康市,永康里,0,1,3081,15,3096,6306,3,1,3,0,1,0,49.10
臺南縣,永康市,埔園里,0,1,3133,18,3151,5813,3,1,3,0,1,0,54.21
臺南縣,永康市,正強里,0,1,3189,24,3213,5790,3,1,3,0,1,0,55.49
臺南縣,永康市,大橋里,0,1,2314,15,2329,4493,3,1,3,0,1,0,51.84
臺南縣,永康市,東橋里,0,1,1285,7,1292,2214,3,1,3,0,1,0,58.36
臺南縣,永康市,西橋里,0,1,1354,9,1363,2599,3,1,3,0,1,0,52.44
臺南縣,永康市,安康里,0,1,1894,13,1907,3875,3,1,3,0,1,0,49.21
臺南縣,永康市,蔦松里,0,1,920,5,925,1523,3,1,3,0,1,0,60.74
臺南縣,永康市,三民里,0,1,703,7,710,1090,3,1,3,0,1,0,65.14
臺南縣,永康市,鹽行里,0,1,3454,18,3472,6419,3,1,3,0,1,0,54.09
臺南縣,永康市,鹽洲里,0,1,2621,21,2642,4433,3,1,3,0,1,0,59.60
臺南縣,永康市,甲頂里,0,1,1355,12,1367,2256,3,1,3,0,1,0,60.59
臺南縣,永康市,尚頂里,0,1,1993,17,2010,3526,3,1,3,0,1,0,57.01
臺南縣,永康市,龍潭里,0,1,3529,25,3554,6580,3,1,3,0,1,0,54.01
臺南縣,永康市,王行里,0,1,1157,5,1162,1879,3,1,3,0,1,0,61.84
臺南縣,永康市,烏竹里,0,1,1021,9,1030,1733,3,1,3,0,1,0,59.43
臺南縣,永康市,西勢里,0,1,2415,12,2427,4282,3,1,3,0,1,0,56.68
臺南縣,永康市,新樹里,0,1,796,8,804,1301,3,1,3,0,1,0,61.80
臺南縣,永康市,大灣里,0,1,1858,14,1872,3009,3,1,3,0,1,0,62.21
臺南縣,永康市,東灣里,0,1,1889,15,1904,3255,3,1,3,0,1,0,58.49
臺南縣,永康市,西灣里,0,1,3158,10,3168,5507,3,1,3,0,1,0,57.53
臺南縣,永康市,南灣里,0,1,2136,20,2156,3525,3,1,3,0,1,0,61.16
臺南縣,永康市,崑山里,0,1,3035,23,3058,5355,3,1,3,0,1,0,57.11
臺南縣,永康市,北灣里,0,1,3449,22,3471,5939,3,1,3,0,1,0,58.44
臺南縣,永康市,復興里,0,1,1076,6,1082,1750,3,1,3,0,1,0,61.83
臺南縣,永康市,光復里,0,1,607,5,612,960,3,1,3,0,1,0,63.75
臺南縣,永康市,建國里,0,1,934,8,942,1546,3,1,3,0,1,0,60.93
臺南縣,永康市,復國里,0,1,1310,7,1317,2163,3,1,3,0,1,0,60.89
臺南縣,永康市,復華里,0,1,5359,38,5397,10442,3,1,3,0,1,0,51.69
臺南縣,永康市,神洲里,0,1,1012,7,1019,1675,3,1,3,0,1,0,60.84
臺南縣,永康市,成功里,0,1,853,6,859,1550,3,1,3,0,1,0,55.42
臺南縣,永康市,中華里,0,1,1237,9,1246,2165,3,1,3,0,1,0,57.55
臺南縣,永康市,中興里,0,1,1699,15,1714,2843,3,1,3,0,1,0,60.29
臺南縣,永康市,勝利里,0,1,2815,20,2835,5382,3,1,3,0,1,0,52.68
高雄縣,鳳山市,鳳崗里,0,1,778,4,782,1278,3,1,3,0,1,0,61.19
高雄縣,鳳山市,縣衙里,0,1,493,1,494,865,3,1,3,0,1,0,57.11
高雄縣,鳳山市,曹公里,0,1,1395,10,1405,2298,3,1,3,0,1,0,61.14
高雄縣,鳳山市,鎮西里,0,1,2959,36,2995,4994,3,1,3,0,1,0,59.97
高雄縣,鳳山市,北門里,0,1,2334,20,2354,3996,3,1,3,0,1,0,58.91
高雄縣,鳳山市,鎮北里,0,1,2494,17,2511,4435,3,1,3,0,1,0,56.62
高雄縣,鳳山市,武松里,0,1,1387,6,1393,2441,3,1,3,0,1,0,57.07
高雄縣,鳳山市,忠誠里,0,1,1609,18,1627,2825,3,1,3,0,1,0,57.59
高雄縣,鳳山市,文英里,0,1,1672,13,1685,2980,3,1,3,0,1,0,56.54
高雄縣,鳳山市,文華里,0,1,3717,22,3739,5951,3,1,3,0,1,0,62.83
高雄縣,鳳山市,文山里,0,1,3064,18,3082,5293,3,1,3,0,1,0,58.23
高雄縣,鳳山市,文德里,0,1,3028,17,3045,5765,3,1,3,0,1,0,52.82
高雄縣,鳳山市,文衡里,0,1,1369,11,1380,2411,3,1,3,0,1,0,57.24
高雄縣,鳳山市,文福里,0,1,3104,19,3123,5909,3,1,3,0,1,0,52.85
高雄縣,鳳山市,成功里,0,1,499,4,503,789,3,1,3,0,1,0,63.75
高雄縣,鳳山市,縣口里,0,1,293,4,297,484,3,1,3,0,1,0,61.36
高雄縣,鳳山市,光明里,0,1,810,4,814,1311,3,1,3,0,1,0,62.09
高雄縣,鳳山市,和德里,0,1,968,7,975,1643,3,1,3,0,1,0,59.34
高雄縣,鳳山市,和興里,0,1,2897,16,2913,4874,3,1,3,0,1,0,59.77
高雄縣,鳳山市,南興里,0,1,638,5,643,1054,3,1,3,0,1,0,61.01
高雄縣,鳳山市,三民里,0,1,694,8,702,1086,3,1,3,0,1,0,64.64
高雄縣,鳳山市,新興里,0,1,762,6,768,1442,3,1,3,0,1,0,53.26
高雄縣,鳳山市,興仁里,0,1,2286,14,2300,3780,3,1,3,0,1,0,60.85
高雄縣,鳳山市,興中里,0,1,465,4,469,814,3,1,3,0,1,0,57.62
高雄縣,鳳山市,協和里,0,1,2049,12,2061,3497,3,1,3,0,1,0,58.94
高雄縣,鳳山市,忠義里,0,1,2353,15,2368,4113,3,1,3,0,1,0,57.57
高雄縣,鳳山市,忠孝里,0,1,3129,19,3148,5357,3,1,3,0,1,0,58.76
高雄縣,鳳山市,中和里,0,1,1922,23,1945,3260,3,1,3,0,1,0,59.66
高雄縣,鳳山市,誠正里,0,1,599,8,607,912,3,1,3,0,1,0,66.56
高雄縣,鳳山市,誠義里,0,1,922,8,930,1586,3,1,3,0,1,0,58.64
高雄縣,鳳山市,生明里,0,1,989,10,999,1582,3,1,3,0,1,0,63.15
高雄縣,鳳山市,鎮東里,0,1,1175,8,1183,2084,3,1,3,0,1,0,56.77
高雄縣,鳳山市,瑞竹里,0,1,3005,18,3023,4823,3,1,3,0,1,0,62.68
高雄縣,鳳山市,瑞興里,0,1,2260,14,2274,3887,3,1,3,0,1,0,58.50
高雄縣,鳳山市,東門里,0,1,3007,17,3024,4802,3,1,3,0,1,0,62.97
高雄縣,鳳山市,誠德里,0,1,1249,10,1259,2027,3,1,3,0,1,0,62.11
高雄縣,鳳山市,誠信里,0,1,916,10,926,1662,3,1,3,0,1,0,55.72
高雄縣,鳳山市,誠智里,0,1,1240,12,1252,2254,3,1,3,0,1,0,55.55
高雄縣,鳳山市,鳳東里,0,1,2362,16,2378,4078,3,1,3,0,1,0,58.31
高雄縣,鳳山市,埤頂里,0,1,2767,16,2783,4639,3,1,3,0,1,0,59.99
高雄縣,鳳山市,美齡里,0,1,71,1,72,155,3,1,3,0,1,0,46.45
高雄縣,鳳山市,中正里,0,1,680,1,681,1148,3,1,3,0,1,0,59.32
高雄縣,鳳山市,海光里,0,1,2265,30,2295,3748,3,1,3,0,1,0,61.23
高雄縣,鳳山市,海風里,0,1,1533,11,1544,2244,3,1,3,0,1,0,68.81
高雄縣,鳳山市,國泰里,0,1,2182,13,2195,3923,3,1,3,0,1,0,55.95
高雄縣,鳳山市,國光里,0,1,1964,9,1973,3678,3,1,3,0,1,0,53.64
高雄縣,鳳山市,國隆里,0,1,1426,9,1435,2675,3,1,3,0,1,0,53.64
高雄縣,鳳山市,國富里,0,1,1245,5,1250,2224,3,1,3,0,1,0,56.21
高雄縣,鳳山市,武慶里,0,1,1151,9,1160,2125,3,1,3,0,1,0,54.59
高雄縣,鳳山市,武漢里,0,1,2083,15,2098,3872,3,1,3,0,1,0,54.18
高雄縣,鳳山市,新甲里,0,1,1301,8,1309,2373,3,1,3,0,1,0,55.16
高雄縣,鳳山市,新武里,0,1,1138,8,1146,1958,3,1,3,0,1,0,58.53
高雄縣,鳳山市,新泰里,0,1,1462,6,1468,2722,3,1,3,0,1,0,53.93
高雄縣,鳳山市,新樂里,0,1,1837,13,1850,3361,3,1,3,0,1,0,55.04
高雄縣,鳳山市,新強里,0,1,2294,12,2306,4075,3,1,3,0,1,0,56.59
高雄縣,鳳山市,海洋里,0,1,1773,14,1787,3141,3,1,3,0,1,0,56.89
高雄縣,鳳山市,新富里,0,1,1897,11,1908,3648,3,1,3,0,1,0,52.30
高雄縣,鳳山市,老爺里,0,1,3338,25,3363,6113,3,1,3,0,1,0,55.01
高雄縣,鳳山市,中民里,0,1,1772,7,1779,3438,3,1,3,0,1,0,51.75
高雄縣,鳳山市,中崙里,0,1,1160,13,1173,1983,3,1,3,0,1,0,59.15
高雄縣,鳳山市,中榮里,0,1,2014,11,2025,3890,3,1,3,0,1,0,52.06
高雄縣,鳳山市,過埤里,0,1,1921,14,1935,3600,3,1,3,0,1,0,53.75
高雄縣,鳳山市,正義里,0,1,4440,29,4469,8605,3,1,3,0,1,0,51.93
高雄縣,鳳山市,一甲里,0,1,1739,12,1751,3151,3,1,3,0,1,0,55.57
高雄縣,鳳山市,二甲里,0,1,2052,16,2068,3649,3,1,3,0,1,0,56.67
高雄縣,鳳山市,龍成里,0,1,1416,14,1430,2674,3,1,3,0,1,0,53.48
高雄縣,鳳山市,鎮南里,0,1,2194,15,2209,3936,3,1,3,0,1,0,56.12
高雄縣,鳳山市,富甲里,0,1,976,10,986,2119,3,1,3,0,1,0,46.53
高雄縣,鳳山市,善美里,0,1,2301,23,2324,4611,3,1,3,0,1,0,50.40
高雄縣,鳳山市,富榮里,0,1,1067,8,1075,1970,3,1,3,0,1,0,54.57
高雄縣,鳳山市,南和里,0,1,1347,6,1353,2470,3,1,3,0,1,0,54.78
高雄縣,鳳山市,南成里,0,1,2303,17,2320,4118,3,1,3,0,1,0,56.34
高雄縣,鳳山市,天興里,0,1,1961,11,1972,3404,3,1,3,0,1,0,57.93
高雄縣,鳳山市,大德里,0,1,1972,13,1985,3567,3,1,3,0,1,0,55.65
高雄縣,鳳山市,五福里,0,1,1770,10,1780,2994,3,1,3,0,1,0,59.45
高雄縣,鳳山市,福興里,0,1,2830,23,2853,5245,3,1,3,0,1,0,54.39
高雄縣,鳳山市,福祥里,0,1,1354,17,1371,2509,3,1,3,0,1,0,54.64
高雄縣,鳳山市,福誠里,0,1,1536,11,1547,2850,3,1,3,0,1,0,54.28
高雄縣,林園鄉,仁愛村,0,1,1561,15,1576,2624,3,1,3,0,1,0,60.06
高雄縣,林園鄉,林園村,0,1,1786,12,1798,2976,3,1,3,0,1,0,60.42
高雄縣,林園鄉,文賢村,0,1,1265,8,1273,2076,3,1,3,0,1,0,61.32
高雄縣,林園鄉,東林村,0,1,1467,7,1474,2491,3,1,3,0,1,0,59.17
高雄縣,林園鄉,溪州村,0,1,2005,10,2015,3362,3,1,3,0,1,0,59.93
高雄縣,林園鄉,五福村,0,1,1041,9,1050,1874,3,1,3,0,1,0,56.03
高雄縣,林園鄉,潭頭村,0,1,1422,11,1433,2381,3,1,3,0,1,0,60.18
高雄縣,林園鄉,中厝村,0,1,1529,22,1551,2549,3,1,3,0,1,0,60.85
高雄縣,林園鄉,林內村,0,1,998,40,1038,1690,3,1,3,0,1,0,61.42
高雄縣,林園鄉,王公村,0,1,1881,12,1893,3131,3,1,3,0,1,0,60.46
高雄縣,林園鄉,廣應村,0,1,1732,11,1743,2897,3,1,3,0,1,0,60.17
高雄縣,林園鄉,林家村,0,1,810,7,817,1193,3,1,3,0,1,0,68.48
高雄縣,林園鄉,龔厝村,0,1,1041,17,1058,1643,3,1,3,0,1,0,64.39
高雄縣,林園鄉,中門村,0,1,1205,13,1218,1958,3,1,3,0,1,0,62.21
高雄縣,林園鄉,頂厝村,0,1,2052,22,2074,3528,3,1,3,0,1,0,58.79
高雄縣,林園鄉,港埔村,0,1,959,6,965,1629,3,1,3,0,1,0,59.24
高雄縣,林園鄉,港嘴村,0,1,902,15,917,1359,3,1,3,0,1,0,67.48
高雄縣,林園鄉,西溪村,0,1,1794,4,1798,2810,3,1,3,0,1,0,63.99
高雄縣,林園鄉,中芸村,0,1,1100,10,1110,1714,3,1,3,0,1,0,64.76
高雄縣,林園鄉,鳳芸村,0,1,1085,8,1093,1660,3,1,3,0,1,0,65.84
高雄縣,林園鄉,東汕村,0,1,537,4,541,880,3,1,3,0,1,0,61.48
高雄縣,林園鄉,西汕村,0,1,449,8,457,743,3,1,3,0,1,0,61.51
高雄縣,林園鄉,中汕村,0,1,1213,18,1231,2089,3,1,3,0,1,0,58.93
高雄縣,林園鄉,北汕村,0,1,812,9,821,1449,3,1,3,0,1,0,56.66
高雄縣,大寮鄉,義和村,0,1,1247,13,1260,2019,3,1,3,0,1,0,62.41
高雄縣,大寮鄉,溪寮村,0,1,905,9,914,1392,3,1,3,0,1,0,65.66
高雄縣,大寮鄉,江山村,0,1,1059,8,1067,1547,3,1,3,0,1,0,68.97
高雄縣,大寮鄉,中庄村,0,1,4859,52,4911,8340,3,1,3,0,1,0,58.88
高雄縣,大寮鄉,後庄村,0,1,2968,25,2993,5342,3,1,3,0,1,0,56.03
高雄縣,大寮鄉,前庄村,0,1,1164,17,1181,1963,3,1,3,0,1,0,60.16
高雄縣,大寮鄉,中興村,0,1,3517,25,3542,5723,3,1,3,0,1,0,61.89
高雄縣,大寮鄉,忠義村,0,1,997,10,1007,1473,3,1,3,0,1,0,68.36
高雄縣,大寮鄉,光武村,0,1,708,13,721,1128,3,1,3,0,1,0,63.92
高雄縣,大寮鄉,復興村,0,1,691,9,700,1165,3,1,3,0,1,0,60.09
高雄縣,大寮鄉,翁園村,0,1,1788,18,1806,2930,3,1,3,0,1,0,61.64
高雄縣,大寮鄉,琉球村,0,1,1895,19,1914,3109,3,1,3,0,1,0,61.56
高雄縣,大寮鄉,永芳村,0,1,3439,28,3467,6010,3,1,3,0,1,0,57.69
高雄縣,大寮鄉,山頂村,0,1,3420,27,3447,5890,3,1,3,0,1,0,58.52
高雄縣,大寮鄉,會社村,0,1,2829,17,2846,4854,3,1,3,0,1,0,58.63
高雄縣,大寮鄉,三隆村,0,1,2406,14,2420,3991,3,1,3,0,1,0,60.64
高雄縣,大寮鄉,上寮村,0,1,1269,7,1276,2087,3,1,3,0,1,0,61.14
高雄縣,大寮鄉,大寮村,0,1,3128,34,3162,5637,3,1,3,0,1,0,56.09
高雄縣,大寮鄉,拷潭村,0,1,839,7,846,1340,3,1,3,0,1,0,63.13
高雄縣,大寮鄉,內坑村,0,1,2063,22,2085,3968,3,1,3,0,1,0,52.55
高雄縣,大寮鄉,新厝村,0,1,881,14,895,1427,3,1,3,0,1,0,62.72
高雄縣,大寮鄉,過溪村,0,1,1116,15,1131,1800,3,1,3,0,1,0,62.83
高雄縣,大寮鄉,潮寮村,0,1,1691,19,1710,2559,3,1,3,0,1,0,66.82
高雄縣,大寮鄉,會結村,0,1,847,7,854,1269,3,1,3,0,1,0,67.30
高雄縣,大寮鄉,昭明村,0,1,1704,10,1714,3021,3,1,3,0,1,0,56.74
高雄縣,大寮鄉,義仁村,0,1,1085,8,1093,1804,3,1,3,0,1,0,60.59
高雄縣,大樹鄉,竹寮村,0,1,1281,7,1288,2152,3,1,3,0,1,0,59.85
高雄縣,大樹鄉,九曲村,0,1,2352,15,2367,4070,3,1,3,0,1,0,58.16
高雄縣,大樹鄉,久堂村,0,1,2504,28,2532,3881,3,1,3,0,1,0,65.24
高雄縣,大樹鄉,水安村,0,1,1408,9,1417,2171,3,1,3,0,1,0,65.27
高雄縣,大樹鄉,水寮村,0,1,1506,11,1517,2278,3,1,3,0,1,0,66.59
高雄縣,大樹鄉,井腳村,0,1,1016,13,1029,1508,3,1,3,0,1,0,68.24
高雄縣,大樹鄉,小坪村,0,1,799,11,810,1234,3,1,3,0,1,0,65.64
高雄縣,大樹鄉,龍目村,0,1,1077,4,1081,1577,3,1,3,0,1,0,68.55
高雄縣,大樹鄉,大樹村,0,1,1490,10,1500,2259,3,1,3,0,1,0,66.40
高雄縣,大樹鄉,檨腳村,0,1,2014,11,2025,3265,3,1,3,0,1,0,62.02
高雄縣,大樹鄉,興山村,0,1,705,5,710,1088,3,1,3,0,1,0,65.26
高雄縣,大樹鄉,和山村,0,1,668,1,669,944,3,1,3,0,1,0,70.87
高雄縣,大樹鄉,姑山村,0,1,603,7,610,955,3,1,3,0,1,0,63.87
高雄縣,大樹鄉,三和村,0,1,518,5,523,814,3,1,3,0,1,0,64.25
高雄縣,大樹鄉,大坑村,0,1,862,1,863,1342,3,1,3,0,1,0,64.31
高雄縣,大樹鄉,溪埔村,0,1,1076,3,1079,1670,3,1,3,0,1,0,64.61
高雄縣,大樹鄉,興田村,0,1,1155,13,1168,1861,3,1,3,0,1,0,62.76
高雄縣,大樹鄉,統嶺村,0,1,433,6,439,611,3,1,3,0,1,0,71.85
高雄縣,大社鄉,嘉誠村,0,1,588,10,598,947,3,1,3,0,1,0,63.15
高雄縣,大社鄉,保社村,0,1,1261,10,1271,1976,3,1,3,0,1,0,64.32
高雄縣,大社鄉,大社村,0,1,2459,21,2480,4105,3,1,3,0,1,0,60.41
高雄縣,大社鄉,保安村,0,1,1528,12,1540,2509,3,1,3,0,1,0,61.38
高雄縣,大社鄉,三奶村,0,1,1541,7,1548,2481,3,1,3,0,1,0,62.39
高雄縣,大社鄉,觀音村,0,1,2846,26,2872,4537,3,1,3,0,1,0,63.30
高雄縣,大社鄉,神農村,0,1,2109,25,2134,3518,3,1,3,0,1,0,60.66
高雄縣,大社鄉,中里村,0,1,1662,15,1677,2664,3,1,3,0,1,0,62.95
高雄縣,大社鄉,翠屏村,0,1,887,7,894,1440,3,1,3,0,1,0,62.08
高雄縣,仁武鄉,仁武村,0,1,2569,28,2597,4234,3,1,3,0,1,0,61.34
高雄縣,仁武鄉,文武村,0,1,3126,24,3150,5399,3,1,3,0,1,0,58.34
高雄縣,仁武鄉,後安村,0,1,1239,14,1253,2104,3,1,3,0,1,0,59.55
高雄縣,仁武鄉,竹後村,0,1,1381,13,1394,2166,3,1,3,0,1,0,64.36
高雄縣,仁武鄉,中華村,0,1,795,8,803,1328,3,1,3,0,1,0,60.47
高雄縣,仁武鄉,八卦村,0,1,3736,35,3771,7182,3,1,3,0,1,0,52.51
高雄縣,仁武鄉,五和村,0,1,1313,8,1321,2322,3,1,3,0,1,0,56.89
高雄縣,仁武鄉,高楠村,0,1,1131,21,1152,1695,3,1,3,0,1,0,67.96
高雄縣,仁武鄉,大灣村,0,1,1140,6,1146,2008,3,1,3,0,1,0,57.07
高雄縣,仁武鄉,赤山村,0,1,1478,8,1486,2637,3,1,3,0,1,0,56.35
高雄縣,仁武鄉,仁和村,0,1,1224,4,1228,2088,3,1,3,0,1,0,58.81
高雄縣,仁武鄉,灣內村,0,1,1776,16,1792,3140,3,1,3,0,1,0,57.07
高雄縣,仁武鄉,仁慈村,0,1,813,10,823,1316,3,1,3,0,1,0,62.54
高雄縣,仁武鄉,考潭村,0,1,1427,17,1444,2362,3,1,3,0,1,0,61.13
高雄縣,仁武鄉,烏林村,0,1,1819,21,1840,2933,3,1,3,0,1,0,62.73
高雄縣,仁武鄉,仁福村,0,1,400,1,401,614,3,1,3,0,1,0,65.31
高雄縣,鳥松鄉,鳥松村,0,1,4415,30,4445,7943,3,1,3,0,1,0,55.96
高雄縣,鳥松鄉,夢裡村,0,1,1771,13,1784,2839,3,1,3,0,1,0,62.84
高雄縣,鳥松鄉,大華村,0,1,4419,26,4445,7579,3,1,3,0,1,0,58.65
高雄縣,鳥松鄉,濫埔村,0,1,1866,16,1882,2920,3,1,3,0,1,0,64.45
高雄縣,鳥松鄉,仁美村,0,1,3460,28,3488,5623,3,1,3,0,1,0,62.03
高雄縣,鳥松鄉,華美村,0,1,1933,29,1962,3240,3,1,3,0,1,0,60.56
高雄縣,鳥松鄉,大竹村,0,1,485,6,491,690,3,1,3,0,1,0,71.16
高雄縣,岡山鎮,岡山里,0,1,2064,20,2084,3784,3,1,3,0,1,0,55.07
高雄縣,岡山鎮,平安里,0,1,727,5,732,1207,3,1,3,0,1,0,60.65
高雄縣,岡山鎮,壽天里,0,1,1877,10,1887,3147,3,1,3,0,1,0,59.96
高雄縣,岡山鎮,維仁里,0,1,694,5,699,1157,3,1,3,0,1,0,60.41
高雄縣,岡山鎮,灣裡里,0,1,961,3,964,1440,3,1,3,0,1,0,66.94
高雄縣,岡山鎮,大遼里,0,1,824,8,832,1244,3,1,3,0,1,0,66.88
高雄縣,岡山鎮,後紅里,0,1,1681,16,1697,3012,3,1,3,0,1,0,56.34
高雄縣,岡山鎮,碧紅里,0,1,1678,13,1691,2971,3,1,3,0,1,0,56.92
高雄縣,岡山鎮,程香里,0,1,1810,16,1826,3075,3,1,3,0,1,0,59.38
高雄縣,岡山鎮,竹圍里,0,1,2609,16,2625,4511,3,1,3,0,1,0,58.19
高雄縣,岡山鎮,臺上里,0,1,2219,22,2241,3794,3,1,3,0,1,0,59.07
高雄縣,岡山鎮,為隨里,0,1,416,4,420,588,3,1,3,0,1,0,71.43
高雄縣,岡山鎮,前峰里,0,1,1549,13,1562,2436,3,1,3,0,1,0,64.12
高雄縣,岡山鎮,壽峰里,0,1,1232,7,1239,1978,3,1,3,0,1,0,62.64
高雄縣,岡山鎮,仁壽里,0,1,2019,15,2034,3260,3,1,3,0,1,0,62.39
高雄縣,岡山鎮,協和里,0,1,2014,8,2022,3242,3,1,3,0,1,0,62.37
高雄縣,岡山鎮,本洲里,0,1,993,14,1007,1470,3,1,3,0,1,0,68.50
高雄縣,岡山鎮,後協里,0,1,2760,25,2785,4741,3,1,3,0,1,0,58.74
高雄縣,岡山鎮,協榮里,0,1,1179,11,1190,1955,3,1,3,0,1,0,60.87
高雄縣,岡山鎮,劉厝里,0,1,837,5,842,1321,3,1,3,0,1,0,63.74
高雄縣,岡山鎮,白米里,0,1,783,6,789,1306,3,1,3,0,1,0,60.41
高雄縣,岡山鎮,石潭里,0,1,865,6,871,1277,3,1,3,0,1,0,68.21
高雄縣,岡山鎮,福興里,0,1,697,4,701,994,3,1,3,0,1,0,70.52
高雄縣,岡山鎮,嘉興里,0,1,2010,14,2024,3188,3,1,3,0,1,0,63.49
高雄縣,岡山鎮,嘉峰里,0,1,1143,8,1151,1640,3,1,3,0,1,0,70.18
高雄縣,岡山鎮,潭底里,0,1,523,9,532,731,3,1,3,0,1,0,72.78
高雄縣,岡山鎮,華崗里,0,1,984,16,1000,1374,3,1,3,0,1,0,72.78
高雄縣,岡山鎮,三和里,0,1,510,7,517,790,3,1,3,0,1,0,65.44
高雄縣,岡山鎮,大莊里,0,1,527,7,534,849,3,1,3,0,1,0,62.90
高雄縣,岡山鎮,忠孝里,0,1,277,2,279,419,3,1,3,0,1,0,66.59
高雄縣,岡山鎮,和平里,0,1,580,4,584,915,3,1,3,0,1,0,63.83
高雄縣,岡山鎮,信義里,0,1,1348,8,1356,2100,3,1,3,0,1,0,64.57
高雄縣,岡山鎮,仁愛里,0,1,878,3,881,1304,3,1,3,0,1,0,67.56
高雄縣,岡山鎮,四維里,0,1,793,8,801,1122,3,1,3,0,1,0,71.39
高雄縣,岡山鎮,復興里,0,1,254,4,258,425,3,1,3,0,1,0,60.71
高雄縣,橋頭鄉,橋頭村,0,1,1098,11,1109,1764,3,1,3,0,1,0,62.87
高雄縣,橋頭鄉,橋南村,0,1,750,7,757,1134,3,1,3,0,1,0,66.75
高雄縣,橋頭鄉,仕隆村,0,1,1367,20,1387,2111,3,1,3,0,1,0,65.70
高雄縣,橋頭鄉,仕豐村,0,1,1345,11,1356,2176,3,1,3,0,1,0,62.32
高雄縣,橋頭鄉,仕和村,0,1,2126,13,2139,3282,3,1,3,0,1,0,65.17
高雄縣,橋頭鄉,新莊村,0,1,870,8,878,1266,3,1,3,0,1,0,69.35
高雄縣,橋頭鄉,甲北村,0,1,1209,20,1229,1950,3,1,3,0,1,0,63.03
高雄縣,橋頭鄉,甲南村,0,1,1338,9,1347,2132,3,1,3,0,1,0,63.18
高雄縣,橋頭鄉,頂鹽村,0,1,687,15,702,1055,3,1,3,0,1,0,66.54
高雄縣,橋頭鄉,白樹村,0,1,1601,12,1613,2727,3,1,3,0,1,0,59.15
高雄縣,橋頭鄉,芋寮村,0,1,819,3,822,1146,3,1,3,0,1,0,71.73
高雄縣,橋頭鄉,三德村,0,1,451,3,454,739,3,1,3,0,1,0,61.43
高雄縣,橋頭鄉,西林村,0,1,974,4,978,1454,3,1,3,0,1,0,67.26
高雄縣,橋頭鄉,東林村,0,1,1351,12,1363,2145,3,1,3,0,1,0,63.54
高雄縣,橋頭鄉,德松村,0,1,687,6,693,1068,3,1,3,0,1,0,64.89
高雄縣,橋頭鄉,筆秀村,0,1,1049,7,1056,1488,3,1,3,0,1,0,70.97
高雄縣,橋頭鄉,中崎村,0,1,424,2,426,646,3,1,3,0,1,0,65.94
高雄縣,燕巢鄉,金山村,0,1,296,1,297,429,3,1,3,0,1,0,69.23
高雄縣,燕巢鄉,尖山村,0,1,725,12,737,1113,3,1,3,0,1,0,66.22
高雄縣,燕巢鄉,東燕村,0,1,1510,26,1536,2219,3,1,3,0,1,0,69.22
高雄縣,燕巢鄉,西燕村,0,1,1950,15,1965,3064,3,1,3,0,1,0,64.13
高雄縣,燕巢鄉,南燕村,0,1,1799,12,1811,2771,3,1,3,0,1,0,65.36
高雄縣,燕巢鄉,瓊林村,0,1,1206,8,1214,1817,3,1,3,0,1,0,66.81
高雄縣,燕巢鄉,安招村,0,1,2329,26,2355,3853,3,1,3,0,1,0,61.12
高雄縣,燕巢鄉,角宿村,0,1,1416,10,1426,2263,3,1,3,0,1,0,63.01
高雄縣,燕巢鄉,鳳雄村,0,1,1439,16,1455,2293,3,1,3,0,1,0,63.45
高雄縣,燕巢鄉,橫山村,0,1,1020,10,1030,1785,3,1,3,0,1,0,57.70
高雄縣,燕巢鄉,深水村,0,1,1492,16,1508,2381,3,1,3,0,1,0,63.33
高雄縣,田寮鄉,鹿埔村,0,1,275,0,275,365,3,1,3,0,1,0,75.34
高雄縣,田寮鄉,古亭村,0,1,383,6,389,648,3,1,3,0,1,0,60.03
高雄縣,田寮鄉,崇德村,0,1,685,3,688,945,3,1,3,0,1,0,72.80
高雄縣,田寮鄉,三和村,0,1,288,1,289,418,3,1,3,0,1,0,69.14
高雄縣,田寮鄉,西德村,0,1,564,6,570,892,3,1,3,0,1,0,63.90
高雄縣,田寮鄉,南安村,0,1,877,9,886,1316,3,1,3,0,1,0,67.33
高雄縣,田寮鄉,大同村,0,1,261,3,264,414,3,1,3,0,1,0,63.77
高雄縣,田寮鄉,田寮村,0,1,285,3,288,420,3,1,3,0,1,0,68.57
高雄縣,田寮鄉,七星村,0,1,572,6,578,842,3,1,3,0,1,0,68.65
高雄縣,田寮鄉,新興村,0,1,895,6,901,1296,3,1,3,0,1,0,69.52
高雄縣,阿蓮鄉,阿蓮村,0,1,2489,19,2508,4225,3,1,3,0,1,0,59.36
高雄縣,阿蓮鄉,南蓮村,0,1,1673,8,1681,2705,3,1,3,0,1,0,62.14
高雄縣,阿蓮鄉,清蓮村,0,1,1487,19,1506,2559,3,1,3,0,1,0,58.85
高雄縣,阿蓮鄉,和蓮村,0,1,1187,15,1202,2053,3,1,3,0,1,0,58.55
高雄縣,阿蓮鄉,青旗村,0,1,766,4,770,1331,3,1,3,0,1,0,57.85
高雄縣,阿蓮鄉,石安村,0,1,736,6,742,1294,3,1,3,0,1,0,57.34
高雄縣,阿蓮鄉,中路村,0,1,1152,15,1167,1933,3,1,3,0,1,0,60.37
高雄縣,阿蓮鄉,峰山村,0,1,691,9,700,1123,3,1,3,0,1,0,62.33
高雄縣,阿蓮鄉,港後村,0,1,1132,20,1152,1857,3,1,3,0,1,0,62.04
高雄縣,阿蓮鄉,崗山村,0,1,441,5,446,725,3,1,3,0,1,0,61.52
高雄縣,阿蓮鄉,復安村,0,1,971,15,986,1587,3,1,3,0,1,0,62.13
高雄縣,阿蓮鄉,玉庫村,0,1,596,6,602,979,3,1,3,0,1,0,61.49
高雄縣,路竹鄉,竹園村,0,1,1120,10,1130,1714,3,1,3,0,1,0,65.93
高雄縣,路竹鄉,下坑村,0,1,1566,15,1581,2514,3,1,3,0,1,0,62.89
高雄縣,路竹鄉,甲南村,0,1,1863,67,1930,2936,3,1,3,0,1,0,65.74
高雄縣,路竹鄉,甲北村,0,1,1221,12,1233,1951,3,1,3,0,1,0,63.20
高雄縣,路竹鄉,社東村,0,1,985,8,993,1572,3,1,3,0,1,0,63.17
高雄縣,路竹鄉,社中村,0,1,596,4,600,891,3,1,3,0,1,0,67.34
高雄縣,路竹鄉,社西村,0,1,1403,16,1419,2198,3,1,3,0,1,0,64.56
高雄縣,路竹鄉,社南村,0,1,2149,22,2171,3566,3,1,3,0,1,0,60.88
高雄縣,路竹鄉,竹東村,0,1,1777,15,1792,2902,3,1,3,0,1,0,61.75
高雄縣,路竹鄉,竹南村,0,1,1643,21,1664,2687,3,1,3,0,1,0,61.93
高雄縣,路竹鄉,竹西村,0,1,1442,20,1462,2190,3,1,3,0,1,0,66.76
高雄縣,路竹鄉,文南村,0,1,1375,14,1389,2148,3,1,3,0,1,0,64.66
高雄縣,路竹鄉,文北村,0,1,1740,17,1757,2772,3,1,3,0,1,0,63.38
高雄縣,路竹鄉,竹滬村,0,1,1537,17,1554,2633,3,1,3,0,1,0,59.02
高雄縣,路竹鄉,頂寮村,0,1,687,3,690,1158,3,1,3,0,1,0,59.59
高雄縣,路竹鄉,新達村,0,1,774,15,789,1190,3,1,3,0,1,0,66.30
高雄縣,路竹鄉,後鄉村,0,1,626,10,636,933,3,1,3,0,1,0,68.17
高雄縣,路竹鄉,北嶺村,0,1,788,7,795,1105,3,1,3,0,1,0,71.95
高雄縣,路竹鄉,三爺村,0,1,644,11,655,879,3,1,3,0,1,0,74.52
高雄縣,路竹鄉,鴨寮村,0,1,985,6,991,1542,3,1,3,0,1,0,64.27
高雄縣,湖內鄉,大湖村,0,1,1623,15,1638,2565,3,1,3,0,1,0,63.86
高雄縣,湖內鄉,田尾村,0,1,645,5,650,1053,3,1,3,0,1,0,61.73
高雄縣,湖內鄉,湖內村,0,1,1754,18,1772,2776,3,1,3,0,1,0,63.83
高雄縣,湖內鄉,湖東村,0,1,1146,14,1160,1919,3,1,3,0,1,0,60.45
高雄縣,湖內鄉,海埔村,0,1,1026,7,1033,1773,3,1,3,0,1,0,58.26
高雄縣,湖內鄉,海山村,0,1,740,7,747,1159,3,1,3,0,1,0,64.45
高雄縣,湖內鄉,劉家村,0,1,669,4,673,1065,3,1,3,0,1,0,63.19
高雄縣,湖內鄉,太爺村,0,1,480,3,483,828,3,1,3,0,1,0,58.33
高雄縣,湖內鄉,公館村,0,1,998,9,1007,1693,3,1,3,0,1,0,59.48
高雄縣,湖內鄉,葉厝村,0,1,1147,10,1157,1881,3,1,3,0,1,0,61.51
高雄縣,湖內鄉,文賢村,0,1,704,11,715,1179,3,1,3,0,1,0,60.64
高雄縣,湖內鄉,中賢村,0,1,1218,7,1225,2010,3,1,3,0,1,0,60.95
高雄縣,湖內鄉,逸賢村,0,1,563,10,573,997,3,1,3,0,1,0,57.47
高雄縣,湖內鄉,忠興村,0,1,494,5,499,753,3,1,3,0,1,0,66.27
高雄縣,茄萣鄉,福德村,0,1,684,4,688,1048,3,1,3,0,1,0,65.65
高雄縣,茄萣鄉,萬福村,0,1,560,2,562,894,3,1,3,0,1,0,62.86
高雄縣,茄萣鄉,白雲村,0,1,984,6,990,1605,3,1,3,0,1,0,61.68
高雄縣,茄萣鄉,嘉賜村,0,1,1563,7,1570,2833,3,1,3,0,1,0,55.42
高雄縣,茄萣鄉,嘉安村,0,1,824,9,833,1479,3,1,3,0,1,0,56.32
高雄縣,茄萣鄉,嘉樂村,0,1,1110,5,1115,1859,3,1,3,0,1,0,59.98
高雄縣,茄萣鄉,嘉泰村,0,1,713,4,717,1174,3,1,3,0,1,0,61.07
高雄縣,茄萣鄉,嘉福村,0,1,574,1,575,983,3,1,3,0,1,0,58.49
高雄縣,茄萣鄉,和協村,0,1,719,7,726,1197,3,1,3,0,1,0,60.65
高雄縣,茄萣鄉,嘉定村,0,1,755,7,762,1278,3,1,3,0,1,0,59.62
高雄縣,茄萣鄉,保定村,0,1,1689,24,1713,2962,3,1,3,0,1,0,57.83
高雄縣,茄萣鄉,大定村,0,1,750,3,753,1190,3,1,3,0,1,0,63.28
高雄縣,茄萣鄉,光定村,0,1,641,10,651,1061,3,1,3,0,1,0,61.36
高雄縣,茄萣鄉,吉定村,0,1,743,19,762,1270,3,1,3,0,1,0,60.00
高雄縣,茄萣鄉,崎漏村,0,1,1951,15,1966,3674,3,1,3,0,1,0,53.51
高雄縣,永安鄉,永安村,0,1,952,9,961,1484,3,1,3,0,1,0,64.76
高雄縣,永安鄉,永華村,0,1,1092,11,1103,1748,3,1,3,0,1,0,63.10
高雄縣,永安鄉,新港村,0,1,1332,20,1352,2378,3,1,3,0,1,0,56.85
高雄縣,永安鄉,鹽田村,0,1,213,1,214,382,3,1,3,0,1,0,56.02
高雄縣,永安鄉,保寧村,0,1,1319,19,1338,2031,3,1,3,0,1,0,65.88
高雄縣,永安鄉,維新村,0,1,1637,12,1649,2646,3,1,3,0,1,0,62.32
高雄縣,彌陀鄉,舊港村,0,1,1063,9,1072,1514,3,1,3,0,1,0,70.81
高雄縣,彌陀鄉,文安村,0,1,1261,13,1274,1773,3,1,3,0,1,0,71.86
高雄縣,彌陀鄉,鹽埕村,0,1,1285,12,1297,1918,3,1,3,0,1,0,67.62
高雄縣,彌陀鄉,過港村,0,1,694,4,698,966,3,1,3,0,1,0,72.26
高雄縣,彌陀鄉,光和村,0,1,697,5,702,1083,3,1,3,0,1,0,64.82
高雄縣,彌陀鄉,彌靖村,0,1,1285,9,1294,1818,3,1,3,0,1,0,71.18
高雄縣,彌陀鄉,彌仁村,0,1,430,1,431,584,3,1,3,0,1,0,73.80
高雄縣,彌陀鄉,彌壽村,0,1,503,1,504,717,3,1,3,0,1,0,70.29
高雄縣,彌陀鄉,彌陀村,0,1,1058,8,1066,1555,3,1,3,0,1,0,68.55
高雄縣,彌陀鄉,海尾村,0,1,565,5,570,859,3,1,3,0,1,0,66.36
高雄縣,彌陀鄉,漯底村,0,1,756,14,770,1015,3,1,3,0,1,0,75.86
高雄縣,彌陀鄉,南寮村,0,1,1428,17,1445,2031,3,1,3,0,1,0,71.15
高雄縣,梓官鄉,梓信村,0,1,1240,9,1249,1996,3,1,3,0,1,0,62.58
高雄縣,梓官鄉,梓義村,0,1,1166,4,1170,1982,3,1,3,0,1,0,59.03
高雄縣,梓官鄉,梓和村,0,1,1406,9,1415,2258,3,1,3,0,1,0,62.67
高雄縣,梓官鄉,梓平村,0,1,794,1,795,1153,3,1,3,0,1,0,68.95
高雄縣,梓官鄉,中崙村,0,1,621,5,626,1046,3,1,3,0,1,0,59.85
高雄縣,梓官鄉,同安村,0,1,614,6,620,926,3,1,3,0,1,0,66.95
高雄縣,梓官鄉,大舍村,0,1,2059,20,2079,3417,3,1,3,0,1,0,60.84
高雄縣,梓官鄉,赤崁村,0,1,1201,10,1211,1873,3,1,3,0,1,0,64.66
高雄縣,梓官鄉,赤東村,0,1,1475,12,1487,2322,3,1,3,0,1,0,64.04
高雄縣,梓官鄉,赤西村,0,1,412,3,415,694,3,1,3,0,1,0,59.80
高雄縣,梓官鄉,禮蚵村,0,1,1351,3,1354,2270,3,1,3,0,1,0,59.65
高雄縣,梓官鄉,智蚵村,0,1,1407,9,1416,2465,3,1,3,0,1,0,57.44
高雄縣,梓官鄉,信蚵村,0,1,959,9,968,1721,3,1,3,0,1,0,56.25
高雄縣,梓官鄉,茄苳村,0,1,1336,20,1356,2172,3,1,3,0,1,0,62.43
高雄縣,梓官鄉,典寶村,0,1,1516,15,1531,2463,3,1,3,0,1,0,62.16
高雄縣,旗山鎮,太平里,0,1,1330,7,1337,2277,3,1,3,0,1,0,58.72
高雄縣,旗山鎮,大德里,0,1,1539,7,1546,2417,3,1,3,0,1,0,63.96
高雄縣,旗山鎮,湄洲里,0,1,513,2,515,888,3,1,3,0,1,0,58.00
高雄縣,旗山鎮,鼓山里,0,1,389,3,392,583,3,1,3,0,1,0,67.24
高雄縣,旗山鎮,新山里,0,1,490,7,497,751,3,1,3,0,1,0,66.18
高雄縣,旗山鎮,和平里,0,1,457,5,462,749,3,1,3,0,1,0,61.68
高雄縣,旗山鎮,竹峰里,0,1,367,1,368,577,3,1,3,0,1,0,63.78
高雄縣,旗山鎮,瑞吉里,0,1,1123,5,1128,1945,3,1,3,0,1,0,57.99
高雄縣,旗山鎮,永和里,0,1,1770,23,1793,3039,3,1,3,0,1,0,59.00
高雄縣,旗山鎮,三協里,0,1,1117,12,1129,1901,3,1,3,0,1,0,59.39
高雄縣,旗山鎮,圓富里,0,1,1118,15,1133,1851,3,1,3,0,1,0,61.21
高雄縣,旗山鎮,中正里,0,1,1023,11,1034,1536,3,1,3,0,1,0,67.32
高雄縣,旗山鎮,大林里,0,1,858,8,866,1453,3,1,3,0,1,0,59.60
高雄縣,旗山鎮,上洲里,0,1,660,7,667,1004,3,1,3,0,1,0,66.43
高雄縣,旗山鎮,鯤洲里,0,1,599,7,606,889,3,1,3,0,1,0,68.17
高雄縣,旗山鎮,大山里,0,1,880,7,887,1306,3,1,3,0,1,0,67.92
高雄縣,旗山鎮,中洲里,0,1,635,3,638,920,3,1,3,0,1,0,69.35
高雄縣,旗山鎮,南洲里,0,1,957,8,965,1358,3,1,3,0,1,0,71.06
高雄縣,旗山鎮,新光里,0,1,617,5,622,863,3,1,3,0,1,0,72.07
高雄縣,旗山鎮,南勝里,0,1,1560,7,1567,2333,3,1,3,0,1,0,67.17
高雄縣,旗山鎮,東平里,0,1,1088,9,1097,1907,3,1,3,0,1,0,57.52
高雄縣,旗山鎮,東昌里,0,1,393,4,397,659,3,1,3,0,1,0,60.24
高雄縣,旗山鎮,糖廠里,0,1,246,2,248,379,3,1,3,0,1,0,65.44
高雄縣,旗山鎮,廣福里,0,1,425,5,430,640,3,1,3,0,1,0,67.19
高雄縣,旗山鎮,中寮里,0,1,136,1,137,206,3,1,3,0,1,0,66.50
高雄縣,美濃鎮,中圳里,0,1,1097,11,1108,1836,3,1,3,0,1,0,60.35
高雄縣,美濃鎮,東門里,0,1,822,7,829,1361,3,1,3,0,1,0,60.91
高雄縣,美濃鎮,泰安里,0,1,914,3,917,1482,3,1,3,0,1,0,61.88
高雄縣,美濃鎮,合和里,0,1,1302,10,1312,2254,3,1,3,0,1,0,58.21
高雄縣,美濃鎮,瀰濃里,0,1,1322,7,1329,2171,3,1,3,0,1,0,61.22
高雄縣,美濃鎮,福安里,0,1,1542,20,1562,2522,3,1,3,0,1,0,61.93
高雄縣,美濃鎮,祿興里,0,1,1530,14,1544,2507,3,1,3,0,1,0,61.59
高雄縣,美濃鎮,中壇里,0,1,1233,6,1239,2017,3,1,3,0,1,0,61.43
高雄縣,美濃鎮,德興里,0,1,956,6,962,1478,3,1,3,0,1,0,65.09
高雄縣,美濃鎮,清水里,0,1,1049,11,1060,1704,3,1,3,0,1,0,62.21
高雄縣,美濃鎮,吉和里,0,1,868,6,874,1407,3,1,3,0,1,0,62.12
高雄縣,美濃鎮,吉洋里,0,1,1197,14,1211,1992,3,1,3,0,1,0,60.79
高雄縣,美濃鎮,吉東里,0,1,1035,8,1043,1692,3,1,3,0,1,0,61.64
高雄縣,美濃鎮,龍山里,0,1,593,3,596,1048,3,1,3,0,1,0,56.87
高雄縣,美濃鎮,龍肚里,0,1,676,10,686,1123,3,1,3,0,1,0,61.09
高雄縣,美濃鎮,獅山里,0,1,1519,5,1524,2366,3,1,3,0,1,0,64.41
高雄縣,美濃鎮,龍肚里,0,1,1022,6,1028,1625,3,1,3,0,1,0,63.26
高雄縣,美濃鎮,廣德里,0,1,845,5,850,1387,3,1,3,0,1,0,61.28
高雄縣,美濃鎮,興隆里,0,1,742,3,745,1218,3,1,3,0,1,0,61.17
高雄縣,美濃鎮,廣林里,0,1,1008,6,1014,1693,3,1,3,0,1,0,59.89
高雄縣,六龜鄉,六龜村,0,1,528,13,541,1043,3,1,3,0,1,0,51.87
高雄縣,六龜鄉,義寶村,0,1,745,9,754,1141,3,1,3,0,1,0,66.08
高雄縣,六龜鄉,文武村,0,1,746,11,757,1551,3,1,3,0,1,0,48.81
高雄縣,六龜鄉,中興村,0,1,728,3,731,1311,3,1,3,0,1,0,55.76
高雄縣,六龜鄉,興龍村,0,1,507,3,510,885,3,1,3,0,1,0,57.63
高雄縣,六龜鄉,新威村,0,1,470,6,476,808,3,1,3,0,1,0,58.91
高雄縣,六龜鄉,新興村,0,1,400,7,407,735,3,1,3,0,1,0,55.37
高雄縣,六龜鄉,新寮村,0,1,435,6,441,623,3,1,3,0,1,0,70.79
高雄縣,六龜鄉,大津村,0,1,207,3,210,344,3,1,3,0,1,0,61.05
高雄縣,六龜鄉,新發村,0,1,686,12,698,1352,3,1,3,0,1,0,51.63
高雄縣,六龜鄉,荖濃村,0,1,723,9,732,1496,3,1,3,0,1,0,48.93
高雄縣,六龜鄉,寶來村,0,1,655,4,659,1096,3,1,3,0,1,0,60.13
高雄縣,甲仙鄉,東安村,0,1,362,0,362,606,3,1,3,0,1,0,59.74
高雄縣,甲仙鄉,西安村,0,1,685,3,688,1042,3,1,3,0,1,0,66.03
高雄縣,甲仙鄉,和安村,0,1,530,4,534,833,3,1,3,0,1,0,64.11
高雄縣,甲仙鄉,大田村,0,1,980,8,988,1591,3,1,3,0,1,0,62.10
高雄縣,甲仙鄉,寶隆村,0,1,468,2,470,714,3,1,3,0,1,0,65.83
高雄縣,甲仙鄉,關山村,0,1,447,6,453,715,3,1,3,0,1,0,63.36
高雄縣,甲仙鄉,小林村,0,1,622,6,628,1126,3,1,3,0,1,0,55.77
高雄縣,杉林鄉,杉林村,0,1,433,0,433,750,3,1,3,0,1,0,57.73
高雄縣,杉林鄉,木梓村,0,1,371,4,375,773,3,1,3,0,1,0,48.51
高雄縣,杉林鄉,集來村,0,1,1056,9,1065,1886,3,1,3,0,1,0,56.47
高雄縣,杉林鄉,新庄村,0,1,1027,17,1044,1738,3,1,3,0,1,0,60.07
高雄縣,杉林鄉,上平村,0,1,922,8,930,1506,3,1,3,0,1,0,61.75
高雄縣,杉林鄉,月眉村,0,1,1013,9,1022,1758,3,1,3,0,1,0,58.13
高雄縣,杉林鄉,月美村,0,1,738,9,747,1305,3,1,3,0,1,0,57.24
高雄縣,內門鄉,金竹村,0,1,467,2,469,787,3,1,3,0,1,0,59.59
高雄縣,內門鄉,溝坪村,0,1,567,7,574,1029,3,1,3,0,1,0,55.78
高雄縣,內門鄉,永興村,0,1,269,2,271,483,3,1,3,0,1,0,56.11
高雄縣,內門鄉,永吉村,0,1,289,1,290,465,3,1,3,0,1,0,62.37
高雄縣,內門鄉,永富村,0,1,600,9,609,1030,3,1,3,0,1,0,59.13
高雄縣,內門鄉,觀亭村,0,1,1079,20,1099,1747,3,1,3,0,1,0,62.91
高雄縣,內門鄉,中埔村,0,1,380,5,385,608,3,1,3,0,1,0,63.32
高雄縣,內門鄉,瑞山村,0,1,234,1,235,363,3,1,3,0,1,0,64.74
高雄縣,內門鄉,內南村,0,1,259,3,262,405,3,1,3,0,1,0,64.69
高雄縣,內門鄉,內東村,0,1,559,5,564,783,3,1,3,0,1,0,72.03
高雄縣,內門鄉,光興村,0,1,418,2,420,644,3,1,3,0,1,0,65.22
高雄縣,內門鄉,東埔村,0,1,334,2,336,497,3,1,3,0,1,0,67.61
高雄縣,內門鄉,內豊村,0,1,814,4,818,1158,3,1,3,0,1,0,70.64
高雄縣,內門鄉,內門村,0,1,663,1,664,981,3,1,3,0,1,0,67.69
高雄縣,內門鄉,石坑村,0,1,323,1,324,505,3,1,3,0,1,0,64.16
高雄縣,內門鄉,三平村,0,1,462,3,465,676,3,1,3,0,1,0,68.79
高雄縣,內門鄉,木柵村,0,1,457,3,460,693,3,1,3,0,1,0,66.38
高雄縣,內門鄉,內興村,0,1,419,8,427,622,3,1,3,0,1,0,68.65
高雄縣,茂林鄉,茂林村,0,1,23,0,23,58,3,1,3,0,1,0,39.66
高雄縣,茂林鄉,萬山村,0,1,11,0,11,23,3,1,3,0,1,0,47.83
高雄縣,茂林鄉,多納村,0,1,9,0,9,25,3,1,3,0,1,0,36.00
高雄縣,桃源鄉,寶山村,0,1,19,0,19,42,3,1,3,0,1,0,45.24
高雄縣,桃源鄉,建山村,0,1,43,0,43,86,3,1,3,0,1,0,50.00
高雄縣,桃源鄉,高中村,0,1,24,0,24,59,3,1,3,0,1,0,40.68
高雄縣,桃源鄉,桃源村,0,1,44,0,44,107,3,1,3,0,1,0,41.12
高雄縣,桃源鄉,勤和村,0,1,6,2,8,18,3,1,3,0,1,0,44.44
高雄縣,桃源鄉,復興村,0,1,8,0,8,15,3,1,3,0,1,0,53.33
高雄縣,桃源鄉,梅蘭村,0,1,4,0,4,10,3,1,3,0,1,0,40.00
高雄縣,桃源鄉,梅山村,0,1,11,0,11,19,3,1,3,0,1,0,57.89
高雄縣,三民鄉,民族村,0,1,61,0,61,187,3,1,3,0,1,0,32.62
高雄縣,三民鄉,民權村,0,1,14,1,15,45,3,1,3,0,1,0,33.33
高雄縣,三民鄉,民生村,0,1,55,1,56,98,3,1,3,0,1,0,57.14
屏東縣,屏東市,大同里、端正里、武廟里,0,1,946,2,948,1465,3,1,3,0,1,0,64.71
屏東縣,屏東市,民權里、光榮里,0,1,932,1,933,1470,3,1,3,0,1,0,63.47
屏東縣,屏東市,泰安里、文明里,0,1,668,5,673,1058,3,1,3,0,1,0,63.61
屏東縣,屏東市,維新里,0,1,1702,9,1711,2792,3,1,3,0,1,0,61.28
屏東縣,屏東市,大埔里、必信里,0,1,918,4,922,1456,3,1,3,0,1,0,63.32
屏東縣,屏東市,崇禮里、崇智里,0,1,558,0,558,845,3,1,3,0,1,0,66.04
屏東縣,屏東市,平和里、安樂里,0,1,923,5,928,1387,3,1,3,0,1,0,66.91
屏東縣,屏東市,楠樹里、扶風里,0,1,892,3,895,1391,3,1,3,0,1,0,64.34
屏東縣,屏東市,勝豐里、金泉里,0,1,762,3,765,1283,3,1,3,0,1,0,59.63
屏東縣,屏東市,橋南里,0,1,897,2,899,1560,3,1,3,0,1,0,57.63
屏東縣,屏東市,橋北里,0,1,574,5,579,909,3,1,3,0,1,0,63.70
屏東縣,屏東市,大連里,0,1,5176,31,5207,8622,3,1,3,0,1,0,60.39
屏東縣,屏東市,豐田里,0,1,2399,12,2411,3920,3,1,3,0,1,0,61.5051020408
屏東縣,屏東市,豐榮里,0,1,1516,5,1521,2396,3,1,3,0,1,0,63.48
屏東縣,屏東市,豐源里,0,1,2297,16,2313,3601,3,1,3,0,1,0,64.23
屏東縣,屏東市,長春里,0,1,1217,3,1220,2048,3,1,3,0,1,0,59.57
屏東縣,屏東市,瑞光里,0,1,3779,34,3813,6437,3,1,3,0,1,0,59.24
屏東縣,屏東市,湖南里,0,1,651,1,652,993,3,1,3,0,1,0,65.66
屏東縣,屏東市,湖西里,0,1,914,7,921,1390,3,1,3,0,1,0,66.2589928058
屏東縣,屏東市,歸心里,0,1,689,3,692,1113,3,1,3,0,1,0,62.1743036837
屏東縣,屏東市,清溪里,0,1,1775,5,1780,3020,3,1,3,0,1,0,58.94
屏東縣,屏東市,大武里,0,1,4213,21,4234,7091,3,1,3,0,1,0,59.709490904
屏東縣,屏東市,凌雲里,0,1,856,4,860,1316,3,1,3,0,1,0,65.3495440729
屏東縣,屏東市,永順里、永昌里,0,1,769,3,772,1230,3,1,3,0,1,0,62.7642276423
屏東縣,屏東市,鵬程里,0,1,897,5,902,1382,3,1,3,0,1,0,65.27
屏東縣,屏東市,安鎮里,0,1,1255,8,1263,1976,3,1,3,0,1,0,63.92
屏東縣,屏東市,永光里,0,1,731,2,733,1134,3,1,3,0,1,0,64.64
屏東縣,屏東市,長安里,0,1,1194,11,1205,1939,3,1,3,0,1,0,62.15
屏東縣,屏東市,前進里,0,1,1758,12,1770,2780,3,1,3,0,1,0,63.67
屏東縣,屏東市,大洲里,0,1,733,3,736,1119,3,1,3,0,1,0,65.77
屏東縣,屏東市,新興里,0,1,1428,8,1436,2223,3,1,3,0,1,0,64.5973909132
屏東縣,屏東市,公館里,0,1,1033,11,1044,1465,3,1,3,0,1,0,71.26
屏東縣,屏東市,新生里,0,1,2890,22,2912,4722,3,1,3,0,1,0,61.67
屏東縣,屏東市,頂宅里,0,1,328,1,329,526,3,1,3,0,1,0,62.55
屏東縣,屏東市,頂柳里,0,1,741,1,742,1038,3,1,3,0,1,0,71.48
屏東縣,屏東市,大湖里,0,1,1030,12,1042,1559,3,1,3,0,1,0,66.84
屏東縣,屏東市,龍華里,0,1,1492,12,1504,2388,3,1,3,0,1,0,62.98
屏東縣,屏東市,玉成里,0,1,914,5,919,1359,3,1,3,0,1,0,67.62
屏東縣,屏東市,建國里、擇仁里,0,1,996,6,1002,1716,3,1,3,0,1,0,58.39
屏東縣,屏東市,萬年里,0,1,494,3,497,771,3,1,3,0,1,0,64.46
屏東縣,屏東市,厚生里,0,1,1846,4,1850,3020,3,1,3,0,1,0,61.26
屏東縣,屏東市,義勇里、一心里,0,1,1055,8,1063,1778,3,1,3,0,1,0,59.79
屏東縣,屏東市,光華里,0,1,448,5,453,740,3,1,3,0,1,0,61.2162162162
屏東縣,屏東市,永安里,0,1,3895,25,3920,6655,3,1,3,0,1,0,58.9030803907
屏東縣,屏東市,崇蘭里,0,1,4742,30,4772,7860,3,1,3,0,1,0,60.71
屏東縣,屏東市,潭墘里,0,1,4397,21,4418,7856,3,1,3,0,1,0,56.24
屏東縣,屏東市,永城里,0,1,1352,8,1360,2297,3,1,3,0,1,0,59.21
屏東縣,屏東市,空翔里,0,1,994,4,998,1548,3,1,3,0,1,0,64.47
屏東縣,屏東市,廣興里,0,1,1282,6,1288,1982,3,1,3,0,1,0,64.98
屏東縣,屏東市,勝利里,0,1,2599,13,2612,4663,3,1,3,0,1,0,56.02
屏東縣,屏東市,斯文里,0,1,1314,6,1320,2066,3,1,3,0,1,0,63.89
屏東縣,屏東市,華山里,0,1,2932,13,2945,4666,3,1,3,0,1,0,63.1161594514
屏東縣,屏東市,溝美里,0,1,1701,7,1708,2717,3,1,3,0,1,0,62.86
屏東縣,屏東市,三山里,0,1,861,3,864,1258,3,1,3,0,1,0,68.68
屏東縣,屏東市,海豐里,0,1,581,4,585,851,3,1,3,0,1,0,68.74
屏東縣,屏東市,仁義里,0,1,657,4,661,1000,3,1,3,0,1,0,66.10
屏東縣,屏東市,北興里,0,1,3266,17,3283,5523,3,1,3,0,1,0,59.44
屏東縣,屏東市,北勢里,0,1,1520,8,1528,2364,3,1,3,0,1,0,64.6362098139
屏東縣,屏東市,中正里,0,1,2049,6,2055,3478,3,1,3,0,1,0,59.09
屏東縣,屏東市,興樂里,0,1,574,6,580,936,3,1,3,0,1,0,61.97
屏東縣,屏東市,明正里、太平里,0,1,1093,5,1098,1750,3,1,3,0,1,0,62.74
屏東縣,屏東市,信和里,0,1,953,7,960,1470,3,1,3,0,1,0,65.31
屏東縣,屏東市,和興里,0,1,616,1,617,933,3,1,3,0,1,0,66.13
屏東縣,屏東市,仁愛里,0,1,1362,10,1372,2286,3,1,3,0,1,0,60.0174978128
屏東縣,潮州鎮,潮州里,0,1,393,4,397,587,3,1,3,0,1,0,67.6320272572
屏東縣,潮州鎮,光華里,0,1,2283,10,2293,4020,3,1,3,0,1,0,57.04
屏東縣,潮州鎮,同榮里,0,1,497,1,498,709,3,1,3,0,1,0,70.24
屏東縣,潮州鎮,新生里,0,1,723,2,725,1137,3,1,3,0,1,0,63.76
屏東縣,潮州鎮,新榮里,0,1,863,6,869,1431,3,1,3,0,1,0,60.73
屏東縣,潮州鎮,彭城里,0,1,540,1,541,813,3,1,3,0,1,0,66.54
屏東縣,潮州鎮,三星里,0,1,2568,10,2578,4276,3,1,3,0,1,0,60.29
屏東縣,潮州鎮,三共里,0,1,3302,16,3318,5447,3,1,3,0,1,0,60.91
屏東縣,潮州鎮,三和里,0,1,1085,8,1093,1832,3,1,3,0,1,0,59.66
屏東縣,潮州鎮,五魁里,0,1,712,4,716,1197,3,1,3,0,1,0,59.82
屏東縣,潮州鎮,蓬萊里,0,1,1073,6,1079,1821,3,1,3,0,1,0,59.2531576057
屏東縣,潮州鎮,八爺里,0,1,1223,7,1230,2058,3,1,3,0,1,0,59.7667638484
屏東縣,潮州鎮,永春里,0,1,3024,21,3045,5200,3,1,3,0,1,0,58.5576923077
屏東縣,潮州鎮,富春里,0,1,812,3,815,1381,3,1,3,0,1,0,59.0152063722
屏東縣,潮州鎮,光春里,0,1,765,7,772,1300,3,1,3,0,1,0,59.38
屏東縣,潮州鎮,興美里,0,1,508,5,513,864,3,1,3,0,1,0,59.38
屏東縣,潮州鎮,檨子里,0,1,327,4,331,580,3,1,3,0,1,0,57.07
屏東縣,潮州鎮,九塊里,0,1,882,3,885,1586,3,1,3,0,1,0,55.80
屏東縣,潮州鎮,泗林里,0,1,1018,7,1025,1523,3,1,3,0,1,0,67.30
屏東縣,潮州鎮,四春里,0,1,1228,10,1238,1895,3,1,3,0,1,0,65.33
屏東縣,潮州鎮,崙東里,0,1,941,11,952,1584,3,1,3,0,1,0,60.101010101
屏東縣,東港鎮,新勝里,0,1,1403,10,1413,2294,3,1,3,0,1,0,61.5954664342
屏東縣,東港鎮,頂新里,0,1,344,0,344,564,3,1,3,0,1,0,60.99
屏東縣,東港鎮,頂中里,0,1,301,0,301,454,3,1,3,0,1,0,66.30
屏東縣,東港鎮,東和里,0,1,461,6,467,760,3,1,3,0,1,0,61.45
屏東縣,東港鎮,興台里,0,1,324,2,326,533,3,1,3,0,1,0,61.16
屏東縣,東港鎮,興東里,0,1,3511,29,3540,6073,3,1,3,0,1,0,58.29
屏東縣,東港鎮,興農里,0,1,513,0,513,731,3,1,3,0,1,0,70.18
屏東縣,東港鎮,中興里,0,1,462,5,467,814,3,1,3,0,1,0,57.37
屏東縣,東港鎮,朝安里,0,1,1087,6,1093,1879,3,1,3,0,1,0,58.17
屏東縣,東港鎮,八德里,0,1,515,0,515,898,3,1,3,0,1,0,57.35
屏東縣,東港鎮,東隆里,0,1,856,9,865,1340,3,1,3,0,1,0,64.55
屏東縣,東港鎮,豐漁里,0,1,412,0,412,724,3,1,3,0,1,0,56.91
屏東縣,東港鎮,盛漁里,0,1,698,2,700,1336,3,1,3,0,1,0,52.40
屏東縣,東港鎮,興漁里,0,1,1044,7,1051,1932,3,1,3,0,1,0,54.40
屏東縣,東港鎮,鎮海里,0,1,1446,4,1450,2638,3,1,3,0,1,0,54.97
屏東縣,東港鎮,嘉蓮里,0,1,903,4,907,1598,3,1,3,0,1,0,56.76
屏東縣,東港鎮,南平里,0,1,1120,6,1126,1786,3,1,3,0,1,0,63.05
屏東縣,東港鎮,船頭里,0,1,2127,5,2132,4003,3,1,3,0,1,0,53.26
屏東縣,東港鎮,下部里,0,1,1145,6,1151,1825,3,1,3,0,1,0,63.07
屏東縣,東港鎮,大潭里,0,1,1005,7,1012,1608,3,1,3,0,1,0,62.94
屏東縣,東港鎮,興和里,0,1,616,5,621,911,3,1,3,0,1,0,68.1668496158
屏東縣,東港鎮,共和里,0,1,461,2,463,736,3,1,3,0,1,0,62.9076086957
屏東縣,東港鎮,大鵬里,0,1,189,0,189,304,3,1,3,0,1,0,62.17
屏東縣,恆春鎮,城南里,0,1,587,5,592,976,3,1,3,0,1,0,60.66
屏東縣,恆春鎮,城北里,0,1,1127,13,1140,1977,3,1,3,0,1,0,57.66
屏東縣,恆春鎮,城西里,0,1,622,3,625,1087,3,1,3,0,1,0,57.50
屏東縣,恆春鎮,山腳里,0,1,1832,18,1850,3459,3,1,3,0,1,0,53.4836657994
屏東縣,恆春鎮,網紗里,0,1,1400,13,1413,2637,3,1,3,0,1,0,53.58
屏東縣,恆春鎮,仁壽里,0,1,408,8,416,770,3,1,3,0,1,0,54.03
屏東縣,恆春鎮,茄湖里,0,1,271,6,277,476,3,1,3,0,1,0,58.19
屏東縣,恆春鎮,頭溝里,0,1,245,3,248,466,3,1,3,0,1,0,53.22
屏東縣,恆春鎮,四溝里,0,1,497,3,500,916,3,1,3,0,1,0,54.59
屏東縣,恆春鎮,德和里,0,1,440,6,446,727,3,1,3,0,1,0,61.35
屏東縣,恆春鎮,龍水里,0,1,568,5,573,982,3,1,3,0,1,0,58.350305499
屏東縣,恆春鎮,山海里,0,1,836,4,840,1509,3,1,3,0,1,0,55.67
屏東縣,恆春鎮,大光里,0,1,1018,7,1025,1863,3,1,3,0,1,0,55.02
屏東縣,恆春鎮,水泉里,0,1,739,5,744,1354,3,1,3,0,1,0,54.95
屏東縣,恆春鎮,南灣里,0,1,769,6,775,1367,3,1,3,0,1,0,56.69
屏東縣,恆春鎮,墾丁里,0,1,777,6,783,1218,3,1,3,0,1,0,64.29
屏東縣,恆春鎮,鵝鑾里,0,1,598,7,605,1023,3,1,3,0,1,0,59.14
屏東縣,萬丹鄉,香社村,0,1,1014,4,1018,1434,3,1,3,0,1,0,70.99
屏東縣,萬丹鄉,新庄村,0,1,1344,11,1355,1841,3,1,3,0,1,0,73.60
屏東縣,萬丹鄉,新鐘村,0,1,1305,10,1315,1857,3,1,3,0,1,0,70.81
屏東縣,萬丹鄉,水仙村,0,1,388,1,389,527,3,1,3,0,1,0,73.81
屏東縣,萬丹鄉,興全村,0,1,870,10,880,1123,3,1,3,0,1,0,78.36
屏東縣,萬丹鄉,興安村,0,1,565,2,567,816,3,1,3,0,1,0,69.49
屏東縣,萬丹鄉,甘棠村,0,1,270,4,274,364,3,1,3,0,1,0,75.27
屏東縣,萬丹鄉,萬惠村,0,1,548,2,550,778,3,1,3,0,1,0,70.69
屏東縣,萬丹鄉,萬全村,0,1,2262,18,2280,3302,3,1,3,0,1,0,69.049061175
屏東縣,萬丹鄉,萬後村,0,1,365,0,365,500,3,1,3,0,1,0,73
屏東縣,萬丹鄉,萬安村,0,1,386,3,389,548,3,1,3,0,1,0,70.99
屏東縣,萬丹鄉,萬生村,0,1,903,8,911,1265,3,1,3,0,1,0,72.02
屏東縣,萬丹鄉,寶厝村,0,1,1376,17,1393,2065,3,1,3,0,1,0,67.4576271186
屏東縣,萬丹鄉,四維村,0,1,1156,10,1166,1735,3,1,3,0,1,0,67.20
屏東縣,萬丹鄉,竹林村,0,1,966,6,972,1506,3,1,3,0,1,0,64.54
屏東縣,萬丹鄉,水泉村,0,1,972,3,975,1400,3,1,3,0,1,0,69.64
屏東縣,萬丹鄉,田厝村,0,1,628,2,630,895,3,1,3,0,1,0,70.39
屏東縣,萬丹鄉,崙頂村,0,1,1149,6,1155,1685,3,1,3,0,1,0,68.55
屏東縣,萬丹鄉,廈北村,0,1,1135,9,1144,1604,3,1,3,0,1,0,71.32
屏東縣,萬丹鄉,廈南村,0,1,978,6,984,1397,3,1,3,0,1,0,70.44
屏東縣,萬丹鄉,後村村,0,1,783,3,786,995,3,1,3,0,1,0,78.99
屏東縣,萬丹鄉,灣內村,0,1,909,5,914,1267,3,1,3,0,1,0,72.14
屏東縣,萬丹鄉,上村村,0,1,526,3,529,678,3,1,3,0,1,0,78.0235988201
屏東縣,萬丹鄉,加興村,0,1,816,8,824,1107,3,1,3,0,1,0,74.4354110208
屏東縣,萬丹鄉,社口村,0,1,946,4,950,1233,3,1,3,0,1,0,77.05
屏東縣,萬丹鄉,磚寮村,0,1,693,7,700,919,3,1,3,0,1,0,76.17
屏東縣,萬丹鄉,社皮村,0,1,1313,4,1317,1805,3,1,3,0,1,0,72.96
屏東縣,萬丹鄉,社中村,0,1,1015,6,1021,1493,3,1,3,0,1,0,68.39
屏東縣,萬丹鄉,社上村,0,1,944,6,950,1452,3,1,3,0,1,0,65.43
屏東縣,萬丹鄉,廣安村,0,1,1358,7,1365,1994,3,1,3,0,1,0,68.46
屏東縣,長治鄉,進興村,0,1,1409,8,1417,2263,3,1,3,0,1,0,62.62
屏東縣,長治鄉,新潭村,0,1,1746,10,1756,2819,3,1,3,0,1,0,62.29
屏東縣,長治鄉,潭頭村,0,1,1058,6,1064,1524,3,1,3,0,1,0,69.82
屏東縣,長治鄉,香楊村,0,1,1193,3,1196,1907,3,1,3,0,1,0,62.72
屏東縣,長治鄉,長興村,0,1,682,3,685,968,3,1,3,0,1,0,70.76
屏東縣,長治鄉,崙上村,0,1,1014,7,1021,1447,3,1,3,0,1,0,70.56
屏東縣,長治鄉,德榮村,0,1,713,9,722,1042,3,1,3,0,1,0,69.29
屏東縣,長治鄉,德和村,0,1,526,2,528,777,3,1,3,0,1,0,67.95
屏東縣,長治鄉,復興村,0,1,941,3,944,1445,3,1,3,0,1,0,65.33
屏東縣,長治鄉,德成村,0,1,635,4,639,880,3,1,3,0,1,0,72.61
屏東縣,長治鄉,德協村,0,1,732,6,738,1124,3,1,3,0,1,0,65.66
屏東縣,長治鄉,繁榮村,0,1,783,8,791,1321,3,1,3,0,1,0,59.88
屏東縣,長治鄉,繁昌村,0,1,1024,3,1027,1707,3,1,3,0,1,0,60.16
屏東縣,長治鄉,繁隆村,0,1,729,4,733,1079,3,1,3,0,1,0,67.93
屏東縣,長治鄉,繁華村,0,1,1371,11,1382,2232,3,1,3,0,1,0,61.917562724
屏東縣,長治鄉,榮華村,0,1,318,2,320,498,3,1,3,0,1,0,64.2570281124
屏東縣,麟洛鄉,新田村,0,1,1242,10,1252,1809,3,1,3,0,1,0,69.21
屏東縣,麟洛鄉,麟頂村,0,1,568,1,569,827,3,1,3,0,1,0,68.80
屏東縣,麟洛鄉,麟蹄村,0,1,1079,7,1086,1572,3,1,3,0,1,0,69.08
屏東縣,麟洛鄉,麟趾村,0,1,1475,4,1479,2283,3,1,3,0,1,0,64.7831800263
屏東縣,麟洛鄉,田中村,0,1,765,9,774,1112,3,1,3,0,1,0,69.60
屏東縣,麟洛鄉,田心村,0,1,574,2,576,843,3,1,3,0,1,0,68.33
屏東縣,麟洛鄉,田道村,0,1,474,2,476,684,3,1,3,0,1,0,69.59
屏東縣,九如鄉,九清村,0,1,1089,7,1096,1553,3,1,3,0,1,0,70.57
屏東縣,九如鄉,九塊村,0,1,885,1,886,1278,3,1,3,0,1,0,69.33
屏東縣,九如鄉,九明村,0,1,964,6,970,1419,3,1,3,0,1,0,68.36
屏東縣,九如鄉,大坵村,0,1,691,5,696,1037,3,1,3,0,1,0,67.1166827387
屏東縣,九如鄉,玉水村,0,1,878,7,885,1235,3,1,3,0,1,0,71.6599190283
屏東縣,九如鄉,玉泉村,0,1,958,2,960,1452,3,1,3,0,1,0,66.1157024793
屏東縣,九如鄉,東寧村,0,1,2386,14,2400,3629,3,1,3,0,1,0,66.1339211904
屏東縣,九如鄉,三塊村,0,1,959,3,962,1422,3,1,3,0,1,0,67.6511954993
屏東縣,九如鄉,耆老村,0,1,931,8,939,1252,3,1,3,0,1,0,75
屏東縣,九如鄉,後庄村,0,1,1262,8,1270,1692,3,1,3,0,1,0,75.0591016548
屏東縣,九如鄉,洽興村,0,1,955,5,960,1317,3,1,3,0,1,0,72.8929384966
屏東縣,里港鄉,玉田村,0,1,1376,9,1385,2206,3,1,3,0,1,0,62.783318223
屏東縣,里港鄉,塔樓村,0,1,947,6,953,1394,3,1,3,0,1,0,68.3644189383
屏東縣,里港鄉,潮厝村,0,1,983,7,990,1384,3,1,3,0,1,0,71.5317919075
屏東縣,里港鄉,大平村,0,1,800,7,807,1125,3,1,3,0,1,0,71.7333333333
屏東縣,里港鄉,永春村,0,1,517,5,522,790,3,1,3,0,1,0,66.0759493671
屏東縣,里港鄉,春林村,0,1,744,3,747,1198,3,1,3,0,1,0,62.3539232053
屏東縣,里港鄉,過江村,0,1,1079,12,1091,1729,3,1,3,0,1,0,63.1000578369
屏東縣,里港鄉,鐵店村,0,1,863,2,865,1214,3,1,3,0,1,0,71.2520593081
屏東縣,里港鄉,茄苳村,0,1,1138,5,1143,1575,3,1,3,0,1,0,72.5714285714
屏東縣,里港鄉,載興村,0,1,1630,6,1636,2317,3,1,3,0,1,0,70.608545533
屏東縣,里港鄉,土庫村,0,1,1355,21,1376,1955,3,1,3,0,1,0,70.3836317136
屏東縣,里港鄉,三部村,0,1,1167,12,1179,1741,3,1,3,0,1,0,67.7197013211
屏東縣,里港鄉,中和村,0,1,530,4,534,823,3,1,3,0,1,0,64.8845686513
屏東縣,里港鄉,瀰力村,0,1,310,2,312,453,3,1,3,0,1,0,68.8741721854
屏東縣,鹽埔鄉,鹽北村,0,1,1187,3,1190,1758,3,1,3,0,1,0,67.6905574516
屏東縣,鹽埔鄉,鹽中村,0,1,1471,13,1484,2284,3,1,3,0,1,0,64.9737302977
屏東縣,鹽埔鄉,鹽南村,0,1,1043,7,1050,1628,3,1,3,0,1,0,64.4963144963
屏東縣,鹽埔鄉,仕絨村,0,1,652,5,657,908,3,1,3,0,1,0,72.3568281938
屏東縣,鹽埔鄉,高朗村,0,1,1745,18,1763,2699,3,1,3,0,1,0,65.32048907
屏東縣,鹽埔鄉,振興村,0,1,1126,13,1139,1851,3,1,3,0,1,0,61.5343057807
屏東縣,鹽埔鄉,久愛村,0,1,549,5,554,864,3,1,3,0,1,0,64.1203703704
屏東縣,鹽埔鄉,新圍村,0,1,1757,16,1773,2907,3,1,3,0,1,0,60.9907120743
屏東縣,鹽埔鄉,新二村,0,1,1704,7,1711,2964,3,1,3,0,1,0,57.7260458839
屏東縣,鹽埔鄉,彭厝村,0,1,650,4,654,971,3,1,3,0,1,0,67.3532440783
屏東縣,鹽埔鄉,洛陽村,0,1,913,9,922,1483,3,1,3,0,1,0,62.1712744437
屏東縣,鹽埔鄉,永隆村,0,1,376,7,383,556,3,1,3,0,1,0,68.8848920863
屏東縣,高樹鄉,高樹村,0,1,1307,8,1315,2152,3,1,3,0,1,0,61.1059479554
屏東縣,高樹鄉,長榮村,0,1,896,3,899,1360,3,1,3,0,1,0,66.1029411765
屏東縣,高樹鄉,東興村,0,1,551,5,556,819,3,1,3,0,1,0,67.8876678877
屏東縣,高樹鄉,東振村,0,1,400,2,402,612,3,1,3,0,1,0,65.6862745098
屏東縣,高樹鄉,源泉村,0,1,657,3,660,1019,3,1,3,0,1,0,64.7693817468
屏東縣,高樹鄉,建興村,0,1,716,5,721,1156,3,1,3,0,1,0,62.3702422145
屏東縣,高樹鄉,大埔村,0,1,405,4,409,673,3,1,3,0,1,0,60.7726597325
屏東縣,高樹鄉,菜寮村,0,1,506,6,512,806,3,1,3,0,1,0,63.523573201
屏東縣,高樹鄉,司馬村,0,1,454,1,455,712,3,1,3,0,1,0,63.904494382
屏東縣,高樹鄉,舊寮村,0,1,774,1,775,1313,3,1,3,0,1,0,59.0251332826
屏東縣,高樹鄉,新豐村,0,1,876,4,880,1547,3,1,3,0,1,0,56.8842921784
屏東縣,高樹鄉,泰山村,0,1,1167,14,1181,1948,3,1,3,0,1,0,60.6262833676
屏東縣,高樹鄉,南華村,0,1,786,4,790,1248,3,1,3,0,1,0,63.3012820513
屏東縣,高樹鄉,廣福村,0,1,590,1,591,939,3,1,3,0,1,0,62.9392971246
屏東縣,高樹鄉,廣興村,0,1,695,5,700,1047,3,1,3,0,1,0,66.8576886342
屏東縣,高樹鄉,舊庄村,0,1,687,6,693,1027,3,1,3,0,1,0,67.4780915287
屏東縣,高樹鄉,田子村,0,1,726,5,731,1104,3,1,3,0,1,0,66.2137681159
屏東縣,高樹鄉,鹽樹村,0,1,875,9,884,1330,3,1,3,0,1,0,66.4661654135
屏東縣,高樹鄉,新南村,0,1,926,2,928,1471,3,1,3,0,1,0,63.086335826
屏東縣,萬巒鄉,萬巒村,0,1,828,3,831,1251,3,1,3,0,1,0,66.4268585132
屏東縣,萬巒鄉,萬全村,0,1,539,1,540,783,3,1,3,0,1,0,68.9655172414
屏東縣,萬巒鄉,萬和村,0,1,924,6,930,1440,3,1,3,0,1,0,64.5833333333
屏東縣,萬巒鄉,鹿寮村,0,1,595,5,600,903,3,1,3,0,1,0,66.4451827243
屏東縣,萬巒鄉,硫黃村,0,1,347,2,349,523,3,1,3,0,1,0,66.7304015296
屏東縣,萬巒鄉,泗溝村,0,1,809,10,819,1232,3,1,3,0,1,0,66.4772727273
屏東縣,萬巒鄉,五溝村,0,1,833,9,842,1142,3,1,3,0,1,0,73.7302977233
屏東縣,萬巒鄉,成德村,0,1,898,4,902,1334,3,1,3,0,1,0,67.616191904
屏東縣,萬巒鄉,赤山村,0,1,938,15,953,1651,3,1,3,0,1,0,57.7225923683
屏東縣,萬巒鄉,萬金村,0,1,1182,17,1199,1905,3,1,3,0,1,0,62.9396325459
屏東縣,萬巒鄉,佳佐村,0,1,1020,3,1023,1566,3,1,3,0,1,0,65.3256704981
屏東縣,萬巒鄉,佳和村,0,1,1065,9,1074,1476,3,1,3,0,1,0,72.7642276423
屏東縣,萬巒鄉,新厝村,0,1,669,8,677,1063,3,1,3,0,1,0,63.6876763876
屏東縣,萬巒鄉,新置村,0,1,715,4,719,1170,3,1,3,0,1,0,61.452991453
屏東縣,內埔鄉,內埔村,0,1,2028,14,2042,3268,3,1,3,0,1,0,62.4847001224
屏東縣,內埔鄉,內田村,0,1,1648,9,1657,2743,3,1,3,0,1,0,60.4083120671
屏東縣,內埔鄉,興南村,0,1,916,6,922,1314,3,1,3,0,1,0,70.1674277017
屏東縣,內埔鄉,義亭村,0,1,394,3,397,592,3,1,3,0,1,0,67.0608108108
屏東縣,內埔鄉,美和村,0,1,1331,8,1339,2111,3,1,3,0,1,0,63.4296541923
屏東縣,內埔鄉,和興村,0,1,1255,4,1259,1994,3,1,3,0,1,0,63.1394182548
屏東縣,內埔鄉,東寧村,0,1,2572,15,2587,4044,3,1,3,0,1,0,63.9713155292
屏東縣,內埔鄉,豐田村,0,1,1480,11,1491,2458,3,1,3,0,1,0,60.6590724166
屏東縣,內埔鄉,振豐村,0,1,1117,7,1124,1621,3,1,3,0,1,0,69.3399136336
屏東縣,內埔鄉,富田村,0,1,1277,8,1285,1905,3,1,3,0,1,0,67.4540682415
屏東縣,內埔鄉,竹圍村,0,1,928,7,935,1566,3,1,3,0,1,0,59.7062579821
屏東縣,內埔鄉,東勢村,0,1,1826,7,1833,2868,3,1,3,0,1,0,63.9121338912
屏東縣,內埔鄉,東片村,0,1,603,2,605,902,3,1,3,0,1,0,67.0731707317
屏東縣,內埔鄉,上樹村,0,1,746,1,747,1099,3,1,3,0,1,0,67.9708826206
屏東縣,內埔鄉,老埤村,0,1,1345,8,1353,2374,3,1,3,0,1,0,56.9924178602
屏東縣,內埔鄉,中林村,0,1,887,14,901,1465,3,1,3,0,1,0,61.5017064846
屏東縣,內埔鄉,龍泉村,0,1,1450,12,1462,2473,3,1,3,0,1,0,59.1184795795
屏東縣,內埔鄉,龍潭村,0,1,1418,13,1431,2474,3,1,3,0,1,0,57.8415521423
屏東縣,內埔鄉,建興村,0,1,830,12,842,1544,3,1,3,0,1,0,54.5336787565
屏東縣,內埔鄉,大新村,0,1,1081,9,1090,1756,3,1,3,0,1,0,62.0728929385
屏東縣,內埔鄉,黎明村,0,1,1259,14,1273,2242,3,1,3,0,1,0,56.7796610169
屏東縣,內埔鄉,隘寮村,0,1,587,4,591,1143,3,1,3,0,1,0,51.7060367454
屏東縣,內埔鄉,水門村,0,1,452,2,454,747,3,1,3,0,1,0,60.7764390897
屏東縣,竹田鄉,竹田村,0,1,1028,4,1032,1463,3,1,3,0,1,0,70.5399863295
屏東縣,竹田鄉,竹南村,0,1,569,3,572,850,3,1,3,0,1,0,67.2941176471
屏東縣,竹田鄉,糶糴村,0,1,503,2,505,674,3,1,3,0,1,0,74.9258160237
屏東縣,竹田鄉,履豐村,0,1,438,2,440,613,3,1,3,0,1,0,71.7781402936
屏東縣,竹田鄉,頭崙村,0,1,905,4,909,1328,3,1,3,0,1,0,68.4487951807
屏東縣,竹田鄉,二崙村,0,1,689,5,694,959,3,1,3,0,1,0,72.3670490094
屏東縣,竹田鄉,美崙村,0,1,446,1,447,605,3,1,3,0,1,0,73.8842975207
屏東縣,竹田鄉,南勢村,0,1,335,3,338,477,3,1,3,0,1,0,70.8595387841
屏東縣,竹田鄉,西勢村,0,1,1774,16,1790,2576,3,1,3,0,1,0,69.4875776398
屏東縣,竹田鄉,福田村,0,1,335,1,336,451,3,1,3,0,1,0,74.5011086475
屏東縣,竹田鄉,永豐村,0,1,431,0,431,614,3,1,3,0,1,0,70.1954397394
屏東縣,竹田鄉,六巷村,0,1,516,1,517,698,3,1,3,0,1,0,74.0687679083
屏東縣,竹田鄉,泗洲村,0,1,671,5,676,1088,3,1,3,0,1,0,62.1323529412
屏東縣,竹田鄉,大湖村,0,1,787,5,792,1150,3,1,3,0,1,0,68.8695652174
屏東縣,竹田鄉,鳳明村,0,1,707,6,713,1033,3,1,3,0,1,0,69.0222652469
屏東縣,新埤鄉,新埤村,0,1,1178,6,1184,1941,3,1,3,0,1,0,60.9994848016
屏東縣,新埤鄉,建功村,0,1,772,4,776,1183,3,1,3,0,1,0,65.595942519
屏東縣,新埤鄉,打鐵村,0,1,697,4,701,988,3,1,3,0,1,0,70.951417004
屏東縣,新埤鄉,南豐村,0,1,494,2,496,743,3,1,3,0,1,0,66.7563930013
屏東縣,新埤鄉,萬隆村,0,1,1035,4,1039,1680,3,1,3,0,1,0,61.8452380952
屏東縣,新埤鄉,餉潭村,0,1,740,8,748,1339,3,1,3,0,1,0,55.8625840179
屏東縣,新埤鄉,箕湖村,0,1,636,4,640,1084,3,1,3,0,1,0,59.0405904059
屏東縣,枋寮鄉,枋寮村,0,1,664,2,666,1219,3,1,3,0,1,0,54.6349466776
屏東縣,枋寮鄉,新龍村,0,1,500,6,506,856,3,1,3,0,1,0,59.1121495327
屏東縣,枋寮鄉,保生村,0,1,632,3,635,975,3,1,3,0,1,0,65.1282051282
屏東縣,枋寮鄉,中寮村,0,1,416,1,417,659,3,1,3,0,1,0,63.277693475
屏東縣,枋寮鄉,安樂村,0,1,1085,7,1092,1813,3,1,3,0,1,0,60.2316602317
屏東縣,枋寮鄉,隆山村,0,1,2053,14,2067,3753,3,1,3,0,1,0,55.0759392486
屏東縣,枋寮鄉,天時村,0,1,1264,3,1267,2060,3,1,3,0,1,0,61.5048543689
屏東縣,枋寮鄉,地利村,0,1,1065,7,1072,1642,3,1,3,0,1,0,65.2862362972
屏東縣,枋寮鄉,人和村,0,1,1312,8,1320,2172,3,1,3,0,1,0,60.773480663
屏東縣,枋寮鄉,內寮村,0,1,394,2,396,740,3,1,3,0,1,0,53.5135135135
屏東縣,枋寮鄉,新開村,0,1,503,6,509,962,3,1,3,0,1,0,52.9106029106
屏東縣,枋寮鄉,東海村,0,1,1761,10,1771,2793,3,1,3,0,1,0,63.4085213033
屏東縣,枋寮鄉,大庄村,0,1,425,0,425,632,3,1,3,0,1,0,67.246835443
屏東縣,枋寮鄉,太源村,0,1,522,6,528,949,3,1,3,0,1,0,55.6375131718
屏東縣,枋寮鄉,玉泉村,0,1,259,4,263,418,3,1,3,0,1,0,62.9186602871
屏東縣,新園鄉,瓦窯村,0,1,1180,2,1182,1632,3,1,3,0,1,0,72.4264705882
屏東縣,新園鄉,仙吉村,0,1,1548,5,1553,2382,3,1,3,0,1,0,65.1973131822
屏東縣,新園鄉,田洋村,0,1,1382,3,1385,2042,3,1,3,0,1,0,67.8256611166
屏東縣,新園鄉,港墘村,0,1,517,3,520,764,3,1,3,0,1,0,68.0628272251
屏東縣,新園鄉,內庄村,0,1,573,4,577,809,3,1,3,0,1,0,71.3226205192
屏東縣,新園鄉,新東村,0,1,1439,8,1447,2232,3,1,3,0,1,0,64.8297491039
屏東縣,新園鄉,新園村,0,1,1345,5,1350,2047,3,1,3,0,1,0,65.9501709819
屏東縣,新園鄉,港西村,0,1,1568,6,1574,2172,3,1,3,0,1,0,72.467771639
屏東縣,新園鄉,五房村,0,1,1898,10,1908,2911,3,1,3,0,1,0,65.5444864308
屏東縣,新園鄉,烏龍村,0,1,890,5,895,1265,3,1,3,0,1,0,70.7509881423
屏東縣,新園鄉,興龍村,0,1,1383,11,1394,2189,3,1,3,0,1,0,63.6820465966
屏東縣,新園鄉,中洲村,0,1,1088,8,1096,1695,3,1,3,0,1,0,64.6607669617
屏東縣,新園鄉,南龍村,0,1,895,9,904,1421,3,1,3,0,1,0,63.6171710063
屏東縣,新園鄉,鹽埔村,0,1,2387,9,2396,4115,3,1,3,0,1,0,58.2260024301
屏東縣,新園鄉,共和村,0,1,1300,13,1313,2240,3,1,3,0,1,0,58.6160714286
屏東縣,崁頂鄉,崁頂村,0,1,1292,5,1297,2062,3,1,3,0,1,0,62.9000969932
屏東縣,崁頂鄉,園寮村,0,1,980,4,984,1695,3,1,3,0,1,0,58.0530973451
屏東縣,崁頂鄉,力社村,0,1,778,10,788,1157,3,1,3,0,1,0,68.1071737252
屏東縣,崁頂鄉,圍內村,0,1,783,4,787,1161,3,1,3,0,1,0,67.7863910422
屏東縣,崁頂鄉,洲子村,0,1,636,5,641,931,3,1,3,0,1,0,68.850698174
屏東縣,崁頂鄉,北勢村,0,1,969,11,980,1488,3,1,3,0,1,0,65.8602150538
屏東縣,崁頂鄉,越溪村,0,1,534,2,536,818,3,1,3,0,1,0,65.5256723716
屏東縣,崁頂鄉,港東村,0,1,1079,9,1088,1786,3,1,3,0,1,0,60.9182530795
屏東縣,林邊鄉,林邊村,0,1,885,2,887,1473,3,1,3,0,1,0,60.2172437203
屏東縣,林邊鄉,光林村,0,1,944,7,951,1628,3,1,3,0,1,0,58.4152334152
屏東縣,林邊鄉,中林村,0,1,506,4,510,822,3,1,3,0,1,0,62.0437956204
屏東縣,林邊鄉,仁和村,0,1,972,2,974,1558,3,1,3,0,1,0,62.5160462131
屏東縣,林邊鄉,永樂村,0,1,2033,11,2044,3259,3,1,3,0,1,0,62.7186253452
屏東縣,林邊鄉,田厝村,0,1,587,4,591,911,3,1,3,0,1,0,64.8737650933
屏東縣,林邊鄉,崎峰村,0,1,658,6,664,1344,3,1,3,0,1,0,49.4047619048
屏東縣,林邊鄉,水利村,0,1,1029,10,1039,1895,3,1,3,0,1,0,54.8284960422
屏東縣,林邊鄉,竹林村,0,1,1724,12,1736,2802,3,1,3,0,1,0,61.9557458958
屏東縣,林邊鄉,鎮安村,0,1,749,5,754,1146,3,1,3,0,1,0,65.7940663176
屏東縣,南州鄉,溪洲村,0,1,1185,8,1193,1775,3,1,3,0,1,0,67.2112676056
屏東縣,南州鄉,溪南村,0,1,651,7,658,986,3,1,3,0,1,0,66.7342799189
屏東縣,南州鄉,仁里村,0,1,350,0,350,526,3,1,3,0,1,0,66.5399239544
屏東縣,南州鄉,溪北村,0,1,496,4,500,761,3,1,3,0,1,0,65.703022339
屏東縣,南州鄉,七塊村,0,1,656,5,661,1051,3,1,3,0,1,0,62.8924833492
屏東縣,南州鄉,萬華村,0,1,638,8,646,1001,3,1,3,0,1,0,64.5354645355
屏東縣,南州鄉,米崙村,0,1,641,2,643,1015,3,1,3,0,1,0,63.3497536946
屏東縣,南州鄉,壽元村,0,1,693,5,698,1149,3,1,3,0,1,0,60.7484769365
屏東縣,南州鄉,同安村,0,1,587,8,595,965,3,1,3,0,1,0,61.6580310881
屏東縣,南州鄉,南安村,0,1,381,1,382,586,3,1,3,0,1,0,65.1877133106
屏東縣,佳冬鄉,佳冬村,0,1,1020,5,1025,1492,3,1,3,0,1,0,68.6997319035
屏東縣,佳冬鄉,六根村,0,1,1044,14,1058,1622,3,1,3,0,1,0,65.2281134402
屏東縣,佳冬鄉,賴家村,0,1,614,1,615,922,3,1,3,0,1,0,66.7028199566
屏東縣,佳冬鄉,萬建村,0,1,1091,4,1095,1672,3,1,3,0,1,0,65.490430622
屏東縣,佳冬鄉,石光村,0,1,1210,3,1213,1958,3,1,3,0,1,0,61.9509703779
屏東縣,佳冬鄉,玉光村,0,1,1385,7,1392,2220,3,1,3,0,1,0,62.7027027027
屏東縣,佳冬鄉,昌隆村,0,1,818,7,825,1122,3,1,3,0,1,0,73.5294117647
屏東縣,佳冬鄉,豐隆村,0,1,583,5,588,830,3,1,3,0,1,0,70.843373494
屏東縣,佳冬鄉,大同村,0,1,820,3,823,1187,3,1,3,0,1,0,69.3344566133
屏東縣,佳冬鄉,羌園村,0,1,695,5,700,1038,3,1,3,0,1,0,67.4373795761
屏東縣,佳冬鄉,燄溫村,0,1,719,5,724,1131,3,1,3,0,1,0,64.0141467728
屏東縣,佳冬鄉,塭豐村,0,1,1400,3,1403,2290,3,1,3,0,1,0,61.2663755459
屏東縣,琉球鄉,本福村,0,1,1001,8,1009,1963,3,1,3,0,1,0,51.4009169638
屏東縣,琉球鄉,中福村,0,1,586,2,588,1101,3,1,3,0,1,0,53.4059945504
屏東縣,琉球鄉,漁福村,0,1,472,3,475,928,3,1,3,0,1,0,51.1853448276
屏東縣,琉球鄉,大福村,0,1,703,0,703,1521,3,1,3,0,1,0,46.2195923734
屏東縣,琉球鄉,南福村,0,1,525,6,531,1169,3,1,3,0,1,0,45.4234388366
屏東縣,琉球鄉,天福村,0,1,460,3,463,1048,3,1,3,0,1,0,44.179389313
屏東縣,琉球鄉,上福村,0,1,685,5,690,1496,3,1,3,0,1,0,46.1229946524
屏東縣,琉球鄉,杉福村,0,1,391,4,395,778,3,1,3,0,1,0,50.7712082262
屏東縣,車城鄉,福興村,0,1,896,7,903,1349,3,1,3,0,1,0,66.9384729429
屏東縣,車城鄉,福安村,0,1,425,3,428,589,3,1,3,0,1,0,72.6655348048
屏東縣,車城鄉,田中村,0,1,430,6,436,711,3,1,3,0,1,0,61.3220815752
屏東縣,車城鄉,海口村,0,1,468,6,474,763,3,1,3,0,1,0,62.123197903
屏東縣,車城鄉,統埔村,0,1,262,1,263,428,3,1,3,0,1,0,61.4485981308
屏東縣,車城鄉,溫泉村,0,1,547,11,558,965,3,1,3,0,1,0,57.8238341969
屏東縣,車城鄉,保力村,0,1,726,10,736,1313,3,1,3,0,1,0,56.0548362529
屏東縣,車城鄉,新街村,0,1,281,1,282,415,3,1,3,0,1,0,67.9518072289
屏東縣,車城鄉,埔墘村,0,1,265,1,266,455,3,1,3,0,1,0,58.4615384615
屏東縣,車城鄉,射寮村,0,1,312,3,315,513,3,1,3,0,1,0,61.4035087719
屏東縣,車城鄉,後灣村,0,1,288,3,291,477,3,1,3,0,1,0,61.0062893082
屏東縣,滿州鄉,滿州村,0,1,649,5,654,1246,3,1,3,0,1,0,52.4879614767
屏東縣,滿州鄉,永靖村,0,1,539,25,564,1073,3,1,3,0,1,0,52.5629077353
屏東縣,滿州鄉,港口村,0,1,570,20,590,1056,3,1,3,0,1,0,55.8712121212
屏東縣,滿州鄉,響林村,0,1,248,1,249,435,3,1,3,0,1,0,57.2413793103
屏東縣,滿州鄉,里德村,0,1,116,8,124,251,3,1,3,0,1,0,49.4023904382
屏東縣,滿州鄉,長樂村,0,1,294,4,298,612,3,1,3,0,1,0,48.6928104575
屏東縣,滿州鄉,九棚村,0,1,110,1,111,238,3,1,3,0,1,0,46.6386554622
屏東縣,滿州鄉,港仔村,0,1,164,7,171,306,3,1,3,0,1,0,55.8823529412
屏東縣,枋山鄉,加祿村,0,1,1153,8,1161,1769,3,1,3,0,1,0,65.6302996043
屏東縣,枋山鄉,枋山村,0,1,631,0,631,1026,3,1,3,0,1,0,61.5009746589
屏東縣,枋山鄉,楓港村,0,1,545,5,550,1040,3,1,3,0,1,0,52.8846153846
屏東縣,枋山鄉,善餘村,0,1,488,1,489,963,3,1,3,0,1,0,50.7788161994
屏東縣,三地門鄉,三地村,0,1,55,2,57,105,3,1,3,0,1,0,54.2857142857
屏東縣,三地門鄉,達來村,0,1,2,0,2,12,3,1,3,0,1,0,16.6666666667
屏東縣,三地門鄉,德文村,0,1,4,0,4,14,3,1,3,0,1,0,28.5714285714
屏東縣,三地門鄉,大社村,0,1,4,0,4,15,3,1,3,0,1,0,26.6666666667
屏東縣,三地門鄉,賽嘉村,0,1,15,1,16,46,3,1,3,0,1,0,34.7826086957
屏東縣,三地門鄉,口社村,0,1,23,0,23,39,3,1,3,0,1,0,58.9743589744
屏東縣,三地門鄉,馬兒村,0,1,5,0,5,12,3,1,3,0,1,0,41.6666666667
屏東縣,三地門鄉,安坡村,0,1,18,0,18,30,3,1,3,0,1,0,60
屏東縣,三地門鄉,青山村,0,1,32,2,34,68,3,1,3,0,1,0,50
屏東縣,三地門鄉,青葉村,0,1,18,1,19,42,3,1,3,0,1,0,45.2380952381
屏東縣,霧臺鄉,霧臺村,0,1,12,1,13,27,3,1,3,0,1,0,48.1481481481
屏東縣,霧臺鄉,吉露村,0,1,2,0,2,3,3,1,3,0,1,0,66.6666666667
屏東縣,霧臺鄉,阿禮村,0,1,2,0,2,4,3,1,3,0,1,0,50
屏東縣,霧臺鄉,大武村,0,1,3,0,3,17,3,1,3,0,1,0,17.6470588235
屏東縣,霧臺鄉,佳暮村,0,1,2,0,2,4,3,1,3,0,1,0,50
屏東縣,霧臺鄉,好茶村,0,1,2,0,2,5,3,1,3,0,1,0,40
屏東縣,瑪家鄉,瑪家村,0,1,8,0,8,15,3,1,3,0,1,0,53.3333333333
屏東縣,瑪家鄉,北葉村,0,1,41,1,42,68,3,1,3,0,1,0,61.7647058824
屏東縣,瑪家鄉,涼山村,0,1,30,0,30,56,3,1,3,0,1,0,53.5714285714
屏東縣,瑪家鄉,佳義村,0,1,25,0,25,49,3,1,3,0,1,0,51.0204081633
屏東縣,瑪家鄉,排灣村,0,1,6,0,6,15,3,1,3,0,1,0,40
屏東縣,瑪家鄉,三和村,0,1,54,1,55,109,3,1,3,0,1,0,50.4587155963
屏東縣,泰武鄉,佳平村,0,1,25,0,25,46,3,1,3,0,1,0,54.347826087
屏東縣,泰武鄉,武潭村,0,1,17,0,17,38,3,1,3,0,1,0,44.7368421053
屏東縣,泰武鄉,平和村,0,1,9,0,9,23,3,1,3,0,1,0,39.1304347826
屏東縣,泰武鄉,佳興村,0,1,7,0,7,10,3,1,3,0,1,0,70
屏東縣,泰武鄉,泰武村,0,1,1,0,1,9,3,1,3,0,1,0,11.1111111111
屏東縣,泰武鄉,萬安村,0,1,8,0,8,27,3,1,3,0,1,0,29.6296296296
屏東縣,來義鄉,來義村,0,1,7,0,7,20,3,1,3,0,1,0,35
屏東縣,來義鄉,義林村,0,1,13,0,13,21,3,1,3,0,1,0,61.9047619048
屏東縣,來義鄉,丹林村,0,1,21,0,21,47,3,1,3,0,1,0,44.6808510638
屏東縣,來義鄉,古樓村,0,1,21,1,22,58,3,1,3,0,1,0,37.9310344828
屏東縣,來義鄉,文樂村,0,1,16,0,16,33,3,1,3,0,1,0,48.4848484848
屏東縣,來義鄉,望嘉村,0,1,30,0,30,43,3,1,3,0,1,0,69.7674418605
屏東縣,來義鄉,南和村,0,1,22,1,23,44,3,1,3,0,1,0,52.2727272727
屏東縣,春日鄉,春日村,0,1,14,0,14,49,3,1,3,0,1,0,28.5714285714
屏東縣,春日鄉,古華村,0,1,16,0,16,43,3,1,3,0,1,0,37.2093023256
屏東縣,春日鄉,士文村,0,1,5,0,5,12,3,1,3,0,1,0,41.6666666667
屏東縣,春日鄉,歸崇村,0,1,61,1,62,110,3,1,3,0,1,0,56.3636363636
屏東縣,春日鄉,七佳村,0,1,49,0,49,92,3,1,3,0,1,0,53.2608695652
屏東縣,春日鄉,力里村,0,1,6,0,6,14,3,1,3,0,1,0,42.8571428571
屏東縣,獅子鄉,楓林村,0,1,28,0,28,57,3,1,3,0,1,0,49.1228070175
屏東縣,獅子鄉,丹路村,0,1,29,0,29,70,3,1,3,0,1,0,41.4285714286
屏東縣,獅子鄉,草埔村,0,1,13,0,13,35,3,1,3,0,1,0,37.1428571429
屏東縣,獅子鄉,內文村,0,1,11,0,11,25,3,1,3,0,1,0,44
屏東縣,獅子鄉,竹坑村,0,1,7,0,7,25,3,1,3,0,1,0,28
屏東縣,獅子鄉,獅子村,0,1,8,0,8,23,3,1,3,0,1,0,34.7826086957
屏東縣,獅子鄉,內獅村,0,1,16,0,16,34,3,1,3,0,1,0,47.0588235294
屏東縣,獅子鄉,南世村,0,1,7,0,7,20,3,1,3,0,1,0,35
屏東縣,牡丹鄉,石門村,0,1,82,0,82,143,3,1,3,0,1,0,57.3426573427
屏東縣,牡丹鄉,牡丹村,0,1,8,0,8,22,3,1,3,0,1,0,36.3636363636
屏東縣,牡丹鄉,東源村,0,1,11,0,11,19,3,1,3,0,1,0,57.8947368421
屏東縣,牡丹鄉,旭海村,0,1,47,0,47,97,3,1,3,0,1,0,48.4536082474
屏東縣,牡丹鄉,高士村,0,1,21,1,22,31,3,1,3,0,1,0,70.9677419355
屏東縣,牡丹鄉,四林村,0,1,11,0,11,23,3,1,3,0,1,0,47.8260869565
臺東縣,台東市,文化里,0,1,502,4,506,983,3,1,3,0,1,0,51.48
臺東縣,台東市,民族里,0,1,813,8,821,1429,3,1,3,0,1,0,57.45
臺東縣,台東市,自強里,0,1,1881,5,1886,3441,3,1,3,0,1,0,54.81
臺東縣,台東市,民生里,0,1,1476,10,1486,2833,3,1,3,0,1,0,52.45
臺東縣,台東市,寶桑里,0,1,361,3,364,739,3,1,3,0,1,0,49.26
臺東縣,台東市,民權里,0,1,571,2,573,1062,3,1,3,0,1,0,53.95
臺東縣,台東市,四維里,0,1,209,1,210,434,3,1,3,0,1,0,48.39
臺東縣,台東市,中華里,0,1,815,2,817,1588,3,1,3,0,1,0,51.45
臺東縣,台東市,仁愛里,0,1,429,2,431,719,3,1,3,0,1,0,59.94
臺東縣,台東市,強國里,0,1,320,4,324,569,3,1,3,0,1,0,56.94
臺東縣,台東市,大同里,0,1,367,7,374,743,3,1,3,0,1,0,50.34
臺東縣,台東市,成功里,0,1,427,3,430,821,3,1,3,0,1,0,52.38
臺東縣,台東市,建國里,0,1,653,2,655,1328,3,1,3,0,1,0,49.32
臺東縣,台東市,中正里,0,1,495,1,496,894,3,1,3,0,1,0,55.48
臺東縣,台東市,中山里,0,1,524,1,525,918,3,1,3,0,1,0,57.19
臺東縣,台東市,興國里,0,1,394,1,395,733,3,1,3,0,1,0,53.89
臺東縣,台東市,鐵花里,0,1,228,1,229,431,3,1,3,0,1,0,53.13
臺東縣,台東市,東海里,0,1,1592,5,1597,2887,3,1,3,0,1,0,55.32
臺東縣,台東市,復國里,0,1,348,4,352,681,3,1,3,0,1,0,51.69
臺東縣,台東市,復興里,0,1,229,3,232,440,3,1,3,0,1,0,52.73
臺東縣,台東市,新興里,0,1,591,1,592,1118,3,1,3,0,1,0,52.95
臺東縣,台東市,新生里,0,1,2424,14,2438,4724,3,1,3,0,1,0,51.61
臺東縣,台東市,中心里,0,1,1235,3,1238,2212,3,1,3,0,1,0,55.97
臺東縣,台東市,馬蘭里,0,1,1409,6,1415,2586,3,1,3,0,1,0,54.72
臺東縣,台東市,光明里,0,1,837,3,840,1616,3,1,3,0,1,0,51.98
臺東縣,台東市,豐年里,0,1,880,2,882,1707,3,1,3,0,1,0,51.67
臺東縣,台東市,豐樂里,0,1,504,1,505,946,3,1,3,0,1,0,53.38
臺東縣,台東市,永樂里,0,1,622,2,624,1181,3,1,3,0,1,0,52.84
臺東縣,台東市,康樂里,0,1,603,2,605,1114,3,1,3,0,1,0,54.31
臺東縣,台東市,豐榮里,0,1,2886,16,2902,5795,3,1,3,0,1,0,50.08
臺東縣,台東市,豐谷里,0,1,1519,10,1529,3125,3,1,3,0,1,0,48.93
臺東縣,台東市,豐里里,0,1,828,8,836,1609,3,1,3,0,1,0,51.96
臺東縣,台東市,豐原里,0,1,499,6,505,956,3,1,3,0,1,0,52.82
臺東縣,台東市,富岡里,0,1,596,5,601,1143,3,1,3,0,1,0,52.58
臺東縣,台東市,富豐里,0,1,221,5,226,480,3,1,3,0,1,0,47.08
臺東縣,台東市,南榮里,0,1,808,7,815,1442,3,1,3,0,1,0,56.52
臺東縣,台東市,岩灣里,0,1,507,4,511,1083,3,1,3,0,1,0,47.18
臺東縣,台東市,卑南里,0,1,1186,3,1189,2025,3,1,3,0,1,0,58.72
臺東縣,台東市,南王里,0,1,789,1,790,1470,3,1,3,0,1,0,53.74
臺東縣,台東市,豐田里,0,1,957,5,962,1696,3,1,3,0,1,0,56.72
臺東縣,台東市,新園里,0,1,467,2,469,943,3,1,3,0,1,0,49.73
臺東縣,台東市,建和里,0,1,393,1,394,785,3,1,3,0,1,0,50.19
臺東縣,台東市,建興里,0,1,498,0,498,862,3,1,3,0,1,0,57.77
臺東縣,台東市,建業里,0,1,435,0,435,804,3,1,3,0,1,0,54.10
臺東縣,台東市,知本里,0,1,431,4,435,872,3,1,3,0,1,0,49.89
臺東縣,台東市,建農里,0,1,497,7,504,1117,3,1,3,0,1,0,45.12
臺東縣,成功鎮,信義里,0,1,169,1,170,426,3,1,3,0,1,0,39.91
臺東縣,成功鎮,和平里,0,1,61,0,61,138,3,1,3,0,1,0,44.20
臺東縣,成功鎮,忠仁里,0,1,560,1,561,1125,3,1,3,0,1,0,49.87
臺東縣,成功鎮,忠智里,0,1,1283,4,1287,2388,3,1,3,0,1,0,53.89
臺東縣,成功鎮,三民里,0,1,536,3,539,1106,3,1,3,0,1,0,48.73
臺東縣,成功鎮,三仙里,0,1,236,0,236,561,3,1,3,0,1,0,42.07
臺東縣,成功鎮,忠孝里,0,1,199,1,200,478,3,1,3,0,1,0,41.84
臺東縣,成功鎮,博愛里,0,1,43,0,43,91,3,1,3,0,1,0,47.25
臺東縣,關山鎮,里壟里,0,1,834,7,841,1564,3,1,3,0,1,0,53.77
臺東縣,關山鎮,中福里,0,1,508,8,516,850,3,1,3,0,1,0,60.71
臺東縣,關山鎮,新福里,0,1,353,3,356,647,3,1,3,0,1,0,55.02
臺東縣,關山鎮,豐泉里,0,1,524,2,526,953,3,1,3,0,1,0,55.19
臺東縣,關山鎮,月眉里,0,1,346,2,348,654,3,1,3,0,1,0,53.21
臺東縣,關山鎮,德高里,0,1,644,7,651,1200,3,1,3,0,1,0,54.25
臺東縣,關山鎮,電光里,0,1,106,0,106,214,3,1,3,0,1,0,49.53
臺東縣,卑南鄉,賓朗村,0,1,911,5,916,1701,3,1,3,0,1,0,53.85
臺東縣,卑南鄉,美農村,0,1,505,1,506,974,3,1,3,0,1,0,51.95
臺東縣,卑南鄉,初鹿村,0,1,465,3,468,994,3,1,3,0,1,0,47.08
臺東縣,卑南鄉,明峰村,0,1,482,3,485,1040,3,1,3,0,1,0,46.63
臺東縣,卑南鄉,嘉豐村,0,1,100,1,101,227,3,1,3,0,1,0,44.49
臺東縣,卑南鄉,太平村,0,1,1393,9,1402,2636,3,1,3,0,1,0,53.19
臺東縣,卑南鄉,泰安村,0,1,311,5,316,649,3,1,3,0,1,0,48.69
臺東縣,卑南鄉,利嘉村,0,1,204,1,205,410,3,1,3,0,1,0,50.00
臺東縣,卑南鄉,東興村,0,1,103,1,104,218,3,1,3,0,1,0,47.71
臺東縣,卑南鄉,溫泉村,0,1,556,7,563,1047,3,1,3,0,1,0,53.77
臺東縣,卑南鄉,富山村,0,1,219,2,221,428,3,1,3,0,1,0,51.64
臺東縣,卑南鄉,富源村,0,1,216,1,217,351,3,1,3,0,1,0,61.82
臺東縣,卑南鄉,利吉村,0,1,126,1,127,254,3,1,3,0,1,0,50.00
臺東縣,鹿野鄉,鹿野村,0,1,360,1,361,725,3,1,3,0,1,0,49.79
臺東縣,鹿野鄉,龍田村,0,1,545,3,548,1056,3,1,3,0,1,0,51.89
臺東縣,鹿野鄉,永安村,0,1,451,3,454,1033,3,1,3,0,1,0,43.95
臺東縣,鹿野鄉,瑞隆村,0,1,368,3,371,754,3,1,3,0,1,0,49.20
臺東縣,鹿野鄉,瑞源村,0,1,312,1,313,593,3,1,3,0,1,0,52.78
臺東縣,鹿野鄉,瑞和村,0,1,174,0,174,341,3,1,3,0,1,0,51.03
臺東縣,鹿野鄉,瑞豐村,0,1,494,5,499,971,3,1,3,0,1,0,51.39
臺東縣,池上鄉,福原村,0,1,958,3,961,1839,3,1,3,0,1,0,52.26
臺東縣,池上鄉,福文村,0,1,548,3,551,1191,3,1,3,0,1,0,46.26
臺東縣,池上鄉,慶豐村,0,1,292,0,292,633,3,1,3,0,1,0,46.13
臺東縣,池上鄉,大坡村,0,1,35,1,36,104,3,1,3,0,1,0,34.62
臺東縣,池上鄉,大埔村,0,1,228,0,228,400,3,1,3,0,1,0,57.00
臺東縣,池上鄉,新興村,0,1,368,1,369,741,3,1,3,0,1,0,49.80
臺東縣,池上鄉,錦園村,0,1,192,1,193,392,3,1,3,0,1,0,49.23
臺東縣,池上鄉,萬安村,0,1,174,4,178,353,3,1,3,0,1,0,50.42
臺東縣,池上鄉,富興村,0,1,149,3,152,330,3,1,3,0,1,0,46.06
臺東縣,池上鄉,振興村,0,1,57,0,57,142,3,1,3,0,1,0,40.14
臺東縣,東河鄉,都蘭村,0,1,587,6,593,1208,3,1,3,0,1,0,49.09
臺東縣,東河鄉,興昌村,0,1,298,1,299,566,3,1,3,0,1,0,52.83
臺東縣,東河鄉,隆昌村,0,1,93,1,94,201,3,1,3,0,1,0,46.77
臺東縣,東河鄉,東河村,0,1,127,0,127,323,3,1,3,0,1,0,39.32
臺東縣,東河鄉,泰源村,0,1,312,2,314,618,3,1,3,0,1,0,50.81
臺東縣,東河鄉,北源村,0,1,395,2,397,867,3,1,3,0,1,0,45.79
臺東縣,東河鄉,尚德村,0,1,77,1,78,180,3,1,3,0,1,0,43.33
臺東縣,長濱鄉,寧埔村,0,1,133,0,133,337,3,1,3,0,1,0,39.47
臺東縣,長濱鄉,竹湖村,0,1,146,0,146,360,3,1,3,0,1,0,40.56
臺東縣,長濱鄉,長濱村,0,1,568,6,574,1280,3,1,3,0,1,0,44.84
臺東縣,長濱鄉,忠勇村,0,1,200,1,201,503,3,1,3,0,1,0,39.96
臺東縣,長濱鄉,三間村,0,1,115,0,115,263,3,1,3,0,1,0,43.73
臺東縣,長濱鄉,樟原村,0,1,181,2,183,383,3,1,3,0,1,0,47.78
臺東縣,太麻里鄉,美和村,0,1,460,1,461,904,3,1,3,0,1,0,51.00
臺東縣,太麻里鄉,三和村,0,1,322,0,322,620,3,1,3,0,1,0,51.94
臺東縣,太麻里鄉,華源村,0,1,371,2,373,681,3,1,3,0,1,0,54.77
臺東縣,太麻里鄉,北里村,0,1,196,0,196,385,3,1,3,0,1,0,50.91
臺東縣,太麻里鄉,大王村,0,1,576,2,578,1155,3,1,3,0,1,0,50.04
臺東縣,太麻里鄉,泰和村,0,1,674,2,676,1224,3,1,3,0,1,0,55.23
臺東縣,太麻里鄉,香蘭村,0,1,229,4,233,462,3,1,3,0,1,0,50.43
臺東縣,太麻里鄉,金崙村,0,1,196,3,199,417,3,1,3,0,1,0,47.72
臺東縣,太麻里鄉,多良村,0,1,96,0,96,212,3,1,3,0,1,0,45.28
臺東縣,大武鄉,南興村,0,1,134,1,135,359,3,1,3,0,1,0,37.60
臺東縣,大武鄉,尚武村,0,1,533,4,537,1449,3,1,3,0,1,0,37.06
臺東縣,大武鄉,大武村,0,1,443,6,449,1056,3,1,3,0,1,0,42.52
臺東縣,大武鄉,大鳥村,0,1,26,0,26,93,3,1,3,0,1,0,27.96
臺東縣,大武鄉,大竹村,0,1,32,0,32,97,3,1,3,0,1,0,32.99
臺東縣,綠島鄉,南寮村,0,1,358,0,358,806,3,1,3,0,1,0,44.42
臺東縣,綠島鄉,中寮村,0,1,323,1,324,873,3,1,3,0,1,0,37.11
臺東縣,綠島鄉,公館村,0,1,247,3,250,586,3,1,3,0,1,0,42.66
臺東縣,海端鄉,加拿村,0,1,12,1,13,24,3,1,3,0,1,0,54.17
臺東縣,海端鄉,崁頂村,0,1,26,0,26,51,3,1,3,0,1,0,50.98
臺東縣,海端鄉,海端村,0,1,56,0,56,110,3,1,3,0,1,0,50.91
臺東縣,海端鄉,廣原村,0,1,40,0,40,72,3,1,3,0,1,0,55.56
臺東縣,海端鄉,霧鹿村,0,1,11,1,12,20,3,1,3,0,1,0,60.00
臺東縣,海端鄉,利稻村,0,1,8,1,9,29,3,1,3,0,1,0,31.03
臺東縣,延平鄉,桃源村,0,1,49,1,50,95,3,1,3,0,1,0,52.63
臺東縣,延平鄉,紅葉村,0,1,10,0,10,23,3,1,3,0,1,0,43.48
臺東縣,延平鄉,永康村,0,1,10,0,10,20,3,1,3,0,1,0,50.00
臺東縣,延平鄉,武陵村,0,1,17,0,17,36,3,1,3,0,1,0,47.22
臺東縣,延平鄉,鸞山村,0,1,50,0,50,104,3,1,3,0,1,0,48.08
臺東縣,金峰鄉,嘉蘭村,0,1,28,0,28,62,3,1,3,0,1,0,45.16
臺東縣,金峰鄉,正興村,0,1,13,0,13,30,3,1,3,0,1,0,43.33
臺東縣,金峰鄉,新興村,0,1,15,1,16,24,3,1,3,0,1,0,66.67
臺東縣,金峰鄉,賓茂村,0,1,5,0,5,8,3,1,3,0,1,0,62.50
臺東縣,金峰鄉,歷坵村,0,1,7,0,7,16,3,1,3,0,1,0,43.75
臺東縣,達仁鄉,安朔村,0,1,60,1,61,140,3,1,3,0,1,0,43.57
臺東縣,達仁鄉,南田村,0,1,31,0,31,65,3,1,3,0,1,0,47.69
臺東縣,達仁鄉,森永村,0,1,23,0,23,59,3,1,3,0,1,0,38.98
臺東縣,達仁鄉,新化村,0,1,6,0,6,16,3,1,3,0,1,0,37.50
臺東縣,達仁鄉,台板村,0,1,8,0,8,34,3,1,3,0,1,0,23.53
臺東縣,達仁鄉,土板村,0,1,10,0,10,23,3,1,3,0,1,0,43.48
臺東縣,蘭嶼鄉,椰油村,0,1,32,0,32,105,3,1,3,0,1,0,30.48
臺東縣,蘭嶼鄉,紅頭村,0,1,46,0,46,116,3,1,3,0,1,0,39.66
臺東縣,蘭嶼鄉,東清村,0,1,9,0,9,38,3,1,3,0,1,0,23.68
臺東縣,蘭嶼鄉,朗島村,0,1,4,0,4,25,3,1,3,0,1,0,16.00
花蓮縣,花蓮市,民德里,0,1,687,3,690,1307,3,1,3,0,1,0,52.79
花蓮縣,花蓮市,民勤里,0,1,1460,19,1479,2790,3,1,3,0,1,0,53.01
花蓮縣,花蓮市,民意里,0,1,1164,17,1181,2380,3,1,3,0,1,0,49.62
花蓮縣,花蓮市,民心里,0,1,337,1,338,782,3,1,3,0,1,0,43.22
花蓮縣,花蓮市,民享里,0,1,807,5,812,1782,3,1,3,0,1,0,45.57
花蓮縣,花蓮市,民孝里,0,1,1162,12,1174,2244,3,1,3,0,1,0,52.32
花蓮縣,花蓮市,民運里,0,1,935,9,944,1787,3,1,3,0,1,0,52.83
花蓮縣,花蓮市,民政里,0,1,1302,6,1308,2683,3,1,3,0,1,0,48.75
花蓮縣,花蓮市,民立里,0,1,638,7,645,1201,3,1,3,0,1,0,53.71
花蓮縣,花蓮市,民樂里,0,1,233,2,235,491,3,1,3,0,1,0,47.86
花蓮縣,花蓮市,民有里,0,1,356,2,358,647,3,1,3,0,1,0,55.33
花蓮縣,花蓮市,民主里,0,1,331,4,335,571,3,1,3,0,1,0,58.6690017513
花蓮縣,花蓮市,民治里,0,1,215,0,215,345,3,1,3,0,1,0,62.3188405797
花蓮縣,花蓮市,民族里,0,1,312,0,312,552,3,1,3,0,1,0,56.52
花蓮縣,花蓮市,民生里,0,1,710,13,723,1342,3,1,3,0,1,0,53.87
花蓮縣,花蓮市,民權里,0,1,237,3,240,449,3,1,3,0,1,0,53.45
花蓮縣,花蓮市,主商里,0,1,374,1,375,675,3,1,3,0,1,0,55.56
花蓮縣,花蓮市,主勤里,0,1,520,8,528,976,3,1,3,0,1,0,54.10
花蓮縣,花蓮市,主工里,0,1,323,3,326,607,3,1,3,0,1,0,53.71
花蓮縣,花蓮市,主信里,0,1,395,0,395,720,3,1,3,0,1,0,54.86
花蓮縣,花蓮市,主睦里、主義里,0,1,530,4,534,1055,3,1,3,0,1,0,50.62
花蓮縣,花蓮市,主計里,0,1,408,3,411,836,3,1,3,0,1,0,49.16
花蓮縣,花蓮市,主和里,0,1,1465,16,1481,2843,3,1,3,0,1,0,52.0928596553
花蓮縣,花蓮市,主學里,0,1,828,6,834,1701,3,1,3,0,1,0,49.03
花蓮縣,花蓮市,主農里,0,1,1393,7,1400,2735,3,1,3,0,1,0,51.19
花蓮縣,花蓮市,主安里,0,1,1127,9,1136,2299,3,1,3,0,1,0,49.41
花蓮縣,花蓮市,主權里,0,1,1924,14,1938,4017,3,1,3,0,1,0,48.24
花蓮縣,花蓮市,主力里,0,1,1219,5,1224,2451,3,1,3,0,1,0,49.94
花蓮縣,花蓮市,國風里,0,1,1516,12,1528,3081,3,1,3,0,1,0,49.59
花蓮縣,花蓮市,國威里,0,1,770,9,779,1692,3,1,3,0,1,0,46.04
花蓮縣,花蓮市,國治里,0,1,477,4,481,1002,3,1,3,0,1,0,48.00
花蓮縣,花蓮市,國安里,0,1,263,3,266,495,3,1,3,0,1,0,53.74
花蓮縣,花蓮市,國光里,0,1,667,6,673,1225,3,1,3,0,1,0,54.9387755102
花蓮縣,花蓮市,國防里,0,1,415,7,422,799,3,1,3,0,1,0,52.816020025
花蓮縣,花蓮市,國華里,0,1,986,6,992,2006,3,1,3,0,1,0,49.45
花蓮縣,花蓮市,國魂里,0,1,888,5,893,1760,3,1,3,0,1,0,50.74
花蓮縣,花蓮市,國聯里,0,1,992,3,995,2121,3,1,3,0,1,0,46.91
花蓮縣,花蓮市,國盛里,0,1,1053,5,1058,2490,3,1,3,0,1,0,42.49
花蓮縣,花蓮市,國強里,0,1,606,5,611,1202,3,1,3,0,1,0,50.83
花蓮縣,花蓮市,國富里,0,1,2070,16,2086,4344,3,1,3,0,1,0,48.02
花蓮縣,花蓮市,國裕里,0,1,1586,13,1599,3285,3,1,3,0,1,0,48.68
花蓮縣,花蓮市,國慶里,0,1,383,2,385,807,3,1,3,0,1,0,47.70755886
花蓮縣,花蓮市,國興里,0,1,1283,10,1293,2883,3,1,3,0,1,0,44.85
花蓮縣,花蓮市,國福里,0,1,352,3,355,913,3,1,3,0,1,0,38.88
花蓮縣,新城鄉,新城村,0,1,647,7,654,1264,3,1,3,0,1,0,51.7405063291
花蓮縣,新城鄉,順安村,0,1,455,4,459,822,3,1,3,0,1,0,55.84
花蓮縣,新城鄉,康樂村,0,1,946,6,952,1906,3,1,3,0,1,0,49.95
花蓮縣,新城鄉,大漢村,0,1,761,8,769,1609,3,1,3,0,1,0,47.79
花蓮縣,新城鄉,北埔村,0,1,1153,12,1165,2441,3,1,3,0,1,0,47.73
花蓮縣,新城鄉,佳林村,0,1,274,4,278,614,3,1,3,0,1,0,45.28
花蓮縣,新城鄉,嘉里村,0,1,1359,11,1370,2757,3,1,3,0,1,0,49.69
花蓮縣,新城鄉,嘉新村,0,1,499,5,504,965,3,1,3,0,1,0,52.23
花蓮縣,秀林鄉,和平村,0,1,143,0,143,326,3,1,3,0,1,0,43.87
花蓮縣,秀林鄉,崇德村,0,1,189,1,190,346,3,1,3,0,1,0,54.91
花蓮縣,秀林鄉,富世村,0,1,137,2,139,371,3,1,3,0,1,0,37.4663072776
花蓮縣,秀林鄉,秀林村,0,1,54,0,54,120,3,1,3,0,1,0,45
花蓮縣,秀林鄉,景美村,0,1,54,0,54,153,3,1,3,0,1,0,35.29
花蓮縣,秀林鄉,佳民村,0,1,65,1,66,144,3,1,3,0,1,0,45.83
花蓮縣,秀林鄉,水源村,0,1,49,1,50,104,3,1,3,0,1,0,48.08
花蓮縣,秀林鄉,銅門村,0,1,37,0,37,73,3,1,3,0,1,0,50.68
花蓮縣,秀林鄉,文蘭村,0,1,38,2,40,83,3,1,3,0,1,0,48.19
花蓮縣,吉安鄉,永安村,0,1,1472,9,1481,3200,3,1,3,0,1,0,46.28125
花蓮縣,吉安鄉,太昌村,0,1,1139,6,1145,2456,3,1,3,0,1,0,46.6205211726
花蓮縣,吉安鄉,慶豐村,0,1,2267,26,2293,4625,3,1,3,0,1,0,49.58
花蓮縣,吉安鄉,吉安村,0,1,1673,13,1686,3609,3,1,3,0,1,0,46.72
花蓮縣,吉安鄉,福興村,0,1,969,2,971,1997,3,1,3,0,1,0,48.6229344016
花蓮縣,吉安鄉,南華村,0,1,580,6,586,1096,3,1,3,0,1,0,53.4671532847
花蓮縣,吉安鄉,干城村,0,1,373,5,378,810,3,1,3,0,1,0,46.67
花蓮縣,吉安鄉,永興村,0,1,1012,10,1022,2082,3,1,3,0,1,0,49.09
花蓮縣,吉安鄉,稻香村,0,1,1293,12,1305,2512,3,1,3,0,1,0,51.95
花蓮縣,吉安鄉,南昌村,0,1,983,3,986,2166,3,1,3,0,1,0,45.52
花蓮縣,吉安鄉,宜昌村,0,1,1275,13,1288,2707,3,1,3,0,1,0,47.58
花蓮縣,吉安鄉,北昌村,0,1,2961,20,2981,5883,3,1,3,0,1,0,50.67
花蓮縣,吉安鄉,勝安村,0,1,1734,19,1753,3600,3,1,3,0,1,0,48.6944444444
花蓮縣,吉安鄉,仁里村,0,1,2208,16,2224,4585,3,1,3,0,1,0,48.505997819
花蓮縣,吉安鄉,東昌村,0,1,1444,8,1452,3190,3,1,3,0,1,0,45.52
花蓮縣,吉安鄉,仁安村,0,1,644,5,649,1420,3,1,3,0,1,0,45.70
花蓮縣,吉安鄉,仁和村,0,1,1400,16,1416,3118,3,1,3,0,1,0,45.41
花蓮縣,吉安鄉,光華村,0,1,471,2,473,923,3,1,3,0,1,0,51.2459371614
花蓮縣,壽豐鄉,溪口村,0,1,422,2,424,780,3,1,3,0,1,0,54.358974359
花蓮縣,壽豐鄉,樹湖村,0,1,161,1,162,285,3,1,3,0,1,0,56.8421052632
花蓮縣,壽豐鄉,豐山村,0,1,901,6,907,1787,3,1,3,0,1,0,50.76
花蓮縣,壽豐鄉,豐裡村,0,1,551,3,554,1170,3,1,3,0,1,0,47.35
花蓮縣,壽豐鄉,豐坪村,0,1,331,1,332,629,3,1,3,0,1,0,52.78
花蓮縣,壽豐鄉,壽豐村,0,1,557,6,563,1059,3,1,3,0,1,0,53.16
花蓮縣,壽豐鄉,共和村,0,1,279,2,281,506,3,1,3,0,1,0,55.53
花蓮縣,壽豐鄉,光榮村,0,1,68,1,69,145,3,1,3,0,1,0,47.59
花蓮縣,壽豐鄉,池南村,0,1,275,3,278,538,3,1,3,0,1,0,51.67
花蓮縣,壽豐鄉,平和村,0,1,538,3,541,1065,3,1,3,0,1,0,50.80
花蓮縣,壽豐鄉,志學村,0,1,869,9,878,1873,3,1,3,0,1,0,46.88
花蓮縣,壽豐鄉,池南村,0,1,177,1,178,347,3,1,3,0,1,0,51.30
花蓮縣,壽豐鄉,米棧村,0,1,75,0,75,143,3,1,3,0,1,0,52.45
花蓮縣,壽豐鄉,月眉村,0,1,104,0,104,235,3,1,3,0,1,0,44.26
花蓮縣,壽豐鄉,鹽寮村,0,1,157,1,158,351,3,1,3,0,1,0,45.01
花蓮縣,壽豐鄉,水璉村,0,1,181,2,183,403,3,1,3,0,1,0,45.41
花蓮縣,鳳林鎮,鳳仁里,0,1,638,5,643,1153,3,1,3,0,1,0,55.77
花蓮縣,鳳林鎮,鳳義里,0,1,355,3,358,612,3,1,3,0,1,0,58.50
花蓮縣,鳳林鎮,鳳禮里,0,1,407,2,409,675,3,1,3,0,1,0,60.59
花蓮縣,鳳林鎮,鳳智里,0,1,615,3,618,1086,3,1,3,0,1,0,56.91
花蓮縣,鳳林鎮,鳳信里,0,1,460,0,460,839,3,1,3,0,1,0,54.83
花蓮縣,鳳林鎮,山興里,0,1,106,1,107,215,3,1,3,0,1,0,49.7674418605
花蓮縣,鳳林鎮,大榮里,0,1,593,5,598,1206,3,1,3,0,1,0,49.59
花蓮縣,鳳林鎮,北林里,0,1,327,5,332,622,3,1,3,0,1,0,53.38
花蓮縣,鳳林鎮,南平里,0,1,312,2,314,633,3,1,3,0,1,0,49.61
花蓮縣,鳳林鎮,林榮里,0,1,426,7,433,817,3,1,3,0,1,0,52.9987760098
花蓮縣,鳳林鎮,長橋里,0,1,492,5,497,969,3,1,3,0,1,0,51.2899896801
花蓮縣,鳳林鎮,森榮里,0,1,64,0,64,109,3,1,3,0,1,0,58.72
花蓮縣,光復鄉,大華村,0,1,552,4,556,1032,3,1,3,0,1,0,53.88
花蓮縣,光復鄉,大安村,0,1,488,2,490,828,3,1,3,0,1,0,59.18
花蓮縣,光復鄉,大平村,0,1,119,1,120,283,3,1,3,0,1,0,42.40
花蓮縣,光復鄉,大馬村,0,1,180,0,180,368,3,1,3,0,1,0,48.91
花蓮縣,光復鄉,大同村,0,1,383,5,388,697,3,1,3,0,1,0,55.67
花蓮縣,光復鄉,東富村,0,1,81,0,81,194,3,1,3,0,1,0,41.7525773196
花蓮縣,光復鄉,西富村,0,1,161,1,162,328,3,1,3,0,1,0,49.39
花蓮縣,光復鄉,南富村,0,1,40,0,40,104,3,1,3,0,1,0,38.46
花蓮縣,光復鄉,北富村,0,1,74,2,76,174,3,1,3,0,1,0,43.68
花蓮縣,光復鄉,大進村,0,1,253,3,256,423,3,1,3,0,1,0,60.52
花蓮縣,光復鄉,大全村,0,1,315,4,319,600,3,1,3,0,1,0,53.17
花蓮縣,光復鄉,大興村,0,1,139,4,143,317,3,1,3,0,1,0,45.1104100946
花蓮縣,光復鄉,大富村,0,1,162,2,164,367,3,1,3,0,1,0,44.6866485014
花蓮縣,光復鄉,大豐村,0,1,245,4,249,523,3,1,3,0,1,0,47.61
花蓮縣,豐濱鄉,靜浦村,0,1,31,0,31,97,3,1,3,0,1,0,31.96
花蓮縣,豐濱鄉,港口村,0,1,69,0,69,138,3,1,3,0,1,0,50.00
花蓮縣,豐濱鄉,豐濱村,0,1,265,6,271,586,3,1,3,0,1,0,46.25
花蓮縣,豐濱鄉,新社村,0,1,23,0,23,74,3,1,3,0,1,0,31.08
花蓮縣,豐濱鄉,磯崎村,0,1,35,0,35,75,3,1,3,0,1,0,46.67
花蓮縣,萬榮鄉,西林村,0,1,15,1,16,44,3,1,3,0,1,0,36.36
花蓮縣,萬榮鄉,見晴村,0,1,13,1,14,34,3,1,3,0,1,0,41.18
花蓮縣,萬榮鄉,萬榮村,0,1,24,0,24,47,3,1,3,0,1,0,51.06
花蓮縣,萬榮鄉,明利村,0,1,33,0,33,58,3,1,3,0,1,0,56.90
花蓮縣,萬榮鄉,馬遠村,0,1,10,0,10,34,3,1,3,0,1,0,29.41
花蓮縣,萬榮鄉,紅葉村,0,1,37,0,37,86,3,1,3,0,1,0,43.02
花蓮縣,瑞穗鄉,瑞穗村,0,1,887,3,890,1767,3,1,3,0,1,0,50.37
花蓮縣,瑞穗鄉,瑞美村,0,1,766,6,772,1533,3,1,3,0,1,0,50.36
花蓮縣,瑞穗鄉,瑞良村,0,1,215,1,216,387,3,1,3,0,1,0,55.8139534884
花蓮縣,瑞穗鄉,瑞祥村,0,1,381,1,382,813,3,1,3,0,1,0,46.9864698647
花蓮縣,瑞穗鄉,瑞北村,0,1,166,0,166,369,3,1,3,0,1,0,44.99
花蓮縣,瑞穗鄉,舞鶴村,0,1,210,3,213,468,3,1,3,0,1,0,45.51
花蓮縣,瑞穗鄉,鶴岡村,0,1,120,1,121,276,3,1,3,0,1,0,43.8405797101
花蓮縣,瑞穗鄉,奇美村,0,1,25,0,25,51,3,1,3,0,1,0,49.0196078431
花蓮縣,瑞穗鄉,富源村,0,1,327,2,329,605,3,1,3,0,1,0,54.38
花蓮縣,瑞穗鄉,富民村,0,1,104,3,107,275,3,1,3,0,1,0,38.91
花蓮縣,瑞穗鄉,富興村,0,1,222,2,224,444,3,1,3,0,1,0,50.45
花蓮縣,玉里鎮,中城里,0,1,2122,21,2143,4269,3,1,3,0,1,0,50.20
花蓮縣,玉里鎮,國武里,0,1,677,5,682,1322,3,1,3,0,1,0,51.59
花蓮縣,玉里鎮,啟模里,0,1,790,7,797,1643,3,1,3,0,1,0,48.51
花蓮縣,玉里鎮,泰昌里,0,1,820,37,857,2392,3,1,3,0,1,0,35.83
花蓮縣,玉里鎮,永昌里,0,1,476,3,479,1001,3,1,3,0,1,0,47.85
花蓮縣,玉里鎮,源城里,0,1,522,7,529,1080,3,1,3,0,1,0,48.98
花蓮縣,玉里鎮,長良里,0,1,200,6,206,536,3,1,3,0,1,0,38.43
花蓮縣,玉里鎮,樂合里,0,1,146,1,147,358,3,1,3,0,1,0,41.06
花蓮縣,玉里鎮,東豐里,0,1,160,0,160,331,3,1,3,0,1,0,48.34
花蓮縣,玉里鎮,觀音里,0,1,405,4,409,930,3,1,3,0,1,0,43.98
花蓮縣,玉里鎮,松浦里,0,1,199,3,202,476,3,1,3,0,1,0,42.44
花蓮縣,玉里鎮,春日里,0,1,173,5,178,455,3,1,3,0,1,0,39.12
花蓮縣,玉里鎮,德武里,0,1,30,0,30,76,3,1,3,0,1,0,39.47
花蓮縣,玉里鎮,三民里,0,1,482,2,484,939,3,1,3,0,1,0,51.54
花蓮縣,玉里鎮,大禹里,0,1,452,4,456,972,3,1,3,0,1,0,46.91
花蓮縣,富里鄉,吳江村,0,1,202,2,204,420,3,1,3,0,1,0,48.57
花蓮縣,富里鄉,東里村,0,1,445,3,448,1120,3,1,3,0,1,0,40.00
花蓮縣,富里鄉,萬寧村,0,1,214,2,216,585,3,1,3,0,1,0,36.92
花蓮縣,富里鄉,新興村,0,1,223,4,227,547,3,1,3,0,1,0,41.50
花蓮縣,富里鄉,竹田村,0,1,483,5,488,1031,3,1,3,0,1,0,47.33
花蓮縣,富里鄉,羅山村,0,1,189,3,192,446,3,1,3,0,1,0,43.05
花蓮縣,富里鄉,石牌村,0,1,407,2,409,837,3,1,3,0,1,0,48.86
花蓮縣,富里鄉,明里村,0,1,182,2,184,389,3,1,3,0,1,0,47.30
花蓮縣,富里鄉,富里村,0,1,696,5,701,1494,3,1,3,0,1,0,46.92
花蓮縣,富里鄉,永豐村,0,1,200,0,200,507,3,1,3,0,1,0,39.45
花蓮縣,富里鄉,豐南村,0,1,143,1,144,312,3,1,3,0,1,0,46.15
花蓮縣,富里鄉,富南村,0,1,218,3,221,517,3,1,3,0,1,0,42.75
花蓮縣,富里鄉,學田村,0,1,291,1,292,536,3,1,3,0,1,0,54.48
花蓮縣,卓溪鄉,崙山村,0,1,9,0,9,19,3,1,3,0,1,0,47.3684210526
花蓮縣,卓溪鄉,立山村,0,1,13,0,13,37,3,1,3,0,1,0,35.1351351351
花蓮縣,卓溪鄉,太平村,0,1,16,0,16,25,3,1,3,0,1,0,64.00
花蓮縣,卓溪鄉,卓溪村,0,1,40,0,40,79,3,1,3,0,1,0,50.63
花蓮縣,卓溪鄉,卓清村,0,1,39,0,39,87,3,1,3,0,1,0,44.8275862069
花蓮縣,卓溪鄉,古風村,0,1,36,0,36,69,3,1,3,0,1,0,52.17
澎湖縣,馬公市,新復里,0,1,187,1,188,300,3,1,3,0,1,0,62.67
澎湖縣,馬公市,復興里,0,1,187,0,187,319,3,1,3,0,1,0,58.62
澎湖縣,馬公市,長安里,0,1,314,4,318,526,3,1,3,0,1,0,60.46
澎湖縣,馬公市,中央里,0,1,283,4,287,491,3,1,3,0,1,0,58.45
澎湖縣,馬公市,啟明里,0,1,509,7,516,867,3,1,3,0,1,0,59.52
澎湖縣,馬公市,重慶里,0,1,585,5,590,978,3,1,3,0,1,0,60.33
澎湖縣,馬公市,中興里,0,1,423,5,428,705,3,1,3,0,1,0,60.71
澎湖縣,馬公市,光復里,0,1,1047,3,1050,1826,3,1,3,0,1,0,57.50
澎湖縣,馬公市,光明里,0,1,671,5,676,1159,3,1,3,0,1,0,58.33
澎湖縣,馬公市,光榮里,0,1,1419,7,1426,2398,3,1,3,0,1,0,59.47
澎湖縣,馬公市,朝陽里,0,1,2585,23,2608,4661,3,1,3,0,1,0,55.95
澎湖縣,馬公市,陽明里,0,1,1264,12,1276,2272,3,1,3,0,1,0,56.16
澎湖縣,馬公市,重光里,0,1,686,3,689,1159,3,1,3,0,1,0,59.45
澎湖縣,馬公市,西衛里,0,1,1609,9,1618,2846,3,1,3,0,1,0,56.85
澎湖縣,馬公市,西文里,0,1,1194,9,1203,2033,3,1,3,0,1,0,59.17
澎湖縣,馬公市,東文里,0,1,1201,5,1206,2084,3,1,3,0,1,0,57.87
澎湖縣,馬公市,案山里,0,1,763,5,768,1231,3,1,3,0,1,0,62.39
澎湖縣,馬公市,光華里,0,1,403,7,410,686,3,1,3,0,1,0,59.77
澎湖縣,馬公市,前寮里,0,1,355,3,358,567,3,1,3,0,1,0,63.14
澎湖縣,馬公市,石泉里,0,1,873,10,883,1512,3,1,3,0,1,0,58.40
澎湖縣,馬公市,菜園里,0,1,221,4,225,323,3,1,3,0,1,0,69.66
澎湖縣,馬公市,東衛里,0,1,791,5,796,1374,3,1,3,0,1,0,57.93
澎湖縣,馬公市,安宅里,0,1,268,2,270,436,3,1,3,0,1,0,61.93
澎湖縣,馬公市,興仁里,0,1,365,0,365,604,3,1,3,0,1,0,60.43
澎湖縣,馬公市,烏崁里,0,1,493,4,497,814,3,1,3,0,1,0,61.06
澎湖縣,馬公市,鐵線里,0,1,258,1,259,387,3,1,3,0,1,0,66.93
澎湖縣,馬公市,鎖港里,0,1,1071,7,1078,2034,3,1,3,0,1,0,53.00
澎湖縣,馬公市,山水里,0,1,820,6,826,1406,3,1,3,0,1,0,58.75
澎湖縣,馬公市,五德里,0,1,104,2,106,178,3,1,3,0,1,0,59.55
澎湖縣,馬公市,井垵里,0,1,207,2,209,336,3,1,3,0,1,0,62.20
澎湖縣,馬公市,時裡里,0,1,628,4,632,1064,3,1,3,0,1,0,59.40
澎湖縣,馬公市,風櫃里,0,1,664,6,670,1231,3,1,3,0,1,0,54.43
澎湖縣,馬公市,虎井里,0,1,207,2,209,602,3,1,3,0,1,0,34.72
澎湖縣,馬公市,桶盤里,0,1,55,0,55,201,3,1,3,0,1,0,27.36
澎湖縣,湖西鄉,湖西村,0,1,532,8,540,845,3,1,3,0,1,0,63.91
澎湖縣,湖西鄉,湖東村,0,1,187,1,188,306,3,1,3,0,1,0,61.44
澎湖縣,湖西鄉,青螺村,0,1,106,0,106,203,3,1,3,0,1,0,52.22
澎湖縣,湖西鄉,白坑村,0,1,148,1,149,243,3,1,3,0,1,0,61.32
澎湖縣,湖西鄉,南寮村,0,1,359,4,363,607,3,1,3,0,1,0,59.80
澎湖縣,湖西鄉,北寮村,0,1,169,3,172,279,3,1,3,0,1,0,61.65
澎湖縣,湖西鄉,紅羅村,0,1,328,4,332,556,3,1,3,0,1,0,59.71
澎湖縣,湖西鄉,西溪村,0,1,263,0,263,459,3,1,3,0,1,0,57.30
澎湖縣,湖西鄉,成功村,0,1,268,1,269,421,3,1,3,0,1,0,63.90
澎湖縣,湖西鄉,東石村,0,1,64,0,64,108,3,1,3,0,1,0,59.26
澎湖縣,湖西鄉,沙港村,0,1,436,7,443,722,3,1,3,0,1,0,61.36
澎湖縣,湖西鄉,中西村,0,1,90,0,90,165,3,1,3,0,1,0,54.55
澎湖縣,湖西鄉,鼎灣村,0,1,179,1,180,296,3,1,3,0,1,0,60.81
澎湖縣,湖西鄉,潭邊村,0,1,143,1,144,228,3,1,3,0,1,0,63.16
澎湖縣,湖西鄉,許家村,0,1,101,0,101,166,3,1,3,0,1,0,60.84
澎湖縣,湖西鄉,城北村,0,1,130,0,130,189,3,1,3,0,1,0,68.78
澎湖縣,湖西鄉,太武村,0,1,61,0,61,109,3,1,3,0,1,0,55.96
澎湖縣,湖西鄉,隘門村,0,1,402,2,404,628,3,1,3,0,1,0,64.33
澎湖縣,湖西鄉,林投村,0,1,470,4,474,876,3,1,3,0,1,0,54.11
澎湖縣,湖西鄉,尖山村,0,1,303,1,304,532,3,1,3,0,1,0,57.14
澎湖縣,湖西鄉,龍門村,0,1,902,8,910,1535,3,1,3,0,1,0,59.28
澎湖縣,湖西鄉,果葉村,0,1,387,1,388,641,3,1,3,0,1,0,60.53
澎湖縣,白沙鄉,中屯村,0,1,279,2,281,441,3,1,3,0,1,0,63.72
澎湖縣,白沙鄉,講美村,0,1,306,2,308,537,3,1,3,0,1,0,57.36
澎湖縣,白沙鄉,城前村,0,1,53,1,54,89,3,1,3,0,1,0,60.67
澎湖縣,白沙鄉,鎮海村,0,1,75,0,75,117,3,1,3,0,1,0,64.10
澎湖縣,白沙鄉,港子村,0,1,123,2,125,239,3,1,3,0,1,0,52.30
澎湖縣,白沙鄉,岐頭村,0,1,112,0,112,207,3,1,3,0,1,0,54.11
澎湖縣,白沙鄉,小赤村,0,1,98,0,98,145,3,1,3,0,1,0,67.59
澎湖縣,白沙鄉,赤崁村,0,1,751,8,759,1306,3,1,3,0,1,0,58.12
澎湖縣,白沙鄉,瓦硐村,0,1,154,2,156,282,3,1,3,0,1,0,55.32
澎湖縣,白沙鄉,後寮村,0,1,373,4,377,644,3,1,3,0,1,0,58.54
澎湖縣,白沙鄉,通梁村,0,1,382,1,383,673,3,1,3,0,1,0,56.91
澎湖縣,白沙鄉,吉貝村,0,1,510,4,514,1212,3,1,3,0,1,0,42.41
澎湖縣,白沙鄉,鳥嶼村,0,1,276,41,317,972,3,1,3,0,1,0,32.61
澎湖縣,白沙鄉,員貝村,0,1,70,0,70,209,3,1,3,0,1,0,33.49
澎湖縣,白沙鄉,大倉村,0,1,80,3,83,175,3,1,3,0,1,0,47.43
澎湖縣,西嶼鄉,橫礁村,0,1,130,0,130,253,3,1,3,0,1,0,51.38
澎湖縣,西嶼鄉,合界村,0,1,194,2,196,387,3,1,3,0,1,0,50.65
澎湖縣,西嶼鄉,竹灣村,0,1,405,4,409,748,3,1,3,0,1,0,54.68
澎湖縣,西嶼鄉,小門村,0,1,135,0,135,262,3,1,3,0,1,0,51.53
澎湖縣,西嶼鄉,大池村,0,1,298,6,304,597,3,1,3,0,1,0,50.92
澎湖縣,西嶼鄉,二崁村,0,1,58,2,60,120,3,1,3,0,1,0,50.00
澎湖縣,西嶼鄉,池東村,0,1,265,1,266,495,3,1,3,0,1,0,53.74
澎湖縣,西嶼鄉,池西村,0,1,97,0,97,188,3,1,3,0,1,0,51.60
澎湖縣,西嶼鄉,赤馬村,0,1,273,1,274,583,3,1,3,0,1,0,47.00
澎湖縣,西嶼鄉,內垵村,0,1,627,4,631,1178,3,1,3,0,1,0,53.57
澎湖縣,西嶼鄉,外垵村,0,1,895,5,900,1783,3,1,3,0,1,0,50.48
澎湖縣,望安鄉,東安村,0,1,186,0,186,410,3,1,3,0,1,0,45.37
澎湖縣,望安鄉,西安村,0,1,133,1,134,311,3,1,3,0,1,0,43.09
澎湖縣,望安鄉,中社村,0,1,75,0,75,217,3,1,3,0,1,0,34.56
澎湖縣,望安鄉,水垵村,0,1,133,0,133,280,3,1,3,0,1,0,47.50
澎湖縣,望安鄉,將軍村,0,1,413,5,418,1166,3,1,3,0,1,0,35.85
澎湖縣,望安鄉,東吉村,0,1,29,1,30,266,3,1,3,0,1,0,11.28
澎湖縣,望安鄉,東坪村,0,1,39,0,39,331,3,1,3,0,1,0,11.78
澎湖縣,望安鄉,西坪村,0,1,16,0,16,171,3,1,3,0,1,0,9.36
澎湖縣,望安鄉,花嶼村,0,1,97,3,100,217,3,1,3,0,1,0,46.08
澎湖縣,七美鄉,東湖村,0,1,84,0,84,221,3,1,3,0,1,0,38.01
澎湖縣,七美鄉,西湖村,0,1,148,0,148,409,3,1,3,0,1,0,36.19
澎湖縣,七美鄉,中和村,0,1,172,3,175,442,3,1,3,0,1,0,39.59
澎湖縣,七美鄉,平和村,0,1,104,2,106,254,3,1,3,0,1,0,41.73
澎湖縣,七美鄉,海豐村,0,1,99,2,101,247,3,1,3,0,1,0,40.89
澎湖縣,七美鄉,南港村,0,1,348,1,349,831,3,1,3,0,1,0,42.00
基隆市,中正區,長潭里,0,1,383,3,386,566,3,1,3,0,1,0,68.20
基隆市,中正區,砂子里,0,1,1464,30,1494,2888,3,1,3,0,1,0,51.73
基隆市,中正區,八斗里,0,1,894,10,904,1545,3,1,3,0,1,0,58.51
基隆市,中正區,碧砂里,0,1,645,6,651,1281,3,1,3,0,1,0,50.82
基隆市,中正區,新富里,0,1,1597,17,1614,3392,3,1,3,0,1,0,47.58
基隆市,中正區,新豐里,0,1,1513,13,1526,3390,3,1,3,0,1,0,45.01
基隆市,中正區,平寮里,0,1,798,2,800,1480,3,1,3,0,1,0,54.05
基隆市,中正區,社寮里,0,1,1011,7,1018,1904,3,1,3,0,1,0,53.47
基隆市,中正區,和憲里,0,1,464,2,466,898,3,1,3,0,1,0,51.89
基隆市,中正區,海濱里,0,1,499,4,503,988,3,1,3,0,1,0,50.91
基隆市,中正區,正濱里,0,1,628,11,639,1216,3,1,3,0,1,0,52.55
基隆市,中正區,中正里,0,1,1062,11,1073,2060,3,1,3,0,1,0,52.09
基隆市,中正區,中濱里,0,1,794,5,799,1350,3,1,3,0,1,0,59.1851851852
基隆市,中正區,建國里,0,1,1205,10,1215,2120,3,1,3,0,1,0,57.31
基隆市,中正區,砂灣里,0,1,1112,15,1127,2093,3,1,3,0,1,0,53.85
基隆市,中正區,真砂里,0,1,839,9,848,1476,3,1,3,0,1,0,57.45
基隆市,中正區,正砂里,0,1,1379,7,1386,2379,3,1,3,0,1,0,58.26
基隆市,中正區,中砂里,0,1,794,5,799,1298,3,1,3,0,1,0,61.56
基隆市,中正區,入船里,0,1,698,5,703,1260,3,1,3,0,1,0,55.79
基隆市,中正區,正船里,0,1,764,3,767,1438,3,1,3,0,1,0,53.34
基隆市,中正區,中船里,0,1,706,5,711,1311,3,1,3,0,1,0,54.23
基隆市,中正區,港通里,0,1,693,5,698,1228,3,1,3,0,1,0,56.84
基隆市,中正區,義重里,0,1,664,4,668,1169,3,1,3,0,1,0,57.1428571429
基隆市,中正區,正義里,0,1,796,3,799,1442,3,1,3,0,1,0,55.4091539528
基隆市,中正區,信義里,0,1,562,6,568,1007,3,1,3,0,1,0,56.41
基隆市,中正區,德義里,0,1,451,4,455,793,3,1,3,0,1,0,57.38
基隆市,信義區,仁壽里,0,1,701,4,705,1174,3,1,3,0,1,0,60.05
基隆市,信義區,仁義里,0,1,765,6,771,1231,3,1,3,0,1,0,62.63
基隆市,信義區,義昭里,0,1,557,1,558,974,3,1,3,0,1,0,57.29
基隆市,信義區,義幸里,0,1,1387,13,1400,2359,3,1,3,0,1,0,59.3471810089
基隆市,信義區,義民里,0,1,484,5,489,812,3,1,3,0,1,0,60.2216748768
基隆市,信義區,義和里,0,1,745,7,752,1245,3,1,3,0,1,0,60.40
基隆市,信義區,智慧里,0,1,414,4,418,684,3,1,3,0,1,0,61.11
基隆市,信義區,智誠里,0,1,907,10,917,1710,3,1,3,0,1,0,53.63
基隆市,信義區,禮儀里,0,1,838,4,842,1448,3,1,3,0,1,0,58.15
基隆市,信義區,禮東里,0,1,888,11,899,1539,3,1,3,0,1,0,58.41
基隆市,信義區,信綠里,0,1,1253,14,1267,2355,3,1,3,0,1,0,53.80
基隆市,信義區,東信里,0,1,1739,12,1751,3389,3,1,3,0,1,0,51.6671584538
基隆市,信義區,東光里,0,1,952,7,959,1836,3,1,3,0,1,0,52.2331154684
基隆市,信義區,東明里,0,1,1746,10,1756,3344,3,1,3,0,1,0,52.51
基隆市,信義區,東安里,0,1,1491,12,1503,2667,3,1,3,0,1,0,56.36
基隆市,信義區,孝賢里,0,1,2093,11,2104,3979,3,1,3,0,1,0,52.88
基隆市,信義區,孝德里,0,1,1958,10,1968,3899,3,1,3,0,1,0,50.47
基隆市,信義區,孝深里,0,1,1151,10,1161,2483,3,1,3,0,1,0,46.76
基隆市,信義區,孝岡里,0,1,455,8,463,908,3,1,3,0,1,0,50.99
基隆市,仁愛區,林泉里,0,1,934,12,946,1726,3,1,3,0,1,0,54.81
基隆市,仁愛區,花崗里,0,1,544,8,552,947,3,1,3,0,1,0,58.29
基隆市,仁愛區,虹橋里,0,1,869,8,877,1526,3,1,3,0,1,0,57.47
基隆市,仁愛區,水錦里,0,1,974,9,983,1756,3,1,3,0,1,0,55.979498861
基隆市,仁愛區,智仁里,0,1,1276,12,1288,2232,3,1,3,0,1,0,57.71
基隆市,仁愛區,和明里,0,1,580,4,584,1069,3,1,3,0,1,0,54.63
基隆市,仁愛區,忠勇里,0,1,554,3,557,1009,3,1,3,0,1,0,55.2031714569
基隆市,仁愛區,玉田里,0,1,602,1,603,1078,3,1,3,0,1,0,55.9369202226
基隆市,仁愛區,仁德里,0,1,574,3,577,1006,3,1,3,0,1,0,57.36
基隆市,仁愛區,博愛里,0,1,974,6,980,1722,3,1,3,0,1,0,56.91
基隆市,仁愛區,福仁里,0,1,447,5,452,857,3,1,3,0,1,0,52.74
基隆市,仁愛區,誠仁里,0,1,565,7,572,1033,3,1,3,0,1,0,55.37
基隆市,仁愛區,吉仁里,0,1,1442,8,1450,2822,3,1,3,0,1,0,51.38
基隆市,仁愛區,育仁里,0,1,486,3,489,884,3,1,3,0,1,0,55.32
基隆市,仁愛區,英仁里,0,1,760,6,766,1367,3,1,3,0,1,0,56.04
基隆市,仁愛區,龍門里,0,1,461,7,468,858,3,1,3,0,1,0,54.55
基隆市,仁愛區,德厚里,0,1,748,1,749,1363,3,1,3,0,1,0,54.95
基隆市,仁愛區,曲水里,0,1,515,3,518,956,3,1,3,0,1,0,54.18
基隆市,仁愛區,崇文里,0,1,498,4,502,942,3,1,3,0,1,0,53.29
基隆市,仁愛區,文安里,0,1,554,3,557,1032,3,1,3,0,1,0,53.97
基隆市,仁愛區,兆連里,0,1,431,2,433,771,3,1,3,0,1,0,56.16
基隆市,仁愛區,獅球里,0,1,622,8,630,1145,3,1,3,0,1,0,55.02
基隆市,仁愛區,書院里,0,1,676,7,683,1158,3,1,3,0,1,0,58.98
基隆市,仁愛區,朝棟里,0,1,1640,17,1657,2862,3,1,3,0,1,0,57.90
基隆市,仁愛區,光華里,0,1,1280,7,1287,2280,3,1,3,0,1,0,56.4473684211
基隆市,仁愛區,明德里,0,1,455,2,457,737,3,1,3,0,1,0,62.0081411126
基隆市,仁愛區,同風里,0,1,405,4,409,652,3,1,3,0,1,0,62.73
基隆市,仁愛區,文昌里,0,1,511,2,513,848,3,1,3,0,1,0,60.50
基隆市,仁愛區,新店里,0,1,409,5,414,690,3,1,3,0,1,0,60.00
基隆市,中山區,新建里,0,1,467,5,472,774,3,1,3,0,1,0,60.98
基隆市,中山區,安民里,0,1,653,8,661,1113,3,1,3,0,1,0,59.39
基隆市,中山區,安平里,0,1,573,10,583,982,3,1,3,0,1,0,59.37
基隆市,中山區,中山里,0,1,600,7,607,1086,3,1,3,0,1,0,55.89
基隆市,中山區,民治里,0,1,525,6,531,957,3,1,3,0,1,0,55.49
基隆市,中山區,中興里,0,1,726,12,738,1284,3,1,3,0,1,0,57.476635514
基隆市,中山區,仁正里,0,1,461,6,467,828,3,1,3,0,1,0,56.4009661836
基隆市,中山區,健民里,0,1,798,7,805,1410,3,1,3,0,1,0,57.0921985816
基隆市,中山區,通化里,0,1,636,9,645,1187,3,1,3,0,1,0,54.34
基隆市,中山區,居仁里,0,1,737,5,742,1467,3,1,3,0,1,0,50.58
基隆市,中山區,通明里,0,1,1053,11,1064,1971,3,1,3,0,1,0,53.98
基隆市,中山區,和平里,0,1,345,3,348,654,3,1,3,0,1,0,53.21
基隆市,中山區,仙洞里,0,1,380,3,383,727,3,1,3,0,1,0,52.6822558459
基隆市,中山區,太白里,0,1,515,3,518,943,3,1,3,0,1,0,54.9310710498
基隆市,中山區,協和里,0,1,876,12,888,1649,3,1,3,0,1,0,53.85
基隆市,中山區,文化里,0,1,559,5,564,1128,3,1,3,0,1,0,50.00
基隆市,中山區,德安里,0,1,1676,7,1683,3138,3,1,3,0,1,0,53.63
基隆市,中山區,德和里,0,1,2819,27,2846,4812,3,1,3,0,1,0,59.14
基隆市,中山區,中和里,0,1,2197,15,2212,4675,3,1,3,0,1,0,47.32
基隆市,中山區,和慶里,0,1,2210,18,2228,4977,3,1,3,0,1,0,44.77
基隆市,中山區,西康里,0,1,859,16,875,1632,3,1,3,0,1,0,53.62
基隆市,中山區,西定里,0,1,538,3,541,993,3,1,3,0,1,0,54.4813695871
基隆市,中山區,西華里,0,1,582,5,587,993,3,1,3,0,1,0,59.113796576
基隆市,中山區,西榮里,0,1,477,2,479,853,3,1,3,0,1,0,56.15
基隆市,安樂區,新西里,0,1,754,10,764,1453,3,1,3,0,1,0,52.58
基隆市,安樂區,西川里,0,1,713,8,721,1332,3,1,3,0,1,0,54.1291291291
基隆市,安樂區,定國里,0,1,658,3,661,1233,3,1,3,0,1,0,53.6090835361
基隆市,安樂區,定邦里,0,1,749,10,759,1302,3,1,3,0,1,0,58.29
基隆市,安樂區,慈仁里,0,1,547,5,552,1025,3,1,3,0,1,0,53.85
基隆市,安樂區,干城里,0,1,1265,9,1274,2274,3,1,3,0,1,0,56.02
基隆市,安樂區,永康里,0,1,1002,4,1006,1963,3,1,3,0,1,0,51.25
基隆市,安樂區,安和里,0,1,499,2,501,902,3,1,3,0,1,0,55.5432372506
基隆市,安樂區,樂一里,0,1,355,2,357,637,3,1,3,0,1,0,56.043956044
基隆市,安樂區,嘉仁里,0,1,1784,17,1801,3309,3,1,3,0,1,0,54.43
基隆市,安樂區,三民里,0,1,2690,18,2708,5306,3,1,3,0,1,0,51.04
基隆市,安樂區,四維里,0,1,2346,14,2360,4235,3,1,3,0,1,0,55.73
基隆市,安樂區,五福里,0,1,1818,15,1833,3429,3,1,3,0,1,0,53.46
基隆市,安樂區,六合里,0,1,1941,12,1953,3557,3,1,3,0,1,0,54.91
基隆市,安樂區,七賢里,0,1,1553,12,1565,2854,3,1,3,0,1,0,54.84
基隆市,安樂區,長樂里,0,1,1431,9,1440,2648,3,1,3,0,1,0,54.38
基隆市,安樂區,鶯歌里,0,1,1410,14,1424,2839,3,1,3,0,1,0,50.16
基隆市,安樂區,鶯安里,0,1,1258,4,1262,2504,3,1,3,0,1,0,50.40
基隆市,安樂區,興寮里,0,1,1545,10,1555,3500,3,1,3,0,1,0,44.43
基隆市,安樂區,外寮里,0,1,1614,18,1632,3301,3,1,3,0,1,0,49.44
基隆市,安樂區,新崙里,0,1,1504,8,1512,3105,3,1,3,0,1,0,48.70
基隆市,安樂區,武崙里,0,1,1657,8,1665,3492,3,1,3,0,1,0,47.6804123711
基隆市,安樂區,中崙里,0,1,653,4,657,1319,3,1,3,0,1,0,49.81
基隆市,安樂區,內寮里,0,1,1642,8,1650,3522,3,1,3,0,1,0,46.85
基隆市,暖暖區,八西里,0,1,735,6,741,1377,3,1,3,0,1,0,53.81
基隆市,暖暖區,八中里,0,1,334,1,335,613,3,1,3,0,1,0,54.6492659054
基隆市,暖暖區,八堵里,0,1,398,3,401,693,3,1,3,0,1,0,57.8643578644
基隆市,暖暖區,八南里,0,1,297,6,303,613,3,1,3,0,1,0,49.43
基隆市,暖暖區,過港里,0,1,1680,18,1698,3310,3,1,3,0,1,0,51.30
基隆市,暖暖區,暖暖里,0,1,1190,12,1202,2229,3,1,3,0,1,0,53.93
基隆市,暖暖區,暖同里,0,1,1174,6,1180,2275,3,1,3,0,1,0,51.8681318681
基隆市,暖暖區,暖東里,0,1,231,3,234,393,3,1,3,0,1,0,59.5419847328
基隆市,暖暖區,暖西里,0,1,1857,15,1872,3655,3,1,3,0,1,0,51.22
基隆市,暖暖區,碇內里,0,1,1175,12,1187,2237,3,1,3,0,1,0,53.06
基隆市,暖暖區,碇和里,0,1,1213,10,1223,2253,3,1,3,0,1,0,54.28
基隆市,暖暖區,碇祥里,0,1,1560,7,1567,3387,3,1,3,0,1,0,46.2651313847
基隆市,暖暖區,碇安里,0,1,2212,18,2230,4376,3,1,3,0,1,0,50.96
基隆市,七堵區,長興里,0,1,1912,15,1927,3647,3,1,3,0,1,0,52.84
基隆市,七堵區,正光里,0,1,1236,19,1255,2230,3,1,3,0,1,0,56.28
基隆市,七堵區,正明里,0,1,1098,11,1109,1957,3,1,3,0,1,0,56.67
基隆市,七堵區,富民里,0,1,2041,16,2057,3626,3,1,3,0,1,0,56.73
基隆市,七堵區,永平里,0,1,1149,13,1162,2010,3,1,3,0,1,0,57.81
基隆市,七堵區,永安里,0,1,1054,5,1059,2002,3,1,3,0,1,0,52.90
基隆市,七堵區,八德里,0,1,787,5,792,1538,3,1,3,0,1,0,51.50
基隆市,七堵區,自強里,0,1,467,11,478,926,3,1,3,0,1,0,51.62
基隆市,七堵區,泰安里,0,1,1559,14,1573,3210,3,1,3,0,1,0,49.0031152648
基隆市,七堵區,六堵里,0,1,698,9,707,1415,3,1,3,0,1,0,49.964664311
基隆市,七堵區,堵南里,0,1,1479,12,1491,3259,3,1,3,0,1,0,45.75
基隆市,七堵區,堵北里,0,1,1518,13,1531,3046,3,1,3,0,1,0,50.2626395272
基隆市,七堵區,百福里,0,1,2075,10,2085,4485,3,1,3,0,1,0,46.49
基隆市,七堵區,實踐里,0,1,1544,11,1555,3351,3,1,3,0,1,0,46.40
基隆市,七堵區,瑪南里,0,1,243,1,244,451,3,1,3,0,1,0,54.10
基隆市,七堵區,瑪東里,0,1,182,0,182,300,3,1,3,0,1,0,60.67
基隆市,七堵區,瑪西里,0,1,201,4,205,350,3,1,3,0,1,0,58.57
基隆市,七堵區,友一里,0,1,739,3,742,1409,3,1,3,0,1,0,52.6614620298
基隆市,七堵區,友二里,0,1,256,1,257,438,3,1,3,0,1,0,58.6757990868
新竹市,東區,育賢里,0,1,512,5,517,1232,3,1,3,0,1,0,41.96
新竹市,東區,親仁里,0,1,938,3,941,1735,3,1,3,0,1,0,54.24
新竹市,東區,東門里,0,1,411,3,414,708,3,1,3,0,1,0,58.47
新竹市,東區,成功里,0,1,411,2,413,757,3,1,3,0,1,0,54.56
新竹市,東區,榮光里,0,1,228,2,230,442,3,1,3,0,1,0,52.04
新竹市,東區,中正里,0,1,282,2,284,481,3,1,3,0,1,0,59.04
新竹市,東區,錦華里,0,1,992,6,998,1735,3,1,3,0,1,0,57.52
新竹市,東區,文華里,0,1,1989,11,2000,3530,3,1,3,0,1,0,56.66
新竹市,東區,復中里,0,1,2074,24,2098,3837,3,1,3,0,1,0,54.68
新竹市,東區,復興里,0,1,1957,6,1963,3624,3,1,3,0,1,0,54.17
新竹市,東區,三民里,0,1,2209,11,2220,3908,3,1,3,0,1,0,56.8065506653
新竹市,東區,東園里,0,1,1447,14,1461,2597,3,1,3,0,1,0,56.26
新竹市,東區,公園里,0,1,1261,8,1269,2244,3,1,3,0,1,0,56.55
新竹市,東區,建華里,0,1,1183,4,1187,2128,3,1,3,0,1,0,55.78
新竹市,東區,東山里,0,1,1661,17,1678,2880,3,1,3,0,1,0,58.26
新竹市,東區,綠水里,0,1,2415,13,2428,4286,3,1,3,0,1,0,56.6495566962
新竹市,東區,東勢里,0,1,571,4,575,1059,3,1,3,0,1,0,54.2965061379
新竹市,東區,光復里,0,1,1013,2,1015,1846,3,1,3,0,1,0,54.98
新竹市,東區,前溪里,0,1,1282,15,1297,2472,3,1,3,0,1,0,52.47
新竹市,東區,水源里,0,1,1679,24,1703,3058,3,1,3,0,1,0,55.6899934598
新竹市,東區,千甲里,0,1,1039,14,1053,1759,3,1,3,0,1,0,59.8635588403
新竹市,東區,豐功里,0,1,1440,9,1449,2513,3,1,3,0,1,0,57.66
新竹市,東區,武功里,0,1,2245,6,2251,3506,3,1,3,0,1,0,64.20
新竹市,東區,軍功里,0,1,1933,12,1945,3269,3,1,3,0,1,0,59.50
新竹市,東區,立功里,0,1,499,5,504,852,3,1,3,0,1,0,59.15
新竹市,東區,建功里,0,1,1382,11,1393,2184,3,1,3,0,1,0,63.78
新竹市,東區,光明里,0,1,1828,9,1837,3210,3,1,3,0,1,0,57.23
新竹市,東區,龍山里,0,1,1512,10,1522,2768,3,1,3,0,1,0,54.99
新竹市,東區,科園里,0,1,3013,16,3029,5109,3,1,3,0,1,0,59.29
新竹市,東區,埔頂里,0,1,1271,11,1282,2264,3,1,3,0,1,0,56.63
新竹市,東區,新莊里,0,1,2150,19,2169,3946,3,1,3,0,1,0,54.9670552458
新竹市,東區,關東里,0,1,1961,16,1977,3623,3,1,3,0,1,0,54.57
新竹市,東區,金山里,0,1,2306,11,2317,4345,3,1,3,0,1,0,53.33
新竹市,東區,仙水里,0,1,1859,8,1867,3349,3,1,3,0,1,0,55.75
新竹市,東區,仙宮里,0,1,537,0,537,874,3,1,3,0,1,0,61.44
新竹市,東區,關帝里,0,1,318,1,319,591,3,1,3,0,1,0,53.98
新竹市,東區,南門里,0,1,391,3,394,688,3,1,3,0,1,0,57.27
新竹市,東區,南市里,0,1,510,3,513,887,3,1,3,0,1,0,57.84
新竹市,東區,福德里,0,1,711,8,719,1300,3,1,3,0,1,0,55.31
新竹市,東區,振興里,0,1,2315,14,2329,4491,3,1,3,0,1,0,51.86
新竹市,東區,新興里,0,1,1718,14,1732,3083,3,1,3,0,1,0,56.18
新竹市,東區,寺前里,0,1,459,1,460,858,3,1,3,0,1,0,53.61
新竹市,東區,竹蓮里,0,1,476,3,479,813,3,1,3,0,1,0,58.92
新竹市,東區,下竹里,0,1,389,5,394,712,3,1,3,0,1,0,55.34
新竹市,東區,頂竹里,0,1,1628,7,1635,2976,3,1,3,0,1,0,54.94
新竹市,東區,南大里,0,1,813,5,818,1496,3,1,3,0,1,0,54.679144385
新竹市,東區,新光里,0,1,1722,11,1733,3249,3,1,3,0,1,0,53.34
新竹市,東區,光鎮里,0,1,1557,11,1568,3018,3,1,3,0,1,0,51.95
新竹市,東區,高峰里,0,1,2597,20,2617,5001,3,1,3,0,1,0,52.3295340932
新竹市,東區,湖濱里,0,1,1518,16,1534,2926,3,1,3,0,1,0,52.4265208476
新竹市,東區,柴橋里,0,1,1861,7,1868,3472,3,1,3,0,1,0,53.80
新竹市,東區,明湖里,0,1,1470,6,1476,3225,3,1,3,0,1,0,45.77
新竹市,北區,西門里,0,1,273,5,278,521,3,1,3,0,1,0,53.358925144
新竹市,北區,潛園里,0,1,469,5,474,793,3,1,3,0,1,0,59.7730138714
新竹市,北區,中央里,0,1,335,3,338,528,3,1,3,0,1,0,64.0151515152
新竹市,北區,石坊里,0,1,293,2,295,538,3,1,3,0,1,0,54.83
新竹市,北區,仁德里,0,1,413,5,418,743,3,1,3,0,1,0,56.26
新竹市,北區,崇禮里,0,1,699,6,705,1168,3,1,3,0,1,0,60.36
新竹市,北區,興南里,0,1,685,4,689,1236,3,1,3,0,1,0,55.74
新竹市,北區,育英里,0,1,1806,9,1815,3403,3,1,3,0,1,0,53.34
新竹市,北區,台溪里,0,1,640,6,646,1291,3,1,3,0,1,0,50.04
新竹市,北區,曲溪里,0,1,2537,24,2561,4698,3,1,3,0,1,0,54.51
新竹市,北區,西雅里,0,1,1395,10,1405,2511,3,1,3,0,1,0,55.9538032656
新竹市,北區,客雅里,0,1,1499,16,1515,2740,3,1,3,0,1,0,55.29
新竹市,北區,南勢里,0,1,1879,25,1904,3422,3,1,3,0,1,0,55.64
新竹市,北區,大鵬里,0,1,967,11,978,1471,3,1,3,0,1,0,66.49
新竹市,北區,大同里,0,1,390,6,396,712,3,1,3,0,1,0,55.62
新竹市,北區,中山里,0,1,391,2,393,656,3,1,3,0,1,0,59.91
新竹市,北區,中興里,0,1,334,3,337,582,3,1,3,0,1,0,57.90
新竹市,北區,新民里,0,1,710,12,722,1275,3,1,3,0,1,0,56.6274509804
新竹市,北區,長和里,0,1,644,3,647,1157,3,1,3,0,1,0,55.9204840104
新竹市,北區,北門里,0,1,521,3,524,906,3,1,3,0,1,0,57.8366445916
新竹市,北區,民富里,0,1,1986,19,2005,4015,3,1,3,0,1,0,49.94
新竹市,北區,磐石里,0,1,2124,11,2135,4108,3,1,3,0,1,0,51.97
新竹市,北區,新雅里,0,1,1886,13,1899,3641,3,1,3,0,1,0,52.16
新竹市,北區,文雅里,0,1,1744,16,1760,3163,3,1,3,0,1,0,55.64
新竹市,北區,水田里,0,1,1512,6,1518,2673,3,1,3,0,1,0,56.79
新竹市,北區,光田里,0,1,1139,6,1145,2014,3,1,3,0,1,0,56.85
新竹市,北區,光華里,0,1,1407,7,1414,3089,3,1,3,0,1,0,45.78
新竹市,北區,金華里,0,1,1898,12,1910,3718,3,1,3,0,1,0,51.37
新竹市,北區,湳雅里,0,1,1323,9,1332,2558,3,1,3,0,1,0,52.07
新竹市,北區,金雅里,0,1,780,6,786,1356,3,1,3,0,1,0,57.96
新竹市,北區,湳中里,0,1,2343,20,2363,4559,3,1,3,0,1,0,51.83
新竹市,北區,舊社里,0,1,2421,11,2432,4738,3,1,3,0,1,0,51.3296749683
新竹市,北區,金竹里,0,1,2172,13,2185,4280,3,1,3,0,1,0,51.05
新竹市,北區,武陵里,0,1,1254,4,1258,1965,3,1,3,0,1,0,64.02
新竹市,北區,福林里,0,1,1689,11,1700,2913,3,1,3,0,1,0,58.36
新竹市,北區,境福里,0,1,2024,15,2039,3756,3,1,3,0,1,0,54.29
新竹市,北區,士林里,0,1,1762,11,1773,2830,3,1,3,0,1,0,62.65
新竹市,北區,古賢里,0,1,429,5,434,875,3,1,3,0,1,0,49.60
新竹市,北區,南寮里,0,1,1943,12,1955,3819,3,1,3,0,1,0,51.1914113642
新竹市,北區,康樂里,0,1,952,7,959,1765,3,1,3,0,1,0,54.33
新竹市,北區,中寮里,0,1,809,6,815,1542,3,1,3,0,1,0,52.85
新竹市,北區,海濱里,0,1,921,6,927,1838,3,1,3,0,1,0,50.44
新竹市,北區,港北里,0,1,676,3,679,1191,3,1,3,0,1,0,57.01
新竹市,北區,舊港里,0,1,322,4,326,554,3,1,3,0,1,0,58.84
新竹市,香山區,頂埔里,0,1,1278,7,1285,2642,3,1,3,0,1,0,48.64
新竹市,香山區,頂福里,0,1,1417,10,1427,2785,3,1,3,0,1,0,51.24
新竹市,香山區,中埔里,0,1,1260,7,1267,2417,3,1,3,0,1,0,52.42
新竹市,香山區,牛埔里,0,1,1237,8,1245,2474,3,1,3,0,1,0,50.32
新竹市,香山區,埔前里,0,1,1385,9,1394,2506,3,1,3,0,1,0,55.63
新竹市,香山區,樹下里,0,1,966,14,980,1877,3,1,3,0,1,0,52.21
新竹市,香山區,浸水里,0,1,874,6,880,1603,3,1,3,0,1,0,54.90
新竹市,香山區,虎林里,0,1,1148,8,1156,1991,3,1,3,0,1,0,58.0612757408
新竹市,香山區,虎山里,0,1,2380,32,2412,4766,3,1,3,0,1,0,50.60847671
新竹市,香山區,港南里,0,1,1009,8,1017,1903,3,1,3,0,1,0,53.44
新竹市,香山區,東香里,0,1,1278,5,1283,2422,3,1,3,0,1,0,52.97
新竹市,香山區,香村里,0,1,1036,9,1045,2059,3,1,3,0,1,0,50.75
新竹市,香山區,香山里,0,1,1363,9,1372,2799,3,1,3,0,1,0,49.02
新竹市,香山區,大庄里,0,1,1103,5,1108,2053,3,1,3,0,1,0,53.9698002923
新竹市,香山區,美山里,0,1,512,5,517,980,3,1,3,0,1,0,52.7551020408
新竹市,香山區,朝山里,0,1,899,4,903,1708,3,1,3,0,1,0,52.87
新竹市,香山區,海山里,0,1,955,9,964,1887,3,1,3,0,1,0,51.09
新竹市,香山區,鹽水里,0,1,645,8,653,1178,3,1,3,0,1,0,55.43
新竹市,香山區,內湖里,0,1,1684,16,1700,3501,3,1,3,0,1,0,48.56
新竹市,香山區,南港里,0,1,438,4,442,801,3,1,3,0,1,0,55.18
新竹市,香山區,中隘里,0,1,693,7,700,1332,3,1,3,0,1,0,52.55
新竹市,香山區,南隘里,0,1,339,4,343,641,3,1,3,0,1,0,53.51
新竹市,香山區,大湖里,0,1,366,5,371,722,3,1,3,0,1,0,51.39
新竹市,香山區,茄苳里,0,1,424,5,429,800,3,1,3,0,1,0,53.63
臺中市,中區,綠川里,0,1,1116,11,1127,1928,3,1,3,0,1,0,58.45
臺中市,中區,繼光里,0,1,976,4,980,1705,3,1,3,0,1,0,57.48
臺中市,中區,公園里,0,1,922,3,925,1696,3,1,3,0,1,0,54.54
臺中市,中區,光復里,0,1,1365,10,1375,2436,3,1,3,0,1,0,56.44
臺中市,中區,大墩里,0,1,1323,12,1335,2417,3,1,3,0,1,0,55.23
臺中市,中區,柳川里,0,1,1047,7,1054,1860,3,1,3,0,1,0,56.67
臺中市,中區,大誠里,0,1,1203,12,1215,2038,3,1,3,0,1,0,59.62
臺中市,中區,中華里,0,1,1047,8,1055,1828,3,1,3,0,1,0,57.71
臺中市,東區,新庄里,0,1,1892,23,1915,3404,3,1,3,0,1,0,56.26
臺中市,東區,振興里,0,1,2018,15,2033,3317,3,1,3,0,1,0,61.29
臺中市,東區,東橋里,0,1,1919,11,1930,3339,3,1,3,0,1,0,57.80
臺中市,東區,東興里,0,1,1718,10,1728,2915,3,1,3,0,1,0,59.28
臺中市,東區,泉源里,0,1,1086,10,1096,1829,3,1,3,0,1,0,59.92
臺中市,東區,干城里,0,1,1451,7,1458,2417,3,1,3,0,1,0,60.32
臺中市,東區,旱溪里,0,1,1382,4,1386,2365,3,1,3,0,1,0,58.60
臺中市,東區,樂成里,0,1,1068,10,1078,1872,3,1,3,0,1,0,57.59
臺中市,東區,東門里,0,1,2903,13,2916,4822,3,1,3,0,1,0,60.47
臺中市,東區,十甲里,0,1,1571,21,1592,2782,3,1,3,0,1,0,57.23
臺中市,東區,東英里,0,1,2211,20,2231,4003,3,1,3,0,1,0,55.73
臺中市,東區,東南里,0,1,1949,17,1966,3309,3,1,3,0,1,0,59.41
臺中市,東區,東勢里,0,1,1636,8,1644,2834,3,1,3,0,1,0,58.01
臺中市,東區,合作里,0,1,1527,8,1535,2577,3,1,3,0,1,0,59.57
臺中市,東區,富仁里,0,1,1998,14,2012,3248,3,1,3,0,1,0,61.95
臺中市,東區,富臺里,0,1,1006,4,1010,1653,3,1,3,0,1,0,61.10
臺中市,東區,東信里,0,1,3230,27,3257,5398,3,1,3,0,1,0,60.34
臺中市,西區,三民里,0,1,1044,6,1050,2171,3,1,3,0,1,0,48.36
臺中市,西區,平和里,0,1,960,7,967,1776,3,1,3,0,1,0,54.45
臺中市,西區,利民里,0,1,1092,8,1100,1966,3,1,3,0,1,0,55.95
臺中市,西區,公民里,0,1,2367,21,2388,4184,3,1,3,0,1,0,57.07
臺中市,西區,廣民里,0,1,1029,12,1041,1756,3,1,3,0,1,0,59.28
臺中市,西區,東昇里,0,1,1337,4,1341,2274,3,1,3,0,1,0,58.97
臺中市,西區,民生里,0,1,1235,6,1241,2086,3,1,3,0,1,0,59.49
臺中市,西區,昇平里,0,1,2672,19,2691,4903,3,1,3,0,1,0,54.88
臺中市,西區,藍興里,0,1,1849,10,1859,3119,3,1,3,0,1,0,59.60
臺中市,西區,公館里,0,1,2797,25,2822,4703,3,1,3,0,1,0,60.00
臺中市,西區,和龍里,0,1,1232,15,1247,2165,3,1,3,0,1,0,57.60
臺中市,西區,民龍里,0,1,1376,9,1385,2453,3,1,3,0,1,0,56.46
臺中市,西區,安龍里,0,1,1402,9,1411,2516,3,1,3,0,1,0,56.08
臺中市,西區,吉龍里,0,1,3053,28,3081,5394,3,1,3,0,1,0,57.12
臺中市,西區,後龍里,0,1,1725,10,1735,3046,3,1,3,0,1,0,56.96
臺中市,西區,中興里,0,1,1932,20,1952,3202,3,1,3,0,1,0,60.96
臺中市,西區,忠明里,0,1,2535,20,2555,4585,3,1,3,0,1,0,55.73
臺中市,西區,公正里,0,1,2567,13,2580,4681,3,1,3,0,1,0,55.12
臺中市,西區,公平里,0,1,1987,9,1996,3684,3,1,3,0,1,0,54.18
臺中市,西區,公德里,0,1,1776,15,1791,3293,3,1,3,0,1,0,54.39
臺中市,西區,公益里,0,1,1676,10,1686,2745,3,1,3,0,1,0,61.42
臺中市,西區,土庫里,0,1,2595,26,2621,4524,3,1,3,0,1,0,57.94
臺中市,西區,忠誠里,0,1,2884,17,2901,5110,3,1,3,0,1,0,56.77
臺中市,西區,大忠里,0,1,1694,8,1702,2831,3,1,3,0,1,0,60.12
臺中市,西區,吉龍里,0,1,1639,8,1647,2776,3,1,3,0,1,0,59.33
臺中市,南區,長春里,0,1,1249,7,1256,2227,3,1,3,0,1,0,56.40
臺中市,南區,長榮里,0,1,1550,12,1562,2500,3,1,3,0,1,0,62.48
臺中市,南區,城隍里,0,1,2020,16,2036,3349,3,1,3,0,1,0,60.79
臺中市,南區,國光里,0,1,2150,19,2169,3563,3,1,3,0,1,0,60.88
臺中市,南區,南門里,0,1,1832,10,1842,3216,3,1,3,0,1,0,57.28
臺中市,南區,德義里,0,1,1453,5,1458,2489,3,1,3,0,1,0,58.58
臺中市,南區,積善里,0,1,1500,10,1510,2640,3,1,3,0,1,0,57.20
臺中市,南區,江川里,0,1,1273,6,1279,2224,3,1,3,0,1,0,57.51
臺中市,南區,新榮里,0,1,1527,7,1534,3286,3,1,3,0,1,0,46.68
臺中市,南區,福興里,0,1,1996,12,2008,3409,3,1,3,0,1,0,58.90
臺中市,南區,福平里,0,1,2334,22,2356,4409,3,1,3,0,1,0,53.44
臺中市,南區,福順里,0,1,1784,26,1810,3221,3,1,3,0,1,0,56.19
臺中市,南區,和平里,0,1,1173,11,1184,2330,3,1,3,0,1,0,50.82
臺中市,南區,平和里,0,1,1742,14,1756,2985,3,1,3,0,1,0,58.83
臺中市,南區,南和里,0,1,2072,22,2094,3907,3,1,3,0,1,0,53.60
臺中市,南區,永興里,0,1,2355,19,2374,4390,3,1,3,0,1,0,54.08
臺中市,南區,永和里,0,1,1686,15,1701,3050,3,1,3,0,1,0,55.77
臺中市,南區,樹義里,0,1,3427,32,3459,6794,3,1,3,0,1,0,50.91
臺中市,南區,工學里,0,1,2024,7,2031,3787,3,1,3,0,1,0,53.63
臺中市,南區,樹德里,0,1,2515,15,2530,4983,3,1,3,0,1,0,50.77
臺中市,南區,西川里,0,1,1723,9,1732,3021,3,1,3,0,1,0,57.33
臺中市,南區,崇倫里,0,1,2040,13,2053,3323,3,1,3,0,1,0,61.78
臺中市,北區,中正里,0,1,955,4,959,1609,3,1,3,0,1,0,59.60
臺中市,北區,六合里,0,1,953,4,957,1675,3,1,3,0,1,0,57.13
臺中市,北區,光大里,0,1,1013,9,1022,1872,3,1,3,0,1,0,54.59
臺中市,北區,文莊里,0,1,2028,12,2040,3228,3,1,3,0,1,0,63.20
臺中市,北區,大湖里,0,1,1244,9,1253,2218,3,1,3,0,1,0,56.49
臺中市,北區,五常里,0,1,688,6,694,1279,3,1,3,0,1,0,54.26
臺中市,北區,錦平里,0,1,995,13,1008,1829,3,1,3,0,1,0,55.11
臺中市,北區,新北里,0,1,1220,5,1225,2163,3,1,3,0,1,0,56.63
臺中市,北區,新興里,0,1,1110,9,1119,1985,3,1,3,0,1,0,56.37
臺中市,北區,樂英里,0,1,1964,17,1981,3186,3,1,3,0,1,0,62.18
臺中市,北區,錦村里,0,1,1753,10,1763,2954,3,1,3,0,1,0,59.68
臺中市,北區,建成里,0,1,2127,15,2142,4027,3,1,3,0,1,0,53.19
臺中市,北區,建德里,0,1,1972,13,1985,3298,3,1,3,0,1,0,60.19
臺中市,北區,錦洲里,0,1,1519,12,1531,2617,3,1,3,0,1,0,58.50
臺中市,北區,錦祥里,0,1,1496,9,1505,2847,3,1,3,0,1,0,52.86
臺中市,北區,金華里,0,1,860,7,867,1531,3,1,3,0,1,0,56.63
臺中市,北區,金龍里,0,1,2331,12,2343,4196,3,1,3,0,1,0,55.84
臺中市,北區,邱厝里,0,1,898,6,904,1688,3,1,3,0,1,0,53.55
臺中市,北區,建興里,0,1,2822,14,2836,5158,3,1,3,0,1,0,54.98
臺中市,北區,頂厝里,0,1,1762,12,1774,3322,3,1,3,0,1,0,53.40
臺中市,北區,崇德里,0,1,1579,7,1586,2748,3,1,3,0,1,0,57.71
臺中市,北區,賴厝里,0,1,1612,6,1618,3775,3,1,3,0,1,0,42.86
臺中市,北區,賴福里,0,1,1393,10,1403,2435,3,1,3,0,1,0,57.62
臺中市,北區,賴興里,0,1,1602,11,1613,3067,3,1,3,0,1,0,52.59
臺中市,北區,賴旺里,0,1,1817,8,1825,3606,3,1,3,0,1,0,50.61
臺中市,北區,賴明里,0,1,1657,12,1669,3231,3,1,3,0,1,0,51.66
臺中市,北區,梅川里,0,1,1189,5,1194,2277,3,1,3,0,1,0,52.44
臺中市,北區,賴村里,0,1,2211,17,2228,3932,3,1,3,0,1,0,56.66
臺中市,北區,育德里,0,1,1633,10,1643,2964,3,1,3,0,1,0,55.43
臺中市,北區,淡溝里,0,1,2222,15,2237,3785,3,1,3,0,1,0,59.10
臺中市,北區,健行里,0,1,3133,20,3153,5557,3,1,3,0,1,0,56.74
臺中市,北區,明德里,0,1,2450,11,2461,4288,3,1,3,0,1,0,57.39
臺中市,北區,明新里,0,1,1349,3,1352,2576,3,1,3,0,1,0,52.48
臺中市,北區,長青里,0,1,2685,18,2703,4897,3,1,3,0,1,0,55.20
臺中市,北區,立人里,0,1,1482,7,1489,2830,3,1,3,0,1,0,52.61
臺中市,北區,中達里,0,1,1392,8,1400,2453,3,1,3,0,1,0,57.07
臺中市,西屯區,西安里,0,1,2185,17,2202,3767,3,1,3,0,1,0,58.46
臺中市,西屯區,至善里,0,1,1542,5,1547,2931,3,1,3,0,1,0,52.78
臺中市,西屯區,西平里,0,1,2782,18,2800,4721,3,1,3,0,1,0,59.31
臺中市,西屯區,西墩里,0,1,2107,14,2121,3627,3,1,3,0,1,0,58.48
臺中市,西屯區,潮洋里,0,1,1378,14,1392,2370,3,1,3,0,1,0,58.73
臺中市,西屯區,龍潭里,0,1,591,1,592,937,3,1,3,0,1,0,63.18
臺中市,西屯區,惠來里,0,1,2954,24,2978,5247,3,1,3,0,1,0,56.76
臺中市,西屯區,上石里,0,1,1603,9,1612,3254,3,1,3,0,1,0,49.54
臺中市,西屯區,上安里,0,1,1415,7,1422,2737,3,1,3,0,1,0,51.95
臺中市,西屯區,上德里,0,1,2042,23,2065,3590,3,1,3,0,1,0,57.52
臺中市,西屯區,逢甲里,0,1,2079,15,2094,3860,3,1,3,0,1,0,54.25
臺中市,西屯區,逢福里,0,1,2389,21,2410,4209,3,1,3,0,1,0,57.26
臺中市,西屯區,何厝里,0,1,1325,6,1331,2584,3,1,3,0,1,0,51.51
臺中市,西屯區,何明里,0,1,1700,9,1709,3162,3,1,3,0,1,0,54.05
臺中市,西屯區,何南里,0,1,1848,15,1863,3360,3,1,3,0,1,0,55.45
臺中市,西屯區,何成里,0,1,2808,17,2825,5401,3,1,3,0,1,0,52.31
臺中市,西屯區,何安里,0,1,2152,13,2165,4343,3,1,3,0,1,0,49.85
臺中市,西屯區,何仁里,0,1,2617,16,2633,4958,3,1,3,0,1,0,53.11
臺中市,西屯區,何德里,0,1,1598,6,1604,2941,3,1,3,0,1,0,54.54
臺中市,西屯區,何福里,0,1,1960,13,1973,3568,3,1,3,0,1,0,55.30
臺中市,西屯區,何源里,0,1,2720,17,2737,4971,3,1,3,0,1,0,55.06
臺中市,西屯區,大河里,0,1,1903,16,1919,3312,3,1,3,0,1,0,57.94
臺中市,西屯區,大石里,0,1,605,7,612,940,3,1,3,0,1,0,65.11
臺中市,西屯區,大福里,0,1,1629,7,1636,2872,3,1,3,0,1,0,56.96
臺中市,西屯區,大鵬里,0,1,2286,14,2300,3982,3,1,3,0,1,0,57.76
臺中市,西屯區,港尾里,0,1,2698,16,2714,4710,3,1,3,0,1,0,57.62
臺中市,西屯區,廣福里,0,1,1319,13,1332,2132,3,1,3,0,1,0,62.48
臺中市,西屯區,林厝里,0,1,1540,19,1559,2606,3,1,3,0,1,0,59.82
臺中市,西屯區,永安里,0,1,3251,18,3269,5522,3,1,3,0,1,0,59.20
臺中市,西屯區,福安里,0,1,1051,2,1053,1983,3,1,3,0,1,0,53.10
臺中市,西屯區,福雅里,0,1,1886,12,1898,3529,3,1,3,0,1,0,53.78
臺中市,西屯區,福林里,0,1,2118,22,2140,3847,3,1,3,0,1,0,55.63
臺中市,西屯區,福瑞里,0,1,1092,4,1096,2057,3,1,3,0,1,0,53.28
臺中市,西屯區,福聯里,0,1,871,4,875,1740,3,1,3,0,1,0,50.29
臺中市,西屯區,福和里,0,1,1813,9,1822,3100,3,1,3,0,1,0,58.77
臺中市,西屯區,福中里,0,1,1307,5,1312,2302,3,1,3,0,1,0,56.99
臺中市,西屯區,福恩里,0,1,1574,5,1579,3069,3,1,3,0,1,0,51.45
臺中市,西屯區,協和里,0,1,1826,11,1837,3145,3,1,3,0,1,0,58.41
臺中市,南屯區,南屯里,0,1,2819,33,2852,5064,3,1,3,0,1,0,56.32
臺中市,南屯區,豐樂里,0,1,3504,18,3522,6520,3,1,3,0,1,0,54.02
臺中市,南屯區,楓樹里,0,1,2490,28,2518,4032,3,1,3,0,1,0,62.45
臺中市,南屯區,中和里,0,1,2300,20,2320,3903,3,1,3,0,1,0,59.44
臺中市,南屯區,鎮平里,0,1,982,6,988,1503,3,1,3,0,1,0,65.74
臺中市,南屯區,永定里,0,1,1721,12,1733,3163,3,1,3,0,1,0,54.79
臺中市,南屯區,春社里,0,1,2585,27,2612,4536,3,1,3,0,1,0,57.58
臺中市,南屯區,春安里,0,1,1529,9,1538,2356,3,1,3,0,1,0,65.28
臺中市,南屯區,文山里,0,1,2496,18,2514,4849,3,1,3,0,1,0,51.85
臺中市,南屯區,寶山里,0,1,1644,14,1658,3045,3,1,3,0,1,0,54.45
臺中市,南屯區,新生里,0,1,736,7,743,1298,3,1,3,0,1,0,57.24
臺中市,南屯區,三義里,0,1,2129,12,2141,4167,3,1,3,0,1,0,51.38
臺中市,南屯區,三和里,0,1,2297,21,2318,4470,3,1,3,0,1,0,51.86
臺中市,南屯區,三厝里,0,1,2386,17,2403,4424,3,1,3,0,1,0,54.32
臺中市,南屯區,黎明里,0,1,2389,16,2405,4011,3,1,3,0,1,0,59.96
臺中市,南屯區,文心里,0,1,1454,11,1465,2726,3,1,3,0,1,0,53.74
臺中市,南屯區,田心里,0,1,2355,24,2379,4107,3,1,3,0,1,0,57.93
臺中市,南屯區,向心里,0,1,1492,9,1501,2684,3,1,3,0,1,0,55.92
臺中市,南屯區,同心里,0,1,2075,19,2094,3863,3,1,3,0,1,0,54.21
臺中市,南屯區,大興里,0,1,1832,13,1845,3235,3,1,3,0,1,0,57.03
臺中市,南屯區,大同里,0,1,2051,15,2066,3658,3,1,3,0,1,0,56.48
臺中市,南屯區,大誠里,0,1,1256,9,1265,2313,3,1,3,0,1,0,54.69
臺中市,南屯區,大業里,0,1,2514,17,2531,4750,3,1,3,0,1,0,53.28
臺中市,南屯區,溝墘里,0,1,1942,8,1950,3465,3,1,3,0,1,0,56.28
臺中市,南屯區,惠中里,0,1,2236,10,2246,4309,3,1,3,0,1,0,52.12
臺中市,北屯區,北屯里,0,1,1652,8,1660,3009,3,1,3,0,1,0,55.17
臺中市,北屯區,北京里,0,1,1833,13,1846,3181,3,1,3,0,1,0,58.03
臺中市,北屯區,北興里,0,1,1792,18,1810,3066,3,1,3,0,1,0,59.03
臺中市,北屯區,三光里,0,1,3032,25,3057,5546,3,1,3,0,1,0,55.12
臺中市,北屯區,三和里,0,1,2558,14,2572,4700,3,1,3,0,1,0,54.72
臺中市,北屯區,水景里,0,1,3610,19,3629,6141,3,1,3,0,1,0,59.09
臺中市,北屯區,軍功里,0,1,3731,41,3772,6404,3,1,3,0,1,0,58.90
臺中市,北屯區,平昌里,0,1,1953,14,1967,3613,3,1,3,0,1,0,54.44
臺中市,北屯區,水湳里,0,1,3398,19,3417,5911,3,1,3,0,1,0,57.81
臺中市,北屯區,陳平里,0,1,1803,12,1815,3275,3,1,3,0,1,0,55.42
臺中市,北屯區,忠平里,0,1,1762,6,1768,3136,3,1,3,0,1,0,56.38
臺中市,北屯區,新平里,0,1,2483,14,2497,4334,3,1,3,0,1,0,57.61
臺中市,北屯區,大德里,0,1,2448,21,2469,4205,3,1,3,0,1,0,58.72
臺中市,北屯區,仁愛里,0,1,784,15,799,1424,3,1,3,0,1,0,56.11
臺中市,北屯區,仁和里,0,1,2615,16,2631,5050,3,1,3,0,1,0,52.10
臺中市,北屯區,仁美里,0,1,3243,22,3265,5234,3,1,3,0,1,0,62.38
臺中市,北屯區,同榮里,0,1,3160,19,3179,5377,3,1,3,0,1,0,59.12
臺中市,北屯區,后庄里,0,1,3748,26,3774,6463,3,1,3,0,1,0,58.39
臺中市,北屯區,四民里,0,1,1265,9,1274,1953,3,1,3,0,1,0,65.23
臺中市,北屯區,松竹里,0,1,2688,14,2702,5127,3,1,3,0,1,0,52.70
臺中市,北屯區,和平里,0,1,2894,21,2915,4844,3,1,3,0,1,0,60.18
臺中市,北屯區,部子里,0,1,980,8,988,1631,3,1,3,0,1,0,60.58
臺中市,北屯區,東山里,0,1,1042,5,1047,1600,3,1,3,0,1,0,65.44
臺中市,北屯區,大坑里,0,1,1040,10,1050,1728,3,1,3,0,1,0,60.76
臺中市,北屯區,民政里,0,1,504,1,505,895,3,1,3,0,1,0,56.42
臺中市,北屯區,民德里,0,1,493,2,495,811,3,1,3,0,1,0,61.04
臺中市,北屯區,平安里,0,1,2483,26,2509,4307,3,1,3,0,1,0,58.25
臺中市,北屯區,平和里,0,1,1776,12,1788,3467,3,1,3,0,1,0,51.57
臺中市,北屯區,平心里,0,1,1644,12,1656,3243,3,1,3,0,1,0,51.06
臺中市,北屯區,平陽里,0,1,1841,12,1853,3495,3,1,3,0,1,0,53.02
臺中市,北屯區,平德里,0,1,2418,11,2429,4522,3,1,3,0,1,0,53.72
臺中市,北屯區,平福里,0,1,1382,16,1398,2494,3,1,3,0,1,0,56.05
臺中市,北屯區,平順里,0,1,1287,13,1300,2295,3,1,3,0,1,0,56.64
臺中市,北屯區,東光里,0,1,2010,21,2031,3716,3,1,3,0,1,0,54.66
臺中市,北屯區,舊社里,0,1,3037,17,3054,5448,3,1,3,0,1,0,56.06
臺中市,北屯區,平興里,0,1,2180,15,2195,4217,3,1,3,0,1,0,52.05
臺中市,北屯區,平田里,0,1,2389,19,2408,4380,3,1,3,0,1,0,54.98
臺中市,北屯區,松安里,0,1,2089,16,2105,3769,3,1,3,0,1,0,55.85
臺中市,北屯區,松和里,0,1,2673,17,2690,5081,3,1,3,0,1,0,52.94
臺中市,北屯區,松茂里,0,1,2202,12,2214,3924,3,1,3,0,1,0,56.42
臺中市,北屯區,松勇里,0,1,2073,16,2089,3640,3,1,3,0,1,0,57.39
臺中市,北屯區,松強里,0,1,1833,8,1841,3640,3,1,3,0,1,0,50.58
嘉義市,東區,短竹里,0,1,2274,13,2287,4192,3,1,3,0,1,0,54.56
嘉義市,東區,東川里,0,1,992,13,1005,1686,3,1,3,0,1,0,59.61
嘉義市,東區,鹿寮里,0,1,353,0,353,632,3,1,3,0,1,0,55.85
嘉義市,東區,盧厝里,0,1,1853,7,1860,3513,3,1,3,0,1,0,52.95
嘉義市,東區,東平里,0,1,495,5,500,871,3,1,3,0,1,0,57.41
嘉義市,東區,太平里,0,1,2090,7,2097,3887,3,1,3,0,1,0,53.95
嘉義市,東區,王田里,0,1,1242,3,1245,2332,3,1,3,0,1,0,53.39
嘉義市,東區,長竹里,0,1,1453,10,1463,2606,3,1,3,0,1,0,56.14
嘉義市,東區,後庄里,0,1,1915,12,1927,3523,3,1,3,0,1,0,54.6977008232
嘉義市,東區,新店里,0,1,1738,8,1746,3243,3,1,3,0,1,0,53.84
嘉義市,東區,圳頭里,0,1,2183,10,2193,3866,3,1,3,0,1,0,56.73
嘉義市,東區,東噴里,0,1,624,4,628,1114,3,1,3,0,1,0,56.37
嘉義市,東區,希康里,0,1,174,0,174,297,3,1,3,0,1,0,58.59
嘉義市,東區,東山里,0,1,275,1,276,452,3,1,3,0,1,0,61.06
嘉義市,東區,東安里,0,1,318,1,319,535,3,1,3,0,1,0,59.63
嘉義市,東區,大街里,0,1,305,3,308,518,3,1,3,0,1,0,59.46
嘉義市,東區,祐民里,0,1,357,3,360,668,3,1,3,0,1,0,53.8922155689
嘉義市,東區,東仁里,0,1,307,1,308,494,3,1,3,0,1,0,62.3481781377
嘉義市,東區,內安里,0,1,245,0,245,427,3,1,3,0,1,0,57.38
嘉義市,東區,雲霄里,0,1,720,5,725,1272,3,1,3,0,1,0,57.00
嘉義市,東區,建國里,0,1,357,1,358,626,3,1,3,0,1,0,57.19
嘉義市,東區,府路里,0,1,561,6,567,1011,3,1,3,0,1,0,56.08
嘉義市,東區,鎮南里,0,1,191,1,192,377,3,1,3,0,1,0,50.9283819629
嘉義市,東區,神農里,0,1,519,3,522,985,3,1,3,0,1,0,52.9949238579
嘉義市,東區,崇文里,0,1,383,1,384,632,3,1,3,0,1,0,60.7594936709
嘉義市,東區,龍山里,0,1,392,1,393,715,3,1,3,0,1,0,54.97
嘉義市,東區,安平里,0,1,416,5,421,706,3,1,3,0,1,0,59.63
嘉義市,東區,文昌里,0,1,382,1,383,648,3,1,3,0,1,0,59.10
嘉義市,東區,志航里,0,1,702,8,710,1156,3,1,3,0,1,0,61.42
嘉義市,東區,蘭井里,0,1,337,0,337,612,3,1,3,0,1,0,55.07
嘉義市,東區,光復里,0,1,576,6,582,1063,3,1,3,0,1,0,54.75
嘉義市,東區,初陽里,0,1,689,2,691,1276,3,1,3,0,1,0,54.15
嘉義市,東區,震安里,0,1,443,2,445,770,3,1,3,0,1,0,57.79
嘉義市,東區,新開里,0,1,779,3,782,1360,3,1,3,0,1,0,57.5
嘉義市,東區,宣信里,0,1,892,3,895,1789,3,1,3,0,1,0,50.03
嘉義市,東區,興南里,0,1,732,4,736,1277,3,1,3,0,1,0,57.64
嘉義市,東區,豐年里,0,1,828,3,831,1538,3,1,3,0,1,0,54.03
嘉義市,東區,芳草里,0,1,1745,6,1751,3513,3,1,3,0,1,0,49.84
嘉義市,東區,芳安里,0,1,1171,7,1178,2044,3,1,3,0,1,0,57.63
嘉義市,東區,頂寮里,0,1,1075,4,1079,2005,3,1,3,0,1,0,53.82
嘉義市,東區,安寮里,0,1,2353,10,2363,4707,3,1,3,0,1,0,50.20
嘉義市,東區,興村里,0,1,1565,7,1572,3180,3,1,3,0,1,0,49.4339622642
嘉義市,東區,興安里,0,1,1068,9,1077,2194,3,1,3,0,1,0,49.09
嘉義市,東區,興仁里,0,1,1649,7,1656,3202,3,1,3,0,1,0,51.72
嘉義市,東區,北城里,0,1,466,5,471,848,3,1,3,0,1,0,55.54
嘉義市,東區,仁武里,0,1,382,2,384,639,3,1,3,0,1,0,60.09
嘉義市,東區,泰安里,0,1,595,2,597,1040,3,1,3,0,1,0,57.40
嘉義市,東區,檜村里,0,1,773,4,777,1455,3,1,3,0,1,0,53.40
嘉義市,東區,社口里,0,1,515,4,519,853,3,1,3,0,1,0,60.84
嘉義市,東區,仁和里,0,1,282,3,285,477,3,1,3,0,1,0,59.75
嘉義市,東區,中庄里,0,1,1432,11,1443,2735,3,1,3,0,1,0,52.76
嘉義市,東區,仁義里,0,1,1114,4,1118,2153,3,1,3,0,1,0,51.93
嘉義市,東區,後湖里,0,1,1636,7,1643,3079,3,1,3,0,1,0,53.36
嘉義市,東區,荖藤里,0,1,1370,4,1374,2734,3,1,3,0,1,0,50.26
嘉義市,東區,頂庄里,0,1,2448,20,2468,4840,3,1,3,0,1,0,50.99
嘉義市,西區,書院里,0,1,556,4,560,1015,3,1,3,0,1,0,55.1724137931
嘉義市,西區,驛站里,0,1,355,0,355,596,3,1,3,0,1,0,59.5637583893
嘉義市,西區,民安里,0,1,251,1,252,477,3,1,3,0,1,0,52.83
嘉義市,西區,菜園里,0,1,378,2,380,631,3,1,3,0,1,0,60.22
嘉義市,西區,集英里,0,1,285,1,286,531,3,1,3,0,1,0,53.86
嘉義市,西區,福松里,0,1,489,2,491,773,3,1,3,0,1,0,63.52
嘉義市,西區,義昌里,0,1,330,3,333,581,3,1,3,0,1,0,57.31
嘉義市,西區,自治里,0,1,641,4,645,1126,3,1,3,0,1,0,57.28
嘉義市,西區,大業里,0,1,508,7,515,828,3,1,3,0,1,0,62.20
嘉義市,西區,中庸里,0,1,450,2,452,810,3,1,3,0,1,0,55.80
嘉義市,西區,學圃里,0,1,313,2,315,530,3,1,3,0,1,0,59.4339622642
嘉義市,西區,北杏里,0,1,432,3,435,800,3,1,3,0,1,0,54.375
嘉義市,西區,社內里,0,1,317,3,320,528,3,1,3,0,1,0,60.6060606061
嘉義市,西區,民生里,0,1,341,0,341,543,3,1,3,0,1,0,62.80
嘉義市,西區,慶昇里,0,1,206,2,208,405,3,1,3,0,1,0,51.36
嘉義市,西區,通運里,0,1,195,0,195,367,3,1,3,0,1,0,53.13
嘉義市,西區,榮檜里,0,1,348,3,351,631,3,1,3,0,1,0,55.63
嘉義市,西區,功科里,0,1,447,5,452,712,3,1,3,0,1,0,63.48
嘉義市,西區,康莊里,0,1,370,3,373,608,3,1,3,0,1,0,61.35
嘉義市,西區,福全里,0,1,3099,34,3133,6059,3,1,3,0,1,0,51.71
嘉義市,西區,力行里,0,1,521,4,525,911,3,1,3,0,1,0,57.63
嘉義市,西區,劉厝里,0,1,1856,15,1871,3676,3,1,3,0,1,0,50.90
嘉義市,西區,港坪里,0,1,1128,7,1135,2062,3,1,3,0,1,0,55.04
嘉義市,西區,頭港里,0,1,679,2,681,1282,3,1,3,0,1,0,53.12
嘉義市,西區,西平里,0,1,743,2,745,1310,3,1,3,0,1,0,56.87
嘉義市,西區,大溪里,0,1,935,8,943,1819,3,1,3,0,1,0,51.84
嘉義市,西區,磚窯里,0,1,1777,13,1790,3240,3,1,3,0,1,0,55.2469135802
嘉義市,西區,新西里,0,1,1048,2,1050,2044,3,1,3,0,1,0,51.37
嘉義市,西區,華明里,0,1,440,2,442,772,3,1,3,0,1,0,57.25
嘉義市,西區,導民里,0,1,665,5,670,1240,3,1,3,0,1,0,54.0322580645
嘉義市,西區,培元里,0,1,562,4,566,991,3,1,3,0,1,0,57.11
嘉義市,西區,垂楊里,0,1,965,6,971,1953,3,1,3,0,1,0,49.72
嘉義市,西區,車店里,0,1,2347,15,2362,4478,3,1,3,0,1,0,52.75
嘉義市,西區,福民里,0,1,2260,13,2273,4369,3,1,3,0,1,0,52.0256351568
嘉義市,西區,湖內里,0,1,3698,25,3723,7042,3,1,3,0,1,0,52.87
嘉義市,西區,美源里,0,1,1780,17,1797,3375,3,1,3,0,1,0,53.24
嘉義市,西區,光路里,0,1,2224,16,2240,4346,3,1,3,0,1,0,51.54
嘉義市,西區,育英里,0,1,1213,8,1221,2242,3,1,3,0,1,0,54.46
嘉義市,西區,自強里,0,1,686,4,690,1212,3,1,3,0,1,0,56.93
嘉義市,西區,長安里,0,1,675,3,678,1262,3,1,3,0,1,0,53.72
嘉義市,西區,北榮里,0,1,1070,5,1075,1963,3,1,3,0,1,0,54.76
嘉義市,西區,重興里,0,1,1055,6,1061,2042,3,1,3,0,1,0,51.96
嘉義市,西區,慶昌里,0,1,290,2,292,491,3,1,3,0,1,0,59.47
嘉義市,西區,小湖里,0,1,346,3,349,647,3,1,3,0,1,0,53.94
嘉義市,西區,竹文里,0,1,789,6,795,1428,3,1,3,0,1,0,55.67
嘉義市,西區,香湖里,0,1,692,3,695,1355,3,1,3,0,1,0,51.2915129151
嘉義市,西區,湖邊里,0,1,945,4,949,1851,3,1,3,0,1,0,51.27
嘉義市,西區,竹圍里,0,1,2077,15,2092,3989,3,1,3,0,1,0,52.4442216094
嘉義市,西區,保安里,0,1,4535,29,4564,9011,3,1,3,0,1,0,50.65
嘉義市,西區,新厝里,0,1,1773,13,1786,3414,3,1,3,0,1,0,52.3140011716
嘉義市,西區,北湖里,0,1,1262,11,1273,2350,3,1,3,0,1,0,54.17
嘉義市,西區,下埤里,0,1,641,6,647,1215,3,1,3,0,1,0,53.25
嘉義市,西區,竹村里,0,1,488,2,490,909,3,1,3,0,1,0,53.91
臺南市,東區,崇信里,0,1,1871,6,1877,3856,3,1,3,0,1,0,48.68
臺南市,東區,崇學里,0,1,1462,9,1471,2608,3,1,3,0,1,0,56.40
臺南市,東區,崇德里,0,1,2319,14,2333,4025,3,1,3,0,1,0,57.96
臺南市,東區,崇善里,0,1,1847,11,1858,3485,3,1,3,0,1,0,53.31
臺南市,東區,崇成里,0,1,1289,7,1296,2344,3,1,3,0,1,0,55.29
臺南市,東區,崇文里,0,1,2516,13,2529,4510,3,1,3,0,1,0,56.08
臺南市,東區,東智里,0,1,1193,10,1203,2068,3,1,3,0,1,0,58.17
臺南市,東區,大智里,0,1,2730,14,2744,4746,3,1,3,0,1,0,57.82
臺南市,東區,德高里,0,1,1460,14,1474,2553,3,1,3,0,1,0,57.74
臺南市,東區,仁和里,0,1,1965,7,1972,3849,3,1,3,0,1,0,51.23
臺南市,東區,和平里,0,1,1563,8,1571,2815,3,1,3,0,1,0,55.81
臺南市,東區,虎尾里,0,1,2456,19,2475,4487,3,1,3,0,1,0,55.16
臺南市,東區,裕聖里,0,1,1043,4,1047,1995,3,1,3,0,1,0,52.48
臺南市,東區,復興里,0,1,1719,7,1726,3133,3,1,3,0,1,0,55.09
臺南市,東區,自強里,0,1,2265,13,2278,4220,3,1,3,0,1,0,53.98
臺南市,東區,東聖里,0,1,1179,6,1185,2130,3,1,3,0,1,0,55.63
臺南市,東區,關聖里,0,1,3682,22,3704,6589,3,1,3,0,1,0,56.21
臺南市,東區,後甲里,0,1,1531,6,1537,2619,3,1,3,0,1,0,58.69
臺南市,東區,復國里,0,1,1238,11,1249,1878,3,1,3,0,1,0,66.51
臺南市,東區,中興里,0,1,1077,12,1089,1584,3,1,3,0,1,0,68.75
臺南市,東區,東光里,0,1,2436,13,2449,4237,3,1,3,0,1,0,57.80
臺南市,東區,東明里,0,1,1829,9,1838,3278,3,1,3,0,1,0,56.07
臺南市,東區,莊敬里,0,1,1942,7,1949,3271,3,1,3,0,1,0,59.58
臺南市,東區,小東里,0,1,2375,11,2386,4170,3,1,3,0,1,0,57.22
臺南市,東區,大學里,0,1,872,2,874,1427,3,1,3,0,1,0,61.25
臺南市,東區,成大里,0,1,1225,6,1231,2134,3,1,3,0,1,0,57.69
臺南市,東區,東門里,0,1,1244,7,1251,2099,3,1,3,0,1,0,59.60
臺南市,東區,圍下里,0,1,1338,7,1345,2216,3,1,3,0,1,0,60.69
臺南市,東區,中西里,0,1,1816,13,1829,3087,3,1,3,0,1,0,59.25
臺南市,東區,東安里,0,1,825,10,835,1565,3,1,3,0,1,0,53.35
臺南市,東區,新東里,0,1,1465,8,1473,2467,3,1,3,0,1,0,59.71
臺南市,東區,崇誨里,0,1,1585,7,1592,2688,3,1,3,0,1,0,59.23
臺南市,東區,衛國里,0,1,876,7,883,1590,3,1,3,0,1,0,55.53
臺南市,東區,裕農里,0,1,1656,7,1663,2887,3,1,3,0,1,0,57.60
臺南市,東區,富強里,0,1,2200,12,2212,3854,3,1,3,0,1,0,57.39
臺南市,東區,富裕里,0,1,1147,8,1155,2082,3,1,3,0,1,0,55.48
臺南市,東區,忠孝里,0,1,2257,9,2266,4146,3,1,3,0,1,0,54.66
臺南市,東區,崇明里,0,1,1791,8,1799,3084,3,1,3,0,1,0,58.33
臺南市,東區,大福里,0,1,1278,8,1286,2149,3,1,3,0,1,0,59.84
臺南市,東區,大德里,0,1,933,5,938,1611,3,1,3,0,1,0,58.22
臺南市,東區,路東里,0,1,698,3,701,1246,3,1,3,0,1,0,56.26
臺南市,東區,大同里,0,1,1661,10,1671,2938,3,1,3,0,1,0,56.88
臺南市,東區,泉南里,0,1,2497,6,2503,4239,3,1,3,0,1,0,59.05
臺南市,東區,龍山里,0,1,1545,13,1558,2815,3,1,3,0,1,0,55.35
臺南市,東區,德光里,0,1,1943,13,1956,3419,3,1,3,0,1,0,57.21
臺南市,南區,大恩里,0,1,1874,10,1884,3167,3,1,3,0,1,0,59.49
臺南市,南區,大林里,0,1,1091,9,1100,1870,3,1,3,0,1,0,58.82
臺南市,南區,大忠里,0,1,2520,21,2541,4279,3,1,3,0,1,0,59.38
臺南市,南區,新生里,0,1,1173,16,1189,1772,3,1,3,0,1,0,67.10
臺南市,南區,竹溪里,0,1,857,11,868,1451,3,1,3,0,1,0,59.82
臺南市,南區,明德里,0,1,435,3,438,745,3,1,3,0,1,0,58.79
臺南市,南區,興中里,0,1,576,2,578,941,3,1,3,0,1,0,61.42
臺南市,南區,荔宅里,0,1,632,5,637,1051,3,1,3,0,1,0,60.61
臺南市,南區,大成里,0,1,555,2,557,920,3,1,3,0,1,0,60.54
臺南市,南區,田寮里,0,1,1954,11,1965,3356,3,1,3,0,1,0,58.55
臺南市,南區,新興里,0,1,1490,9,1499,2625,3,1,3,0,1,0,57.10
臺南市,南區,再興里,0,1,1312,11,1323,2161,3,1,3,0,1,0,61.22
臺南市,南區,廣州里,0,1,1577,9,1586,2512,3,1,3,0,1,0,63.14
臺南市,南區,新昌里,0,1,1352,5,1357,2352,3,1,3,0,1,0,57.70
臺南市,南區,文華里,0,1,1884,11,1895,3110,3,1,3,0,1,0,60.93
臺南市,南區,文南里,0,1,2296,12,2308,4066,3,1,3,0,1,0,56.76
臺南市,南區,金華里,0,1,2660,20,2680,4732,3,1,3,0,1,0,56.64
臺南市,南區,國宅里,0,1,1759,8,1767,2959,3,1,3,0,1,0,59.72
臺南市,南區,日新里,0,1,1193,4,1197,2055,3,1,3,0,1,0,58.25
臺南市,南區,光明里,0,1,2302,12,2314,4108,3,1,3,0,1,0,56.33
臺南市,南區,白雪里,0,1,1139,6,1145,1878,3,1,3,0,1,0,60.97
臺南市,南區,明亮里,0,1,1926,15,1941,3510,3,1,3,0,1,0,55.30
臺南市,南區,府南里,0,1,2272,12,2284,4114,3,1,3,0,1,0,55.52
臺南市,南區,明興里,0,1,1809,18,1827,3177,3,1,3,0,1,0,57.51
臺南市,南區,郡南里,0,1,1757,6,1763,3092,3,1,3,0,1,0,57.02
臺南市,南區,建南里,0,1,2362,15,2377,4042,3,1,3,0,1,0,58.81
臺南市,南區,南都里,0,1,1113,4,1117,2383,3,1,3,0,1,0,46.87
臺南市,南區,南華里,0,1,1317,8,1325,2442,3,1,3,0,1,0,54.26
臺南市,南區,開南里,0,1,2088,13,2101,4057,3,1,3,0,1,0,51.79
臺南市,南區,彰南里,0,1,1010,7,1017,1825,3,1,3,0,1,0,55.73
臺南市,南區,鯤鯓里,0,1,1193,7,1200,1859,3,1,3,0,1,0,64.55
臺南市,南區,喜北里,0,1,1335,4,1339,2178,3,1,3,0,1,0,61.48
臺南市,南區,喜南里,0,1,880,5,885,1452,3,1,3,0,1,0,60.95
臺南市,南區,喜東里,0,1,949,7,956,1516,3,1,3,0,1,0,63.06
臺南市,南區,省躬里,0,1,1513,6,1519,2638,3,1,3,0,1,0,57.58
臺南市,南區,永寧里,0,1,1249,4,1253,1954,3,1,3,0,1,0,64.12
臺南市,南區,松安里,0,1,1063,5,1068,1784,3,1,3,0,1,0,59.87
臺南市,南區,佛壇里,0,1,1061,7,1068,1836,3,1,3,0,1,0,58.17
臺南市,南區,同安里,0,1,1195,9,1204,2033,3,1,3,0,1,0,59.22
臺南市,南區,興農里,0,1,1122,10,1132,1827,3,1,3,0,1,0,61.96
臺南市,中西區,小西里,0,1,596,1,597,968,3,1,3,0,1,0,61.67
臺南市,中西區,大南里,0,1,747,5,752,1234,3,1,3,0,1,0,60.94
臺南市,中西區,銀同里,0,1,737,1,738,1223,3,1,3,0,1,0,60.34
臺南市,中西區,五妃里,0,1,891,5,896,1576,3,1,3,0,1,0,56.85
臺南市,中西區,郡王里,0,1,824,2,826,1439,3,1,3,0,1,0,57.40
臺南市,中西區,仙草里,0,1,1309,0,1309,2362,3,1,3,0,1,0,55.42
臺南市,中西區,法華里,0,1,1447,5,1452,2498,3,1,3,0,1,0,58.13
臺南市,中西區,福安里,0,1,815,4,819,1309,3,1,3,0,1,0,62.57
臺南市,中西區,進學里,0,1,790,5,795,1322,3,1,3,0,1,0,60.14
臺南市,中西區,建國里,0,1,778,1,779,1345,3,1,3,0,1,0,57.92
臺南市,中西區,青年里,0,1,832,2,834,1345,3,1,3,0,1,0,62.01
臺南市,中西區,永福里,0,1,837,6,843,1410,3,1,3,0,1,0,59.79
臺南市,中西區,永華里,0,1,808,14,822,1423,3,1,3,0,1,0,57.77
臺南市,中西區,天后里,0,1,978,6,984,1607,3,1,3,0,1,0,61.23
臺南市,中西區,三民里,0,1,902,8,910,1486,3,1,3,0,1,0,61.24
臺南市,中西區,赤嵌里,0,1,866,6,872,1514,3,1,3,0,1,0,57.60
臺南市,中西區,公正里,0,1,803,7,810,1429,3,1,3,0,1,0,56.68
臺南市,中西區,萬昌里,0,1,1299,6,1305,2026,3,1,3,0,1,0,64.41
臺南市,中西區,開山里,0,1,1210,6,1216,2104,3,1,3,0,1,0,57.79
臺南市,中西區,西賢里,0,1,2069,8,2077,3559,3,1,3,0,1,0,58.36
臺南市,中西區,西湖里,0,1,1907,11,1918,3257,3,1,3,0,1,0,58.89
臺南市,中西區,光賢里,0,1,1689,9,1698,2755,3,1,3,0,1,0,61.63
臺南市,中西區,文賢里,0,1,776,3,779,1286,3,1,3,0,1,0,60.58
臺南市,中西區,協和里,0,1,1134,7,1141,2066,3,1,3,0,1,0,55.23
臺南市,中西區,三合里,0,1,1128,8,1136,1870,3,1,3,0,1,0,60.75
臺南市,中西區,普濟里,0,1,729,3,732,1164,3,1,3,0,1,0,62.89
臺南市,中西區,水仙里,0,1,802,3,805,1336,3,1,3,0,1,0,60.25
臺南市,中西區,民權里,0,1,970,10,980,1576,3,1,3,0,1,0,62.18
臺南市,中西區,藥王里,0,1,1595,12,1607,2932,3,1,3,0,1,0,54.81
臺南市,中西區,協進里,0,1,611,2,613,1064,3,1,3,0,1,0,57.61
臺南市,中西區,中正里,0,1,785,9,794,1309,3,1,3,0,1,0,60.66
臺南市,中西區,安海里,0,1,661,0,661,1272,3,1,3,0,1,0,51.97
臺南市,中西區,大涼里,0,1,1358,14,1372,2405,3,1,3,0,1,0,57.05
臺南市,中西區,民主里,0,1,572,6,578,965,3,1,3,0,1,0,59.90
臺南市,中西區,保安里,0,1,773,4,777,1309,3,1,3,0,1,0,59.36
臺南市,中西區,郡西里,0,1,743,7,750,1222,3,1,3,0,1,0,61.37
臺南市,中西區,民生里,0,1,1037,10,1047,1777,3,1,3,0,1,0,58.92
臺南市,中西區,元安里,0,1,746,2,748,1287,3,1,3,0,1,0,58.12
臺南市,北區,開元里,0,1,1351,12,1363,2293,3,1,3,0,1,0,59.44
臺南市,北區,元寶里,0,1,849,5,854,1775,3,1,3,0,1,0,48.11
臺南市,北區,國興里,0,1,841,10,851,1419,3,1,3,0,1,0,59.97
臺南市,北區,華興里,0,1,1183,7,1190,2053,3,1,3,0,1,0,57.96
臺南市,北區,力行里,0,1,1349,4,1353,2233,3,1,3,0,1,0,60.59
臺南市,北區,重興里,0,1,1676,10,1686,2775,3,1,3,0,1,0,60.76
臺南市,北區,東興里,0,1,1152,1,1153,1978,3,1,3,0,1,0,58.29
臺南市,北區,新勝里,0,1,1004,5,1009,1791,3,1,3,0,1,0,56.34
臺南市,北區,長榮里,0,1,746,7,753,1120,3,1,3,0,1,0,67.23
臺南市,北區,振興里,0,1,1108,8,1116,1848,3,1,3,0,1,0,60.39
臺南市,北區,仁愛里,0,1,1001,7,1008,1744,3,1,3,0,1,0,57.80
臺南市,北區,勝安里,0,1,697,7,704,1202,3,1,3,0,1,0,58.57
臺南市,北區,中樓里,0,1,1226,16,1242,2021,3,1,3,0,1,0,61.45
臺南市,北區,永祥里,0,1,1688,9,1697,2868,3,1,3,0,1,0,59.17
臺南市,北區,小康里,0,1,1197,11,1208,2018,3,1,3,0,1,0,59.86
臺南市,北區,實踐里,0,1,894,5,899,1430,3,1,3,0,1,0,62.87
臺南市,北區,光武里,0,1,502,1,503,770,3,1,3,0,1,0,65.32
臺南市,北區,大道里,0,1,558,7,565,830,3,1,3,0,1,0,68.07
臺南市,北區,大山里,0,1,730,10,740,1206,3,1,3,0,1,0,61.36
臺南市,北區,大仁里,0,1,534,5,539,904,3,1,3,0,1,0,59.62
臺南市,北區,興北里,0,1,888,6,894,1508,3,1,3,0,1,0,59.28
臺南市,北區,公園里,0,1,1087,5,1092,1893,3,1,3,0,1,0,57.69
臺南市,北區,正風里,0,1,856,5,861,1470,3,1,3,0,1,0,58.57
臺南市,北區,延平里,0,1,956,2,958,1745,3,1,3,0,1,0,54.90
臺南市,北區,興南里,0,1,699,7,706,1293,3,1,3,0,1,0,54.60
臺南市,北區,玉皇里,0,1,979,2,981,1649,3,1,3,0,1,0,59.49
臺南市,北區,正覺里,0,1,1913,9,1922,3186,3,1,3,0,1,0,60.33
臺南市,北區,六甲里,0,1,1201,5,1206,2252,3,1,3,0,1,0,53.55
臺南市,北區,國姓里,0,1,892,4,896,1532,3,1,3,0,1,0,58.49
臺南市,北區,長德里,0,1,832,4,836,1506,3,1,3,0,1,0,55.51
臺南市,北區,三德里,0,1,771,4,775,1337,3,1,3,0,1,0,57.97
臺南市,北區,五福里,0,1,690,2,692,1599,3,1,3,0,1,0,43.28
臺南市,北區,成功里,0,1,1905,14,1919,3495,3,1,3,0,1,0,54.91
臺南市,北區,成德里,0,1,2994,11,3005,5634,3,1,3,0,1,0,53.34
臺南市,北區,和順里,0,1,2844,22,2866,5291,3,1,3,0,1,0,54.17
臺南市,北區,安民里,0,1,835,4,839,1351,3,1,3,0,1,0,62.10
臺南市,北區,文元里,0,1,2200,11,2211,4106,3,1,3,0,1,0,53.85
臺南市,北區,文成里,0,1,1572,13,1585,2770,3,1,3,0,1,0,57.22
臺南市,北區,裕民里,0,1,862,7,869,1383,3,1,3,0,1,0,62.83
臺南市,北區,大和里,0,1,1776,15,1791,3056,3,1,3,0,1,0,58.61
臺南市,北區,大港里,0,1,2582,22,2604,4544,3,1,3,0,1,0,57.31
臺南市,北區,大豐里,0,1,2247,11,2258,4016,3,1,3,0,1,0,56.23
臺南市,北區,賢北里,0,1,1442,8,1450,2460,3,1,3,0,1,0,58.94
臺南市,安南區,東和里,0,1,360,3,363,584,3,1,3,0,1,0,62.16
臺南市,安南區,塭南里,0,1,2052,14,2066,3650,3,1,3,0,1,0,56.60
臺南市,安南區,州南里,0,1,2432,11,2443,4267,3,1,3,0,1,0,57.25
臺南市,安南區,安順里,0,1,1713,15,1728,2763,3,1,3,0,1,0,62.54
臺南市,安南區,州北里,0,1,1993,10,2003,3345,3,1,3,0,1,0,59.88
臺南市,安南區,新順里,0,1,2134,12,2146,3639,3,1,3,0,1,0,58.97
臺南市,安南區,頂安里,0,1,1651,13,1664,2793,3,1,3,0,1,0,59.58
臺南市,安南區,安慶里,0,1,2520,18,2538,4184,3,1,3,0,1,0,60.66
臺南市,安南區,溪北里,0,1,1554,9,1563,2532,3,1,3,0,1,0,61.73
臺南市,安南區,安和里,0,1,1155,5,1160,1947,3,1,3,0,1,0,59.58
臺南市,安南區,安西里,0,1,1380,8,1388,2171,3,1,3,0,1,0,63.93
臺南市,安南區,溪頂里,0,1,2266,18,2284,3844,3,1,3,0,1,0,59.42
臺南市,安南區,安東里,0,1,1562,8,1570,2531,3,1,3,0,1,0,62.03
臺南市,安南區,鳳凰里,0,1,1944,14,1958,3722,3,1,3,0,1,0,52.61
臺南市,安南區,梅花里,0,1,1720,9,1729,3161,3,1,3,0,1,0,54.70
臺南市,安南區,理想里,0,1,2026,11,2037,3548,3,1,3,0,1,0,57.41
臺南市,安南區,大安里,0,1,1717,16,1733,3033,3,1,3,0,1,0,57.14
臺南市,安南區,原佃里,0,1,1008,7,1015,1503,3,1,3,0,1,0,67.53
臺南市,安南區,長安里,0,1,1888,8,1896,3311,3,1,3,0,1,0,57.26
臺南市,安南區,公親里,0,1,690,4,694,1042,3,1,3,0,1,0,66.60
臺南市,安南區,布袋里,0,1,749,2,751,1301,3,1,3,0,1,0,57.72
臺南市,安南區,總頭里,0,1,1105,7,1112,1701,3,1,3,0,1,0,65.37
臺南市,安南區,南興里,0,1,800,3,803,1333,3,1,3,0,1,0,60.24
臺南市,安南區,學東里,0,1,1051,7,1058,1810,3,1,3,0,1,0,58.45
臺南市,安南區,公塭里,0,1,638,0,638,825,3,1,3,0,1,0,77.33
臺南市,安南區,佃東里,0,1,1317,5,1322,2233,3,1,3,0,1,0,59.20
臺南市,安南區,佃西里,0,1,930,4,934,1480,3,1,3,0,1,0,63.11
臺南市,安南區,淵西里,0,1,1421,9,1430,2443,3,1,3,0,1,0,58.53
臺南市,安南區,海西里,0,1,1365,8,1373,2321,3,1,3,0,1,0,59.16
臺南市,安南區,海東里,0,1,1995,14,2009,3613,3,1,3,0,1,0,55.60
臺南市,安南區,溪心里,0,1,2110,15,2125,4099,3,1,3,0,1,0,51.84
臺南市,安南區,淵東里,0,1,1739,14,1753,3025,3,1,3,0,1,0,57.95
臺南市,安南區,淵中里,0,1,1520,13,1533,2702,3,1,3,0,1,0,56.74
臺南市,安南區,溪墘里,0,1,1723,4,1727,2844,3,1,3,0,1,0,60.72
臺南市,安南區,海佃里,0,1,2350,16,2366,3930,3,1,3,0,1,0,60.20
臺南市,安南區,國安里,0,1,1029,3,1032,1677,3,1,3,0,1,0,61.54
臺南市,安南區,溪東里,0,1,1653,12,1665,2775,3,1,3,0,1,0,60.00
臺南市,安南區,安富里,0,1,2380,19,2399,4171,3,1,3,0,1,0,57.52
臺南市,安南區,幸福里,0,1,2118,17,2135,3451,3,1,3,0,1,0,61.87
臺南市,安南區,海南里,0,1,1280,8,1288,1975,3,1,3,0,1,0,65.22
臺南市,安南區,城東里,0,1,862,2,864,1378,3,1,3,0,1,0,62.70
臺南市,安南區,城南里,0,1,1623,9,1632,2404,3,1,3,0,1,0,67.89
臺南市,安南區,青草里,0,1,822,3,825,1283,3,1,3,0,1,0,64.30
臺南市,安南區,城西里,0,1,706,8,714,1023,3,1,3,0,1,0,69.79
臺南市,安南區,城北里,0,1,850,4,854,1217,3,1,3,0,1,0,70.17
臺南市,安南區,城中里,0,1,700,1,701,886,3,1,3,0,1,0,79.12
臺南市,安南區,砂崙里,0,1,720,4,724,1059,3,1,3,0,1,0,68.37
臺南市,安南區,顯宮里,0,1,715,1,716,1089,3,1,3,0,1,0,65.75
臺南市,安南區,鹿耳里,0,1,399,0,399,642,3,1,3,0,1,0,62.15
臺南市,安南區,四草里,0,1,984,2,986,1433,3,1,3,0,1,0,68.81
臺南市,安南區,鹽田里,0,1,402,0,402,551,3,1,3,0,1,0,72.96
臺南市,安平區,平安里,0,1,1721,11,1732,2955,3,1,3,0,1,0,58.61
臺南市,安平區,石門里,0,1,1182,8,1190,2276,3,1,3,0,1,0,52.28
臺南市,安平區,港仔里,0,1,879,6,885,1435,3,1,3,0,1,0,61.67
臺南市,安平區,海頭里,0,1,900,3,903,1493,3,1,3,0,1,0,60.48
臺南市,安平區,西門里,0,1,1206,7,1213,1943,3,1,3,0,1,0,62.43
臺南市,安平區,金城里,0,1,877,7,884,1502,3,1,3,0,1,0,58.85
臺南市,安平區,漁光里,0,1,360,1,361,518,3,1,3,0,1,0,69.69
臺南市,安平區,億載里,0,1,795,1,796,1477,3,1,3,0,1,0,53.89
臺南市,安平區,平通里,0,1,1856,8,1864,3946,3,1,3,0,1,0,47.24
臺南市,安平區,育平里,0,1,2346,12,2358,4952,3,1,3,0,1,0,47.62
臺南市,安平區,華平里,0,1,1894,14,1908,3683,3,1,3,0,1,0,51.81
臺南市,安平區,怡平里,0,1,1317,5,1322,2671,3,1,3,0,1,0,49.49
臺南市,安平區,國平里,0,1,1769,9,1778,3553,3,1,3,0,1,0,50.04
臺南市,安平區,建平里,0,1,1661,9,1670,3138,3,1,3,0,1,0,53.22
臺南市,安平區,文平里,0,1,1764,4,1768,3218,3,1,3,0,1,0,54.94
金門縣,金城鎮,東門里,0,1,1038,14,1052,2208,3,1,3,0,1,0,47.64
金門縣,金城鎮,南門里,0,1,1148,13,1161,2530,3,1,3,0,1,0,45.89
金門縣,金城鎮,西門里,0,1,1976,23,1999,4195,3,1,3,0,1,0,47.65
金門縣,金城鎮,北門里,0,1,814,11,825,1778,3,1,3,0,1,0,46.40
金門縣,金城鎮,賢庵里,0,1,658,10,668,1480,3,1,3,0,1,0,45.14
金門縣,金城鎮,金水里,0,1,418,4,422,795,3,1,3,0,1,0,53.08
金門縣,金城鎮,古城里,0,1,729,9,738,1467,3,1,3,0,1,0,50.31
金門縣,金城鎮,珠沙里,0,1,440,4,444,943,3,1,3,0,1,0,47.08
金門縣,金寧鄉,古寧村,0,1,655,13,668,1328,3,1,3,0,1,0,50.30
金門縣,金寧鄉,安美村,0,1,871,17,888,1670,3,1,3,0,1,0,53.1736526946
金門縣,金寧鄉,湖埔村,0,1,791,13,804,1683,3,1,3,0,1,0,47.7718360071
金門縣,金寧鄉,榜林村,0,1,778,10,788,1718,3,1,3,0,1,0,45.8672875437
金門縣,金寧鄉,盤山村,0,1,654,8,662,1398,3,1,3,0,1,0,47.3533619456
金門縣,金寧鄉,后盤村,0,1,295,4,299,564,3,1,3,0,1,0,53.0141843972
金門縣,金湖鎮,新市里,0,1,1086,13,1099,2123,3,1,3,0,1,0,51.7663683467
金門縣,金湖鎮,山外里,0,1,794,11,805,1572,3,1,3,0,1,0,51.2086513995
金門縣,金湖鎮,溪湖里,0,1,328,5,333,664,3,1,3,0,1,0,50.1506024096
金門縣,金湖鎮,蓮庵里,0,1,345,4,349,652,3,1,3,0,1,0,53.527607362
金門縣,金湖鎮,料羅里,0,1,368,1,369,718,3,1,3,0,1,0,51.3927576602
金門縣,金湖鎮,新湖里,0,1,1039,17,1056,2098,3,1,3,0,1,0,50.3336510963
金門縣,金湖鎮,正義里,0,1,509,13,522,950,3,1,3,0,1,0,54.9473684211
金門縣,金湖鎮,瓊林里,0,1,651,8,659,1369,3,1,3,0,1,0,48.1373265157
金門縣,金沙鎮,汶沙里,0,1,1042,8,1050,2242,3,1,3,0,1,0,46.8331846566
金門縣,金沙鎮,何斗里,0,1,430,6,436,870,3,1,3,0,1,0,50.1149425287
金門縣,金沙鎮,浦山里,0,1,448,8,456,965,3,1,3,0,1,0,47.2538860104
金門縣,金沙鎮,西園里,0,1,317,1,318,646,3,1,3,0,1,0,49.226006192
金門縣,金沙鎮,官嶼里,0,1,389,2,391,840,3,1,3,0,1,0,46.5476190476
金門縣,金沙鎮,三山里,0,1,399,2,401,834,3,1,3,0,1,0,48.0815347722
金門縣,金沙鎮,大洋里,0,1,296,3,299,499,3,1,3,0,1,0,59.9198396794
金門縣,金沙鎮,光前里,0,1,440,4,444,916,3,1,3,0,1,0,48.4716157205
金門縣,烈嶼鄉,林湖村,0,1,709,5,714,1350,3,1,3,0,1,0,52.8888888889
金門縣,烈嶼鄉,黃埔村,0,1,277,1,278,580,3,1,3,0,1,0,47.9310344828
金門縣,烈嶼鄉,西口村,0,1,396,2,398,838,3,1,3,0,1,0,47.4940334129
金門縣,烈嶼鄉,上林村,0,1,280,1,281,579,3,1,3,0,1,0,48.5319516408
金門縣,烈嶼鄉,上岐村,0,1,592,2,594,1125,3,1,3,0,1,0,52.8
金門縣,烏坵鄉,大坵村,0,1,27,0,27,103,3,1,3,0,1,0,26.213592233
金門縣,烏坵鄉,小坵村,0,1,19,0,19,159,3,1,3,0,1,0,11.9496855346
連江縣,南竿鄉,介壽村,0,1,970,9,979,1347,3,1,3,0,1,0,72.68
連江縣,南竿鄉,福沃村、復興村,0,1,811,5,816,1210,3,1,3,0,1,0,67.44
連江縣,南竿鄉,仁愛村、馬祖村、津沙村、珠螺村、清水村、四維村,0,1,909,13,922,1521,3,1,3,0,1,0,60.62
連江縣,北竿鄉,后沃村、橋仔村、塘岐村,0,1,603,10,613,933,3,1,3,0,1,0,65.70
連江縣,北竿鄉,白沙村、板里村、芹壁村,0,1,271,6,277,438,3,1,3,0,1,0,63.24
連江縣,莒光鄉,青帆村、田沃村、西坵村,0,1,279,0,279,489,3,1,3,0,1,0,57.06
連江縣,莒光鄉,大坪村、福正村,0,1,211,0,211,376,3,1,3,0,1,0,56.12
連江縣,東引鄉,中柳村、樂華村,0,1,397,4,401,643,3,1,3,0,1,0,62.36
臺北市,北投區,建民里,1,1,1175,5,1180,1843,3,1,3,0,1,0,64.03
臺北市,北投區,建民里,2,1,1187,7,1194,1954,3,1,3,0,1,0,61.11
臺北市,北投區,文林里,3,1,1118,2,1120,1774,3,1,3,0,1,0,63.13
臺北市,北投區,文林里,4,1,1067,10,1077,1803,3,1,3,0,1,0,59.73
臺北市,北投區,石牌里,5,1,837,8,845,1397,3,1,3,0,1,0,60.49
臺北市,北投區,石牌里,6,1,867,9,876,1405,3,1,3,0,1,0,62.35
臺北市,北投區,石牌里,7,1,840,5,845,1430,3,1,3,0,1,0,59.09
臺北市,北投區,福興里,8,1,1186,7,1193,1789,3,1,3,0,1,0,66.69
臺北市,北投區,福興里,9,1,1185,10,1195,1913,3,1,3,0,1,0,62.47
臺北市,北投區,福興里,10,1,1015,7,1022,1607,3,1,3,0,1,0,63.60
臺北市,北投區,榮光里,11,1,1024,4,1028,1843,3,1,3,0,1,0,55.78
臺北市,北投區,榮光里,12,1,1203,3,1206,1951,3,1,3,0,1,0,61.81
臺北市,北投區,榮光里,13,1,1148,3,1151,1833,3,1,3,0,1,0,62.79
臺北市,北投區,榮華里,14,1,874,3,877,1463,3,1,3,0,1,0,59.95
臺北市,北投區,榮華里,15,1,958,2,960,1578,3,1,3,0,1,0,60.84
臺北市,北投區,榮華里,16,1,1004,5,1009,1578,3,1,3,0,1,0,63.94
臺北市,北投區,榮華里,17,1,940,1,941,1429,3,1,3,0,1,0,65.85
臺北市,北投區,裕民里,18,1,1101,6,1107,1747,3,1,3,0,1,0,63.37
臺北市,北投區,裕民里,19,1,1155,8,1163,1862,3,1,3,0,1,0,62.46
臺北市,北投區,裕民里,20,1,1160,4,1164,1806,3,1,3,0,1,0,64.45
臺北市,北投區,振華里,21,1,1107,6,1113,1711,3,1,3,0,1,0,65.05
臺北市,北投區,振華里,22,1,1168,12,1180,1817,3,1,3,0,1,0,64.94
臺北市,北投區,振華里,23,1,929,3,932,1407,3,1,3,0,1,0,66.24
臺北市,北投區,振華里,24,1,913,4,917,1458,3,1,3,0,1,0,62.89
臺北市,北投區,永和里,25,1,985,6,991,1652,3,1,3,0,1,0,59.99
臺北市,北投區,永和里,26,1,1051,3,1054,1773,3,1,3,0,1,0,59.45
臺北市,北投區,永和里,27,1,1095,7,1102,1791,3,1,3,0,1,0,61.53
臺北市,北投區,永和里,28,1,834,2,836,1388,3,1,3,0,1,0,60.23
臺北市,北投區,永欣里,29,1,1047,2,1049,1740,3,1,3,0,1,0,60.29
臺北市,北投區,永欣里,30,1,1135,5,1140,1726,3,1,3,0,1,0,66.05
臺北市,北投區,永欣里,31,1,1033,2,1035,1767,3,1,3,0,1,0,58.57
臺北市,北投區,永明里,32,1,1181,5,1186,1822,3,1,3,0,1,0,65.09
臺北市,北投區,永明里,33,1,1097,5,1102,1726,3,1,3,0,1,0,63.85
臺北市,北投區,東華里,34,1,1241,10,1251,1824,3,1,3,0,1,0,68.59
臺北市,北投區,東華里,35,1,1177,8,1185,1808,3,1,3,0,1,0,65.54
臺北市,北投區,吉利里,36,1,1041,12,1053,1662,3,1,3,0,1,0,63.36
臺北市,北投區,吉利里,37,1,1067,4,1071,1772,3,1,3,0,1,0,60.44
臺北市,北投區,吉利里,38,1,1062,9,1071,1718,3,1,3,0,1,0,62.34
臺北市,北投區,吉慶里,39,1,1228,7,1235,2047,3,1,3,0,1,0,60.33
臺北市,北投區,吉慶里,40,1,1284,8,1292,2012,3,1,3,0,1,0,64.21
臺北市,北投區,尊賢里,41,1,1176,4,1180,1921,3,1,3,0,1,0,61.43
臺北市,北投區,尊賢里,42,1,1147,7,1154,1906,3,1,3,0,1,0,60.55
臺北市,北投區,立賢里,43,1,873,10,883,1439,3,1,3,0,1,0,61.36
臺北市,北投區,立賢里,44,1,742,5,747,1238,3,1,3,0,1,0,60.34
臺北市,北投區,立賢里,45,1,838,7,845,1444,3,1,3,0,1,0,58.52
臺北市,北投區,立農里,46,1,1157,5,1162,1797,3,1,3,0,1,0,64.66
臺北市,北投區,立農里,47,1,917,4,921,1480,3,1,3,0,1,0,62.23
臺北市,北投區,立農里,48,1,1033,6,1039,1615,3,1,3,0,1,0,64.33
臺北市,北投區,立農里,49,1,1173,7,1180,1896,3,1,3,0,1,0,62.24
臺北市,北投區,八仙里,50,1,1121,5,1126,1856,3,1,3,0,1,0,60.67
臺北市,北投區,八仙里,51,1,1180,4,1184,2030,3,1,3,0,1,0,58.33
臺北市,北投區,洲美里,52,1,899,2,901,1487,3,1,3,0,1,0,60.59
臺北市,北投區,奇岩里,53,1,1166,6,1172,1939,3,1,3,0,1,0,60.44
臺北市,北投區,奇岩里,54,1,1162,7,1169,1868,3,1,3,0,1,0,62.58
臺北市,北投區,奇岩里,55,1,1200,6,1206,1898,3,1,3,0,1,0,63.54
臺北市,北投區,奇岩里,56,1,1113,9,1122,1945,3,1,3,0,1,0,57.69
臺北市,北投區,清江里,57,1,965,5,970,2172,3,1,3,0,1,0,44.66
臺北市,北投區,清江里,58,1,1008,12,1020,1654,3,1,3,0,1,0,61.67
臺北市,北投區,清江里,59,1,1210,6,1216,1992,3,1,3,0,1,0,61.04
臺北市,北投區,清江里,60,1,1116,4,1120,1816,3,1,3,0,1,0,61.67
臺北市,北投區,中央里,61,1,958,6,964,1511,3,1,3,0,1,0,63.80
臺北市,北投區,中央里,62,1,834,1,835,1475,3,1,3,0,1,0,56.61
臺北市,北投區,中央里,63,1,828,4,832,1583,3,1,3,0,1,0,52.56
臺北市,北投區,中央里,64,1,870,5,875,1433,3,1,3,0,1,0,61.06
臺北市,北投區,長安里,65,1,971,6,977,1564,3,1,3,0,1,0,62.47
臺北市,北投區,長安里,66,1,859,3,862,1466,3,1,3,0,1,0,58.80
臺北市,北投區,長安里,67,1,865,1,866,1515,3,1,3,0,1,0,57.16
臺北市,北投區,大同里,68,1,911,9,920,1479,3,1,3,0,1,0,62.20
臺北市,北投區,大同里,69,1,919,0,919,1532,3,1,3,0,1,0,59.99
臺北市,北投區,大同里,70,1,1045,0,1045,1758,3,1,3,0,1,0,59.44
臺北市,北投區,溫泉里,71,1,1055,5,1060,1673,3,1,3,0,1,0,63.36
臺北市,北投區,溫泉里,72,1,969,0,969,1669,3,1,3,0,1,0,58.06
臺北市,北投區,溫泉里,73,1,1028,8,1036,1749,3,1,3,0,1,0,59.23
臺北市,北投區,林泉里,74,1,779,5,784,1290,3,1,3,0,1,0,60.78
臺北市,北投區,林泉里,75,1,784,7,791,1439,3,1,3,0,1,0,54.97
臺北市,北投區,中心里,76,1,914,2,916,1599,3,1,3,0,1,0,57.29
臺北市,北投區,中心里,77,1,817,4,821,1523,3,1,3,0,1,0,53.91
臺北市,北投區,中心里,78,1,874,6,880,1733,3,1,3,0,1,0,50.78
臺北市,北投區,中庸里,79,1,1031,11,1042,1666,3,1,3,0,1,0,62.55
臺北市,北投區,中庸里,80,1,1056,9,1065,1719,3,1,3,0,1,0,61.95
臺北市,北投區,開明里,81,1,1006,4,1010,1692,3,1,3,0,1,0,59.69
臺北市,北投區,開明里,82,1,1030,8,1038,1680,3,1,3,0,1,0,61.79
臺北市,北投區,開明里,83,1,1073,6,1079,1779,3,1,3,0,1,0,60.65
臺北市,北投區,中和里,84,1,1031,3,1034,1642,3,1,3,0,1,0,62.97
臺北市,北投區,中和里,85,1,704,3,707,1206,3,1,3,0,1,0,58.62
臺北市,北投區,中和里,86,1,768,3,771,1210,3,1,3,0,1,0,63.72
臺北市,北投區,智仁里,87,1,926,9,935,1468,3,1,3,0,1,0,63.69
臺北市,北投區,智仁里,88,1,1096,5,1101,1683,3,1,3,0,1,0,65.42
臺北市,北投區,智仁里,89,1,999,4,1003,1617,3,1,3,0,1,0,62.03
臺北市,北投區,秀山里,90,1,875,6,881,1382,3,1,3,0,1,0,63.75
臺北市,北投區,秀山里,91,1,883,4,887,1467,3,1,3,0,1,0,60.46
臺北市,北投區,文化里,92,1,1181,2,1183,1696,3,1,3,0,1,0,69.75
臺北市,北投區,文化里,93,1,1059,6,1065,1637,3,1,3,0,1,0,65.06
臺北市,北投區,豐年里,94,1,1056,5,1061,1710,3,1,3,0,1,0,62.05
臺北市,北投區,豐年里,95,1,951,7,958,1599,3,1,3,0,1,0,59.91
臺北市,北投區,稻香里,96,1,1149,8,1157,1968,3,1,3,0,1,0,58.79
臺北市,北投區,稻香里,97,1,1101,5,1106,1963,3,1,3,0,1,0,56.34
臺北市,北投區,桃源里,98,1,705,5,710,1185,3,1,3,0,1,0,59.92
臺北市,北投區,桃源里,99,1,886,5,891,1440,3,1,3,0,1,0,61.88
臺北市,北投區,桃源里,100,1,892,2,894,1567,3,1,3,0,1,0,57.05
臺北市,北投區,一德里,101,1,969,6,975,1755,3,1,3,0,1,0,55.56
臺北市,北投區,一德里,102,1,822,4,826,1506,3,1,3,0,1,0,54.85
臺北市,北投區,一德里,103,1,1038,13,1051,1793,3,1,3,0,1,0,58.62
臺北市,北投區,關渡里,104,1,1087,7,1094,1837,3,1,3,0,1,0,59.55
臺北市,北投區,關渡里,105,1,889,10,899,1596,3,1,3,0,1,0,56.33
臺北市,北投區,關渡里,106,1,1115,1,1116,1914,3,1,3,0,1,0,58.31
臺北市,北投區,關渡里,107,1,961,8,969,1642,3,1,3,0,1,0,59.01
臺北市,北投區,關渡里,108,1,824,12,836,1259,3,1,3,0,1,0,66.40
臺北市,北投區,泉源里,109,1,252,2,254,408,3,1,3,0,1,0,62.25
臺北市,北投區,泉源里,110,1,869,6,875,1546,3,1,3,0,1,0,56.60
臺北市,北投區,湖山里,111,1,434,4,438,720,3,1,3,0,1,0,60.83
臺北市,北投區,湖山里,112,1,594,3,597,958,3,1,3,0,1,0,62.32
臺北市,北投區,大屯里,113,1,564,5,569,985,3,1,3,0,1,0,57.77
臺北市,北投區,湖田里,114,1,451,4,455,739,3,1,3,0,1,0,61.57
臺北市,士林區,仁勇里,115,1,1115,8,1123,1843,3,1,3,0,1,0,60.93
臺北市,士林區,仁勇里,116,1,1032,1,1033,1632,3,1,3,0,1,0,63.30
臺北市,士林區,義信里,117,1,778,7,785,1365,3,1,3,0,1,0,57.51
臺北市,士林區,義信里,118,1,792,2,794,1307,3,1,3,0,1,0,60.75
臺北市,士林區,福林里,119,1,755,5,760,1185,3,1,3,0,1,0,64.14
臺北市,士林區,福林里,120,1,427,3,430,738,3,1,3,0,1,0,58.27
臺北市,士林區,福林里,121,1,913,4,917,1374,3,1,3,0,1,0,66.74
臺北市,士林區,福德里,122,1,881,9,890,1460,3,1,3,0,1,0,60.96
臺北市,士林區,福德里,123,1,823,3,826,1382,3,1,3,0,1,0,59.77
臺北市,士林區,福德里,124,1,504,2,506,1581,3,1,3,0,1,0,32.01
臺北市,士林區,福志里,125,1,1185,5,1190,1901,3,1,3,0,1,0,62.60
臺北市,士林區,福志里,126,1,1202,9,1211,1859,3,1,3,0,1,0,65.14
臺北市,士林區,福志里,127,1,1306,9,1315,2029,3,1,3,0,1,0,64.81
臺北市,士林區,舊佳里,128,1,1084,35,1119,1741,3,1,3,0,1,0,64.27
臺北市,士林區,舊佳里,129,1,1044,5,1049,1604,3,1,3,0,1,0,65.40
臺北市,士林區,舊佳里,130,1,1107,4,1111,1873,3,1,3,0,1,0,59.32
臺北市,士林區,福佳里,131,1,855,6,861,1417,3,1,3,0,1,0,60.76
臺北市,士林區,福佳里,132,1,997,1,998,1559,3,1,3,0,1,0,64.02
臺北市,士林區,福佳里,133,1,995,7,1002,1641,3,1,3,0,1,0,61.06
臺北市,士林區,福佳里,134,1,915,1,916,1454,3,1,3,0,1,0,63.00
臺北市,士林區,後港里,135,1,1041,9,1050,1679,3,1,3,0,1,0,62.54
臺北市,士林區,後港里,136,1,887,3,890,1612,3,1,3,0,1,0,55.21
臺北市,士林區,後港里,137,1,956,4,960,1651,3,1,3,0,1,0,58.15
臺北市,士林區,後港里,138,1,827,2,829,1405,3,1,3,0,1,0,59.00
臺北市,士林區,福中里,139,1,822,2,824,1360,3,1,3,0,1,0,60.59
臺北市,士林區,福中里,140,1,863,4,867,1445,3,1,3,0,1,0,60.00
臺北市,士林區,福中里,141,1,989,4,993,1593,3,1,3,0,1,0,62.34
臺北市,士林區,前港里,142,1,988,7,995,1708,3,1,3,0,1,0,58.26
臺北市,士林區,前港里,143,1,1092,4,1096,1765,3,1,3,0,1,0,62.10
臺北市,士林區,百齡里,144,1,1115,5,1120,1820,3,1,3,0,1,0,61.54
臺北市,士林區,百齡里,145,1,1119,9,1128,1875,3,1,3,0,1,0,60.16
臺北市,士林區,百齡里,146,1,1238,6,1244,2057,3,1,3,0,1,0,60.48
臺北市,士林區,承德里,147,1,788,6,794,1368,3,1,3,0,1,0,58.04
臺北市,士林區,承德里,148,1,954,4,958,1586,3,1,3,0,1,0,60.40
臺北市,士林區,承德里,149,1,885,7,892,1525,3,1,3,0,1,0,58.49
臺北市,士林區,福華里,150,1,1011,1,1012,1838,3,1,3,0,1,0,55.06
臺北市,士林區,福華里,151,1,1004,9,1013,1789,3,1,3,0,1,0,56.62
臺北市,士林區,福華里,152,1,1161,8,1169,1892,3,1,3,0,1,0,61.79
臺北市,士林區,明勝里,153,1,716,4,720,1263,3,1,3,0,1,0,57.01
臺北市,士林區,明勝里,154,1,783,5,788,1360,3,1,3,0,1,0,57.94
臺北市,士林區,明勝里,155,1,798,3,801,1393,3,1,3,0,1,0,57.50
臺北市,士林區,福順里,156,1,788,9,797,1411,3,1,3,0,1,0,56.48
臺北市,士林區,福順里,157,1,764,7,771,1339,3,1,3,0,1,0,57.58
臺北市,士林區,福順里,158,1,887,7,894,1568,3,1,3,0,1,0,57.02
臺北市,士林區,富光里,159,1,923,6,929,1695,3,1,3,0,1,0,54.81
臺北市,士林區,富光里,160,1,921,9,930,1546,3,1,3,0,1,0,60.16
臺北市,士林區,富光里,161,1,943,3,946,1589,3,1,3,0,1,0,59.53
臺北市,士林區,葫蘆里,162,1,1217,4,1221,1981,3,1,3,0,1,0,61.64
臺北市,士林區,葫蘆里,163,1,1125,11,1136,1897,3,1,3,0,1,0,59.88
臺北市,士林區,葫蘆里,164,1,1302,2,1304,2003,3,1,3,0,1,0,65.10
臺北市,士林區,葫東里,165,1,952,5,957,1675,3,1,3,0,1,0,57.13
臺北市,士林區,葫東里,166,1,886,5,891,1443,3,1,3,0,1,0,61.75
臺北市,士林區,社子里,167,1,951,5,956,1562,3,1,3,0,1,0,61.20
臺北市,士林區,社子里,168,1,942,6,948,1732,3,1,3,0,1,0,54.73
臺北市,士林區,社子里,169,1,957,13,970,1755,3,1,3,0,1,0,55.27
臺北市,士林區,社新里,170,1,1058,6,1064,1785,3,1,3,0,1,0,59.61
臺北市,士林區,社新里,171,1,989,8,997,1709,3,1,3,0,1,0,58.34
臺北市,士林區,社新里,172,1,890,6,896,1586,3,1,3,0,1,0,56.49
臺北市,士林區,社新里,173,1,919,2,921,1607,3,1,3,0,1,0,57.31
臺北市,士林區,社園里,174,1,1100,5,1105,1821,3,1,3,0,1,0,60.68
臺北市,士林區,社園里,175,1,1199,5,1204,1969,3,1,3,0,1,0,61.15
臺北市,士林區,社園里,176,1,1139,5,1144,1891,3,1,3,0,1,0,60.50
臺北市,士林區,永倫里,177,1,1132,5,1137,1861,3,1,3,0,1,0,61.10
臺北市,士林區,永倫里,178,1,1183,5,1188,1962,3,1,3,0,1,0,60.55
臺北市,士林區,永倫里,179,1,1198,3,1201,1968,3,1,3,0,1,0,61.03
臺北市,士林區,福安里,180,1,793,6,799,1304,3,1,3,0,1,0,61.27
臺北市,士林區,福安里,181,1,776,6,782,1267,3,1,3,0,1,0,61.72
臺北市,士林區,福安里,182,1,809,5,814,1333,3,1,3,0,1,0,61.07
臺北市,士林區,富洲里,183,1,869,3,872,1426,3,1,3,0,1,0,61.15
臺北市,士林區,富洲里,184,1,801,7,808,1343,3,1,3,0,1,0,60.16
臺北市,士林區,富洲里,185,1,1115,7,1122,1694,3,1,3,0,1,0,66.23
臺北市,士林區,岩山里,186,1,895,5,900,1578,3,1,3,0,1,0,57.03
臺北市,士林區,岩山里,187,1,927,6,933,1538,3,1,3,0,1,0,60.66
臺北市,士林區,名山里,188,1,1233,4,1237,1906,3,1,3,0,1,0,64.90
臺北市,士林區,名山里,189,1,1140,6,1146,1852,3,1,3,0,1,0,61.88
臺北市,士林區,名山里,190,1,1251,3,1254,1995,3,1,3,0,1,0,62.86
臺北市,士林區,德行里,191,1,1023,5,1028,1615,3,1,3,0,1,0,63.65
臺北市,士林區,德行里,192,1,980,6,986,1693,3,1,3,0,1,0,58.24
臺北市,士林區,德華里,193,1,835,3,838,1375,3,1,3,0,1,0,60.95
臺北市,士林區,德華里,194,1,978,3,981,1598,3,1,3,0,1,0,61.39
臺北市,士林區,德華里,195,1,983,7,990,1645,3,1,3,0,1,0,60.18
臺北市,士林區,聖山里,196,1,761,5,766,1307,3,1,3,0,1,0,58.61
臺北市,士林區,聖山里,197,1,892,4,896,1443,3,1,3,0,1,0,62.09
臺北市,士林區,聖山里,198,1,995,6,1001,1458,3,1,3,0,1,0,68.66
臺北市,士林區,忠誠里,199,1,1035,1,1036,1547,3,1,3,0,1,0,66.97
臺北市,士林區,忠誠里,200,1,977,5,982,1480,3,1,3,0,1,0,66.35
臺北市,士林區,忠誠里,201,1,968,3,971,1604,3,1,3,0,1,0,60.54
臺北市,士林區,芝山里,202,1,1134,4,1138,1894,3,1,3,0,1,0,60.08
臺北市,士林區,芝山里,203,1,1230,6,1236,2035,3,1,3,0,1,0,60.74
臺北市,士林區,芝山里,204,1,1114,12,1126,1838,3,1,3,0,1,0,61.26
臺北市,士林區,東山里,205,1,830,2,832,1276,3,1,3,0,1,0,65.20
臺北市,士林區,東山里,206,1,935,2,937,1423,3,1,3,0,1,0,65.85
臺北市,士林區,東山里,207,1,901,11,912,1417,3,1,3,0,1,0,64.36
臺北市,士林區,三玉里,208,1,904,7,911,1486,3,1,3,0,1,0,61.31
臺北市,士林區,三玉里,209,1,978,1,979,1567,3,1,3,0,1,0,62.48
臺北市,士林區,三玉里,210,1,943,3,946,1473,3,1,3,0,1,0,64.22
臺北市,士林區,蘭雅里,211,1,1039,4,1043,1741,3,1,3,0,1,0,59.91
臺北市,士林區,蘭雅里,212,1,941,2,943,1536,3,1,3,0,1,0,61.39
臺北市,士林區,蘭雅里,213,1,1019,3,1022,1678,3,1,3,0,1,0,60.91
臺北市,士林區,蘭雅里,214,1,1037,11,1048,1833,3,1,3,0,1,0,57.17
臺北市,士林區,蘭興里,215,1,1040,4,1044,1676,3,1,3,0,1,0,62.29
臺北市,士林區,蘭興里,216,1,1016,6,1022,1581,3,1,3,0,1,0,64.64
臺北市,士林區,蘭興里,217,1,1075,6,1081,1731,3,1,3,0,1,0,62.45
臺北市,士林區,天福里,218,1,1078,5,1083,1684,3,1,3,0,1,0,64.31
臺北市,士林區,天福里,219,1,1084,9,1093,1779,3,1,3,0,1,0,61.44
臺北市,士林區,天福里,220,1,931,7,938,1527,3,1,3,0,1,0,61.43
臺北市,士林區,天祿里,221,1,869,8,877,1417,3,1,3,0,1,0,61.89
臺北市,士林區,天祿里,222,1,916,2,918,1418,3,1,3,0,1,0,64.74
臺北市,士林區,天祿里,223,1,794,4,798,1295,3,1,3,0,1,0,61.62
臺北市,士林區,天壽里,224,1,1158,4,1162,1856,3,1,3,0,1,0,62.61
臺北市,士林區,天壽里,225,1,1179,9,1188,1954,3,1,3,0,1,0,60.8
臺北市,士林區,天和里,226,1,884,9,893,1438,3,1,3,0,1,0,62.1
臺北市,士林區,天和里,227,1,936,4,940,1510,3,1,3,0,1,0,62.25
臺北市,士林區,天和里,228,1,895,7,902,1535,3,1,3,0,1,0,58.76
臺北市,士林區,天和里,229,1,922,5,927,1463,3,1,3,0,1,0,63.36
臺北市,士林區,天山里,230,1,1097,3,1100,1790,3,1,3,0,1,0,61.45
臺北市,士林區,天山里,231,1,1090,9,1099,1762,3,1,3,0,1,0,62.37
臺北市,士林區,天山里,232,1,1119,10,1129,1959,3,1,3,0,1,0,57.63
臺北市,士林區,天玉里,233,1,1036,3,1039,1735,3,1,3,0,1,0,59.88
臺北市,士林區,天玉里,234,1,929,3,932,1548,3,1,3,0,1,0,60.21
臺北市,士林區,天玉里,235,1,1043,3,1046,1712,3,1,3,0,1,0,61.1
臺北市,士林區,天玉里,236,1,1020,3,1023,1678,3,1,3,0,1,0,60.97
臺北市,士林區,天母里,237,1,1057,3,1060,1672,3,1,3,0,1,0,63.4
臺北市,士林區,天母里,238,1,1140,5,1145,1785,3,1,3,0,1,0,64.15
臺北市,士林區,天母里,239,1,1024,13,1037,1653,3,1,3,0,1,0,62.73
臺北市,士林區,永福里,240,1,685,4,689,1148,3,1,3,0,1,0,60.02
臺北市,士林區,公館里,241,1,744,5,749,1234,3,1,3,0,1,0,60.7
臺北市,士林區,新安里,242,1,1036,6,1042,1747,3,1,3,0,1,0,59.65
臺北市,士林區,陽明里,243,1,565,2,567,932,3,1,3,0,1,0,60.84
臺北市,士林區,陽明里,244,1,593,2,595,1028,3,1,3,0,1,0,57.88
臺北市,士林區,陽明里,245,1,458,5,463,799,3,1,3,0,1,0,57.95
臺北市,士林區,菁山里,246,1,812,3,815,1367,3,1,3,0,1,0,59.62
臺北市,士林區,平等里,247,1,769,10,779,1189,3,1,3,0,1,0,65.52
臺北市,士林區,溪山里,248,1,710,7,717,1231,3,1,3,0,1,0,58.25
臺北市,士林區,翠山里,249,1,813,2,815,1264,3,1,3,0,1,0,64.48
臺北市,士林區,翠山里,250,1,773,4,777,1207,3,1,3,0,1,0,64.37
臺北市,士林區,臨溪里,251,1,862,6,868,1386,3,1,3,0,1,0,62.63
臺北市,士林區,臨溪里,252,1,652,3,655,1076,3,1,3,0,1,0,60.87
臺北市,內湖區,西湖里,253,1,906,5,911,1476,3,1,3,0,1,0,61.72
臺北市,內湖區,西湖里,254,1,1009,4,1013,1603,3,1,3,0,1,0,63.19
臺北市,內湖區,西湖里,255,1,1004,3,1007,1588,3,1,3,0,1,0,63.41
臺北市,內湖區,西湖里,256,1,919,4,923,1530,3,1,3,0,1,0,60.33
臺北市,內湖區,西康里,257,1,961,5,966,1524,3,1,3,0,1,0,63.39
臺北市,內湖區,西康里,258,1,915,7,922,1531,3,1,3,0,1,0,60.22
臺北市,內湖區,西康里,259,1,845,6,851,1416,3,1,3,0,1,0,60.1
臺北市,內湖區,西康里,260,1,1232,3,1235,1901,3,1,3,0,1,0,64.97
臺北市,內湖區,西安里,261,1,1066,3,1069,1677,3,1,3,0,1,0,63.74
臺北市,內湖區,西安里,262,1,986,0,986,1603,3,1,3,0,1,0,61.51
臺北市,內湖區,西安里,263,1,1064,6,1070,1747,3,1,3,0,1,0,61.25
臺北市,內湖區,港墘里,264,1,965,5,970,1521,3,1,3,0,1,0,63.77
臺北市,內湖區,港墘里,265,1,959,4,963,1517,3,1,3,0,1,0,63.48
臺北市,內湖區,港墘里,266,1,832,6,838,1371,3,1,3,0,1,0,61.12
臺北市,內湖區,港都里,267,1,915,5,920,1466,3,1,3,0,1,0,62.76
臺北市,內湖區,港都里,268,1,744,2,746,1188,3,1,3,0,1,0,62.79
臺北市,內湖區,港都里,269,1,795,2,797,1357,3,1,3,0,1,0,58.73
臺北市,內湖區,麗山里,270,1,877,5,882,1463,3,1,3,0,1,0,60.29
臺北市,內湖區,麗山里,271,1,766,3,769,1245,3,1,3,0,1,0,61.77
臺北市,內湖區,麗山里,272,1,893,5,898,1445,3,1,3,0,1,0,62.15
臺北市,內湖區,港富里,273,1,904,4,908,1440,3,1,3,0,1,0,63.06
臺北市,內湖區,港富里,274,1,881,5,886,1441,3,1,3,0,1,0,61.49
臺北市,內湖區,港富里,275,1,943,8,951,1549,3,1,3,0,1,0,61.39
臺北市,內湖區,港富里,276,1,903,5,908,1445,3,1,3,0,1,0,62.84
臺北市,內湖區,港富里,277,1,832,3,835,1308,3,1,3,0,1,0,63.84
臺北市,內湖區,港華里,278,1,941,5,946,1520,3,1,3,0,1,0,62.24
臺北市,內湖區,港華里,279,1,956,12,968,1546,3,1,3,0,1,0,62.61
臺北市,內湖區,港華里,280,1,1043,4,1047,1626,3,1,3,0,1,0,64.39
臺北市,內湖區,港華里,281,1,910,8,918,1542,3,1,3,0,1,0,59.53
臺北市,內湖區,內湖里,282,1,977,4,981,1513,3,1,3,0,1,0,64.84
臺北市,內湖區,內湖里,283,1,916,4,920,1487,3,1,3,0,1,0,61.87
臺北市,內湖區,內湖里,284,1,862,6,868,1518,3,1,3,0,1,0,57.18
臺北市,內湖區,湖濱里,285,1,1038,8,1046,1602,3,1,3,0,1,0,65.29
臺北市,內湖區,湖濱里,286,1,907,2,909,1363,3,1,3,0,1,0,66.69
臺北市,內湖區,湖濱里,287,1,716,7,723,1143,3,1,3,0,1,0,63.25
臺北市,內湖區,湖濱里,288,1,1064,9,1073,1657,3,1,3,0,1,0,64.76
臺北市,內湖區,紫星里,289,1,982,1,983,1506,3,1,3,0,1,0,65.27
臺北市,內湖區,紫星里,290,1,1070,2,1072,1734,3,1,3,0,1,0,61.82
臺北市,內湖區,紫星里,291,1,1019,2,1021,1662,3,1,3,0,1,0,61.43
臺北市,內湖區,紫星里,292,1,960,2,962,1550,3,1,3,0,1,0,62.06
臺北市,內湖區,大湖里,293,1,781,7,788,1317,3,1,3,0,1,0,59.83
臺北市,內湖區,大湖里,294,1,693,0,693,1218,3,1,3,0,1,0,56.9
臺北市,內湖區,大湖里,295,1,835,3,838,1391,3,1,3,0,1,0,60.24
臺北市,內湖區,秀湖里,296,1,878,4,882,1510,3,1,3,0,1,0,58.41
臺北市,內湖區,秀湖里,297,1,967,7,974,1570,3,1,3,0,1,0,62.04
臺北市,內湖區,秀湖里,298,1,1052,0,1052,1647,3,1,3,0,1,0,63.87
臺北市,內湖區,金龍里,299,1,844,5,849,1536,3,1,3,0,1,0,55.27
臺北市,內湖區,金龍里,300,1,924,2,926,1577,3,1,3,0,1,0,58.72
臺北市,內湖區,金龍里,301,1,891,6,897,1416,3,1,3,0,1,0,63.35
臺北市,內湖區,金瑞里,302,1,1041,9,1050,1646,3,1,3,0,1,0,63.79
臺北市,內湖區,金瑞里,303,1,1037,2,1039,1729,3,1,3,0,1,0,60.09
臺北市,內湖區,金瑞里,304,1,1074,2,1076,1636,3,1,3,0,1,0,65.77
臺北市,內湖區,碧山里,305,1,250,2,252,401,3,1,3,0,1,0,62.84
臺北市,內湖區,碧山里,306,1,1071,4,1075,1629,3,1,3,0,1,0,65.99
臺北市,內湖區,碧山里,307,1,1062,3,1065,1763,3,1,3,0,1,0,60.41
臺北市,內湖區,碧山里,308,1,916,3,919,1505,3,1,3,0,1,0,61.06
臺北市,內湖區,紫雲里,309,1,1042,7,1049,1510,3,1,3,0,1,0,69.47
臺北市,內湖區,紫雲里,310,1,909,13,922,1481,3,1,3,0,1,0,62.26
臺北市,內湖區,紫雲里,311,1,960,2,962,1529,3,1,3,0,1,0,62.92
臺北市,內湖區,清白里,312,1,1134,5,1139,1850,3,1,3,0,1,0,61.57
臺北市,內湖區,清白里,313,1,959,7,966,1690,3,1,3,0,1,0,57.16
臺北市,內湖區,清白里,314,1,985,3,988,1738,3,1,3,0,1,0,56.85
臺北市,內湖區,葫洲里,315,1,1158,2,1160,1887,3,1,3,0,1,0,61.47
臺北市,內湖區,葫洲里,316,1,895,4,899,1539,3,1,3,0,1,0,58.41
臺北市,內湖區,葫洲里,317,1,1032,4,1036,1770,3,1,3,0,1,0,58.53
臺北市,內湖區,葫洲里,318,1,1023,10,1033,1795,3,1,3,0,1,0,57.55
臺北市,內湖區,金湖里,319,1,918,3,921,1556,3,1,3,0,1,0,59.19
臺北市,內湖區,金湖里,320,1,1005,4,1009,1707,3,1,3,0,1,0,59.11
臺北市,內湖區,金湖里,321,1,918,7,925,1500,3,1,3,0,1,0,61.67
臺北市,內湖區,康寧里,322,1,771,7,778,1418,3,1,3,0,1,0,54.87
臺北市,內湖區,康寧里,323,1,870,3,873,1496,3,1,3,0,1,0,58.36
臺北市,內湖區,康寧里,324,1,885,4,889,1536,3,1,3,0,1,0,57.88
臺北市,內湖區,康寧里,325,1,836,5,841,1410,3,1,3,0,1,0,59.65
臺北市,內湖區,明湖里,326,1,1111,8,1119,1801,3,1,3,0,1,0,62.13
臺北市,內湖區,明湖里,327,1,1059,1,1060,1796,3,1,3,0,1,0,59.02
臺北市,內湖區,蘆洲里,328,1,453,0,453,792,3,1,3,0,1,0,57.2
臺北市,內湖區,紫陽里,329,1,826,5,831,1408,3,1,3,0,1,0,59.02
臺北市,內湖區,紫陽里,330,1,864,8,872,1417,3,1,3,0,1,0,61.54
臺北市,內湖區,紫陽里,331,1,842,9,851,1419,3,1,3,0,1,0,59.97
臺北市,內湖區,紫陽里,332,1,975,5,980,1534,3,1,3,0,1,0,63.89
臺北市,內湖區,瑞陽里,333,1,1192,7,1199,1776,3,1,3,0,1,0,67.51
臺北市,內湖區,瑞陽里,334,1,1086,5,1091,1637,3,1,3,0,1,0,66.65
臺北市,內湖區,瑞陽里,335,1,1065,5,1070,1493,3,1,3,0,1,0,71.67
臺北市,內湖區,瑞陽里,336,1,1061,6,1067,1480,3,1,3,0,1,0,72.09
臺北市,內湖區,瑞光里,337,1,804,2,806,1282,3,1,3,0,1,0,62.87
臺北市,內湖區,瑞光里,338,1,790,4,794,1225,3,1,3,0,1,0,64.82
臺北市,內湖區,瑞光里,339,1,805,5,810,1195,3,1,3,0,1,0,67.78
臺北市,內湖區,五分里,340,1,995,7,1002,1737,3,1,3,0,1,0,57.69
臺北市,內湖區,五分里,341,1,1053,6,1059,1813,3,1,3,0,1,0,58.41
臺北市,內湖區,五分里,342,1,866,4,870,1716,3,1,3,0,1,0,50.7
臺北市,內湖區,五分里,343,1,973,9,982,1708,3,1,3,0,1,0,57.49
臺北市,內湖區,東湖里,344,1,885,2,887,1486,3,1,3,0,1,0,59.69
臺北市,內湖區,東湖里,345,1,851,9,860,1509,3,1,3,0,1,0,56.99
臺北市,內湖區,東湖里,346,1,839,2,841,1509,3,1,3,0,1,0,55.73
臺北市,內湖區,東湖里,347,1,810,11,821,1438,3,1,3,0,1,0,57.09
臺北市,內湖區,安湖里,348,1,1056,5,1061,1776,3,1,3,0,1,0,59.74
臺北市,內湖區,安湖里,349,1,955,6,961,1662,3,1,3,0,1,0,57.82
臺北市,內湖區,安湖里,350,1,1073,11,1084,1829,3,1,3,0,1,0,59.27
臺北市,內湖區,樂康里,351,1,790,6,796,1393,3,1,3,0,1,0,57.14
臺北市,內湖區,樂康里,352,1,913,6,919,1591,3,1,3,0,1,0,57.76
臺北市,內湖區,樂康里,353,1,808,7,815,1452,3,1,3,0,1,0,56.13
臺北市,內湖區,樂康里,354,1,834,3,837,1466,3,1,3,0,1,0,57.09
臺北市,內湖區,內溝里,355,1,451,4,455,797,3,1,3,0,1,0,57.09
臺北市,內湖區,內溝里,356,1,715,7,722,1143,3,1,3,0,1,0,63.17
臺北市,內湖區,內溝里,357,1,780,5,785,1333,3,1,3,0,1,0,58.89
臺北市,內湖區,安泰里,358,1,1030,5,1035,1705,3,1,3,0,1,0,60.7
臺北市,內湖區,安泰里,359,1,1099,5,1104,1906,3,1,3,0,1,0,57.92
臺北市,內湖區,週美里,360,1,730,3,733,1229,3,1,3,0,1,0,59.64
臺北市,內湖區,週美里,361,1,825,6,831,1300,3,1,3,0,1,0,63.92
臺北市,內湖區,週美里,362,1,865,2,867,1387,3,1,3,0,1,0,62.51
臺北市,內湖區,行善里,363,1,852,7,859,1347,3,1,3,0,1,0,63.77
臺北市,內湖區,行善里,364,1,623,13,636,1052,3,1,3,0,1,0,60.46
臺北市,內湖區,行善里,365,1,808,4,812,1340,3,1,3,0,1,0,60.6
臺北市,內湖區,行善里,366,1,842,6,848,1405,3,1,3,0,1,0,60.36
臺北市,內湖區,石潭里,367,1,851,5,856,1422,3,1,3,0,1,0,60.2
臺北市,內湖區,湖興里,368,1,904,6,910,1604,3,1,3,0,1,0,56.73
臺北市,內湖區,湖興里,369,1,775,2,777,2166,3,1,3,0,1,0,35.87
臺北市,內湖區,湖興里,370,1,952,4,956,1607,3,1,3,0,1,0,59.49
臺北市,內湖區,湖興里,371,1,931,8,939,1553,3,1,3,0,1,0,60.46
臺北市,內湖區,湖興里,372,1,885,1,886,1526,3,1,3,0,1,0,58.06
臺北市,內湖區,湖元里,373,1,822,5,827,1344,3,1,3,0,1,0,61.53
臺北市,內湖區,湖元里,374,1,812,1,813,1339,3,1,3,0,1,0,60.72
臺北市,內湖區,湖元里,375,1,776,5,781,1340,3,1,3,0,1,0,58.28
臺北市,南港區,南港里,376,1,861,4,865,1445,3,1,3,0,1,0,59.86
臺北市,南港區,南港里,377,1,891,1,892,1536,3,1,3,0,1,0,58.07
臺北市,南港區,南港里,378,1,885,4,889,1829,3,1,3,0,1,0,48.61
臺北市,南港區,中南里,379,1,1007,7,1014,1824,3,1,3,0,1,0,55.59
臺北市,南港區,中南里,380,1,903,6,909,1473,3,1,3,0,1,0,61.71
臺北市,南港區,新富里,381,1,938,8,946,1532,3,1,3,0,1,0,61.75
臺北市,南港區,新富里,382,1,949,5,954,1663,3,1,3,0,1,0,57.37
臺北市,南港區,三重里,383,1,789,2,791,1353,3,1,3,0,1,0,58.46
臺北市,南港區,三重里,384,1,691,8,699,1228,3,1,3,0,1,0,56.92
臺北市,南港區,東新里,385,1,963,7,970,1663,3,1,3,0,1,0,58.33
臺北市,南港區,東新里,386,1,858,4,862,1441,3,1,3,0,1,0,59.82
臺北市,南港區,東新里,387,1,746,1,747,1275,3,1,3,0,1,0,58.59
臺北市,南港區,東新里,388,1,841,4,845,1359,3,1,3,0,1,0,62.18
臺北市,南港區,新光里,389,1,1090,10,1100,1685,3,1,3,0,1,0,65.28
臺北市,南港區,新光里,390,1,1010,5,1015,1628,3,1,3,0,1,0,62.35
臺北市,南港區,東明里,391,1,1164,5,1169,1874,3,1,3,0,1,0,62.38
臺北市,南港區,東明里,392,1,1000,10,1010,1761,3,1,3,0,1,0,57.35
臺北市,南港區,西新里,393,1,941,9,950,1662,3,1,3,0,1,0,57.16
臺北市,南港區,西新里,394,1,1165,8,1173,1869,3,1,3,0,1,0,62.76
臺北市,南港區,玉成里,395,1,1066,9,1075,1769,3,1,3,0,1,0,60.77
臺北市,南港區,玉成里,396,1,1180,5,1185,1884,3,1,3,0,1,0,62.9
臺北市,南港區,合成里,397,1,899,4,903,1489,3,1,3,0,1,0,60.64
臺北市,南港區,合成里,398,1,846,5,851,1386,3,1,3,0,1,0,61.4
臺北市,南港區,合成里,399,1,710,13,723,1120,3,1,3,0,1,0,64.55
臺北市,南港區,合成里,400,1,657,3,660,1050,3,1,3,0,1,0,62.86
臺北市,南港區,成福里,401,1,867,2,869,1363,3,1,3,0,1,0,63.76
臺北市,南港區,成福里,402,1,994,13,1007,1616,3,1,3,0,1,0,62.31
臺北市,南港區,成福里,403,1,813,5,818,1374,3,1,3,0,1,0,59.53
臺北市,南港區,成福里,404,1,1096,11,1107,1765,3,1,3,0,1,0,62.72
臺北市,南港區,萬福里,405,1,1193,7,1200,1733,3,1,3,0,1,0,69.24
臺北市,南港區,萬福里,406,1,1025,5,1030,1608,3,1,3,0,1,0,64.05
臺北市,南港區,鴻福里,407,1,1183,6,1189,1889,3,1,3,0,1,0,62.94
臺北市,南港區,鴻福里,408,1,1150,10,1160,1917,3,1,3,0,1,0,60.51
臺北市,南港區,百福里,409,1,1263,4,1267,2071,3,1,3,0,1,0,61.18
臺北市,南港區,百福里,410,1,1185,12,1197,1894,3,1,3,0,1,0,63.2
臺北市,南港區,聯成里,411,1,906,0,906,1399,3,1,3,0,1,0,64.76
臺北市,南港區,聯成里,412,1,883,5,888,1424,3,1,3,0,1,0,62.36
臺北市,南港區,聯成里,413,1,920,7,927,1463,3,1,3,0,1,0,63.36
臺北市,南港區,舊莊里,414,1,755,7,762,1291,3,1,3,0,1,0,59.02
臺北市,南港區,舊莊里,415,1,742,8,750,1286,3,1,3,0,1,0,58.32
臺北市,南港區,舊莊里,416,1,816,10,826,1412,3,1,3,0,1,0,58.5
臺北市,南港區,舊莊里,417,1,754,4,758,1300,3,1,3,0,1,0,58.31
臺北市,南港區,舊莊里,418,1,836,3,839,1497,3,1,3,0,1,0,56.05
臺北市,南港區,中研里,419,1,794,4,798,1352,3,1,3,0,1,0,59.02
臺北市,南港區,中研里,420,1,994,9,1003,1576,3,1,3,0,1,0,63.64
臺北市,南港區,中研里,421,1,893,5,898,1454,3,1,3,0,1,0,61.76
臺北市,南港區,中研里,422,1,965,8,973,1507,3,1,3,0,1,0,64.57
臺北市,南港區,中研里,423,1,776,4,780,1272,3,1,3,0,1,0,61.32
臺北市,南港區,九如里,424,1,961,9,970,1501,3,1,3,0,1,0,64.62
臺北市,南港區,九如里,425,1,1066,6,1072,1593,3,1,3,0,1,0,67.29
臺北市,南港區,九如里,426,1,947,7,954,1558,3,1,3,0,1,0,61.23
臺北市,南港區,仁福里,427,1,769,4,773,1282,3,1,3,0,1,0,60.3
臺北市,南港區,仁福里,428,1,958,7,965,1569,3,1,3,0,1,0,61.5
臺北市,南港區,仁福里,429,1,933,10,943,1511,3,1,3,0,1,0,62.41
臺北市,松山區,莊敬里,430,1,937,5,942,1517,3,1,3,0,1,0,62.1
臺北市,松山區,莊敬里,431,1,1016,4,1020,1600,3,1,3,0,1,0,63.75
臺北市,松山區,莊敬里,432,1,937,8,945,1555,3,1,3,0,1,0,60.77
臺北市,松山區,東榮里,433,1,1163,3,1166,1837,3,1,3,0,1,0,63.47
臺北市,松山區,東榮里,434,1,975,6,981,1596,3,1,3,0,1,0,61.47
臺北市,松山區,東榮里,435,1,1206,5,1211,1859,3,1,3,0,1,0,65.14
臺北市,松山區,東榮里,436,1,965,6,971,1555,3,1,3,0,1,0,62.44
臺北市,松山區,三民里,437,1,1146,7,1153,1783,3,1,3,0,1,0,64.67
臺北市,松山區,三民里,438,1,1187,6,1193,1974,3,1,3,0,1,0,60.44
臺北市,松山區,三民里,439,1,1152,6,1158,1828,3,1,3,0,1,0,63.35
臺北市,松山區,新益里,440,1,1122,8,1130,1830,3,1,3,0,1,0,61.75
臺北市,松山區,新益里,441,1,1163,6,1169,1886,3,1,3,0,1,0,61.98
臺北市,松山區,富錦里,442,1,930,4,934,1515,3,1,3,0,1,0,61.65
臺北市,松山區,富錦里,443,1,1050,2,1052,1682,3,1,3,0,1,0,62.54
臺北市,松山區,富錦里,444,1,650,4,654,1022,3,1,3,0,1,0,63.99
臺北市,松山區,新東里,445,1,1227,9,1236,2006,3,1,3,0,1,0,61.62
臺北市,松山區,新東里,446,1,1127,2,1129,2004,3,1,3,0,1,0,56.34
臺北市,松山區,富泰里,447,1,1120,2,1122,1851,3,1,3,0,1,0,60.62
臺北市,松山區,富泰里,448,1,1103,3,1106,1857,3,1,3,0,1,0,59.56
臺北市,松山區,介壽里,449,1,1029,6,1035,1699,3,1,3,0,1,0,60.92
臺北市,松山區,介壽里,450,1,1191,2,1193,1925,3,1,3,0,1,0,61.97
臺北市,松山區,精忠里,451,1,1043,6,1049,1700,3,1,3,0,1,0,61.71
臺北市,松山區,精忠里,452,1,1114,5,1119,1879,3,1,3,0,1,0,59.55
臺北市,松山區,東光里,453,1,1181,4,1185,1990,3,1,3,0,1,0,59.55
臺北市,松山區,東光里,454,1,1157,7,1164,1941,3,1,3,0,1,0,59.97
臺北市,松山區,東光里,455,1,1326,8,1334,2126,3,1,3,0,1,0,62.75
臺北市,松山區,龍田里,456,1,891,1,892,1440,3,1,3,0,1,0,61.94
臺北市,松山區,龍田里,457,1,787,3,790,1239,3,1,3,0,1,0,63.76
臺北市,松山區,龍田里,458,1,1420,4,1424,2124,3,1,3,0,1,0,67.04
臺北市,松山區,龍田里,459,1,1390,1,1391,2194,3,1,3,0,1,0,63.4
臺北市,松山區,東昌里,460,1,1322,12,1334,2124,3,1,3,0,1,0,62.81
臺北市,松山區,東勢里,461,1,1119,7,1126,1767,3,1,3,0,1,0,63.72
臺北市,松山區,東勢里,462,1,1105,12,1117,1758,3,1,3,0,1,0,63.54
臺北市,松山區,中華里,463,1,935,1,936,1555,3,1,3,0,1,0,60.19
臺北市,松山區,中華里,464,1,1064,1,1065,1621,3,1,3,0,1,0,65.7
臺北市,松山區,中華里,465,1,1046,7,1053,1720,3,1,3,0,1,0,61.22
臺北市,松山區,民有里,466,1,1039,8,1047,1685,3,1,3,0,1,0,62.14
臺北市,松山區,民有里,467,1,970,3,973,1747,3,1,3,0,1,0,55.7
臺北市,松山區,民有里,468,1,1167,6,1173,1894,3,1,3,0,1,0,61.93
臺北市,松山區,民有里,469,1,1018,3,1021,1755,3,1,3,0,1,0,58.18
臺北市,松山區,民福里,470,1,1228,3,1231,1894,3,1,3,0,1,0,64.99
臺北市,松山區,民福里,471,1,1203,4,1207,1813,3,1,3,0,1,0,66.57
臺北市,松山區,民福里,472,1,1006,8,1014,1699,3,1,3,0,1,0,59.68
臺北市,松山區,慈祐里,473,1,1074,4,1078,1810,3,1,3,0,1,0,59.56
臺北市,松山區,慈祐里,474,1,894,3,897,2297,3,1,3,0,1,0,39.05
臺北市,松山區,慈祐里,475,1,876,3,879,1507,3,1,3,0,1,0,58.33
臺北市,松山區,安平里,476,1,1127,10,1137,1775,3,1,3,0,1,0,64.06
臺北市,松山區,安平里,477,1,1037,9,1046,1712,3,1,3,0,1,0,61.1
臺北市,松山區,安平里,478,1,1107,13,1120,1785,3,1,3,0,1,0,62.75
臺北市,松山區,安平里,479,1,1018,7,1025,1621,3,1,3,0,1,0,63.23
臺北市,松山區,鵬程里,480,1,1043,3,1046,1575,3,1,3,0,1,0,66.41
臺北市,松山區,鵬程里,481,1,980,1,981,1538,3,1,3,0,1,0,63.78
臺北市,松山區,鵬程里,482,1,1006,5,1011,1576,3,1,3,0,1,0,64.15
臺北市,松山區,自強里,483,1,1354,8,1362,1977,3,1,3,0,1,0,68.89
臺北市,松山區,自強里,484,1,1150,7,1157,1834,3,1,3,0,1,0,63.09
臺北市,松山區,自強里,485,1,1183,6,1189,1761,3,1,3,0,1,0,67.52
臺北市,松山區,吉祥里,486,1,1056,2,1058,1742,3,1,3,0,1,0,60.73
臺北市,松山區,吉祥里,487,1,1061,1,1062,1673,3,1,3,0,1,0,63.48
臺北市,松山區,吉祥里,488,1,854,2,856,1522,3,1,3,0,1,0,56.24
臺北市,松山區,吉祥里,489,1,1101,2,1103,1741,3,1,3,0,1,0,63.35
臺北市,松山區,新聚里,490,1,1205,7,1212,1956,3,1,3,0,1,0,61.96
臺北市,松山區,新聚里,491,1,1185,7,1192,2000,3,1,3,0,1,0,59.6
臺北市,松山區,新聚里,492,1,1309,9,1318,2104,3,1,3,0,1,0,62.64
臺北市,松山區,復盛里,493,1,1135,6,1141,1766,3,1,3,0,1,0,64.61
臺北市,松山區,復盛里,494,1,1080,6,1086,1700,3,1,3,0,1,0,63.88
臺北市,松山區,復盛里,495,1,1098,6,1104,1773,3,1,3,0,1,0,62.27
臺北市,松山區,中正里,496,1,986,3,989,1591,3,1,3,0,1,0,62.16
臺北市,松山區,中正里,497,1,804,7,811,1412,3,1,3,0,1,0,57.44
臺北市,松山區,中正里,498,1,975,5,980,1641,3,1,3,0,1,0,59.72
臺北市,松山區,中正里,499,1,986,7,993,1760,3,1,3,0,1,0,56.42
臺北市,松山區,中崙里,500,1,857,6,863,1516,3,1,3,0,1,0,56.93
臺北市,松山區,中崙里,501,1,976,10,986,1563,3,1,3,0,1,0,63.08
臺北市,松山區,美仁里,502,1,800,6,806,1318,3,1,3,0,1,0,61.15
臺北市,松山區,美仁里,503,1,830,2,832,1280,3,1,3,0,1,0,65
臺北市,松山區,吉仁里,504,1,947,10,957,1574,3,1,3,0,1,0,60.8
臺北市,松山區,吉仁里,505,1,962,5,967,1538,3,1,3,0,1,0,62.87
臺北市,松山區,敦化里,506,1,1068,5,1073,1731,3,1,3,0,1,0,61.99
臺北市,松山區,敦化里,507,1,1213,7,1220,1933,3,1,3,0,1,0,63.11
臺北市,松山區,敦化里,508,1,1148,6,1154,1818,3,1,3,0,1,0,63.48
臺北市,松山區,復源里,509,1,804,5,809,1293,3,1,3,0,1,0,62.57
臺北市,松山區,復源里,510,1,738,3,741,1175,3,1,3,0,1,0,63.06
臺北市,松山區,復建里,511,1,859,3,862,1450,3,1,3,0,1,0,59.45
臺北市,松山區,復建里,512,1,953,2,955,1609,3,1,3,0,1,0,59.35
臺北市,松山區,復勢里,513,1,937,7,944,1508,3,1,3,0,1,0,62.6
臺北市,松山區,復勢里,514,1,1120,4,1124,1765,3,1,3,0,1,0,63.68
臺北市,松山區,復勢里,515,1,846,6,852,1429,3,1,3,0,1,0,59.62
臺北市,松山區,福成里,516,1,1309,11,1320,2080,3,1,3,0,1,0,63.46
臺北市,松山區,松基里,517,1,971,10,981,1591,3,1,3,0,1,0,61.66
臺北市,松山區,松基里,518,1,884,4,888,1491,3,1,3,0,1,0,59.56
臺北市,信義區,西村里,519,1,856,6,862,2135,3,1,3,0,1,0,40.37
臺北市,信義區,西村里,520,1,914,3,917,1336,3,1,3,0,1,0,68.64
臺北市,信義區,西村里,521,1,877,1,878,1369,3,1,3,0,1,0,64.13
臺北市,信義區,正和里,522,1,1238,2,1240,1966,3,1,3,0,1,0,63.07
臺北市,信義區,正和里,523,1,1228,9,1237,1943,3,1,3,0,1,0,63.66
臺北市,信義區,興隆里,524,1,667,1,668,1101,3,1,3,0,1,0,60.67
臺北市,信義區,興隆里,525,1,795,4,799,1377,3,1,3,0,1,0,58.02
臺北市,信義區,中興里,526,1,706,4,710,1288,3,1,3,0,1,0,55.12
臺北市,信義區,中興里,527,1,734,2,736,1290,3,1,3,0,1,0,57.05
臺北市,信義區,新仁里,528,1,889,2,891,1460,3,1,3,0,1,0,61.03
臺北市,信義區,新仁里,529,1,899,5,904,1467,3,1,3,0,1,0,61.62
臺北市,信義區,興雅里,530,1,991,4,995,1609,3,1,3,0,1,0,61.84
臺北市,信義區,興雅里,531,1,975,5,980,1594,3,1,3,0,1,0,61.48
臺北市,信義區,興雅里,532,1,1024,3,1027,1608,3,1,3,0,1,0,63.87
臺北市,信義區,敦厚里,533,1,776,0,776,1317,3,1,3,0,1,0,58.92
臺北市,信義區,敦厚里,534,1,699,2,701,1266,3,1,3,0,1,0,55.37
臺北市,信義區,敦厚里,535,1,751,5,756,1313,3,1,3,0,1,0,57.58
臺北市,信義區,廣居里,536,1,885,6,891,1390,3,1,3,0,1,0,64.1
臺北市,信義區,廣居里,537,1,1029,1,1030,1632,3,1,3,0,1,0,63.11
臺北市,信義區,廣居里,538,1,788,4,792,1308,3,1,3,0,1,0,60.55
臺北市,信義區,廣居里,539,1,876,4,880,1501,3,1,3,0,1,0,58.63
臺北市,信義區,安康里,540,1,969,0,969,1528,3,1,3,0,1,0,63.42
臺北市,信義區,安康里,541,1,952,0,952,1535,3,1,3,0,1,0,62.02
臺北市,信義區,安康里,542,1,932,4,936,1514,3,1,3,0,1,0,61.82
臺北市,信義區,安康里,543,1,944,3,947,1624,3,1,3,0,1,0,58.31
臺北市,信義區,六藝里,544,1,863,10,873,1511,3,1,3,0,1,0,57.78
臺北市,信義區,六藝里,545,1,898,3,901,1410,3,1,3,0,1,0,63.9
臺北市,信義區,雅祥里,546,1,744,3,747,1288,3,1,3,0,1,0,58
臺北市,信義區,雅祥里,547,1,763,6,769,1280,3,1,3,0,1,0,60.08
臺北市,信義區,雅祥里,548,1,884,6,890,1478,3,1,3,0,1,0,60.22
臺北市,信義區,五常里,549,1,930,4,934,1534,3,1,3,0,1,0,60.89
臺北市,信義區,五常里,550,1,930,4,934,1561,3,1,3,0,1,0,59.83
臺北市,信義區,五全里,551,1,911,6,917,1465,3,1,3,0,1,0,62.59
臺北市,信義區,五全里,552,1,892,5,897,1403,3,1,3,0,1,0,63.93
臺北市,信義區,五全里,553,1,902,7,909,1399,3,1,3,0,1,0,64.97
臺北市,信義區,永吉里,554,1,660,4,664,1221,3,1,3,0,1,0,54.38
臺北市,信義區,永吉里,555,1,700,4,704,1245,3,1,3,0,1,0,56.55
臺北市,信義區,永吉里,556,1,756,6,762,1299,3,1,3,0,1,0,58.66
臺北市,信義區,長春里,557,1,1081,8,1089,1842,3,1,3,0,1,0,59.12
臺北市,信義區,長春里,558,1,1074,6,1080,1731,3,1,3,0,1,0,62.39
臺北市,信義區,四育里,559,1,891,4,895,1493,3,1,3,0,1,0,59.95
臺北市,信義區,四育里,560,1,996,4,1000,1598,3,1,3,0,1,0,62.58
臺北市,信義區,四育里,561,1,993,8,1001,1533,3,1,3,0,1,0,65.3
臺北市,信義區,四維里,562,1,952,8,960,1606,3,1,3,0,1,0,59.78
臺北市,信義區,四維里,563,1,937,7,944,1582,3,1,3,0,1,0,59.67
臺北市,信義區,四維里,564,1,809,4,813,1401,3,1,3,0,1,0,58.03
臺北市,信義區,永春里,565,1,872,5,877,1478,3,1,3,0,1,0,59.34
臺北市,信義區,永春里,566,1,937,3,940,1495,3,1,3,0,1,0,62.88
臺北市,信義區,永春里,567,1,797,6,803,1390,3,1,3,0,1,0,57.77
臺北市,信義區,富臺里,568,1,1034,7,1041,1605,3,1,3,0,1,0,64.86
臺北市,信義區,富臺里,569,1,900,3,903,1463,3,1,3,0,1,0,61.72
臺北市,信義區,國業里,570,1,999,4,1003,1567,3,1,3,0,1,0,64.01
臺北市,信義區,國業里,571,1,876,4,880,1447,3,1,3,0,1,0,60.82
臺北市,信義區,國業里,572,1,853,3,856,1304,3,1,3,0,1,0,65.64
臺北市,信義區,國業里,573,1,877,8,885,1418,3,1,3,0,1,0,62.41
臺北市,信義區,松隆里,574,1,686,3,689,1138,3,1,3,0,1,0,60.54
臺北市,信義區,松隆里,575,1,494,7,501,929,3,1,3,0,1,0,53.93
臺北市,信義區,松友里,576,1,974,8,982,1688,3,1,3,0,1,0,58.18
臺北市,信義區,松友里,577,1,1068,2,1070,1803,3,1,3,0,1,0,59.35
臺北市,信義區,松友里,578,1,1085,2,1087,1815,3,1,3,0,1,0,59.89
臺北市,信義區,松光里,579,1,863,1,864,1455,3,1,3,0,1,0,59.38
臺北市,信義區,松光里,580,1,989,3,992,1606,3,1,3,0,1,0,61.77
臺北市,信義區,松光里,581,1,855,2,857,1395,3,1,3,0,1,0,61.43
臺北市,信義區,中坡里,582,1,720,4,724,1148,3,1,3,0,1,0,63.07
臺北市,信義區,中坡里,583,1,722,6,728,1206,3,1,3,0,1,0,60.36
臺北市,信義區,中坡里,584,1,870,1,871,1412,3,1,3,0,1,0,61.69
臺北市,信義區,中行里,585,1,956,4,960,1591,3,1,3,0,1,0,60.34
臺北市,信義區,中行里,586,1,1050,4,1054,1694,3,1,3,0,1,0,62.22
臺北市,信義區,中行里,587,1,960,5,965,1515,3,1,3,0,1,0,63.7
臺北市,信義區,中行里,588,1,1067,9,1076,1688,3,1,3,0,1,0,63.74
臺北市,信義區,大道里,589,1,1064,10,1074,1784,3,1,3,0,1,0,60.2
臺北市,信義區,大道里,590,1,1220,2,1222,1903,3,1,3,0,1,0,64.21
臺北市,信義區,大道里,591,1,998,3,1001,1698,3,1,3,0,1,0,58.95
臺北市,信義區,大仁里,592,1,860,17,877,1464,3,1,3,0,1,0,59.9
臺北市,信義區,大仁里,593,1,946,6,952,1486,3,1,3,0,1,0,64.06
臺北市,信義區,大仁里,594,1,955,5,960,1471,3,1,3,0,1,0,65.26
臺北市,信義區,景新里,595,1,857,5,862,1379,3,1,3,0,1,0,62.51
臺北市,信義區,景新里,596,1,887,4,891,1386,3,1,3,0,1,0,64.29
臺北市,信義區,景新里,597,1,762,7,769,1277,3,1,3,0,1,0,60.22
臺北市,信義區,惠安里,598,1,1124,5,1129,1783,3,1,3,0,1,0,63.32
臺北市,信義區,惠安里,599,1,1100,2,1102,1779,3,1,3,0,1,0,61.94
臺北市,信義區,惠安里,600,1,1214,9,1223,1897,3,1,3,0,1,0,64.47
臺北市,信義區,三張里,601,1,954,2,956,1456,3,1,3,0,1,0,65.66
臺北市,信義區,三張里,602,1,886,5,891,1431,3,1,3,0,1,0,62.26
臺北市,信義區,三張里,603,1,1000,8,1008,1616,3,1,3,0,1,0,62.38
臺北市,信義區,三張里,604,1,1038,3,1041,1602,3,1,3,0,1,0,64.98
臺北市,信義區,三張里,605,1,866,10,876,1450,3,1,3,0,1,0,60.41
臺北市,信義區,三犁里,606,1,810,2,812,1264,3,1,3,0,1,0,64.24
臺北市,信義區,三犁里,607,1,845,3,848,1438,3,1,3,0,1,0,58.97
臺北市,信義區,三犁里,608,1,844,1,845,1400,3,1,3,0,1,0,60.36
臺北市,信義區,六合里,609,1,854,3,857,1321,3,1,3,0,1,0,64.88
臺北市,信義區,六合里,610,1,893,0,893,1451,3,1,3,0,1,0,61.54
臺北市,信義區,六合里,611,1,815,6,821,1375,3,1,3,0,1,0,59.71
臺北市,信義區,六合里,612,1,730,1,731,1302,3,1,3,0,1,0,56.14
臺北市,信義區,泰和里,613,1,834,5,839,1547,3,1,3,0,1,0,54.23
臺北市,信義區,泰和里,614,1,923,9,932,1536,3,1,3,0,1,0,60.68
臺北市,信義區,泰和里,615,1,1054,5,1059,1710,3,1,3,0,1,0,61.93
臺北市,信義區,泰和里,616,1,1043,3,1046,1743,3,1,3,0,1,0,60.01
臺北市,信義區,景聯里,617,1,723,1,724,1250,3,1,3,0,1,0,57.92
臺北市,信義區,景聯里,618,1,877,5,882,1363,3,1,3,0,1,0,64.71
臺北市,信義區,景聯里,619,1,824,7,831,1338,3,1,3,0,1,0,62.11
臺北市,信義區,景勤里,620,1,635,5,640,1067,3,1,3,0,1,0,59.98
臺北市,信義區,景勤里,621,1,781,7,788,1271,3,1,3,0,1,0,62
臺北市,信義區,景勤里,622,1,883,6,889,1349,3,1,3,0,1,0,65.9
臺北市,信義區,雙和里,623,1,930,7,937,1512,3,1,3,0,1,0,61.97
臺北市,信義區,雙和里,624,1,944,4,948,1464,3,1,3,0,1,0,64.75
臺北市,信義區,雙和里,625,1,873,4,877,1459,3,1,3,0,1,0,60.11
臺北市,信義區,雙和里,626,1,976,6,982,1537,3,1,3,0,1,0,63.89
臺北市,信義區,嘉興里,627,1,864,1,865,1404,3,1,3,0,1,0,61.61
臺北市,信義區,嘉興里,628,1,769,4,773,1262,3,1,3,0,1,0,61.25
臺北市,信義區,黎順里,629,1,1069,4,1073,1859,3,1,3,0,1,0,57.72
臺北市,信義區,黎順里,630,1,1102,5,1107,1683,3,1,3,0,1,0,65.78
臺北市,信義區,黎平里,631,1,1021,6,1027,1585,3,1,3,0,1,0,64.79
臺北市,信義區,黎平里,632,1,806,1,807,1300,3,1,3,0,1,0,62.08
臺北市,信義區,黎平里,633,1,811,4,815,1330,3,1,3,0,1,0,61.28
臺北市,信義區,黎平里,634,1,845,6,851,1447,3,1,3,0,1,0,58.81
臺北市,信義區,黎忠里,635,1,891,2,893,1410,3,1,3,0,1,0,63.33
臺北市,信義區,黎忠里,636,1,830,0,830,1370,3,1,3,0,1,0,60.58
臺北市,信義區,黎忠里,637,1,818,8,826,1259,3,1,3,0,1,0,65.61
臺北市,信義區,黎安里,638,1,642,5,647,983,3,1,3,0,1,0,65.82
臺北市,信義區,黎安里,639,1,766,4,770,1257,3,1,3,0,1,0,61.26
臺北市,中山區,正守里,640,2,825,7,832,1428,3,1,3,0,1,0,58.26
臺北市,中山區,正守里,641,2,650,8,658,1011,3,1,3,0,1,0,65.08
臺北市,中山區,正義里,642,2,1026,12,1038,1995,3,1,3,0,1,0,52.03
臺北市,中山區,正義里,643,2,886,10,896,1651,3,1,3,0,1,0,54.27
臺北市,中山區,正得里,644,2,574,3,577,947,3,1,3,0,1,0,60.93
臺北市,中山區,正得里,645,2,890,5,895,1645,3,1,3,0,1,0,54.41
臺北市,中山區,民安里,646,2,1099,3,1102,1791,3,1,3,0,1,0,61.53
臺北市,中山區,民安里,647,2,1311,6,1317,2281,3,1,3,0,1,0,57.74
臺北市,中山區,康樂里,648,2,975,9,984,1869,3,1,3,0,1,0,52.65
臺北市,中山區,中山里,649,2,763,2,765,1403,3,1,3,0,1,0,54.53
臺北市,中山區,中山里,650,2,743,6,749,1462,3,1,3,0,1,0,51.23
臺北市,中山區,中山里,651,2,813,4,817,1415,3,1,3,0,1,0,57.74
臺北市,中山區,聚盛里,652,2,709,4,713,1414,3,1,3,0,1,0,50.42
臺北市,中山區,聚盛里,653,2,674,8,682,1397,3,1,3,0,1,0,48.82
臺北市,中山區,集英里,654,2,1096,6,1102,1815,3,1,3,0,1,0,60.72
臺北市,中山區,集英里,655,2,946,9,955,1629,3,1,3,0,1,0,58.62
臺北市,中山區,集英里,656,2,761,3,764,1330,3,1,3,0,1,0,57.44
臺北市,中山區,聚葉里,657,2,910,7,917,1556,3,1,3,0,1,0,58.93
臺北市,中山區,聚葉里,658,2,861,4,865,1535,3,1,3,0,1,0,56.35
臺北市,中山區,恆安里,659,2,865,11,876,1504,3,1,3,0,1,0,58.24
臺北市,中山區,恆安里,660,2,616,2,618,1160,3,1,3,0,1,0,53.28
臺北市,中山區,晴光里,661,2,984,12,996,1967,3,1,3,0,1,0,50.64
臺北市,中山區,晴光里,662,2,795,4,799,1539,3,1,3,0,1,0,51.92
臺北市,中山區,圓山里,663,2,982,8,990,1857,3,1,3,0,1,0,53.31
臺北市,中山區,圓山里,664,2,678,7,685,1222,3,1,3,0,1,0,56.06
臺北市,中山區,新庄里,665,2,1151,5,1156,2092,3,1,3,0,1,0,55.26
臺北市,中山區,新庄里,666,2,1164,6,1170,1866,3,1,3,0,1,0,62.70
臺北市,中山區,劍潭里,667,2,997,7,1004,1481,3,1,3,0,1,0,67.79
臺北市,中山區,劍潭里,668,2,1123,5,1128,1639,3,1,3,0,1,0,68.82
臺北市,中山區,大直里,669,2,1214,5,1219,1951,3,1,3,0,1,0,62.48
臺北市,中山區,大直里,670,2,1270,12,1282,1996,3,1,3,0,1,0,64.23
臺北市,中山區,大直里,671,2,1257,5,1262,1961,3,1,3,0,1,0,64.35
臺北市,中山區,大直里,672,2,1073,3,1076,1708,3,1,3,0,1,0,63.00
臺北市,中山區,成功里,673,2,761,4,765,1237,3,1,3,0,1,0,61.84
臺北市,中山區,成功里,674,2,881,6,887,1396,3,1,3,0,1,0,63.54
臺北市,中山區,永安里,675,2,1143,4,1147,1796,3,1,3,0,1,0,63.86
臺北市,中山區,永安里,676,2,975,4,979,1588,3,1,3,0,1,0,61.65
臺北市,中山區,永安里,677,2,809,3,812,1364,3,1,3,0,1,0,59.53
臺北市,中山區,永安里,678,2,1173,5,1178,1884,3,1,3,0,1,0,62.53
臺北市,中山區,大佳里,679,2,599,4,603,944,3,1,3,0,1,0,63.88
臺北市,中山區,新喜里,680,2,1205,7,1212,1937,3,1,3,0,1,0,62.57
臺北市,中山區,新喜里,681,2,1195,6,1201,2090,3,1,3,0,1,0,57.46
臺北市,中山區,新福里,682,2,1293,6,1299,2156,3,1,3,0,1,0,60.25
臺北市,中山區,新福里,683,2,1121,9,1130,1950,3,1,3,0,1,0,57.95
臺北市,中山區,松江里,684,2,1112,14,1126,1771,3,1,3,0,1,0,63.58
臺北市,中山區,松江里,685,2,1134,7,1141,1867,3,1,3,0,1,0,61.11
臺北市,中山區,松江里,686,2,842,3,845,1379,3,1,3,0,1,0,61.28
臺北市,中山區,新生里,687,2,1291,13,1304,2150,3,1,3,0,1,0,60.65
臺北市,中山區,新生里,688,2,1052,11,1063,1820,3,1,3,0,1,0,58.41
臺北市,中山區,中庄里,689,2,957,2,959,1584,3,1,3,0,1,0,60.54
臺北市,中山區,中庄里,690,2,923,4,927,1490,3,1,3,0,1,0,62.21
臺北市,中山區,中庄里,691,2,807,4,811,1413,3,1,3,0,1,0,57.40
臺北市,中山區,行政里,692,2,852,4,856,2609,3,1,3,0,1,0,32.81
臺北市,中山區,行政里,693,2,987,6,993,1672,3,1,3,0,1,0,59.39
臺北市,中山區,行政里,694,2,864,10,874,1420,3,1,3,0,1,0,61.55
臺北市,中山區,行仁里,695,2,1095,6,1101,1791,3,1,3,0,1,0,61.47
臺北市,中山區,行仁里,696,2,1038,4,1042,1737,3,1,3,0,1,0,59.99
臺北市,中山區,行仁里,697,2,998,7,1005,1570,3,1,3,0,1,0,64.01
臺北市,中山區,行仁里,698,2,881,9,890,1491,3,1,3,0,1,0,59.69
臺北市,中山區,行孝里,699,2,1024,1,1025,1644,3,1,3,0,1,0,62.35
臺北市,中山區,行孝里,700,2,1025,10,1035,1738,3,1,3,0,1,0,59.55
臺北市,中山區,下埤里,701,2,1242,2,1244,1998,3,1,3,0,1,0,62.26
臺北市,中山區,下埤里,702,2,1196,6,1202,2031,3,1,3,0,1,0,59.18
臺北市,中山區,下埤里,703,2,1094,12,1106,1946,3,1,3,0,1,0,56.83
臺北市,中山區,江寧里,704,2,1138,7,1145,1883,3,1,3,0,1,0,60.81
臺北市,中山區,江寧里,705,2,1084,3,1087,1802,3,1,3,0,1,0,60.32
臺北市,中山區,江寧里,706,2,1075,5,1080,1803,3,1,3,0,1,0,59.90
臺北市,中山區,江山里,707,2,923,1,924,1479,3,1,3,0,1,0,62.47
臺北市,中山區,江山里,708,2,1040,5,1045,1709,3,1,3,0,1,0,61.15
臺北市,中山區,江山里,709,2,1007,6,1013,1655,3,1,3,0,1,0,61.21
臺北市,中山區,江山里,710,2,891,2,893,1441,3,1,3,0,1,0,61.97
臺北市,中山區,中吉里,711,2,1345,3,1348,2165,3,1,3,0,1,0,62.26
臺北市,中山區,中吉里,712,2,1137,3,1140,1907,3,1,3,0,1,0,59.78
臺北市,中山區,中原里,713,2,1146,5,1151,1902,3,1,3,0,1,0,60.52
臺北市,中山區,中原里,714,2,1133,12,1145,1958,3,1,3,0,1,0,58.48
臺北市,中山區,興亞里,715,2,1165,4,1169,1945,3,1,3,0,1,0,60.10
臺北市,中山區,興亞里,716,2,1278,5,1283,2169,3,1,3,0,1,0,59.15
臺北市,中山區,中央里,717,2,911,3,914,1480,3,1,3,0,1,0,61.76
臺北市,中山區,中央里,718,2,838,7,845,1368,3,1,3,0,1,0,61.77
臺北市,中山區,朱馥里,719,2,992,9,1001,1638,3,1,3,0,1,0,61.11
臺北市,中山區,朱馥里,720,2,992,6,998,1621,3,1,3,0,1,0,61.57
臺北市,中山區,朱馥里,721,2,1041,6,1047,1694,3,1,3,0,1,0,61.81
臺北市,中山區,龍洲里,722,2,931,3,934,1428,3,1,3,0,1,0,65.41
臺北市,中山區,龍洲里,723,2,1069,6,1075,1541,3,1,3,0,1,0,69.76
臺北市,中山區,龍洲里,724,2,875,7,882,1282,3,1,3,0,1,0,68.80
臺北市,中山區,朱園里,725,2,1087,4,1091,1716,3,1,3,0,1,0,63.58
臺北市,中山區,朱園里,726,2,1070,10,1080,1828,3,1,3,0,1,0,59.08
臺北市,中山區,埤頭里,727,2,955,5,960,1543,3,1,3,0,1,0,62.22
臺北市,中山區,埤頭里,728,2,1069,8,1077,1741,3,1,3,0,1,0,61.86
臺北市,中山區,朱崙里,729,2,757,3,760,1357,3,1,3,0,1,0,56.01
臺北市,中山區,朱崙里,730,2,738,3,741,1206,3,1,3,0,1,0,61.44
臺北市,中山區,力行里,731,2,1127,12,1139,1812,3,1,3,0,1,0,62.86
臺北市,中山區,力行里,732,2,848,4,852,1509,3,1,3,0,1,0,56.46
臺北市,中山區,力行里,733,2,903,2,905,1454,3,1,3,0,1,0,62.24
臺北市,中山區,復華里,734,2,1006,5,1011,1660,3,1,3,0,1,0,60.90
臺北市,中山區,復華里,735,2,913,5,918,1554,3,1,3,0,1,0,59.07
臺北市,中山區,金泰里,736,2,884,8,892,1449,3,1,3,0,1,0,61.56
臺北市,中山區,金泰里,737,2,876,4,880,1439,3,1,3,0,1,0,61.15
臺北市,中山區,金泰里,738,2,845,5,850,1402,3,1,3,0,1,0,60.63
臺北市,中山區,北安里,739,2,925,3,928,1387,3,1,3,0,1,0,66.91
臺北市,中山區,北安里,740,2,610,5,615,956,3,1,3,0,1,0,64.33
臺北市,大同區,玉泉里,741,2,980,7,987,1668,3,1,3,0,1,0,59.17
臺北市,大同區,玉泉里,742,2,667,8,675,1198,3,1,3,0,1,0,56.34
臺北市,大同區,建明里,743,2,821,6,827,1380,3,1,3,0,1,0,59.93
臺北市,大同區,建明里,744,2,857,4,861,1415,3,1,3,0,1,0,60.85
臺北市,大同區,建功里,745,2,1223,9,1232,1966,3,1,3,0,1,0,62.67
臺北市,大同區,建功里,746,2,1004,6,1010,1901,3,1,3,0,1,0,53.13
臺北市,大同區,建泰里,747,2,916,4,920,1498,3,1,3,0,1,0,61.42
臺北市,大同區,建泰里,748,2,885,7,892,1502,3,1,3,0,1,0,59.39
臺北市,大同區,永樂里,749,2,885,4,889,1572,3,1,3,0,1,0,56.55
臺北市,大同區,永樂里,750,2,806,6,812,1306,3,1,3,0,1,0,62.17
臺北市,大同區,永樂里,751,2,831,9,840,1376,3,1,3,0,1,0,61.05
臺北市,大同區,朝陽里,752,2,969,7,976,1698,3,1,3,0,1,0,57.48
臺北市,大同區,朝陽里,753,2,942,6,948,1606,3,1,3,0,1,0,59.03
臺北市,大同區,星明里,754,2,742,5,747,1342,3,1,3,0,1,0,55.66
臺北市,大同區,星明里,755,2,751,2,753,1269,3,1,3,0,1,0,59.34
臺北市,大同區,星明里,756,2,764,6,770,1355,3,1,3,0,1,0,56.83
臺北市,大同區,光能里,757,2,770,5,775,1294,3,1,3,0,1,0,59.89
臺北市,大同區,光能里,758,2,839,8,847,1332,3,1,3,0,1,0,63.59
臺北市,大同區,光能里,759,2,1021,10,1031,1572,3,1,3,0,1,0,65.59
臺北市,大同區,大有里,760,2,782,5,787,1299,3,1,3,0,1,0,60.59
臺北市,大同區,大有里,761,2,871,7,878,1442,3,1,3,0,1,0,60.89
臺北市,大同區,大有里,762,2,812,4,816,1292,3,1,3,0,1,0,63.16
臺北市,大同區,延平里,763,2,965,10,975,1636,3,1,3,0,1,0,59.60
臺北市,大同區,延平里,764,2,893,5,898,1559,3,1,3,0,1,0,57.60
臺北市,大同區,雙連里,765,2,983,3,986,1509,3,1,3,0,1,0,65.34
臺北市,大同區,雙連里,766,2,924,7,931,1590,3,1,3,0,1,0,58.55
臺北市,大同區,雙連里,767,2,886,6,892,1505,3,1,3,0,1,0,59.27
臺北市,大同區,雙連里,768,2,880,7,887,1537,3,1,3,0,1,0,57.71
臺北市,大同區,雙連里,769,2,868,4,872,1479,3,1,3,0,1,0,58.96
臺北市,大同區,南芳里,770,2,943,6,949,1632,3,1,3,0,1,0,58.15
臺北市,大同區,南芳里,771,2,970,13,983,1695,3,1,3,0,1,0,57.99
臺北市,大同區,民權里,772,2,1081,7,1088,1774,3,1,3,0,1,0,61.33
臺北市,大同區,民權里,773,2,1058,11,1069,1719,3,1,3,0,1,0,62.19
臺北市,大同區,民權里,774,2,978,9,987,1628,3,1,3,0,1,0,60.63
臺北市,大同區,景星里,775,2,715,9,724,1187,3,1,3,0,1,0,60.99
臺北市,大同區,景星里,776,2,727,6,733,1164,3,1,3,0,1,0,62.97
臺北市,大同區,隆和里,777,2,835,4,839,1413,3,1,3,0,1,0,59.38
臺北市,大同區,隆和里,778,2,779,7,786,1276,3,1,3,0,1,0,61.60
臺北市,大同區,蓬萊里,779,2,738,3,741,1249,3,1,3,0,1,0,59.33
臺北市,大同區,蓬萊里,780,2,736,11,747,1242,3,1,3,0,1,0,60.14
臺北市,大同區,蓬萊里,781,2,790,10,800,1348,3,1,3,0,1,0,59.35
臺北市,大同區,國順里,782,2,696,3,699,1145,3,1,3,0,1,0,61.05
臺北市,大同區,國順里,783,2,912,8,920,1492,3,1,3,0,1,0,61.66
臺北市,大同區,國慶里,784,2,956,3,959,1522,3,1,3,0,1,0,63.01
臺北市,大同區,國慶里,785,2,883,4,887,1567,3,1,3,0,1,0,56.60
臺北市,大同區,揚雅里,786,2,840,5,845,1308,3,1,3,0,1,0,64.60
臺北市,大同區,揚雅里,787,2,781,8,789,1757,3,1,3,0,1,0,44.91
臺北市,大同區,斯文里,788,2,826,15,841,1541,3,1,3,0,1,0,54.57
臺北市,大同區,斯文里,789,2,1029,6,1035,1647,3,1,3,0,1,0,62.84
臺北市,大同區,斯文里,790,2,757,6,763,1263,3,1,3,0,1,0,60.41
臺北市,大同區,鄰江里,791,2,1134,8,1142,1827,3,1,3,0,1,0,62.51
臺北市,大同區,鄰江里,792,2,1040,7,1047,1701,3,1,3,0,1,0,61.55
臺北市,大同區,鄰江里,793,2,1046,10,1056,1710,3,1,3,0,1,0,61.75
臺北市,大同區,至聖里,794,2,983,7,990,1564,3,1,3,0,1,0,63.30
臺北市,大同區,至聖里,795,2,1019,2,1021,1601,3,1,3,0,1,0,63.77
臺北市,大同區,至聖里,796,2,983,8,991,1539,3,1,3,0,1,0,64.39
臺北市,大同區,至聖里,797,2,935,8,943,1532,3,1,3,0,1,0,61.55
臺北市,大同區,老師里,798,2,958,4,962,1626,3,1,3,0,1,0,59.16
臺北市,大同區,老師里,799,2,924,4,928,1504,3,1,3,0,1,0,61.70
臺北市,大同區,老師里,800,2,1006,8,1014,1624,3,1,3,0,1,0,62.44
臺北市,大同區,重慶里,801,2,1006,8,1014,1625,3,1,3,0,1,0,62.40
臺北市,大同區,重慶里,802,2,933,5,938,1467,3,1,3,0,1,0,63.94
臺北市,大同區,重慶里,803,2,1027,4,1031,1569,3,1,3,0,1,0,65.71
臺北市,大同區,保安里,804,2,1063,9,1072,1658,3,1,3,0,1,0,64.66
臺北市,大同區,保安里,805,2,1224,5,1229,1968,3,1,3,0,1,0,62.45
臺北市,中正區,水源里,806,2,886,6,892,1434,3,1,3,0,1,0,62.20
臺北市,中正區,水源里,807,2,668,5,673,1102,3,1,3,0,1,0,61.07
臺北市,中正區,富水里,808,2,769,6,775,1287,3,1,3,0,1,0,60.22
臺北市,中正區,富水里,809,2,790,7,797,1198,3,1,3,0,1,0,66.53
臺北市,中正區,文盛里,810,2,742,5,747,1095,3,1,3,0,1,0,68.22
臺北市,中正區,文盛里,811,2,712,2,714,1145,3,1,3,0,1,0,62.36
臺北市,中正區,林興里,812,2,830,3,833,1262,3,1,3,0,1,0,66.01
臺北市,中正區,林興里,813,2,816,6,822,1315,3,1,3,0,1,0,62.51
臺北市,中正區,林興里,814,2,788,5,793,1369,3,1,3,0,1,0,57.93
臺北市,中正區,河堤里,815,2,816,3,819,1279,3,1,3,0,1,0,64.03
臺北市,中正區,河堤里,816,2,709,6,715,1120,3,1,3,0,1,0,63.84
臺北市,中正區,河堤里,817,2,864,5,869,1409,3,1,3,0,1,0,61.67
臺北市,中正區,頂東里,818,2,1100,9,1109,1666,3,1,3,0,1,0,66.57
臺北市,中正區,頂東里,819,2,1025,3,1028,1558,3,1,3,0,1,0,65.98
臺北市,中正區,頂東里,820,2,906,5,911,1471,3,1,3,0,1,0,61.93
臺北市,中正區,網溪里,821,2,980,6,986,1558,3,1,3,0,1,0,63.29
臺北市,中正區,網溪里,822,2,886,4,890,1445,3,1,3,0,1,0,61.59
臺北市,中正區,網溪里,823,2,896,7,903,1432,3,1,3,0,1,0,63.06
臺北市,中正區,板溪里,824,2,890,5,895,1419,3,1,3,0,1,0,63.07
臺北市,中正區,板溪里,825,2,848,2,850,1389,3,1,3,0,1,0,61.20
臺北市,中正區,螢圃里,826,2,1062,1,1063,1535,3,1,3,0,1,0,69.25
臺北市,中正區,螢圃里,827,2,851,3,854,1366,3,1,3,0,1,0,62.52
臺北市,中正區,螢圃里,828,2,954,2,956,1491,3,1,3,0,1,0,64.12
臺北市,中正區,螢雪里,829,2,686,6,692,1130,3,1,3,0,1,0,61.24
臺北市,中正區,螢雪里,830,2,814,2,816,1264,3,1,3,0,1,0,64.56
臺北市,中正區,螢雪里,831,2,723,5,728,1181,3,1,3,0,1,0,61.64
臺北市,中正區,永功里,832,2,1072,4,1076,1773,3,1,3,0,1,0,60.69
臺北市,中正區,永功里,833,2,1069,4,1073,1719,3,1,3,0,1,0,62.42
臺北市,中正區,永功里,834,2,835,3,838,1449,3,1,3,0,1,0,57.83
臺北市,中正區,永昌里,835,2,952,6,958,1488,3,1,3,0,1,0,64.38
臺北市,中正區,永昌里,836,2,928,1,929,1497,3,1,3,0,1,0,62.06
臺北市,中正區,永昌里,837,2,885,3,888,1394,3,1,3,0,1,0,63.70
臺北市,中正區,龍興里,838,2,1001,10,1011,1653,3,1,3,0,1,0,61.16
臺北市,中正區,龍興里,839,2,856,5,861,1413,3,1,3,0,1,0,60.93
臺北市,中正區,忠勤里,840,2,895,10,905,1530,3,1,3,0,1,0,59.15
臺北市,中正區,忠勤里,841,2,901,8,909,1453,3,1,3,0,1,0,62.56
臺北市,中正區,忠勤里,842,2,800,8,808,1349,3,1,3,0,1,0,59.90
臺北市,中正區,忠勤里,843,2,858,8,866,1357,3,1,3,0,1,0,63.82
臺北市,中正區,廈安里,844,2,869,6,875,1437,3,1,3,0,1,0,60.89
臺北市,中正區,廈安里,845,2,919,6,925,1565,3,1,3,0,1,0,59.11
臺北市,中正區,愛國里,846,2,802,0,802,1255,3,1,3,0,1,0,63.90
臺北市,中正區,愛國里,847,2,775,3,778,1214,3,1,3,0,1,0,64.09
臺北市,中正區,南門里,848,2,741,4,745,1119,3,1,3,0,1,0,66.58
臺北市,中正區,南門里,849,2,670,1,671,1087,3,1,3,0,1,0,61.73
臺北市,中正區,龍光里,850,2,839,2,841,1443,3,1,3,0,1,0,58.28
臺北市,中正區,龍光里,851,2,847,7,854,1329,3,1,3,0,1,0,64.26
臺北市,中正區,南福里,852,2,1087,7,1094,1662,3,1,3,0,1,0,65.82
臺北市,中正區,南福里,853,2,1062,4,1066,1613,3,1,3,0,1,0,66.09
臺北市,中正區,南福里,854,2,924,5,929,1470,3,1,3,0,1,0,63.20
臺北市,中正區,南福里,855,2,959,5,964,1483,3,1,3,0,1,0,65.00
臺北市,中正區,龍福里,856,2,1015,11,1026,2224,3,1,3,0,1,0,46.13
臺北市,中正區,龍福里,857,2,967,3,970,1567,3,1,3,0,1,0,61.90
臺北市,中正區,龍福里,858,2,1032,7,1039,1632,3,1,3,0,1,0,63.66
臺北市,中正區,新營里,859,2,1029,8,1037,1574,3,1,3,0,1,0,65.88
臺北市,中正區,新營里,860,2,1047,8,1055,1588,3,1,3,0,1,0,66.44
臺北市,中正區,新營里,861,2,1029,9,1038,1602,3,1,3,0,1,0,64.79
臺北市,中正區,新營里,862,2,995,11,1006,1555,3,1,3,0,1,0,64.69
臺北市,中正區,建國里,863,2,644,3,647,1098,3,1,3,0,1,0,58.93
臺北市,中正區,光復里,864,2,802,6,808,1339,3,1,3,0,1,0,60.34
臺北市,中正區,光復里,865,2,935,9,944,1665,3,1,3,0,1,0,56.7
臺北市,中正區,黎明里,866,2,634,4,638,1228,3,1,3,0,1,0,51.95
臺北市,中正區,黎明里,867,2,685,0,685,1210,3,1,3,0,1,0,56.61
臺北市,中正區,梅花里,868,2,877,5,882,1462,3,1,3,0,1,0,60.33
臺北市,中正區,梅花里,869,2,805,3,808,1323,3,1,3,0,1,0,61.07
臺北市,中正區,幸福里,870,2,1089,5,1094,1834,3,1,3,0,1,0,59.65
臺北市,中正區,幸福里,871,2,1121,1,1122,1847,3,1,3,0,1,0,60.75
臺北市,中正區,幸市里,872,2,1062,4,1066,1703,3,1,3,0,1,0,62.6
臺北市,中正區,幸市里,873,2,1019,3,1022,1691,3,1,3,0,1,0,60.44
臺北市,中正區,東門里,874,2,735,3,738,1152,3,1,3,0,1,0,64.06
臺北市,中正區,東門里,875,2,720,4,724,1159,3,1,3,0,1,0,62.47
臺北市,中正區,東門里,876,2,726,4,730,1238,3,1,3,0,1,0,58.97
臺北市,中正區,文北里,877,2,882,3,885,1420,3,1,3,0,1,0,62.32
臺北市,中正區,文北里,878,2,866,4,870,1383,3,1,3,0,1,0,62.91
臺北市,中正區,文北里,879,2,842,6,848,1335,3,1,3,0,1,0,63.52
臺北市,中正區,文祥里,880,2,893,4,897,1440,3,1,3,0,1,0,62.29
臺北市,中正區,文祥里,881,2,788,1,789,1220,3,1,3,0,1,0,64.67
臺北市,中正區,文祥里,882,2,888,7,895,1397,3,1,3,0,1,0,64.07
臺北市,中正區,文祥里,883,2,904,7,911,1397,3,1,3,0,1,0,65.21
臺北市,中正區,三愛里,884,2,846,3,849,1364,3,1,3,0,1,0,62.24
臺北市,中正區,三愛里,885,2,1064,3,1067,1663,3,1,3,0,1,0,64.16
臺北市,中正區,三愛里,886,2,875,6,881,1353,3,1,3,0,1,0,65.11
臺北市,中正區,三愛里,887,2,1106,1,1107,1690,3,1,3,0,1,0,65.5
臺北市,萬華區,福星里,888,2,893,5,898,1505,3,1,3,0,1,0,59.67
臺北市,萬華區,福星里,889,2,624,8,632,1091,3,1,3,0,1,0,57.93
臺北市,萬華區,福星里,890,2,940,8,948,1652,3,1,3,0,1,0,57.38
臺北市,萬華區,萬壽里,891,2,666,5,671,1275,3,1,3,0,1,0,52.63
臺北市,萬華區,萬壽里,892,2,819,10,829,1499,3,1,3,0,1,0,55.3
臺北市,萬華區,西門里,893,2,852,3,855,1571,3,1,3,0,1,0,54.42
臺北市,萬華區,西門里,894,2,753,7,760,1391,3,1,3,0,1,0,54.64
臺北市,萬華區,新起里,895,2,828,7,835,1412,3,1,3,0,1,0,59.14
臺北市,萬華區,新起里,896,2,905,7,912,1580,3,1,3,0,1,0,57.72
臺北市,萬華區,新起里,897,2,800,4,804,1439,3,1,3,0,1,0,55.87
臺北市,萬華區,新起里,898,2,872,6,878,1424,3,1,3,0,1,0,61.66
臺北市,萬華區,菜園里,899,2,925,5,930,1587,3,1,3,0,1,0,58.6
臺北市,萬華區,菜園里,900,2,927,3,930,1549,3,1,3,0,1,0,60.04
臺北市,萬華區,菜園里,901,2,1040,7,1047,1773,3,1,3,0,1,0,59.05
臺北市,萬華區,青山里,902,2,901,8,909,1516,3,1,3,0,1,0,59.96
臺北市,萬華區,青山里,903,2,914,5,919,1558,3,1,3,0,1,0,58.99
臺北市,萬華區,青山里,904,2,792,7,799,1413,3,1,3,0,1,0,56.55
臺北市,萬華區,富民里,905,2,1029,4,1033,1690,3,1,3,0,1,0,61.12
臺北市,萬華區,富民里,906,2,676,2,678,1180,3,1,3,0,1,0,57.46
臺北市,萬華區,富民里,907,2,842,5,847,1368,3,1,3,0,1,0,61.92
臺北市,萬華區,福音里,908,2,980,5,985,1570,3,1,3,0,1,0,62.74
臺北市,萬華區,福音里,909,2,934,10,944,1487,3,1,3,0,1,0,63.48
臺北市,萬華區,仁德里,910,2,1195,10,1205,1876,3,1,3,0,1,0,64.23
臺北市,萬華區,仁德里,911,2,1091,4,1095,1681,3,1,3,0,1,0,65.14
臺北市,萬華區,富福里,912,2,846,6,852,1634,3,1,3,0,1,0,52.14
臺北市,萬華區,富福里,913,2,742,4,746,1159,3,1,3,0,1,0,64.37
臺北市,萬華區,富福里,914,2,877,5,882,1390,3,1,3,0,1,0,63.45
臺北市,萬華區,柳鄉里,915,2,995,5,1000,1748,3,1,3,0,1,0,57.21
臺北市,萬華區,柳鄉里,916,2,761,4,765,1236,3,1,3,0,1,0,61.89
臺北市,萬華區,柳鄉里,917,2,905,12,917,1480,3,1,3,0,1,0,61.96
臺北市,萬華區,華江里,918,2,1026,8,1034,1626,3,1,3,0,1,0,63.59
臺北市,萬華區,華江里,919,2,918,8,926,1555,3,1,3,0,1,0,59.55
臺北市,萬華區,華江里,920,2,1161,4,1165,1871,3,1,3,0,1,0,62.27
臺北市,萬華區,華江里,921,2,1100,10,1110,1952,3,1,3,0,1,0,56.86
臺北市,萬華區,糖部里,922,2,816,7,823,1453,3,1,3,0,1,0,56.64
臺北市,萬華區,糖部里,923,2,898,6,904,1536,3,1,3,0,1,0,58.85
臺北市,萬華區,糖部里,924,2,877,5,882,1536,3,1,3,0,1,0,57.42
臺北市,萬華區,綠堤里,925,2,851,5,856,1384,3,1,3,0,1,0,61.85
臺北市,萬華區,綠堤里,926,2,639,5,644,1230,3,1,3,0,1,0,52.36
臺北市,萬華區,綠堤里,927,2,757,9,766,1289,3,1,3,0,1,0,59.43
臺北市,萬華區,頂碩里,928,2,1152,12,1164,1794,3,1,3,0,1,0,64.88
臺北市,萬華區,頂碩里,929,2,1112,7,1119,2185,3,1,3,0,1,0,51.21
臺北市,萬華區,頂碩里,930,2,1055,4,1059,1713,3,1,3,0,1,0,61.82
臺北市,萬華區,頂碩里,931,2,774,7,781,1224,3,1,3,0,1,0,63.81
臺北市,萬華區,雙園里,932,2,802,5,807,1314,3,1,3,0,1,0,61.42
臺北市,萬華區,雙園里,933,2,851,1,852,1331,3,1,3,0,1,0,64.01
臺北市,萬華區,雙園里,934,2,844,7,851,1407,3,1,3,0,1,0,60.48
臺北市,萬華區,和平里,935,2,1001,11,1012,1643,3,1,3,0,1,0,61.59
臺北市,萬華區,和平里,936,2,953,5,958,1544,3,1,3,0,1,0,62.05
臺北市,萬華區,和平里,937,2,812,4,816,1273,3,1,3,0,1,0,64.1
臺北市,萬華區,和平里,938,2,936,7,943,1583,3,1,3,0,1,0,59.57
臺北市,萬華區,和德里,939,2,950,4,954,1568,3,1,3,0,1,0,60.84
臺北市,萬華區,和德里,940,2,749,12,761,1463,3,1,3,0,1,0,52.02
臺北市,萬華區,和德里,941,2,792,1,793,1430,3,1,3,0,1,0,55.45
臺北市,萬華區,和德里,942,2,837,4,841,1403,3,1,3,0,1,0,59.94
臺北市,萬華區,全德里,943,2,1068,10,1078,1773,3,1,3,0,1,0,60.8
臺北市,萬華區,全德里,944,2,1093,8,1101,1775,3,1,3,0,1,0,62.03
臺北市,萬華區,日善里,945,2,964,2,966,1545,3,1,3,0,1,0,62.52
臺北市,萬華區,日善里,946,2,1055,11,1066,1688,3,1,3,0,1,0,63.15
臺北市,萬華區,壽德里,947,2,936,7,943,1474,3,1,3,0,1,0,63.98
臺北市,萬華區,壽德里,948,2,933,5,938,1580,3,1,3,0,1,0,59.37
臺北市,萬華區,壽德里,949,2,744,6,750,1197,3,1,3,0,1,0,62.66
臺北市,萬華區,忠德里,950,2,1085,7,1092,1777,3,1,3,0,1,0,61.45
臺北市,萬華區,忠德里,951,2,1198,11,1209,1971,3,1,3,0,1,0,61.34
臺北市,萬華區,錦德里,952,2,906,7,913,1505,3,1,3,0,1,0,60.66
臺北市,萬華區,錦德里,953,2,949,4,953,1591,3,1,3,0,1,0,59.9
臺北市,萬華區,錦德里,954,2,798,7,805,1314,3,1,3,0,1,0,61.26
臺北市,萬華區,銘德里,955,2,878,6,884,1395,3,1,3,0,1,0,63.37
臺北市,萬華區,銘德里,956,2,892,7,899,1431,3,1,3,0,1,0,62.82
臺北市,萬華區,銘德里,957,2,688,5,693,1126,3,1,3,0,1,0,61.55
臺北市,萬華區,孝德里,958,2,858,0,858,1437,3,1,3,0,1,0,59.71
臺北市,萬華區,孝德里,959,2,793,5,798,1238,3,1,3,0,1,0,64.46
臺北市,萬華區,保德里,960,2,837,2,839,1248,3,1,3,0,1,0,67.23
臺北市,萬華區,保德里,961,2,803,4,807,1233,3,1,3,0,1,0,65.45
臺北市,萬華區,榮德里,962,2,1002,4,1006,1522,3,1,3,0,1,0,66.1
臺北市,萬華區,榮德里,963,2,1038,9,1047,1658,3,1,3,0,1,0,63.15
臺北市,萬華區,華中里,964,2,1162,6,1168,1867,3,1,3,0,1,0,62.56
臺北市,萬華區,華中里,965,2,1069,7,1076,1727,3,1,3,0,1,0,62.3
臺北市,萬華區,華中里,966,2,978,14,992,1565,3,1,3,0,1,0,63.39
臺北市,萬華區,興德里,967,2,813,10,823,1264,3,1,3,0,1,0,65.11
臺北市,萬華區,興德里,968,2,864,4,868,1385,3,1,3,0,1,0,62.67
臺北市,萬華區,興德里,969,2,775,3,778,1334,3,1,3,0,1,0,58.32
臺北市,萬華區,日祥里,970,2,858,0,858,1398,3,1,3,0,1,0,61.37
臺北市,萬華區,日祥里,971,2,991,7,998,1654,3,1,3,0,1,0,60.34
臺北市,萬華區,日祥里,972,2,871,5,876,1270,3,1,3,0,1,0,68.98
臺北市,萬華區,忠貞里,973,2,950,7,957,1329,3,1,3,0,1,0,72.01
臺北市,萬華區,忠貞里,974,2,1036,5,1041,1550,3,1,3,0,1,0,67.16
臺北市,萬華區,忠貞里,975,2,913,4,917,1448,3,1,3,0,1,0,63.33
臺北市,萬華區,新忠里,976,2,958,4,962,1554,3,1,3,0,1,0,61.9
臺北市,萬華區,新忠里,977,2,1233,6,1239,1738,3,1,3,0,1,0,71.29
臺北市,萬華區,新和里,978,2,1091,7,1098,1525,3,1,3,0,1,0,72
臺北市,萬華區,新和里,979,2,1013,2,1015,1486,3,1,3,0,1,0,68.3
臺北市,萬華區,新和里,980,2,993,1,994,1481,3,1,3,0,1,0,67.12
臺北市,萬華區,新和里,981,2,914,6,920,1448,3,1,3,0,1,0,63.54
臺北市,萬華區,新和里,982,2,1012,5,1017,1435,3,1,3,0,1,0,70.87
臺北市,萬華區,新安里,983,2,894,4,898,1498,3,1,3,0,1,0,59.95
臺北市,萬華區,新安里,984,2,811,7,818,1401,3,1,3,0,1,0,58.39
臺北市,萬華區,新安里,985,2,752,11,763,1172,3,1,3,0,1,0,65.1
臺北市,萬華區,新安里,986,2,874,3,877,1294,3,1,3,0,1,0,67.77
臺北市,萬華區,凌霄里,987,2,1094,6,1100,1768,3,1,3,0,1,0,62.22
臺北市,萬華區,凌霄里,988,2,1107,6,1113,1657,3,1,3,0,1,0,67.17
臺北市,萬華區,騰雲里,989,2,840,1,841,1325,3,1,3,0,1,0,63.47
臺北市,萬華區,騰雲里,990,2,847,6,853,1308,3,1,3,0,1,0,65.21
臺北市,大安區,德安里,991,2,995,3,998,1534,3,1,3,0,1,0,65.06
臺北市,大安區,德安里,992,2,1008,4,1012,1567,3,1,3,0,1,0,64.58
臺北市,大安區,德安里,993,2,839,6,845,1480,3,1,3,0,1,0,57.09
臺北市,大安區,仁慈里,994,2,1180,8,1188,1952,3,1,3,0,1,0,60.86
臺北市,大安區,仁慈里,995,2,1162,2,1164,1924,3,1,3,0,1,0,60.5
臺北市,大安區,和安里,996,2,994,2,996,1628,3,1,3,0,1,0,61.18
臺北市,大安區,和安里,997,2,993,7,1000,1674,3,1,3,0,1,0,59.74
臺北市,大安區,和安里,998,2,1096,6,1102,1679,3,1,3,0,1,0,65.63
臺北市,大安區,民炤里,999,2,977,4,981,1602,3,1,3,0,1,0,61.24
臺北市,大安區,民炤里,1000,2,961,1,962,1539,3,1,3,0,1,0,62.51
臺北市,大安區,民炤里,1001,2,882,2,884,1454,3,1,3,0,1,0,60.8
臺北市,大安區,民炤里,1002,2,1004,8,1012,1685,3,1,3,0,1,0,60.06
臺北市,大安區,仁愛里,1003,2,791,3,794,1464,3,1,3,0,1,0,54.23
臺北市,大安區,仁愛里,1004,2,826,5,831,1546,3,1,3,0,1,0,53.75
臺北市,大安區,仁愛里,1005,2,903,3,906,1604,3,1,3,0,1,0,56.48
臺北市,大安區,義村里,1006,2,1102,5,1107,1643,3,1,3,0,1,0,67.38
臺北市,大安區,義村里,1007,2,1172,5,1177,1820,3,1,3,0,1,0,64.67
臺北市,大安區,義村里,1008,2,1245,1,1246,1980,3,1,3,0,1,0,62.93
臺北市,大安區,民輝里,1009,2,1294,3,1297,2061,3,1,3,0,1,0,62.93
臺北市,大安區,民輝里,1010,2,1242,5,1247,2007,3,1,3,0,1,0,62.13
臺北市,大安區,民輝里,1011,2,789,2,791,1389,3,1,3,0,1,0,56.95
臺北市,大安區,昌隆里,1012,2,806,4,810,1241,3,1,3,0,1,0,65.27
臺北市,大安區,昌隆里,1013,2,927,1,928,1449,3,1,3,0,1,0,64.04
臺北市,大安區,誠安里,1014,2,1100,7,1107,1761,3,1,3,0,1,0,62.86
臺北市,大安區,誠安里,1015,2,1169,5,1174,1917,3,1,3,0,1,0,61.24
臺北市,大安區,光武里,1016,2,816,8,824,1461,3,1,3,0,1,0,56.4
臺北市,大安區,光武里,1017,2,821,3,824,1422,3,1,3,0,1,0,57.95
臺北市,大安區,光武里,1018,2,934,4,938,1630,3,1,3,0,1,0,57.55
臺北市,大安區,光武里,1019,2,1097,5,1102,1874,3,1,3,0,1,0,58.8
臺北市,大安區,龍坡里,1020,2,941,6,947,1476,3,1,3,0,1,0,64.16
臺北市,大安區,龍坡里,1021,2,877,1,878,1362,3,1,3,0,1,0,64.46
臺北市,大安區,龍坡里,1022,2,1143,2,1145,1773,3,1,3,0,1,0,64.58
臺北市,大安區,龍泉里,1023,2,1187,4,1191,1886,3,1,3,0,1,0,63.15
臺北市,大安區,龍泉里,1024,2,1024,4,1028,1709,3,1,3,0,1,0,60.15
臺北市,大安區,古風里,1025,2,978,5,983,1520,3,1,3,0,1,0,64.67
臺北市,大安區,古風里,1026,2,1069,3,1072,1740,3,1,3,0,1,0,61.61
臺北市,大安區,古莊里,1027,2,1123,6,1129,1867,3,1,3,0,1,0,60.47
臺北市,大安區,古莊里,1028,2,1011,5,1016,1637,3,1,3,0,1,0,62.06
臺北市,大安區,古莊里,1029,2,1015,6,1021,1599,3,1,3,0,1,0,63.85
臺北市,大安區,龍安里,1030,2,291,4,295,1785,3,1,3,0,1,0,16.53
臺北市,大安區,龍安里,1031,2,955,7,962,1475,3,1,3,0,1,0,65.22
臺北市,大安區,龍安里,1032,2,948,6,954,1456,3,1,3,0,1,0,65.52
臺北市,大安區,龍安里,1033,2,643,1,644,1026,3,1,3,0,1,0,62.77
臺北市,大安區,錦安里,1034,2,800,1,801,1249,3,1,3,0,1,0,64.13
臺北市,大安區,錦安里,1035,2,871,2,873,1303,3,1,3,0,1,0,67
臺北市,大安區,錦安里,1036,2,898,6,904,1455,3,1,3,0,1,0,62.13
臺北市,大安區,福住里,1037,2,785,1,786,1300,3,1,3,0,1,0,60.46
臺北市,大安區,福住里,1038,2,947,1,948,1490,3,1,3,0,1,0,63.62
臺北市,大安區,福住里,1039,2,982,5,987,1571,3,1,3,0,1,0,62.83
臺北市,大安區,永康里,1040,2,893,2,895,1347,3,1,3,0,1,0,66.44
臺北市,大安區,永康里,1041,2,789,1,790,1208,3,1,3,0,1,0,65.4
臺北市,大安區,光明里,1042,2,916,3,919,1437,3,1,3,0,1,0,63.95
臺北市,大安區,光明里,1043,2,966,10,976,1487,3,1,3,0,1,0,65.64
臺北市,大安區,錦泰里,1044,2,1406,2,1408,2048,3,1,3,0,1,0,68.75
臺北市,大安區,錦泰里,1045,2,1213,8,1221,1857,3,1,3,0,1,0,65.75
臺北市,大安區,錦華里,1046,2,888,3,891,1326,3,1,3,0,1,0,67.19
臺北市,大安區,錦華里,1047,2,937,2,939,1430,3,1,3,0,1,0,65.66
臺北市,大安區,錦華里,1048,2,799,9,808,1286,3,1,3,0,1,0,62.83
臺北市,大安區,龍圖里,1049,2,1070,5,1075,1775,3,1,3,0,1,0,60.56
臺北市,大安區,龍圖里,1050,2,1095,4,1099,1713,3,1,3,0,1,0,64.16
臺北市,大安區,龍圖里,1051,2,1057,5,1062,1763,3,1,3,0,1,0,60.24
臺北市,大安區,新龍里,1052,2,1109,8,1117,1719,3,1,3,0,1,0,64.98
臺北市,大安區,新龍里,1053,2,1115,7,1122,1672,3,1,3,0,1,0,67.11
臺北市,大安區,新龍里,1054,2,1173,4,1177,1778,3,1,3,0,1,0,66.2
臺北市,大安區,龍陣里,1055,2,883,8,891,1424,3,1,3,0,1,0,62.57
臺北市,大安區,龍陣里,1056,2,967,8,975,1536,3,1,3,0,1,0,63.48
臺北市,大安區,龍雲里,1057,2,821,3,824,1279,3,1,3,0,1,0,64.43
臺北市,大安區,龍雲里,1058,2,882,3,885,1429,3,1,3,0,1,0,61.93
臺北市,大安區,龍雲里,1059,2,807,4,811,1358,3,1,3,0,1,0,59.72
臺北市,大安區,龍生里,1060,2,1104,6,1110,1605,3,1,3,0,1,0,69.16
臺北市,大安區,龍生里,1061,2,1121,3,1124,1732,3,1,3,0,1,0,64.9
臺北市,大安區,龍生里,1062,2,1056,8,1064,1642,3,1,3,0,1,0,64.8
臺北市,大安區,住安里,1063,2,938,8,946,1512,3,1,3,0,1,0,62.57
臺北市,大安區,住安里,1064,2,753,9,762,1276,3,1,3,0,1,0,59.72
臺北市,大安區,住安里,1065,2,932,6,938,1567,3,1,3,0,1,0,59.86
臺北市,大安區,義安里,1066,2,950,4,954,1586,3,1,3,0,1,0,60.15
臺北市,大安區,義安里,1067,2,900,2,902,1482,3,1,3,0,1,0,60.86
臺北市,大安區,義安里,1068,2,845,4,849,1386,3,1,3,0,1,0,61.26
臺北市,大安區,通化里,1069,2,882,2,884,1448,3,1,3,0,1,0,61.05
臺北市,大安區,通化里,1070,2,1082,7,1089,1760,3,1,3,0,1,0,61.88
臺北市,大安區,通化里,1071,2,1069,3,1072,1772,3,1,3,0,1,0,60.5
臺北市,大安區,通安里,1072,2,1052,3,1055,1672,3,1,3,0,1,0,63.1
臺北市,大安區,通安里,1073,2,859,3,862,1513,3,1,3,0,1,0,56.97
臺北市,大安區,通安里,1074,2,959,5,964,1540,3,1,3,0,1,0,62.6
臺北市,大安區,臨江里,1075,2,1011,7,1018,1682,3,1,3,0,1,0,60.52
臺北市,大安區,臨江里,1076,2,1105,2,1107,1788,3,1,3,0,1,0,61.91
臺北市,大安區,法治里,1077,2,1129,5,1134,1781,3,1,3,0,1,0,63.67
臺北市,大安區,法治里,1078,2,1093,8,1101,1787,3,1,3,0,1,0,61.61
臺北市,大安區,全安里,1079,2,1058,4,1062,1709,3,1,3,0,1,0,62.14
臺北市,大安區,全安里,1080,2,1093,2,1095,1784,3,1,3,0,1,0,61.38
臺北市,大安區,群賢里,1081,2,1067,2,1069,1723,3,1,3,0,1,0,62.04
臺北市,大安區,群賢里,1082,2,941,2,943,1495,3,1,3,0,1,0,63.08
臺北市,大安區,群賢里,1083,2,1032,10,1042,1739,3,1,3,0,1,0,59.92
臺北市,大安區,群英里,1084,2,909,9,918,1334,3,1,3,0,1,0,68.82
臺北市,大安區,群英里,1085,2,1092,5,1097,1597,3,1,3,0,1,0,68.69
臺北市,大安區,群英里,1086,2,956,1,957,1388,3,1,3,0,1,0,68.95
臺北市,大安區,群英里,1087,2,1086,4,1090,1620,3,1,3,0,1,0,67.28
臺北市,大安區,虎嘯里,1088,2,970,3,973,1595,3,1,3,0,1,0,61
臺北市,大安區,虎嘯里,1089,2,704,4,708,1127,3,1,3,0,1,0,62.82
臺北市,大安區,臥龍里,1090,2,1074,5,1079,1774,3,1,3,0,1,0,60.82
臺北市,大安區,龍淵里,1091,2,1061,6,1067,1699,3,1,3,0,1,0,62.8
臺北市,大安區,龍淵里,1092,2,1221,1,1222,1849,3,1,3,0,1,0,66.09
臺北市,大安區,龍淵里,1093,2,1063,6,1069,1658,3,1,3,0,1,0,64.48
臺北市,大安區,龍淵里,1094,2,1114,3,1117,1722,3,1,3,0,1,0,64.87
臺北市,大安區,龍門里,1095,2,1064,7,1071,1724,3,1,3,0,1,0,62.12
臺北市,大安區,龍門里,1096,2,1004,3,1007,1582,3,1,3,0,1,0,63.65
臺北市,大安區,大學里,1097,2,999,4,1003,1589,3,1,3,0,1,0,63.12
臺北市,大安區,大學里,1098,2,1019,9,1028,1651,3,1,3,0,1,0,62.27
臺北市,大安區,大學里,1099,2,964,6,970,1618,3,1,3,0,1,0,59.95
臺北市,大安區,大學里,1100,2,1008,2,1010,1615,3,1,3,0,1,0,62.54
臺北市,大安區,芳和里,1101,2,1045,4,1049,1602,3,1,3,0,1,0,65.48
臺北市,大安區,芳和里,1102,2,997,9,1006,1621,3,1,3,0,1,0,62.06
臺北市,大安區,芳和里,1103,2,1176,4,1180,1848,3,1,3,0,1,0,63.85
臺北市,大安區,黎元里,1104,2,829,5,834,1369,3,1,3,0,1,0,60.92
臺北市,大安區,黎元里,1105,2,1083,6,1089,1712,3,1,3,0,1,0,63.61
臺北市,大安區,黎元里,1106,2,913,3,916,1417,3,1,3,0,1,0,64.64
臺北市,大安區,黎孝里,1107,2,937,14,951,1484,3,1,3,0,1,0,64.08
臺北市,大安區,黎孝里,1108,2,945,3,948,1518,3,1,3,0,1,0,62.45
臺北市,大安區,黎孝里,1109,2,1060,6,1066,1588,3,1,3,0,1,0,67.13
臺北市,大安區,黎孝里,1110,2,1050,5,1055,1639,3,1,3,0,1,0,64.37
臺北市,大安區,黎和里,1111,2,958,6,964,1655,3,1,3,0,1,0,58.25
臺北市,大安區,黎和里,1112,2,1203,9,1212,1911,3,1,3,0,1,0,63.42
臺北市,大安區,建安里,1113,2,707,6,713,1309,3,1,3,0,1,0,54.47
臺北市,大安區,建安里,1114,2,831,5,836,1393,3,1,3,0,1,0,60.01
臺北市,大安區,建安里,1115,2,754,5,759,1387,3,1,3,0,1,0,54.72
臺北市,大安區,建倫里,1116,2,955,2,957,1652,3,1,3,0,1,0,57.93
臺北市,大安區,建倫里,1117,2,1000,5,1005,1659,3,1,3,0,1,0,60.58
臺北市,大安區,建倫里,1118,2,843,6,849,1559,3,1,3,0,1,0,54.46
臺北市,大安區,敦安里,1119,2,1159,4,1163,1908,3,1,3,0,1,0,60.95
臺北市,大安區,敦安里,1120,2,995,6,1001,1633,3,1,3,0,1,0,61.3
臺北市,大安區,敦安里,1121,2,869,2,871,1428,3,1,3,0,1,0,60.99
臺北市,大安區,正聲里,1122,2,695,5,700,1167,3,1,3,0,1,0,59.98
臺北市,大安區,正聲里,1123,2,796,2,798,1312,3,1,3,0,1,0,60.82
臺北市,大安區,正聲里,1124,2,834,1,835,1491,3,1,3,0,1,0,56
臺北市,大安區,敦煌里,1125,2,1026,7,1033,1656,3,1,3,0,1,0,62.38
臺北市,大安區,敦煌里,1126,2,969,2,971,1592,3,1,3,0,1,0,60.99
臺北市,大安區,敦煌里,1127,2,930,3,933,1521,3,1,3,0,1,0,61.34
臺北市,大安區,華聲里,1128,2,1018,3,1021,1720,3,1,3,0,1,0,59.36
臺北市,大安區,華聲里,1129,2,1073,9,1082,1779,3,1,3,0,1,0,60.82
臺北市,大安區,車層里,1130,2,1020,4,1024,1755,3,1,3,0,1,0,58.35
臺北市,大安區,車層里,1131,2,1081,5,1086,1799,3,1,3,0,1,0,60.37
臺北市,大安區,車層里,1132,2,999,2,1001,1698,3,1,3,0,1,0,58.95
臺北市,大安區,光信里,1133,2,973,10,983,1614,3,1,3,0,1,0,60.9
臺北市,大安區,光信里,1134,2,1022,3,1025,1634,3,1,3,0,1,0,62.73
臺北市,大安區,光信里,1135,2,889,4,893,1519,3,1,3,0,1,0,58.79
臺北市,大安區,光信里,1136,2,968,3,971,1518,3,1,3,0,1,0,63.97
臺北市,大安區,學府里,1137,2,687,1,688,1077,3,1,3,0,1,0,63.88
臺北市,大安區,學府里,1138,2,478,3,481,752,3,1,3,0,1,0,63.96
臺北市,大安區,學府里,1139,2,767,3,770,1234,3,1,3,0,1,0,62.4
臺北市,文山區,景行里,1140,2,830,3,833,1357,3,1,3,0,1,0,61.39
臺北市,文山區,景行里,1141,2,899,7,906,1440,3,1,3,0,1,0,62.92
臺北市,文山區,景行里,1142,2,932,5,937,1566,3,1,3,0,1,0,59.83
臺北市,文山區,景東里,1143,2,1082,4,1086,1781,3,1,3,0,1,0,60.98
臺北市,文山區,景東里,1144,2,1042,7,1049,1710,3,1,3,0,1,0,61.35
臺北市,文山區,景東里,1145,2,1070,3,1073,1734,3,1,3,0,1,0,61.88
臺北市,文山區,景美里,1146,2,1157,2,1159,1827,3,1,3,0,1,0,63.44
臺北市,文山區,景美里,1147,2,1095,3,1098,1693,3,1,3,0,1,0,64.86
臺北市,文山區,景慶里,1148,2,983,11,994,1586,3,1,3,0,1,0,62.67
臺北市,文山區,景慶里,1149,2,1013,5,1018,1651,3,1,3,0,1,0,61.66
臺北市,文山區,景慶里,1150,2,1086,4,1090,1718,3,1,3,0,1,0,63.45
臺北市,文山區,景仁里,1151,2,1115,5,1120,1734,3,1,3,0,1,0,64.59
臺北市,文山區,景仁里,1152,2,1187,8,1195,1839,3,1,3,0,1,0,64.98
臺北市,文山區,景華里,1153,2,927,2,929,1503,3,1,3,0,1,0,61.81
臺北市,文山區,景華里,1154,2,948,2,950,1493,3,1,3,0,1,0,63.63
臺北市,文山區,景華里,1155,2,952,2,954,1485,3,1,3,0,1,0,64.24
臺北市,文山區,萬有里,1156,2,1110,4,1114,1711,3,1,3,0,1,0,65.11
臺北市,文山區,萬有里,1157,2,1314,7,1321,2026,3,1,3,0,1,0,65.2
臺北市,文山區,萬祥里,1158,2,1119,6,1125,1721,3,1,3,0,1,0,65.37
臺北市,文山區,萬祥里,1159,2,1209,7,1216,1845,3,1,3,0,1,0,65.91
臺北市,文山區,萬隆里,1160,2,1149,4,1153,1835,3,1,3,0,1,0,62.83
臺北市,文山區,萬隆里,1161,2,1154,10,1164,1783,3,1,3,0,1,0,65.28
臺北市,文山區,萬隆里,1162,2,1311,7,1318,2007,3,1,3,0,1,0,65.67
臺北市,文山區,萬年里,1163,2,926,6,932,1528,3,1,3,0,1,0,60.99
臺北市,文山區,萬年里,1164,2,883,6,889,1354,3,1,3,0,1,0,65.66
臺北市,文山區,萬年里,1165,2,847,3,850,1392,3,1,3,0,1,0,61.06
臺北市,文山區,萬和里,1166,2,974,5,979,1465,3,1,3,0,1,0,66.83
臺北市,文山區,萬和里,1167,2,894,6,900,1293,3,1,3,0,1,0,69.61
臺北市,文山區,萬盛里,1168,2,1120,5,1125,1824,3,1,3,0,1,0,61.68
臺北市,文山區,萬盛里,1169,2,1281,1,1282,1995,3,1,3,0,1,0,64.26
臺北市,文山區,興豐里,1170,2,1141,4,1145,1816,3,1,3,0,1,0,63.05
臺北市,文山區,興豐里,1171,2,988,2,990,1503,3,1,3,0,1,0,65.87
臺北市,文山區,興豐里,1172,2,1165,3,1168,1804,3,1,3,0,1,0,64.75
臺北市,文山區,興豐里,1173,2,1097,4,1101,1768,3,1,3,0,1,0,62.27
臺北市,文山區,興光里,1174,2,783,8,791,1326,3,1,3,0,1,0,59.65
臺北市,文山區,興光里,1175,2,747,2,749,1210,3,1,3,0,1,0,61.9
臺北市,文山區,興家里,1176,2,1175,8,1183,1906,3,1,3,0,1,0,62.07
臺北市,文山區,興家里,1177,2,1389,6,1395,2112,3,1,3,0,1,0,66.05
臺北市,文山區,興家里,1178,2,1131,6,1137,1879,3,1,3,0,1,0,60.51
臺北市,文山區,興得里,1179,2,962,4,966,1548,3,1,3,0,1,0,62.4
臺北市,文山區,興得里,1180,2,1086,3,1089,1827,3,1,3,0,1,0,59.61
臺北市,文山區,興得里,1181,2,984,4,988,1660,3,1,3,0,1,0,59.52
臺北市,文山區,興業里,1182,2,1017,5,1022,1965,3,1,3,0,1,0,52.01
臺北市,文山區,興業里,1183,2,915,5,920,1450,3,1,3,0,1,0,63.45
臺北市,文山區,興業里,1184,2,854,3,857,1409,3,1,3,0,1,0,60.82
臺北市,文山區,興安里,1185,2,1023,3,1026,1587,3,1,3,0,1,0,64.65
臺北市,文山區,興安里,1186,2,1107,2,1109,1663,3,1,3,0,1,0,66.69
臺北市,文山區,興安里,1187,2,1133,6,1139,1731,3,1,3,0,1,0,65.8
臺北市,文山區,興福里,1188,2,981,2,983,1473,3,1,3,0,1,0,66.73
臺北市,文山區,興福里,1189,2,939,2,941,1469,3,1,3,0,1,0,64.06
臺北市,文山區,興福里,1190,2,1065,6,1071,1677,3,1,3,0,1,0,63.86
臺北市,文山區,興旺里,1191,2,966,5,971,1676,3,1,3,0,1,0,57.94
臺北市,文山區,興旺里,1192,2,1074,11,1085,1695,3,1,3,0,1,0,64.01
臺北市,文山區,興旺里,1193,2,1306,9,1315,2162,3,1,3,0,1,0,60.82
臺北市,文山區,興泰里,1194,2,997,7,1004,1657,3,1,3,0,1,0,60.59
臺北市,文山區,興泰里,1195,2,869,1,870,1398,3,1,3,0,1,0,62.23
臺北市,文山區,興昌里,1196,2,1028,0,1028,1685,3,1,3,0,1,0,61.01
臺北市,文山區,興昌里,1197,2,1094,8,1102,1696,3,1,3,0,1,0,64.98
臺北市,文山區,興昌里,1198,2,1105,4,1109,1745,3,1,3,0,1,0,63.55
臺北市,文山區,試院里,1199,2,1112,4,1116,1682,3,1,3,0,1,0,66.35
臺北市,文山區,試院里,1200,2,1094,5,1099,1684,3,1,3,0,1,0,65.26
臺北市,文山區,試院里,1201,2,1081,5,1086,1642,3,1,3,0,1,0,66.14
臺北市,文山區,華興里,1202,2,1280,6,1286,2010,3,1,3,0,1,0,63.98
臺北市,文山區,華興里,1203,2,1282,5,1287,2039,3,1,3,0,1,0,63.12
臺北市,文山區,華興里,1204,2,1227,8,1235,1859,3,1,3,0,1,0,66.43
臺北市,文山區,明義里,1205,2,1207,10,1217,1997,3,1,3,0,1,0,60.94
臺北市,文山區,明義里,1206,2,949,24,973,1853,3,1,3,0,1,0,52.51
臺北市,文山區,明興里,1207,2,1199,6,1205,1939,3,1,3,0,1,0,62.15
臺北市,文山區,明興里,1208,2,1099,5,1104,1879,3,1,3,0,1,0,58.75
臺北市,文山區,明興里,1209,2,1103,2,1105,1741,3,1,3,0,1,0,63.47
臺北市,文山區,木柵里,1210,2,1140,8,1148,1823,3,1,3,0,1,0,62.97
臺北市,文山區,木柵里,1211,2,977,7,984,1529,3,1,3,0,1,0,64.36
臺北市,文山區,木柵里,1212,2,937,3,940,1259,3,1,3,0,1,0,74.66
臺北市,文山區,木柵里,1213,2,903,4,907,1339,3,1,3,0,1,0,67.74
臺北市,文山區,木新里,1214,2,878,4,882,1490,3,1,3,0,1,0,59.19
臺北市,文山區,木新里,1215,2,1134,5,1139,1811,3,1,3,0,1,0,62.89
臺北市,文山區,木新里,1216,2,1134,12,1146,1894,3,1,3,0,1,0,60.51
臺北市,文山區,木新里,1217,2,1049,10,1059,1740,3,1,3,0,1,0,60.86
臺北市,文山區,順興里,1218,2,1168,8,1176,1870,3,1,3,0,1,0,62.89
臺北市,文山區,順興里,1219,2,1143,3,1146,1777,3,1,3,0,1,0,64.49
臺北市,文山區,順興里,1220,2,1122,4,1126,1809,3,1,3,0,1,0,62.24
臺北市,文山區,忠順里,1221,2,1019,6,1025,1538,3,1,3,0,1,0,66.64
臺北市,文山區,忠順里,1222,2,944,5,949,1491,3,1,3,0,1,0,63.65
臺北市,文山區,樟林里,1223,2,963,1,964,1471,3,1,3,0,1,0,65.53
臺北市,文山區,樟林里,1224,2,1049,4,1053,1670,3,1,3,0,1,0,63.05
臺北市,文山區,樟林里,1225,2,1166,5,1171,1818,3,1,3,0,1,0,64.41
臺北市,文山區,樟林里,1226,2,1046,5,1051,1614,3,1,3,0,1,0,65.12
臺北市,文山區,樟新里,1227,2,988,8,996,1529,3,1,3,0,1,0,65.14
臺北市,文山區,樟新里,1228,2,1033,6,1039,1691,3,1,3,0,1,0,61.44
臺北市,文山區,樟新里,1229,2,1231,10,1241,1973,3,1,3,0,1,0,62.9
臺北市,文山區,樟新里,1230,2,1144,5,1149,1896,3,1,3,0,1,0,60.6
臺北市,文山區,樟新里,1231,2,1199,3,1202,1888,3,1,3,0,1,0,63.67
臺北市,文山區,樟腳里,1232,2,1286,14,1300,1960,3,1,3,0,1,0,66.33
臺北市,文山區,樟腳里,1233,2,1031,10,1041,1676,3,1,3,0,1,0,62.11
臺北市,文山區,樟腳里,1234,2,1025,9,1034,1618,3,1,3,0,1,0,63.91
臺北市,文山區,樟腳里,1235,2,1180,7,1187,1897,3,1,3,0,1,0,62.57
臺北市,文山區,萬芳里,1236,2,680,2,682,1100,3,1,3,0,1,0,62
臺北市,文山區,萬芳里,1237,2,970,2,972,1495,3,1,3,0,1,0,65.02
臺北市,文山區,萬芳里,1238,2,1039,5,1044,1565,3,1,3,0,1,0,66.71
臺北市,文山區,萬芳里,1239,2,952,2,954,1583,3,1,3,0,1,0,60.27
臺北市,文山區,萬美里,1240,2,1128,7,1135,1851,3,1,3,0,1,0,61.32
臺北市,文山區,萬美里,1241,2,1093,7,1100,1816,3,1,3,0,1,0,60.57
臺北市,文山區,萬美里,1242,2,961,9,970,1578,3,1,3,0,1,0,61.47
臺北市,文山區,博嘉里,1243,2,1139,6,1145,1825,3,1,3,0,1,0,62.74
臺北市,文山區,博嘉里,1244,2,1199,10,1209,1989,3,1,3,0,1,0,60.78
臺北市,文山區,萬興里,1245,2,1440,6,1446,2356,3,1,3,0,1,0,61.38
臺北市,文山區,萬興里,1246,2,1292,5,1297,2059,3,1,3,0,1,0,62.99
臺北市,文山區,萬興里,1247,2,1230,12,1242,2113,3,1,3,0,1,0,58.78
臺北市,文山區,萬興里,1248,2,1323,2,1325,2102,3,1,3,0,1,0,63.04
臺北市,文山區,指南里,1249,2,1027,5,1032,1684,3,1,3,0,1,0,61.28
臺北市,文山區,指南里,1250,2,425,5,430,674,3,1,3,0,1,0,63.8
臺北市,文山區,老泉里,1251,2,404,5,409,704,3,1,3,0,1,0,58.1
高雄市,鹽埕區,藍橋里,1,1,815,4,819,1289,3,1,3,0,1,0,63.54
高雄市,鹽埕區,慈愛里,2,1,309,1,310,477,3,1,3,0,1,0,64.99
高雄市,鹽埕區,博愛里,3,1,432,2,434,724,3,1,3,0,1,0,59.94
高雄市,鹽埕區,壽星里,4,1,817,6,823,1329,3,1,3,0,1,0,61.93
高雄市,鹽埕區,中山里,5,1,704,2,706,1185,3,1,3,0,1,0,59.58
高雄市,鹽埕區,教仁里,6,1,810,7,817,1359,3,1,3,0,1,0,60.12
高雄市,鹽埕區,教仁里,7,1,534,4,538,860,3,1,3,0,1,0,62.56
高雄市,鹽埕區,新樂里,8,1,612,5,617,940,3,1,3,0,1,0,65.64
高雄市,鹽埕區,中原里,9,1,460,0,460,698,3,1,3,0,1,0,65.90
高雄市,鹽埕區,光明里,10,1,750,5,755,1227,3,1,3,0,1,0,61.53
高雄市,鹽埕區,育仁里,11,1,493,3,496,829,3,1,3,0,1,0,59.83
高雄市,鹽埕區,河濱里,12,1,1084,3,1087,1860,3,1,3,0,1,0,58.44
高雄市,鹽埕區,沙地里,13,1,637,2,639,1095,3,1,3,0,1,0,58.36
高雄市,鹽埕區,南端里,14,1,660,4,664,1101,3,1,3,0,1,0,60.31
高雄市,鹽埕區,港都里,15,1,682,3,685,1175,3,1,3,0,1,0,58.30
高雄市,鹽埕區,江西里,16,1,740,7,747,1200,3,1,3,0,1,0,62.25
高雄市,鹽埕區,新豐里,17,1,392,1,393,599,3,1,3,0,1,0,65.61
高雄市,鹽埕區,府北里,18,1,978,5,983,1802,3,1,3,0,1,0,54.55
高雄市,鹽埕區,陸橋里,19,1,754,8,762,1245,3,1,3,0,1,0,61.20
高雄市,鹽埕區,瀨南里,20,1,449,2,451,718,3,1,3,0,1,0,62.81
高雄市,鹽埕區,新化里,21,1,451,2,453,705,3,1,3,0,1,0,64.26
高雄市,鹽埕區,江南里,22,1,571,1,572,935,3,1,3,0,1,0,61.18
高雄市,鼓山區,鼓峰里,23,1,644,3,647,1032,3,1,3,0,1,0,62.69
高雄市,鼓山區,鼓峰里,24,1,634,6,640,980,3,1,3,0,1,0,65.31
高雄市,鼓山區,雄峰里,25,1,585,6,591,981,3,1,3,0,1,0,60.24
高雄市,鼓山區,雄峰里,26,1,663,5,668,1108,3,1,3,0,1,0,60.29
高雄市,鼓山區,前峰里,27,1,1079,8,1087,1655,3,1,3,0,1,0,65.68
高雄市,鼓山區,前峰里,28,1,950,5,955,1425,3,1,3,0,1,0,67.02
高雄市,鼓山區,前峰里,29,1,776,4,780,1185,3,1,3,0,1,0,65.82
高雄市,鼓山區,光榮里,30,1,711,3,714,1169,3,1,3,0,1,0,61.08
高雄市,鼓山區,光榮里,31,1,768,3,771,1360,3,1,3,0,1,0,56.69
高雄市,鼓山區,光榮里,32,1,869,7,876,1345,3,1,3,0,1,0,65.13
高雄市,鼓山區,民族里,33,1,962,0,962,1457,3,1,3,0,1,0,66.03
高雄市,鼓山區,內惟里,34,1,771,6,777,1194,3,1,3,0,1,0,65.08
高雄市,鼓山區,建國里,35,1,690,3,693,1084,3,1,3,0,1,0,63.93
高雄市,鼓山區,建國里,36,1,651,1,652,1000,3,1,3,0,1,0,65.20
高雄市,鼓山區,忠正里,37,1,831,3,834,1406,3,1,3,0,1,0,59.32
高雄市,鼓山區,忠正里,38,1,773,2,775,1326,3,1,3,0,1,0,58.45
高雄市,鼓山區,忠正里,39,1,733,4,737,1219,3,1,3,0,1,0,60.46
高雄市,鼓山區,自強里,40,1,586,3,589,830,3,1,3,0,1,0,70.96
高雄市,鼓山區,龍井里,41,1,919,10,929,1480,3,1,3,0,1,0,62.77
高雄市,鼓山區,正德里,42,1,1069,9,1078,1839,3,1,3,0,1,0,58.62
高雄市,鼓山區,平和里,43,1,1007,7,1014,1668,3,1,3,0,1,0,60.79
高雄市,鼓山區,平和里,44,1,938,5,943,1550,3,1,3,0,1,0,60.84
高雄市,鼓山區,民強里,45,1,960,8,968,1471,3,1,3,0,1,0,65.81
高雄市,鼓山區,民強里,46,1,804,5,809,1329,3,1,3,0,1,0,60.87
高雄市,鼓山區,厚生里,47,1,1089,8,1097,1805,3,1,3,0,1,0,60.78
高雄市,鼓山區,厚生里,48,1,505,5,510,805,3,1,3,0,1,0,63.35
高雄市,鼓山區,龍子里,49,1,1040,9,1049,1777,3,1,3,0,1,0,59.03
高雄市,鼓山區,龍子里,50,1,1122,7,1129,1975,3,1,3,0,1,0,57.16
高雄市,鼓山區,龍子里,51,1,919,7,926,1716,3,1,3,0,1,0,53.96
高雄市,鼓山區,龍水里,52,1,1555,3,1558,2784,3,1,3,0,1,0,55.96
高雄市,鼓山區,明誠里,53,1,1025,3,1028,1769,3,1,3,0,1,0,58.11
高雄市,鼓山區,明誠里,54,1,1094,4,1098,1825,3,1,3,0,1,0,60.16
高雄市,鼓山區,明誠里,55,1,1180,3,1183,2037,3,1,3,0,1,0,58.08
高雄市,鼓山區,明誠里,56,1,1023,7,1030,1811,3,1,3,0,1,0,56.87
高雄市,鼓山區,明誠里,57,1,852,2,854,1550,3,1,3,0,1,0,55.10
高雄市,鼓山區,明誠里,58,1,913,4,917,1624,3,1,3,0,1,0,56.47
高雄市,鼓山區,華豐里,59,1,1157,4,1161,1826,3,1,3,0,1,0,63.58
高雄市,鼓山區,華豐里,60,1,1090,4,1094,1800,3,1,3,0,1,0,60.78
高雄市,鼓山區,裕興里,61,1,851,4,855,1422,3,1,3,0,1,0,60.13
高雄市,鼓山區,裕興里,62,1,851,2,853,1435,3,1,3,0,1,0,59.44
高雄市,鼓山區,裕豐里,63,1,648,1,649,1048,3,1,3,0,1,0,61.93
高雄市,鼓山區,裕豐里,64,1,760,1,761,1285,3,1,3,0,1,0,59.22
高雄市,鼓山區,鼓岩里,65,1,840,10,850,1492,3,1,3,0,1,0,56.97
高雄市,鼓山區,樹德里,66,1,752,14,766,1176,3,1,3,0,1,0,65.14
高雄市,鼓山區,寶樹里,67,1,607,7,614,1240,3,1,3,0,1,0,49.52
高雄市,鼓山區,興宗里,68,1,893,4,897,1488,3,1,3,0,1,0,60.28
高雄市,鼓山區,光化里,69,1,930,12,942,1524,3,1,3,0,1,0,61.81
高雄市,鼓山區,山下里,70,1,775,8,783,1310,3,1,3,0,1,0,59.77
高雄市,鼓山區,河邊里,71,1,957,10,967,1550,3,1,3,0,1,0,62.39
高雄市,鼓山區,綠川里,72,1,922,6,928,1560,3,1,3,0,1,0,59.49
高雄市,鼓山區,登山里,73,1,504,4,508,804,3,1,3,0,1,0,63.18
高雄市,鼓山區,峰南里,74,1,586,9,595,1034,3,1,3,0,1,0,57.54
高雄市,鼓山區,麗興里,75,1,649,7,656,1158,3,1,3,0,1,0,56.65
高雄市,鼓山區,新民里,76,1,676,7,683,1150,3,1,3,0,1,0,59.39
高雄市,鼓山區,延平里,77,1,580,2,582,912,3,1,3,0,1,0,63.82
高雄市,鼓山區,維生里,78,1,843,4,847,1419,3,1,3,0,1,0,59.69
高雄市,鼓山區,惠安里,79,1,769,7,776,1409,3,1,3,0,1,0,55.07
高雄市,鼓山區,壽山里,80,1,873,7,880,1568,3,1,3,0,1,0,56.12
高雄市,鼓山區,哨船頭里,81,1,694,5,699,1174,3,1,3,0,1,0,59.54
高雄市,鼓山區,桃源里,82,1,317,1,318,602,3,1,3,0,1,0,52.82
高雄市,旗津區,旗下里,83,1,699,8,707,1230,3,1,3,0,1,0,57.48
高雄市,旗津區,永安里,84,1,626,6,632,1077,3,1,3,0,1,0,58.68
高雄市,旗津區,振興里,85,1,910,10,920,1682,3,1,3,0,1,0,54.70
高雄市,旗津區,慈愛里,86,1,632,4,636,1129,3,1,3,0,1,0,56.33
高雄市,旗津區,慈愛里,87,1,494,2,496,965,3,1,3,0,1,0,51.40
高雄市,旗津區,復興里,88,1,750,9,759,1416,3,1,3,0,1,0,53.60
高雄市,旗津區,復興里,89,1,695,9,704,1345,3,1,3,0,1,0,52.34
高雄市,旗津區,中華里,90,1,720,6,726,1264,3,1,3,0,1,0,57.44
高雄市,旗津區,實踐里,91,1,714,13,727,1292,3,1,3,0,1,0,56.27
高雄市,旗津區,北汕里,92,1,643,3,646,1210,3,1,3,0,1,0,53.39
高雄市,旗津區,北汕里,93,1,623,4,627,1221,3,1,3,0,1,0,51.35
高雄市,旗津區,南汕里,94,1,929,7,936,1670,3,1,3,0,1,0,56.05
高雄市,旗津區,上竹里,95,1,669,5,674,1335,3,1,3,0,1,0,50.49
高雄市,旗津區,上竹里,96,1,684,1,685,1222,3,1,3,0,1,0,56.06
高雄市,旗津區,中洲里,97,1,929,6,935,1624,3,1,3,0,1,0,57.57
高雄市,旗津區,安順里,98,1,475,5,480,926,3,1,3,0,1,0,51.84
高雄市,旗津區,中興里,99,1,644,1,645,1075,3,1,3,0,1,0,60.00
高雄市,旗津區,中興里,100,1,594,3,597,1118,3,1,3,0,1,0,53.40
高雄市,左營區,進學里,101,1,934,10,944,2016,3,1,3,0,1,0,46.83
高雄市,左營區,尾西里,102,1,779,4,783,1194,3,1,3,0,1,0,65.58
高雄市,左營區,頂北里,103,1,363,6,369,591,3,1,3,0,1,0,62.44
高雄市,左營區,中北里,104,1,430,4,434,692,3,1,3,0,1,0,62.72
高雄市,左營區,中南里,105,1,346,6,352,566,3,1,3,0,1,0,62.19
高雄市,左營區,廟東里,106,1,598,1,599,887,3,1,3,0,1,0,67.53
高雄市,左營區,廟北里,107,1,653,3,656,1025,3,1,3,0,1,0,64.00
高雄市,左營區,尾南里,108,1,521,1,522,817,3,1,3,0,1,0,63.89
高雄市,左營區,尾北里,109,1,865,7,872,1365,3,1,3,0,1,0,63.88
高雄市,左營區,尾北里,110,1,937,5,942,1525,3,1,3,0,1,0,61.77
高雄市,左營區,屏山里,111,1,910,10,920,1436,3,1,3,0,1,0,64.07
高雄市,左營區,祥和里,112,1,436,1,437,586,3,1,3,0,1,0,74.57
高雄市,左營區,永清里,113,1,693,3,696,1019,3,1,3,0,1,0,68.30
高雄市,左營區,永清里,114,1,567,4,571,927,3,1,3,0,1,0,61.60
高雄市,左營區,復興里,115,1,824,2,826,1226,3,1,3,0,1,0,67.37
高雄市,左營區,莒光里,116,1,1044,5,1049,1718,3,1,3,0,1,0,61.06
高雄市,左營區,光輝里,117,1,691,3,694,1134,3,1,3,0,1,0,61.20
高雄市,左營區,光輝里,118,1,813,6,819,1357,3,1,3,0,1,0,60.35
高雄市,左營區,合群里,119,1,920,2,922,1325,3,1,3,0,1,0,69.58
高雄市,左營區,自治里,120,1,56,0,56,158,3,1,3,0,1,0,35.44
高雄市,左營區,明建里,121,1,981,6,987,1505,3,1,3,0,1,0,65.58
高雄市,左營區,自立里,122,1,19,0,19,46,3,1,3,0,1,0,41.30
高雄市,左營區,頂西里,123,1,766,3,769,1152,3,1,3,0,1,0,66.75
高雄市,左營區,聖后里,124,1,598,4,602,914,3,1,3,0,1,0,65.86
高雄市,左營區,聖西里,125,1,236,0,236,368,3,1,3,0,1,0,64.13
高雄市,左營區,聖南里,126,1,344,0,344,583,3,1,3,0,1,0,59.01
高雄市,左營區,城南里,127,1,370,0,370,568,3,1,3,0,1,0,65.14
高雄市,左營區,路東里,128,1,480,2,482,768,3,1,3,0,1,0,62.76
高雄市,左營區,部北里,129,1,330,14,344,535,3,1,3,0,1,0,64.30
高雄市,左營區,部南里,130,1,458,0,458,713,3,1,3,0,1,0,64.24
高雄市,左營區,埤西里,131,1,709,9,718,1091,3,1,3,0,1,0,65.81
高雄市,左營區,埤北里,132,1,865,7,872,1418,3,1,3,0,1,0,61.50
高雄市,左營區,埤東里,133,1,734,4,738,1184,3,1,3,0,1,0,62.33
高雄市,左營區,海勝里,134,1,953,2,955,1429,3,1,3,0,1,0,66.83
高雄市,左營區,海勝里,135,1,1345,11,1356,2013,3,1,3,0,1,0,67.36
高雄市,左營區,海勝里,136,1,885,0,885,1219,3,1,3,0,1,0,72.60
高雄市,左營區,海勝里,137,1,708,0,708,993,3,1,3,0,1,0,71.30
高雄市,左營區,自勉里,138,1,15,0,15,59,3,1,3,0,1,0,25.42
高雄市,左營區,崇實里,139,1,783,3,786,1113,3,1,3,0,1,0,70.62
高雄市,左營區,自助里,140,1,921,5,926,1360,3,1,3,0,1,0,68.09
高雄市,左營區,自助里,141,1,599,4,603,932,3,1,3,0,1,0,64.70
高雄市,左營區,果貿里,142,1,610,6,616,875,3,1,3,0,1,0,70.40
高雄市,左營區,果貿里,143,1,713,0,713,1020,3,1,3,0,1,0,69.90
高雄市,左營區,果惠里,144,1,960,4,964,1541,3,1,3,0,1,0,62.56
高雄市,左營區,果峰里,145,1,1143,8,1151,1705,3,1,3,0,1,0,67.51
高雄市,左營區,新下里,146,1,993,5,998,1742,3,1,3,0,1,0,57.29
高雄市,左營區,新下里,147,1,902,7,909,1717,3,1,3,0,1,0,52.94
高雄市,左營區,新下里,148,1,911,12,923,1658,3,1,3,0,1,0,55.67
高雄市,左營區,新下里,149,1,883,1,884,1661,3,1,3,0,1,0,53.22
高雄市,左營區,新下里,150,1,1056,4,1060,1713,3,1,3,0,1,0,61.88
高雄市,左營區,新下里,151,1,785,5,790,1401,3,1,3,0,1,0,56.39
高雄市,左營區,新上里,152,1,782,2,784,1301,3,1,3,0,1,0,60.26
高雄市,左營區,新上里,153,1,879,6,885,1403,3,1,3,0,1,0,63.08
高雄市,左營區,新上里,154,1,839,4,843,1416,3,1,3,0,1,0,59.53
高雄市,左營區,新上里,155,1,1044,3,1047,1855,3,1,3,0,1,0,56.44
高雄市,左營區,新上里,156,1,1069,2,1071,1967,3,1,3,0,1,0,54.45
高雄市,左營區,新上里,157,1,1004,7,1011,2015,3,1,3,0,1,0,50.17
高雄市,左營區,新上里,158,1,1026,3,1029,1895,3,1,3,0,1,0,54.30
高雄市,左營區,新上里,159,1,833,5,838,1540,3,1,3,0,1,0,54.42
高雄市,左營區,新上里,160,1,1009,2,1011,1963,3,1,3,0,1,0,51.50
高雄市,左營區,新上里,161,1,1020,6,1026,1938,3,1,3,0,1,0,52.94
高雄市,左營區,新上里,162,1,971,3,974,1743,3,1,3,0,1,0,55.88
高雄市,左營區,新中里,163,1,1013,6,1019,1727,3,1,3,0,1,0,59.00
高雄市,左營區,新中里,164,1,791,7,798,1280,3,1,3,0,1,0,62.34
高雄市,左營區,新中里,165,1,822,5,827,1511,3,1,3,0,1,0,54.73
高雄市,左營區,新光里,166,1,1014,5,1019,1730,3,1,3,0,1,0,58.90
高雄市,左營區,新光里,167,1,944,5,949,1861,3,1,3,0,1,0,50.99
高雄市,左營區,新光里,168,1,990,7,997,1786,3,1,3,0,1,0,55.82
高雄市,左營區,新光里,169,1,1114,2,1116,1946,3,1,3,0,1,0,57.35
高雄市,左營區,新光里,170,1,1072,6,1078,1965,3,1,3,0,1,0,54.86
高雄市,左營區,菜公里,171,1,868,5,873,1644,3,1,3,0,1,0,53.10
高雄市,左營區,菜公里,172,1,849,4,853,1727,3,1,3,0,1,0,49.39
高雄市,左營區,菜公里,173,1,976,9,985,1787,3,1,3,0,1,0,55.12
高雄市,左營區,菜公里,174,1,776,3,779,1503,3,1,3,0,1,0,51.83
高雄市,左營區,菜公里,175,1,864,9,873,1681,3,1,3,0,1,0,51.93
高雄市,左營區,菜公里,176,1,847,3,850,1631,3,1,3,0,1,0,52.12
高雄市,左營區,菜公里,177,1,882,5,887,1769,3,1,3,0,1,0,50.14
高雄市,左營區,菜公里,178,1,985,2,987,1870,3,1,3,0,1,0,52.78
高雄市,左營區,菜公里,179,1,945,1,946,1726,3,1,3,0,1,0,54.81
高雄市,左營區,菜公里,180,1,812,4,816,1512,3,1,3,0,1,0,53.97
高雄市,左營區,菜公里,181,1,707,4,711,1305,3,1,3,0,1,0,54.48
高雄市,左營區,福山里,182,1,700,3,703,1425,3,1,3,0,1,0,49.33
高雄市,左營區,福山里,183,1,732,5,737,1557,3,1,3,0,1,0,47.33
高雄市,左營區,福山里,184,1,896,4,900,1767,3,1,3,0,1,0,50.93
高雄市,左營區,福山里,185,1,845,6,851,1686,3,1,3,0,1,0,50.47
高雄市,左營區,福山里,186,1,864,3,867,1676,3,1,3,0,1,0,51.73
高雄市,左營區,福山里,187,1,875,4,879,1820,3,1,3,0,1,0,48.30
高雄市,左營區,福山里,188,1,753,3,756,1649,3,1,3,0,1,0,45.85
高雄市,左營區,福山里,189,1,832,4,836,1659,3,1,3,0,1,0,50.39
高雄市,左營區,福山里,190,1,661,5,666,1356,3,1,3,0,1,0,49.12
高雄市,左營區,福山里,191,1,1028,9,1037,1958,3,1,3,0,1,0,52.96
高雄市,左營區,福山里,192,1,689,3,692,1412,3,1,3,0,1,0,49.01
高雄市,左營區,福山里,193,1,722,5,727,1406,3,1,3,0,1,0,51.71
高雄市,左營區,福山里,194,1,793,1,794,1469,3,1,3,0,1,0,54.05
高雄市,楠梓區,清豐里,195,1,1028,9,1037,1847,3,1,3,0,1,0,56.15
高雄市,楠梓區,清豐里,196,1,924,8,932,1718,3,1,3,0,1,0,54.25
高雄市,楠梓區,清豐里,197,1,650,3,653,1220,3,1,3,0,1,0,53.52
高雄市,楠梓區,清豐里,198,1,719,6,725,1389,3,1,3,0,1,0,52.20
高雄市,楠梓區,清豐里,199,1,916,3,919,1792,3,1,3,0,1,0,51.28
高雄市,楠梓區,清豐里,200,1,981,4,985,1771,3,1,3,0,1,0,55.62
高雄市,楠梓區,東寧里,201,1,658,6,664,1164,3,1,3,0,1,0,57.04
高雄市,楠梓區,東寧里,202,1,620,3,623,1075,3,1,3,0,1,0,57.95
高雄市,楠梓區,五常里,203,1,742,2,744,1302,3,1,3,0,1,0,57.14
高雄市,楠梓區,五常里,204,1,739,4,743,1481,3,1,3,0,1,0,50.17
高雄市,楠梓區,五常里,205,1,744,8,752,1504,3,1,3,0,1,0,50.00
高雄市,楠梓區,享平里,206,1,815,6,821,1274,3,1,3,0,1,0,64.44
高雄市,楠梓區,享平里,207,1,691,4,695,1417,3,1,3,0,1,0,49.05
高雄市,楠梓區,中陽里,208,1,839,8,847,1418,3,1,3,0,1,0,59.73
高雄市,楠梓區,中陽里,209,1,747,3,750,1208,3,1,3,0,1,0,62.09
高雄市,楠梓區,惠楠里,210,1,591,4,595,1348,3,1,3,0,1,0,44.14
高雄市,楠梓區,惠楠里,211,1,678,7,685,1202,3,1,3,0,1,0,56.99
高雄市,楠梓區,惠民里,212,1,864,7,871,1567,3,1,3,0,1,0,55.58
高雄市,楠梓區,惠民里,213,1,975,5,980,1664,3,1,3,0,1,0,58.89
高雄市,楠梓區,惠豐里,214,1,812,4,816,1514,3,1,3,0,1,0,53.90
高雄市,楠梓區,惠豐里,215,1,810,5,815,1537,3,1,3,0,1,0,53.03
高雄市,楠梓區,錦屏里,216,1,990,5,995,1635,3,1,3,0,1,0,60.86
高雄市,楠梓區,錦屏里,217,1,1002,5,1007,1727,3,1,3,0,1,0,58.31
高雄市,楠梓區,玉屏里,218,1,635,1,636,1064,3,1,3,0,1,0,59.77
高雄市,楠梓區,玉屏里,219,1,744,3,747,1232,3,1,3,0,1,0,60.63
高雄市,楠梓區,金田里,220,1,960,7,967,1635,3,1,3,0,1,0,59.14
高雄市,楠梓區,金田里,221,1,921,4,925,1501,3,1,3,0,1,0,61.63
高雄市,楠梓區,稔田里,222,1,951,7,958,1591,3,1,3,0,1,0,60.21
高雄市,楠梓區,瑞屏里,223,1,880,5,885,1565,3,1,3,0,1,0,56.55
高雄市,楠梓區,瑞屏里,224,1,829,2,831,1583,3,1,3,0,1,0,52.50
高雄市,楠梓區,翠屏里,225,1,849,2,851,1542,3,1,3,0,1,0,55.19
高雄市,楠梓區,翠屏里,226,1,840,7,847,1613,3,1,3,0,1,0,52.51
高雄市,楠梓區,翠屏里,227,1,832,5,837,1527,3,1,3,0,1,0,54.81
高雄市,楠梓區,翠屏里,228,1,831,3,834,1556,3,1,3,0,1,0,53.60
高雄市,楠梓區,翠屏里,229,1,829,4,833,1536,3,1,3,0,1,0,54.23
高雄市,楠梓區,翠屏里,230,1,834,4,838,1553,3,1,3,0,1,0,53.96
高雄市,楠梓區,翠屏里,231,1,840,4,844,1628,3,1,3,0,1,0,51.84
高雄市,楠梓區,宏南里,232,1,1069,12,1081,1654,3,1,3,0,1,0,65.36
高雄市,楠梓區,宏毅里,233,1,936,8,944,1458,3,1,3,0,1,0,64.75
高雄市,楠梓區,宏毅里,234,1,921,5,926,1416,3,1,3,0,1,0,65.40
高雄市,楠梓區,宏榮里,235,1,864,2,866,1258,3,1,3,0,1,0,68.84
高雄市,楠梓區,宏榮里,236,1,591,5,596,902,3,1,3,0,1,0,66.08
高雄市,楠梓區,廣昌里,237,1,874,7,881,1380,3,1,3,0,1,0,63.84
高雄市,楠梓區,廣昌里,238,1,998,11,1009,1625,3,1,3,0,1,0,62.09
高雄市,楠梓區,久昌里,239,1,582,2,584,1073,3,1,3,0,1,0,54.43
高雄市,楠梓區,久昌里,240,1,622,6,628,1163,3,1,3,0,1,0,54.00
高雄市,楠梓區,大昌里,241,1,453,3,456,697,3,1,3,0,1,0,65.42
高雄市,楠梓區,大昌里,242,1,779,6,785,1295,3,1,3,0,1,0,60.62
高雄市,楠梓區,福昌里,243,1,1163,9,1172,1796,3,1,3,0,1,0,65.26
高雄市,楠梓區,福昌里,244,1,869,1,870,1412,3,1,3,0,1,0,61.61
高雄市,楠梓區,盛昌里,245,1,821,3,824,1433,3,1,3,0,1,0,57.50
高雄市,楠梓區,盛昌里,246,1,779,2,781,1347,3,1,3,0,1,0,57.98
高雄市,楠梓區,泰昌里,247,1,926,7,933,1541,3,1,3,0,1,0,60.55
高雄市,楠梓區,興昌里,248,1,777,4,781,1301,3,1,3,0,1,0,60.03
高雄市,楠梓區,興昌里,249,1,1000,3,1003,1842,3,1,3,0,1,0,54.45
高雄市,楠梓區,建昌里,250,1,709,3,712,1251,3,1,3,0,1,0,56.91
高雄市,楠梓區,建昌里,251,1,674,3,677,1152,3,1,3,0,1,0,58.77
高雄市,楠梓區,宏昌里,252,1,676,4,680,1143,3,1,3,0,1,0,59.49
高雄市,楠梓區,宏昌里,253,1,658,6,664,1211,3,1,3,0,1,0,54.83
高雄市,楠梓區,和昌里,254,1,628,5,633,1020,3,1,3,0,1,0,62.06
高雄市,楠梓區,和昌里,255,1,692,4,696,1071,3,1,3,0,1,0,64.99
高雄市,楠梓區,慶昌里,256,1,1061,6,1067,1623,3,1,3,0,1,0,65.74
高雄市,楠梓區,慶昌里,257,1,920,6,926,1483,3,1,3,0,1,0,62.44
高雄市,楠梓區,隆昌里,258,1,995,5,1000,1653,3,1,3,0,1,0,60.50
高雄市,楠梓區,隆昌里,259,1,930,3,933,1588,3,1,3,0,1,0,58.75
高雄市,楠梓區,秀昌里,260,1,538,4,542,1010,3,1,3,0,1,0,53.66
高雄市,楠梓區,秀昌里,261,1,626,3,629,1003,3,1,3,0,1,0,62.71
高雄市,楠梓區,裕昌里,262,1,847,5,852,1385,3,1,3,0,1,0,61.52
高雄市,楠梓區,裕昌里,263,1,890,10,900,1468,3,1,3,0,1,0,61.31
高雄市,楠梓區,國昌里,264,1,909,5,914,1567,3,1,3,0,1,0,58.33
高雄市,楠梓區,國昌里,265,1,912,7,919,1585,3,1,3,0,1,0,57.98
高雄市,楠梓區,加昌里,266,1,679,4,683,1283,3,1,3,0,1,0,53.23
高雄市,楠梓區,加昌里,267,1,820,3,823,1447,3,1,3,0,1,0,56.88
高雄市,楠梓區,加昌里,268,1,862,3,865,1508,3,1,3,0,1,0,57.36
高雄市,楠梓區,加昌里,269,1,874,4,878,1565,3,1,3,0,1,0,56.10
高雄市,楠梓區,仁昌里,270,1,915,1,916,1708,3,1,3,0,1,0,53.63
高雄市,楠梓區,仁昌里,271,1,964,8,972,1760,3,1,3,0,1,0,55.23
高雄市,楠梓區,藍田里,272,1,591,34,625,1035,3,1,3,0,1,0,60.39
高雄市,楠梓區,中興里,273,1,498,2,500,847,3,1,3,0,1,0,59.03
高雄市,楠梓區,中和里,274,1,932,2,934,1487,3,1,3,0,1,0,62.81
高雄市,三民區,鼎金里,275,1,1001,4,1005,1898,3,1,3,0,1,0,52.95
高雄市,三民區,鼎金里,276,1,676,5,681,1208,3,1,3,0,1,0,56.37
高雄市,三民區,鼎盛里,277,1,734,10,744,1363,3,1,3,0,1,0,54.59
高雄市,三民區,鼎盛里,278,1,732,3,735,1336,3,1,3,0,1,0,55.01
高雄市,三民區,鼎盛里,279,1,767,9,776,1522,3,1,3,0,1,0,50.99
高雄市,三民區,鼎盛里,280,1,905,7,912,1646,3,1,3,0,1,0,55.41
高雄市,三民區,鼎強里,281,1,925,2,927,1652,3,1,3,0,1,0,56.11
高雄市,三民區,鼎強里,282,1,948,2,950,1785,3,1,3,0,1,0,53.22
高雄市,三民區,鼎力里,283,1,913,8,921,1642,3,1,3,0,1,0,56.09
高雄市,三民區,鼎力里,284,1,994,8,1002,1772,3,1,3,0,1,0,56.55
高雄市,三民區,鼎西里,285,1,1055,5,1060,2070,3,1,3,0,1,0,51.21
高雄市,三民區,鼎西里,286,1,1007,8,1015,1763,3,1,3,0,1,0,57.57
高雄市,三民區,鼎西里,287,1,881,8,889,1690,3,1,3,0,1,0,52.60
高雄市,三民區,鼎中里,288,1,991,5,996,1575,3,1,3,0,1,0,63.24
高雄市,三民區,鼎中里,289,1,936,7,943,1541,3,1,3,0,1,0,61.19
高雄市,三民區,鼎泰里,290,1,958,2,960,1741,3,1,3,0,1,0,55.14
高雄市,三民區,鼎泰里,291,1,997,8,1005,1826,3,1,3,0,1,0,55.04
高雄市,三民區,鼎泰里,292,1,993,8,1001,1755,3,1,3,0,1,0,57.04
高雄市,三民區,鼎泰里,293,1,639,2,641,1378,3,1,3,0,1,0,46.52
高雄市,三民區,鼎泰里,294,1,1076,5,1081,1970,3,1,3,0,1,0,54.87
高雄市,三民區,鼎泰里,295,1,1033,3,1036,1842,3,1,3,0,1,0,56.24
高雄市,三民區,鼎泰里,296,1,927,5,932,1724,3,1,3,0,1,0,54.06
高雄市,三民區,鼎泰里,297,1,698,5,703,1175,3,1,3,0,1,0,59.83
高雄市,三民區,鼎泰里,298,1,796,2,798,1416,3,1,3,0,1,0,56.36
高雄市,三民區,鼎泰里,299,1,880,2,882,1481,3,1,3,0,1,0,59.55
高雄市,三民區,本館里,300,1,1071,5,1076,1881,3,1,3,0,1,0,57.20
高雄市,三民區,本館里,301,1,1075,14,1089,1807,3,1,3,0,1,0,60.27
高雄市,三民區,本館里,302,1,1040,4,1044,1814,3,1,3,0,1,0,57.55
高雄市,三民區,本館里,303,1,1116,6,1122,1916,3,1,3,0,1,0,58.56
高雄市,三民區,本和里,304,1,1045,6,1051,1850,3,1,3,0,1,0,56.81
高雄市,三民區,本和里,305,1,1095,6,1101,1929,3,1,3,0,1,0,57.08
高雄市,三民區,本和里,306,1,1107,10,1117,2102,3,1,3,0,1,0,53.14
高雄市,三民區,本文里,307,1,622,6,628,1099,3,1,3,0,1,0,57.14
高雄市,三民區,本文里,308,1,594,3,597,930,3,1,3,0,1,0,64.19
高雄市,三民區,本武里,309,1,887,6,893,1508,3,1,3,0,1,0,59.22
高雄市,三民區,本元里,310,1,856,5,861,1512,3,1,3,0,1,0,56.94
高雄市,三民區,本元里,311,1,787,9,796,1425,3,1,3,0,1,0,55.86
高雄市,三民區,本元里,312,1,799,2,801,1469,3,1,3,0,1,0,54.53
高雄市,三民區,本安里,313,1,615,5,620,1204,3,1,3,0,1,0,51.50
高雄市,三民區,本安里,314,1,757,4,761,1262,3,1,3,0,1,0,60.30
高雄市,三民區,本安里,315,1,762,4,766,1323,3,1,3,0,1,0,57.90
高雄市,三民區,本上里,316,1,775,3,778,1378,3,1,3,0,1,0,56.46
高雄市,三民區,本上里,317,1,726,2,728,1255,3,1,3,0,1,0,58.01
高雄市,三民區,本上里,318,1,828,6,834,1476,3,1,3,0,1,0,56.50
高雄市,三民區,本揚里,319,1,941,2,943,1614,3,1,3,0,1,0,58.43
高雄市,三民區,本揚里,320,1,917,5,922,1632,3,1,3,0,1,0,56.50
高雄市,三民區,本揚里,321,1,956,8,964,1706,3,1,3,0,1,0,56.51
高雄市,三民區,本揚里,322,1,835,3,838,1564,3,1,3,0,1,0,53.58
高雄市,三民區,寶獅里,323,1,988,9,997,1808,3,1,3,0,1,0,55.14
高雄市,三民區,寶獅里,324,1,947,3,950,1626,3,1,3,0,1,0,58.43
高雄市,三民區,寶德里,325,1,752,6,758,1334,3,1,3,0,1,0,56.82
高雄市,三民區,寶德里,326,1,849,5,854,1585,3,1,3,0,1,0,53.88
高雄市,三民區,寶德里,327,1,848,6,854,1549,3,1,3,0,1,0,55.13
高雄市,三民區,寶泰里,328,1,787,2,789,1518,3,1,3,0,1,0,51.98
高雄市,三民區,寶泰里,329,1,774,4,778,1597,3,1,3,0,1,0,48.72
高雄市,三民區,寶興里,330,1,796,5,801,1321,3,1,3,0,1,0,60.64
高雄市,三民區,寶興里,331,1,754,5,759,1295,3,1,3,0,1,0,58.61
高雄市,三民區,寶興里,332,1,696,6,702,1266,3,1,3,0,1,0,55.45
高雄市,三民區,寶興里,333,1,718,3,721,1383,3,1,3,0,1,0,52.13
高雄市,三民區,寶中里,334,1,789,2,791,1293,3,1,3,0,1,0,61.18
高雄市,三民區,寶中里,335,1,808,4,812,1375,3,1,3,0,1,0,59.05
高雄市,三民區,寶華里,336,1,777,1,778,1351,3,1,3,0,1,0,57.59
高雄市,三民區,寶華里,337,1,860,3,863,1438,3,1,3,0,1,0,60.01
高雄市,三民區,寶國里,338,1,838,1,839,1695,3,1,3,0,1,0,49.50
高雄市,三民區,寶國里,339,1,779,6,785,1505,3,1,3,0,1,0,52.16
高雄市,三民區,寶國里,340,1,958,8,966,1724,3,1,3,0,1,0,56.03
高雄市,三民區,寶國里,341,1,840,6,846,1475,3,1,3,0,1,0,57.36
高雄市,三民區,寶民里,342,1,732,6,738,1285,3,1,3,0,1,0,57.43
高雄市,三民區,寶民里,343,1,745,3,748,1351,3,1,3,0,1,0,55.37
高雄市,三民區,寶慶里,344,1,672,2,674,1219,3,1,3,0,1,0,55.29
高雄市,三民區,寶慶里,345,1,609,3,612,1214,3,1,3,0,1,0,50.41
高雄市,三民區,寶業里,346,1,757,4,761,1436,3,1,3,0,1,0,52.99
高雄市,三民區,寶業里,347,1,741,3,744,1395,3,1,3,0,1,0,53.33
高雄市,三民區,寶業里,348,1,762,3,765,1346,3,1,3,0,1,0,56.84
高雄市,三民區,寶盛里,349,1,757,4,761,1269,3,1,3,0,1,0,59.97
高雄市,三民區,寶盛里,350,1,738,6,744,1217,3,1,3,0,1,0,61.13
高雄市,三民區,寶盛里,351,1,839,3,842,1464,3,1,3,0,1,0,57.51
高雄市,三民區,寶安里,352,1,1047,7,1054,1943,3,1,3,0,1,0,54.25
高雄市,三民區,寶安里,353,1,1035,5,1040,2034,3,1,3,0,1,0,51.13
高雄市,三民區,寶安里,354,1,1021,3,1024,1923,3,1,3,0,1,0,53.25
高雄市,三民區,寶龍里,355,1,768,2,770,1352,3,1,3,0,1,0,56.95
高雄市,三民區,寶龍里,356,1,723,5,728,1203,3,1,3,0,1,0,60.52
高雄市,三民區,寶龍里,357,1,747,1,748,1366,3,1,3,0,1,0,54.76
高雄市,三民區,寶珠里,358,1,868,7,875,2103,3,1,3,0,1,0,41.61
高雄市,三民區,寶珠里,359,1,797,9,806,1550,3,1,3,0,1,0,52.00
高雄市,三民區,寶珠里,360,1,876,1,877,1577,3,1,3,0,1,0,55.61
高雄市,三民區,寶玉里,361,1,923,14,937,1755,3,1,3,0,1,0,53.39
高雄市,三民區,寶玉里,362,1,985,3,988,1769,3,1,3,0,1,0,55.85
高雄市,三民區,寶玉里,363,1,845,9,854,1723,3,1,3,0,1,0,49.56
高雄市,三民區,寶玉里,364,1,930,5,935,1787,3,1,3,0,1,0,52.32
高雄市,三民區,灣子里,365,1,866,0,866,1652,3,1,3,0,1,0,52.42
高雄市,三民區,灣子里,366,1,727,4,731,1377,3,1,3,0,1,0,53.09
高雄市,三民區,灣愛里,367,1,782,6,788,1435,3,1,3,0,1,0,54.91
高雄市,三民區,灣愛里,368,1,708,3,711,1467,3,1,3,0,1,0,48.47
高雄市,三民區,灣中里,369,1,823,3,826,1413,3,1,3,0,1,0,58.46
高雄市,三民區,灣中里,370,1,644,3,647,1186,3,1,3,0,1,0,54.55
高雄市,三民區,灣中里,371,1,807,7,814,1404,3,1,3,0,1,0,57.98
高雄市,三民區,灣華里,372,1,744,5,749,1375,3,1,3,0,1,0,54.47
高雄市,三民區,灣華里,373,1,704,5,709,1236,3,1,3,0,1,0,57.36
高雄市,三民區,灣勝里,374,1,581,6,587,999,3,1,3,0,1,0,58.76
高雄市,三民區,灣勝里,375,1,620,1,621,1019,3,1,3,0,1,0,60.94
高雄市,三民區,灣利里,376,1,978,9,987,1700,3,1,3,0,1,0,58.06
高雄市,三民區,灣利里,377,1,941,4,945,1529,3,1,3,0,1,0,61.81
高雄市,三民區,灣復里,378,1,828,16,844,1425,3,1,3,0,1,0,59.23
高雄市,三民區,灣復里,379,1,739,4,743,1526,3,1,3,0,1,0,48.69
高雄市,三民區,正興里,380,1,793,11,804,1583,3,1,3,0,1,0,50.79
高雄市,三民區,正興里,381,1,1178,12,1190,2233,3,1,3,0,1,0,53.29
高雄市,三民區,正興里,382,1,931,5,936,1701,3,1,3,0,1,0,55.03
高雄市,三民區,正興里,383,1,844,0,844,1588,3,1,3,0,1,0,53.15
高雄市,三民區,正興里,384,1,921,6,927,1805,3,1,3,0,1,0,51.36
高雄市,三民區,正順里,385,1,891,5,896,1555,3,1,3,0,1,0,57.62
高雄市,三民區,正順里,386,1,1035,8,1043,1726,3,1,3,0,1,0,60.43
高雄市,三民區,灣興里,387,1,911,4,915,1506,3,1,3,0,1,0,60.76
高雄市,三民區,灣成里,388,1,1074,7,1081,1980,3,1,3,0,1,0,54.60
高雄市,三民區,安康里,389,1,771,1,772,1443,3,1,3,0,1,0,53.50
高雄市,三民區,安康里,390,1,813,2,815,1468,3,1,3,0,1,0,55.52
高雄市,三民區,安寧里,391,1,513,2,515,974,3,1,3,0,1,0,52.87
高雄市,三民區,安寧里,392,1,554,8,562,1042,3,1,3,0,1,0,53.93
高雄市,三民區,安吉里,393,1,625,6,631,1336,3,1,3,0,1,0,47.23
高雄市,三民區,安吉里,394,1,686,3,689,1314,3,1,3,0,1,0,52.44
高雄市,三民區,安吉里,395,1,864,2,866,1574,3,1,3,0,1,0,55.02
高雄市,三民區,安發里,396,1,742,6,748,1370,3,1,3,0,1,0,54.60
高雄市,三民區,安發里,397,1,778,10,788,1362,3,1,3,0,1,0,57.86
高雄市,三民區,安發里,398,1,758,5,763,1401,3,1,3,0,1,0,54.46
高雄市,三民區,安東里,399,1,945,2,947,1555,3,1,3,0,1,0,60.90
高雄市,三民區,安東里,400,1,952,5,957,1568,3,1,3,0,1,0,61.03
高雄市,三民區,安和里,401,1,803,3,806,1297,3,1,3,0,1,0,62.14
高雄市,三民區,安和里,402,1,811,2,813,1360,3,1,3,0,1,0,59.78
高雄市,三民區,達德里,403,1,875,4,879,1428,3,1,3,0,1,0,61.55
高雄市,三民區,達明里,404,1,1034,7,1041,1666,3,1,3,0,1,0,62.48
高雄市,三民區,達仁里,405,1,900,6,906,1443,3,1,3,0,1,0,62.79
高雄市,三民區,達勇里,406,1,616,3,619,1056,3,1,3,0,1,0,58.62
高雄市,三民區,同德里,407,1,837,3,840,1445,3,1,3,0,1,0,58.13
高雄市,三民區,同德里,408,1,786,6,792,1307,3,1,3,0,1,0,60.60
高雄市,三民區,德智里,409,1,709,7,716,1172,3,1,3,0,1,0,61.09
高雄市,三民區,德智里,410,1,756,2,758,1243,3,1,3,0,1,0,60.98
高雄市,三民區,德仁里,411,1,527,3,530,929,3,1,3,0,1,0,57.05
高雄市,三民區,德仁里,412,1,551,1,552,986,3,1,3,0,1,0,55.98
高雄市,三民區,安生里,413,1,1035,8,1043,1667,3,1,3,0,1,0,62.57
高雄市,三民區,德東里,414,1,527,6,533,874,3,1,3,0,1,0,60.98
高雄市,三民區,德行里,415,1,653,0,653,1102,3,1,3,0,1,0,59.26
高雄市,三民區,精華里,416,1,994,5,999,1586,3,1,3,0,1,0,62.99
高雄市,三民區,民享里,417,1,635,2,637,994,3,1,3,0,1,0,64.08
高雄市,三民區,民享里,418,1,627,3,630,1035,3,1,3,0,1,0,60.87
高雄市,三民區,安宜里,419,1,937,6,943,1580,3,1,3,0,1,0,59.68
高雄市,三民區,安宜里,420,1,941,9,950,1582,3,1,3,0,1,0,60.05
高雄市,三民區,安泰里,421,1,710,7,717,1191,3,1,3,0,1,0,60.20
高雄市,三民區,安泰里,422,1,710,9,719,1242,3,1,3,0,1,0,57.89
高雄市,三民區,安泰里,423,1,797,3,800,1492,3,1,3,0,1,0,53.62
高雄市,三民區,安邦里,424,1,639,6,645,1459,3,1,3,0,1,0,44.21
高雄市,三民區,安邦里,425,1,810,2,812,1298,3,1,3,0,1,0,62.56
高雄市,三民區,安邦里,426,1,692,5,697,1189,3,1,3,0,1,0,58.62
高雄市,三民區,十全里,427,1,905,3,908,1557,3,1,3,0,1,0,58.32
高雄市,三民區,十美里,428,1,514,3,517,894,3,1,3,0,1,0,57.83
高雄市,三民區,十美里,429,1,504,4,508,873,3,1,3,0,1,0,58.19
高雄市,三民區,德北里,430,1,521,2,523,938,3,1,3,0,1,0,55.76
高雄市,三民區,德北里,431,1,619,2,621,1101,3,1,3,0,1,0,56.40
高雄市,三民區,立誠里,432,1,581,7,588,918,3,1,3,0,1,0,64.05
高雄市,三民區,立業里,433,1,666,0,666,1069,3,1,3,0,1,0,62.30
高雄市,三民區,港東里,434,1,758,3,761,1416,3,1,3,0,1,0,53.74
高雄市,三民區,港新里,435,1,762,1,763,1393,3,1,3,0,1,0,54.77
高雄市,三民區,港西里,436,1,460,5,465,827,3,1,3,0,1,0,56.23
高雄市,三民區,港北里,437,1,277,0,277,403,3,1,3,0,1,0,68.73
高雄市,三民區,博愛里,438,1,656,3,659,1163,3,1,3,0,1,0,56.66
高雄市,三民區,博惠里,439,1,773,1,774,1322,3,1,3,0,1,0,58.55
高雄市,三民區,博惠里,440,1,790,5,795,1357,3,1,3,0,1,0,58.59
高雄市,三民區,博惠里,441,1,747,1,748,1298,3,1,3,0,1,0,57.63
高雄市,三民區,長明里,442,1,653,1,654,1143,3,1,3,0,1,0,57.22
高雄市,三民區,建東里,443,1,537,5,542,1109,3,1,3,0,1,0,48.87
高雄市,三民區,興德里,444,1,925,8,933,1674,3,1,3,0,1,0,55.73
高雄市,三民區,鳳南里,445,1,698,2,700,1114,3,1,3,0,1,0,62.84
高雄市,三民區,鳳北里,446,1,588,2,590,951,3,1,3,0,1,0,62.04
高雄市,三民區,鳳北里,447,1,511,4,515,910,3,1,3,0,1,0,56.59
高雄市,三民區,德西里,448,1,698,7,705,1209,3,1,3,0,1,0,58.31
高雄市,三民區,九如里,449,1,255,4,259,398,3,1,3,0,1,0,65.08
高雄市,三民區,豐裕里,450,1,828,3,831,1408,3,1,3,0,1,0,59.02
高雄市,三民區,豐裕里,451,1,683,4,687,1229,3,1,3,0,1,0,55.90
高雄市,三民區,川東里,452,1,565,4,569,956,3,1,3,0,1,0,59.52
高雄市,三民區,川東里,453,1,567,6,573,944,3,1,3,0,1,0,60.70
高雄市,三民區,裕民里,454,1,536,6,542,844,3,1,3,0,1,0,64.22
高雄市,三民區,力行里,455,1,777,5,782,1139,3,1,3,0,1,0,68.66
高雄市,三民區,千歲里,456,1,718,7,725,1176,3,1,3,0,1,0,61.65
高雄市,三民區,立德里,457,1,788,2,790,1326,3,1,3,0,1,0,59.58
高雄市,三民區,千北里,458,1,749,7,756,1275,3,1,3,0,1,0,59.29
高雄市,三民區,千秋里,459,1,698,4,702,1216,3,1,3,0,1,0,57.73
高雄市,三民區,千秋里,460,1,668,2,670,1138,3,1,3,0,1,0,58.88
高雄市,新興區,浩然里,461,2,652,5,657,1088,3,1,3,0,1,0,60.39
高雄市,新興區,浩然里,462,2,474,0,474,840,3,1,3,0,1,0,56.43
高雄市,新興區,振成里,463,2,668,1,669,1253,3,1,3,0,1,0,53.39
高雄市,新興區,德生里,464,2,834,5,839,1563,3,1,3,0,1,0,53.68
高雄市,新興區,德生里,465,2,535,1,536,997,3,1,3,0,1,0,53.76
高雄市,新興區,振華里,466,2,761,6,767,1294,3,1,3,0,1,0,59.27
高雄市,新興區,正氣里,467,2,988,7,995,1588,3,1,3,0,1,0,62.66
高雄市,新興區,德政里,468,2,413,8,421,735,3,1,3,0,1,0,57.28
高雄市,新興區,仁聲里,469,2,453,1,454,863,3,1,3,0,1,0,52.61
高雄市,新興區,德望里,470,2,511,0,511,993,3,1,3,0,1,0,51.46
高雄市,新興區,德望里,471,2,574,5,579,1030,3,1,3,0,1,0,56.21
高雄市,新興區,華聲里,472,2,610,6,616,1028,3,1,3,0,1,0,59.92
高雄市,新興區,蕉園里,473,2,489,3,492,798,3,1,3,0,1,0,61.65
高雄市,新興區,永寧里,474,2,780,7,787,1456,3,1,3,0,1,0,54.05
高雄市,新興區,玉衡里,475,2,624,8,632,1077,3,1,3,0,1,0,58.68
高雄市,新興區,順昌里,476,2,747,3,750,1137,3,1,3,0,1,0,65.96
高雄市,新興區,順昌里,477,2,539,1,540,940,3,1,3,0,1,0,57.45
高雄市,新興區,文昌里,478,2,868,7,875,1476,3,1,3,0,1,0,59.28
高雄市,新興區,文昌里,479,2,619,1,620,1130,3,1,3,0,1,0,54.87
高雄市,新興區,光耀里,480,2,711,5,716,1223,3,1,3,0,1,0,58.54
高雄市,新興區,光耀里,481,2,698,2,700,1177,3,1,3,0,1,0,59.47
高雄市,新興區,興昌里,482,2,538,2,540,852,3,1,3,0,1,0,63.38
高雄市,新興區,興昌里,483,2,544,2,546,934,3,1,3,0,1,0,58.46
高雄市,新興區,開平里,484,2,852,7,859,1469,3,1,3,0,1,0,58.48
高雄市,新興區,開平里,485,2,921,6,927,1526,3,1,3,0,1,0,60.75
高雄市,新興區,成功里,486,2,698,5,703,1136,3,1,3,0,1,0,61.88
高雄市,新興區,新江里,487,2,631,2,633,1129,3,1,3,0,1,0,56.07
高雄市,新興區,黎明里,488,2,501,3,504,922,3,1,3,0,1,0,54.66
高雄市,新興區,愛平里,489,2,535,4,539,887,3,1,3,0,1,0,60.77
高雄市,新興區,南港里,490,2,642,2,644,1073,3,1,3,0,1,0,60.02
高雄市,新興區,南港里,491,2,705,6,711,1132,3,1,3,0,1,0,62.81
高雄市,新興區,中東里,492,2,576,3,579,1243,3,1,3,0,1,0,46.58
高雄市,新興區,中東里,493,2,761,7,768,1450,3,1,3,0,1,0,52.97
高雄市,新興區,明莊里,494,2,486,2,488,826,3,1,3,0,1,0,59.08
高雄市,新興區,大明里,495,2,676,0,676,1169,3,1,3,0,1,0,57.83
高雄市,新興區,秋山里,496,2,543,4,547,948,3,1,3,0,1,0,57.70
高雄市,新興區,長驛里,497,2,522,4,526,948,3,1,3,0,1,0,55.49
高雄市,新興區,建興里,498,2,545,2,547,908,3,1,3,0,1,0,60.24
高雄市,新興區,建華里,499,2,545,3,548,968,3,1,3,0,1,0,56.61
高雄市,新興區,漢民里,500,2,525,2,527,842,3,1,3,0,1,0,62.59
高雄市,新興區,榮治里,501,2,465,1,466,784,3,1,3,0,1,0,59.44
高雄市,新興區,東坡里,502,2,782,8,790,1349,3,1,3,0,1,0,58.56
高雄市,前金區,三川里,503,2,469,2,471,784,3,1,3,0,1,0,60.08
高雄市,前金區,草江里,504,2,643,5,648,1151,3,1,3,0,1,0,56.30
高雄市,前金區,長城里,505,2,811,6,817,1417,3,1,3,0,1,0,57.66
高雄市,前金區,北金里,506,2,527,2,529,904,3,1,3,0,1,0,58.52
高雄市,前金區,東金里,507,2,525,4,529,911,3,1,3,0,1,0,58.07
高雄市,前金區,新生里,508,2,896,7,903,1583,3,1,3,0,1,0,57.04
高雄市,前金區,新生里,509,2,785,4,789,1446,3,1,3,0,1,0,54.56
高雄市,前金區,後金里,510,2,548,3,551,926,3,1,3,0,1,0,59.50
高雄市,前金區,長興里,511,2,613,5,618,1148,3,1,3,0,1,0,53.83
高雄市,前金區,青山里,512,2,793,3,796,1416,3,1,3,0,1,0,56.21
高雄市,前金區,民生里,513,2,417,2,419,745,3,1,3,0,1,0,56.24
高雄市,前金區,復元里,514,2,603,3,606,1044,3,1,3,0,1,0,58.05
高雄市,前金區,林投里,515,2,684,2,686,1257,3,1,3,0,1,0,54.57
高雄市,前金區,國民里,516,2,596,2,598,1080,3,1,3,0,1,0,55.37
高雄市,前金區,社東里,517,2,494,4,498,855,3,1,3,0,1,0,58.25
高雄市,前金區,社東里,518,2,523,1,524,856,3,1,3,0,1,0,61.21
高雄市,前金區,社西里,519,2,605,5,610,1163,3,1,3,0,1,0,52.45
高雄市,前金區,博孝里,520,2,507,5,512,949,3,1,3,0,1,0,53.95
高雄市,前金區,長生里,521,2,825,3,828,1536,3,1,3,0,1,0,53.91
高雄市,前金區,榮復里,522,2,747,8,755,1263,3,1,3,0,1,0,59.78
高雄市,前金區,文西里,523,2,657,2,659,1085,3,1,3,0,1,0,60.74
高雄市,前金區,文東里,524,2,775,3,778,1361,3,1,3,0,1,0,57.16
高雄市,苓雅區,博仁里,525,2,339,1,340,584,3,1,3,0,1,0,58.22
高雄市,苓雅區,苓洲里,526,2,805,3,808,1333,3,1,3,0,1,0,60.62
高雄市,苓雅區,苓昇里,527,2,859,6,865,1423,3,1,3,0,1,0,60.79
高雄市,苓雅區,苓中里,528,2,966,7,973,1664,3,1,3,0,1,0,58.47
高雄市,苓雅區,苓雅里,529,2,836,2,838,1460,3,1,3,0,1,0,57.40
高雄市,苓雅區,苓東里,530,2,865,8,873,1530,3,1,3,0,1,0,57.06
高雄市,苓雅區,城北里,531,2,821,6,827,1560,3,1,3,0,1,0,53.01
高雄市,苓雅區,城西里,532,2,395,3,398,692,3,1,3,0,1,0,57.51
高雄市,苓雅區,城東里,533,2,1004,6,1010,1840,3,1,3,0,1,0,54.89
高雄市,苓雅區,意誠里,534,2,658,4,662,1282,3,1,3,0,1,0,51.64
高雄市,苓雅區,意誠里,535,2,639,5,644,1425,3,1,3,0,1,0,45.19
高雄市,苓雅區,鼓中里,536,2,691,4,695,1154,3,1,3,0,1,0,60.23
高雄市,苓雅區,田西里,537,2,888,7,895,1437,3,1,3,0,1,0,62.28
高雄市,苓雅區,人和里,538,2,576,2,578,971,3,1,3,0,1,0,59.53
高雄市,苓雅區,人和里,539,2,467,0,467,897,3,1,3,0,1,0,52.06
高雄市,苓雅區,仁政里,540,2,748,7,755,1415,3,1,3,0,1,0,53.36
高雄市,苓雅區,廣澤里,541,2,1257,6,1263,1971,3,1,3,0,1,0,64.08
高雄市,苓雅區,美田里,542,2,744,2,746,1258,3,1,3,0,1,0,59.30
高雄市,苓雅區,華堂里,543,2,833,5,838,1527,3,1,3,0,1,0,54.88
高雄市,苓雅區,華堂里,544,2,798,2,800,1504,3,1,3,0,1,0,53.19
高雄市,苓雅區,日中里,545,2,674,1,675,1148,3,1,3,0,1,0,58.80
高雄市,苓雅區,日中里,546,2,600,3,603,1137,3,1,3,0,1,0,53.03
高雄市,苓雅區,普照里,547,2,749,5,754,1278,3,1,3,0,1,0,59.00
高雄市,苓雅區,普照里,548,2,779,3,782,1361,3,1,3,0,1,0,57.46
高雄市,苓雅區,和煦里,549,2,642,3,645,1011,3,1,3,0,1,0,63.80
高雄市,苓雅區,和煦里,550,2,696,2,698,1142,3,1,3,0,1,0,61.12
高雄市,苓雅區,晴朗里,551,2,706,3,709,1715,3,1,3,0,1,0,41.34
高雄市,苓雅區,普天里,552,2,825,1,826,1436,3,1,3,0,1,0,57.52
高雄市,苓雅區,普天里,553,2,800,3,803,1395,3,1,3,0,1,0,57.56
高雄市,苓雅區,林富里,554,2,1025,4,1029,1797,3,1,3,0,1,0,57.26
高雄市,苓雅區,林圍里,555,2,534,1,535,1057,3,1,3,0,1,0,50.61
高雄市,苓雅區,林圍里,556,2,635,7,642,1107,3,1,3,0,1,0,57.99
高雄市,苓雅區,林安里,557,2,947,6,953,1556,3,1,3,0,1,0,61.25
高雄市,苓雅區,光華里,558,2,472,3,475,780,3,1,3,0,1,0,60.90
高雄市,苓雅區,林興里,559,2,810,5,815,1444,3,1,3,0,1,0,56.44
高雄市,苓雅區,林華里,560,2,884,7,891,1473,3,1,3,0,1,0,60.49
高雄市,苓雅區,林華里,561,2,861,4,865,1540,3,1,3,0,1,0,56.17
高雄市,苓雅區,林西里,562,2,970,13,983,1795,3,1,3,0,1,0,54.76
高雄市,苓雅區,林中里,563,2,895,2,897,1583,3,1,3,0,1,0,56.66
高雄市,苓雅區,林中里,564,2,930,8,938,1679,3,1,3,0,1,0,55.87
高雄市,苓雅區,林泉里,565,2,1067,3,1070,1832,3,1,3,0,1,0,58.41
高雄市,苓雅區,林南里,566,2,862,5,867,1496,3,1,3,0,1,0,57.95
高雄市,苓雅區,林南里,567,2,742,3,745,1348,3,1,3,0,1,0,55.27
高雄市,苓雅區,中正里,568,2,706,3,709,1257,3,1,3,0,1,0,56.40
高雄市,苓雅區,中正里,569,2,707,2,709,1302,3,1,3,0,1,0,54.45
高雄市,苓雅區,尚義里,570,2,721,2,723,1414,3,1,3,0,1,0,51.13
高雄市,苓雅區,同慶里,571,2,945,6,951,1547,3,1,3,0,1,0,61.47
高雄市,苓雅區,凱旋里,572,2,1219,7,1226,1902,3,1,3,0,1,0,64.46
高雄市,苓雅區,安祥里,573,2,566,3,569,1083,3,1,3,0,1,0,52.54
高雄市,苓雅區,安祥里,574,2,755,4,759,1296,3,1,3,0,1,0,58.56
高雄市,苓雅區,奏捷里,575,2,1006,4,1010,1622,3,1,3,0,1,0,62.27
高雄市,苓雅區,福壽里,576,2,963,5,968,1535,3,1,3,0,1,0,63.06
高雄市,苓雅區,福南里,577,2,735,3,738,1182,3,1,3,0,1,0,62.44
高雄市,苓雅區,福南里,578,2,682,7,689,1165,3,1,3,0,1,0,59.14
高雄市,苓雅區,五權里,579,2,532,0,532,946,3,1,3,0,1,0,56.24
高雄市,苓雅區,五權里,580,2,625,2,627,1033,3,1,3,0,1,0,60.70
高雄市,苓雅區,民主里,581,2,741,0,741,1283,3,1,3,0,1,0,57.76
高雄市,苓雅區,民主里,582,2,661,2,663,1175,3,1,3,0,1,0,56.43
高雄市,苓雅區,民主里,583,2,799,6,805,1416,3,1,3,0,1,0,56.85
高雄市,苓雅區,林德里,584,2,509,3,512,892,3,1,3,0,1,0,57.40
高雄市,苓雅區,林德里,585,2,471,4,475,795,3,1,3,0,1,0,59.75
高雄市,苓雅區,林貴里,586,2,800,3,803,1361,3,1,3,0,1,0,59.00
高雄市,苓雅區,林榮里,587,2,1180,4,1184,1966,3,1,3,0,1,0,60.22
高雄市,苓雅區,林榮里,588,2,1119,6,1125,1985,3,1,3,0,1,0,56.68
高雄市,苓雅區,英明里,589,2,557,7,564,1009,3,1,3,0,1,0,55.90
高雄市,苓雅區,英明里,590,2,607,1,608,1027,3,1,3,0,1,0,59.20
高雄市,苓雅區,林靖里,591,2,913,6,919,1547,3,1,3,0,1,0,59.41
高雄市,苓雅區,朝陽里,592,2,890,2,892,1501,3,1,3,0,1,0,59.43
高雄市,苓雅區,福隆里,593,2,816,4,820,1454,3,1,3,0,1,0,56.40
高雄市,苓雅區,福隆里,594,2,748,3,751,1287,3,1,3,0,1,0,58.35
高雄市,苓雅區,福祥里,595,2,817,6,823,1335,3,1,3,0,1,0,61.65
高雄市,苓雅區,福海里,596,2,607,9,616,1019,3,1,3,0,1,0,60.45
高雄市,苓雅區,福康里,597,2,535,1,536,918,3,1,3,0,1,0,58.39
高雄市,苓雅區,福康里,598,2,619,3,622,1025,3,1,3,0,1,0,60.68
高雄市,苓雅區,福人里,599,2,653,8,661,1102,3,1,3,0,1,0,59.98
高雄市,苓雅區,福人里,600,2,590,3,593,1073,3,1,3,0,1,0,55.27
高雄市,苓雅區,福地里,601,2,888,12,900,1401,3,1,3,0,1,0,64.24
高雄市,苓雅區,福地里,602,2,885,6,891,1498,3,1,3,0,1,0,59.48
高雄市,苓雅區,福居里,603,2,768,10,778,1341,3,1,3,0,1,0,58.02
高雄市,苓雅區,福居里,604,2,891,1,892,1494,3,1,3,0,1,0,59.71
高雄市,苓雅區,福東里,605,2,762,8,770,1355,3,1,3,0,1,0,56.83
高雄市,苓雅區,福東里,606,2,642,2,644,1200,3,1,3,0,1,0,53.67
高雄市,苓雅區,福西里,607,2,686,5,691,1206,3,1,3,0,1,0,57.30
高雄市,苓雅區,福西里,608,2,452,1,453,797,3,1,3,0,1,0,56.84
高雄市,苓雅區,永康里,609,2,680,9,689,1143,3,1,3,0,1,0,60.28
高雄市,苓雅區,永康里,610,2,701,2,703,1211,3,1,3,0,1,0,58.05
高雄市,苓雅區,正文里,611,2,954,4,958,1782,3,1,3,0,1,0,53.76
高雄市,苓雅區,正言里,612,2,737,8,745,1400,3,1,3,0,1,0,53.21
高雄市,苓雅區,正言里,613,2,708,7,715,1321,3,1,3,0,1,0,54.13
高雄市,苓雅區,正大里,614,2,725,3,728,1365,3,1,3,0,1,0,53.33
高雄市,苓雅區,正大里,615,2,748,4,752,1398,3,1,3,0,1,0,53.79
高雄市,苓雅區,正大里,616,2,818,8,826,1832,3,1,3,0,1,0,45.09
高雄市,苓雅區,五福里,617,2,732,6,738,1254,3,1,3,0,1,0,58.85
高雄市,苓雅區,五福里,618,2,698,6,704,1303,3,1,3,0,1,0,54.03
高雄市,苓雅區,五福里,619,2,744,3,747,1342,3,1,3,0,1,0,55.66
高雄市,苓雅區,正心里,620,2,1033,6,1039,1854,3,1,3,0,1,0,56.04
高雄市,苓雅區,正心里,621,2,984,2,986,1756,3,1,3,0,1,0,56.15
高雄市,苓雅區,正道里,622,2,703,5,708,1277,3,1,3,0,1,0,55.44
高雄市,苓雅區,正道里,623,2,816,5,821,1446,3,1,3,0,1,0,56.78
高雄市,苓雅區,正道里,624,2,785,5,790,1412,3,1,3,0,1,0,55.95
高雄市,苓雅區,正義里,625,2,687,3,690,1200,3,1,3,0,1,0,57.50
高雄市,苓雅區,正義里,626,2,728,6,734,1149,3,1,3,0,1,0,63.88
高雄市,苓雅區,正仁里,627,2,653,4,657,1224,3,1,3,0,1,0,53.68
高雄市,苓雅區,正仁里,628,2,612,3,615,1201,3,1,3,0,1,0,51.21
高雄市,苓雅區,文昌里,629,2,659,3,662,1064,3,1,3,0,1,0,62.22
高雄市,苓雅區,文昌里,630,2,955,5,960,1630,3,1,3,0,1,0,58.90
高雄市,苓雅區,文昌里,631,2,637,4,641,1156,3,1,3,0,1,0,55.45
高雄市,苓雅區,建軍里,632,2,1208,10,1218,2066,3,1,3,0,1,0,58.95
高雄市,苓雅區,衛武里,633,2,605,8,613,1075,3,1,3,0,1,0,57.02
高雄市,苓雅區,衛武里,634,2,620,3,623,1053,3,1,3,0,1,0,59.16
高雄市,前鎮區,草衙里,635,2,734,4,738,1300,3,1,3,0,1,0,56.77
高雄市,前鎮區,草衙里,636,2,937,9,946,1677,3,1,3,0,1,0,56.41
高雄市,前鎮區,草衙里,637,2,919,5,924,1741,3,1,3,0,1,0,53.07
高雄市,前鎮區,草衙里,638,2,888,7,895,1772,3,1,3,0,1,0,50.51
高雄市,前鎮區,草衙里,639,2,836,3,839,1582,3,1,3,0,1,0,53.03
高雄市,前鎮區,明孝里,640,2,897,11,908,1546,3,1,3,0,1,0,58.73
高雄市,前鎮區,明孝里,641,2,509,1,510,859,3,1,3,0,1,0,59.37
高雄市,前鎮區,明正里,642,2,962,5,967,1613,3,1,3,0,1,0,59.95
高雄市,前鎮區,明正里,643,2,908,4,912,1558,3,1,3,0,1,0,58.54
高雄市,前鎮區,明義里,644,2,590,3,593,964,3,1,3,0,1,0,61.51
高雄市,前鎮區,明義里,645,2,524,6,530,852,3,1,3,0,1,0,62.21
高雄市,前鎮區,仁愛里,646,2,864,3,867,1434,3,1,3,0,1,0,60.46
高雄市,前鎮區,德昌里,647,2,1156,7,1163,1870,3,1,3,0,1,0,62.19
高雄市,前鎮區,平等里,648,2,1081,5,1086,2226,3,1,3,0,1,0,48.79
高雄市,前鎮區,平昌里,649,2,427,3,430,707,3,1,3,0,1,0,60.82
高雄市,前鎮區,明禮里,650,2,1040,8,1048,1727,3,1,3,0,1,0,60.68
高雄市,前鎮區,信義里,651,2,992,10,1002,1554,3,1,3,0,1,0,64.48
高雄市,前鎮區,信德里,652,2,657,10,667,1067,3,1,3,0,1,0,62.51
高雄市,前鎮區,信德里,653,2,777,5,782,1369,3,1,3,0,1,0,57.12
高雄市,前鎮區,明道里,654,2,777,7,784,1274,3,1,3,0,1,0,61.54
高雄市,前鎮區,興化里,655,2,481,1,482,766,3,1,3,0,1,0,62.92
高雄市,前鎮區,興仁里,656,2,497,6,503,875,3,1,3,0,1,0,57.49
高雄市,前鎮區,前鎮里,657,2,882,6,888,1479,3,1,3,0,1,0,60.04
高雄市,前鎮區,鎮東里,658,2,1201,10,1211,1919,3,1,3,0,1,0,63.11
高雄市,前鎮區,鎮榮里,659,2,836,7,843,1259,3,1,3,0,1,0,66.96
高雄市,前鎮區,鎮榮里,660,2,593,1,594,1037,3,1,3,0,1,0,57.28
高雄市,前鎮區,鎮昌里,661,2,538,7,545,833,3,1,3,0,1,0,65.43
高雄市,前鎮區,鎮昌里,662,2,744,32,776,1217,3,1,3,0,1,0,63.76
高雄市,前鎮區,鎮海里,663,2,653,2,655,1101,3,1,3,0,1,0,59.49
高雄市,前鎮區,鎮海里,664,2,716,2,718,1288,3,1,3,0,1,0,55.75
高雄市,前鎮區,鎮海里,665,2,882,5,887,1479,3,1,3,0,1,0,59.97
高雄市,前鎮區,鎮陽里,666,2,758,8,766,1140,3,1,3,0,1,0,67.19
高雄市,前鎮區,興邦里,667,2,612,5,617,1040,3,1,3,0,1,0,59.33
高雄市,前鎮區,興邦里,668,2,560,2,562,970,3,1,3,0,1,0,57.94
高雄市,前鎮區,鎮中里,669,2,553,6,559,856,3,1,3,0,1,0,65.30
高雄市,前鎮區,鎮北里,670,2,706,5,711,1033,3,1,3,0,1,0,68.83
高雄市,前鎮區,忠純里,671,2,1458,6,1464,2331,3,1,3,0,1,0,62.81
高雄市,前鎮區,忠純里,672,2,1348,11,1359,2007,3,1,3,0,1,0,67.71
高雄市,前鎮區,忠誠里,673,2,698,0,698,1018,3,1,3,0,1,0,68.57
高雄市,前鎮區,忠誠里,674,2,761,4,765,1048,3,1,3,0,1,0,73.00
高雄市,前鎮區,西山里,675,2,974,9,983,1676,3,1,3,0,1,0,58.65
高雄市,前鎮區,西山里,676,2,974,5,979,1647,3,1,3,0,1,0,59.44
高雄市,前鎮區,民權里,677,2,719,7,726,1198,3,1,3,0,1,0,60.60
高雄市,前鎮區,民權里,678,2,858,10,868,1355,3,1,3,0,1,0,64.06
高雄市,前鎮區,民權里,679,2,698,2,700,1249,3,1,3,0,1,0,56.04
高雄市,前鎮區,建隆里,680,2,485,0,485,841,3,1,3,0,1,0,57.67
高雄市,前鎮區,振興里,681,2,1073,9,1082,1928,3,1,3,0,1,0,56.12
高雄市,前鎮區,良和里,682,2,749,8,757,1285,3,1,3,0,1,0,58.91
高雄市,前鎮區,良和里,683,2,746,3,749,1318,3,1,3,0,1,0,56.83
高雄市,前鎮區,西甲里,684,2,1146,51,1197,1940,3,1,3,0,1,0,61.70
高雄市,前鎮區,盛興里,685,2,695,3,698,1295,3,1,3,0,1,0,53.90
高雄市,前鎮區,盛興里,686,2,655,6,661,1217,3,1,3,0,1,0,54.31
高雄市,前鎮區,盛豐里,687,2,825,7,832,1427,3,1,3,0,1,0,58.30
高雄市,前鎮區,盛豐里,688,2,775,3,778,1418,3,1,3,0,1,0,54.87
高雄市,前鎮區,興中里,689,2,872,6,878,1515,3,1,3,0,1,0,57.95
高雄市,前鎮區,興中里,690,2,809,8,817,1583,3,1,3,0,1,0,51.61
高雄市,前鎮區,興東里,691,2,859,5,864,1458,3,1,3,0,1,0,59.26
高雄市,前鎮區,興東里,692,2,880,3,883,1553,3,1,3,0,1,0,56.86
高雄市,前鎮區,興東里,693,2,877,5,882,1610,3,1,3,0,1,0,54.78
高雄市,前鎮區,忠孝里,694,2,661,4,665,1117,3,1,3,0,1,0,59.53
高雄市,前鎮區,忠孝里,695,2,755,10,765,1230,3,1,3,0,1,0,62.20
高雄市,前鎮區,復國里,696,2,801,3,804,1353,3,1,3,0,1,0,59.42
高雄市,前鎮區,復國里,697,2,916,3,919,1497,3,1,3,0,1,0,61.39
高雄市,前鎮區,竹內里,698,2,802,5,807,1234,3,1,3,0,1,0,65.40
高雄市,前鎮區,竹內里,699,2,820,7,827,1359,3,1,3,0,1,0,60.85
高雄市,前鎮區,竹東里,700,2,548,1,549,1061,3,1,3,0,1,0,51.74
高雄市,前鎮區,竹東里,701,2,588,6,594,1054,3,1,3,0,1,0,56.36
高雄市,前鎮區,竹南里,702,2,736,6,742,1364,3,1,3,0,1,0,54.40
高雄市,前鎮區,竹南里,703,2,785,3,788,1342,3,1,3,0,1,0,58.72
高雄市,前鎮區,竹北里,704,2,619,4,623,1119,3,1,3,0,1,0,55.67
高雄市,前鎮區,竹北里,705,2,504,2,506,893,3,1,3,0,1,0,56.66
高雄市,前鎮區,竹西里,706,2,735,5,740,1174,3,1,3,0,1,0,63.03
高雄市,前鎮區,竹西里,707,2,787,7,794,1277,3,1,3,0,1,0,62.18
高雄市,前鎮區,竹西里,708,2,811,7,818,1369,3,1,3,0,1,0,59.75
高雄市,前鎮區,竹中里,709,2,816,0,816,1459,3,1,3,0,1,0,55.93
高雄市,前鎮區,竹中里,710,2,826,3,829,1345,3,1,3,0,1,0,61.64
高雄市,前鎮區,瑞竹里,711,2,733,6,739,1278,3,1,3,0,1,0,57.82
高雄市,前鎮區,瑞南里,712,2,883,8,891,1477,3,1,3,0,1,0,60.32
高雄市,前鎮區,瑞南里,713,2,873,7,880,1457,3,1,3,0,1,0,60.40
高雄市,前鎮區,瑞南里,714,2,928,5,933,1616,3,1,3,0,1,0,57.74
高雄市,前鎮區,瑞豐里,715,2,801,5,806,1254,3,1,3,0,1,0,64.27
高雄市,前鎮區,瑞豐里,716,2,641,3,644,1047,3,1,3,0,1,0,61.51
高雄市,前鎮區,瑞祥里,717,2,960,1,961,1675,3,1,3,0,1,0,57.37
高雄市,前鎮區,瑞祥里,718,2,986,9,995,1645,3,1,3,0,1,0,60.49
高雄市,前鎮區,瑞祥里,719,2,785,4,789,1396,3,1,3,0,1,0,56.52
高雄市,前鎮區,瑞東里,720,2,706,5,711,1181,3,1,3,0,1,0,60.20
高雄市,前鎮區,瑞東里,721,2,741,1,742,1228,3,1,3,0,1,0,60.42
高雄市,前鎮區,瑞和里,722,2,565,4,569,959,3,1,3,0,1,0,59.33
高雄市,前鎮區,瑞和里,723,2,599,20,619,1069,3,1,3,0,1,0,57.90
高雄市,前鎮區,瑞平里,724,2,701,2,703,1129,3,1,3,0,1,0,62.27
高雄市,前鎮區,瑞平里,725,2,763,9,772,1224,3,1,3,0,1,0,63.07
高雄市,前鎮區,瑞平里,726,2,709,4,713,1288,3,1,3,0,1,0,55.36
高雄市,前鎮區,瑞隆里,727,2,714,4,718,1244,3,1,3,0,1,0,57.72
高雄市,前鎮區,瑞隆里,728,2,587,6,593,1046,3,1,3,0,1,0,56.69
高雄市,前鎮區,瑞隆里,729,2,640,1,641,1234,3,1,3,0,1,0,51.94
高雄市,前鎮區,瑞北里,730,2,840,6,846,1436,3,1,3,0,1,0,58.91
高雄市,前鎮區,瑞北里,731,2,787,4,791,1442,3,1,3,0,1,0,54.85
高雄市,前鎮區,瑞西里,732,2,852,4,856,1401,3,1,3,0,1,0,61.10
高雄市,前鎮區,瑞西里,733,2,781,2,783,1198,3,1,3,0,1,0,65.36
高雄市,前鎮區,瑞崗里,734,2,781,5,786,1200,3,1,3,0,1,0,65.50
高雄市,前鎮區,瑞崗里,735,2,729,1,730,1316,3,1,3,0,1,0,55.47
高雄市,前鎮區,瑞興里,736,2,781,7,788,1359,3,1,3,0,1,0,57.98
高雄市,前鎮區,瑞興里,737,2,695,4,699,1251,3,1,3,0,1,0,55.88
高雄市,前鎮區,瑞誠里,738,2,745,19,764,1347,3,1,3,0,1,0,56.72
高雄市,前鎮區,瑞誠里,739,2,577,3,580,1074,3,1,3,0,1,0,54.00
高雄市,前鎮區,瑞文里,740,2,608,4,612,1088,3,1,3,0,1,0,56.25
高雄市,前鎮區,瑞文里,741,2,701,3,704,1306,3,1,3,0,1,0,53.91
高雄市,前鎮區,瑞華里,742,2,780,29,809,1425,3,1,3,0,1,0,56.77
高雄市,前鎮區,瑞華里,743,2,844,5,849,1508,3,1,3,0,1,0,56.30
高雄市,前鎮區,瑞華里,744,2,715,3,718,1328,3,1,3,0,1,0,54.07
高雄市,前鎮區,瑞昌里,745,2,753,4,757,1356,3,1,3,0,1,0,55.83
高雄市,前鎮區,瑞昌里,746,2,759,3,762,1367,3,1,3,0,1,0,55.74
高雄市,小港區,小港里,747,2,1022,5,1027,1732,3,1,3,0,1,0,59.30
高雄市,小港區,港口里,748,2,1021,4,1025,1681,3,1,3,0,1,0,60.98
高雄市,小港區,港口里,749,2,904,6,910,1533,3,1,3,0,1,0,59.36
高雄市,小港區,港正里,750,2,694,7,701,1196,3,1,3,0,1,0,58.61
高雄市,小港區,港正里,751,2,697,3,700,1226,3,1,3,0,1,0,57.10
高雄市,小港區,港墘里,752,2,929,9,938,1560,3,1,3,0,1,0,60.13
高雄市,小港區,港明里,753,2,808,6,814,1427,3,1,3,0,1,0,57.04
高雄市,小港區,港明里,754,2,786,5,791,1417,3,1,3,0,1,0,55.82
高雄市,小港區,港后里,755,2,1084,5,1089,1877,3,1,3,0,1,0,58.02
高雄市,小港區,港南里,756,2,885,4,889,1650,3,1,3,0,1,0,53.88
高雄市,小港區,港興里,757,2,1237,6,1243,2020,3,1,3,0,1,0,61.53
高雄市,小港區,鳳宮里,758,2,1027,7,1034,1867,3,1,3,0,1,0,55.38
高雄市,小港區,店鎮里,759,2,721,6,727,1381,3,1,3,0,1,0,52.64
高雄市,小港區,店鎮里,760,2,894,11,905,1556,3,1,3,0,1,0,58.16
高雄市,小港區,店鎮里,761,2,883,3,886,1623,3,1,3,0,1,0,54.59
高雄市,小港區,大苓里,762,2,571,3,574,1027,3,1,3,0,1,0,55.89
高雄市,小港區,大苓里,763,2,727,5,732,1172,3,1,3,0,1,0,62.46
高雄市,小港區,二苓里,764,2,862,3,865,1471,3,1,3,0,1,0,58.80
高雄市,小港區,二苓里,765,2,864,4,868,1560,3,1,3,0,1,0,55.64
高雄市,小港區,三苓里,766,2,681,3,684,1234,3,1,3,0,1,0,55.43
高雄市,小港區,三苓里,767,2,748,5,753,1206,3,1,3,0,1,0,62.44
高雄市,小港區,正苓里,768,2,866,1,867,1625,3,1,3,0,1,0,53.35
高雄市,小港區,正苓里,769,2,898,8,906,1641,3,1,3,0,1,0,55.21
高雄市,小港區,順苓里,770,2,974,7,981,1924,3,1,3,0,1,0,50.99
高雄市,小港區,順苓里,771,2,950,4,954,1629,3,1,3,0,1,0,58.56
高雄市,小港區,六苓里,772,2,936,4,940,1620,3,1,3,0,1,0,58.02
高雄市,小港區,宏亮里,773,2,584,8,592,1093,3,1,3,0,1,0,54.16
高雄市,小港區,宏亮里,774,2,756,6,762,1430,3,1,3,0,1,0,53.29
高雄市,小港區,山東里,775,2,565,1,566,936,3,1,3,0,1,0,60.47
高雄市,小港區,山東里,776,2,726,5,731,1244,3,1,3,0,1,0,58.76
高雄市,小港區,青島里,777,2,1120,2,1122,1844,3,1,3,0,1,0,60.85
高雄市,小港區,濟南里,778,2,880,7,887,1572,3,1,3,0,1,0,56.42
高雄市,小港區,濟南里,779,2,924,4,928,1529,3,1,3,0,1,0,60.69
高雄市,小港區,泰山里,780,2,628,2,630,1079,3,1,3,0,1,0,58.39
高雄市,小港區,泰山里,781,2,588,7,595,1043,3,1,3,0,1,0,57.05
高雄市,小港區,山明里,782,2,1130,7,1137,2057,3,1,3,0,1,0,55.27
高雄市,小港區,山明里,783,2,997,6,1003,1645,3,1,3,0,1,0,60.97
高雄市,小港區,山明里,784,2,915,5,920,1748,3,1,3,0,1,0,52.63
高雄市,小港區,高松里,785,2,754,5,759,1465,3,1,3,0,1,0,51.81
高雄市,小港區,高松里,786,2,951,4,955,1641,3,1,3,0,1,0,58.20
高雄市,小港區,松金里,787,2,589,10,599,922,3,1,3,0,1,0,64.97
高雄市,小港區,松金里,788,2,612,7,619,1049,3,1,3,0,1,0,59.01
高雄市,小港區,松山里,789,2,1069,9,1078,1903,3,1,3,0,1,0,56.65
高雄市,小港區,大坪里,790,2,802,9,811,1302,3,1,3,0,1,0,62.29
高雄市,小港區,坪頂里,791,2,787,3,790,1397,3,1,3,0,1,0,56.55
高雄市,小港區,孔宅里,792,2,638,1,639,1083,3,1,3,0,1,0,59.00
高雄市,小港區,孔宅里,793,2,613,5,618,1119,3,1,3,0,1,0,55.23
高雄市,小港區,孔宅里,794,2,457,3,460,905,3,1,3,0,1,0,50.83
高雄市,小港區,廈莊里,795,2,1064,3,1067,1813,3,1,3,0,1,0,58.85
高雄市,小港區,合作里,796,2,659,4,663,1112,3,1,3,0,1,0,59.62
高雄市,小港區,合作里,797,2,613,4,617,1075,3,1,3,0,1,0,57.40
高雄市,小港區,桂林里,798,2,830,6,836,1479,3,1,3,0,1,0,56.52
高雄市,小港區,桂林里,799,2,883,1,884,1600,3,1,3,0,1,0,55.25
高雄市,小港區,桂林里,800,2,751,4,755,1544,3,1,3,0,1,0,48.90
高雄市,小港區,桂林里,801,2,775,6,781,1488,3,1,3,0,1,0,52.49
高雄市,小港區,中厝里,802,2,652,1,653,1220,3,1,3,0,1,0,53.52
高雄市,小港區,中厝里,803,2,817,1,818,1578,3,1,3,0,1,0,51.84
高雄市,小港區,鳳鳴里,804,2,750,3,753,1141,3,1,3,0,1,0,65.99
高雄市,小港區,鳳鳴里,805,2,650,6,656,1093,3,1,3,0,1,0,60.02
高雄市,小港區,龍鳳里,806,2,622,3,625,993,3,1,3,0,1,0,62.94
高雄市,小港區,龍鳳里,807,2,673,8,681,1056,3,1,3,0,1,0,64.49
高雄市,小港區,鳳森里,808,2,954,7,961,1470,3,1,3,0,1,0,65.37
高雄市,小港區,鳳林里,809,2,601,2,603,990,3,1,3,0,1,0,60.91
高雄市,小港區,鳳林里,810,2,597,3,600,1012,3,1,3,0,1,0,59.29
高雄市,小港區,鳳興里,811,2,915,1,916,1557,3,1,3,0,1,0,58.83
高雄市,小港區,鳳源里,812,2,627,8,635,1021,3,1,3,0,1,0,62.19
高雄市,小港區,鳳源里,813,2,671,5,676,1230,3,1,3,0,1,0,54.96
高雄市,小港區,海澄里,814,2,738,5,743,1445,3,1,3,0,1,0,51.42
高雄市,小港區,海澄里,815,2,669,3,672,1339,3,1,3,0,1,0,50.19
高雄市,小港區,海澄里,816,2,746,6,752,1671,3,1,3,0,1,0,45.00
高雄市,小港區,海昌里,817,2,520,1,521,1138,3,1,3,0,1,0,45.78
高雄市,小港區,海昌里,818,2,562,3,565,1149,3,1,3,0,1,0,49.17
高雄市,小港區,海豐里,819,2,644,4,648,1334,3,1,3,0,1,0,48.58
高雄市,小港區,海豐里,820,2,517,0,517,1023,3,1,3,0,1,0,50.54
高雄市,小港區,海原里,821,2,597,6,603,1299,3,1,3,0,1,0,46.42
高雄市,小港區,海原里,822,2,664,4,668,1414,3,1,3,0,1,0,47.24
高雄市,小港區,海城里,823,2,639,2,641,1390,3,1,3,0,1,0,46.12
高雄市,小港區,海城里,824,2,601,6,607,1374,3,1,3,0,1,0,44.18
臺北縣,板橋市,留侯里,1,1,682,1,683,1183,3,1,3,0,1,0,57.73
臺北縣,板橋市,流芳里,2,1,684,6,690,1223,3,1,3,0,1,0,56.42
臺北縣,板橋市,赤松里,3,1,390,1,391,656,3,1,3,0,1,0,59.60
臺北縣,板橋市,黃石里,4,1,597,6,603,1028,3,1,3,0,1,0,58.66
臺北縣,板橋市,挹秀里,5,1,473,2,475,792,3,1,3,0,1,0,59.97
臺北縣,板橋市,挹秀里,6,1,373,4,377,653,3,1,3,0,1,0,57.73
臺北縣,板橋市,湳興里,7,1,530,7,537,939,3,1,3,0,1,0,57.19
臺北縣,板橋市,湳興里,8,1,479,2,481,909,3,1,3,0,1,0,52.92
臺北縣,板橋市,湳興里,9,1,438,9,447,770,3,1,3,0,1,0,58.05
臺北縣,板橋市,湳興里,10,1,669,9,678,1108,3,1,3,0,1,0,61.19
臺北縣,板橋市,新興里,11,1,644,13,657,1202,3,1,3,0,1,0,54.66
臺北縣,板橋市,新興里,12,1,704,3,707,1346,3,1,3,0,1,0,52.53
臺北縣,板橋市,社後里,13,1,699,4,703,1882,3,1,3,0,1,0,37.35
臺北縣,板橋市,社後里,14,1,848,6,854,1495,3,1,3,0,1,0,57.12
臺北縣,板橋市,社後里,15,1,627,4,631,1033,3,1,3,0,1,0,61.08
臺北縣,板橋市,社後里,16,1,616,1,617,1139,3,1,3,0,1,0,54.17
臺北縣,板橋市,香社里,17,1,681,3,684,1243,3,1,3,0,1,0,55.03
臺北縣,板橋市,香社里,18,1,559,3,562,1057,3,1,3,0,1,0,53.17
臺北縣,板橋市,香社里,19,1,754,3,757,1255,3,1,3,0,1,0,60.32
臺北縣,板橋市,香雅里,20,1,595,3,598,1038,3,1,3,0,1,0,57.61
臺北縣,板橋市,香雅里,21,1,642,3,645,1166,3,1,3,0,1,0,55.32
臺北縣,板橋市,中正里,22,1,623,6,629,1142,3,1,3,0,1,0,55.08
臺北縣,板橋市,中正里,23,1,649,5,654,1166,3,1,3,0,1,0,56.09
臺北縣,板橋市,中正里,24,1,621,7,628,1212,3,1,3,0,1,0,51.82
臺北縣,板橋市,自強里,25,1,709,8,717,1130,3,1,3,0,1,0,63.45
臺北縣,板橋市,自強里,26,1,723,6,729,1193,3,1,3,0,1,0,61.11
臺北縣,板橋市,自強里,27,1,622,3,625,1096,3,1,3,0,1,0,57.03
臺北縣,板橋市,自強里,28,1,644,4,648,1046,3,1,3,0,1,0,61.95
臺北縣,板橋市,自立里,29,1,819,10,829,1293,3,1,3,0,1,0,64.11
臺北縣,板橋市,自立里,30,1,662,4,666,1091,3,1,3,0,1,0,61.04
臺北縣,板橋市,光華里,31,1,644,7,651,1171,3,1,3,0,1,0,55.59
臺北縣,板橋市,光華里,32,1,706,2,708,1105,3,1,3,0,1,0,64.07
臺北縣,板橋市,光榮里,33,1,631,5,636,1063,3,1,3,0,1,0,59.83
臺北縣,板橋市,光榮里,34,1,618,14,632,1102,3,1,3,0,1,0,57.35
臺北縣,板橋市,國光里,35,1,830,11,841,1234,3,1,3,0,1,0,68.15
臺北縣,板橋市,國光里,36,1,697,9,706,1015,3,1,3,0,1,0,69.56
臺北縣,板橋市,國光里,37,1,632,6,638,1020,3,1,3,0,1,0,62.55
臺北縣,板橋市,港尾里,38,1,730,4,734,1256,3,1,3,0,1,0,58.44
臺北縣,板橋市,港尾里,39,1,577,3,580,885,3,1,3,0,1,0,65.54
臺北縣,板橋市,新生里,40,1,640,6,646,1246,3,1,3,0,1,0,51.85
臺北縣,板橋市,新生里,41,1,776,7,783,1342,3,1,3,0,1,0,58.35
臺北縣,板橋市,新生里,42,1,627,3,630,1140,3,1,3,0,1,0,55.26
臺北縣,板橋市,金華里,43,1,592,8,600,1138,3,1,3,0,1,0,52.72
臺北縣,板橋市,金華里,44,1,595,4,599,1091,3,1,3,0,1,0,54.90
臺北縣,板橋市,金華里,45,1,655,4,659,1153,3,1,3,0,1,0,57.16
臺北縣,板橋市,港德里,46,1,561,7,568,1080,3,1,3,0,1,0,52.59
臺北縣,板橋市,港德里,47,1,558,8,566,1054,3,1,3,0,1,0,53.70
臺北縣,板橋市,港德里,48,1,483,6,489,860,3,1,3,0,1,0,56.86
臺北縣,板橋市,港德里,49,1,658,4,662,1162,3,1,3,0,1,0,56.97
臺北縣,板橋市,民權里,50,1,718,5,723,1171,3,1,3,0,1,0,61.74
臺北縣,板橋市,民權里,51,1,816,13,829,1296,3,1,3,0,1,0,63.97
臺北縣,板橋市,民安里,52,1,513,2,515,798,3,1,3,0,1,0,64.54
臺北縣,板橋市,民安里,53,1,607,6,613,970,3,1,3,0,1,0,63.2
臺北縣,板橋市,建國里,54,1,591,3,594,1042,3,1,3,0,1,0,57.01
臺北縣,板橋市,建國里,55,1,698,3,701,1121,3,1,3,0,1,0,62.53
臺北縣,板橋市,建國里,56,1,628,8,636,978,3,1,3,0,1,0,65.03
臺北縣,板橋市,漢生里,57,1,722,3,725,1168,3,1,3,0,1,0,62.07
臺北縣,板橋市,漢生里,58,1,771,4,775,1272,3,1,3,0,1,0,60.93
臺北縣,板橋市,漢生里,59,1,773,3,776,1285,3,1,3,0,1,0,60.39
臺北縣,板橋市,新民里,60,1,626,0,626,1160,3,1,3,0,1,0,53.97
臺北縣,板橋市,新民里,61,1,673,3,676,1103,3,1,3,0,1,0,61.29
臺北縣,板橋市,新民里,62,1,729,5,734,1330,3,1,3,0,1,0,55.19
臺北縣,板橋市,公館里,63,1,659,2,661,1201,3,1,3,0,1,0,55.04
臺北縣,板橋市,公館里,64,1,610,9,619,1031,3,1,3,0,1,0,60.04
臺北縣,板橋市,公館里,65,1,525,7,532,964,3,1,3,0,1,0,55.19
臺北縣,板橋市,幸福里,66,1,635,2,637,1167,3,1,3,0,1,0,54.58
臺北縣,板橋市,幸福里,67,1,649,3,652,1156,3,1,3,0,1,0,56.40
臺北縣,板橋市,幸福里,68,1,545,2,547,1036,3,1,3,0,1,0,52.80
臺北縣,板橋市,文德里,69,1,733,4,737,1334,3,1,3,0,1,0,55.25
臺北縣,板橋市,文德里,70,1,683,2,685,1205,3,1,3,0,1,0,56.85
臺北縣,板橋市,忠誠里,71,1,799,3,802,1289,3,1,3,0,1,0,62.22
臺北縣,板橋市,忠誠里,72,1,677,2,679,1052,3,1,3,0,1,0,64.54
臺北縣,板橋市,陽明里,73,1,715,3,718,1225,3,1,3,0,1,0,58.61
臺北縣,板橋市,陽明里,74,1,680,3,683,1193,3,1,3,0,1,0,57.25
臺北縣,板橋市,百壽里,75,1,688,5,693,1172,3,1,3,0,1,0,59.13
臺北縣,板橋市,百壽里,76,1,514,5,519,921,3,1,3,0,1,0,56.35
臺北縣,板橋市,介壽里,77,1,686,2,688,1243,3,1,3,0,1,0,55.35
臺北縣,板橋市,介壽里,78,1,717,6,723,1289,3,1,3,0,1,0,56.09
臺北縣,板橋市,新埔里,79,1,486,7,493,903,3,1,3,0,1,0,54.60
臺北縣,板橋市,新埔里,80,1,634,2,636,1114,3,1,3,0,1,0,57.09
臺北縣,板橋市,華江里,81,1,772,7,779,1406,3,1,3,0,1,0,55.41
臺北縣,板橋市,華江里,82,1,730,8,738,1317,3,1,3,0,1,0,56.04
臺北縣,板橋市,華江里,83,1,771,8,779,1425,3,1,3,0,1,0,54.67
臺北縣,板橋市,江翠里,84,1,777,9,786,1436,3,1,3,0,1,0,54.74
臺北縣,板橋市,江翠里,85,1,717,4,721,1290,3,1,3,0,1,0,55.89
臺北縣,板橋市,江翠里,86,1,673,4,677,1279,3,1,3,0,1,0,52.93
臺北縣,板橋市,純翠里,87,1,850,3,853,1487,3,1,3,0,1,0,57.36
臺北縣,板橋市,純翠里,88,1,695,2,697,1365,3,1,3,0,1,0,51.06
臺北縣,板橋市,純翠里,89,1,703,2,705,1350,3,1,3,0,1,0,52.22
臺北縣,板橋市,溪頭里,90,1,648,1,649,1227,3,1,3,0,1,0,52.89
臺北縣,板橋市,溪頭里,91,1,698,4,702,1409,3,1,3,0,1,0,49.82
臺北縣,板橋市,溪頭里,92,1,580,5,585,1075,3,1,3,0,1,0,54.42
臺北縣,板橋市,溪頭里,93,1,679,5,684,1187,3,1,3,0,1,0,57.62
臺北縣,板橋市,聯翠里,94,1,880,4,884,1677,3,1,3,0,1,0,52.71
臺北縣,板橋市,聯翠里,95,1,866,11,877,1577,3,1,3,0,1,0,55.61
臺北縣,板橋市,文化里,96,1,674,5,679,1215,3,1,3,0,1,0,55.88
臺北縣,板橋市,文化里,97,1,810,4,814,1422,3,1,3,0,1,0,57.24
臺北縣,板橋市,宏翠里,98,1,688,2,690,1212,3,1,3,0,1,0,56.93
臺北縣,板橋市,宏翠里,99,1,779,12,791,1426,3,1,3,0,1,0,55.47
臺北縣,板橋市,仁翠里,100,1,796,11,807,1440,3,1,3,0,1,0,56.04
臺北縣,板橋市,仁翠里,101,1,742,4,746,1304,3,1,3,0,1,0,57.21
臺北縣,板橋市,新翠里,102,1,815,9,824,1555,3,1,3,0,1,0,52.99
臺北縣,板橋市,新翠里,103,1,862,10,872,1567,3,1,3,0,1,0,55.65
臺北縣,板橋市,新翠里,104,1,767,4,771,1448,3,1,3,0,1,0,53.25
臺北縣,板橋市,新翠里,105,1,865,5,870,1618,3,1,3,0,1,0,53.77
臺北縣,板橋市,朝陽里,106,1,550,4,554,1017,3,1,3,0,1,0,54.47
臺北縣,板橋市,朝陽里,107,1,456,2,458,830,3,1,3,0,1,0,55.18
臺北縣,板橋市,朝陽里,108,1,578,4,582,1051,3,1,3,0,1,0,55.38
臺北縣,板橋市,吉翠里,109,1,612,5,617,1024,3,1,3,0,1,0,60.25
臺北縣,板橋市,吉翠里,110,1,553,3,556,954,3,1,3,0,1,0,58.28
臺北縣,板橋市,吉翠里,111,1,572,4,576,1046,3,1,3,0,1,0,55.07
臺北縣,板橋市,德翠里,112,1,878,9,887,1584,3,1,3,0,1,0,56.00
臺北縣,板橋市,德翠里,113,1,722,3,725,1209,3,1,3,0,1,0,59.97
臺北縣,板橋市,德翠里,114,1,1127,9,1136,2078,3,1,3,0,1,0,54.67
臺北縣,板橋市,新海里,115,1,481,6,487,1031,3,1,3,0,1,0,47.24
臺北縣,板橋市,新海里,116,1,503,3,506,935,3,1,3,0,1,0,54.12
臺北縣,板橋市,新海里,117,1,496,4,500,947,3,1,3,0,1,0,52.8
臺北縣,板橋市,滿翠里,118,1,409,0,409,785,3,1,3,0,1,0,52.10
臺北縣,板橋市,滿翠里,119,1,487,1,488,897,3,1,3,0,1,0,54.40
臺北縣,板橋市,滿翠里,120,1,588,4,592,1010,3,1,3,0,1,0,58.61
臺北縣,板橋市,明翠里,121,1,427,2,429,805,3,1,3,0,1,0,53.29
臺北縣,板橋市,明翠里,122,1,573,9,582,1024,3,1,3,0,1,0,56.84
臺北縣,板橋市,明翠里,123,1,596,3,599,1104,3,1,3,0,1,0,54.26
臺北縣,板橋市,明翠里,124,1,675,9,684,1151,3,1,3,0,1,0,59.43
臺北縣,板橋市,松翠里,125,1,749,3,752,1455,3,1,3,0,1,0,51.68
臺北縣,板橋市,松翠里,126,1,803,7,810,1602,3,1,3,0,1,0,50.56
臺北縣,板橋市,柏翠里,127,1,844,5,849,1544,3,1,3,0,1,0,54.99
臺北縣,板橋市,柏翠里,128,1,800,5,805,1401,3,1,3,0,1,0,57.46
臺北縣,板橋市,龍翠里,129,1,658,2,660,1211,3,1,3,0,1,0,54.50
臺北縣,板橋市,龍翠里,130,1,651,3,654,1241,3,1,3,0,1,0,52.70
臺北縣,板橋市,龍翠里,131,1,702,4,706,1210,3,1,3,0,1,0,58.35
臺北縣,板橋市,松柏里,132,1,566,2,568,1053,3,1,3,0,1,0,53.94
臺北縣,板橋市,松柏里,133,1,452,4,456,786,3,1,3,0,1,0,58.02
臺北縣,板橋市,華翠里,134,1,696,5,701,1230,3,1,3,0,1,0,56.99
臺北縣,板橋市,華翠里,135,1,823,3,826,1436,3,1,3,0,1,0,57.52
臺北縣,板橋市,莒光里,136,1,744,4,748,1369,3,1,3,0,1,0,54.64
臺北縣,板橋市,莒光里,137,1,592,6,598,1148,3,1,3,0,1,0,52.09
臺北縣,板橋市,忠翠里,138,1,978,16,994,1676,3,1,3,0,1,0,59.31
臺北縣,板橋市,忠翠里,139,1,860,8,868,1451,3,1,3,0,1,0,59.82
臺北縣,板橋市,忠翠里,140,1,928,5,933,1657,3,1,3,0,1,0,56.31
臺北縣,板橋市,忠翠里,141,1,1199,7,1206,2146,3,1,3,0,1,0,56.20
臺北縣,板橋市,嵐翠里,142,1,623,4,627,1066,3,1,3,0,1,0,58.82
臺北縣,板橋市,嵐翠里,143,1,627,8,635,1095,3,1,3,0,1,0,57.99
臺北縣,板橋市,文聖里,144,1,905,12,917,1574,3,1,3,0,1,0,58.26
臺北縣,板橋市,文聖里,145,1,807,3,810,1427,3,1,3,0,1,0,56.76
臺北縣,板橋市,文聖里,146,1,723,3,726,1219,3,1,3,0,1,0,59.56
臺北縣,板橋市,文翠里,147,1,595,3,598,1060,3,1,3,0,1,0,56.42
臺北縣,板橋市,文翠里,148,1,708,5,713,1238,3,1,3,0,1,0,57.59
臺北縣,板橋市,青翠里,149,1,631,4,635,1252,3,1,3,0,1,0,50.72
臺北縣,板橋市,青翠里,150,1,651,4,655,1281,3,1,3,0,1,0,51.13
臺北縣,板橋市,懷翠里,151,1,1019,8,1027,1988,3,1,3,0,1,0,51.66
臺北縣,板橋市,懷翠里,152,1,694,6,700,1363,3,1,3,0,1,0,51.36
臺北縣,板橋市,懷翠里,153,1,744,6,750,1423,3,1,3,0,1,0,52.71
臺北縣,板橋市,福翠里,154,1,350,4,354,623,3,1,3,0,1,0,56.82
臺北縣,板橋市,福翠里,155,1,477,3,480,851,3,1,3,0,1,0,56.40
臺北縣,板橋市,港嘴里,156,1,756,18,774,1313,3,1,3,0,1,0,58.95
臺北縣,板橋市,港嘴里,157,1,720,5,725,1352,3,1,3,0,1,0,53.62
臺北縣,板橋市,港嘴里,158,1,550,6,556,952,3,1,3,0,1,0,58.40
臺北縣,板橋市,港嘴里,159,1,501,3,504,849,3,1,3,0,1,0,59.36
臺北縣,板橋市,振興里,160,1,771,10,781,1288,3,1,3,0,1,0,60.64
臺北縣,板橋市,振興里,161,1,789,6,795,1298,3,1,3,0,1,0,61.25
臺北縣,板橋市,振興里,162,1,566,8,574,910,3,1,3,0,1,0,63.08
臺北縣,板橋市,振義里,163,1,795,4,799,1424,3,1,3,0,1,0,56.11
臺北縣,板橋市,振義里,164,1,657,6,663,1130,3,1,3,0,1,0,58.67
臺北縣,板橋市,振義里,165,1,542,2,544,914,3,1,3,0,1,0,59.52
臺北縣,板橋市,光復里,166,1,773,10,783,1334,3,1,3,0,1,0,58.70
臺北縣,板橋市,光復里,167,1,629,8,637,1185,3,1,3,0,1,0,53.76
臺北縣,板橋市,埔墘里,168,1,866,8,874,1509,3,1,3,0,1,0,57.92
臺北縣,板橋市,埔墘里,169,1,795,0,795,1340,3,1,3,0,1,0,59.33
臺北縣,板橋市,埔墘里,170,1,760,6,766,1316,3,1,3,0,1,0,58.21
臺北縣,板橋市,富貴里,171,1,483,4,487,894,3,1,3,0,1,0,54.47
臺北縣,板橋市,富貴里,172,1,602,3,605,984,3,1,3,0,1,0,61.48
臺北縣,板橋市,長壽里,173,1,704,3,707,1241,3,1,3,0,1,0,56.97
臺北縣,板橋市,長壽里,174,1,655,5,660,1162,3,1,3,0,1,0,56.80
臺北縣,板橋市,福壽里,175,1,754,2,756,1282,3,1,3,0,1,0,58.97
臺北縣,板橋市,福壽里,176,1,716,9,725,1354,3,1,3,0,1,0,53.55
臺北縣,板橋市,居仁里,177,1,715,3,718,1260,3,1,3,0,1,0,56.98
臺北縣,板橋市,居仁里,178,1,626,1,627,1217,3,1,3,0,1,0,51.52
臺北縣,板橋市,海山里,179,1,842,5,847,1511,3,1,3,0,1,0,56.06
臺北縣,板橋市,海山里,180,1,758,7,765,1301,3,1,3,0,1,0,58.80
臺北縣,板橋市,海山里,181,1,713,6,719,1311,3,1,3,0,1,0,54.84
臺北縣,板橋市,海山里,182,1,719,5,724,1470,3,1,3,0,1,0,49.25
臺北縣,板橋市,九如里,183,1,709,6,715,1280,3,1,3,0,1,0,55.86
臺北縣,板橋市,九如里,184,1,570,8,578,1064,3,1,3,0,1,0,54.32
臺北縣,板橋市,正泰里,185,1,773,6,779,1356,3,1,3,0,1,0,57.45
臺北縣,板橋市,正泰里,186,1,700,4,704,1086,3,1,3,0,1,0,64.83
臺北縣,板橋市,玉光里,187,1,824,7,831,1656,3,1,3,0,1,0,50.18
臺北縣,板橋市,玉光里,188,1,671,5,676,1253,3,1,3,0,1,0,53.95
臺北縣,板橋市,玉光里,189,1,643,3,646,1135,3,1,3,0,1,0,56.92
臺北縣,板橋市,光仁里,190,1,750,6,756,1289,3,1,3,0,1,0,58.65
臺北縣,板橋市,光仁里,191,1,648,8,656,1120,3,1,3,0,1,0,58.57
臺北縣,板橋市,埤墘里,192,1,892,3,895,1647,3,1,3,0,1,0,54.34
臺北縣,板橋市,埤墘里,193,1,768,5,773,1381,3,1,3,0,1,0,55.97
臺北縣,板橋市,莊敬里,194,1,930,3,933,1617,3,1,3,0,1,0,57.7
臺北縣,板橋市,莊敬里,195,1,767,9,776,1278,3,1,3,0,1,0,60.72
臺北縣,板橋市,永安里,196,1,716,5,721,1318,3,1,3,0,1,0,54.70
臺北縣,板橋市,永安里,197,1,749,4,753,1357,3,1,3,0,1,0,55.49
臺北縣,板橋市,雙玉里,198,1,963,12,975,1658,3,1,3,0,1,0,58.81
臺北縣,板橋市,雙玉里,199,1,742,2,744,1336,3,1,3,0,1,0,55.69
臺北縣,板橋市,廣新里,200,1,424,6,430,858,3,1,3,0,1,0,50.12
臺北縣,板橋市,廣新里,201,1,541,8,549,996,3,1,3,0,1,0,55.12
臺北縣,板橋市,廣新里,202,1,608,5,613,1076,3,1,3,0,1,0,56.97
臺北縣,板橋市,深丘里,203,1,582,4,586,1028,3,1,3,0,1,0,57.00
臺北縣,板橋市,深丘里,204,1,846,6,852,1409,3,1,3,0,1,0,60.47
臺北縣,板橋市,深丘里,205,1,524,5,529,979,3,1,3,0,1,0,54.03
臺北縣,板橋市,深丘里,206,1,509,1,510,871,3,1,3,0,1,0,58.55
臺北縣,板橋市,香丘里,207,1,625,6,631,1041,3,1,3,0,1,0,60.61
臺北縣,板橋市,香丘里,208,1,488,3,491,880,3,1,3,0,1,0,55.80
臺北縣,板橋市,香丘里,209,1,624,3,627,1111,3,1,3,0,1,0,56.44
臺北縣,板橋市,西安里,210,1,674,8,682,1144,3,1,3,0,1,0,59.62
臺北縣,板橋市,西安里,211,1,622,3,625,1053,3,1,3,0,1,0,59.35
臺北縣,板橋市,東丘里,212,1,620,2,622,1099,3,1,3,0,1,0,56.60
臺北縣,板橋市,東丘里,213,1,666,6,672,1172,3,1,3,0,1,0,57.34
臺北縣,板橋市,東丘里,214,1,645,5,650,1147,3,1,3,0,1,0,56.67
臺北縣,板橋市,民生里,215,1,449,1,450,760,3,1,3,0,1,0,59.21
臺北縣,板橋市,民生里,216,1,473,3,476,839,3,1,3,0,1,0,56.73
臺北縣,板橋市,長安里,217,1,777,4,781,1332,3,1,3,0,1,0,58.63
臺北縣,板橋市,長安里,218,1,947,10,957,1663,3,1,3,0,1,0,57.55
臺北縣,板橋市,東安里,219,1,579,6,585,961,3,1,3,0,1,0,60.87
臺北縣,板橋市,東安里,220,1,643,5,648,1800,3,1,3,0,1,0,36
臺北縣,板橋市,福丘里,221,1,645,5,650,1055,3,1,3,0,1,0,61.61
臺北縣,板橋市,福丘里,222,1,357,3,360,573,3,1,3,0,1,0,62.83
臺北縣,板橋市,福祿里,223,1,837,6,843,1620,3,1,3,0,1,0,52.04
臺北縣,板橋市,福祿里,224,1,791,10,801,1385,3,1,3,0,1,0,57.83
臺北縣,板橋市,民族里,225,1,645,2,647,1106,3,1,3,0,1,0,58.50
臺北縣,板橋市,民族里,226,1,610,5,615,1045,3,1,3,0,1,0,58.85
臺北縣,板橋市,民族里,227,1,512,2,514,891,3,1,3,0,1,0,57.69
臺北縣,板橋市,國泰里,228,1,677,2,679,1158,3,1,3,0,1,0,58.64
臺北縣,板橋市,國泰里,229,1,787,2,789,1370,3,1,3,0,1,0,57.59
臺北縣,板橋市,後埔里,230,1,832,9,841,1365,3,1,3,0,1,0,61.61
臺北縣,板橋市,後埔里,231,1,874,16,890,1523,3,1,3,0,1,0,58.44
臺北縣,板橋市,福德里,232,1,727,5,732,1227,3,1,3,0,1,0,59.66
臺北縣,板橋市,福德里,233,1,859,10,869,1358,3,1,3,0,1,0,63.99
臺北縣,板橋市,福德里,234,1,896,6,902,1569,3,1,3,0,1,0,57.49
臺北縣,板橋市,景星里,235,1,799,7,806,1367,3,1,3,0,1,0,58.96
臺北縣,板橋市,景星里,236,1,749,4,753,1341,3,1,3,0,1,0,56.15
臺北縣,板橋市,福星里,237,1,849,10,859,1437,3,1,3,0,1,0,59.78
臺北縣,板橋市,福星里,238,1,793,6,799,1320,3,1,3,0,1,0,60.53
臺北縣,板橋市,鄉雲里,239,1,956,11,967,1708,3,1,3,0,1,0,56.62
臺北縣,板橋市,鄉雲里,240,1,719,7,726,1204,3,1,3,0,1,0,60.30
臺北縣,板橋市,廣德里,241,1,621,5,626,1214,3,1,3,0,1,0,51.57
臺北縣,板橋市,廣德里,242,1,689,2,691,1179,3,1,3,0,1,0,58.61
臺北縣,板橋市,廣德里,243,1,794,10,804,1318,3,1,3,0,1,0,61.00
臺北縣,板橋市,廣德里,244,1,631,0,631,1090,3,1,3,0,1,0,57.89
臺北縣,板橋市,大豐里,245,1,832,8,840,1496,3,1,3,0,1,0,56.15
臺北縣,板橋市,大豐里,246,1,726,2,728,1180,3,1,3,0,1,0,61.69
臺北縣,板橋市,大豐里,247,1,662,8,670,1131,3,1,3,0,1,0,59.24
臺北縣,板橋市,重慶里,248,1,885,13,898,1634,3,1,3,0,1,0,54.96
臺北縣,板橋市,重慶里,249,1,771,12,783,1535,3,1,3,0,1,0,51.01
臺北縣,板橋市,重慶里,250,1,738,4,742,1451,3,1,3,0,1,0,51.14
臺北縣,板橋市,重慶里,251,1,954,6,960,1792,3,1,3,0,1,0,53.57
臺北縣,板橋市,仁愛里,252,1,603,4,607,904,3,1,3,0,1,0,67.15
臺北縣,板橋市,仁愛里,253,1,527,2,529,903,3,1,3,0,1,0,58.58
臺北縣,板橋市,仁愛里,254,1,523,7,530,900,3,1,3,0,1,0,58.89
臺北縣,板橋市,和平里,255,1,498,5,503,910,3,1,3,0,1,0,55.27
臺北縣,板橋市,廣福里,256,1,762,11,773,1337,3,1,3,0,1,0,57.82
臺北縣,板橋市,廣福里,257,1,685,2,687,1417,3,1,3,0,1,0,48.48
臺北縣,板橋市,五權里,258,1,627,2,629,1090,3,1,3,0,1,0,57.71
臺北縣,板橋市,五權里,259,1,689,6,695,1211,3,1,3,0,1,0,57.39
臺北縣,板橋市,五權里,260,1,677,8,685,1279,3,1,3,0,1,0,53.56
臺北縣,板橋市,華興里,261,1,907,4,911,1561,3,1,3,0,1,0,58.36
臺北縣,板橋市,華興里,262,1,962,12,974,1711,3,1,3,0,1,0,56.93
臺北縣,板橋市,華貴里,263,1,694,10,704,1149,3,1,3,0,1,0,61.27
臺北縣,板橋市,華貴里,264,1,752,11,763,1217,3,1,3,0,1,0,62.70
臺北縣,板橋市,華福里,265,1,611,4,615,983,3,1,3,0,1,0,62.56
臺北縣,板橋市,華福里,266,1,487,6,493,797,3,1,3,0,1,0,61.86
臺北縣,板橋市,華德里,267,1,679,10,689,1365,3,1,3,0,1,0,50.48
臺北縣,板橋市,華德里,268,1,763,9,772,1452,3,1,3,0,1,0,53.17
臺北縣,板橋市,華德里,269,1,643,2,645,1192,3,1,3,0,1,0,54.11
臺北縣,板橋市,華德里,270,1,633,4,637,1180,3,1,3,0,1,0,53.98
臺北縣,板橋市,華東里,271,1,845,7,852,1399,3,1,3,0,1,0,60.90
臺北縣,板橋市,華東里,272,1,966,7,973,1623,3,1,3,0,1,0,59.95
臺北縣,板橋市,華東里,273,1,877,5,882,1466,3,1,3,0,1,0,60.16
臺北縣,板橋市,信義里,274,1,591,5,596,1098,3,1,3,0,1,0,54.28
臺北縣,板橋市,信義里,275,1,657,5,662,1093,3,1,3,0,1,0,60.57
臺北縣,板橋市,信義里,276,1,688,9,697,1149,3,1,3,0,1,0,60.66
臺北縣,板橋市,浮洲里,277,1,672,4,676,1281,3,1,3,0,1,0,52.77
臺北縣,板橋市,浮洲里,278,1,552,4,556,1059,3,1,3,0,1,0,52.5
臺北縣,板橋市,浮洲里,279,1,505,3,508,1221,3,1,3,0,1,0,41.61
臺北縣,板橋市,華中里,280,1,662,7,669,1232,3,1,3,0,1,0,54.3
臺北縣,板橋市,華中里,281,1,833,4,837,1513,3,1,3,0,1,0,55.32
臺北縣,板橋市,華中里,282,1,809,6,815,1524,3,1,3,0,1,0,53.48
臺北縣,板橋市,僑中里,283,1,533,8,541,1012,3,1,3,0,1,0,53.46
臺北縣,板橋市,僑中里,284,1,444,2,446,937,3,1,3,0,1,0,47.6
臺北縣,板橋市,僑中里,285,1,623,2,625,1071,3,1,3,0,1,0,58.36
臺北縣,板橋市,大觀里,286,1,732,5,737,1285,3,1,3,0,1,0,57.35
臺北縣,板橋市,大觀里,287,1,784,10,794,1472,3,1,3,0,1,0,53.94
臺北縣,板橋市,歡園里,288,1,610,5,615,1013,3,1,3,0,1,0,60.71
臺北縣,板橋市,中山里,289,1,581,3,584,1048,3,1,3,0,1,0,55.73
臺北縣,板橋市,中山里,290,1,465,8,473,899,3,1,3,0,1,0,52.61
臺北縣,板橋市,中山里,291,1,631,4,635,1144,3,1,3,0,1,0,55.51
臺北縣,板橋市,中山里,292,1,498,7,505,816,3,1,3,0,1,0,61.89
臺北縣,板橋市,復興里,293,1,730,36,766,1186,3,1,3,0,1,0,64.59
臺北縣,板橋市,復興里,294,1,325,2,327,594,3,1,3,0,1,0,55.05
臺北縣,板橋市,大安里,295,1,628,5,633,1150,3,1,3,0,1,0,55.04
臺北縣,板橋市,大安里,296,1,744,2,746,1184,3,1,3,0,1,0,63.01
臺北縣,板橋市,大安里,297,1,623,6,629,1104,3,1,3,0,1,0,56.97
臺北縣,板橋市,福安里,298,1,752,14,766,1140,3,1,3,0,1,0,67.19
臺北縣,板橋市,福安里,299,1,602,8,610,1096,3,1,3,0,1,0,55.66
臺北縣,板橋市,聚安里,300,1,471,6,477,884,3,1,3,0,1,0,53.96
臺北縣,板橋市,聚安里,301,1,577,7,584,986,3,1,3,0,1,0,59.23
臺北縣,板橋市,聚安里,302,1,523,3,526,964,3,1,3,0,1,0,54.56
臺北縣,板橋市,聚安里,303,1,675,9,684,1246,3,1,3,0,1,0,54.9
臺北縣,板橋市,龍安里,304,1,679,4,683,1165,3,1,3,0,1,0,58.63
臺北縣,板橋市,龍安里,305,1,714,17,731,1206,3,1,3,0,1,0,60.61
臺北縣,板橋市,崑崙里,306,1,856,8,864,1558,3,1,3,0,1,0,55.46
臺北縣,板橋市,崑崙里,307,1,753,4,757,1426,3,1,3,0,1,0,53.09
臺北縣,板橋市,崑崙里,308,1,776,9,785,1564,3,1,3,0,1,0,50.19
臺北縣,板橋市,崑崙里,309,1,752,8,760,1522,3,1,3,0,1,0,49.93
臺北縣,板橋市,成和里,310,1,630,4,634,1266,3,1,3,0,1,0,50.08
臺北縣,板橋市,成和里,311,1,651,7,658,1256,3,1,3,0,1,0,52.39
臺北縣,板橋市,成和里,312,1,531,2,533,1126,3,1,3,0,1,0,47.34
臺北縣,板橋市,溪洲里,313,1,720,5,725,1297,3,1,3,0,1,0,55.9
臺北縣,板橋市,溪洲里,314,1,863,9,872,1686,3,1,3,0,1,0,51.72
臺北縣,板橋市,溪洲里,315,1,716,7,723,1414,3,1,3,0,1,0,51.13
臺北縣,板橋市,溪福里,316,1,768,7,775,1478,3,1,3,0,1,0,52.44
臺北縣,板橋市,溪福里,317,1,678,3,681,1385,3,1,3,0,1,0,49.17
臺北縣,板橋市,溪福里,318,1,622,4,626,1394,3,1,3,0,1,0,44.91
臺北縣,板橋市,溪福里,319,1,728,5,733,1453,3,1,3,0,1,0,50.45
臺北縣,板橋市,溪福里,320,1,650,7,657,1269,3,1,3,0,1,0,51.77
臺北縣,板橋市,溪福里,321,1,674,6,680,1349,3,1,3,0,1,0,50.41
臺北縣,板橋市,溪北里,322,1,721,6,727,1291,3,1,3,0,1,0,56.31
臺北縣,板橋市,溪北里,323,1,765,11,776,1345,3,1,3,0,1,0,57.7
臺北縣,板橋市,堂春里,324,1,730,10,740,1391,3,1,3,0,1,0,53.2
臺北縣,板橋市,堂春里,325,1,917,5,922,1594,3,1,3,0,1,0,57.84
臺北縣,土城市,祖田里,326,1,728,8,736,1235,3,1,3,0,1,0,59.6
臺北縣,土城市,頂新里,327,1,359,0,359,623,3,1,3,0,1,0,57.62
臺北縣,土城市,頂福里,328,1,658,2,660,1163,3,1,3,0,1,0,56.75
臺北縣,土城市,頂福里,329,1,564,4,568,1010,3,1,3,0,1,0,56.24
臺北縣,土城市,頂福里,330,1,812,9,821,1295,3,1,3,0,1,0,63.4
臺北縣,土城市,頂埔里,331,1,618,9,627,1135,3,1,3,0,1,0,55.24
臺北縣,土城市,頂埔里,332,1,727,6,733,1348,3,1,3,0,1,0,54.38
臺北縣,土城市,頂埔里,333,1,667,6,673,1193,3,1,3,0,1,0,56.41
臺北縣,土城市,沛陂里,334,1,877,7,884,1612,3,1,3,0,1,0,54.84
臺北縣,土城市,沛陂里,335,1,649,8,657,1259,3,1,3,0,1,0,52.18
臺北縣,土城市,永寧里,336,1,659,8,667,1359,3,1,3,0,1,0,49.08
臺北縣,土城市,永寧里,337,1,753,3,756,1431,3,1,3,0,1,0,52.83
臺北縣,土城市,永寧里,338,1,648,6,654,1247,3,1,3,0,1,0,52.45
臺北縣,土城市,永寧里,339,1,770,5,775,1395,3,1,3,0,1,0,55.56
臺北縣,土城市,大安里,340,1,369,4,373,636,3,1,3,0,1,0,58.65
臺北縣,土城市,大安里,341,1,890,5,895,1584,3,1,3,0,1,0,56.5
臺北縣,土城市,大安里,342,1,693,8,701,1398,3,1,3,0,1,0,50.14
臺北縣,土城市,員仁里,343,1,788,9,797,1515,3,1,3,0,1,0,52.61
臺北縣,土城市,員仁里,344,1,619,4,623,1158,3,1,3,0,1,0,53.8
臺北縣,土城市,員仁里,345,1,761,4,765,1501,3,1,3,0,1,0,50.97
臺北縣,土城市,埤塘里,346,1,858,5,863,2384,3,1,3,0,1,0,36.2
臺北縣,土城市,埤塘里,347,1,477,5,482,871,3,1,3,0,1,0,55.34
臺北縣,土城市,土城里,348,1,496,6,502,828,3,1,3,0,1,0,60.63
臺北縣,土城市,土城里,349,1,449,4,453,813,3,1,3,0,1,0,55.72
臺北縣,土城市,長風里,350,1,1078,7,1085,1565,3,1,3,0,1,0,69.33
臺北縣,土城市,員信里,351,1,909,8,917,1742,3,1,3,0,1,0,52.64
臺北縣,土城市,員信里,352,1,789,3,792,1464,3,1,3,0,1,0,54.1
臺北縣,土城市,員林里,353,1,721,6,727,1295,3,1,3,0,1,0,56.14
臺北縣,土城市,員林里,354,1,893,5,898,1586,3,1,3,0,1,0,56.62
臺北縣,土城市,員林里,355,1,791,9,800,1412,3,1,3,0,1,0,56.66
臺北縣,土城市,員福里,356,1,629,4,633,1072,3,1,3,0,1,0,59.05
臺北縣,土城市,員福里,357,1,848,6,854,1521,3,1,3,0,1,0,56.15
臺北縣,土城市,員福里,358,1,858,5,863,1553,3,1,3,0,1,0,55.57
臺北縣,土城市,日和里,359,1,716,7,723,1284,3,1,3,0,1,0,56.31
臺北縣,土城市,日和里,360,1,902,4,906,1587,3,1,3,0,1,0,57.09
臺北縣,土城市,日和里,361,1,679,3,682,1272,3,1,3,0,1,0,53.62
臺北縣,土城市,日新里,362,1,772,10,782,1407,3,1,3,0,1,0,55.58
臺北縣,土城市,日新里,363,1,632,3,635,1172,3,1,3,0,1,0,54.18
臺北縣,土城市,日新里,364,1,679,7,686,1162,3,1,3,0,1,0,59.04
臺北縣,土城市,裕生里,365,1,785,7,792,1408,3,1,3,0,1,0,56.25
臺北縣,土城市,裕生里,366,1,718,7,725,1467,3,1,3,0,1,0,49.42
臺北縣,土城市,裕生里,367,1,774,5,779,1556,3,1,3,0,1,0,50.06
臺北縣,土城市,貨饒里,368,1,881,13,894,1540,3,1,3,0,1,0,58.05
臺北縣,土城市,貨饒里,369,1,897,4,901,1613,3,1,3,0,1,0,55.86
臺北縣,土城市,瑞興里,370,1,757,5,762,1336,3,1,3,0,1,0,57.04
臺北縣,土城市,瑞興里,371,1,715,6,721,1267,3,1,3,0,1,0,56.91
臺北縣,土城市,復興里,372,1,640,8,648,1254,3,1,3,0,1,0,51.67
臺北縣,土城市,復興里,373,1,639,6,645,1193,3,1,3,0,1,0,54.07
臺北縣,土城市,復興里,374,1,643,2,645,1115,3,1,3,0,1,0,57.85
臺北縣,土城市,廣福里,375,1,829,7,836,1386,3,1,3,0,1,0,60.32
臺北縣,土城市,廣福里,376,1,734,5,739,1268,3,1,3,0,1,0,58.28
臺北縣,土城市,廣福里,377,1,792,10,802,1409,3,1,3,0,1,0,56.92
臺北縣,土城市,學成里,378,1,805,2,807,1380,3,1,3,0,1,0,58.48
臺北縣,土城市,學成里,379,1,670,6,676,1160,3,1,3,0,1,0,58.28
臺北縣,土城市,埤林里,380,1,785,6,791,1411,3,1,3,0,1,0,56.06
臺北縣,土城市,埤林里,381,1,622,6,628,1174,3,1,3,0,1,0,53.49
臺北縣,土城市,埤林里,382,1,691,3,694,1133,3,1,3,0,1,0,61.25
臺北縣,土城市,埤林里,383,1,741,2,743,1258,3,1,3,0,1,0,59.06
臺北縣,土城市,埤林里,384,1,615,2,617,972,3,1,3,0,1,0,63.48
臺北縣,土城市,廣興里,385,1,517,4,521,1039,3,1,3,0,1,0,50.14
臺北縣,土城市,廣興里,386,1,822,3,825,1464,3,1,3,0,1,0,56.35
臺北縣,土城市,樂利里,387,1,717,10,727,1359,3,1,3,0,1,0,53.5
臺北縣,土城市,樂利里,388,1,772,6,778,1460,3,1,3,0,1,0,53.29
臺北縣,土城市,樂利里,389,1,680,4,684,1300,3,1,3,0,1,0,52.62
臺北縣,土城市,學府里,390,1,837,5,842,1550,3,1,3,0,1,0,54.32
臺北縣,土城市,學府里,391,1,606,5,611,1164,3,1,3,0,1,0,52.49
臺北縣,土城市,明德里,392,1,575,3,578,1049,3,1,3,0,1,0,55.1
臺北縣,土城市,明德里,393,1,550,2,552,1106,3,1,3,0,1,0,49.91
臺北縣,土城市,明德里,394,1,651,3,654,1181,3,1,3,0,1,0,55.38
臺北縣,土城市,學士里,395,1,1003,7,1010,1751,3,1,3,0,1,0,57.68
臺北縣,土城市,學士里,396,1,891,7,898,1584,3,1,3,0,1,0,56.69
臺北縣,土城市,柑林里,397,1,1006,13,1019,1858,3,1,3,0,1,0,54.84
臺北縣,土城市,柑林里,398,1,302,1,303,525,3,1,3,0,1,0,57.71
臺北縣,土城市,中正里,399,1,609,4,613,1101,3,1,3,0,1,0,55.68
臺北縣,土城市,中正里,400,1,675,4,679,1141,3,1,3,0,1,0,59.51
臺北縣,土城市,青雲里,401,1,702,5,707,1264,3,1,3,0,1,0,55.93
臺北縣,土城市,青雲里,402,1,563,5,568,948,3,1,3,0,1,0,59.92
臺北縣,土城市,清和里,403,1,822,6,828,1479,3,1,3,0,1,0,55.98
臺北縣,土城市,清和里,404,1,865,8,873,1772,3,1,3,0,1,0,49.27
臺北縣,土城市,清和里,405,1,842,5,847,1587,3,1,3,0,1,0,53.37
臺北縣,土城市,清化里,406,1,739,11,750,1321,3,1,3,0,1,0,56.78
臺北縣,土城市,清溪里,407,1,635,4,639,1137,3,1,3,0,1,0,56.2
臺北縣,土城市,清溪里,408,1,628,6,634,1106,3,1,3,0,1,0,57.32
臺北縣,土城市,清溪里,409,1,808,5,813,1514,3,1,3,0,1,0,53.7
臺北縣,土城市,清溪里,410,1,805,4,809,1481,3,1,3,0,1,0,54.63
臺北縣,土城市,青山里,411,1,659,3,662,1179,3,1,3,0,1,0,56.15
臺北縣,土城市,青山里,412,1,669,4,673,1207,3,1,3,0,1,0,55.76
臺北縣,土城市,清水里,413,1,732,6,738,1347,3,1,3,0,1,0,54.79
臺北縣,土城市,清水里,414,1,763,3,766,1425,3,1,3,0,1,0,53.75
臺北縣,土城市,清水里,415,1,749,2,751,1386,3,1,3,0,1,0,54.18
臺北縣,土城市,清水里,416,1,776,9,785,1443,3,1,3,0,1,0,54.4
臺北縣,土城市,永豐里,417,1,691,8,699,1243,3,1,3,0,1,0,56.23
臺北縣,土城市,永豐里,418,1,593,10,603,1175,3,1,3,0,1,0,51.32
臺北縣,土城市,永富里,419,1,567,4,571,1176,3,1,3,0,1,0,48.55
臺北縣,土城市,永富里,420,1,713,8,721,1395,3,1,3,0,1,0,51.68
臺北縣,土城市,永富里,421,1,714,5,719,1411,3,1,3,0,1,0,50.96
臺北縣,土城市,廷寮里,422,1,638,5,643,1171,3,1,3,0,1,0,54.91
臺北縣,土城市,廷寮里,423,1,576,3,579,997,3,1,3,0,1,0,58.07
臺北縣,土城市,廷寮里,424,1,631,7,638,1208,3,1,3,0,1,0,52.81
臺北縣,土城市,金城里,425,1,778,2,780,1523,3,1,3,0,1,0,51.21
臺北縣,土城市,金城里,426,1,618,4,622,1119,3,1,3,0,1,0,55.59
臺北縣,土城市,金城里,427,1,833,4,837,1509,3,1,3,0,1,0,55.47
臺北縣,土城市,峰廷里,428,1,621,4,625,1157,3,1,3,0,1,0,54.02
臺北縣,土城市,峰廷里,429,1,713,8,721,1384,3,1,3,0,1,0,52.1
臺北縣,土城市,峰廷里,430,1,663,4,667,1373,3,1,3,0,1,0,48.58
臺北縣,土城市,峰廷里,431,1,800,2,802,1598,3,1,3,0,1,0,50.19
臺北縣,土城市,延吉里,432,1,783,3,786,1377,3,1,3,0,1,0,57.08
臺北縣,土城市,延吉里,433,1,590,5,595,1084,3,1,3,0,1,0,54.89
臺北縣,土城市,延吉里,434,1,495,2,497,1001,3,1,3,0,1,0,49.65
臺北縣,土城市,延壽里,435,1,511,2,513,1040,3,1,3,0,1,0,49.33
臺北縣,土城市,延壽里,436,1,806,6,812,1396,3,1,3,0,1,0,58.17
臺北縣,土城市,延壽里,437,1,516,3,519,992,3,1,3,0,1,0,52.32
臺北縣,土城市,延祿里,438,1,461,5,466,884,3,1,3,0,1,0,52.71
臺北縣,土城市,延祿里,439,1,617,3,620,1130,3,1,3,0,1,0,54.87
臺北縣,土城市,延祿里,440,1,657,5,662,1215,3,1,3,0,1,0,54.49
臺北縣,土城市,平和里,441,1,752,8,760,1332,3,1,3,0,1,0,57.06
臺北縣,土城市,平和里,442,1,780,7,787,1468,3,1,3,0,1,0,53.61
臺北縣,土城市,平和里,443,1,572,6,578,1063,3,1,3,0,1,0,54.37
臺北縣,土城市,平和里,444,1,694,5,699,1305,3,1,3,0,1,0,53.56
臺北縣,土城市,安和里,445,1,653,8,661,1232,3,1,3,0,1,0,53.65
臺北縣,土城市,安和里,446,1,646,6,652,1247,3,1,3,0,1,0,52.29
臺北縣,土城市,安和里,447,1,686,7,693,1300,3,1,3,0,1,0,53.31
臺北縣,土城市,延和里,448,1,716,5,721,1375,3,1,3,0,1,0,52.44
臺北縣,土城市,延和里,449,1,760,12,772,1525,3,1,3,0,1,0,50.62
臺北縣,土城市,延和里,450,1,797,5,802,1676,3,1,3,0,1,0,47.85
臺北縣,樹林市,三興里,451,1,549,12,561,1099,3,1,3,0,1,0,51.05
臺北縣,樹林市,三興里,452,1,572,4,576,1099,3,1,3,0,1,0,52.41
臺北縣,樹林市,三興里,453,1,660,7,667,1348,3,1,3,0,1,0,49.48
臺北縣,樹林市,三福里,454,1,588,7,595,1084,3,1,3,0,1,0,54.89
臺北縣,樹林市,三福里,455,1,618,4,622,1116,3,1,3,0,1,0,55.73
臺北縣,樹林市,三福里,456,1,565,5,570,1057,3,1,3,0,1,0,53.93
臺北縣,樹林市,三多里,457,1,718,6,724,1417,3,1,3,0,1,0,51.09
臺北縣,樹林市,三多里,458,1,858,12,870,1531,3,1,3,0,1,0,56.83
臺北縣,樹林市,三龍里,459,1,821,8,829,1496,3,1,3,0,1,0,55.41
臺北縣,樹林市,羌寮里,460,1,609,6,615,1141,3,1,3,0,1,0,53.9
臺北縣,樹林市,羌寮里,461,1,634,6,640,1267,3,1,3,0,1,0,50.51
臺北縣,樹林市,羌寮里,462,1,501,1,502,1086,3,1,3,0,1,0,46.22
臺北縣,樹林市,光興里,463,1,672,12,684,1379,3,1,3,0,1,0,49.6
臺北縣,樹林市,光興里,464,1,659,2,661,1378,3,1,3,0,1,0,47.97
臺北縣,樹林市,金寮里,465,1,871,9,880,1569,3,1,3,0,1,0,56.09
臺北縣,樹林市,金寮里,466,1,635,9,644,1378,3,1,3,0,1,0,46.73
臺北縣,樹林市,潭底里,467,1,571,1,572,1327,3,1,3,0,1,0,43.1
臺北縣,樹林市,潭底里,468,1,472,6,478,866,3,1,3,0,1,0,55.2
臺北縣,樹林市,潭底里,469,1,723,6,729,1361,3,1,3,0,1,0,53.56
臺北縣,樹林市,文林里,470,1,819,8,827,1504,3,1,3,0,1,0,54.99
臺北縣,樹林市,文林里,471,1,562,5,567,1164,3,1,3,0,1,0,48.71
臺北縣,樹林市,文林里,472,1,490,6,496,1057,3,1,3,0,1,0,46.93
臺北縣,樹林市,保安里,473,1,739,8,747,1361,3,1,3,0,1,0,54.89
臺北縣,樹林市,保安里,474,1,776,2,778,1327,3,1,3,0,1,0,58.63
臺北縣,樹林市,保安里,475,1,662,11,673,1159,3,1,3,0,1,0,58.07
臺北縣,樹林市,保安里,476,1,583,3,586,1063,3,1,3,0,1,0,55.13
臺北縣,樹林市,圳安里,477,1,561,4,565,1020,3,1,3,0,1,0,55.39
臺北縣,樹林市,圳安里,478,1,667,5,672,1515,3,1,3,0,1,0,44.36
臺北縣,樹林市,圳福里,479,1,545,5,550,1082,3,1,3,0,1,0,50.83
臺北縣,樹林市,圳福里,480,1,558,2,560,974,3,1,3,0,1,0,57.49
臺北縣,樹林市,圳福里,481,1,508,5,513,932,3,1,3,0,1,0,55.04
臺北縣,樹林市,圳民里,482,1,487,6,493,936,3,1,3,0,1,0,52.67
臺北縣,樹林市,圳民里,483,1,491,2,493,1007,3,1,3,0,1,0,48.96
臺北縣,樹林市,圳生里,484,1,720,4,724,1275,3,1,3,0,1,0,56.78
臺北縣,樹林市,樹德里,485,1,777,0,777,1421,3,1,3,0,1,0,54.68
臺北縣,樹林市,樹德里,486,1,923,7,930,1520,3,1,3,0,1,0,61.18
臺北縣,樹林市,樹福里,487,1,663,10,673,1130,3,1,3,0,1,0,59.56
臺北縣,樹林市,樹福里,488,1,432,2,434,762,3,1,3,0,1,0,56.96
臺北縣,樹林市,樹西里,489,1,613,3,616,1049,3,1,3,0,1,0,58.72
臺北縣,樹林市,樹西里,490,1,818,14,832,1435,3,1,3,0,1,0,57.98
臺北縣,樹林市,樹西里,491,1,943,8,951,1593,3,1,3,0,1,0,59.7
臺北縣,樹林市,樹興里,492,1,752,7,759,1460,3,1,3,0,1,0,51.99
臺北縣,樹林市,樹興里,493,1,770,6,776,1414,3,1,3,0,1,0,54.88
臺北縣,樹林市,樹人里,494,1,710,9,719,1248,3,1,3,0,1,0,57.61
臺北縣,樹林市,樹人里,495,1,734,7,741,1246,3,1,3,0,1,0,59.47
臺北縣,樹林市,育英里,496,1,645,2,647,1179,3,1,3,0,1,0,54.88
臺北縣,樹林市,育英里,497,1,728,3,731,1203,3,1,3,0,1,0,60.76
臺北縣,樹林市,樹南里,498,1,949,14,963,1665,3,1,3,0,1,0,57.84
臺北縣,樹林市,樹南里,499,1,879,6,885,1555,3,1,3,0,1,0,56.91
臺北縣,樹林市,坡內里,500,1,676,6,682,1285,3,1,3,0,1,0,53.07
臺北縣,樹林市,樹東里,501,1,645,6,651,1064,3,1,3,0,1,0,61.18
臺北縣,樹林市,樹北里,502,1,639,2,641,990,3,1,3,0,1,0,64.75
臺北縣,樹林市,彭福里,503,1,638,6,644,1310,3,1,3,0,1,0,49.16
臺北縣,樹林市,彭福里,504,1,576,8,584,1164,3,1,3,0,1,0,50.17
臺北縣,樹林市,彭福里,505,1,620,1,621,1205,3,1,3,0,1,0,51.54
臺北縣,樹林市,和平里,506,1,914,14,928,1615,3,1,3,0,1,0,57.46
臺北縣,樹林市,和平里,507,1,788,7,795,1492,3,1,3,0,1,0,53.28
臺北縣,樹林市,彭興里,508,1,663,1,664,1389,3,1,3,0,1,0,47.8
臺北縣,樹林市,彭興里,509,1,637,8,645,1381,3,1,3,0,1,0,46.71
臺北縣,樹林市,彭興里,510,1,673,5,678,1368,3,1,3,0,1,0,49.56
臺北縣,樹林市,彭厝里,511,1,621,2,623,1161,3,1,3,0,1,0,53.66
臺北縣,樹林市,彭厝里,512,1,641,6,647,1276,3,1,3,0,1,0,50.71
臺北縣,樹林市,彭厝里,513,1,523,3,526,1002,3,1,3,0,1,0,52.5
臺北縣,樹林市,大同里,514,1,755,5,760,1296,3,1,3,0,1,0,58.64
臺北縣,樹林市,大同里,515,1,505,6,511,1023,3,1,3,0,1,0,49.95
臺北縣,樹林市,中華里,516,1,612,5,617,1149,3,1,3,0,1,0,53.7
臺北縣,樹林市,中華里,517,1,493,4,497,1027,3,1,3,0,1,0,48.39
臺北縣,樹林市,太順里,518,1,469,2,471,993,3,1,3,0,1,0,47.43
臺北縣,樹林市,太順里,519,1,496,4,500,1041,3,1,3,0,1,0,48.03
臺北縣,樹林市,東昇里,520,1,532,5,537,954,3,1,3,0,1,0,56.29
臺北縣,樹林市,東昇里,521,1,625,3,628,1176,3,1,3,0,1,0,53.4
臺北縣,樹林市,東昇里,522,1,489,2,491,839,3,1,3,0,1,0,58.52
臺北縣,樹林市,東陽里,523,1,782,5,787,1472,3,1,3,0,1,0,53.46
臺北縣,樹林市,東陽里,524,1,728,7,735,1414,3,1,3,0,1,0,51.98
臺北縣,樹林市,東陽里,525,1,605,7,612,1205,3,1,3,0,1,0,50.79
臺北縣,樹林市,東山里,526,1,874,7,881,1534,3,1,3,0,1,0,57.43
臺北縣,樹林市,東山里,527,1,587,8,595,1086,3,1,3,0,1,0,54.79
臺北縣,樹林市,山佳里,528,1,506,5,511,982,3,1,3,0,1,0,52.04
臺北縣,樹林市,山佳里,529,1,605,5,610,1176,3,1,3,0,1,0,51.87
臺北縣,樹林市,山佳里,530,1,444,4,448,822,3,1,3,0,1,0,54.5
臺北縣,樹林市,中山里,531,1,795,4,799,1456,3,1,3,0,1,0,54.88
臺北縣,樹林市,中山里,532,1,811,13,824,1488,3,1,3,0,1,0,55.38
臺北縣,樹林市,樂山里,533,1,707,5,712,1335,3,1,3,0,1,0,53.33
臺北縣,樹林市,柑園里,534,1,752,12,764,1268,3,1,3,0,1,0,60.25
臺北縣,樹林市,西園里,535,1,707,7,714,1338,3,1,3,0,1,0,53.36
臺北縣,樹林市,南園里,536,1,414,4,418,647,3,1,3,0,1,0,64.61
臺北縣,樹林市,東園里,537,1,764,10,774,1328,3,1,3,0,1,0,58.28
臺北縣,樹林市,北園里,538,1,911,8,919,1591,3,1,3,0,1,0,57.76
臺北縣,鶯歌鎮,建德里,539,1,258,1,259,448,3,1,3,0,1,0,57.81
臺北縣,鶯歌鎮,東鶯里,540,1,529,5,534,892,3,1,3,0,1,0,59.87
臺北縣,鶯歌鎮,北鶯里,541,1,794,15,809,1439,3,1,3,0,1,0,56.22
臺北縣,鶯歌鎮,西鶯里,542,1,640,5,645,978,3,1,3,0,1,0,65.95
臺北縣,鶯歌鎮,西鶯里,543,1,485,11,496,848,3,1,3,0,1,0,58.49
臺北縣,鶯歌鎮,中鶯里,544,1,527,4,531,845,3,1,3,0,1,0,62.84
臺北縣,鶯歌鎮,南鶯里,545,1,872,3,875,1451,3,1,3,0,1,0,60.3
臺北縣,鶯歌鎮,南鶯里,546,1,778,3,781,1353,3,1,3,0,1,0,57.72
臺北縣,鶯歌鎮,南鶯里,547,1,754,5,759,1334,3,1,3,0,1,0,56.9
臺北縣,鶯歌鎮,建國里,548,1,812,9,821,1486,3,1,3,0,1,0,55.25
臺北縣,鶯歌鎮,建國里,549,1,763,5,768,1471,3,1,3,0,1,0,52.21
臺北縣,鶯歌鎮,建國里,550,1,678,3,681,1347,3,1,3,0,1,0,50.56
臺北縣,鶯歌鎮,二甲里,551,1,493,4,497,762,3,1,3,0,1,0,65.22
臺北縣,鶯歌鎮,二橋里,552,1,826,12,838,1782,3,1,3,0,1,0,47.03
臺北縣,鶯歌鎮,二橋里,553,1,930,10,940,1587,3,1,3,0,1,0,59.23
臺北縣,鶯歌鎮,二橋里,554,1,1020,12,1032,1692,3,1,3,0,1,0,60.99
臺北縣,鶯歌鎮,尖山里,555,1,753,5,758,1315,3,1,3,0,1,0,57.64
臺北縣,鶯歌鎮,尖山里,556,1,815,3,818,1471,3,1,3,0,1,0,55.61
臺北縣,鶯歌鎮,尖山里,557,1,811,10,821,1611,3,1,3,0,1,0,50.96
臺北縣,鶯歌鎮,南靖里,558,1,677,4,681,1132,3,1,3,0,1,0,60.16
臺北縣,鶯歌鎮,南靖里,559,1,489,2,491,805,3,1,3,0,1,0,60.99
臺北縣,鶯歌鎮,南靖里,560,1,398,6,404,715,3,1,3,0,1,0,56.5
臺北縣,鶯歌鎮,同慶里,561,1,807,4,811,1352,3,1,3,0,1,0,59.99
臺北縣,鶯歌鎮,永昌里,562,1,649,6,655,1324,3,1,3,0,1,0,49.47
臺北縣,鶯歌鎮,永昌里,563,1,775,7,782,1407,3,1,3,0,1,0,55.58
臺北縣,鶯歌鎮,永昌里,564,1,745,6,751,1405,3,1,3,0,1,0,53.45
臺北縣,鶯歌鎮,永昌里,565,1,688,4,692,1204,3,1,3,0,1,0,57.48
臺北縣,鶯歌鎮,永昌里,566,1,474,5,479,832,3,1,3,0,1,0,57.57
臺北縣,鶯歌鎮,永吉里,567,1,741,5,746,1366,3,1,3,0,1,0,54.61
臺北縣,鶯歌鎮,永吉里,568,1,723,3,726,1249,3,1,3,0,1,0,58.13
臺北縣,鶯歌鎮,永吉里,569,1,599,4,603,1055,3,1,3,0,1,0,57.16
臺北縣,鶯歌鎮,鳳祥里,570,1,726,14,740,1307,3,1,3,0,1,0,56.62
臺北縣,鶯歌鎮,鳳祥里,571,1,535,3,538,1132,3,1,3,0,1,0,47.53
臺北縣,鶯歌鎮,鳳祥里,572,1,496,4,500,1043,3,1,3,0,1,0,47.94
臺北縣,鶯歌鎮,鳳鳴里,573,1,593,9,602,1202,3,1,3,0,1,0,50.08
臺北縣,鶯歌鎮,鳳鳴里,574,1,687,15,702,1257,3,1,3,0,1,0,55.85
臺北縣,鶯歌鎮,鳳鳴里,575,1,658,4,662,1080,3,1,3,0,1,0,61.3
臺北縣,鶯歌鎮,鳳福里,576,1,657,6,663,1088,3,1,3,0,1,0,60.94
臺北縣,鶯歌鎮,鳳福里,577,1,562,5,567,1078,3,1,3,0,1,0,52.6
臺北縣,鶯歌鎮,鳳福里,578,1,700,4,704,1320,3,1,3,0,1,0,53.33
臺北縣,鶯歌鎮,大湖里,579,1,731,3,734,1316,3,1,3,0,1,0,55.78
臺北縣,鶯歌鎮,大湖里,580,1,899,5,904,1515,3,1,3,0,1,0,59.67
臺北縣,鶯歌鎮,大湖里,581,1,742,7,749,1232,3,1,3,0,1,0,60.8
臺北縣,鶯歌鎮,中湖里,582,1,809,7,816,1664,3,1,3,0,1,0,49.04
臺北縣,鶯歌鎮,中湖里,583,1,706,9,715,1262,3,1,3,0,1,0,56.66
臺北縣,鶯歌鎮,中湖里,584,1,823,8,831,1432,3,1,3,0,1,0,58.03
臺北縣,鶯歌鎮,東湖里,585,1,140,1,141,205,3,1,3,0,1,0,68.78
臺北縣,三峽鎮,三峽里,586,1,195,4,199,317,3,1,3,0,1,0,62.78
臺北縣,三峽鎮,秀川里,587,1,237,4,241,402,3,1,3,0,1,0,59.95
臺北縣,三峽鎮,八張里,588,1,737,6,743,1276,3,1,3,0,1,0,58.23
臺北縣,三峽鎮,八張里,589,1,706,6,712,1300,3,1,3,0,1,0,54.77
臺北縣,三峽鎮,中埔里,590,1,818,6,824,1478,3,1,3,0,1,0,55.75
臺北縣,三峽鎮,弘道里,591,1,495,7,502,926,3,1,3,0,1,0,54.21
臺北縣,三峽鎮,永館里,592,1,674,2,676,1254,3,1,3,0,1,0,53.91
臺北縣,三峽鎮,永館里,593,1,717,9,726,1233,3,1,3,0,1,0,58.88
臺北縣,三峽鎮,永館里,594,1,616,2,618,1126,3,1,3,0,1,0,54.88
臺北縣,三峽鎮,永館里,595,1,732,2,734,1410,3,1,3,0,1,0,52.06
臺北縣,三峽鎮,鳶山里,596,1,598,7,605,1099,3,1,3,0,1,0,55.05
臺北縣,三峽鎮,鳶山里,597,1,508,4,512,1037,3,1,3,0,1,0,49.37
臺北縣,三峽鎮,鳶山里,598,1,572,6,578,1049,3,1,3,0,1,0,55.1
臺北縣,三峽鎮,鳶山里,599,1,567,2,569,1149,3,1,3,0,1,0,49.52
臺北縣,三峽鎮,鳶山里,600,1,654,4,658,1398,3,1,3,0,1,0,47.07
臺北縣,三峽鎮,龍埔里,601,1,745,6,751,1372,3,1,3,0,1,0,54.74
臺北縣,三峽鎮,龍埔里,602,1,786,5,791,1425,3,1,3,0,1,0,55.51
臺北縣,三峽鎮,龍埔里,603,1,627,7,634,1218,3,1,3,0,1,0,52.05
臺北縣,三峽鎮,龍埔里,604,1,766,5,771,1444,3,1,3,0,1,0,53.39
臺北縣,三峽鎮,礁溪里,605,1,632,2,634,1086,3,1,3,0,1,0,58.38
臺北縣,三峽鎮,礁溪里,606,1,504,1,505,916,3,1,3,0,1,0,55.13
臺北縣,三峽鎮,礁溪里,607,1,567,2,569,1140,3,1,3,0,1,0,49.91
臺北縣,三峽鎮,安溪里,608,1,711,2,713,1284,3,1,3,0,1,0,55.53
臺北縣,三峽鎮,安溪里,609,1,691,4,695,1439,3,1,3,0,1,0,48.3
臺北縣,三峽鎮,安溪里,610,1,709,4,713,1297,3,1,3,0,1,0,54.97
臺北縣,三峽鎮,安溪里,611,1,607,1,608,1099,3,1,3,0,1,0,55.32
臺北縣,三峽鎮,介壽里,612,1,669,7,676,1353,3,1,3,0,1,0,49.96
臺北縣,三峽鎮,介壽里,613,1,651,2,653,1219,3,1,3,0,1,0,53.57
臺北縣,三峽鎮,介壽里,614,1,611,5,616,1250,3,1,3,0,1,0,49.28
臺北縣,三峽鎮,中正里,615,1,603,9,612,1214,3,1,3,0,1,0,50.41
臺北縣,三峽鎮,中正里,616,1,626,4,630,1160,3,1,3,0,1,0,54.31
臺北縣,三峽鎮,中正里,617,1,645,3,648,1136,3,1,3,0,1,0,57.04
臺北縣,三峽鎮,大埔里,618,1,656,7,663,1244,3,1,3,0,1,0,53.3
臺北縣,三峽鎮,大埔里,619,1,561,2,563,1008,3,1,3,0,1,0,55.85
臺北縣,三峽鎮,大埔里,620,1,587,4,591,933,3,1,3,0,1,0,63.34
臺北縣,三峽鎮,嘉添里,621,1,690,9,699,1176,3,1,3,0,1,0,59.44
臺北縣,三峽鎮,嘉添里,622,1,769,15,784,1335,3,1,3,0,1,0,58.73
臺北縣,三峽鎮,添福里,623,1,555,2,557,940,3,1,3,0,1,0,59.26
臺北縣,三峽鎮,金圳里,624,1,262,4,266,466,3,1,3,0,1,0,57.08
臺北縣,三峽鎮,五寮里,625,1,549,4,553,873,3,1,3,0,1,0,63.34
臺北縣,三峽鎮,插角里,626,1,445,3,448,796,3,1,3,0,1,0,56.28
臺北縣,三峽鎮,有木里,627,1,439,2,441,783,3,1,3,0,1,0,56.32
臺北縣,三峽鎮,二鬮里,628,1,579,6,585,1147,3,1,3,0,1,0,51
臺北縣,三峽鎮,二鬮里,629,1,659,3,662,1249,3,1,3,0,1,0,53
臺北縣,三峽鎮,溪南里,630,1,733,4,737,1246,3,1,3,0,1,0,59.15
臺北縣,三峽鎮,溪北里,631,1,354,1,355,614,3,1,3,0,1,0,57.82
臺北縣,三峽鎮,溪北里,632,1,774,3,777,1227,3,1,3,0,1,0,63.33
臺北縣,三峽鎮,溪東里,633,1,565,10,575,1036,3,1,3,0,1,0,55.5
臺北縣,三峽鎮,溪東里,634,1,661,8,669,1275,3,1,3,0,1,0,52.47
臺北縣,三峽鎮,成福里,635,1,544,4,548,842,3,1,3,0,1,0,65.08
臺北縣,三峽鎮,竹崙里,636,1,484,4,488,852,3,1,3,0,1,0,57.28
臺北縣,三峽鎮,竹崙里,637,1,483,8,491,880,3,1,3,0,1,0,55.8
臺北縣,三峽鎮,安坑里,638,1,691,10,701,1273,3,1,3,0,1,0,55.07
臺北縣,三重市,大有里,639,2,704,5,709,1261,3,1,3,0,1,0,56.23
臺北縣,三重市,大有里,640,2,606,6,612,1157,3,1,3,0,1,0,52.90
臺北縣,三重市,大有里,641,2,657,6,663,1154,3,1,3,0,1,0,57.45
臺北縣,三重市,博愛里,642,2,772,5,777,1270,3,1,3,0,1,0,61.18
臺北縣,三重市,博愛里,643,2,853,9,862,1358,3,1,3,0,1,0,63.48
臺北縣,三重市,博愛里,644,2,643,2,645,1034,3,1,3,0,1,0,62.38
臺北縣,三重市,二重里,645,2,482,1,483,903,3,1,3,0,1,0,53.49
臺北縣,三重市,二重里,646,2,440,0,440,819,3,1,3,0,1,0,53.72
臺北縣,三重市,頂崁里,647,2,530,7,537,919,3,1,3,0,1,0,58.43
臺北縣,三重市,頂崁里,648,2,506,6,512,853,3,1,3,0,1,0,60.02
臺北縣,三重市,谷王里,649,2,725,2,727,1098,3,1,3,0,1,0,66.21
臺北縣,三重市,五谷里,650,2,716,9,725,1161,3,1,3,0,1,0,62.45
臺北縣,三重市,五谷里,651,2,393,1,394,664,3,1,3,0,1,0,59.34
臺北縣,三重市,中興里,652,2,1001,16,1017,1641,3,1,3,0,1,0,61.97
臺北縣,三重市,中興里,653,2,855,9,864,1390,3,1,3,0,1,0,62.16
臺北縣,三重市,德厚里,654,2,234,6,240,376,3,1,3,0,1,0,63.83
臺北縣,三重市,成功里,655,2,635,3,638,1079,3,1,3,0,1,0,59.13
臺北縣,三重市,成功里,656,2,779,2,781,1422,3,1,3,0,1,0,54.92
臺北縣,三重市,成功里,657,2,1031,6,1037,1781,3,1,3,0,1,0,58.23
臺北縣,三重市,福祉里,658,2,892,11,903,1467,3,1,3,0,1,0,61.55
臺北縣,三重市,福祉里,659,2,1000,6,1006,1729,3,1,3,0,1,0,58.18
臺北縣,三重市,福德里,660,2,798,4,802,1429,3,1,3,0,1,0,56.12
臺北縣,三重市,福德里,661,2,892,8,900,1685,3,1,3,0,1,0,53.41
臺北縣,三重市,福民里,662,2,788,9,797,1319,3,1,3,0,1,0,60.42
臺北縣,三重市,福民里,663,2,776,10,786,1338,3,1,3,0,1,0,58.74
臺北縣,三重市,過田里,664,2,827,6,833,1978,3,1,3,0,1,0,42.11
臺北縣,三重市,過田里,665,2,932,5,937,1529,3,1,3,0,1,0,61.28
臺北縣,三重市,過田里,666,2,749,5,754,1426,3,1,3,0,1,0,52.88
臺北縣,三重市,錦田里,667,2,472,6,478,787,3,1,3,0,1,0,60.74
臺北縣,三重市,錦田里,668,2,553,4,557,956,3,1,3,0,1,0,58.26
臺北縣,三重市,重明里,669,2,834,3,837,1180,3,1,3,0,1,0,70.93
臺北縣,三重市,重明里,670,2,921,7,928,1387,3,1,3,0,1,0,66.91
臺北縣,三重市,光田里,671,2,599,5,604,1048,3,1,3,0,1,0,57.63
臺北縣,三重市,光田里,672,2,769,5,774,1293,3,1,3,0,1,0,59.86
臺北縣,三重市,光田里,673,2,727,2,729,1165,3,1,3,0,1,0,62.58
臺北縣,三重市,光陽里,674,2,960,3,963,1661,3,1,3,0,1,0,57.98
臺北縣,三重市,光陽里,675,2,1035,4,1039,1697,3,1,3,0,1,0,61.23
臺北縣,三重市,光陽里,676,2,1027,9,1036,1644,3,1,3,0,1,0,63.02
臺北縣,三重市,田心里,677,2,706,9,715,1197,3,1,3,0,1,0,59.73
臺北縣,三重市,田心里,678,2,693,4,697,1086,3,1,3,0,1,0,64.18
臺北縣,三重市,田心里,679,2,649,6,655,1090,3,1,3,0,1,0,60.09
臺北縣,三重市,福田里,680,2,791,8,799,1374,3,1,3,0,1,0,58.15
臺北縣,三重市,福田里,681,2,835,3,838,1436,3,1,3,0,1,0,58.36
臺北縣,三重市,田中里,682,2,913,5,918,1518,3,1,3,0,1,0,60.47
臺北縣,三重市,田中里,683,2,962,7,969,1562,3,1,3,0,1,0,62.04
臺北縣,三重市,田中里,684,2,919,6,925,1523,3,1,3,0,1,0,60.74
臺北縣,三重市,田安里,685,2,977,8,985,1644,3,1,3,0,1,0,59.91
臺北縣,三重市,田安里,686,2,973,6,979,1666,3,1,3,0,1,0,58.76
臺北縣,三重市,田安里,687,2,914,5,919,1591,3,1,3,0,1,0,57.76
臺北縣,三重市,三民里,688,2,866,3,869,1536,3,1,3,0,1,0,56.58
臺北縣,三重市,三民里,689,2,607,1,608,1043,3,1,3,0,1,0,58.29
臺北縣,三重市,光明里,690,2,713,4,717,1254,3,1,3,0,1,0,57.18
臺北縣,三重市,光明里,691,2,714,6,720,1314,3,1,3,0,1,0,54.79
臺北縣,三重市,光明里,692,2,640,1,641,1214,3,1,3,0,1,0,52.80
臺北縣,三重市,光明里,693,2,678,5,683,1278,3,1,3,0,1,0,53.44
臺北縣,三重市,光正里,694,2,848,10,858,1528,3,1,3,0,1,0,56.15
臺北縣,三重市,同安里,695,2,801,6,807,1481,3,1,3,0,1,0,54.49
臺北縣,三重市,同慶里,696,2,858,10,868,1437,3,1,3,0,1,0,60.40
臺北縣,三重市,菜寮里,697,2,583,6,589,1009,3,1,3,0,1,0,58.37
臺北縣,三重市,菜寮里,698,2,425,3,428,739,3,1,3,0,1,0,57.92
臺北縣,三重市,永春里,699,2,888,8,896,1489,3,1,3,0,1,0,60.17
臺北縣,三重市,中正里,700,2,741,11,752,1189,3,1,3,0,1,0,63.25
臺北縣,三重市,吉利里,701,2,723,13,736,1246,3,1,3,0,1,0,59.07
臺北縣,三重市,大同里,702,2,845,8,853,1557,3,1,3,0,1,0,54.78
臺北縣,三重市,中民里,703,2,700,10,710,1151,3,1,3,0,1,0,61.69
臺北縣,三重市,平和里,704,2,847,7,854,1431,3,1,3,0,1,0,59.68
臺北縣,三重市,大安里,705,2,833,8,841,1427,3,1,3,0,1,0,58.93
臺北縣,三重市,仁德里,706,2,464,8,472,795,3,1,3,0,1,0,59.37
臺北縣,三重市,仁德里,707,2,609,7,616,1065,3,1,3,0,1,0,57.84
臺北縣,三重市,忠孝里,708,2,943,10,953,1590,3,1,3,0,1,0,59.94
臺北縣,三重市,仁義里,709,2,670,6,676,1090,3,1,3,0,1,0,62.02
臺北縣,三重市,光榮里,710,2,657,7,664,1091,3,1,3,0,1,0,60.86
臺北縣,三重市,光輝里,711,2,1004,9,1013,1545,3,1,3,0,1,0,65.57
臺北縣,三重市,福星里,712,2,529,9,538,769,3,1,3,0,1,0,69.96
臺北縣,三重市,福利里,713,2,862,11,873,1596,3,1,3,0,1,0,54.70
臺北縣,三重市,清和里,714,2,1031,6,1037,1865,3,1,3,0,1,0,55.60
臺北縣,三重市,清和里,715,2,720,7,727,1220,3,1,3,0,1,0,59.59
臺北縣,三重市,永興里,716,2,667,9,676,1194,3,1,3,0,1,0,56.62
臺北縣,三重市,中山里,717,2,565,7,572,982,3,1,3,0,1,0,58.25
臺北縣,三重市,中山里,718,2,654,7,661,1108,3,1,3,0,1,0,59.66
臺北縣,三重市,大園里,719,2,584,4,588,994,3,1,3,0,1,0,59.15
臺北縣,三重市,大園里,720,2,615,6,621,1116,3,1,3,0,1,0,55.65
臺北縣,三重市,國隆里,721,2,632,4,636,1019,3,1,3,0,1,0,62.41
臺北縣,三重市,國隆里,722,2,690,8,698,1129,3,1,3,0,1,0,61.82
臺北縣,三重市,重陽里,723,2,887,5,892,1505,3,1,3,0,1,0,59.27
臺北縣,三重市,重陽里,724,2,795,5,800,1403,3,1,3,0,1,0,57.02
臺北縣,三重市,民生里,725,2,676,3,679,1202,3,1,3,0,1,0,56.49
臺北縣,三重市,民生里,726,2,771,6,777,1290,3,1,3,0,1,0,60.23
臺北縣,三重市,民生里,727,2,663,5,668,1161,3,1,3,0,1,0,57.54
臺北縣,三重市,重新里,728,2,824,8,832,1317,3,1,3,0,1,0,63.17
臺北縣,三重市,正德里,729,2,658,5,663,1019,3,1,3,0,1,0,65.06
臺北縣,三重市,正義里,730,2,899,5,904,1498,3,1,3,0,1,0,60.35
臺北縣,三重市,正安里,731,2,1019,13,1032,1676,3,1,3,0,1,0,61.58
臺北縣,三重市,自強里,732,2,967,8,975,1615,3,1,3,0,1,0,60.37
臺北縣,三重市,文化里,733,2,677,4,681,1089,3,1,3,0,1,0,62.53
臺北縣,三重市,文化里,734,2,618,4,622,1021,3,1,3,0,1,0,60.92
臺北縣,三重市,中央里,735,2,907,10,917,1513,3,1,3,0,1,0,60.61
臺北縣,三重市,雙園里,736,2,514,2,516,836,3,1,3,0,1,0,61.72
臺北縣,三重市,錦通里,737,2,890,10,900,1451,3,1,3,0,1,0,62.03
臺北縣,三重市,錦安里,738,2,548,3,551,909,3,1,3,0,1,0,60.62
臺北縣,三重市,錦安里,739,2,523,6,529,815,3,1,3,0,1,0,64.91
臺北縣,三重市,長安里,740,2,543,3,546,957,3,1,3,0,1,0,57.05
臺北縣,三重市,長安里,741,2,596,6,602,999,3,1,3,0,1,0,60.26
臺北縣,三重市,光華里,742,2,912,5,917,1671,3,1,3,0,1,0,54.88
臺北縣,三重市,長生里,743,2,404,1,405,752,3,1,3,0,1,0,53.86
臺北縣,三重市,開元里,744,2,852,15,867,1317,3,1,3,0,1,0,65.83
臺北縣,三重市,大德里,745,2,388,1,389,659,3,1,3,0,1,0,59.03
臺北縣,三重市,長元里,746,2,562,4,566,958,3,1,3,0,1,0,59.08
臺北縣,三重市,長元里,747,2,671,12,683,1160,3,1,3,0,1,0,58.88
臺北縣,三重市,長江里,748,2,980,8,988,1701,3,1,3,0,1,0,58.08
臺北縣,三重市,長泰里,749,2,633,1,634,1147,3,1,3,0,1,0,55.27
臺北縣,三重市,長泰里,750,2,500,3,503,912,3,1,3,0,1,0,55.15
臺北縣,三重市,長福里,751,2,838,6,844,1405,3,1,3,0,1,0,60.07
臺北縣,三重市,介壽里,752,2,615,28,643,1084,3,1,3,0,1,0,59.32
臺北縣,三重市,萬壽里,753,2,439,8,447,769,3,1,3,0,1,0,58.13
臺北縣,三重市,萬壽里,754,2,568,2,570,943,3,1,3,0,1,0,60.45
臺北縣,三重市,錦江里,755,2,541,6,547,1022,3,1,3,0,1,0,53.52
臺北縣,三重市,錦江里,756,2,555,3,558,1034,3,1,3,0,1,0,53.97
臺北縣,三重市,龍濱里,757,2,715,7,722,1184,3,1,3,0,1,0,60.98
臺北縣,三重市,龍濱里,758,2,815,10,825,1404,3,1,3,0,1,0,58.76
臺北縣,三重市,龍門里,759,2,920,8,928,1656,3,1,3,0,1,0,56.04
臺北縣,三重市,秀江里,760,2,710,8,718,1154,3,1,3,0,1,0,62.22
臺北縣,三重市,奕壽里,761,2,755,8,763,1303,3,1,3,0,1,0,58.56
臺北縣,三重市,三安里,762,2,587,4,591,1048,3,1,3,0,1,0,56.39
臺北縣,三重市,三安里,763,2,704,7,711,1202,3,1,3,0,1,0,59.15
臺北縣,三重市,福安里,764,2,713,7,720,1204,3,1,3,0,1,0,59.80
臺北縣,三重市,福安里,765,2,808,13,821,1367,3,1,3,0,1,0,60.06
臺北縣,三重市,信安里,766,2,926,15,941,1582,3,1,3,0,1,0,59.48
臺北縣,三重市,安慶里,767,2,512,3,515,861,3,1,3,0,1,0,59.81
臺北縣,三重市,安慶里,768,2,583,2,585,972,3,1,3,0,1,0,60.19
臺北縣,三重市,幸福里,769,2,751,7,758,1335,3,1,3,0,1,0,56.78
臺北縣,三重市,幸福里,770,2,702,6,708,1191,3,1,3,0,1,0,59.45
臺北縣,三重市,幸福里,771,2,729,6,735,1227,3,1,3,0,1,0,59.90
臺北縣,三重市,六合里,772,2,990,14,1004,1691,3,1,3,0,1,0,59.37
臺北縣,三重市,六合里,773,2,833,7,840,1452,3,1,3,0,1,0,57.85
臺北縣,三重市,六福里,774,2,721,4,725,1322,3,1,3,0,1,0,54.84
臺北縣,三重市,六福里,775,2,872,8,880,1501,3,1,3,0,1,0,58.63
臺北縣,三重市,六福里,776,2,758,12,770,1447,3,1,3,0,1,0,53.21
臺北縣,三重市,順德里,777,2,607,9,616,998,3,1,3,0,1,0,61.72
臺北縣,三重市,順德里,778,2,495,13,508,874,3,1,3,0,1,0,58.12
臺北縣,三重市,承德里,779,2,1011,14,1025,1633,3,1,3,0,1,0,62.77
臺北縣,三重市,瑞德里,780,2,582,4,586,962,3,1,3,0,1,0,60.91
臺北縣,三重市,瑞德里,781,2,687,8,695,1112,3,1,3,0,1,0,62.50
臺北縣,三重市,崇德里,782,2,678,5,683,1190,3,1,3,0,1,0,57.39
臺北縣,三重市,崇德里,783,2,469,6,475,810,3,1,3,0,1,0,58.64
臺北縣,三重市,崇德里,784,2,829,8,837,1391,3,1,3,0,1,0,60.17
臺北縣,三重市,厚德里,785,2,842,8,850,1299,3,1,3,0,1,0,65.43
臺北縣,三重市,厚德里,786,2,925,7,932,1539,3,1,3,0,1,0,60.56
臺北縣,三重市,維德里,787,2,845,9,854,1388,3,1,3,0,1,0,61.53
臺北縣,三重市,維德里,788,2,622,6,628,1035,3,1,3,0,1,0,60.68
臺北縣,三重市,尚德里,789,2,906,12,918,1609,3,1,3,0,1,0,57.05
臺北縣,三重市,尚德里,790,2,680,5,685,1126,3,1,3,0,1,0,60.83
臺北縣,三重市,培德里,791,2,898,9,907,1423,3,1,3,0,1,0,63.74
臺北縣,三重市,培德里,792,2,784,4,788,1382,3,1,3,0,1,0,57.02
臺北縣,三重市,立德里,793,2,858,5,863,1420,3,1,3,0,1,0,60.77
臺北縣,三重市,立德里,794,2,774,7,781,1325,3,1,3,0,1,0,58.94
臺北縣,三重市,永德里,795,2,939,7,946,1533,3,1,3,0,1,0,61.71
臺北縣,三重市,永德里,796,2,723,12,735,1157,3,1,3,0,1,0,63.53
臺北縣,三重市,永德里,797,2,791,11,802,1380,3,1,3,0,1,0,58.12
臺北縣,三重市,永輝里,798,2,739,6,745,1214,3,1,3,0,1,0,61.37
臺北縣,三重市,永輝里,799,2,543,2,545,964,3,1,3,0,1,0,56.54
臺北縣,三重市,永發里,800,2,652,3,655,1094,3,1,3,0,1,0,59.87
臺北縣,三重市,永發里,801,2,676,7,683,1168,3,1,3,0,1,0,58.48
臺北縣,三重市,永發里,802,2,815,7,822,1346,3,1,3,0,1,0,61.07
臺北縣,三重市,永盛里,803,2,796,11,807,1380,3,1,3,0,1,0,58.48
臺北縣,三重市,永盛里,804,2,822,7,829,1477,3,1,3,0,1,0,56.13
臺北縣,三重市,永吉里,805,2,672,4,676,1268,3,1,3,0,1,0,53.31
臺北縣,三重市,永吉里,806,2,611,6,617,1149,3,1,3,0,1,0,53.70
臺北縣,三重市,永安里,807,2,815,5,820,1456,3,1,3,0,1,0,56.32
臺北縣,三重市,永安里,808,2,671,3,674,1288,3,1,3,0,1,0,52.33
臺北縣,三重市,永豐里,809,2,761,8,769,1356,3,1,3,0,1,0,56.71
臺北縣,三重市,永豐里,810,2,567,6,573,1026,3,1,3,0,1,0,55.85
臺北縣,三重市,永豐里,811,2,862,9,871,1592,3,1,3,0,1,0,54.71
臺北縣,三重市,永福里,812,2,745,5,750,1335,3,1,3,0,1,0,56.18
臺北縣,三重市,永福里,813,2,623,6,629,1174,3,1,3,0,1,0,53.58
臺北縣,三重市,永福里,814,2,911,4,915,1624,3,1,3,0,1,0,56.34
臺北縣,三重市,永清里,815,2,818,6,824,1516,3,1,3,0,1,0,54.35
臺北縣,三重市,永清里,816,2,826,8,834,1553,3,1,3,0,1,0,53.70
臺北縣,三重市,永清里,817,2,743,7,750,1415,3,1,3,0,1,0,53.00
臺北縣,三重市,永順里,818,2,697,1,698,1358,3,1,3,0,1,0,51.40
臺北縣,三重市,永順里,819,2,715,6,721,1408,3,1,3,0,1,0,51.21
臺北縣,三重市,永順里,820,2,558,2,560,990,3,1,3,0,1,0,56.57
臺北縣,三重市,溪美里,821,2,936,6,942,1590,3,1,3,0,1,0,59.25
臺北縣,三重市,溪美里,822,2,650,4,654,1582,3,1,3,0,1,0,41.34
臺北縣,三重市,溪美里,823,2,902,5,907,1569,3,1,3,0,1,0,57.81
臺北縣,三重市,溪美里,824,2,660,8,668,1190,3,1,3,0,1,0,56.13
臺北縣,三重市,福隆里,825,2,800,4,804,1611,3,1,3,0,1,0,49.91
臺北縣,三重市,福隆里,826,2,760,6,766,1498,3,1,3,0,1,0,51.13
臺北縣,三重市,五常里,827,2,665,7,672,1060,3,1,3,0,1,0,63.40
臺北縣,三重市,五常里,828,2,640,5,645,1104,3,1,3,0,1,0,58.42
臺北縣,三重市,五常里,829,2,668,6,674,1161,3,1,3,0,1,0,58.05
臺北縣,三重市,五福里,830,2,602,5,607,1095,3,1,3,0,1,0,55.43
臺北縣,三重市,五福里,831,2,591,4,595,1173,3,1,3,0,1,0,50.72
臺北縣,三重市,仁忠里,832,2,760,8,768,1490,3,1,3,0,1,0,51.54
臺北縣,三重市,仁忠里,833,2,685,5,690,1177,3,1,3,0,1,0,58.62
臺北縣,三重市,慈福里,834,2,486,7,493,885,3,1,3,0,1,0,55.71
臺北縣,三重市,慈福里,835,2,639,8,647,1094,3,1,3,0,1,0,59.14
臺北縣,三重市,慈生里,836,2,521,5,526,866,3,1,3,0,1,0,60.74
臺北縣,三重市,慈生里,837,2,683,5,688,1141,3,1,3,0,1,0,60.30
臺北縣,三重市,慈惠里,838,2,638,6,644,1051,3,1,3,0,1,0,61.27
臺北縣,三重市,慈惠里,839,2,553,10,563,936,3,1,3,0,1,0,60.15
臺北縣,三重市,慈愛里,840,2,941,14,955,1590,3,1,3,0,1,0,60.06
臺北縣,三重市,慈愛里,841,2,905,14,919,1571,3,1,3,0,1,0,58.50
臺北縣,三重市,慈化里,842,2,561,13,574,1031,3,1,3,0,1,0,55.67
臺北縣,三重市,慈化里,843,2,565,6,571,1027,3,1,3,0,1,0,55.60
臺北縣,三重市,慈祐里,844,2,677,10,687,1206,3,1,3,0,1,0,56.97
臺北縣,三重市,慈祐里,845,2,647,4,651,1204,3,1,3,0,1,0,54.07
臺北縣,三重市,慈祐里,846,2,683,7,690,1257,3,1,3,0,1,0,54.89
臺北縣,三重市,富華里,847,2,591,5,596,1065,3,1,3,0,1,0,55.96
臺北縣,三重市,富華里,848,2,613,7,620,1163,3,1,3,0,1,0,53.31
臺北縣,三重市,富貴里,849,2,742,8,750,1436,3,1,3,0,1,0,52.23
臺北縣,三重市,富貴里,850,2,704,6,710,1232,3,1,3,0,1,0,57.63
臺北縣,三重市,富福里,851,2,398,6,404,739,3,1,3,0,1,0,54.67
臺北縣,三重市,富福里,852,2,568,7,575,1039,3,1,3,0,1,0,55.34
臺北縣,三重市,五華里,853,2,903,4,907,1580,3,1,3,0,1,0,57.41
臺北縣,三重市,五華里,854,2,766,5,771,1321,3,1,3,0,1,0,58.36
臺北縣,三重市,碧華里,855,2,612,4,616,1035,3,1,3,0,1,0,59.52
臺北縣,三重市,碧華里,856,2,616,8,624,1130,3,1,3,0,1,0,55.22
臺北縣,三重市,福樂里,857,2,909,5,914,1495,3,1,3,0,1,0,61.14
臺北縣,三重市,福樂里,858,2,882,7,889,1506,3,1,3,0,1,0,59.03
臺北縣,三重市,仁華里,859,2,973,8,981,1684,3,1,3,0,1,0,58.25
臺北縣,三重市,仁華里,860,2,827,9,836,1507,3,1,3,0,1,0,55.47
臺北縣,三重市,五順里,861,2,877,9,886,1543,3,1,3,0,1,0,57.42
臺北縣,三重市,五順里,862,2,815,10,825,1542,3,1,3,0,1,0,53.50
臺北縣,蘆洲市,光華里,863,2,816,9,825,1386,3,1,3,0,1,0,59.52
臺北縣,蘆洲市,光華里,864,2,719,2,721,1368,3,1,3,0,1,0,52.7
臺北縣,蘆洲市,光華里,865,2,631,6,637,1145,3,1,3,0,1,0,55.63
臺北縣,蘆洲市,光明里,866,2,775,8,783,1470,3,1,3,0,1,0,53.27
臺北縣,蘆洲市,光明里,867,2,993,4,997,1870,3,1,3,0,1,0,53.32
臺北縣,蘆洲市,中路里,868,2,737,4,741,1259,3,1,3,0,1,0,58.86
臺北縣,蘆洲市,中路里,869,2,813,10,823,1429,3,1,3,0,1,0,57.59
臺北縣,蘆洲市,永安里,870,2,922,11,933,1732,3,1,3,0,1,0,53.87
臺北縣,蘆洲市,永安里,871,2,919,10,929,1536,3,1,3,0,1,0,60.48
臺北縣,蘆洲市,九芎里,872,2,748,6,754,1337,3,1,3,0,1,0,56.39
臺北縣,蘆洲市,九芎里,873,2,552,4,556,1005,3,1,3,0,1,0,55.32
臺北縣,蘆洲市,九芎里,874,2,746,7,753,1337,3,1,3,0,1,0,56.32
臺北縣,蘆洲市,延平里,875,2,808,9,817,1510,3,1,3,0,1,0,54.11
臺北縣,蘆洲市,延平里,876,2,755,3,758,1312,3,1,3,0,1,0,57.77
臺北縣,蘆洲市,中華里,877,2,771,5,776,1356,3,1,3,0,1,0,57.23
臺北縣,蘆洲市,中華里,878,2,647,1,648,1090,3,1,3,0,1,0,59.45
臺北縣,蘆洲市,中原里,879,2,750,9,759,1431,3,1,3,0,1,0,53.04
臺北縣,蘆洲市,中原里,880,2,927,6,933,1732,3,1,3,0,1,0,53.87
臺北縣,蘆洲市,長安里,881,2,884,2,886,1768,3,1,3,0,1,0,50.11
臺北縣,蘆洲市,長安里,882,2,884,7,891,1813,3,1,3,0,1,0,49.15
臺北縣,蘆洲市,忠義里,883,2,952,16,968,1766,3,1,3,0,1,0,54.81
臺北縣,蘆洲市,正義里,884,2,595,5,600,1151,3,1,3,0,1,0,52.13
臺北縣,蘆洲市,南港里,885,2,800,4,804,1616,3,1,3,0,1,0,49.75
臺北縣,蘆洲市,南港里,886,2,652,6,658,1197,3,1,3,0,1,0,54.97
臺北縣,蘆洲市,南港里,887,2,695,5,700,1323,3,1,3,0,1,0,52.91
臺北縣,蘆洲市,永樂里,888,2,720,7,727,1451,3,1,3,0,1,0,50.1
臺北縣,蘆洲市,永樂里,889,2,697,6,703,1385,3,1,3,0,1,0,50.76
臺北縣,蘆洲市,永樂里,890,2,789,5,794,1532,3,1,3,0,1,0,51.83
臺北縣,蘆洲市,成功里,891,2,729,3,732,1491,3,1,3,0,1,0,49.09
臺北縣,蘆洲市,成功里,892,2,756,8,764,1487,3,1,3,0,1,0,51.38
臺北縣,蘆洲市,成功里,893,2,830,4,834,1596,3,1,3,0,1,0,52.26
臺北縣,蘆洲市,永康里,894,2,648,17,665,1228,3,1,3,0,1,0,54.15
臺北縣,蘆洲市,永康里,895,2,636,4,640,1234,3,1,3,0,1,0,51.86
臺北縣,蘆洲市,永康里,896,2,844,10,854,1841,3,1,3,0,1,0,46.39
臺北縣,蘆洲市,永德里,897,2,703,4,707,1469,3,1,3,0,1,0,48.13
臺北縣,蘆洲市,永德里,898,2,796,4,800,1574,3,1,3,0,1,0,50.83
臺北縣,蘆洲市,樓厝里,899,2,923,5,928,1695,3,1,3,0,1,0,54.75
臺北縣,蘆洲市,樓厝里,900,2,715,6,721,1371,3,1,3,0,1,0,52.59
臺北縣,蘆洲市,樓厝里,901,2,648,4,652,1147,3,1,3,0,1,0,56.84
臺北縣,蘆洲市,信義里,902,2,900,6,906,1553,3,1,3,0,1,0,58.34
臺北縣,蘆洲市,信義里,903,2,881,7,888,1551,3,1,3,0,1,0,57.25
臺北縣,蘆洲市,玉清里,904,2,963,21,984,1869,3,1,3,0,1,0,52.65
臺北縣,蘆洲市,玉清里,905,2,1019,8,1027,1856,3,1,3,0,1,0,55.33
臺北縣,蘆洲市,復興里,906,2,796,7,803,1288,3,1,3,0,1,0,62.34
臺北縣,蘆洲市,復興里,907,2,795,9,804,1429,3,1,3,0,1,0,56.26
臺北縣,蘆洲市,福安里,908,2,618,7,625,1162,3,1,3,0,1,0,53.79
臺北縣,蘆洲市,福安里,909,2,651,11,662,1151,3,1,3,0,1,0,57.52
臺北縣,蘆洲市,鷺江里,910,2,901,9,910,1695,3,1,3,0,1,0,53.69
臺北縣,蘆洲市,鷺江里,911,2,634,4,638,1180,3,1,3,0,1,0,54.07
臺北縣,蘆洲市,鷺江里,912,2,643,2,645,1184,3,1,3,0,1,0,54.48
臺北縣,蘆洲市,恆德里,913,2,881,6,887,1722,3,1,3,0,1,0,51.51
臺北縣,蘆洲市,恆德里,914,2,798,3,801,1485,3,1,3,0,1,0,53.94
臺北縣,蘆洲市,恆德里,915,2,762,3,765,1494,3,1,3,0,1,0,51.2
臺北縣,蘆洲市,溪墘里,916,2,635,8,643,1170,3,1,3,0,1,0,54.96
臺北縣,蘆洲市,溪墘里,917,2,836,8,844,1445,3,1,3,0,1,0,58.41
臺北縣,蘆洲市,仁復里,918,2,976,7,983,1728,3,1,3,0,1,0,56.89
臺北縣,蘆洲市,仁德里,919,2,679,2,681,1315,3,1,3,0,1,0,51.79
臺北縣,蘆洲市,仁德里,920,2,772,1,773,1319,3,1,3,0,1,0,58.61
臺北縣,蘆洲市,仁德里,921,2,687,1,688,1362,3,1,3,0,1,0,50.51
臺北縣,蘆洲市,仁義里,922,2,578,4,582,1626,3,1,3,0,1,0,35.79
臺北縣,蘆洲市,仁義里,923,2,600,11,611,1142,3,1,3,0,1,0,53.5
臺北縣,蘆洲市,得勝里,924,2,801,1,802,1234,3,1,3,0,1,0,64.99
臺北縣,蘆洲市,得勝里,925,2,876,11,887,1532,3,1,3,0,1,0,57.9
臺北縣,蘆洲市,得仁里,926,2,626,4,630,1086,3,1,3,0,1,0,58.01
臺北縣,蘆洲市,得仁里,927,2,625,7,632,1113,3,1,3,0,1,0,56.78
臺北縣,蘆洲市,保和里,928,2,567,3,570,989,3,1,3,0,1,0,57.63
臺北縣,蘆洲市,保和里,929,2,622,9,631,1081,3,1,3,0,1,0,58.37
臺北縣,蘆洲市,樹德里,930,2,753,4,757,1341,3,1,3,0,1,0,56.45
臺北縣,蘆洲市,樹德里,931,2,687,3,690,1261,3,1,3,0,1,0,54.72
臺北縣,蘆洲市,民和里,932,2,741,13,754,1294,3,1,3,0,1,0,58.27
臺北縣,蘆洲市,民和里,933,2,661,8,669,1063,3,1,3,0,1,0,62.94
臺北縣,蘆洲市,水湳里,934,2,835,4,839,1590,3,1,3,0,1,0,52.77
臺北縣,蘆洲市,水湳里,935,2,645,5,650,1308,3,1,3,0,1,0,49.69
臺北縣,蘆洲市,水湳里,936,2,1066,3,1069,1933,3,1,3,0,1,0,55.3
臺北縣,蘆洲市,水湳里,937,2,822,4,826,1606,3,1,3,0,1,0,51.43
臺北縣,蘆洲市,水河里,938,2,853,3,856,1605,3,1,3,0,1,0,53.33
臺北縣,蘆洲市,水河里,939,2,879,7,886,1729,3,1,3,0,1,0,51.24
臺北縣,蘆洲市,水河里,940,2,635,2,637,1287,3,1,3,0,1,0,49.49
臺北縣,蘆洲市,水河里,941,2,833,10,843,1639,3,1,3,0,1,0,51.43
臺北縣,蘆洲市,仁愛里,942,2,805,8,813,1498,3,1,3,0,1,0,54.27
臺北縣,蘆洲市,仁愛里,943,2,617,5,622,1243,3,1,3,0,1,0,50.04
臺北縣,蘆洲市,仁愛里,944,2,599,5,604,1165,3,1,3,0,1,0,51.85
臺北縣,蘆洲市,忠孝里,945,2,475,3,478,922,3,1,3,0,1,0,51.84
臺北縣,蘆洲市,忠孝里,946,2,434,7,441,818,3,1,3,0,1,0,53.91
臺北縣,蘆洲市,保佑里,947,2,889,4,893,1672,3,1,3,0,1,0,53.41
臺北縣,蘆洲市,保佑里,948,2,687,6,693,1303,3,1,3,0,1,0,53.18
臺北縣,蘆洲市,保新里,949,2,569,2,571,1012,3,1,3,0,1,0,56.42
臺北縣,蘆洲市,保新里,950,2,690,5,695,1081,3,1,3,0,1,0,64.29
臺北縣,新莊市,海山里,951,2,701,2,703,1191,3,1,3,0,1,0,59.03
臺北縣,新莊市,海山里,952,2,859,10,869,1516,3,1,3,0,1,0,57.32
臺北縣,新莊市,海山里,953,2,1036,18,1054,1736,3,1,3,0,1,0,60.71
臺北縣,新莊市,全安里,954,2,761,6,767,1172,3,1,3,0,1,0,65.44
臺北縣,新莊市,全安里,955,2,733,3,736,1344,3,1,3,0,1,0,54.76
臺北縣,新莊市,全安里,956,2,566,5,571,904,3,1,3,0,1,0,63.16
臺北縣,新莊市,全泰里,957,2,889,7,896,1475,3,1,3,0,1,0,60.75
臺北縣,新莊市,全泰里,958,2,946,5,951,1528,3,1,3,0,1,0,62.24
臺北縣,新莊市,全泰里,959,2,829,3,832,1275,3,1,3,0,1,0,65.25
臺北縣,新莊市,忠孝里,960,2,672,6,678,1146,3,1,3,0,1,0,59.16
臺北縣,新莊市,忠孝里,961,2,782,3,785,1221,3,1,3,0,1,0,64.29
臺北縣,新莊市,忠孝里,962,2,785,10,795,1322,3,1,3,0,1,0,60.14
臺北縣,新莊市,文衡里,963,2,1098,10,1108,1738,3,1,3,0,1,0,63.75
臺北縣,新莊市,文聖里,964,2,1008,14,1022,1618,3,1,3,0,1,0,63.16
臺北縣,新莊市,文聖里,965,2,847,5,852,1428,3,1,3,0,1,0,59.66
臺北縣,新莊市,興漢里,966,2,413,5,418,692,3,1,3,0,1,0,60.4
臺北縣,新莊市,興漢里,967,2,719,4,723,1158,3,1,3,0,1,0,62.44
臺北縣,新莊市,興漢里,968,2,714,8,722,1226,3,1,3,0,1,0,58.89
臺北縣,新莊市,榮和里,969,2,665,9,674,1087,3,1,3,0,1,0,62.01
臺北縣,新莊市,榮和里,970,2,853,5,858,2249,3,1,3,0,1,0,38.15
臺北縣,新莊市,文德里,971,2,893,2,895,1438,3,1,3,0,1,0,62.24
臺北縣,新莊市,文明里,972,2,992,9,1001,1574,3,1,3,0,1,0,63.6
臺北縣,新莊市,化成里,973,2,683,2,685,1184,3,1,3,0,1,0,57.85
臺北縣,新莊市,化成里,974,2,619,6,625,1020,3,1,3,0,1,0,61.27
臺北縣,新莊市,頭前里,975,2,878,8,886,1513,3,1,3,0,1,0,58.56
臺北縣,新莊市,頭前里,976,2,982,9,991,1719,3,1,3,0,1,0,57.65
臺北縣,新莊市,福基里,977,2,732,5,737,1211,3,1,3,0,1,0,60.86
臺北縣,新莊市,福基里,978,2,521,4,525,891,3,1,3,0,1,0,58.92
臺北縣,新莊市,福興里,979,2,845,5,850,1660,3,1,3,0,1,0,51.2
臺北縣,新莊市,福興里,980,2,812,2,814,1465,3,1,3,0,1,0,55.56
臺北縣,新莊市,昌平里,981,2,779,8,787,1478,3,1,3,0,1,0,53.25
臺北縣,新莊市,昌平里,982,2,634,5,639,1302,3,1,3,0,1,0,49.08
臺北縣,新莊市,和平里,983,2,692,4,696,1320,3,1,3,0,1,0,52.73
臺北縣,新莊市,和平里,984,2,742,9,751,1290,3,1,3,0,1,0,58.22
臺北縣,新莊市,和平里,985,2,754,4,758,1334,3,1,3,0,1,0,56.82
臺北縣,新莊市,幸福里,986,2,623,2,625,1158,3,1,3,0,1,0,53.97
臺北縣,新莊市,幸福里,987,2,666,6,672,1199,3,1,3,0,1,0,56.05
臺北縣,新莊市,幸福里,988,2,724,9,733,1303,3,1,3,0,1,0,56.25
臺北縣,新莊市,昌隆里,989,2,768,2,770,1405,3,1,3,0,1,0,54.8
臺北縣,新莊市,昌隆里,990,2,749,7,756,1434,3,1,3,0,1,0,52.72
臺北縣,新莊市,信義里,991,2,787,12,799,1427,3,1,3,0,1,0,55.99
臺北縣,新莊市,信義里,992,2,751,5,756,1353,3,1,3,0,1,0,55.88
臺北縣,新莊市,信義里,993,2,790,9,799,1530,3,1,3,0,1,0,52.22
臺北縣,新莊市,昌信里,994,2,664,4,668,1183,3,1,3,0,1,0,56.47
臺北縣,新莊市,昌信里,995,2,618,4,622,1161,3,1,3,0,1,0,53.57
臺北縣,新莊市,昌明里,996,2,914,5,919,1525,3,1,3,0,1,0,60.26
臺北縣,新莊市,昌明里,997,2,680,3,683,1193,3,1,3,0,1,0,57.25
臺北縣,新莊市,仁義里,998,2,758,7,765,1428,3,1,3,0,1,0,53.57
臺北縣,新莊市,仁義里,999,2,806,8,814,1437,3,1,3,0,1,0,56.65
臺北縣,新莊市,仁愛里,1000,2,670,1,671,1203,3,1,3,0,1,0,55.78
臺北縣,新莊市,仁愛里,1001,2,710,6,716,1152,3,1,3,0,1,0,62.15
臺北縣,新莊市,自信里,1002,2,534,5,539,953,3,1,3,0,1,0,56.56
臺北縣,新莊市,自信里,1003,2,602,5,607,1104,3,1,3,0,1,0,54.98
臺北縣,新莊市,自立里,1004,2,809,12,821,1415,3,1,3,0,1,0,58.02
臺北縣,新莊市,自立里,1005,2,703,9,712,1248,3,1,3,0,1,0,57.05
臺北縣,新莊市,自立里,1006,2,787,11,798,1305,3,1,3,0,1,0,61.15
臺北縣,新莊市,自強里,1007,2,686,9,695,1263,3,1,3,0,1,0,55.03
臺北縣,新莊市,自強里,1008,2,643,18,661,1137,3,1,3,0,1,0,58.14
臺北縣,新莊市,思源里,1009,2,785,3,788,1446,3,1,3,0,1,0,54.5
臺北縣,新莊市,思源里,1010,2,853,3,856,1573,3,1,3,0,1,0,54.42
臺北縣,新莊市,思源里,1011,2,736,3,739,1313,3,1,3,0,1,0,56.28
臺北縣,新莊市,思賢里,1012,2,986,6,992,1714,3,1,3,0,1,0,57.88
臺北縣,新莊市,思賢里,1013,2,878,11,889,1506,3,1,3,0,1,0,59.03
臺北縣,新莊市,中華里,1014,2,903,6,909,1585,3,1,3,0,1,0,57.35
臺北縣,新莊市,中美里,1015,2,921,4,925,1561,3,1,3,0,1,0,59.26
臺北縣,新莊市,中美里,1016,2,950,8,958,1694,3,1,3,0,1,0,56.55
臺北縣,新莊市,中美里,1017,2,866,8,874,1445,3,1,3,0,1,0,60.48
臺北縣,新莊市,恆安里,1018,2,772,4,776,1280,3,1,3,0,1,0,60.62
臺北縣,新莊市,恆安里,1019,2,741,4,745,1269,3,1,3,0,1,0,58.71
臺北縣,新莊市,恆安里,1020,2,646,3,649,1143,3,1,3,0,1,0,56.78
臺北縣,新莊市,立人里,1021,2,1074,9,1083,1754,3,1,3,0,1,0,61.74
臺北縣,新莊市,立德里,1022,2,669,1,670,1122,3,1,3,0,1,0,59.71
臺北縣,新莊市,立德里,1023,2,644,3,647,1106,3,1,3,0,1,0,58.5
臺北縣,新莊市,中和里,1024,2,623,5,628,1192,3,1,3,0,1,0,52.68
臺北縣,新莊市,中和里,1025,2,792,6,798,1322,3,1,3,0,1,0,60.36
臺北縣,新莊市,中和里,1026,2,723,7,730,1223,3,1,3,0,1,0,59.69
臺北縣,新莊市,中泰里,1027,2,764,3,767,1300,3,1,3,0,1,0,59
臺北縣,新莊市,中泰里,1028,2,741,6,747,1278,3,1,3,0,1,0,58.45
臺北縣,新莊市,中泰里,1029,2,729,7,736,1294,3,1,3,0,1,0,56.88
臺北縣,新莊市,中宏里,1030,2,729,8,737,1268,3,1,3,0,1,0,58.12
臺北縣,新莊市,中宏里,1031,2,875,6,881,1436,3,1,3,0,1,0,61.35
臺北縣,新莊市,中全里,1032,2,790,8,798,1471,3,1,3,0,1,0,54.25
臺北縣,新莊市,中全里,1033,2,754,8,762,1410,3,1,3,0,1,0,54.04
臺北縣,新莊市,立志里,1034,2,802,4,806,1461,3,1,3,0,1,0,55.17
臺北縣,新莊市,立志里,1035,2,932,8,940,1600,3,1,3,0,1,0,58.75
臺北縣,新莊市,立廷里,1036,2,674,1,675,1207,3,1,3,0,1,0,55.92
臺北縣,新莊市,立廷里,1037,2,764,4,768,1564,3,1,3,0,1,0,49.1
臺北縣,新莊市,立基里,1038,2,1013,3,1016,1793,3,1,3,0,1,0,56.66
臺北縣,新莊市,立基里,1039,2,789,5,794,1379,3,1,3,0,1,0,57.58
臺北縣,新莊市,立基里,1040,2,806,10,816,1406,3,1,3,0,1,0,58.04
臺北縣,新莊市,中誠里,1041,2,944,8,952,1755,3,1,3,0,1,0,54.25
臺北縣,新莊市,中港里,1042,2,861,5,866,1589,3,1,3,0,1,0,54.5
臺北縣,新莊市,中港里,1043,2,854,2,856,1537,3,1,3,0,1,0,55.69
臺北縣,新莊市,中港里,1044,2,896,3,899,1560,3,1,3,0,1,0,57.63
臺北縣,新莊市,中信里,1045,2,824,4,828,1448,3,1,3,0,1,0,57.18
臺北縣,新莊市,中信里,1046,2,748,6,754,1403,3,1,3,0,1,0,53.74
臺北縣,新莊市,中信里,1047,2,914,3,917,1714,3,1,3,0,1,0,53.5
臺北縣,新莊市,中信里,1048,2,764,6,770,1489,3,1,3,0,1,0,51.71
臺北縣,新莊市,中平里,1049,2,751,3,754,1346,3,1,3,0,1,0,56.02
臺北縣,新莊市,中平里,1050,2,752,8,760,1532,3,1,3,0,1,0,49.61
臺北縣,新莊市,中平里,1051,2,749,2,751,1488,3,1,3,0,1,0,50.47
臺北縣,新莊市,中平里,1052,2,655,3,658,1241,3,1,3,0,1,0,53.02
臺北縣,新莊市,中原里,1053,2,797,9,806,1413,3,1,3,0,1,0,57.04
臺北縣,新莊市,中原里,1054,2,804,5,809,1561,3,1,3,0,1,0,51.83
臺北縣,新莊市,中原里,1055,2,817,6,823,1484,3,1,3,0,1,0,55.46
臺北縣,新莊市,中原里,1056,2,729,4,733,1359,3,1,3,0,1,0,53.94
臺北縣,新莊市,中隆里,1057,2,1005,10,1015,1713,3,1,3,0,1,0,59.25
臺北縣,新莊市,中隆里,1058,2,534,4,538,997,3,1,3,0,1,0,53.96
臺北縣,新莊市,立功里,1059,2,848,8,856,1527,3,1,3,0,1,0,56.06
臺北縣,新莊市,立功里,1060,2,848,4,852,1592,3,1,3,0,1,0,53.52
臺北縣,新莊市,立泰里,1061,2,751,2,753,1348,3,1,3,0,1,0,55.86
臺北縣,新莊市,立泰里,1062,2,629,4,633,1134,3,1,3,0,1,0,55.82
臺北縣,新莊市,立泰里,1063,2,697,8,705,1314,3,1,3,0,1,0,53.65
臺北縣,新莊市,立言里,1064,2,751,5,756,1299,3,1,3,0,1,0,58.2
臺北縣,新莊市,立言里,1065,2,714,4,718,1208,3,1,3,0,1,0,59.44
臺北縣,新莊市,立言里,1066,2,780,3,783,1445,3,1,3,0,1,0,54.19
臺北縣,新莊市,豐年里,1067,2,839,9,848,1606,3,1,3,0,1,0,52.8
臺北縣,新莊市,豐年里,1068,2,820,2,822,1442,3,1,3,0,1,0,57
臺北縣,新莊市,國泰里,1069,2,923,9,932,1429,3,1,3,0,1,0,65.22
臺北縣,新莊市,泰豐里,1070,2,704,4,708,1150,3,1,3,0,1,0,61.57
臺北縣,新莊市,泰豐里,1071,2,486,7,493,850,3,1,3,0,1,0,58
臺北縣,新莊市,瓊林里,1072,2,1021,4,1025,1698,3,1,3,0,1,0,60.37
臺北縣,新莊市,瓊林里,1073,2,803,7,810,1451,3,1,3,0,1,0,55.82
臺北縣,新莊市,瓊林里,1074,2,834,10,844,1458,3,1,3,0,1,0,57.89
臺北縣,新莊市,福營里,1075,2,623,5,628,1021,3,1,3,0,1,0,61.51
臺北縣,新莊市,福營里,1076,2,618,8,626,952,3,1,3,0,1,0,65.76
臺北縣,新莊市,營盤里,1077,2,558,4,562,942,3,1,3,0,1,0,59.66
臺北縣,新莊市,營盤里,1078,2,598,4,602,995,3,1,3,0,1,0,60.5
臺北縣,新莊市,丹鳳里,1079,2,737,2,739,1275,3,1,3,0,1,0,57.96
臺北縣,新莊市,丹鳳里,1080,2,689,3,692,1295,3,1,3,0,1,0,53.44
臺北縣,新莊市,丹鳳里,1081,2,599,5,604,1139,3,1,3,0,1,0,53.03
臺北縣,新莊市,丹鳳里,1082,2,748,4,752,1650,3,1,3,0,1,0,45.58
臺北縣,新莊市,合鳳里,1083,2,571,8,579,1101,3,1,3,0,1,0,52.59
臺北縣,新莊市,合鳳里,1084,2,581,1,582,1209,3,1,3,0,1,0,48.14
臺北縣,新莊市,合鳳里,1085,2,667,4,671,1297,3,1,3,0,1,0,51.73
臺北縣,新莊市,祥鳳里,1086,2,964,3,967,1759,3,1,3,0,1,0,54.97
臺北縣,新莊市,雙鳳里,1087,2,608,7,615,1289,3,1,3,0,1,0,47.71
臺北縣,新莊市,雙鳳里,1088,2,857,6,863,1734,3,1,3,0,1,0,49.77
臺北縣,新莊市,雙鳳里,1089,2,742,5,747,1317,3,1,3,0,1,0,56.72
臺北縣,新莊市,雙鳳里,1090,2,232,0,232,350,3,1,3,0,1,0,66.29
臺北縣,新莊市,龍福里,1091,2,790,12,802,1516,3,1,3,0,1,0,52.9
臺北縣,新莊市,龍鳳里,1092,2,760,4,764,1582,3,1,3,0,1,0,48.29
臺北縣,新莊市,龍鳳里,1093,2,665,5,670,1303,3,1,3,0,1,0,51.42
臺北縣,新莊市,龍鳳里,1094,2,833,5,838,1514,3,1,3,0,1,0,55.35
臺北縣,新莊市,裕民里,1095,2,735,5,740,1302,3,1,3,0,1,0,56.84
臺北縣,新莊市,裕民里,1096,2,698,4,702,1314,3,1,3,0,1,0,53.42
臺北縣,新莊市,裕民里,1097,2,733,4,737,1334,3,1,3,0,1,0,55.25
臺北縣,新莊市,裕民里,1098,2,587,2,589,1054,3,1,3,0,1,0,55.88
臺北縣,新莊市,龍安里,1099,2,497,7,504,931,3,1,3,0,1,0,54.14
臺北縣,新莊市,龍安里,1100,2,548,7,555,1024,3,1,3,0,1,0,54.2
臺北縣,新莊市,富國里,1101,2,543,4,547,985,3,1,3,0,1,0,55.53
臺北縣,新莊市,富國里,1102,2,615,4,619,1070,3,1,3,0,1,0,57.85
臺北縣,新莊市,富民里,1103,2,736,5,741,1369,3,1,3,0,1,0,54.13
臺北縣,新莊市,富民里,1104,2,726,8,734,1320,3,1,3,0,1,0,55.61
臺北縣,新莊市,後德里,1105,2,607,3,610,1046,3,1,3,0,1,0,58.32
臺北縣,新莊市,後德里,1106,2,658,1,659,1170,3,1,3,0,1,0,56.32
臺北縣,新莊市,萬安里,1107,2,620,6,626,1172,3,1,3,0,1,0,53.41
臺北縣,新莊市,萬安里,1108,2,805,5,810,1478,3,1,3,0,1,0,54.8
臺北縣,新莊市,建福里,1109,2,525,2,527,940,3,1,3,0,1,0,56.06
臺北縣,新莊市,建福里,1110,2,572,7,579,1069,3,1,3,0,1,0,54.16
臺北縣,新莊市,後港里,1111,2,697,3,700,1284,3,1,3,0,1,0,54.52
臺北縣,新莊市,後港里,1112,2,743,3,746,1303,3,1,3,0,1,0,57.25
臺北縣,新莊市,後港里,1113,2,696,7,703,1281,3,1,3,0,1,0,54.88
臺北縣,新莊市,後港里,1114,2,685,2,687,1180,3,1,3,0,1,0,58.22
臺北縣,新莊市,四維里,1115,2,616,5,621,1222,3,1,3,0,1,0,50.82
臺北縣,新莊市,四維里,1116,2,663,1,664,1295,3,1,3,0,1,0,51.27
臺北縣,新莊市,四維里,1117,2,681,9,690,1308,3,1,3,0,1,0,52.75
臺北縣,新莊市,南港里,1118,2,674,4,678,1279,3,1,3,0,1,0,53.01
臺北縣,新莊市,南港里,1119,2,660,1,661,1240,3,1,3,0,1,0,53.31
臺北縣,新莊市,南港里,1120,2,656,3,659,1343,3,1,3,0,1,0,49.07
臺北縣,新莊市,建安里,1121,2,792,7,799,1495,3,1,3,0,1,0,53.44
臺北縣,新莊市,建安里,1122,2,745,2,747,1524,3,1,3,0,1,0,49.02
臺北縣,新莊市,建安里,1123,2,747,5,752,1431,3,1,3,0,1,0,52.55
臺北縣,新莊市,民全里,1124,2,638,3,641,1174,3,1,3,0,1,0,54.6
臺北縣,新莊市,民全里,1125,2,664,3,667,1213,3,1,3,0,1,0,54.99
臺北縣,新莊市,民本里,1126,2,688,6,694,1264,3,1,3,0,1,0,54.91
臺北縣,新莊市,民本里,1127,2,638,6,644,1227,3,1,3,0,1,0,52.49
臺北縣,新莊市,八德里,1128,2,663,5,668,1317,3,1,3,0,1,0,50.72
臺北縣,新莊市,八德里,1129,2,591,7,598,1191,3,1,3,0,1,0,50.21
臺北縣,新莊市,民安里,1130,2,711,11,722,1374,3,1,3,0,1,0,52.55
臺北縣,新莊市,民安里,1131,2,661,7,668,1225,3,1,3,0,1,0,54.53
臺北縣,新莊市,民安里,1132,2,595,5,600,1173,3,1,3,0,1,0,51.15
臺北縣,新莊市,成德里,1133,2,733,2,735,1543,3,1,3,0,1,0,47.63
臺北縣,新莊市,成德里,1134,2,989,8,997,2075,3,1,3,0,1,0,48.05
臺北縣,新莊市,光明里,1135,2,741,6,747,1450,3,1,3,0,1,0,51.52
臺北縣,新莊市,光明里,1136,2,729,6,735,1434,3,1,3,0,1,0,51.26
臺北縣,新莊市,光華里,1137,2,699,5,704,1445,3,1,3,0,1,0,48.72
臺北縣,新莊市,光華里,1138,2,697,4,701,1471,3,1,3,0,1,0,47.65
臺北縣,新莊市,光華里,1139,2,752,6,758,1567,3,1,3,0,1,0,48.37
臺北縣,新莊市,光榮里,1140,2,786,7,793,1485,3,1,3,0,1,0,53.4
臺北縣,新莊市,光榮里,1141,2,736,6,742,1441,3,1,3,0,1,0,51.49
臺北縣,新莊市,光正里,1142,2,780,10,790,1490,3,1,3,0,1,0,53.02
臺北縣,新莊市,光正里,1143,2,713,7,720,1263,3,1,3,0,1,0,57.01
臺北縣,新莊市,光和里,1144,2,511,3,514,991,3,1,3,0,1,0,51.87
臺北縣,新莊市,光和里,1145,2,476,2,478,982,3,1,3,0,1,0,48.68
臺北縣,新莊市,民有里,1146,2,747,6,753,1337,3,1,3,0,1,0,56.32
臺北縣,新莊市,民有里,1147,2,738,7,745,1441,3,1,3,0,1,0,51.7
臺北縣,新莊市,西盛里,1148,2,697,10,707,1248,3,1,3,0,1,0,56.65
臺北縣,新莊市,西盛里,1149,2,844,16,860,1692,3,1,3,0,1,0,50.83
臺北縣,新莊市,西盛里,1150,2,697,5,702,1331,3,1,3,0,1,0,52.74
臺北縣,五股鄉,興珍村,1151,2,711,4,715,1262,3,1,3,0,1,0,56.66
臺北縣,五股鄉,興珍村,1152,2,765,8,773,1355,3,1,3,0,1,0,57.05
臺北縣,五股鄉,興珍村,1153,2,729,6,735,1184,3,1,3,0,1,0,62.08
臺北縣,五股鄉,更寮村,1154,2,667,3,670,1116,3,1,3,0,1,0,60.04
臺北縣,五股鄉,集福村,1155,2,659,4,663,1247,3,1,3,0,1,0,53.17
臺北縣,五股鄉,集福村,1156,2,447,7,454,790,3,1,3,0,1,0,57.47
臺北縣,五股鄉,集福村,1157,2,304,4,308,471,3,1,3,0,1,0,65.39
臺北縣,五股鄉,集賢村,1158,2,802,8,810,1469,3,1,3,0,1,0,55.14
臺北縣,五股鄉,集賢村,1159,2,704,10,714,1277,3,1,3,0,1,0,55.91
臺北縣,五股鄉,觀音村,1160,2,750,6,756,1270,3,1,3,0,1,0,59.53
臺北縣,五股鄉,成州村,1161,2,851,4,855,1464,3,1,3,0,1,0,58.4
臺北縣,五股鄉,成州村,1162,2,766,8,774,1342,3,1,3,0,1,0,57.68
臺北縣,五股鄉,成州村,1163,2,693,7,700,1371,3,1,3,0,1,0,51.06
臺北縣,五股鄉,成德村,1164,2,624,5,629,1166,3,1,3,0,1,0,53.95
臺北縣,五股鄉,成德村,1165,2,563,6,569,1091,3,1,3,0,1,0,52.15
臺北縣,五股鄉,成功村,1166,2,800,10,810,1507,3,1,3,0,1,0,53.75
臺北縣,五股鄉,成功村,1167,2,748,5,753,1544,3,1,3,0,1,0,48.77
臺北縣,五股鄉,成泰村,1168,2,783,7,790,1419,3,1,3,0,1,0,55.67
臺北縣,五股鄉,成泰村,1169,2,767,8,775,1274,3,1,3,0,1,0,60.83
臺北縣,五股鄉,五龍村,1170,2,735,5,740,1168,3,1,3,0,1,0,63.36
臺北縣,五股鄉,五福村,1171,2,800,7,807,1344,3,1,3,0,1,0,60.04
臺北縣,五股鄉,五福村,1172,2,892,4,896,1486,3,1,3,0,1,0,60.3
臺北縣,五股鄉,六福村,1173,2,741,3,744,1282,3,1,3,0,1,0,58.03
臺北縣,五股鄉,六福村,1174,2,753,4,757,1318,3,1,3,0,1,0,57.44
臺北縣,五股鄉,五股村,1175,2,805,7,812,1599,3,1,3,0,1,0,50.78
臺北縣,五股鄉,五股村,1176,2,931,7,938,1619,3,1,3,0,1,0,57.94
臺北縣,五股鄉,民義村,1177,2,789,4,793,1309,3,1,3,0,1,0,60.58
臺北縣,五股鄉,民義村,1178,2,775,4,779,1254,3,1,3,0,1,0,62.12
臺北縣,五股鄉,德音村,1179,2,689,5,694,1203,3,1,3,0,1,0,57.69
臺北縣,五股鄉,德音村,1180,2,691,3,694,1185,3,1,3,0,1,0,58.57
臺北縣,五股鄉,德音村,1181,2,714,6,720,1233,3,1,3,0,1,0,58.39
臺北縣,五股鄉,水碓村,1182,2,703,5,708,1220,3,1,3,0,1,0,58.03
臺北縣,五股鄉,水碓村,1183,2,660,6,666,1332,3,1,3,0,1,0,50
臺北縣,五股鄉,水碓村,1184,2,711,4,715,1270,3,1,3,0,1,0,56.3
臺北縣,五股鄉,水碓村,1185,2,685,8,693,1306,3,1,3,0,1,0,53.06
臺北縣,五股鄉,德泰村,1186,2,704,3,707,1358,3,1,3,0,1,0,52.06
臺北縣,五股鄉,德泰村,1187,2,837,4,841,1645,3,1,3,0,1,0,51.12
臺北縣,五股鄉,德泰村,1188,2,801,5,806,1751,3,1,3,0,1,0,46.03
臺北縣,五股鄉,貿商村,1189,2,1292,8,1300,1847,3,1,3,0,1,0,70.38
臺北縣,泰山鄉,大科村,1190,2,384,6,390,606,3,1,3,0,1,0,64.36
臺北縣,泰山鄉,大科村,1191,2,163,1,164,260,3,1,3,0,1,0,63.08
臺北縣,泰山鄉,黎明村,1192,2,749,11,760,1297,3,1,3,0,1,0,58.6
臺北縣,泰山鄉,黎明村,1193,2,533,2,535,1057,3,1,3,0,1,0,50.61
臺北縣,泰山鄉,黎明村,1194,2,333,2,335,475,3,1,3,0,1,0,70.53
臺北縣,泰山鄉,山腳村,1195,2,667,3,670,1228,3,1,3,0,1,0,54.56
臺北縣,泰山鄉,山腳村,1196,2,685,4,689,1253,3,1,3,0,1,0,54.99
臺北縣,泰山鄉,山腳村,1197,2,489,2,491,937,3,1,3,0,1,0,52.4
臺北縣,泰山鄉,山腳村,1198,2,586,10,596,980,3,1,3,0,1,0,60.82
臺北縣,泰山鄉,福泰村,1199,2,571,3,574,994,3,1,3,0,1,0,57.75
臺北縣,泰山鄉,福泰村,1200,2,639,4,643,1032,3,1,3,0,1,0,62.31
臺北縣,泰山鄉,福泰村,1201,2,702,4,706,1259,3,1,3,0,1,0,56.08
臺北縣,泰山鄉,福泰村,1202,2,748,3,751,1360,3,1,3,0,1,0,55.22
臺北縣,泰山鄉,楓樹村,1203,2,578,3,581,958,3,1,3,0,1,0,60.65
臺北縣,泰山鄉,楓樹村,1204,2,455,2,457,777,3,1,3,0,1,0,58.82
臺北縣,泰山鄉,楓樹村,1205,2,582,3,585,917,3,1,3,0,1,0,63.79
臺北縣,泰山鄉,同榮村,1206,2,754,13,767,1192,3,1,3,0,1,0,64.35
臺北縣,泰山鄉,同榮村,1207,2,667,4,671,1133,3,1,3,0,1,0,59.22
臺北縣,泰山鄉,同榮村,1208,2,470,7,477,821,3,1,3,0,1,0,58.1
臺北縣,泰山鄉,同興村,1209,2,658,8,666,1226,3,1,3,0,1,0,54.32
臺北縣,泰山鄉,同興村,1210,2,775,4,779,1376,3,1,3,0,1,0,56.61
臺北縣,泰山鄉,同興村,1211,2,719,4,723,1529,3,1,3,0,1,0,47.29
臺北縣,泰山鄉,義學村,1212,2,554,9,563,986,3,1,3,0,1,0,57.1
臺北縣,泰山鄉,義學村,1213,2,523,6,529,969,3,1,3,0,1,0,54.59
臺北縣,泰山鄉,義學村,1214,2,750,4,754,1250,3,1,3,0,1,0,60.32
臺北縣,泰山鄉,義仁村,1215,2,822,6,828,1442,3,1,3,0,1,0,57.42
臺北縣,泰山鄉,義仁村,1216,2,796,4,800,1436,3,1,3,0,1,0,55.71
臺北縣,泰山鄉,義仁村,1217,2,741,7,748,1303,3,1,3,0,1,0,57.41
臺北縣,泰山鄉,明志村,1218,2,610,8,618,1055,3,1,3,0,1,0,58.58
臺北縣,泰山鄉,明志村,1219,2,532,5,537,919,3,1,3,0,1,0,58.43
臺北縣,泰山鄉,明志村,1220,2,599,2,601,975,3,1,3,0,1,0,61.64
臺北縣,泰山鄉,泰友村,1221,2,563,7,570,935,3,1,3,0,1,0,60.96
臺北縣,泰山鄉,泰友村,1222,2,516,5,521,877,3,1,3,0,1,0,59.41
臺北縣,泰山鄉,新明村,1223,2,811,5,816,1367,3,1,3,0,1,0,59.69
臺北縣,泰山鄉,新明村,1224,2,781,11,792,1345,3,1,3,0,1,0,58.88
臺北縣,泰山鄉,貴子村,1225,2,591,4,595,1038,3,1,3,0,1,0,57.32
臺北縣,泰山鄉,貴子村,1226,2,620,4,624,1041,3,1,3,0,1,0,59.94
臺北縣,泰山鄉,貴子村,1227,2,587,5,592,1018,3,1,3,0,1,0,58.15
臺北縣,泰山鄉,貴賢村,1228,2,947,9,956,1474,3,1,3,0,1,0,64.86
臺北縣,泰山鄉,貴賢村,1229,2,911,5,916,1560,3,1,3,0,1,0,58.72
臺北縣,泰山鄉,貴和村,1230,2,777,8,785,1344,3,1,3,0,1,0,58.41
臺北縣,泰山鄉,貴和村,1231,2,767,2,769,1343,3,1,3,0,1,0,57.26
臺北縣,泰山鄉,貴和村,1232,2,652,7,659,1188,3,1,3,0,1,0,55.47
臺北縣,林口鄉,東林村,1233,2,639,6,645,1092,3,1,3,0,1,0,59.07
臺北縣,林口鄉,東林村,1234,2,565,5,570,1027,3,1,3,0,1,0,55.5
臺北縣,林口鄉,東林村,1235,2,713,8,721,1307,3,1,3,0,1,0,55.16
臺北縣,林口鄉,林口村,1236,2,508,5,513,1092,3,1,3,0,1,0,46.98
臺北縣,林口鄉,林口村,1237,2,696,9,705,1294,3,1,3,0,1,0,54.48
臺北縣,林口鄉,林口村,1238,2,673,7,680,1094,3,1,3,0,1,0,62.16
臺北縣,林口鄉,西林村,1239,2,625,2,627,1060,3,1,3,0,1,0,59.15
臺北縣,林口鄉,西林村,1240,2,789,5,794,1405,3,1,3,0,1,0,56.51
臺北縣,林口鄉,西林村,1241,2,499,3,502,843,3,1,3,0,1,0,59.55
臺北縣,林口鄉,菁湖村,1242,2,1009,6,1015,1683,3,1,3,0,1,0,60.31
臺北縣,林口鄉,菁湖村,1243,2,939,9,948,1578,3,1,3,0,1,0,60.08
臺北縣,林口鄉,中湖村,1244,2,759,6,765,1342,3,1,3,0,1,0,57
臺北縣,林口鄉,中湖村,1245,2,592,4,596,990,3,1,3,0,1,0,60.2
臺北縣,林口鄉,湖北村,1246,2,697,16,713,1101,3,1,3,0,1,0,64.76
臺北縣,林口鄉,湖南村,1247,2,749,11,760,1267,3,1,3,0,1,0,59.98
臺北縣,林口鄉,南勢村,1248,2,469,6,475,746,3,1,3,0,1,0,63.67
臺北縣,林口鄉,仁愛村,1249,2,682,6,688,1345,3,1,3,0,1,0,51.15
臺北縣,林口鄉,仁愛村,1250,2,540,6,546,1061,3,1,3,0,1,0,51.46
臺北縣,林口鄉,仁愛村,1251,2,529,0,529,955,3,1,3,0,1,0,55.39
臺北縣,林口鄉,麗林村,1252,2,626,2,628,1269,3,1,3,0,1,0,49.49
臺北縣,林口鄉,麗林村,1253,2,776,6,782,1557,3,1,3,0,1,0,50.22
臺北縣,林口鄉,麗林村,1254,2,642,3,645,1189,3,1,3,0,1,0,54.25
臺北縣,林口鄉,東勢村,1255,2,674,9,683,1264,3,1,3,0,1,0,54.03
臺北縣,林口鄉,東勢村,1256,2,717,2,719,1247,3,1,3,0,1,0,57.66
臺北縣,林口鄉,東勢村,1257,2,782,4,786,1449,3,1,3,0,1,0,54.24
臺北縣,林口鄉,麗園村,1258,2,674,8,682,1314,3,1,3,0,1,0,51.9
臺北縣,林口鄉,麗園村,1259,2,765,7,772,1446,3,1,3,0,1,0,53.39
臺北縣,林口鄉,頂福村,1260,2,579,7,586,949,3,1,3,0,1,0,61.75
臺北縣,林口鄉,下福村,1261,2,594,4,598,933,3,1,3,0,1,0,64.09
臺北縣,林口鄉,嘉寶村,1262,2,452,1,453,637,3,1,3,0,1,0,71.11
臺北縣,林口鄉,瑞平村,1263,2,283,2,285,446,3,1,3,0,1,0,63.9
臺北縣,林口鄉,太平村,1264,2,480,6,486,875,3,1,3,0,1,0,55.54
臺北縣,淡水鎮,中和里,1265,2,345,5,350,571,3,1,3,0,1,0,61.3
臺北縣,淡水鎮,屯山里,1266,2,612,4,616,946,3,1,3,0,1,0,65.12
臺北縣,淡水鎮,賢孝里,1267,2,760,9,769,1339,3,1,3,0,1,0,57.43
臺北縣,淡水鎮,興仁里,1268,2,848,9,857,1373,3,1,3,0,1,0,62.42
臺北縣,淡水鎮,蕃薯里,1269,2,401,0,401,786,3,1,3,0,1,0,51.02
臺北縣,淡水鎮,忠山里,1270,2,485,5,490,811,3,1,3,0,1,0,60.42
臺北縣,淡水鎮,義山里,1271,2,585,5,590,1061,3,1,3,0,1,0,55.61
臺北縣,淡水鎮,義山里,1272,2,576,5,581,1091,3,1,3,0,1,0,53.25
臺北縣,淡水鎮,水源里,1273,2,521,8,529,947,3,1,3,0,1,0,55.86
臺北縣,淡水鎮,水源里,1274,2,479,10,489,876,3,1,3,0,1,0,55.82
臺北縣,淡水鎮,忠寮里,1275,2,604,3,607,1008,3,1,3,0,1,0,60.22
臺北縣,淡水鎮,樹興里,1276,2,480,2,482,781,3,1,3,0,1,0,61.72
臺北縣,淡水鎮,坪頂里,1277,2,575,9,584,1053,3,1,3,0,1,0,55.46
臺北縣,淡水鎮,福德里,1278,2,1104,3,1107,1950,3,1,3,0,1,0,56.77
臺北縣,淡水鎮,福德里,1279,2,747,6,753,1371,3,1,3,0,1,0,54.92
臺北縣,淡水鎮,福德里,1280,2,823,9,832,1406,3,1,3,0,1,0,59.17
臺北縣,淡水鎮,竹圍里,1281,2,927,5,932,1666,3,1,3,0,1,0,55.94
臺北縣,淡水鎮,竹圍里,1282,2,958,7,965,1693,3,1,3,0,1,0,57
臺北縣,淡水鎮,竹圍里,1283,2,849,7,856,1700,3,1,3,0,1,0,50.35
臺北縣,淡水鎮,竹圍里,1284,2,955,8,963,1691,3,1,3,0,1,0,56.95
臺北縣,淡水鎮,民生里,1285,2,751,6,757,1517,3,1,3,0,1,0,49.9
臺北縣,淡水鎮,民生里,1286,2,734,3,737,1414,3,1,3,0,1,0,52.12
臺北縣,淡水鎮,民生里,1287,2,708,5,713,1300,3,1,3,0,1,0,54.85
臺北縣,淡水鎮,八勢里,1288,2,1126,11,1137,2119,3,1,3,0,1,0,53.66
臺北縣,淡水鎮,竿蓁里,1289,2,784,3,787,1715,3,1,3,0,1,0,45.89
臺北縣,淡水鎮,竿蓁里,1290,2,904,7,911,1730,3,1,3,0,1,0,52.66
臺北縣,淡水鎮,崁頂里,1291,2,758,6,764,1290,3,1,3,0,1,0,59.22
臺北縣,淡水鎮,埤島里,1292,2,643,2,645,1060,3,1,3,0,1,0,60.85
臺北縣,淡水鎮,水碓里,1293,2,794,8,802,1427,3,1,3,0,1,0,56.2
臺北縣,淡水鎮,水碓里,1294,2,787,5,792,1487,3,1,3,0,1,0,53.26
臺北縣,淡水鎮,水碓里,1295,2,692,5,697,1368,3,1,3,0,1,0,50.95
臺北縣,淡水鎮,水碓里,1296,2,800,1,801,1590,3,1,3,0,1,0,50.38
臺北縣,淡水鎮,水碓里,1297,2,821,5,826,1679,3,1,3,0,1,0,49.2
臺北縣,淡水鎮,水碓里,1298,2,804,2,806,1532,3,1,3,0,1,0,52.61
臺北縣,淡水鎮,新興里,1299,2,865,5,870,1642,3,1,3,0,1,0,52.98
臺北縣,淡水鎮,新興里,1300,2,926,11,937,1772,3,1,3,0,1,0,52.88
臺北縣,淡水鎮,新興里,1301,2,780,5,785,1570,3,1,3,0,1,0,50
臺北縣,淡水鎮,新興里,1302,2,719,2,721,1503,3,1,3,0,1,0,47.97
臺北縣,淡水鎮,新興里,1303,2,812,5,817,1743,3,1,3,0,1,0,46.87
臺北縣,淡水鎮,新興里,1304,2,751,7,758,1500,3,1,3,0,1,0,50.53
臺北縣,淡水鎮,新興里,1305,2,732,4,736,1424,3,1,3,0,1,0,51.69
臺北縣,淡水鎮,新興里,1306,2,783,6,789,1498,3,1,3,0,1,0,52.67
臺北縣,淡水鎮,新興里,1307,2,904,3,907,1625,3,1,3,0,1,0,55.82
臺北縣,淡水鎮,北投里,1308,2,902,9,911,1679,3,1,3,0,1,0,54.26
臺北縣,淡水鎮,鄧公里,1309,2,880,9,889,1654,3,1,3,0,1,0,53.75
臺北縣,淡水鎮,鄧公里,1310,2,1002,8,1010,1892,3,1,3,0,1,0,53.38
臺北縣,淡水鎮,鄧公里,1311,2,951,4,955,1671,3,1,3,0,1,0,57.15
臺北縣,淡水鎮,鄧公里,1312,2,795,14,809,1707,3,1,3,0,1,0,47.39
臺北縣,淡水鎮,鄧公里,1313,2,901,12,913,1645,3,1,3,0,1,0,55.5
臺北縣,淡水鎮,鄧公里,1314,2,940,10,950,1738,3,1,3,0,1,0,54.66
臺北縣,淡水鎮,中興里,1315,2,601,3,604,1091,3,1,3,0,1,0,55.36
臺北縣,淡水鎮,中興里,1316,2,733,8,741,1306,3,1,3,0,1,0,56.74
臺北縣,淡水鎮,中興里,1317,2,663,15,678,1143,3,1,3,0,1,0,59.32
臺北縣,淡水鎮,長庚里,1318,2,840,8,848,1472,3,1,3,0,1,0,57.61
臺北縣,淡水鎮,清文里,1319,2,583,11,594,1038,3,1,3,0,1,0,57.23
臺北縣,淡水鎮,草東里,1320,2,522,6,528,798,3,1,3,0,1,0,66.17
臺北縣,淡水鎮,協元里,1321,2,744,8,752,1341,3,1,3,0,1,0,56.08
臺北縣,淡水鎮,永吉里,1322,2,482,6,488,733,3,1,3,0,1,0,66.58
臺北縣,淡水鎮,民安里,1323,2,458,3,461,728,3,1,3,0,1,0,63.32
臺北縣,淡水鎮,新生里,1324,2,289,3,292,674,3,1,3,0,1,0,43.32
臺北縣,淡水鎮,文化里,1325,2,861,9,870,1477,3,1,3,0,1,0,58.9
臺北縣,淡水鎮,油車里,1326,2,712,12,724,1194,3,1,3,0,1,0,60.64
臺北縣,淡水鎮,油車里,1327,2,701,2,703,1316,3,1,3,0,1,0,53.42
臺北縣,淡水鎮,油車里,1328,2,752,5,757,1245,3,1,3,0,1,0,60.8
臺北縣,淡水鎮,沙崙里,1329,2,926,7,933,1666,3,1,3,0,1,0,56
臺北縣,淡水鎮,沙崙里,1330,2,921,10,931,1647,3,1,3,0,1,0,56.53
臺北縣,淡水鎮,沙崙里,1331,2,876,10,886,1584,3,1,3,0,1,0,55.93
臺北縣,八里鄉,龍源村,1332,2,871,5,876,1621,3,1,3,0,1,0,54.04
臺北縣,八里鄉,龍源村,1333,2,819,5,824,1519,3,1,3,0,1,0,54.25
臺北縣,八里鄉,龍源村,1334,2,748,8,756,1280,3,1,3,0,1,0,59.06
臺北縣,八里鄉,米倉村,1335,2,628,7,635,1252,3,1,3,0,1,0,50.72
臺北縣,八里鄉,米倉村,1336,2,634,7,641,1017,3,1,3,0,1,0,63.03
臺北縣,八里鄉,大崁村,1337,2,901,10,911,1511,3,1,3,0,1,0,60.29
臺北縣,八里鄉,埤頭村,1338,2,574,3,577,1144,3,1,3,0,1,0,50.44
臺北縣,八里鄉,埤頭村,1339,2,772,8,780,1325,3,1,3,0,1,0,58.87
臺北縣,八里鄉,頂罟村,1340,2,653,6,659,1133,3,1,3,0,1,0,58.16
臺北縣,八里鄉,舊城村,1341,2,723,9,732,1441,3,1,3,0,1,0,50.8
臺北縣,八里鄉,舊城村,1342,2,823,8,831,1588,3,1,3,0,1,0,52.33
臺北縣,八里鄉,舊城村,1343,2,724,6,730,1416,3,1,3,0,1,0,51.55
臺北縣,八里鄉,訊塘村,1344,2,751,5,756,1340,3,1,3,0,1,0,56.42
臺北縣,八里鄉,訊塘村,1345,2,655,4,659,1201,3,1,3,0,1,0,54.87
臺北縣,八里鄉,荖阡村,1346,2,741,8,749,1296,3,1,3,0,1,0,57.79
臺北縣,八里鄉,長坑村,1347,2,761,3,764,1109,3,1,3,0,1,0,68.89
臺北縣,八里鄉,下罟村,1348,2,712,13,725,1065,3,1,3,0,1,0,68.08
臺北縣,三芝鄉,八賢村,1349,2,217,1,218,353,3,1,3,0,1,0,61.76
臺北縣,三芝鄉,埔頭村,1350,2,712,3,715,1240,3,1,3,0,1,0,57.66
臺北縣,三芝鄉,埔頭村,1351,2,747,3,750,1286,3,1,3,0,1,0,58.32
臺北縣,三芝鄉,埔頭村,1352,2,616,4,620,1152,3,1,3,0,1,0,53.82
臺北縣,三芝鄉,古庄村,1353,2,468,4,472,884,3,1,3,0,1,0,53.39
臺北縣,三芝鄉,新庄村,1354,2,487,4,491,800,3,1,3,0,1,0,61.38
臺北縣,三芝鄉,埔坪村,1355,2,904,10,914,1766,3,1,3,0,1,0,51.76
臺北縣,三芝鄉,埔坪村,1356,2,869,4,873,1608,3,1,3,0,1,0,54.29
臺北縣,三芝鄉,埔坪村,1357,2,864,6,870,1702,3,1,3,0,1,0,51.12
臺北縣,三芝鄉,茂長村,1358,2,261,4,265,459,3,1,3,0,1,0,57.73
臺北縣,三芝鄉,橫山村,1359,2,354,4,358,529,3,1,3,0,1,0,67.67
臺北縣,三芝鄉,錫板村,1360,2,466,4,470,764,3,1,3,0,1,0,61.52
臺北縣,三芝鄉,後厝村,1361,2,851,7,858,1599,3,1,3,0,1,0,53.66
臺北縣,三芝鄉,福德村,1362,2,367,2,369,648,3,1,3,0,1,0,56.94
臺北縣,三芝鄉,圓山村,1363,2,313,2,315,492,3,1,3,0,1,0,64.02
臺北縣,三芝鄉,店子村,1364,2,390,3,393,620,3,1,3,0,1,0,63.39
臺北縣,三芝鄉,興華村,1365,2,613,2,615,1109,3,1,3,0,1,0,55.46
臺北縣,石門鄉,德茂村,1366,2,524,4,528,895,3,1,3,0,1,0,58.99
臺北縣,石門鄉,富基村,1367,2,682,6,688,1085,3,1,3,0,1,0,63.41
臺北縣,石門鄉,老梅村,1368,2,985,10,995,1790,3,1,3,0,1,0,55.59
臺北縣,石門鄉,山溪村,1369,2,411,2,413,726,3,1,3,0,1,0,56.89
臺北縣,石門鄉,石門村,1370,2,729,9,738,1213,3,1,3,0,1,0,60.84
臺北縣,石門鄉,尖鹿村,1371,2,675,7,682,1240,3,1,3,0,1,0,55
臺北縣,石門鄉,乾華村,1372,2,155,1,156,300,3,1,3,0,1,0,52
臺北縣,石門鄉,茂林村,1373,2,301,3,304,499,3,1,3,0,1,0,60.92
臺北縣,石門鄉,草里村,1374,2,464,8,472,763,3,1,3,0,1,0,61.86
臺北縣,金山鄉,和平村,1375,2,304,0,304,443,3,1,3,0,1,0,68.62
臺北縣,金山鄉,大同村,1376,2,406,6,412,635,3,1,3,0,1,0,64.88
臺北縣,金山鄉,豐漁村,1377,2,292,0,292,470,3,1,3,0,1,0,62.13
臺北縣,金山鄉,磺港村,1378,2,915,3,918,1594,3,1,3,0,1,0,57.59
臺北縣,金山鄉,美田村,1379,2,1100,9,1109,1848,3,1,3,0,1,0,60.01
臺北縣,金山鄉,美田村,1380,2,962,8,970,1658,3,1,3,0,1,0,58.5
臺北縣,金山鄉,美田村,1381,2,1024,8,1032,1810,3,1,3,0,1,0,57.02
臺北縣,金山鄉,美田村,1382,2,946,6,952,1600,3,1,3,0,1,0,59.5
臺北縣,金山鄉,五湖村,1383,2,430,2,432,687,3,1,3,0,1,0,62.88
臺北縣,金山鄉,五湖村,1384,2,456,10,466,741,3,1,3,0,1,0,62.89
臺北縣,金山鄉,重和村,1385,2,570,6,576,995,3,1,3,0,1,0,57.89
臺北縣,金山鄉,兩湖村,1386,2,233,3,236,377,3,1,3,0,1,0,62.6
臺北縣,金山鄉,六股村,1387,2,353,4,357,544,3,1,3,0,1,0,65.63
臺北縣,金山鄉,三界村,1388,2,367,5,372,601,3,1,3,0,1,0,61.9
臺北縣,金山鄉,清泉村,1389,2,512,5,517,835,3,1,3,0,1,0,61.92
臺北縣,金山鄉,西湖村,1390,2,120,1,121,191,3,1,3,0,1,0,63.35
臺北縣,金山鄉,萬壽村,1391,2,294,1,295,467,3,1,3,0,1,0,63.17
臺北縣,金山鄉,永興村,1392,2,358,0,358,583,3,1,3,0,1,0,61.41
臺北縣,萬里鄉,萬里村,1393,2,1024,3,1027,1663,3,1,3,0,1,0,61.76
臺北縣,萬里鄉,萬里村,1394,2,840,7,847,1474,3,1,3,0,1,0,57.46
臺北縣,萬里鄉,北基村,1395,2,553,6,559,1020,3,1,3,0,1,0,54.8
臺北縣,萬里鄉,北基村,1396,2,480,9,489,929,3,1,3,0,1,0,52.64
臺北縣,萬里鄉,龜吼村,1397,2,272,5,277,581,3,1,3,0,1,0,47.68
臺北縣,萬里鄉,龜吼村,1398,2,626,13,639,1140,3,1,3,0,1,0,56.05
臺北縣,萬里鄉,野柳村,1399,2,706,5,711,1266,3,1,3,0,1,0,56.16
臺北縣,萬里鄉,野柳村,1400,2,658,3,661,1137,3,1,3,0,1,0,58.14
臺北縣,萬里鄉,大鵬村,1401,2,434,5,439,706,3,1,3,0,1,0,62.18
臺北縣,萬里鄉,大鵬村,1402,2,913,9,922,1489,3,1,3,0,1,0,61.92
臺北縣,萬里鄉,磺潭村,1403,2,307,4,311,469,3,1,3,0,1,0,66.31
臺北縣,萬里鄉,雙興村,1404,2,464,5,469,779,3,1,3,0,1,0,60.21
臺北縣,萬里鄉,溪底村,1405,2,301,1,302,528,3,1,3,0,1,0,57.2
臺北縣,萬里鄉,崁腳村,1406,2,298,4,302,554,3,1,3,0,1,0,54.51
臺北縣,萬里鄉,中幅村,1407,2,463,4,467,807,3,1,3,0,1,0,57.87
臺北縣,中和市,中原里,1408,3,888,8,896,1619,3,1,3,0,1,0,55.34
臺北縣,中和市,中原里,1409,3,419,3,422,745,3,1,3,0,1,0,56.64
臺北縣,中和市,中原里,1410,3,757,10,767,1503,3,1,3,0,1,0,51.03
臺北縣,中和市,連和里,1411,3,446,3,449,815,3,1,3,0,1,0,55.09
臺北縣,中和市,連和里,1412,3,225,0,225,339,3,1,3,0,1,0,66.37
臺北縣,中和市,連城里,1413,3,1073,4,1077,1805,3,1,3,0,1,0,59.67
臺北縣,中和市,連城里,1414,3,929,6,935,1401,3,1,3,0,1,0,66.74
臺北縣,中和市,連城里,1415,3,1006,5,1011,1816,3,1,3,0,1,0,55.67
臺北縣,中和市,力行里,1416,3,1033,2,1035,1728,3,1,3,0,1,0,59.90
臺北縣,中和市,力行里,1417,3,895,3,898,1469,3,1,3,0,1,0,61.13
臺北縣,中和市,力行里,1418,3,713,8,721,1151,3,1,3,0,1,0,62.64
臺北縣,中和市,正行里,1419,3,548,4,552,940,3,1,3,0,1,0,58.72
臺北縣,中和市,正行里,1420,3,728,5,733,1271,3,1,3,0,1,0,57.67
臺北縣,中和市,德行里,1421,3,1219,6,1225,2008,3,1,3,0,1,0,61.01
臺北縣,中和市,德行里,1422,3,960,6,966,1759,3,1,3,0,1,0,54.92
臺北縣,中和市,枋寮里,1423,3,860,4,864,1434,3,1,3,0,1,0,60.25
臺北縣,中和市,枋寮里,1424,3,927,8,935,1593,3,1,3,0,1,0,58.69
臺北縣,中和市,漳和里,1425,3,823,1,824,1324,3,1,3,0,1,0,62.24
臺北縣,中和市,漳和里,1426,3,895,3,898,1475,3,1,3,0,1,0,60.88
臺北縣,中和市,廟美里,1427,3,686,4,690,1155,3,1,3,0,1,0,59.74
臺北縣,中和市,廟美里,1428,3,680,6,686,1195,3,1,3,0,1,0,57.41
臺北縣,中和市,廟美里,1429,3,822,15,837,1493,3,1,3,0,1,0,56.06
臺北縣,中和市,福真里,1430,3,892,6,898,1634,3,1,3,0,1,0,54.96
臺北縣,中和市,福真里,1431,3,1023,10,1033,1748,3,1,3,0,1,0,59.10
臺北縣,中和市,福善里,1432,3,965,11,976,1626,3,1,3,0,1,0,60.02
臺北縣,中和市,福善里,1433,3,596,2,598,1043,3,1,3,0,1,0,57.33
臺北縣,中和市,福善里,1434,3,535,7,542,886,3,1,3,0,1,0,61.17
臺北縣,中和市,福美里,1435,3,987,7,994,1512,3,1,3,0,1,0,65.74
臺北縣,中和市,福美里,1436,3,764,4,768,1304,3,1,3,0,1,0,58.90
臺北縣,中和市,福美里,1437,3,669,8,677,1098,3,1,3,0,1,0,61.66
臺北縣,中和市,福祥里,1438,3,767,4,771,1257,3,1,3,0,1,0,61.34
臺北縣,中和市,福祥里,1439,3,609,3,612,1039,3,1,3,0,1,0,58.90
臺北縣,中和市,福祥里,1440,3,921,9,930,1605,3,1,3,0,1,0,57.94
臺北縣,中和市,瓦窯里,1441,3,517,10,527,971,3,1,3,0,1,0,54.27
臺北縣,中和市,瓦窯里,1442,3,834,7,841,1450,3,1,3,0,1,0,58.00
臺北縣,中和市,瓦窯里,1443,3,1028,6,1034,1769,3,1,3,0,1,0,58.45
臺北縣,中和市,福和里,1444,3,895,6,901,1492,3,1,3,0,1,0,60.39
臺北縣,中和市,福和里,1445,3,1017,6,1023,1750,3,1,3,0,1,0,58.46
臺北縣,中和市,佳和里,1446,3,944,7,951,1581,3,1,3,0,1,0,60.15
臺北縣,中和市,佳和里,1447,3,859,11,870,1428,3,1,3,0,1,0,60.92
臺北縣,中和市,佳和里,1448,3,616,4,620,1082,3,1,3,0,1,0,57.30
臺北縣,中和市,新南里,1449,3,976,5,981,1706,3,1,3,0,1,0,57.50
臺北縣,中和市,新南里,1450,3,848,5,853,1423,3,1,3,0,1,0,59.94
臺北縣,中和市,新南里,1451,3,948,6,954,1538,3,1,3,0,1,0,62.03
臺北縣,中和市,新南里,1452,3,929,2,931,1730,3,1,3,0,1,0,53.82
臺北縣,中和市,南山里,1453,3,843,7,850,1415,3,1,3,0,1,0,60.07
臺北縣,中和市,南山里,1454,3,778,6,784,1304,3,1,3,0,1,0,60.12
臺北縣,中和市,南山里,1455,3,766,3,769,1386,3,1,3,0,1,0,55.48
臺北縣,中和市,平河里,1456,3,1017,4,1021,1849,3,1,3,0,1,0,55.22
臺北縣,中和市,平河里,1457,3,852,4,856,1478,3,1,3,0,1,0,57.92
臺北縣,中和市,平河里,1458,3,841,4,845,1478,3,1,3,0,1,0,57.17
臺北縣,中和市,平河里,1459,3,566,3,569,967,3,1,3,0,1,0,58.84
臺北縣,中和市,平河里,1460,3,528,8,536,941,3,1,3,0,1,0,56.96
臺北縣,中和市,信和里,1461,3,614,5,619,1067,3,1,3,0,1,0,58.01
臺北縣,中和市,信和里,1462,3,770,7,777,1277,3,1,3,0,1,0,60.85
臺北縣,中和市,信和里,1463,3,817,5,822,1258,3,1,3,0,1,0,65.34
臺北縣,中和市,仁和里,1464,3,785,4,789,1372,3,1,3,0,1,0,57.51
臺北縣,中和市,仁和里,1465,3,561,7,568,940,3,1,3,0,1,0,60.43
臺北縣,中和市,仁和里,1466,3,683,9,692,1226,3,1,3,0,1,0,56.44
臺北縣,中和市,中正里,1467,3,1017,7,1024,1665,3,1,3,0,1,0,61.50
臺北縣,中和市,中正里,1468,3,993,7,1000,1718,3,1,3,0,1,0,58.21
臺北縣,中和市,中山里,1469,3,632,4,636,1015,3,1,3,0,1,0,62.66
臺北縣,中和市,中山里,1470,3,683,9,692,1146,3,1,3,0,1,0,60.38
臺北縣,中和市,建和里,1471,3,941,1,942,1367,3,1,3,0,1,0,68.91
臺北縣,中和市,建和里,1472,3,1158,9,1167,1906,3,1,3,0,1,0,61.23
臺北縣,中和市,碧河里,1473,3,774,9,783,1366,3,1,3,0,1,0,57.32
臺北縣,中和市,碧河里,1474,3,771,13,784,1313,3,1,3,0,1,0,59.71
臺北縣,中和市,宜安里,1475,3,1026,6,1032,1570,3,1,3,0,1,0,65.73
臺北縣,中和市,安樂里,1476,3,855,8,863,1414,3,1,3,0,1,0,61.03
臺北縣,中和市,安樂里,1477,3,1102,5,1107,1687,3,1,3,0,1,0,65.62
臺北縣,中和市,安和里,1478,3,841,6,847,1323,3,1,3,0,1,0,64.02
臺北縣,中和市,安和里,1479,3,707,3,710,1187,3,1,3,0,1,0,59.81
臺北縣,中和市,安順里,1480,3,733,3,736,1087,3,1,3,0,1,0,67.71
臺北縣,中和市,安順里,1481,3,566,3,569,898,3,1,3,0,1,0,63.36
臺北縣,中和市,安順里,1482,3,950,6,956,1524,3,1,3,0,1,0,62.73
臺北縣,中和市,安平里,1483,3,704,9,713,1122,3,1,3,0,1,0,63.55
臺北縣,中和市,安平里,1484,3,830,4,834,1249,3,1,3,0,1,0,66.77
臺北縣,中和市,安平里,1485,3,1047,6,1053,1651,3,1,3,0,1,0,63.78
臺北縣,中和市,中安里,1486,3,1084,1,1085,1637,3,1,3,0,1,0,66.28
臺北縣,中和市,中安里,1487,3,1163,4,1167,1820,3,1,3,0,1,0,64.12
臺北縣,中和市,泰安里,1488,3,695,6,701,1127,3,1,3,0,1,0,62.20
臺北縣,中和市,泰安里,1489,3,560,5,565,939,3,1,3,0,1,0,60.17
臺北縣,中和市,泰安里,1490,3,762,4,766,1201,3,1,3,0,1,0,63.78
臺北縣,中和市,秀山里,1491,3,1082,9,1091,1873,3,1,3,0,1,0,58.25
臺北縣,中和市,秀山里,1492,3,1094,7,1101,1827,3,1,3,0,1,0,60.26
臺北縣,中和市,秀成里,1493,3,847,5,852,1430,3,1,3,0,1,0,59.58
臺北縣,中和市,秀成里,1494,3,899,6,905,1514,3,1,3,0,1,0,59.78
臺北縣,中和市,秀義里,1495,3,766,6,772,1247,3,1,3,0,1,0,61.91
臺北縣,中和市,秀義里,1496,3,738,7,745,1093,3,1,3,0,1,0,68.16
臺北縣,中和市,秀福里,1497,3,1138,7,1145,1809,3,1,3,0,1,0,63.29
臺北縣,中和市,秀福里,1498,3,627,10,637,985,3,1,3,0,1,0,64.67
臺北縣,中和市,秀福里,1499,3,824,6,830,1281,3,1,3,0,1,0,64.79
臺北縣,中和市,秀景里,1500,3,981,6,987,1717,3,1,3,0,1,0,57.48
臺北縣,中和市,秀景里,1501,3,954,8,962,1645,3,1,3,0,1,0,58.48
臺北縣,中和市,秀景里,1502,3,482,6,488,811,3,1,3,0,1,0,60.17
臺北縣,中和市,秀景里,1503,3,749,4,753,1131,3,1,3,0,1,0,66.58
臺北縣,中和市,秀明里,1504,3,742,2,744,1234,3,1,3,0,1,0,60.29
臺北縣,中和市,秀明里,1505,3,1204,11,1215,1946,3,1,3,0,1,0,62.44
臺北縣,中和市,秀明里,1506,3,453,1,454,905,3,1,3,0,1,0,50.17
臺北縣,中和市,秀峰里,1507,3,854,4,858,1349,3,1,3,0,1,0,63.60
臺北縣,中和市,秀峰里,1508,3,614,5,619,1023,3,1,3,0,1,0,60.51
臺北縣,中和市,秀峰里,1509,3,600,6,606,1031,3,1,3,0,1,0,58.78
臺北縣,中和市,秀士里,1510,3,591,6,597,999,3,1,3,0,1,0,59.76
臺北縣,中和市,秀士里,1511,3,720,7,727,1176,3,1,3,0,1,0,61.82
臺北縣,中和市,秀水里,1512,3,669,7,676,1140,3,1,3,0,1,0,59.30
臺北縣,中和市,秀水里,1513,3,661,6,667,1122,3,1,3,0,1,0,59.45
臺北縣,中和市,秀水里,1514,3,754,2,756,1168,3,1,3,0,1,0,64.73
臺北縣,中和市,秀仁里,1515,3,729,10,739,1219,3,1,3,0,1,0,60.62
臺北縣,中和市,秀仁里,1516,3,685,4,689,1154,3,1,3,0,1,0,59.71
臺北縣,中和市,正南里,1517,3,670,8,678,1172,3,1,3,0,1,0,57.85
臺北縣,中和市,正南里,1518,3,559,6,565,925,3,1,3,0,1,0,61.08
臺北縣,中和市,正南里,1519,3,641,5,646,1099,3,1,3,0,1,0,58.78
臺北縣,中和市,頂南里,1520,3,738,4,742,1185,3,1,3,0,1,0,62.62
臺北縣,中和市,頂南里,1521,3,885,5,890,1432,3,1,3,0,1,0,62.15
臺北縣,中和市,華新里,1522,3,738,8,746,1451,3,1,3,0,1,0,51.41
臺北縣,中和市,華新里,1523,3,760,3,763,1438,3,1,3,0,1,0,53.06
臺北縣,中和市,華新里,1524,3,778,8,786,1356,3,1,3,0,1,0,57.96
臺北縣,中和市,華新里,1525,3,718,4,722,1370,3,1,3,0,1,0,52.70
臺北縣,中和市,東南里,1526,3,702,3,705,1039,3,1,3,0,1,0,67.85
臺北縣,中和市,東南里,1527,3,881,4,885,1401,3,1,3,0,1,0,63.17
臺北縣,中和市,東南里,1528,3,958,5,963,1447,3,1,3,0,1,0,66.55
臺北縣,中和市,華南里,1529,3,1124,13,1137,1822,3,1,3,0,1,0,62.40
臺北縣,中和市,華南里,1530,3,949,8,957,1545,3,1,3,0,1,0,61.94
臺北縣,中和市,忠孝里,1531,3,509,6,515,891,3,1,3,0,1,0,57.80
臺北縣,中和市,忠孝里,1532,3,536,5,541,877,3,1,3,0,1,0,61.69
臺北縣,中和市,忠孝里,1533,3,810,8,818,1291,3,1,3,0,1,0,63.36
臺北縣,中和市,忠孝里,1534,3,744,8,752,1344,3,1,3,0,1,0,55.95
臺北縣,中和市,崇南里,1535,3,904,0,904,1488,3,1,3,0,1,0,60.75
臺北縣,中和市,崇南里,1536,3,991,8,999,1596,3,1,3,0,1,0,62.59
臺北縣,中和市,興南里,1537,3,871,8,879,1420,3,1,3,0,1,0,61.90
臺北縣,中和市,興南里,1538,3,857,7,864,1429,3,1,3,0,1,0,60.46
臺北縣,中和市,景南里,1539,3,706,3,709,1111,3,1,3,0,1,0,63.82
臺北縣,中和市,景南里,1540,3,973,4,977,1627,3,1,3,0,1,0,60.05
臺北縣,中和市,景本里,1541,3,557,2,559,875,3,1,3,0,1,0,63.89
臺北縣,中和市,景本里,1542,3,694,4,698,1069,3,1,3,0,1,0,65.29
臺北縣,中和市,橫路里,1543,3,214,3,217,329,3,1,3,0,1,0,65.96
臺北縣,中和市,內南里,1544,3,785,9,794,1324,3,1,3,0,1,0,59.97
臺北縣,中和市,內南里,1545,3,781,4,785,1333,3,1,3,0,1,0,58.89
臺北縣,中和市,內南里,1546,3,856,8,864,1510,3,1,3,0,1,0,57.22
臺北縣,中和市,壽南里,1547,3,909,7,916,1365,3,1,3,0,1,0,67.11
臺北縣,中和市,壽南里,1548,3,470,3,473,798,3,1,3,0,1,0,59.27
臺北縣,中和市,福南里,1549,3,1005,10,1015,1622,3,1,3,0,1,0,62.58
臺北縣,中和市,福南里,1550,3,934,8,942,1565,3,1,3,0,1,0,60.19
臺北縣,中和市,外南里,1551,3,869,7,876,2205,3,1,3,0,1,0,39.73
臺北縣,中和市,外南里,1552,3,1035,7,1042,1849,3,1,3,0,1,0,56.35
臺北縣,中和市,中興里,1553,3,835,3,838,1445,3,1,3,0,1,0,57.99
臺北縣,中和市,中興里,1554,3,649,5,654,1280,3,1,3,0,1,0,51.09
臺北縣,中和市,中興里,1555,3,729,6,735,1172,3,1,3,0,1,0,62.71
臺北縣,中和市,吉興里,1556,3,660,10,670,1044,3,1,3,0,1,0,64.18
臺北縣,中和市,吉興里,1557,3,568,3,571,976,3,1,3,0,1,0,58.50
臺北縣,中和市,復興里,1558,3,980,8,988,1658,3,1,3,0,1,0,59.59
臺北縣,中和市,復興里,1559,3,863,6,869,1551,3,1,3,0,1,0,56.03
臺北縣,中和市,復興里,1560,3,841,5,846,1393,3,1,3,0,1,0,60.73
臺北縣,中和市,和興里,1561,3,1202,8,1210,1993,3,1,3,0,1,0,60.71
臺北縣,中和市,和興里,1562,3,1051,12,1063,1737,3,1,3,0,1,0,61.20
臺北縣,中和市,景平里,1563,3,1074,9,1083,1788,3,1,3,0,1,0,60.57
臺北縣,中和市,景平里,1564,3,712,12,724,1230,3,1,3,0,1,0,58.86
臺北縣,中和市,景平里,1565,3,572,4,576,943,3,1,3,0,1,0,61.08
臺北縣,中和市,景新里,1566,3,941,5,946,1582,3,1,3,0,1,0,59.80
臺北縣,中和市,景新里,1567,3,1001,10,1011,1583,3,1,3,0,1,0,63.87
臺北縣,中和市,景福里,1568,3,915,15,930,1552,3,1,3,0,1,0,59.92
臺北縣,中和市,景福里,1569,3,736,4,740,1204,3,1,3,0,1,0,61.46
臺北縣,中和市,景福里,1570,3,908,12,920,1480,3,1,3,0,1,0,62.16
臺北縣,中和市,景安里,1571,3,480,2,482,774,3,1,3,0,1,0,62.27
臺北縣,中和市,景安里,1572,3,710,2,712,1170,3,1,3,0,1,0,60.85
臺北縣,中和市,景安里,1573,3,811,8,819,1303,3,1,3,0,1,0,62.85
臺北縣,中和市,景安里,1574,3,595,1,596,941,3,1,3,0,1,0,63.34
臺北縣,中和市,景文里,1575,3,944,3,947,1543,3,1,3,0,1,0,61.37
臺北縣,中和市,景文里,1576,3,664,7,671,1111,3,1,3,0,1,0,60.40
臺北縣,中和市,錦和里,1577,3,880,3,883,1427,3,1,3,0,1,0,61.88
臺北縣,中和市,錦和里,1578,3,766,5,771,1388,3,1,3,0,1,0,55.55
臺北縣,中和市,錦中里,1579,3,607,6,613,1166,3,1,3,0,1,0,52.57
臺北縣,中和市,錦中里,1580,3,1003,4,1007,1776,3,1,3,0,1,0,56.70
臺北縣,中和市,錦中里,1581,3,750,6,756,1296,3,1,3,0,1,0,58.33
臺北縣,中和市,錦昌里,1582,3,840,11,851,1423,3,1,3,0,1,0,59.80
臺北縣,中和市,錦盛里,1583,3,1099,9,1108,1854,3,1,3,0,1,0,59.76
臺北縣,中和市,錦盛里,1584,3,790,6,796,1347,3,1,3,0,1,0,59.09
臺北縣,中和市,灰窯里,1585,3,322,1,323,518,3,1,3,0,1,0,62.36
臺北縣,中和市,積穗里,1586,3,863,5,868,1469,3,1,3,0,1,0,59.09
臺北縣,中和市,積穗里,1587,3,893,14,907,1462,3,1,3,0,1,0,62.04
臺北縣,中和市,積穗里,1588,3,577,6,583,1048,3,1,3,0,1,0,55.63
臺北縣,中和市,積穗里,1589,3,352,1,353,584,3,1,3,0,1,0,60.45
臺北縣,中和市,民享里,1590,3,724,6,730,1063,3,1,3,0,1,0,68.67
臺北縣,中和市,民享里,1591,3,780,3,783,1177,3,1,3,0,1,0,66.53
臺北縣,中和市,民有里,1592,3,814,5,819,1374,3,1,3,0,1,0,59.61
臺北縣,中和市,民有里,1593,3,692,5,697,1184,3,1,3,0,1,0,58.87
臺北縣,中和市,員山里,1594,3,738,11,749,1269,3,1,3,0,1,0,59.02
臺北縣,中和市,員山里,1595,3,864,5,869,1552,3,1,3,0,1,0,55.99
臺北縣,中和市,員山里,1596,3,437,2,439,781,3,1,3,0,1,0,56.21
臺北縣,中和市,員富里,1597,3,357,10,367,1122,3,1,3,0,1,0,32.71
臺北縣,中和市,員富里,1598,3,731,14,745,1435,3,1,3,0,1,0,51.92
臺北縣,中和市,嘉穗里,1599,3,756,8,764,1217,3,1,3,0,1,0,62.78
臺北縣,中和市,嘉穗里,1600,3,546,2,548,982,3,1,3,0,1,0,55.80
臺北縣,中和市,嘉慶里,1601,3,858,6,864,1565,3,1,3,0,1,0,55.21
臺北縣,中和市,嘉慶里,1602,3,891,6,897,1758,3,1,3,0,1,0,51.02
臺北縣,中和市,文元里,1603,3,654,6,660,1235,3,1,3,0,1,0,53.44
臺北縣,中和市,文元里,1604,3,919,4,923,1633,3,1,3,0,1,0,56.52
臺北縣,中和市,文元里,1605,3,1053,2,1055,1765,3,1,3,0,1,0,59.77
臺北縣,中和市,嘉新里,1606,3,806,10,816,1446,3,1,3,0,1,0,56.43
臺北縣,中和市,嘉新里,1607,3,949,7,956,1664,3,1,3,0,1,0,57.45
臺北縣,中和市,民安里,1608,3,820,7,827,1351,3,1,3,0,1,0,61.21
臺北縣,中和市,民安里,1609,3,653,7,660,1137,3,1,3,0,1,0,58.05
臺北縣,中和市,民安里,1610,3,772,9,781,1409,3,1,3,0,1,0,55.43
臺北縣,中和市,安穗里,1611,3,826,10,836,1370,3,1,3,0,1,0,61.02
臺北縣,中和市,安穗里,1612,3,1020,9,1029,1654,3,1,3,0,1,0,62.21
臺北縣,中和市,瑞穗里,1613,3,530,2,532,883,3,1,3,0,1,0,60.25
臺北縣,中和市,瑞穗里,1614,3,596,3,599,944,3,1,3,0,1,0,63.45
臺北縣,中和市,冠穗里,1615,3,919,8,927,1621,3,1,3,0,1,0,57.19
臺北縣,中和市,冠穗里,1616,3,853,8,861,1336,3,1,3,0,1,0,64.45
臺北縣,中和市,明穗里,1617,3,979,6,985,1625,3,1,3,0,1,0,60.62
臺北縣,中和市,明穗里,1618,3,1024,8,1032,1716,3,1,3,0,1,0,60.14
臺北縣,中和市,清穗里,1619,3,803,10,813,1394,3,1,3,0,1,0,58.32
臺北縣,中和市,清穗里,1620,3,762,7,769,1383,3,1,3,0,1,0,55.60
臺北縣,中和市,自強里,1621,3,586,8,594,1110,3,1,3,0,1,0,53.51
臺北縣,中和市,自強里,1622,3,821,9,830,1548,3,1,3,0,1,0,53.62
臺北縣,中和市,自強里,1623,3,739,7,746,1339,3,1,3,0,1,0,55.71
臺北縣,中和市,德穗里,1624,3,865,6,871,1418,3,1,3,0,1,0,61.42
臺北縣,中和市,德穗里,1625,3,608,4,612,1160,3,1,3,0,1,0,52.76
臺北縣,中和市,德穗里,1626,3,613,2,615,1116,3,1,3,0,1,0,55.11
臺北縣,中和市,民生里,1627,3,967,7,974,1641,3,1,3,0,1,0,59.35
臺北縣,中和市,民生里,1628,3,1074,9,1083,1905,3,1,3,0,1,0,56.85
臺北縣,中和市,國光里,1629,3,808,10,818,1477,3,1,3,0,1,0,55.38
臺北縣,中和市,國光里,1630,3,993,7,1000,1681,3,1,3,0,1,0,59.49
臺北縣,中和市,國華里,1631,3,614,7,621,1081,3,1,3,0,1,0,57.45
臺北縣,中和市,國華里,1632,3,807,7,814,1518,3,1,3,0,1,0,53.62
臺北縣,中和市,壽德里,1633,3,496,1,497,856,3,1,3,0,1,0,58.06
臺北縣,中和市,壽德里,1634,3,901,2,903,1362,3,1,3,0,1,0,66.30
臺北縣,中和市,壽德里,1635,3,838,5,843,1253,3,1,3,0,1,0,67.28
臺北縣,中和市,明德里,1636,3,1026,12,1038,1886,3,1,3,0,1,0,55.04
臺北縣,中和市,明德里,1637,3,881,12,893,1463,3,1,3,0,1,0,61.04
臺北縣,永和市,光復里,1638,3,910,3,913,1472,3,1,3,0,1,0,62.02
臺北縣,永和市,網溪里,1639,3,636,9,645,1054,3,1,3,0,1,0,61.20
臺北縣,永和市,復興里,1640,3,546,6,552,892,3,1,3,0,1,0,61.88
臺北縣,永和市,復興里,1641,3,747,4,751,1258,3,1,3,0,1,0,59.70
臺北縣,永和市,竹林里,1642,3,1023,9,1032,1678,3,1,3,0,1,0,61.50
臺北縣,永和市,竹林里,1643,3,1003,8,1011,1687,3,1,3,0,1,0,59.93
臺北縣,永和市,桂林里,1644,3,996,5,1001,1654,3,1,3,0,1,0,60.52
臺北縣,永和市,桂林里,1645,3,880,9,889,1527,3,1,3,0,1,0,58.22
臺北縣,永和市,上林里,1646,3,982,6,988,1575,3,1,3,0,1,0,62.73
臺北縣,永和市,上林里,1647,3,974,7,981,1588,3,1,3,0,1,0,61.78
臺北縣,永和市,福林里,1648,3,959,6,965,1544,3,1,3,0,1,0,62.50
臺北縣,永和市,福林里,1649,3,895,5,900,1519,3,1,3,0,1,0,59.25
臺北縣,永和市,勵行里,1650,3,688,7,695,1079,3,1,3,0,1,0,64.41
臺北縣,永和市,中興里,1651,3,705,1,706,1078,3,1,3,0,1,0,65.49
臺北縣,永和市,中興里,1652,3,860,2,862,1482,3,1,3,0,1,0,58.16
臺北縣,永和市,永興里,1653,3,873,4,877,1469,3,1,3,0,1,0,59.70
臺北縣,永和市,永興里,1654,3,856,4,860,1467,3,1,3,0,1,0,58.62
臺北縣,永和市,正興里,1655,3,650,5,655,1096,3,1,3,0,1,0,59.76
臺北縣,永和市,正興里,1656,3,564,7,571,946,3,1,3,0,1,0,60.36
臺北縣,永和市,豫溪里,1657,3,941,6,947,1619,3,1,3,0,1,0,58.49
臺北縣,永和市,豫溪里,1658,3,893,6,899,2285,3,1,3,0,1,0,39.34
臺北縣,永和市,光明里,1659,3,826,3,829,1262,3,1,3,0,1,0,65.69
臺北縣,永和市,光明里,1660,3,866,0,866,1413,3,1,3,0,1,0,61.29
臺北縣,永和市,福和里,1661,3,730,7,737,1253,3,1,3,0,1,0,58.82
臺北縣,永和市,福和里,1662,3,908,2,910,1596,3,1,3,0,1,0,57.02
臺北縣,永和市,福和里,1663,3,700,3,703,1210,3,1,3,0,1,0,58.10
臺北縣,永和市,得和里,1664,3,868,2,870,1386,3,1,3,0,1,0,62.77
臺北縣,永和市,得和里,1665,3,787,8,795,1243,3,1,3,0,1,0,63.96
臺北縣,永和市,得和里,1666,3,692,8,700,1135,3,1,3,0,1,0,61.67
臺北縣,永和市,永貞里,1667,3,946,6,952,1623,3,1,3,0,1,0,58.66
臺北縣,永和市,永貞里,1668,3,865,10,875,1473,3,1,3,0,1,0,59.40
臺北縣,永和市,永福里,1669,3,799,7,806,1308,3,1,3,0,1,0,61.62
臺北縣,永和市,永福里,1670,3,780,5,785,1260,3,1,3,0,1,0,62.30
臺北縣,永和市,河濱里,1671,3,851,2,853,1372,3,1,3,0,1,0,62.17
臺北縣,永和市,河濱里,1672,3,713,4,717,1176,3,1,3,0,1,0,60.97
臺北縣,永和市,秀和里,1673,3,1030,6,1036,1642,3,1,3,0,1,0,63.09
臺北縣,永和市,秀和里,1674,3,690,6,696,1169,3,1,3,0,1,0,59.54
臺北縣,永和市,秀和里,1675,3,665,3,668,1156,3,1,3,0,1,0,57.79
臺北縣,永和市,永元里,1676,3,823,5,828,1359,3,1,3,0,1,0,60.93
臺北縣,永和市,永元里,1677,3,740,7,747,1226,3,1,3,0,1,0,60.93
臺北縣,永和市,永元里,1678,3,880,7,887,1463,3,1,3,0,1,0,60.63
臺北縣,永和市,民權里,1679,3,774,6,780,1340,3,1,3,0,1,0,58.21
臺北縣,永和市,民權里,1680,3,824,9,833,1403,3,1,3,0,1,0,59.37
臺北縣,永和市,民權里,1681,3,670,2,672,1120,3,1,3,0,1,0,60.00
臺北縣,永和市,民族里,1682,3,698,4,702,1169,3,1,3,0,1,0,60.05
臺北縣,永和市,民族里,1683,3,893,3,896,1431,3,1,3,0,1,0,62.61
臺北縣,永和市,民族里,1684,3,736,4,740,1181,3,1,3,0,1,0,62.66
臺北縣,永和市,秀朗里,1685,3,994,10,1004,1678,3,1,3,0,1,0,59.83
臺北縣,永和市,秀朗里,1686,3,928,10,938,1655,3,1,3,0,1,0,56.68
臺北縣,永和市,秀成里,1687,3,754,2,756,1274,3,1,3,0,1,0,59.34
臺北縣,永和市,秀成里,1688,3,762,8,770,1239,3,1,3,0,1,0,62.15
臺北縣,永和市,秀林里,1689,3,1039,8,1047,1690,3,1,3,0,1,0,61.95
臺北縣,永和市,秀林里,1690,3,808,4,812,1263,3,1,3,0,1,0,64.29
臺北縣,永和市,秀得里,1691,3,693,0,693,1150,3,1,3,0,1,0,60.26
臺北縣,永和市,秀得里,1692,3,662,6,668,1143,3,1,3,0,1,0,58.44
臺北縣,永和市,秀元里,1693,3,854,1,855,1387,3,1,3,0,1,0,61.64
臺北縣,永和市,秀元里,1694,3,804,2,806,1339,3,1,3,0,1,0,60.19
臺北縣,永和市,民生里,1695,3,670,3,673,1079,3,1,3,0,1,0,62.37
臺北縣,永和市,民生里,1696,3,695,3,698,1161,3,1,3,0,1,0,60.12
臺北縣,永和市,民生里,1697,3,743,7,750,1181,3,1,3,0,1,0,63.51
臺北縣,永和市,民本里,1698,3,708,4,712,1210,3,1,3,0,1,0,58.84
臺北縣,永和市,民本里,1699,3,714,3,717,1316,3,1,3,0,1,0,54.48
臺北縣,永和市,民富里,1700,3,810,3,813,1341,3,1,3,0,1,0,60.63
臺北縣,永和市,民富里,1701,3,714,4,718,1164,3,1,3,0,1,0,61.68
臺北縣,永和市,民樂里,1702,3,1286,12,1298,2050,3,1,3,0,1,0,63.32
臺北縣,永和市,民樂里,1703,3,1076,5,1081,1787,3,1,3,0,1,0,60.49
臺北縣,永和市,民治里,1704,3,760,10,770,1294,3,1,3,0,1,0,59.51
臺北縣,永和市,民治里,1705,3,753,3,756,1329,3,1,3,0,1,0,56.88
臺北縣,永和市,智光里,1706,3,885,6,891,1462,3,1,3,0,1,0,60.94
臺北縣,永和市,智光里,1707,3,878,5,883,1474,3,1,3,0,1,0,59.91
臺北縣,永和市,潭安里,1708,3,1081,11,1092,1760,3,1,3,0,1,0,62.05
臺北縣,永和市,潭安里,1709,3,715,1,716,1180,3,1,3,0,1,0,60.68
臺北縣,永和市,潭安里,1710,3,648,5,653,1083,3,1,3,0,1,0,60.30
臺北縣,永和市,潭墘里,1711,3,725,6,731,1179,3,1,3,0,1,0,62.00
臺北縣,永和市,潭墘里,1712,3,759,3,762,1265,3,1,3,0,1,0,60.24
臺北縣,永和市,潭墘里,1713,3,630,2,632,1101,3,1,3,0,1,0,57.40
臺北縣,永和市,店街里,1714,3,905,5,910,1493,3,1,3,0,1,0,60.95
臺北縣,永和市,店街里,1715,3,966,4,970,1707,3,1,3,0,1,0,56.82
臺北縣,永和市,大新里,1716,3,662,0,662,1065,3,1,3,0,1,0,62.16
臺北縣,永和市,大新里,1717,3,675,6,681,1100,3,1,3,0,1,0,61.91
臺北縣,永和市,永安里,1718,3,1064,5,1069,1784,3,1,3,0,1,0,59.92
臺北縣,永和市,永安里,1719,3,1047,6,1053,1747,3,1,3,0,1,0,60.27
臺北縣,永和市,永樂里,1720,3,624,2,626,1034,3,1,3,0,1,0,60.54
臺北縣,永和市,永樂里,1721,3,622,5,627,1044,3,1,3,0,1,0,60.06
臺北縣,永和市,水源里,1722,3,1085,7,1092,1800,3,1,3,0,1,0,60.67
臺北縣,永和市,水源里,1723,3,1044,11,1055,1664,3,1,3,0,1,0,63.40
臺北縣,永和市,協和里,1724,3,716,5,721,1254,3,1,3,0,1,0,57.50
臺北縣,永和市,協和里,1725,3,846,9,855,1349,3,1,3,0,1,0,63.38
臺北縣,永和市,雙和里,1726,3,994,8,1002,1715,3,1,3,0,1,0,58.43
臺北縣,永和市,雙和里,1727,3,1018,2,1020,1575,3,1,3,0,1,0,64.76
臺北縣,永和市,安和里,1728,3,955,11,966,1602,3,1,3,0,1,0,60.30
臺北縣,永和市,安和里,1729,3,977,5,982,1521,3,1,3,0,1,0,64.56
臺北縣,永和市,前溪里,1730,3,1066,7,1073,1750,3,1,3,0,1,0,61.31
臺北縣,永和市,和平里,1731,3,1111,8,1119,1812,3,1,3,0,1,0,61.75
臺北縣,永和市,和平里,1732,3,1141,6,1147,1866,3,1,3,0,1,0,61.47
臺北縣,永和市,保平里,1733,3,628,7,635,1053,3,1,3,0,1,0,60.30
臺北縣,永和市,保平里,1734,3,913,6,919,1497,3,1,3,0,1,0,61.39
臺北縣,永和市,保平里,1735,3,815,7,822,1356,3,1,3,0,1,0,60.62
臺北縣,永和市,中溪里,1736,3,854,7,861,1428,3,1,3,0,1,0,60.29
臺北縣,永和市,中溪里,1737,3,783,7,790,1250,3,1,3,0,1,0,63.20
臺北縣,永和市,中溪里,1738,3,934,11,945,1517,3,1,3,0,1,0,62.29
臺北縣,永和市,保安里,1739,3,1045,8,1053,1809,3,1,3,0,1,0,58.21
臺北縣,永和市,保安里,1740,3,708,5,713,1128,3,1,3,0,1,0,63.21
臺北縣,永和市,保安里,1741,3,747,3,750,1178,3,1,3,0,1,0,63.67
臺北縣,永和市,保安里,1742,3,805,1,806,1315,3,1,3,0,1,0,61.29
臺北縣,永和市,保順里,1743,3,967,7,974,1763,3,1,3,0,1,0,55.25
臺北縣,永和市,保順里,1744,3,954,1,955,1635,3,1,3,0,1,0,58.41
臺北縣,永和市,保順里,1745,3,1026,4,1030,1950,3,1,3,0,1,0,52.82
臺北縣,永和市,下溪里,1746,3,969,7,976,1550,3,1,3,0,1,0,62.97
臺北縣,永和市,下溪里,1747,3,1020,7,1027,1737,3,1,3,0,1,0,59.12
臺北縣,永和市,大同里,1748,3,603,7,610,891,3,1,3,0,1,0,68.46
臺北縣,永和市,新生里,1749,3,467,6,473,766,3,1,3,0,1,0,61.75
臺北縣,永和市,永成里,1750,3,582,8,590,923,3,1,3,0,1,0,63.92
臺北縣,永和市,忠義里,1751,3,460,3,463,696,3,1,3,0,1,0,66.52
臺北縣,永和市,文化里,1752,3,623,8,631,1047,3,1,3,0,1,0,60.27
臺北縣,永和市,文化里,1753,3,851,6,857,1330,3,1,3,0,1,0,64.44
臺北縣,永和市,仁愛里,1754,3,600,7,607,1003,3,1,3,0,1,0,60.52
臺北縣,永和市,仁愛里,1755,3,696,4,700,1199,3,1,3,0,1,0,58.38
臺北縣,永和市,信義里,1756,3,701,5,706,1134,3,1,3,0,1,0,62.26
臺北縣,永和市,信義里,1757,3,632,6,638,1002,3,1,3,0,1,0,63.67
臺北縣,永和市,後溪里,1758,3,936,11,947,1606,3,1,3,0,1,0,58.97
臺北縣,永和市,上溪里,1759,3,398,5,403,692,3,1,3,0,1,0,58.24
臺北縣,永和市,上溪里,1760,3,613,2,615,1058,3,1,3,0,1,0,58.13
臺北縣,永和市,頂溪里,1761,3,722,7,729,1171,3,1,3,0,1,0,62.25
臺北縣,永和市,頂溪里,1762,3,642,3,645,1002,3,1,3,0,1,0,64.37
臺北縣,永和市,河堤里,1763,3,605,6,611,971,3,1,3,0,1,0,62.92
臺北縣,永和市,河堤里,1764,3,724,2,726,1221,3,1,3,0,1,0,59.46
臺北縣,永和市,新部里,1765,3,575,8,583,947,3,1,3,0,1,0,61.56
臺北縣,永和市,新部里,1766,3,755,3,758,1180,3,1,3,0,1,0,64.24
臺北縣,新店市,新店里,1767,3,852,7,859,1465,3,1,3,0,1,0,58.63
臺北縣,新店市,張南里,1768,3,659,3,662,1126,3,1,3,0,1,0,58.79
臺北縣,新店市,國校里,1769,3,738,7,745,1337,3,1,3,0,1,0,55.72
臺北縣,新店市,國校里,1770,3,511,4,515,907,3,1,3,0,1,0,56.78
臺北縣,新店市,文中里,1771,3,839,9,848,1392,3,1,3,0,1,0,60.92
臺北縣,新店市,廣明里,1772,3,450,5,455,691,3,1,3,0,1,0,65.85
臺北縣,新店市,文明里,1773,3,680,2,682,1038,3,1,3,0,1,0,65.70
臺北縣,新店市,文明里,1774,3,717,2,719,1053,3,1,3,0,1,0,68.28
臺北縣,新店市,中興里,1775,3,916,5,921,1385,3,1,3,0,1,0,66.50
臺北縣,新店市,中興里,1776,3,354,2,356,1649,3,1,3,0,1,0,21.59
臺北縣,新店市,中興里,1777,3,803,2,805,1276,3,1,3,0,1,0,63.09
臺北縣,新店市,中興里,1778,3,748,2,750,1290,3,1,3,0,1,0,58.14
臺北縣,新店市,新生里,1779,3,1102,2,1104,1652,3,1,3,0,1,0,66.83
臺北縣,新店市,新生里,1780,3,978,3,981,1596,3,1,3,0,1,0,61.47
臺北縣,新店市,新生里,1781,3,1038,6,1044,1647,3,1,3,0,1,0,63.39
臺北縣,新店市,新德里,1782,3,684,5,689,1130,3,1,3,0,1,0,60.97
臺北縣,新店市,新德里,1783,3,688,9,697,1146,3,1,3,0,1,0,60.82
臺北縣,新店市,張北里,1784,3,749,9,758,1385,3,1,3,0,1,0,54.73
臺北縣,新店市,張北里,1785,3,878,5,883,1450,3,1,3,0,1,0,60.90
臺北縣,新店市,張北里,1786,3,817,2,819,1415,3,1,3,0,1,0,57.88
臺北縣,新店市,張北里,1787,3,748,3,751,1233,3,1,3,0,1,0,60.91
臺北縣,新店市,五峰里,1788,3,868,6,874,1371,3,1,3,0,1,0,63.75
臺北縣,新店市,五峰里,1789,3,897,11,908,1557,3,1,3,0,1,0,58.32
臺北縣,新店市,五峰里,1790,3,922,5,927,1502,3,1,3,0,1,0,61.72
臺北縣,新店市,五峰里,1791,3,762,3,765,1364,3,1,3,0,1,0,56.09
臺北縣,新店市,長春里,1792,3,655,2,657,1048,3,1,3,0,1,0,62.69
臺北縣,新店市,長春里,1793,3,528,13,541,924,3,1,3,0,1,0,58.55
臺北縣,新店市,新安里,1794,3,867,12,879,1417,3,1,3,0,1,0,62.03
臺北縣,新店市,新安里,1795,3,912,2,914,1572,3,1,3,0,1,0,58.14
臺北縣,新店市,忠誠里,1796,3,691,8,699,1129,3,1,3,0,1,0,61.91
臺北縣,新店市,忠誠里,1797,3,670,1,671,1080,3,1,3,0,1,0,62.13
臺北縣,新店市,中正里,1798,3,824,1,825,1308,3,1,3,0,1,0,63.07
臺北縣,新店市,中正里,1799,3,893,3,896,1541,3,1,3,0,1,0,58.14
臺北縣,新店市,中正里,1800,3,846,4,850,1397,3,1,3,0,1,0,60.84
臺北縣,新店市,中正里,1801,3,704,7,711,1303,3,1,3,0,1,0,54.57
臺北縣,新店市,中華里,1802,3,610,1,611,1045,3,1,3,0,1,0,58.47
臺北縣,新店市,中華里,1803,3,707,3,710,1122,3,1,3,0,1,0,63.28
臺北縣,新店市,中華里,1804,3,572,7,579,991,3,1,3,0,1,0,58.43
臺北縣,新店市,仁愛里,1805,3,669,3,672,1120,3,1,3,0,1,0,60.00
臺北縣,新店市,仁愛里,1806,3,575,5,580,938,3,1,3,0,1,0,61.83
臺北縣,新店市,建國里,1807,3,640,4,644,1018,3,1,3,0,1,0,63.26
臺北縣,新店市,建國里,1808,3,909,7,916,1494,3,1,3,0,1,0,61.31
臺北縣,新店市,百忍里,1809,3,615,1,616,953,3,1,3,0,1,0,64.64
臺北縣,新店市,百忍里,1810,3,703,1,704,1115,3,1,3,0,1,0,63.14
臺北縣,新店市,百忍里,1811,3,796,5,801,1281,3,1,3,0,1,0,62.53
臺北縣,新店市,百和里,1812,3,795,1,796,1275,3,1,3,0,1,0,62.43
臺北縣,新店市,百和里,1813,3,925,6,931,1554,3,1,3,0,1,0,59.91
臺北縣,新店市,福德里,1814,3,832,9,841,1378,3,1,3,0,1,0,61.03
臺北縣,新店市,福德里,1815,3,528,4,532,933,3,1,3,0,1,0,57.02
臺北縣,新店市,福德里,1816,3,606,3,609,1023,3,1,3,0,1,0,59.53
臺北縣,新店市,百福里,1817,3,749,5,754,1179,3,1,3,0,1,0,63.95
臺北縣,新店市,百福里,1818,3,799,2,801,1317,3,1,3,0,1,0,60.82
臺北縣,新店市,福民里,1819,3,1096,1,1097,1729,3,1,3,0,1,0,63.45
臺北縣,新店市,福民里,1820,3,997,7,1004,1685,3,1,3,0,1,0,59.58
臺北縣,新店市,中山里,1821,3,862,2,864,1413,3,1,3,0,1,0,61.15
臺北縣,新店市,中山里,1822,3,1034,4,1038,1923,3,1,3,0,1,0,53.98
臺北縣,新店市,和平里,1823,3,523,2,525,802,3,1,3,0,1,0,65.46
臺北縣,新店市,中央里,1824,3,1122,4,1126,1806,3,1,3,0,1,0,62.35
臺北縣,新店市,中央里,1825,3,1136,2,1138,1812,3,1,3,0,1,0,62.80
臺北縣,新店市,國豐里,1826,3,659,1,660,1016,3,1,3,0,1,0,64.96
臺北縣,新店市,國豐里,1827,3,543,2,545,936,3,1,3,0,1,0,58.23
臺北縣,新店市,國豐里,1828,3,623,2,625,1016,3,1,3,0,1,0,61.52
臺北縣,新店市,明德里,1829,3,760,6,766,1219,3,1,3,0,1,0,62.84
臺北縣,新店市,明德里,1830,3,637,3,640,1060,3,1,3,0,1,0,60.38
臺北縣,新店市,明德里,1831,3,781,6,787,1291,3,1,3,0,1,0,60.96
臺北縣,新店市,大豐里,1832,3,953,4,957,1628,3,1,3,0,1,0,58.78
臺北縣,新店市,大豐里,1833,3,947,3,950,1555,3,1,3,0,1,0,61.09
臺北縣,新店市,大同里,1834,3,1067,9,1076,1695,3,1,3,0,1,0,63.48
臺北縣,新店市,大同里,1835,3,1054,2,1056,1623,3,1,3,0,1,0,65.06
臺北縣,新店市,江陵里,1836,3,782,0,782,1245,3,1,3,0,1,0,62.81
臺北縣,新店市,江陵里,1837,3,732,4,736,1174,3,1,3,0,1,0,62.69
臺北縣,新店市,江陵里,1838,3,855,2,857,1396,3,1,3,0,1,0,61.39
臺北縣,新店市,復興里,1839,3,788,4,792,1448,3,1,3,0,1,0,54.70
臺北縣,新店市,復興里,1840,3,881,5,886,1589,3,1,3,0,1,0,55.76
臺北縣,新店市,寶興里,1841,3,701,3,704,1150,3,1,3,0,1,0,61.22
臺北縣,新店市,寶興里,1842,3,813,3,816,1398,3,1,3,0,1,0,58.37
臺北縣,新店市,寶興里,1843,3,728,8,736,1246,3,1,3,0,1,0,59.07
臺北縣,新店市,寶福里,1844,3,664,5,669,1222,3,1,3,0,1,0,54.75
臺北縣,新店市,寶福里,1845,3,1043,5,1048,1772,3,1,3,0,1,0,59.14
臺北縣,新店市,寶福里,1846,3,931,5,936,1486,3,1,3,0,1,0,62.99
臺北縣,新店市,寶安里,1847,3,705,4,709,1144,3,1,3,0,1,0,61.98
臺北縣,新店市,寶安里,1848,3,1038,3,1041,1695,3,1,3,0,1,0,61.42
臺北縣,新店市,寶安里,1849,3,1045,6,1051,1716,3,1,3,0,1,0,61.25
臺北縣,新店市,信義里,1850,3,764,4,768,1290,3,1,3,0,1,0,59.53
臺北縣,新店市,信義里,1851,3,701,8,709,1158,3,1,3,0,1,0,61.23
臺北縣,新店市,信義里,1852,3,961,4,965,1607,3,1,3,0,1,0,60.05
臺北縣,新店市,信義里,1853,3,838,5,843,1434,3,1,3,0,1,0,58.79
臺北縣,新店市,忠孝里,1854,3,1065,8,1073,1706,3,1,3,0,1,0,62.90
臺北縣,新店市,忠孝里,1855,3,528,3,531,923,3,1,3,0,1,0,57.53
臺北縣,新店市,大鵬里,1856,3,1296,4,1300,1906,3,1,3,0,1,0,68.21
臺北縣,新店市,太平里,1857,3,797,16,813,1417,3,1,3,0,1,0,57.37
臺北縣,新店市,太平里,1858,3,655,3,658,1108,3,1,3,0,1,0,59.39
臺北縣,新店市,美城里,1859,3,675,3,678,1063,3,1,3,0,1,0,63.78
臺北縣,新店市,美城里,1860,3,664,7,671,1046,3,1,3,0,1,0,64.15
臺北縣,新店市,頂城里,1861,3,727,4,731,1301,3,1,3,0,1,0,56.19
臺北縣,新店市,下城里,1862,3,1074,10,1084,1803,3,1,3,0,1,0,60.12
臺北縣,新店市,柴埕里,1863,3,783,7,790,1308,3,1,3,0,1,0,60.40
臺北縣,新店市,柴埕里,1864,3,819,7,826,1410,3,1,3,0,1,0,58.58
臺北縣,新店市,柴埕里,1865,3,908,5,913,1704,3,1,3,0,1,0,53.58
臺北縣,新店市,柴埕里,1866,3,910,3,913,1603,3,1,3,0,1,0,56.96
臺北縣,新店市,安和里,1867,3,880,9,889,1560,3,1,3,0,1,0,56.99
臺北縣,新店市,安和里,1868,3,893,5,898,1531,3,1,3,0,1,0,58.65
臺北縣,新店市,安和里,1869,3,768,6,774,1302,3,1,3,0,1,0,59.45
臺北縣,新店市,永安里,1870,3,824,3,827,1453,3,1,3,0,1,0,56.92
臺北縣,新店市,永安里,1871,3,779,7,786,1375,3,1,3,0,1,0,57.16
臺北縣,新店市,永安里,1872,3,735,3,738,1230,3,1,3,0,1,0,60.00
臺北縣,新店市,新和里,1873,3,952,4,956,1593,3,1,3,0,1,0,60.01
臺北縣,新店市,新和里,1874,3,906,12,918,1525,3,1,3,0,1,0,60.20
臺北縣,新店市,永平里,1875,3,595,3,598,1055,3,1,3,0,1,0,56.68
臺北縣,新店市,永平里,1876,3,814,5,819,1304,3,1,3,0,1,0,62.81
臺北縣,新店市,永平里,1877,3,936,4,940,1623,3,1,3,0,1,0,57.92
臺北縣,新店市,公崙里,1878,3,982,4,986,1735,3,1,3,0,1,0,56.83
臺北縣,新店市,公崙里,1879,3,940,0,940,1612,3,1,3,0,1,0,58.31
臺北縣,新店市,公崙里,1880,3,1014,6,1020,2019,3,1,3,0,1,0,50.52
臺北縣,新店市,公崙里,1881,3,882,9,891,1588,3,1,3,0,1,0,56.11
臺北縣,新店市,安昌里,1882,3,917,3,920,1528,3,1,3,0,1,0,60.21
臺北縣,新店市,安昌里,1883,3,935,4,939,1581,3,1,3,0,1,0,59.39
臺北縣,新店市,德安里,1884,3,864,7,871,1438,3,1,3,0,1,0,60.57
臺北縣,新店市,德安里,1885,3,891,5,896,1637,3,1,3,0,1,0,54.73
臺北縣,新店市,德安里,1886,3,946,11,957,1667,3,1,3,0,1,0,57.41
臺北縣,新店市,達觀里,1887,3,773,1,774,1456,3,1,3,0,1,0,53.16
臺北縣,新店市,達觀里,1888,3,679,3,682,1226,3,1,3,0,1,0,55.63
臺北縣,新店市,明城里,1889,3,854,1,855,1395,3,1,3,0,1,0,61.29
臺北縣,新店市,明城里,1890,3,657,4,661,1149,3,1,3,0,1,0,57.53
臺北縣,新店市,小城里,1891,3,747,5,752,1146,3,1,3,0,1,0,65.62
臺北縣,新店市,小城里,1892,3,1046,4,1050,1621,3,1,3,0,1,0,64.77
臺北縣,新店市,雙城里,1893,3,558,1,559,1037,3,1,3,0,1,0,53.91
臺北縣,新店市,雙城里,1894,3,505,5,510,842,3,1,3,0,1,0,60.57
臺北縣,新店市,雙城里,1895,3,894,8,902,1570,3,1,3,0,1,0,57.45
臺北縣,新店市,雙城里,1896,3,665,5,670,1186,3,1,3,0,1,0,56.49
臺北縣,新店市,香坡里,1897,3,1016,5,1021,1841,3,1,3,0,1,0,55.46
臺北縣,新店市,香坡里,1898,3,693,1,694,1377,3,1,3,0,1,0,50.40
臺北縣,新店市,香坡里,1899,3,697,1,698,1376,3,1,3,0,1,0,50.73
臺北縣,新店市,日興里,1900,3,912,10,922,1655,3,1,3,0,1,0,55.71
臺北縣,新店市,日興里,1901,3,733,7,740,1298,3,1,3,0,1,0,57.01
臺北縣,新店市,日興里,1902,3,762,8,770,1318,3,1,3,0,1,0,58.42
臺北縣,新店市,玫瑰里,1903,3,967,7,974,1626,3,1,3,0,1,0,59.90
臺北縣,新店市,玫瑰里,1904,3,876,8,884,1481,3,1,3,0,1,0,59.69
臺北縣,新店市,玫瑰里,1905,3,794,1,795,1338,3,1,3,0,1,0,59.42
臺北縣,新店市,吉祥里,1906,3,587,2,589,997,3,1,3,0,1,0,59.08
臺北縣,新店市,吉祥里,1907,3,711,1,712,1133,3,1,3,0,1,0,62.84
臺北縣,新店市,吉祥里,1908,3,811,4,815,1345,3,1,3,0,1,0,60.59
臺北縣,新店市,塗潭里,1909,3,457,3,460,730,3,1,3,0,1,0,63.01
臺北縣,新店市,華城里,1910,3,896,4,900,1520,3,1,3,0,1,0,59.21
臺北縣,新店市,青潭里,1911,3,933,10,943,1626,3,1,3,0,1,0,58.00
臺北縣,新店市,青潭里,1912,3,652,1,653,1103,3,1,3,0,1,0,59.20
臺北縣,新店市,青潭里,1913,3,660,2,662,1233,3,1,3,0,1,0,53.69
臺北縣,新店市,美潭里,1914,3,801,6,807,1366,3,1,3,0,1,0,59.08
臺北縣,新店市,美潭里,1915,3,901,7,908,1634,3,1,3,0,1,0,55.57
臺北縣,新店市,美潭里,1916,3,664,5,669,1036,3,1,3,0,1,0,64.58
臺北縣,新店市,員潭里,1917,3,904,4,908,1580,3,1,3,0,1,0,57.47
臺北縣,新店市,員潭里,1918,3,901,6,907,1597,3,1,3,0,1,0,56.79
臺北縣,新店市,雙坑里,1919,3,426,3,429,754,3,1,3,0,1,0,56.90
臺北縣,新店市,粗坑里,1920,3,253,2,255,385,3,1,3,0,1,0,66.23
臺北縣,新店市,粗坑里,1921,3,1027,7,1034,1730,3,1,3,0,1,0,59.77
臺北縣,新店市,屈尺里,1922,3,630,3,633,1020,3,1,3,0,1,0,62.06
臺北縣,新店市,屈尺里,1923,3,677,15,692,1218,3,1,3,0,1,0,56.81
臺北縣,新店市,龜山里,1924,3,768,7,775,1346,3,1,3,0,1,0,57.58
臺北縣,新店市,廣興里,1925,3,644,6,650,1090,3,1,3,0,1,0,59.63
臺北縣,新店市,直潭里,1926,3,241,1,242,410,3,1,3,0,1,0,59.02
臺北縣,新店市,直潭里,1927,3,224,1,225,350,3,1,3,0,1,0,64.29
臺北縣,深坑鄉,萬順村,1928,3,485,1,486,923,3,1,3,0,1,0,52.65
臺北縣,深坑鄉,萬順村,1929,3,545,7,552,958,3,1,3,0,1,0,57.62
臺北縣,深坑鄉,萬福村,1930,3,564,5,569,998,3,1,3,0,1,0,57.01
臺北縣,深坑鄉,萬福村,1931,3,422,4,426,857,3,1,3,0,1,0,49.71
臺北縣,深坑鄉,土庫村,1932,3,571,10,581,1063,3,1,3,0,1,0,54.66
臺北縣,深坑鄉,土庫村,1933,3,567,4,571,1031,3,1,3,0,1,0,55.38
臺北縣,深坑鄉,賴仲村,1934,3,787,3,790,1547,3,1,3,0,1,0,51.07
臺北縣,深坑鄉,深坑村,1935,3,696,2,698,1238,3,1,3,0,1,0,56.38
臺北縣,深坑鄉,深坑村,1936,3,672,7,679,1229,3,1,3,0,1,0,55.25
臺北縣,深坑鄉,埔新村,1937,3,633,2,635,1233,3,1,3,0,1,0,51.50
臺北縣,深坑鄉,埔新村,1938,3,591,2,593,1165,3,1,3,0,1,0,50.90
臺北縣,深坑鄉,埔新村,1939,3,677,7,684,1296,3,1,3,0,1,0,52.78
臺北縣,深坑鄉,昇高村,1940,3,833,9,842,1563,3,1,3,0,1,0,53.87
臺北縣,深坑鄉,阿柔村,1941,3,311,4,315,488,3,1,3,0,1,0,64.55
臺北縣,石碇鄉,石碇村,1942,3,263,1,264,395,3,1,3,0,1,0,66.84
臺北縣,石碇鄉,潭邊村,1943,3,394,4,398,670,3,1,3,0,1,0,59.40
臺北縣,石碇鄉,烏塗村,1944,3,385,5,390,600,3,1,3,0,1,0,65.00
臺北縣,石碇鄉,彭山村,1945,3,162,2,164,294,3,1,3,0,1,0,55.78
臺北縣,石碇鄉,豐田村,1946,3,184,3,187,313,3,1,3,0,1,0,59.74
臺北縣,石碇鄉,豐田村,1947,3,81,1,82,124,3,1,3,0,1,0,66.13
臺北縣,石碇鄉,隆盛村,1948,3,381,3,384,697,3,1,3,0,1,0,55.09
臺北縣,石碇鄉,豐林村,1949,3,118,1,119,231,3,1,3,0,1,0,51.52
臺北縣,石碇鄉,中民村,1950,3,410,5,415,756,3,1,3,0,1,0,54.89
臺北縣,石碇鄉,永定村,1951,3,266,1,267,567,3,1,3,0,1,0,47.09
臺北縣,石碇鄉,光明村,1952,3,139,1,140,241,3,1,3,0,1,0,58.09
臺北縣,石碇鄉,永安村,1953,3,274,0,274,432,3,1,3,0,1,0,63.43
臺北縣,石碇鄉,格頭村,1954,3,418,3,421,680,3,1,3,0,1,0,61.91
臺北縣,坪林鄉,坪林村,1955,3,637,3,640,1024,3,1,3,0,1,0,62.50
臺北縣,坪林鄉,水德村,1956,3,346,6,352,564,3,1,3,0,1,0,62.41
臺北縣,坪林鄉,大林村,1957,3,530,3,533,964,3,1,3,0,1,0,55.29
臺北縣,坪林鄉,石曹村,1958,3,210,1,211,381,3,1,3,0,1,0,55.38
臺北縣,坪林鄉,粗窟村,1959,3,277,5,282,499,3,1,3,0,1,0,56.51
臺北縣,坪林鄉,粗窟村,1960,3,131,0,131,212,3,1,3,0,1,0,61.79
臺北縣,坪林鄉,上德村,1961,3,191,0,191,312,3,1,3,0,1,0,61.22
臺北縣,坪林鄉,上德村,1962,3,237,2,239,401,3,1,3,0,1,0,59.60
臺北縣,坪林鄉,漁光村,1963,3,191,0,191,365,3,1,3,0,1,0,52.33
臺北縣,坪林鄉,漁光村,1964,3,220,2,222,411,3,1,3,0,1,0,54.01
臺北縣,烏來鄉,忠治村,1965,3,368,2,370,626,3,1,3,0,1,0,59.11
臺北縣,烏來鄉,烏來村,1966,3,603,7,610,1075,3,1,3,0,1,0,56.74
臺北縣,烏來鄉,孝義村,1967,3,95,0,95,147,3,1,3,0,1,0,64.63
臺北縣,烏來鄉,信賢村,1968,3,135,0,135,215,3,1,3,0,1,0,62.79
臺北縣,烏來鄉,福山村,1969,3,52,0,52,90,3,1,3,0,1,0,57.78
臺北縣,汐止市,仁德里,1970,3,852,9,861,1527,3,1,3,0,1,0,56.39
臺北縣,汐止市,義民里,1971,3,672,6,678,1207,3,1,3,0,1,0,56.17
臺北縣,汐止市,禮門里,1972,3,513,1,514,928,3,1,3,0,1,0,55.39
臺北縣,汐止市,智慧里,1973,3,749,6,755,1442,3,1,3,0,1,0,52.36
臺北縣,汐止市,智慧里,1974,3,757,2,759,1368,3,1,3,0,1,0,55.48
臺北縣,汐止市,大同里,1975,3,530,1,531,937,3,1,3,0,1,0,56.67
臺北縣,汐止市,大同里,1976,3,517,2,519,990,3,1,3,0,1,0,52.42
臺北縣,汐止市,信望里,1977,3,212,2,214,370,3,1,3,0,1,0,57.84
臺北縣,汐止市,新昌里,1978,3,722,8,730,1357,3,1,3,0,1,0,53.80
臺北縣,汐止市,新昌里,1979,3,800,1,801,1409,3,1,3,0,1,0,56.85
臺北縣,汐止市,新昌里,1980,3,835,6,841,1551,3,1,3,0,1,0,54.22
臺北縣,汐止市,福安里,1981,3,618,6,624,1149,3,1,3,0,1,0,54.31
臺北縣,汐止市,福安里,1982,3,602,21,623,1222,3,1,3,0,1,0,50.98
臺北縣,汐止市,秀峰里,1983,3,463,3,466,869,3,1,3,0,1,0,53.62
臺北縣,汐止市,秀峰里,1984,3,519,3,522,977,3,1,3,0,1,0,53.43
臺北縣,汐止市,秀峰里,1985,3,631,3,634,1164,3,1,3,0,1,0,54.47
臺北縣,汐止市,秀山里,1986,3,766,3,769,1350,3,1,3,0,1,0,56.96
臺北縣,汐止市,秀山里,1987,3,808,8,816,1494,3,1,3,0,1,0,54.62
臺北縣,汐止市,復興里,1988,3,735,5,740,1731,3,1,3,0,1,0,42.75
臺北縣,汐止市,復興里,1989,3,960,7,967,1739,3,1,3,0,1,0,55.61
臺北縣,汐止市,復興里,1990,3,994,6,1000,1773,3,1,3,0,1,0,56.40
臺北縣,汐止市,自強里,1991,3,853,11,864,1629,3,1,3,0,1,0,53.04
臺北縣,汐止市,自強里,1992,3,890,5,895,1766,3,1,3,0,1,0,50.68
臺北縣,汐止市,文化里,1993,3,537,8,545,1059,3,1,3,0,1,0,51.46
臺北縣,汐止市,文化里,1994,3,909,9,918,1611,3,1,3,0,1,0,56.98
臺北縣,汐止市,白雲里,1995,3,849,5,854,1525,3,1,3,0,1,0,56.00
臺北縣,汐止市,白雲里,1996,3,863,6,869,1601,3,1,3,0,1,0,54.28
臺北縣,汐止市,茄苳里,1997,3,853,8,861,1642,3,1,3,0,1,0,52.44
臺北縣,汐止市,茄苳里,1998,3,763,9,772,1444,3,1,3,0,1,0,53.46
臺北縣,汐止市,崇德里,1999,3,886,6,892,1611,3,1,3,0,1,0,55.37
臺北縣,汐止市,崇德里,2000,3,798,6,804,1655,3,1,3,0,1,0,48.58
臺北縣,汐止市,橋東里,2001,3,658,4,662,1233,3,1,3,0,1,0,53.69
臺北縣,汐止市,橋東里,2002,3,529,3,532,946,3,1,3,0,1,0,56.24
臺北縣,汐止市,橋東里,2003,3,915,6,921,1688,3,1,3,0,1,0,54.56
臺北縣,汐止市,橋東里,2004,3,728,4,732,1302,3,1,3,0,1,0,56.22
臺北縣,汐止市,橋東里,2005,3,907,6,913,1641,3,1,3,0,1,0,55.64
臺北縣,汐止市,橋東里,2006,3,788,4,792,1493,3,1,3,0,1,0,53.05
臺北縣,汐止市,長安里,2007,3,757,6,763,1376,3,1,3,0,1,0,55.45
臺北縣,汐止市,保安里,2008,3,664,3,667,1245,3,1,3,0,1,0,53.57
臺北縣,汐止市,東山里,2009,3,280,0,280,490,3,1,3,0,1,0,57.14
臺北縣,汐止市,保長里,2010,3,585,6,591,1147,3,1,3,0,1,0,51.53
臺北縣,汐止市,保長里,2011,3,595,9,604,1144,3,1,3,0,1,0,52.80
臺北縣,汐止市,保長里,2012,3,705,10,715,1441,3,1,3,0,1,0,49.62
臺北縣,汐止市,鄉長里,2013,3,1014,16,1030,1663,3,1,3,0,1,0,61.94
臺北縣,汐止市,江北里,2014,3,643,133,776,1370,3,1,3,0,1,0,56.64
臺北縣,汐止市,江北里,2015,3,646,4,650,1158,3,1,3,0,1,0,56.13
臺北縣,汐止市,江北里,2016,3,803,5,808,1631,3,1,3,0,1,0,49.54
臺北縣,汐止市,拱北里,2017,3,609,4,613,1258,3,1,3,0,1,0,48.73
臺北縣,汐止市,拱北里,2018,3,474,0,474,1075,3,1,3,0,1,0,44.09
臺北縣,汐止市,拱北里,2019,3,614,2,616,1159,3,1,3,0,1,0,53.15
臺北縣,汐止市,烘內里,2020,3,670,6,676,1164,3,1,3,0,1,0,58.08
臺北縣,汐止市,八連里,2021,3,471,2,473,781,3,1,3,0,1,0,60.56
臺北縣,汐止市,長青里,2022,3,516,8,524,866,3,1,3,0,1,0,60.51
臺北縣,汐止市,北峰里,2023,3,792,4,796,1542,3,1,3,0,1,0,51.62
臺北縣,汐止市,北峰里,2024,3,857,8,865,1686,3,1,3,0,1,0,51.30
臺北縣,汐止市,金龍里,2025,3,635,2,637,1311,3,1,3,0,1,0,48.59
臺北縣,汐止市,金龍里,2026,3,532,6,538,1174,3,1,3,0,1,0,45.83
臺北縣,汐止市,金龍里,2027,3,646,4,650,1268,3,1,3,0,1,0,51.26
臺北縣,汐止市,樟樹里,2028,3,833,8,841,1628,3,1,3,0,1,0,51.66
臺北縣,汐止市,忠孝里,2029,3,647,13,660,1253,3,1,3,0,1,0,52.67
臺北縣,汐止市,忠孝里,2030,3,719,10,729,1346,3,1,3,0,1,0,54.16
臺北縣,汐止市,忠孝里,2031,3,524,5,529,1182,3,1,3,0,1,0,44.75
臺北縣,汐止市,忠孝里,2032,3,666,3,669,1283,3,1,3,0,1,0,52.14
臺北縣,汐止市,厚德里,2033,3,683,6,689,1403,3,1,3,0,1,0,49.11
臺北縣,汐止市,厚德里,2034,3,681,2,683,1457,3,1,3,0,1,0,46.88
臺北縣,汐止市,厚德里,2035,3,623,4,627,1288,3,1,3,0,1,0,48.68
臺北縣,汐止市,山光里,2036,3,349,4,353,815,3,1,3,0,1,0,43.31
臺北縣,汐止市,山光里,2037,3,364,1,365,754,3,1,3,0,1,0,48.41
臺北縣,汐止市,中興里,2038,3,799,6,805,1741,3,1,3,0,1,0,46.24
臺北縣,汐止市,中興里,2039,3,906,9,915,1803,3,1,3,0,1,0,50.75
臺北縣,汐止市,中興里,2040,3,765,4,769,1510,3,1,3,0,1,0,50.93
臺北縣,汐止市,福德里,2041,3,562,3,565,1099,3,1,3,0,1,0,51.41
臺北縣,汐止市,福德里,2042,3,522,1,523,1124,3,1,3,0,1,0,46.53
臺北縣,汐止市,興福里,2043,3,551,18,569,1051,3,1,3,0,1,0,54.14
臺北縣,汐止市,興福里,2044,3,535,4,539,1050,3,1,3,0,1,0,51.33
臺北縣,汐止市,康福里,2045,3,598,4,602,1202,3,1,3,0,1,0,50.08
臺北縣,汐止市,康福里,2046,3,534,2,536,1165,3,1,3,0,1,0,46.01
臺北縣,汐止市,湖光里,2047,3,890,10,900,1786,3,1,3,0,1,0,50.39
臺北縣,汐止市,湖光里,2048,3,874,4,878,1704,3,1,3,0,1,0,51.53
臺北縣,汐止市,湖光里,2049,3,556,1,557,1105,3,1,3,0,1,0,50.41
臺北縣,汐止市,湖興里,2050,3,798,3,801,1437,3,1,3,0,1,0,55.74
臺北縣,汐止市,湖興里,2051,3,564,5,569,1014,3,1,3,0,1,0,56.11
臺北縣,汐止市,湖興里,2052,3,789,2,791,1597,3,1,3,0,1,0,49.53
臺北縣,汐止市,北山里,2053,3,505,1,506,949,3,1,3,0,1,0,53.32
臺北縣,汐止市,北山里,2054,3,610,3,613,1215,3,1,3,0,1,0,50.45
臺北縣,汐止市,北山里,2055,3,1066,10,1076,1879,3,1,3,0,1,0,57.26
臺北縣,汐止市,忠山里,2056,3,773,1,774,1376,3,1,3,0,1,0,56.25
臺北縣,汐止市,忠山里,2057,3,740,5,745,1202,3,1,3,0,1,0,61.98
臺北縣,汐止市,環河里,2058,3,548,5,553,955,3,1,3,0,1,0,57.91
臺北縣,汐止市,橫科里,2059,3,900,5,905,1560,3,1,3,0,1,0,58.01
臺北縣,汐止市,橫科里,2060,3,756,7,763,1264,3,1,3,0,1,0,60.36
臺北縣,汐止市,橫科里,2061,3,570,8,578,1069,3,1,3,0,1,0,54.07
臺北縣,汐止市,福山里,2062,3,723,1,724,1400,3,1,3,0,1,0,51.71
臺北縣,汐止市,福山里,2063,3,792,5,797,1440,3,1,3,0,1,0,55.35
臺北縣,汐止市,宜興里,2064,3,750,7,757,1286,3,1,3,0,1,0,58.86
臺北縣,汐止市,宜興里,2065,3,674,5,679,1096,3,1,3,0,1,0,61.95
臺北縣,汐止市,東勢里,2066,3,584,5,589,1001,3,1,3,0,1,0,58.84
臺北縣,汐止市,東勢里,2067,3,935,7,942,1641,3,1,3,0,1,0,57.40
臺北縣,瑞芳鎮,龍潭里,2068,3,457,3,460,777,3,1,3,0,1,0,59.20
臺北縣,瑞芳鎮,龍興里,2069,3,559,2,561,918,3,1,3,0,1,0,61.11
臺北縣,瑞芳鎮,龍興里,2070,3,463,4,467,754,3,1,3,0,1,0,61.94
臺北縣,瑞芳鎮,龍鎮里,2071,3,764,2,766,1277,3,1,3,0,1,0,59.98
臺北縣,瑞芳鎮,龍安里,2072,3,375,5,380,596,3,1,3,0,1,0,63.76
臺北縣,瑞芳鎮,龍川里,2073,3,486,4,490,817,3,1,3,0,1,0,59.98
臺北縣,瑞芳鎮,龍川里,2074,3,415,5,420,745,3,1,3,0,1,0,56.38
臺北縣,瑞芳鎮,龍山里,2075,3,685,7,692,1264,3,1,3,0,1,0,54.75
臺北縣,瑞芳鎮,爪峰里,2076,3,835,6,841,1529,3,1,3,0,1,0,55.00
臺北縣,瑞芳鎮,爪峰里,2077,3,590,2,592,1048,3,1,3,0,1,0,56.49
臺北縣,瑞芳鎮,爪峰里,2078,3,574,3,577,961,3,1,3,0,1,0,60.04
臺北縣,瑞芳鎮,新峰里,2079,3,671,5,676,1268,3,1,3,0,1,0,53.31
臺北縣,瑞芳鎮,新峰里,2080,3,485,1,486,1093,3,1,3,0,1,0,44.46
臺北縣,瑞芳鎮,東和里,2081,3,603,5,608,1055,3,1,3,0,1,0,57.63
臺北縣,瑞芳鎮,東和里,2082,3,376,3,379,707,3,1,3,0,1,0,53.61
臺北縣,瑞芳鎮,柑坪里,2083,3,580,6,586,1064,3,1,3,0,1,0,55.08
臺北縣,瑞芳鎮,弓橋里,2084,3,160,2,162,288,3,1,3,0,1,0,56.25
臺北縣,瑞芳鎮,侯硐里,2085,3,296,4,300,484,3,1,3,0,1,0,61.98
臺北縣,瑞芳鎮,光復里,2086,3,225,1,226,340,3,1,3,0,1,0,66.47
臺北縣,瑞芳鎮,碩仁里,2087,3,83,0,83,109,3,1,3,0,1,0,76.15
臺北縣,瑞芳鎮,吉慶里,2088,3,449,4,453,832,3,1,3,0,1,0,54.45
臺北縣,瑞芳鎮,吉慶里,2089,3,384,4,388,781,3,1,3,0,1,0,49.68
臺北縣,瑞芳鎮,吉安里,2090,3,541,6,547,927,3,1,3,0,1,0,59.01
臺北縣,瑞芳鎮,吉安里,2091,3,408,2,410,838,3,1,3,0,1,0,48.93
臺北縣,瑞芳鎮,吉安里,2092,3,579,4,583,1017,3,1,3,0,1,0,57.33
臺北縣,瑞芳鎮,上天里,2093,3,381,1,382,639,3,1,3,0,1,0,59.78
臺北縣,瑞芳鎮,上天里,2094,3,314,0,314,634,3,1,3,0,1,0,49.53
臺北縣,瑞芳鎮,傑魚里,2095,3,489,6,495,968,3,1,3,0,1,0,51.14
臺北縣,瑞芳鎮,傑魚里,2096,3,419,1,420,862,3,1,3,0,1,0,48.72
臺北縣,瑞芳鎮,基山里,2097,3,282,1,283,540,3,1,3,0,1,0,52.41
臺北縣,瑞芳鎮,永慶里,2098,3,304,2,306,559,3,1,3,0,1,0,54.74
臺北縣,瑞芳鎮,崇文里,2099,3,197,0,197,403,3,1,3,0,1,0,48.88
臺北縣,瑞芳鎮,福住里,2100,3,137,0,137,240,3,1,3,0,1,0,57.08
臺北縣,瑞芳鎮,頌德里,2101,3,204,3,207,376,3,1,3,0,1,0,55.05
臺北縣,瑞芳鎮,瓜山里,2102,3,146,0,146,255,3,1,3,0,1,0,57.25
臺北縣,瑞芳鎮,銅山里,2103,3,161,2,163,267,3,1,3,0,1,0,61.05
臺北縣,瑞芳鎮,新山里,2104,3,245,5,250,430,3,1,3,0,1,0,58.14
臺北縣,瑞芳鎮,石山里,2105,3,232,3,235,417,3,1,3,0,1,0,56.35
臺北縣,瑞芳鎮,濂洞里,2106,3,382,4,386,579,3,1,3,0,1,0,66.67
臺北縣,瑞芳鎮,濂新里,2107,3,193,0,193,318,3,1,3,0,1,0,60.69
臺北縣,瑞芳鎮,南雅里,2108,3,175,1,176,254,3,1,3,0,1,0,69.29
臺北縣,瑞芳鎮,鼻頭里,2109,3,394,7,401,753,3,1,3,0,1,0,53.25
臺北縣,瑞芳鎮,海濱里,2110,3,589,5,594,960,3,1,3,0,1,0,61.88
臺北縣,瑞芳鎮,瑞濱里,2111,3,481,3,484,832,3,1,3,0,1,0,58.17
臺北縣,瑞芳鎮,瑞濱里,2112,3,514,7,521,862,3,1,3,0,1,0,60.44
臺北縣,瑞芳鎮,深澳里,2113,3,682,4,686,1109,3,1,3,0,1,0,61.86
臺北縣,平溪鄉,薯榔村,2114,3,262,3,265,436,3,1,3,0,1,0,60.78
臺北縣,平溪鄉,菁桐村,2115,3,179,3,182,305,3,1,3,0,1,0,59.67
臺北縣,平溪鄉,白石村,2116,3,181,1,182,272,3,1,3,0,1,0,66.91
臺北縣,平溪鄉,石底村,2117,3,355,8,363,555,3,1,3,0,1,0,65.41
臺北縣,平溪鄉,平溪村,2118,3,177,3,180,271,3,1,3,0,1,0,66.42
臺北縣,平溪鄉,嶺腳村,2119,3,423,1,424,677,3,1,3,0,1,0,62.63
臺北縣,平溪鄉,東勢村,2120,3,280,2,282,421,3,1,3,0,1,0,66.98
臺北縣,平溪鄉,十分村,2121,3,601,5,606,988,3,1,3,0,1,0,61.34
臺北縣,平溪鄉,望古村,2122,3,73,0,73,147,3,1,3,0,1,0,49.66
臺北縣,平溪鄉,南山村,2123,3,254,0,254,479,3,1,3,0,1,0,53.03
臺北縣,平溪鄉,新寮村,2124,3,105,0,105,183,3,1,3,0,1,0,57.38
臺北縣,平溪鄉,平湖村,2125,3,89,0,89,160,3,1,3,0,1,0,55.63
臺北縣,雙溪鄉,雙溪村,2126,3,313,4,317,544,3,1,3,0,1,0,58.27
臺北縣,雙溪鄉,新基村,2127,3,175,1,176,308,3,1,3,0,1,0,57.14
臺北縣,雙溪鄉,新基村,2128,3,361,6,367,588,3,1,3,0,1,0,62.41
臺北縣,雙溪鄉,三港村,2129,3,252,2,254,466,3,1,3,0,1,0,54.51
臺北縣,雙溪鄉,牡丹村,2130,3,550,6,556,1034,3,1,3,0,1,0,53.77
臺北縣,雙溪鄉,牡丹村,2131,3,445,3,448,773,3,1,3,0,1,0,57.96
臺北縣,雙溪鄉,三貂村,2132,3,201,1,202,343,3,1,3,0,1,0,58.89
臺北縣,雙溪鄉,平林村,2133,3,415,3,418,659,3,1,3,0,1,0,63.43
臺北縣,雙溪鄉,平林村,2134,3,154,1,155,288,3,1,3,0,1,0,53.82
臺北縣,雙溪鄉,上林村,2135,3,385,4,389,710,3,1,3,0,1,0,54.79
臺北縣,雙溪鄉,外柑村,2136,3,279,1,280,486,3,1,3,0,1,0,57.61
臺北縣,雙溪鄉,長源村,2137,3,257,5,262,406,3,1,3,0,1,0,64.53
臺北縣,雙溪鄉,共和村,2138,3,99,1,100,147,3,1,3,0,1,0,68.03
臺北縣,雙溪鄉,共和村,2139,3,173,2,175,323,3,1,3,0,1,0,54.18
臺北縣,雙溪鄉,魚行村,2140,3,192,2,194,335,3,1,3,0,1,0,57.91
臺北縣,雙溪鄉,魚行村,2141,3,179,1,180,306,3,1,3,0,1,0,58.82
臺北縣,雙溪鄉,泰平村,2142,3,194,0,194,391,3,1,3,0,1,0,49.62
臺北縣,雙溪鄉,泰平村,2143,3,85,0,85,147,3,1,3,0,1,0,57.82
臺北縣,貢寮鄉,貢寮村,2144,3,555,8,563,919,3,1,3,0,1,0,61.26
臺北縣,貢寮鄉,龍崗村,2145,3,256,4,260,439,3,1,3,0,1,0,59.23
臺北縣,貢寮鄉,吉林村,2146,3,272,3,275,494,3,1,3,0,1,0,55.67
臺北縣,貢寮鄉,雙玉村,2147,3,193,0,193,415,3,1,3,0,1,0,46.51
臺北縣,貢寮鄉,雙玉村,2148,3,211,0,211,340,3,1,3,0,1,0,62.06
臺北縣,貢寮鄉,福隆村,2149,3,551,4,555,1016,3,1,3,0,1,0,54.63
臺北縣,貢寮鄉,福隆村,2150,3,351,1,352,620,3,1,3,0,1,0,56.77
臺北縣,貢寮鄉,福連村,2151,3,435,5,440,884,3,1,3,0,1,0,49.77
臺北縣,貢寮鄉,龍門村,2152,3,397,3,400,679,3,1,3,0,1,0,58.91
臺北縣,貢寮鄉,仁里村,2153,3,960,13,973,1613,3,1,3,0,1,0,60.32
臺北縣,貢寮鄉,真理村,2154,3,611,2,613,1157,3,1,3,0,1,0,52.98
臺北縣,貢寮鄉,真理村,2155,3,432,2,434,820,3,1,3,0,1,0,52.93
臺北縣,貢寮鄉,美豐村,2156,3,235,3,238,398,3,1,3,0,1,0,59.80
臺北縣,貢寮鄉,美豐村,2157,3,220,3,223,412,3,1,3,0,1,0,54.13
臺北縣,貢寮鄉,和美村,2158,3,283,3,286,478,3,1,3,0,1,0,59.83
臺北縣,貢寮鄉,和美村,2159,3,283,1,284,452,3,1,3,0,1,0,62.83
宜蘭縣,宜蘭市,南門里,1,1,370,4,374,629,3,1,3,0,1,0,59.46
宜蘭縣,宜蘭市,負郭里,2,1,348,1,349,595,3,1,3,0,1,0,58.66
宜蘭縣,宜蘭市,負郭里,3,1,522,5,527,1033,3,1,3,0,1,0,51.02
宜蘭縣,宜蘭市,民族里,4,1,260,1,261,429,3,1,3,0,1,0,60.84
宜蘭縣,宜蘭市,民族里,5,1,454,2,456,699,3,1,3,0,1,0,65.24
宜蘭縣,宜蘭市,建軍里,6,1,309,3,312,554,3,1,3,0,1,0,56.32
宜蘭縣,宜蘭市,建軍里,7,1,370,1,371,613,3,1,3,0,1,0,60.52
宜蘭縣,宜蘭市,復興里,8,1,416,5,421,698,3,1,3,0,1,0,60.32
宜蘭縣,宜蘭市,復興里,9,1,717,6,723,1350,3,1,3,0,1,0,53.56
宜蘭縣,宜蘭市,復興里,10,1,711,6,717,1298,3,1,3,0,1,0,55.24
宜蘭縣,宜蘭市,思源里,11,1,796,3,799,1431,3,1,3,0,1,0,55.84
宜蘭縣,宜蘭市,思源里,12,1,369,2,371,650,3,1,3,0,1,0,57.08
宜蘭縣,宜蘭市,思源里,13,1,796,4,800,1359,3,1,3,0,1,0,58.87
宜蘭縣,宜蘭市,思源里,14,1,367,4,371,680,3,1,3,0,1,0,54.56
宜蘭縣,宜蘭市,文化里,15,1,598,6,604,1063,3,1,3,0,1,0,56.82
宜蘭縣,宜蘭市,文化里,16,1,446,2,448,792,3,1,3,0,1,0,56.57
宜蘭縣,宜蘭市,神農里,17,1,594,7,601,1073,3,1,3,0,1,0,56.01
宜蘭縣,宜蘭市,民生里,18,1,778,8,786,1291,3,1,3,0,1,0,60.88
宜蘭縣,宜蘭市,昇平里,19,1,567,2,569,951,3,1,3,0,1,0,59.83
宜蘭縣,宜蘭市,大東里,20,1,664,0,664,1254,3,1,3,0,1,0,52.95
宜蘭縣,宜蘭市,新興里,21,1,815,4,819,1508,3,1,3,0,1,0,54.31
宜蘭縣,宜蘭市,和睦里,22,1,588,3,591,997,3,1,3,0,1,0,59.28
宜蘭縣,宜蘭市,和睦里,23,1,938,5,943,1732,3,1,3,0,1,0,54.45
宜蘭縣,宜蘭市,民權里,24,1,650,11,661,1179,3,1,3,0,1,0,56.06
宜蘭縣,宜蘭市,民權里,25,1,641,11,652,1182,3,1,3,0,1,0,55.16
宜蘭縣,宜蘭市,進士里,26,1,649,7,656,1227,3,1,3,0,1,0,53.46
宜蘭縣,宜蘭市,進士里,27,1,718,7,725,1327,3,1,3,0,1,0,54.63
宜蘭縣,宜蘭市,進士里,28,1,750,4,754,1491,3,1,3,0,1,0,50.57
宜蘭縣,宜蘭市,進士里,29,1,412,2,414,650,3,1,3,0,1,0,63.69
宜蘭縣,宜蘭市,南橋里,30,1,309,0,309,534,3,1,3,0,1,0,57.87
宜蘭縣,宜蘭市,建業里,31,1,360,2,362,596,3,1,3,0,1,0,60.74
宜蘭縣,宜蘭市,南津里,32,1,761,3,764,1276,3,1,3,0,1,0,59.87
宜蘭縣,宜蘭市,凱旋里,33,1,790,5,795,1340,3,1,3,0,1,0,59.33
宜蘭縣,宜蘭市,黎明里,34,1,583,2,585,995,3,1,3,0,1,0,58.79
宜蘭縣,宜蘭市,東村里,35,1,736,3,739,1380,3,1,3,0,1,0,53.55
宜蘭縣,宜蘭市,東村里,36,1,496,5,501,847,3,1,3,0,1,0,59.15
宜蘭縣,宜蘭市,東村里,37,1,429,0,429,813,3,1,3,0,1,0,52.77
宜蘭縣,宜蘭市,延平里,38,1,554,4,558,1000,3,1,3,0,1,0,55.80
宜蘭縣,宜蘭市,延平里,39,1,843,8,851,1528,3,1,3,0,1,0,55.69
宜蘭縣,宜蘭市,延平里,40,1,774,5,779,1391,3,1,3,0,1,0,56.00
宜蘭縣,宜蘭市,七張里,41,1,687,1,688,1143,3,1,3,0,1,0,60.19
宜蘭縣,宜蘭市,慈安里,42,1,526,2,528,894,3,1,3,0,1,0,59.06
宜蘭縣,宜蘭市,慈安里,43,1,397,5,402,720,3,1,3,0,1,0,55.83
宜蘭縣,宜蘭市,慈安里,44,1,439,1,440,765,3,1,3,0,1,0,57.52
宜蘭縣,宜蘭市,新民里,45,1,412,3,415,768,3,1,3,0,1,0,54.04
宜蘭縣,宜蘭市,東門里,46,1,717,6,723,1207,3,1,3,0,1,0,59.90
宜蘭縣,宜蘭市,中正里,47,1,757,5,762,1373,3,1,3,0,1,0,55.50
宜蘭縣,宜蘭市,小東里,48,1,336,1,337,590,3,1,3,0,1,0,57.12
宜蘭縣,宜蘭市,菜園里,49,1,460,6,466,781,3,1,3,0,1,0,59.67
宜蘭縣,宜蘭市,孝廉里,50,1,812,8,820,1453,3,1,3,0,1,0,56.43
宜蘭縣,宜蘭市,新生里,51,1,677,1,678,1166,3,1,3,0,1,0,58.15
宜蘭縣,宜蘭市,新生里,52,1,660,4,664,1112,3,1,3,0,1,0,59.71
宜蘭縣,宜蘭市,茭白里,53,1,719,3,722,1342,3,1,3,0,1,0,53.80
宜蘭縣,宜蘭市,茭白里,54,1,644,6,650,1211,3,1,3,0,1,0,53.67
宜蘭縣,宜蘭市,北津里,55,1,700,5,705,1216,3,1,3,0,1,0,57.98
宜蘭縣,宜蘭市,梅洲里,56,1,772,7,779,1424,3,1,3,0,1,0,54.71
宜蘭縣,宜蘭市,梅洲里,57,1,689,5,694,1140,3,1,3,0,1,0,60.88
宜蘭縣,宜蘭市,北門里,58,1,475,3,478,925,3,1,3,0,1,0,51.68
宜蘭縣,宜蘭市,慶和里,59,1,808,5,813,1438,3,1,3,0,1,0,56.54
宜蘭縣,宜蘭市,鄂王里,60,1,801,3,804,1444,3,1,3,0,1,0,55.68
宜蘭縣,宜蘭市,西門里,61,1,617,1,618,1019,3,1,3,0,1,0,60.65
宜蘭縣,宜蘭市,中山里,62,1,467,4,471,795,3,1,3,0,1,0,59.25
宜蘭縣,宜蘭市,大道里,63,1,589,5,594,1026,3,1,3,0,1,0,57.89
宜蘭縣,羅東鎮,開羅里,64,1,280,2,282,491,3,1,3,0,1,0,57.43
宜蘭縣,羅東鎮,開元里,65,1,329,3,332,535,3,1,3,0,1,0,62.06
宜蘭縣,羅東鎮,東明里,66,1,257,2,259,494,3,1,3,0,1,0,52.43
宜蘭縣,羅東鎮,大新里,67,1,704,7,711,1273,3,1,3,0,1,0,55.85
宜蘭縣,羅東鎮,東安里,68,1,503,6,509,816,3,1,3,0,1,0,62.38
宜蘭縣,羅東鎮,東安里,69,1,806,6,812,1653,3,1,3,0,1,0,49.12
宜蘭縣,羅東鎮,新群里,70,1,627,2,629,1084,3,1,3,0,1,0,58.03
宜蘭縣,羅東鎮,新群里,71,1,486,6,492,996,3,1,3,0,1,0,49.40
宜蘭縣,羅東鎮,羅莊里,72,1,559,6,565,1095,3,1,3,0,1,0,51.60
宜蘭縣,羅東鎮,羅莊里,73,1,483,1,484,982,3,1,3,0,1,0,49.29
宜蘭縣,羅東鎮,南昌里,74,1,780,4,784,1404,3,1,3,0,1,0,55.84
宜蘭縣,羅東鎮,南昌里,75,1,501,2,503,844,3,1,3,0,1,0,59.60
宜蘭縣,羅東鎮,南豪里,76,1,754,18,772,1335,3,1,3,0,1,0,57.83
宜蘭縣,羅東鎮,成功里,77,1,820,2,822,1320,3,1,3,0,1,0,62.27
宜蘭縣,羅東鎮,仁德里,78,1,476,5,481,829,3,1,3,0,1,0,58.02
宜蘭縣,羅東鎮,居仁里,79,1,375,4,379,710,3,1,3,0,1,0,53.38
宜蘭縣,羅東鎮,義和里,80,1,471,1,472,829,3,1,3,0,1,0,56.94
宜蘭縣,羅東鎮,羅東里,81,1,379,0,379,604,3,1,3,0,1,0,62.75
宜蘭縣,羅東鎮,浮崙里,82,1,412,1,413,702,3,1,3,0,1,0,58.83
宜蘭縣,羅東鎮,漢民里,83,1,627,7,634,1085,3,1,3,0,1,0,58.43
宜蘭縣,羅東鎮,漢民里,84,1,809,7,816,1451,3,1,3,0,1,0,56.24
宜蘭縣,羅東鎮,漢民里,85,1,521,5,526,990,3,1,3,0,1,0,53.13
宜蘭縣,羅東鎮,西安里,86,1,514,6,520,958,3,1,3,0,1,0,54.28
宜蘭縣,羅東鎮,西安里,87,1,811,2,813,1489,3,1,3,0,1,0,54.60
宜蘭縣,羅東鎮,西安里,88,1,567,5,572,1069,3,1,3,0,1,0,53.51
宜蘭縣,羅東鎮,西安里,89,1,750,2,752,1380,3,1,3,0,1,0,54.49
宜蘭縣,羅東鎮,北成里,90,1,771,4,775,1387,3,1,3,0,1,0,55.88
宜蘭縣,羅東鎮,北成里,91,1,716,3,719,1335,3,1,3,0,1,0,53.86
宜蘭縣,羅東鎮,北成里,92,1,748,5,753,1416,3,1,3,0,1,0,53.18
宜蘭縣,羅東鎮,北成里,93,1,746,6,752,1424,3,1,3,0,1,0,52.81
宜蘭縣,羅東鎮,賢文里,94,1,715,4,719,1363,3,1,3,0,1,0,52.75
宜蘭縣,羅東鎮,賢文里,95,1,568,5,573,1028,3,1,3,0,1,0,55.74
宜蘭縣,羅東鎮,賢文里,96,1,591,6,597,1037,3,1,3,0,1,0,57.57
宜蘭縣,羅東鎮,公正里,97,1,557,2,559,1005,3,1,3,0,1,0,55.62
宜蘭縣,羅東鎮,公正里,98,1,496,3,499,873,3,1,3,0,1,0,57.16
宜蘭縣,羅東鎮,集祥里,99,1,517,5,522,1074,3,1,3,0,1,0,48.60
宜蘭縣,羅東鎮,信義里,100,1,769,3,772,1494,3,1,3,0,1,0,51.67
宜蘭縣,羅東鎮,信義里,101,1,792,4,796,1498,3,1,3,0,1,0,53.14
宜蘭縣,羅東鎮,樹林里,102,1,768,6,774,1416,3,1,3,0,1,0,54.66
宜蘭縣,羅東鎮,樹林里,103,1,648,3,651,1223,3,1,3,0,1,0,53.23
宜蘭縣,羅東鎮,樹林里,104,1,796,8,804,1444,3,1,3,0,1,0,55.68
宜蘭縣,羅東鎮,竹林里,105,1,679,8,687,1218,3,1,3,0,1,0,56.40
宜蘭縣,羅東鎮,竹林里,106,1,639,3,642,1162,3,1,3,0,1,0,55.25
宜蘭縣,羅東鎮,仁愛里,107,1,628,5,633,1191,3,1,3,0,1,0,53.15
宜蘭縣,羅東鎮,仁愛里,108,1,623,4,627,1146,3,1,3,0,1,0,54.71
宜蘭縣,蘇澳鎮,龍德里,109,1,371,5,376,658,3,1,3,0,1,0,57.14
宜蘭縣,蘇澳鎮,龍德里,110,1,659,3,662,1210,3,1,3,0,1,0,54.71
宜蘭縣,蘇澳鎮,龍德里,111,1,641,4,645,1138,3,1,3,0,1,0,56.68
宜蘭縣,蘇澳鎮,頂寮里,112,1,462,6,468,778,3,1,3,0,1,0,60.15
宜蘭縣,蘇澳鎮,永榮里,113,1,549,1,550,1077,3,1,3,0,1,0,51.07
宜蘭縣,蘇澳鎮,永榮里,114,1,542,2,544,973,3,1,3,0,1,0,55.91
宜蘭縣,蘇澳鎮,永榮里,115,1,482,3,485,898,3,1,3,0,1,0,54.01
宜蘭縣,蘇澳鎮,存仁里,116,1,368,1,369,599,3,1,3,0,1,0,61.60
宜蘭縣,蘇澳鎮,存仁里,117,1,232,1,233,349,3,1,3,0,1,0,66.76
宜蘭縣,蘇澳鎮,港邊里,118,1,400,6,406,757,3,1,3,0,1,0,53.63
宜蘭縣,蘇澳鎮,港邊里,119,1,231,1,232,432,3,1,3,0,1,0,53.70
宜蘭縣,蘇澳鎮,岳明里,120,1,115,3,118,237,3,1,3,0,1,0,49.79
宜蘭縣,蘇澳鎮,隘丁里,121,1,562,5,567,1042,3,1,3,0,1,0,54.41
宜蘭縣,蘇澳鎮,隘丁里,122,1,517,5,522,1079,3,1,3,0,1,0,48.38
宜蘭縣,蘇澳鎮,新城里,123,1,623,7,630,1084,3,1,3,0,1,0,58.12
宜蘭縣,蘇澳鎮,聖湖里,124,1,632,7,639,1343,3,1,3,0,1,0,47.58
宜蘭縣,蘇澳鎮,聖湖里,125,1,522,2,524,1013,3,1,3,0,1,0,51.73
宜蘭縣,蘇澳鎮,聖湖里,126,1,683,4,687,1309,3,1,3,0,1,0,52.48
宜蘭縣,蘇澳鎮,聖湖里,127,1,671,1,672,1296,3,1,3,0,1,0,51.85
宜蘭縣,蘇澳鎮,蘇西里,128,1,656,8,664,1131,3,1,3,0,1,0,58.71
宜蘭縣,蘇澳鎮,蘇西里,129,1,655,4,659,1199,3,1,3,0,1,0,54.96
宜蘭縣,蘇澳鎮,蘇北里,130,1,711,4,715,1193,3,1,3,0,1,0,59.93
宜蘭縣,蘇澳鎮,蘇南里,131,1,334,2,336,566,3,1,3,0,1,0,59.36
宜蘭縣,蘇澳鎮,蘇東里,132,1,266,1,267,524,3,1,3,0,1,0,50.95
宜蘭縣,蘇澳鎮,長安里,133,1,334,0,334,609,3,1,3,0,1,0,54.84
宜蘭縣,蘇澳鎮,永光里,134,1,286,1,287,464,3,1,3,0,1,0,61.85
宜蘭縣,蘇澳鎮,永春里,135,1,347,6,353,633,3,1,3,0,1,0,55.77
宜蘭縣,蘇澳鎮,永樂里,136,1,322,0,322,502,3,1,3,0,1,0,64.14
宜蘭縣,蘇澳鎮,南安里,137,1,635,3,638,1055,3,1,3,0,1,0,60.47
宜蘭縣,蘇澳鎮,南正里,138,1,572,3,575,1045,3,1,3,0,1,0,55.02
宜蘭縣,蘇澳鎮,南成里,139,1,673,4,677,1189,3,1,3,0,1,0,56.94
宜蘭縣,蘇澳鎮,南興里,140,1,429,1,430,843,3,1,3,0,1,0,51.01
宜蘭縣,蘇澳鎮,南興里,141,1,372,4,376,768,3,1,3,0,1,0,48.96
宜蘭縣,蘇澳鎮,南寧里,142,1,635,4,639,1148,3,1,3,0,1,0,55.66
宜蘭縣,蘇澳鎮,南建里,143,1,698,3,701,1313,3,1,3,0,1,0,53.39
宜蘭縣,蘇澳鎮,東澳里,144,1,161,5,166,301,3,1,3,0,1,0,55.15
宜蘭縣,蘇澳鎮,南強里,145,1,408,4,412,785,3,1,3,0,1,0,52.48
宜蘭縣,蘇澳鎮,朝陽里,146,1,234,6,240,469,3,1,3,0,1,0,51.17
宜蘭縣,蘇澳鎮,朝陽里,147,1,141,3,144,252,3,1,3,0,1,0,57.14
宜蘭縣,頭城鎮,石城里,148,1,190,0,190,366,3,1,3,0,1,0,51.91
宜蘭縣,頭城鎮,大里里,149,1,394,2,396,735,3,1,3,0,1,0,53.88
宜蘭縣,頭城鎮,龜山里,150,1,495,3,498,910,3,1,3,0,1,0,54.73
宜蘭縣,頭城鎮,大溪里,151,1,223,0,223,391,3,1,3,0,1,0,57.03
宜蘭縣,頭城鎮,合興里,152,1,939,5,944,1400,3,1,3,0,1,0,67.43
宜蘭縣,頭城鎮,更新里,153,1,506,4,510,932,3,1,3,0,1,0,54.72
宜蘭縣,頭城鎮,外澳里,154,1,360,4,364,625,3,1,3,0,1,0,58.24
宜蘭縣,頭城鎮,港口里,155,1,771,7,778,1431,3,1,3,0,1,0,54.37
宜蘭縣,頭城鎮,武營里,156,1,711,6,717,1223,3,1,3,0,1,0,58.63
宜蘭縣,頭城鎮,大坑里,157,1,505,3,508,751,3,1,3,0,1,0,67.64
宜蘭縣,頭城鎮,城東里,158,1,343,0,343,543,3,1,3,0,1,0,63.17
宜蘭縣,頭城鎮,城北里,159,1,401,3,404,622,3,1,3,0,1,0,64.95
宜蘭縣,頭城鎮,城西里,160,1,376,6,382,622,3,1,3,0,1,0,61.41
宜蘭縣,頭城鎮,城南里,161,1,538,3,541,993,3,1,3,0,1,0,54.48
宜蘭縣,頭城鎮,竹安里,162,1,580,2,582,1020,3,1,3,0,1,0,57.06
宜蘭縣,頭城鎮,竹安里,163,1,507,3,510,783,3,1,3,0,1,0,65.13
宜蘭縣,頭城鎮,新建里,164,1,547,4,551,1026,3,1,3,0,1,0,53.70
宜蘭縣,頭城鎮,新建里,165,1,765,4,769,1384,3,1,3,0,1,0,55.56
宜蘭縣,頭城鎮,拔雅里,166,1,512,7,519,999,3,1,3,0,1,0,51.95
宜蘭縣,頭城鎮,福成里,167,1,873,5,878,1666,3,1,3,0,1,0,52.70
宜蘭縣,頭城鎮,金面里,168,1,384,2,386,693,3,1,3,0,1,0,55.70
宜蘭縣,頭城鎮,金盈里,169,1,754,8,762,1277,3,1,3,0,1,0,59.67
宜蘭縣,頭城鎮,頂埔里,170,1,585,5,590,942,3,1,3,0,1,0,62.63
宜蘭縣,頭城鎮,下埔里,171,1,596,5,601,974,3,1,3,0,1,0,61.70
宜蘭縣,頭城鎮,中崙里,172,1,626,7,633,1085,3,1,3,0,1,0,58.34
宜蘭縣,頭城鎮,二城里,173,1,364,2,366,637,3,1,3,0,1,0,57.46
宜蘭縣,礁溪鄉,白雲村,174,1,810,9,819,1402,3,1,3,0,1,0,58.42
宜蘭縣,礁溪鄉,玉石村,175,1,979,7,986,1643,3,1,3,0,1,0,60.01
宜蘭縣,礁溪鄉,德陽村,176,1,903,9,912,1674,3,1,3,0,1,0,54.48
宜蘭縣,礁溪鄉,德陽村,177,1,968,8,976,1777,3,1,3,0,1,0,54.92
宜蘭縣,礁溪鄉,大忠村,178,1,750,4,754,1371,3,1,3,0,1,0,55.00
宜蘭縣,礁溪鄉,大忠村,179,1,485,3,488,792,3,1,3,0,1,0,61.62
宜蘭縣,礁溪鄉,大義村,180,1,416,3,419,681,3,1,3,0,1,0,61.53
宜蘭縣,礁溪鄉,六結村,181,1,851,1,852,1407,3,1,3,0,1,0,60.55
宜蘭縣,礁溪鄉,二龍村,182,1,670,7,677,1095,3,1,3,0,1,0,61.83
宜蘭縣,礁溪鄉,時潮村,183,1,840,10,850,1377,3,1,3,0,1,0,61.73
宜蘭縣,礁溪鄉,玉田村,184,1,453,6,459,829,3,1,3,0,1,0,55.37
宜蘭縣,礁溪鄉,玉田村,185,1,612,4,616,1043,3,1,3,0,1,0,59.06
宜蘭縣,礁溪鄉,三民村,186,1,808,9,817,1381,3,1,3,0,1,0,59.16
宜蘭縣,礁溪鄉,三民村,187,1,507,2,509,908,3,1,3,0,1,0,56.06
宜蘭縣,礁溪鄉,林美村,188,1,640,7,647,1071,3,1,3,0,1,0,60.41
宜蘭縣,礁溪鄉,白鵝村,189,1,437,2,439,726,3,1,3,0,1,0,60.47
宜蘭縣,礁溪鄉,玉光村,190,1,537,3,540,908,3,1,3,0,1,0,59.47
宜蘭縣,礁溪鄉,光武村,191,1,655,4,659,1113,3,1,3,0,1,0,59.21
宜蘭縣,礁溪鄉,吳沙村,192,1,640,4,644,1051,3,1,3,0,1,0,61.27
宜蘭縣,礁溪鄉,吳沙村,193,1,699,1,700,1162,3,1,3,0,1,0,60.24
宜蘭縣,礁溪鄉,龍潭村,194,1,829,8,837,1458,3,1,3,0,1,0,57.41
宜蘭縣,礁溪鄉,龍潭村,195,1,715,11,726,1305,3,1,3,0,1,0,55.63
宜蘭縣,礁溪鄉,匏崙村,196,1,510,1,511,931,3,1,3,0,1,0,54.89
宜蘭縣,礁溪鄉,二結村,197,1,252,3,255,408,3,1,3,0,1,0,62.50
宜蘭縣,壯圍鄉,吉祥村,198,1,543,10,553,949,3,1,3,0,1,0,58.27
宜蘭縣,壯圍鄉,吉祥村,199,1,532,3,535,900,3,1,3,0,1,0,59.44
宜蘭縣,壯圍鄉,古結村,200,1,450,1,451,815,3,1,3,0,1,0,55.34
宜蘭縣,壯圍鄉,美福村,201,1,467,3,470,789,3,1,3,0,1,0,59.57
宜蘭縣,壯圍鄉,美福村,202,1,536,4,540,877,3,1,3,0,1,0,61.57
宜蘭縣,壯圍鄉,新南村,203,1,508,5,513,975,3,1,3,0,1,0,52.62
宜蘭縣,壯圍鄉,東港村,204,1,448,3,451,798,3,1,3,0,1,0,56.52
宜蘭縣,壯圍鄉,復興村,205,1,431,1,432,815,3,1,3,0,1,0,53.01
宜蘭縣,壯圍鄉,復興村,206,1,484,3,487,896,3,1,3,0,1,0,54.35
宜蘭縣,壯圍鄉,過嶺村,207,1,355,1,356,690,3,1,3,0,1,0,51.59
宜蘭縣,壯圍鄉,過嶺村,208,1,480,2,482,852,3,1,3,0,1,0,56.57
宜蘭縣,壯圍鄉,永鎮村,209,1,489,1,490,820,3,1,3,0,1,0,59.76
宜蘭縣,壯圍鄉,忠孝村,210,1,697,4,701,1269,3,1,3,0,1,0,55.24
宜蘭縣,壯圍鄉,忠孝村,211,1,747,2,749,1275,3,1,3,0,1,0,58.75
宜蘭縣,壯圍鄉,古亭村,212,1,567,2,569,973,3,1,3,0,1,0,58.48
宜蘭縣,壯圍鄉,功勞村,213,1,542,4,546,937,3,1,3,0,1,0,58.27
宜蘭縣,壯圍鄉,美城村,214,1,603,4,607,998,3,1,3,0,1,0,60.82
宜蘭縣,壯圍鄉,美城村,215,1,656,2,658,1056,3,1,3,0,1,0,62.31
宜蘭縣,壯圍鄉,新社村,216,1,488,2,490,882,3,1,3,0,1,0,55.56
宜蘭縣,壯圍鄉,大福村,217,1,441,2,443,738,3,1,3,0,1,0,60.03
宜蘭縣,壯圍鄉,大福村,218,1,557,3,560,954,3,1,3,0,1,0,58.70
宜蘭縣,員山鄉,員山村,219,1,769,5,774,1506,3,1,3,0,1,0,51.39
宜蘭縣,員山鄉,員山村,220,1,726,2,728,1321,3,1,3,0,1,0,55.11
宜蘭縣,員山鄉,員山村,221,1,760,4,764,1428,3,1,3,0,1,0,53.50
宜蘭縣,員山鄉,尚德村,222,1,477,2,479,948,3,1,3,0,1,0,50.53
宜蘭縣,員山鄉,尚德村,223,1,464,6,470,881,3,1,3,0,1,0,53.35
宜蘭縣,員山鄉,惠好村,224,1,729,4,733,1222,3,1,3,0,1,0,59.98
宜蘭縣,員山鄉,七賢村,225,1,543,1,544,969,3,1,3,0,1,0,56.14
宜蘭縣,員山鄉,深溝村,226,1,783,9,792,1449,3,1,3,0,1,0,54.66
宜蘭縣,員山鄉,蓁巷村,227,1,621,8,629,1198,3,1,3,0,1,0,52.50
宜蘭縣,員山鄉,內城村,228,1,544,6,550,961,3,1,3,0,1,0,57.23
宜蘭縣,員山鄉,內城村,229,1,250,1,251,439,3,1,3,0,1,0,57.18
宜蘭縣,員山鄉,中華村,230,1,239,1,240,443,3,1,3,0,1,0,54.18
宜蘭縣,員山鄉,中華村,231,1,137,1,138,268,3,1,3,0,1,0,51.49
宜蘭縣,員山鄉,永和村,232,1,885,2,887,1601,3,1,3,0,1,0,55.40
宜蘭縣,員山鄉,頭分村,233,1,624,5,629,1093,3,1,3,0,1,0,57.55
宜蘭縣,員山鄉,枕山村,234,1,920,1,921,1586,3,1,3,0,1,0,58.07
宜蘭縣,員山鄉,枕山村,235,1,282,3,285,512,3,1,3,0,1,0,55.66
宜蘭縣,員山鄉,同樂村,236,1,715,10,725,1228,3,1,3,0,1,0,59.04
宜蘭縣,員山鄉,同樂村,237,1,651,3,654,1238,3,1,3,0,1,0,52.83
宜蘭縣,員山鄉,湖東村,238,1,475,2,477,840,3,1,3,0,1,0,56.79
宜蘭縣,員山鄉,逸仙村,239,1,460,1,461,815,3,1,3,0,1,0,56.56
宜蘭縣,員山鄉,湖北村,240,1,553,14,567,972,3,1,3,0,1,0,58.33
宜蘭縣,員山鄉,湖西村,241,1,828,8,836,1460,3,1,3,0,1,0,57.26
宜蘭縣,冬山鄉,珍珠村,242,1,636,6,642,1050,3,1,3,0,1,0,61.14
宜蘭縣,冬山鄉,補城村,243,1,787,7,794,1344,3,1,3,0,1,0,59.08
宜蘭縣,冬山鄉,三奇村,244,1,574,3,577,1000,3,1,3,0,1,0,57.70
宜蘭縣,冬山鄉,大興村,245,1,481,3,484,812,3,1,3,0,1,0,59.61
宜蘭縣,冬山鄉,東城村,246,1,562,3,565,924,3,1,3,0,1,0,61.15
宜蘭縣,冬山鄉,香和村,247,1,681,4,685,1185,3,1,3,0,1,0,57.81
宜蘭縣,冬山鄉,香和村,248,1,562,3,565,980,3,1,3,0,1,0,57.65
宜蘭縣,冬山鄉,南興村,249,1,607,7,614,1056,3,1,3,0,1,0,58.14
宜蘭縣,冬山鄉,南興村,250,1,505,3,508,841,3,1,3,0,1,0,60.40
宜蘭縣,冬山鄉,安平村,251,1,607,7,614,1109,3,1,3,0,1,0,55.37
宜蘭縣,冬山鄉,冬山村,252,1,496,3,499,821,3,1,3,0,1,0,60.78
宜蘭縣,冬山鄉,太和村,253,1,387,3,390,694,3,1,3,0,1,0,56.20
宜蘭縣,冬山鄉,八寶村,254,1,840,9,849,1331,3,1,3,0,1,0,63.79
宜蘭縣,冬山鄉,丸山村,255,1,475,3,478,799,3,1,3,0,1,0,59.82
宜蘭縣,冬山鄉,中山村,256,1,707,6,713,1232,3,1,3,0,1,0,57.87
宜蘭縣,冬山鄉,順安村,257,1,271,1,272,447,3,1,3,0,1,0,60.85
宜蘭縣,冬山鄉,順安村,258,1,610,3,613,1207,3,1,3,0,1,0,50.79
宜蘭縣,冬山鄉,順安村,259,1,805,5,810,1633,3,1,3,0,1,0,49.60
宜蘭縣,冬山鄉,永美村,260,1,794,2,796,1512,3,1,3,0,1,0,52.65
宜蘭縣,冬山鄉,永美村,261,1,505,2,507,873,3,1,3,0,1,0,58.08
宜蘭縣,冬山鄉,武淵村,262,1,646,7,653,1197,3,1,3,0,1,0,54.55
宜蘭縣,冬山鄉,群英村,263,1,678,6,684,1221,3,1,3,0,1,0,56.02
宜蘭縣,冬山鄉,群英村,264,1,610,3,613,1073,3,1,3,0,1,0,57.13
宜蘭縣,冬山鄉,群英村,265,1,718,5,723,1249,3,1,3,0,1,0,57.89
宜蘭縣,冬山鄉,群英村,266,1,534,4,538,944,3,1,3,0,1,0,56.99
宜蘭縣,冬山鄉,清溝村,267,1,744,7,751,1291,3,1,3,0,1,0,58.17
宜蘭縣,冬山鄉,清溝村,268,1,737,4,741,1406,3,1,3,0,1,0,52.70
宜蘭縣,冬山鄉,鹿埔村,269,1,611,1,612,1093,3,1,3,0,1,0,55.99
宜蘭縣,冬山鄉,鹿埔村,270,1,585,5,590,1101,3,1,3,0,1,0,53.59
宜蘭縣,冬山鄉,得安村,271,1,533,6,539,1062,3,1,3,0,1,0,50.75
宜蘭縣,冬山鄉,廣興村,272,1,629,2,631,1125,3,1,3,0,1,0,56.09
宜蘭縣,冬山鄉,廣興村,273,1,557,5,562,1119,3,1,3,0,1,0,50.22
宜蘭縣,冬山鄉,廣安村,274,1,697,4,701,1347,3,1,3,0,1,0,52.04
宜蘭縣,冬山鄉,柯林村,275,1,615,7,622,1121,3,1,3,0,1,0,55.49
宜蘭縣,冬山鄉,大進村,276,1,479,4,483,838,3,1,3,0,1,0,57.64
宜蘭縣,五結鄉,三興村,277,1,935,6,941,1563,3,1,3,0,1,0,60.20
宜蘭縣,五結鄉,二結村,278,1,893,9,902,1465,3,1,3,0,1,0,61.57
宜蘭縣,五結鄉,鎮安村,279,1,597,6,603,1036,3,1,3,0,1,0,58.20
宜蘭縣,五結鄉,鎮安村,280,1,582,11,593,1051,3,1,3,0,1,0,56.42
宜蘭縣,五結鄉,上四村,281,1,829,0,829,1470,3,1,3,0,1,0,56.39
宜蘭縣,五結鄉,中興村,282,1,521,7,528,1027,3,1,3,0,1,0,51.41
宜蘭縣,五結鄉,四結村,283,1,498,3,501,908,3,1,3,0,1,0,55.18
宜蘭縣,五結鄉,四結村,284,1,666,5,671,1187,3,1,3,0,1,0,56.53
宜蘭縣,五結鄉,福興村,285,1,859,6,865,1480,3,1,3,0,1,0,58.45
宜蘭縣,五結鄉,五結村,286,1,842,4,846,1364,3,1,3,0,1,0,62.02
宜蘭縣,五結鄉,五結村,287,1,742,4,746,1398,3,1,3,0,1,0,53.36
宜蘭縣,五結鄉,大吉村,288,1,954,10,964,1653,3,1,3,0,1,0,58.32
宜蘭縣,五結鄉,大吉村,289,1,635,7,642,1105,3,1,3,0,1,0,58.10
宜蘭縣,五結鄉,協和村,290,1,807,4,811,1478,3,1,3,0,1,0,54.87
宜蘭縣,五結鄉,協和村,291,1,491,5,496,919,3,1,3,0,1,0,53.97
宜蘭縣,五結鄉,孝威村,292,1,733,2,735,1352,3,1,3,0,1,0,54.36
宜蘭縣,五結鄉,錦眾村,293,1,787,9,796,1449,3,1,3,0,1,0,54.93
宜蘭縣,五結鄉,利澤村,294,1,537,6,543,986,3,1,3,0,1,0,55.07
宜蘭縣,五結鄉,利澤村,295,1,557,5,562,951,3,1,3,0,1,0,59.10
宜蘭縣,五結鄉,成興村,296,1,899,8,907,1594,3,1,3,0,1,0,56.90
宜蘭縣,五結鄉,成興村,297,1,396,5,401,738,3,1,3,0,1,0,54.34
宜蘭縣,五結鄉,季新村,298,1,913,6,919,1710,3,1,3,0,1,0,53.74
宜蘭縣,五結鄉,季新村,299,1,414,2,416,752,3,1,3,0,1,0,55.32
宜蘭縣,三星鄉,員山村,300,1,140,1,141,236,3,1,3,0,1,0,59.75
宜蘭縣,三星鄉,天山村,301,1,309,5,314,562,3,1,3,0,1,0,55.87
宜蘭縣,三星鄉,天福村,302,1,402,5,407,782,3,1,3,0,1,0,52.05
宜蘭縣,三星鄉,雙賢村,303,1,375,9,384,653,3,1,3,0,1,0,58.81
宜蘭縣,三星鄉,人和村,304,1,254,4,258,456,3,1,3,0,1,0,56.58
宜蘭縣,三星鄉,義德村,305,1,644,5,649,1097,3,1,3,0,1,0,59.16
宜蘭縣,三星鄉,集慶村,306,1,632,2,634,1142,3,1,3,0,1,0,55.52
宜蘭縣,三星鄉,月眉村,307,1,479,5,484,789,3,1,3,0,1,0,61.34
宜蘭縣,三星鄉,拱照村,308,1,550,3,553,992,3,1,3,0,1,0,55.75
宜蘭縣,三星鄉,大隱村,309,1,909,5,914,1704,3,1,3,0,1,0,53.64
宜蘭縣,三星鄉,大隱村,310,1,747,10,757,1444,3,1,3,0,1,0,52.42
宜蘭縣,三星鄉,行健村,311,1,393,1,394,679,3,1,3,0,1,0,58.03
宜蘭縣,三星鄉,萬德村,312,1,271,2,273,559,3,1,3,0,1,0,48.84
宜蘭縣,三星鄉,貴林村,313,1,238,1,239,470,3,1,3,0,1,0,50.85
宜蘭縣,三星鄉,萬富村,314,1,409,5,414,670,3,1,3,0,1,0,61.79
宜蘭縣,三星鄉,大義村,315,1,623,7,630,1095,3,1,3,0,1,0,57.53
宜蘭縣,三星鄉,尚武村,316,1,471,5,476,778,3,1,3,0,1,0,61.18
宜蘭縣,三星鄉,大洲村,317,1,774,5,779,1258,3,1,3,0,1,0,61.92
宜蘭縣,三星鄉,尾塹村,318,1,692,6,698,1140,3,1,3,0,1,0,61.23
宜蘭縣,大同鄉,寒溪村,319,1,49,1,50,109,3,1,3,0,1,0,45.87
宜蘭縣,大同鄉,崙埤村,320,1,49,2,51,93,3,1,3,0,1,0,54.84
宜蘭縣,大同鄉,松羅村,321,1,128,0,128,247,3,1,3,0,1,0,51.82
宜蘭縣,大同鄉,復興村,322,1,130,1,131,232,3,1,3,0,1,0,56.47
宜蘭縣,大同鄉,英士村,323,1,39,0,39,80,3,1,3,0,1,0,48.75
宜蘭縣,大同鄉,樂水村,324,1,26,0,26,45,3,1,3,0,1,0,57.78
宜蘭縣,大同鄉,太平村,325,1,32,1,33,64,3,1,3,0,1,0,51.56
宜蘭縣,大同鄉,茂安村,326,1,18,0,18,49,3,1,3,0,1,0,36.73
宜蘭縣,大同鄉,四季村,327,1,34,0,34,73,3,1,3,0,1,0,46.58
宜蘭縣,大同鄉,南山村,328,1,11,0,11,16,3,1,3,0,1,0,68.75
宜蘭縣,南澳鄉,東岳村,329,1,93,0,93,210,3,1,3,0,1,0,44.29
宜蘭縣,南澳鄉,南澳村,330,1,33,0,33,81,3,1,3,0,1,0,40.74
宜蘭縣,南澳鄉,碧候村,331,1,34,0,34,62,3,1,3,0,1,0,54.84
宜蘭縣,南澳鄉,金岳村,332,1,32,1,33,60,3,1,3,0,1,0,55.00
宜蘭縣,南澳鄉,武塔村,333,1,39,1,40,110,3,1,3,0,1,0,36.36
宜蘭縣,南澳鄉,金洋村,334,1,11,0,11,30,3,1,3,0,1,0,36.67
宜蘭縣,南澳鄉,澳花村,335,1,64,1,65,138,3,1,3,0,1,0,47.10
桃園縣,桃園市,大林里,1,1,684,2,686,1108,3,1,3,0,1,0,61.91
桃園縣,桃園市,大林里,2,1,905,6,911,1440,3,1,3,0,1,0,63.26
桃園縣,桃園市,大林里,3,1,922,12,934,1622,3,1,3,0,1,0,57.58
桃園縣,桃園市,大林里,4,1,657,4,661,1148,3,1,3,0,1,0,57.58
桃園縣,桃園市,雲林里,5,1,1010,6,1016,1734,3,1,3,0,1,0,58.59
桃園縣,桃園市,雲林里,6,1,761,7,768,1423,3,1,3,0,1,0,53.97
桃園縣,桃園市,雲林里,7,1,969,11,980,1664,3,1,3,0,1,0,58.89
桃園縣,桃園市,大豐里,8,1,698,11,709,1211,3,1,3,0,1,0,58.55
桃園縣,桃園市,大豐里,9,1,973,7,980,1606,3,1,3,0,1,0,61.02
桃園縣,桃園市,大豐里,10,1,760,11,771,1390,3,1,3,0,1,0,55.47
桃園縣,桃園市,福林里,11,1,971,4,975,1494,3,1,3,0,1,0,65.26
桃園縣,桃園市,福林里,12,1,944,3,947,1563,3,1,3,0,1,0,60.59
桃園縣,桃園市,福林里,13,1,737,3,740,1348,3,1,3,0,1,0,54.90
桃園縣,桃園市,福安里,14,1,996,3,999,1851,3,1,3,0,1,0,53.97
桃園縣,桃園市,福安里,15,1,939,2,941,1535,3,1,3,0,1,0,61.30
桃園縣,桃園市,豐林里,16,1,963,8,971,1612,3,1,3,0,1,0,60.24
桃園縣,桃園市,豐林里,17,1,1159,4,1163,1937,3,1,3,0,1,0,60.04
桃園縣,桃園市,豐林里,18,1,1047,9,1056,1731,3,1,3,0,1,0,61.01
桃園縣,桃園市,建國里,19,1,852,6,858,1449,3,1,3,0,1,0,59.21
桃園縣,桃園市,建國里,20,1,939,5,944,1706,3,1,3,0,1,0,55.33
桃園縣,桃園市,建國里,21,1,693,7,700,1199,3,1,3,0,1,0,58.38
桃園縣,桃園市,東門里,22,1,696,4,700,1267,3,1,3,0,1,0,55.25
桃園縣,桃園市,東門里,23,1,749,4,753,1337,3,1,3,0,1,0,56.32
桃園縣,桃園市,東山里,24,1,1066,6,1072,1800,3,1,3,0,1,0,59.56
桃園縣,桃園市,萬壽里,25,1,570,5,575,900,3,1,3,0,1,0,63.89
桃園縣,桃園市,武陵里,26,1,826,3,829,1500,3,1,3,0,1,0,55.27
桃園縣,桃園市,民生里,27,1,880,7,887,1387,3,1,3,0,1,0,63.95
桃園縣,桃園市,文化里,28,1,454,0,454,747,3,1,3,0,1,0,60.78
桃園縣,桃園市,文明里,29,1,822,9,831,1384,3,1,3,0,1,0,60.04
桃園縣,桃園市,文昌里,30,1,591,7,598,928,3,1,3,0,1,0,64.44
桃園縣,桃園市,南門里,31,1,648,6,654,1122,3,1,3,0,1,0,58.29
桃園縣,桃園市,南門里,32,1,801,2,803,1501,3,1,3,0,1,0,53.50
桃園縣,桃園市,南門里,33,1,686,4,690,1102,3,1,3,0,1,0,62.61
桃園縣,桃園市,南門里,34,1,591,3,594,1057,3,1,3,0,1,0,56.20
桃園縣,桃園市,南華里,35,1,868,9,877,1349,3,1,3,0,1,0,65.01
桃園縣,桃園市,西門里,36,1,807,9,816,1344,3,1,3,0,1,0,60.71
桃園縣,桃園市,西湖里,37,1,758,9,767,1297,3,1,3,0,1,0,59.14
桃園縣,桃園市,長美里,38,1,577,3,580,909,3,1,3,0,1,0,63.81
桃園縣,桃園市,永興里,39,1,1033,3,1036,1695,3,1,3,0,1,0,61.12
桃園縣,桃園市,中興里,40,1,999,8,1007,1704,3,1,3,0,1,0,59.10
桃園縣,桃園市,中興里,41,1,825,5,830,1339,3,1,3,0,1,0,61.99
桃園縣,桃園市,中興里,42,1,982,7,989,1710,3,1,3,0,1,0,57.84
桃園縣,桃園市,光興里,43,1,855,6,861,1439,3,1,3,0,1,0,59.83
桃園縣,桃園市,光興里,44,1,937,3,940,1462,3,1,3,0,1,0,64.30
桃園縣,桃園市,光興里,45,1,862,2,864,1964,3,1,3,0,1,0,43.99
桃園縣,桃園市,中路里,46,1,745,4,749,1357,3,1,3,0,1,0,55.20
桃園縣,桃園市,中路里,47,1,890,8,898,1649,3,1,3,0,1,0,54.46
桃園縣,桃園市,中信里,48,1,682,4,686,1189,3,1,3,0,1,0,57.70
桃園縣,桃園市,中信里,49,1,737,3,740,1361,3,1,3,0,1,0,54.37
桃園縣,桃園市,中信里,50,1,597,8,605,1118,3,1,3,0,1,0,54.11
桃園縣,桃園市,中山里,51,1,920,5,925,1611,3,1,3,0,1,0,57.42
桃園縣,桃園市,中山里,52,1,760,6,766,1506,3,1,3,0,1,0,50.86
桃園縣,桃園市,中山里,53,1,738,5,743,1322,3,1,3,0,1,0,56.20
桃園縣,桃園市,中平里,54,1,938,9,947,1772,3,1,3,0,1,0,53.44
桃園縣,桃園市,中平里,55,1,958,8,966,1693,3,1,3,0,1,0,57.06
桃園縣,桃園市,中原里,56,1,795,8,803,1385,3,1,3,0,1,0,57.98
桃園縣,桃園市,中原里,57,1,800,6,806,1399,3,1,3,0,1,0,57.61
桃園縣,桃園市,中泰里,58,1,797,8,805,1547,3,1,3,0,1,0,52.04
桃園縣,桃園市,中泰里,59,1,832,2,834,1567,3,1,3,0,1,0,53.22
桃園縣,桃園市,中泰里,60,1,747,3,750,1384,3,1,3,0,1,0,54.19
桃園縣,桃園市,中泰里,61,1,739,2,741,1588,3,1,3,0,1,0,46.66
桃園縣,桃園市,中德里,62,1,824,3,827,1547,3,1,3,0,1,0,53.46
桃園縣,桃園市,中德里,63,1,726,10,736,1284,3,1,3,0,1,0,57.32
桃園縣,桃園市,中德里,64,1,947,7,954,1543,3,1,3,0,1,0,61.83
桃園縣,桃園市,中正里,65,1,876,5,881,1378,3,1,3,0,1,0,63.93
桃園縣,桃園市,中正里,66,1,662,4,666,1157,3,1,3,0,1,0,57.56
桃園縣,桃園市,中正里,67,1,1067,7,1074,1852,3,1,3,0,1,0,57.99
桃園縣,桃園市,文中里,68,1,769,4,773,1240,3,1,3,0,1,0,62.34
桃園縣,桃園市,文中里,69,1,790,6,796,1223,3,1,3,0,1,0,65.09
桃園縣,桃園市,中成里,70,1,629,6,635,1008,3,1,3,0,1,0,63.00
桃園縣,桃園市,中成里,71,1,888,8,896,1500,3,1,3,0,1,0,59.73
桃園縣,桃園市,中成里,72,1,737,2,739,1304,3,1,3,0,1,0,56.67
桃園縣,桃園市,玉山里,73,1,811,3,814,1346,3,1,3,0,1,0,60.48
桃園縣,桃園市,玉山里,74,1,766,6,772,1340,3,1,3,0,1,0,57.61
桃園縣,桃園市,玉山里,75,1,826,5,831,1540,3,1,3,0,1,0,53.96
桃園縣,桃園市,泰山里,76,1,779,6,785,1292,3,1,3,0,1,0,60.76
桃園縣,桃園市,泰山里,77,1,1011,16,1027,1724,3,1,3,0,1,0,59.57
桃園縣,桃園市,龍岡里,78,1,699,4,703,1228,3,1,3,0,1,0,57.25
桃園縣,桃園市,龍岡里,79,1,698,19,717,1258,3,1,3,0,1,0,57.00
桃園縣,桃園市,龍岡里,80,1,684,6,690,1298,3,1,3,0,1,0,53.16
桃園縣,桃園市,龍安里,81,1,771,6,777,1533,3,1,3,0,1,0,50.68
桃園縣,桃園市,龍安里,82,1,828,9,837,1569,3,1,3,0,1,0,53.35
桃園縣,桃園市,龍鳳里,83,1,803,4,807,1582,3,1,3,0,1,0,51.01
桃園縣,桃園市,龍鳳里,84,1,760,4,764,1422,3,1,3,0,1,0,53.73
桃園縣,桃園市,龍鳳里,85,1,745,9,754,1437,3,1,3,0,1,0,52.47
桃園縣,桃園市,龍祥里,86,1,742,4,746,1353,3,1,3,0,1,0,55.14
桃園縣,桃園市,龍祥里,87,1,863,7,870,1421,3,1,3,0,1,0,61.22
桃園縣,桃園市,龍祥里,88,1,676,4,680,1523,3,1,3,0,1,0,44.65
桃園縣,桃園市,龍祥里,89,1,805,1,806,1539,3,1,3,0,1,0,52.37
桃園縣,桃園市,龍山里,90,1,606,5,611,1025,3,1,3,0,1,0,59.61
桃園縣,桃園市,龍山里,91,1,652,7,659,1158,3,1,3,0,1,0,56.91
桃園縣,桃園市,龍山里,92,1,635,7,642,1113,3,1,3,0,1,0,57.68
桃園縣,桃園市,東埔里,93,1,840,6,846,1400,3,1,3,0,1,0,60.43
桃園縣,桃園市,東埔里,94,1,834,9,843,1341,3,1,3,0,1,0,62.86
桃園縣,桃園市,東埔里,95,1,723,6,729,1268,3,1,3,0,1,0,57.49
桃園縣,桃園市,信光里,96,1,752,5,757,1322,3,1,3,0,1,0,57.26
桃園縣,桃園市,信光里,97,1,843,3,846,1434,3,1,3,0,1,0,59.00
桃園縣,桃園市,信光里,98,1,737,5,742,1399,3,1,3,0,1,0,53.04
桃園縣,桃園市,永安里,99,1,823,4,827,1381,3,1,3,0,1,0,59.88
桃園縣,桃園市,永安里,100,1,741,6,747,1225,3,1,3,0,1,0,60.98
桃園縣,桃園市,永安里,101,1,750,3,753,1223,3,1,3,0,1,0,61.57
桃園縣,桃園市,中寧里,102,1,924,3,927,1714,3,1,3,0,1,0,54.08
桃園縣,桃園市,中寧里,103,1,758,3,761,1551,3,1,3,0,1,0,49.07
桃園縣,桃園市,中寧里,104,1,744,8,752,1529,3,1,3,0,1,0,49.18
桃園縣,桃園市,中寧里,105,1,683,1,684,1331,3,1,3,0,1,0,51.39
桃園縣,桃園市,中寧里,106,1,851,5,856,1664,3,1,3,0,1,0,51.44
桃園縣,桃園市,中埔里,107,1,597,9,606,1015,3,1,3,0,1,0,59.70
桃園縣,桃園市,中埔里,108,1,590,3,593,916,3,1,3,0,1,0,64.74
桃園縣,桃園市,南埔里,109,1,778,5,783,1447,3,1,3,0,1,0,54.11
桃園縣,桃園市,南埔里,110,1,880,7,887,1501,3,1,3,0,1,0,59.09
桃園縣,桃園市,寶慶里,111,1,713,2,715,1586,3,1,3,0,1,0,45.08
桃園縣,桃園市,寶慶里,112,1,830,5,835,1630,3,1,3,0,1,0,51.23
桃園縣,桃園市,寶慶里,113,1,714,4,718,1452,3,1,3,0,1,0,49.45
桃園縣,桃園市,寶慶里,114,1,753,6,759,1563,3,1,3,0,1,0,48.56
桃園縣,桃園市,北埔里,115,1,690,1,691,1568,3,1,3,0,1,0,44.07
桃園縣,桃園市,北埔里,116,1,708,7,715,1338,3,1,3,0,1,0,53.44
桃園縣,桃園市,北埔里,117,1,634,2,636,1315,3,1,3,0,1,0,48.37
桃園縣,桃園市,北埔里,118,1,729,3,732,1412,3,1,3,0,1,0,51.84
桃園縣,桃園市,北埔里,119,1,657,1,658,1358,3,1,3,0,1,0,48.45
桃園縣,桃園市,西埔里,120,1,864,11,875,1353,3,1,3,0,1,0,64.67
桃園縣,桃園市,西埔里,121,1,707,14,721,1078,3,1,3,0,1,0,66.88
桃園縣,桃園市,慈文里,122,1,782,16,798,1427,3,1,3,0,1,0,55.92
桃園縣,桃園市,慈文里,123,1,908,7,915,1550,3,1,3,0,1,0,59.03
桃園縣,桃園市,慈文里,124,1,776,3,779,1469,3,1,3,0,1,0,53.03
桃園縣,桃園市,新埔里,125,1,809,8,817,1404,3,1,3,0,1,0,58.19
桃園縣,桃園市,新埔里,126,1,729,4,733,1249,3,1,3,0,1,0,58.69
桃園縣,桃園市,新埔里,127,1,637,8,645,1198,3,1,3,0,1,0,53.84
桃園縣,桃園市,新埔里,128,1,1127,16,1143,1707,3,1,3,0,1,0,66.96
桃園縣,桃園市,同安里,129,1,635,9,644,1246,3,1,3,0,1,0,51.69
桃園縣,桃園市,同安里,130,1,807,8,815,1453,3,1,3,0,1,0,56.09
桃園縣,桃園市,同安里,131,1,769,0,769,1252,3,1,3,0,1,0,61.42
桃園縣,桃園市,同安里,132,1,662,2,664,1220,3,1,3,0,1,0,54.43
桃園縣,桃園市,莊敬里,133,1,710,6,716,1418,3,1,3,0,1,0,50.49
桃園縣,桃園市,莊敬里,134,1,653,2,655,1422,3,1,3,0,1,0,46.06
桃園縣,桃園市,莊敬里,135,1,664,3,667,1249,3,1,3,0,1,0,53.40
桃園縣,桃園市,莊敬里,136,1,523,3,526,1126,3,1,3,0,1,0,46.71
桃園縣,桃園市,自強里,137,1,591,4,595,1005,3,1,3,0,1,0,59.20
桃園縣,桃園市,自強里,138,1,794,5,799,1328,3,1,3,0,1,0,60.17
桃園縣,桃園市,自強里,139,1,660,5,665,1174,3,1,3,0,1,0,56.64
桃園縣,桃園市,自強里,140,1,615,2,617,1214,3,1,3,0,1,0,50.82
桃園縣,桃園市,長安里,141,1,763,6,769,1392,3,1,3,0,1,0,55.24
桃園縣,桃園市,長安里,142,1,810,6,816,1470,3,1,3,0,1,0,55.51
桃園縣,桃園市,長德里,143,1,913,4,917,1643,3,1,3,0,1,0,55.81
桃園縣,桃園市,長德里,144,1,986,7,993,1648,3,1,3,0,1,0,60.25
桃園縣,桃園市,中和里,145,1,928,6,934,1393,3,1,3,0,1,0,67.05
桃園縣,桃園市,北門里,146,1,939,13,952,1572,3,1,3,0,1,0,60.56
桃園縣,桃園市,朝陽里,147,1,1080,12,1092,1840,3,1,3,0,1,0,59.35
桃園縣,桃園市,青溪里,148,1,866,10,876,1474,3,1,3,0,1,0,59.43
桃園縣,桃園市,青溪里,149,1,703,5,708,1137,3,1,3,0,1,0,62.27
桃園縣,桃園市,青溪里,150,1,940,5,945,1635,3,1,3,0,1,0,57.80
桃園縣,桃園市,成功里,151,1,921,8,929,1503,3,1,3,0,1,0,61.81
桃園縣,桃園市,成功里,152,1,1092,4,1096,1867,3,1,3,0,1,0,58.70
桃園縣,桃園市,三民里,153,1,1082,4,1086,1726,3,1,3,0,1,0,62.92
桃園縣,桃園市,三民里,154,1,1039,6,1045,1829,3,1,3,0,1,0,57.14
桃園縣,桃園市,忠義里,155,1,915,8,923,1623,3,1,3,0,1,0,56.87
桃園縣,桃園市,忠義里,156,1,675,6,681,1253,3,1,3,0,1,0,54.35
桃園縣,桃園市,忠義里,157,1,760,4,764,1522,3,1,3,0,1,0,50.20
桃園縣,桃園市,忠義里,158,1,620,7,627,1219,3,1,3,0,1,0,51.44
桃園縣,桃園市,忠義里,159,1,617,2,619,1200,3,1,3,0,1,0,51.58
桃園縣,桃園市,大興里,160,1,651,8,659,1162,3,1,3,0,1,0,56.71
桃園縣,桃園市,大興里,161,1,611,3,614,1206,3,1,3,0,1,0,50.91
桃園縣,桃園市,大興里,162,1,753,10,763,1305,3,1,3,0,1,0,58.47
桃園縣,桃園市,大興里,163,1,670,3,673,1268,3,1,3,0,1,0,53.08
桃園縣,桃園市,大興里,164,1,482,3,485,1032,3,1,3,0,1,0,47.00
桃園縣,桃園市,會稽里,165,1,849,12,861,1711,3,1,3,0,1,0,50.32
桃園縣,桃園市,會稽里,166,1,802,9,811,1573,3,1,3,0,1,0,51.56
桃園縣,桃園市,會稽里,167,1,698,4,702,1648,3,1,3,0,1,0,42.60
桃園縣,桃園市,大有里,168,1,695,4,699,1309,3,1,3,0,1,0,53.40
桃園縣,桃園市,大有里,169,1,557,10,567,1291,3,1,3,0,1,0,43.92
桃園縣,桃園市,寶山里,170,1,772,5,777,1509,3,1,3,0,1,0,51.49
桃園縣,桃園市,寶山里,171,1,815,10,825,1919,3,1,3,0,1,0,42.99
桃園縣,桃園市,寶山里,172,1,647,4,651,1256,3,1,3,0,1,0,51.83
桃園縣,桃園市,春日里,173,1,697,8,705,1478,3,1,3,0,1,0,47.70
桃園縣,桃園市,春日里,174,1,859,9,868,1550,3,1,3,0,1,0,56.00
桃園縣,桃園市,春日里,175,1,685,10,695,1445,3,1,3,0,1,0,48.10
桃園縣,桃園市,汴洲里,176,1,1061,7,1068,1675,3,1,3,0,1,0,63.76
桃園縣,桃園市,汴洲里,177,1,990,10,1000,1697,3,1,3,0,1,0,58.93
桃園縣,龜山鄉,龜山村,178,1,864,10,874,1308,3,1,3,0,1,0,66.82
桃園縣,龜山鄉,龜山村,179,1,934,11,945,1544,3,1,3,0,1,0,61.20
桃園縣,龜山鄉,龜山村,180,1,1056,7,1063,1762,3,1,3,0,1,0,60.33
桃園縣,龜山鄉,新路村,181,1,1003,7,1010,1497,3,1,3,0,1,0,67.47
桃園縣,龜山鄉,新路村,182,1,666,5,671,1060,3,1,3,0,1,0,63.30
桃園縣,龜山鄉,新路村,183,1,807,8,815,1350,3,1,3,0,1,0,60.37
桃園縣,龜山鄉,新路村,184,1,829,7,836,1244,3,1,3,0,1,0,67.20
桃園縣,龜山鄉,大同村,185,1,904,6,910,1520,3,1,3,0,1,0,59.87
桃園縣,龜山鄉,大同村,186,1,817,8,825,1433,3,1,3,0,1,0,57.57
桃園縣,龜山鄉,大同村,187,1,869,1,870,1394,3,1,3,0,1,0,62.41
桃園縣,龜山鄉,中興村,188,1,1123,4,1127,1874,3,1,3,0,1,0,60.14
桃園縣,龜山鄉,中興村,189,1,1191,8,1199,1929,3,1,3,0,1,0,62.16
桃園縣,龜山鄉,新興村,190,1,1060,7,1067,1904,3,1,3,0,1,0,56.04
桃園縣,龜山鄉,陸光村,191,1,426,0,426,641,3,1,3,0,1,0,66.46
桃園縣,龜山鄉,精忠村,192,1,498,1,499,738,3,1,3,0,1,0,67.62
桃園縣,龜山鄉,精忠村,193,1,1300,13,1313,1789,3,1,3,0,1,0,73.39
桃園縣,龜山鄉,福源村,194,1,1069,16,1085,1754,3,1,3,0,1,0,61.86
桃園縣,龜山鄉,兔坑村,195,1,686,8,694,1175,3,1,3,0,1,0,59.06
桃園縣,龜山鄉,兔坑村,196,1,675,4,679,1434,3,1,3,0,1,0,47.35
桃園縣,龜山鄉,迴龍村,197,1,885,21,906,1590,3,1,3,0,1,0,56.98
桃園縣,龜山鄉,迴龍村,198,1,703,7,710,1343,3,1,3,0,1,0,52.87
桃園縣,龜山鄉,迴龍村,199,1,705,12,717,1426,3,1,3,0,1,0,50.28
桃園縣,龜山鄉,龍華村,200,1,668,10,678,1264,3,1,3,0,1,0,53.64
桃園縣,龜山鄉,龍華村,201,1,706,8,714,1380,3,1,3,0,1,0,51.74
桃園縣,龜山鄉,龍壽村,202,1,268,4,272,567,3,1,3,0,1,0,47.97
桃園縣,龜山鄉,龍壽村,203,1,609,6,615,938,3,1,3,0,1,0,65.57
桃園縣,龜山鄉,嶺頂村,204,1,576,9,585,954,3,1,3,0,1,0,61.32
桃園縣,龜山鄉,嶺頂村,205,1,661,5,666,1095,3,1,3,0,1,0,60.82
桃園縣,龜山鄉,嶺頂村,206,1,543,5,548,1101,3,1,3,0,1,0,49.77
桃園縣,龜山鄉,新嶺村,207,1,767,7,774,1390,3,1,3,0,1,0,55.68
桃園縣,龜山鄉,新嶺村,208,1,892,10,902,1570,3,1,3,0,1,0,57.45
桃園縣,龜山鄉,舊路村,209,1,665,9,674,1042,3,1,3,0,1,0,64.68
桃園縣,龜山鄉,舊路村,210,1,584,2,586,921,3,1,3,0,1,0,63.63
桃園縣,龜山鄉,山德村,211,1,895,9,904,1576,3,1,3,0,1,0,57.36
桃園縣,龜山鄉,山德村,212,1,861,9,870,1437,3,1,3,0,1,0,60.54
桃園縣,龜山鄉,山德村,213,1,1030,7,1037,1706,3,1,3,0,1,0,60.79
桃園縣,龜山鄉,山頂村,214,1,970,10,980,1738,3,1,3,0,1,0,56.39
桃園縣,龜山鄉,山頂村,215,1,1144,9,1153,2227,3,1,3,0,1,0,51.77
桃園縣,龜山鄉,山福村,216,1,862,10,872,1478,3,1,3,0,1,0,59.00
桃園縣,龜山鄉,山福村,217,1,807,6,813,1356,3,1,3,0,1,0,59.96
桃園縣,龜山鄉,幸福村,218,1,769,6,775,1381,3,1,3,0,1,0,56.12
桃園縣,龜山鄉,幸福村,219,1,730,14,744,1431,3,1,3,0,1,0,51.99
桃園縣,龜山鄉,幸福村,220,1,670,11,681,1310,3,1,3,0,1,0,51.98
桃園縣,龜山鄉,大湖村,221,1,610,5,615,1420,3,1,3,0,1,0,43.31
桃園縣,龜山鄉,大湖村,222,1,567,3,570,1117,3,1,3,0,1,0,51.03
桃園縣,龜山鄉,大華村,223,1,754,3,757,1476,3,1,3,0,1,0,51.29
桃園縣,龜山鄉,大華村,224,1,918,8,926,1803,3,1,3,0,1,0,51.36
桃園縣,龜山鄉,大崗村,225,1,943,11,954,1410,3,1,3,0,1,0,67.66
桃園縣,龜山鄉,大崗村,226,1,902,4,906,1493,3,1,3,0,1,0,60.68
桃園縣,龜山鄉,公西村,227,1,742,6,748,1141,3,1,3,0,1,0,65.56
桃園縣,龜山鄉,文化村,228,1,710,4,714,1335,3,1,3,0,1,0,53.48
桃園縣,龜山鄉,文化村,229,1,708,2,710,1516,3,1,3,0,1,0,46.83
桃園縣,龜山鄉,樂善村,230,1,710,58,768,1478,3,1,3,0,1,0,51.96
桃園縣,龜山鄉,樂善村,231,1,588,8,596,1277,3,1,3,0,1,0,46.67
桃園縣,龜山鄉,長庚村,232,1,546,6,552,1251,3,1,3,0,1,0,44.12
桃園縣,龜山鄉,長庚村,233,1,618,7,625,1391,3,1,3,0,1,0,44.93
桃園縣,龜山鄉,大坑村,234,1,818,13,831,1333,3,1,3,0,1,0,62.34
桃園縣,龜山鄉,南上村,235,1,797,5,802,1307,3,1,3,0,1,0,61.36
桃園縣,龜山鄉,南美村,236,1,810,8,818,1399,3,1,3,0,1,0,58.47
桃園縣,龜山鄉,楓樹村,237,1,938,4,942,1521,3,1,3,0,1,0,61.93
桃園縣,龜山鄉,楓樹村,238,1,1062,6,1068,1728,3,1,3,0,1,0,61.81
桃園縣,八德市,興仁里,239,1,868,8,876,1557,3,1,3,0,1,0,56.26
桃園縣,八德市,興仁里,240,1,876,3,879,2004,3,1,3,0,1,0,43.86
桃園縣,八德市,福興里,241,1,896,8,904,1561,3,1,3,0,1,0,57.91
桃園縣,八德市,福興里,242,1,781,8,789,1344,3,1,3,0,1,0,58.71
桃園縣,八德市,瑞豐里,243,1,812,11,823,1335,3,1,3,0,1,0,61.65
桃園縣,八德市,瑞興里,244,1,1261,11,1272,2160,3,1,3,0,1,0,58.89
桃園縣,八德市,瑞泰里,245,1,866,11,877,1538,3,1,3,0,1,0,57.02
桃園縣,八德市,瑞泰里,246,1,832,10,842,1517,3,1,3,0,1,0,55.50
桃園縣,八德市,瑞發里,247,1,862,12,874,1501,3,1,3,0,1,0,58.23
桃園縣,八德市,瑞發里,248,1,901,15,916,1604,3,1,3,0,1,0,57.11
桃園縣,八德市,瑞德里,249,1,964,6,970,1522,3,1,3,0,1,0,63.73
桃園縣,八德市,瑞德里,250,1,884,8,892,1433,3,1,3,0,1,0,62.25
桃園縣,八德市,瑞祥里,251,1,855,16,871,1401,3,1,3,0,1,0,62.17
桃園縣,八德市,瑞祥里,252,1,855,11,866,1417,3,1,3,0,1,0,61.12
桃園縣,八德市,廣興里,253,1,1063,19,1082,1992,3,1,3,0,1,0,54.32
桃園縣,八德市,廣興里,254,1,996,17,1013,1713,3,1,3,0,1,0,59.14
桃園縣,八德市,廣興里,255,1,781,13,794,1265,3,1,3,0,1,0,62.77
桃園縣,八德市,廣隆里,256,1,1254,12,1266,2034,3,1,3,0,1,0,62.24
桃園縣,八德市,廣隆里,257,1,637,6,643,1016,3,1,3,0,1,0,63.29
桃園縣,八德市,竹園里,258,1,871,9,880,1496,3,1,3,0,1,0,58.82
桃園縣,八德市,竹園里,259,1,822,8,830,1417,3,1,3,0,1,0,58.57
桃園縣,八德市,霄裡里,260,1,976,13,989,1661,3,1,3,0,1,0,59.54
桃園縣,八德市,霄裡里,261,1,714,7,721,1102,3,1,3,0,1,0,65.43
桃園縣,八德市,霄裡里,262,1,783,8,791,1176,3,1,3,0,1,0,67.26
桃園縣,八德市,茄明里,263,1,676,10,686,1471,3,1,3,0,1,0,46.63
桃園縣,八德市,茄明里,264,1,847,7,854,1553,3,1,3,0,1,0,54.99
桃園縣,八德市,茄苳里,265,1,927,5,932,1628,3,1,3,0,1,0,57.25
桃園縣,八德市,茄苳里,266,1,696,10,706,1300,3,1,3,0,1,0,54.31
桃園縣,八德市,茄苳里,267,1,764,14,778,1248,3,1,3,0,1,0,62.34
桃園縣,八德市,高明里,268,1,930,15,945,1771,3,1,3,0,1,0,53.36
桃園縣,八德市,高明里,269,1,710,14,724,1313,3,1,3,0,1,0,55.14
桃園縣,八德市,高城里,270,1,1221,12,1233,2059,3,1,3,0,1,0,59.88
桃園縣,八德市,白鷺里,271,1,1038,9,1047,1742,3,1,3,0,1,0,60.10
桃園縣,八德市,白鷺里,272,1,420,4,424,686,3,1,3,0,1,0,61.81
桃園縣,八德市,大湳里,273,1,658,6,664,1189,3,1,3,0,1,0,55.85
桃園縣,八德市,大湳里,274,1,797,15,812,1519,3,1,3,0,1,0,53.46
桃園縣,八德市,大發里,275,1,959,13,972,1722,3,1,3,0,1,0,56.45
桃園縣,八德市,大仁里,276,1,1044,8,1052,1807,3,1,3,0,1,0,58.22
桃園縣,八德市,大仁里,277,1,763,5,768,1356,3,1,3,0,1,0,56.64
桃園縣,八德市,大明里,278,1,830,6,836,1558,3,1,3,0,1,0,53.66
桃園縣,八德市,大明里,279,1,375,1,376,695,3,1,3,0,1,0,54.10
桃園縣,八德市,大安里,280,1,650,7,657,1161,3,1,3,0,1,0,56.59
桃園縣,八德市,大安里,281,1,837,10,847,1380,3,1,3,0,1,0,61.38
桃園縣,八德市,大竹里,282,1,824,5,829,1451,3,1,3,0,1,0,57.13
桃園縣,八德市,大興里,283,1,623,8,631,1101,3,1,3,0,1,0,57.31
桃園縣,八德市,大興里,284,1,694,10,704,1101,3,1,3,0,1,0,63.94
桃園縣,八德市,大愛里,285,1,526,12,538,930,3,1,3,0,1,0,57.85
桃園縣,八德市,大愛里,286,1,516,6,522,891,3,1,3,0,1,0,58.59
桃園縣,八德市,大華里,287,1,832,5,837,1521,3,1,3,0,1,0,55.03
桃園縣,八德市,大華里,288,1,576,1,577,1179,3,1,3,0,1,0,48.94
桃園縣,八德市,大華里,289,1,744,6,750,1267,3,1,3,0,1,0,59.19
桃園縣,八德市,大和里,290,1,1161,13,1174,2131,3,1,3,0,1,0,55.09
桃園縣,八德市,大和里,291,1,653,4,657,1189,3,1,3,0,1,0,55.26
桃園縣,八德市,大昌里,292,1,592,5,597,945,3,1,3,0,1,0,63.17
桃園縣,八德市,大昌里,293,1,970,7,977,1656,3,1,3,0,1,0,59.00
桃園縣,八德市,大信里,294,1,852,8,860,1693,3,1,3,0,1,0,50.80
桃園縣,八德市,大信里,295,1,805,7,812,1134,3,1,3,0,1,0,71.60
桃園縣,八德市,大信里,296,1,775,18,793,1703,3,1,3,0,1,0,46.56
桃園縣,八德市,大同里,297,1,1331,17,1348,1879,3,1,3,0,1,0,71.74
桃園縣,八德市,大同里,298,1,1185,14,1199,1828,3,1,3,0,1,0,65.59
桃園縣,八德市,大慶里,299,1,777,11,788,1370,3,1,3,0,1,0,57.52
桃園縣,八德市,大成里,300,1,1048,12,1060,1669,3,1,3,0,1,0,63.51
桃園縣,八德市,大成里,301,1,1018,12,1030,1703,3,1,3,0,1,0,60.48
桃園縣,八德市,大義里,302,1,869,12,881,1552,3,1,3,0,1,0,56.77
桃園縣,八德市,大義里,303,1,939,9,948,1586,3,1,3,0,1,0,59.77
桃園縣,八德市,大忠里,304,1,603,4,607,987,3,1,3,0,1,0,61.50
桃園縣,八德市,大忠里,305,1,469,7,476,827,3,1,3,0,1,0,57.56
桃園縣,八德市,大智里,306,1,829,7,836,1323,3,1,3,0,1,0,63.19
桃園縣,八德市,大智里,307,1,650,6,656,1050,3,1,3,0,1,0,62.48
桃園縣,八德市,大宏里,308,1,1228,16,1244,2070,3,1,3,0,1,0,60.10
桃園縣,八德市,大正里,309,1,655,12,667,1056,3,1,3,0,1,0,63.16
桃園縣,八德市,大正里,310,1,607,3,610,1060,3,1,3,0,1,0,57.55
桃園縣,八德市,大福里,311,1,588,3,591,967,3,1,3,0,1,0,61.12
桃園縣,八德市,大福里,312,1,834,3,837,1496,3,1,3,0,1,0,55.95
桃園縣,八德市,大福里,313,1,601,5,606,1042,3,1,3,0,1,0,58.16
桃園縣,八德市,大強里,314,1,740,15,755,1270,3,1,3,0,1,0,59.45
桃園縣,八德市,大強里,315,1,755,8,763,1344,3,1,3,0,1,0,56.77
桃園縣,八德市,大勇里,316,1,681,6,687,1181,3,1,3,0,1,0,58.17
桃園縣,八德市,大勇里,317,1,559,7,566,1020,3,1,3,0,1,0,55.49
桃園縣,八德市,大榮里,318,1,818,11,829,1520,3,1,3,0,1,0,54.54
桃園縣,八德市,大千里,319,1,864,6,870,1556,3,1,3,0,1,0,55.91
桃園縣,八德市,大漢里,320,1,701,6,707,1306,3,1,3,0,1,0,54.13
桃園縣,八德市,大漢里,321,1,628,10,638,1164,3,1,3,0,1,0,54.81
桃園縣,蘆竹鄉,新興村,322,1,743,8,751,1230,3,1,3,0,1,0,61.06
桃園縣,蘆竹鄉,新興村,323,1,643,11,654,999,3,1,3,0,1,0,65.47
桃園縣,蘆竹鄉,新興村,324,1,600,3,603,1093,3,1,3,0,1,0,55.17
桃園縣,蘆竹鄉,中福村,325,1,1001,12,1013,1804,3,1,3,0,1,0,56.15
桃園縣,蘆竹鄉,中福村,326,1,1067,12,1079,1685,3,1,3,0,1,0,64.04
桃園縣,蘆竹鄉,新莊村,327,1,1003,48,1051,1847,3,1,3,0,1,0,56.90
桃園縣,蘆竹鄉,新莊村,328,1,741,13,754,1252,3,1,3,0,1,0,60.22
桃園縣,蘆竹鄉,上竹村,329,1,714,6,720,1214,3,1,3,0,1,0,59.31
桃園縣,蘆竹鄉,上竹村,330,1,568,5,573,971,3,1,3,0,1,0,59.01
桃園縣,蘆竹鄉,宏竹村,331,1,683,3,686,1064,3,1,3,0,1,0,64.47
桃園縣,蘆竹鄉,宏竹村,332,1,707,8,715,1172,3,1,3,0,1,0,61.01
桃園縣,蘆竹鄉,大竹村,333,1,843,9,852,1554,3,1,3,0,1,0,54.83
桃園縣,蘆竹鄉,大竹村,334,1,853,3,856,1408,3,1,3,0,1,0,60.80
桃園縣,蘆竹鄉,富竹村,335,1,745,6,751,1164,3,1,3,0,1,0,64.52
桃園縣,蘆竹鄉,大華村,336,1,886,5,891,1348,3,1,3,0,1,0,66.10
桃園縣,蘆竹鄉,蘆竹村,337,1,620,10,630,1002,3,1,3,0,1,0,62.87
桃園縣,蘆竹鄉,蘆竹村,338,1,668,5,673,978,3,1,3,0,1,0,68.81
桃園縣,蘆竹鄉,蘆竹村,339,1,641,2,643,958,3,1,3,0,1,0,67.12
桃園縣,蘆竹鄉,南興村,340,1,807,5,812,1269,3,1,3,0,1,0,63.99
桃園縣,蘆竹鄉,南興村,341,1,1101,7,1108,2296,3,1,3,0,1,0,48.26
桃園縣,蘆竹鄉,南興村,342,1,697,6,703,1422,3,1,3,0,1,0,49.44
桃園縣,蘆竹鄉,南興村,343,1,1169,15,1184,2555,3,1,3,0,1,0,46.34
桃園縣,蘆竹鄉,南興村,344,1,687,4,691,1622,3,1,3,0,1,0,42.60
桃園縣,蘆竹鄉,南興村,345,1,596,5,601,1361,3,1,3,0,1,0,44.16
桃園縣,蘆竹鄉,南榮村,346,1,745,2,747,1474,3,1,3,0,1,0,50.68
桃園縣,蘆竹鄉,南榮村,347,1,825,7,832,1531,3,1,3,0,1,0,54.34
桃園縣,蘆竹鄉,南崁村,348,1,704,2,706,1137,3,1,3,0,1,0,62.09
桃園縣,蘆竹鄉,南崁村,349,1,776,12,788,1614,3,1,3,0,1,0,48.82
桃園縣,蘆竹鄉,錦興村,350,1,929,5,934,1629,3,1,3,0,1,0,57.34
桃園縣,蘆竹鄉,錦興村,351,1,873,8,881,1583,3,1,3,0,1,0,55.65
桃園縣,蘆竹鄉,錦中村,352,1,562,5,567,892,3,1,3,0,1,0,63.57
桃園縣,蘆竹鄉,錦中村,353,1,571,2,573,928,3,1,3,0,1,0,61.75
桃園縣,蘆竹鄉,長興村,354,1,942,15,957,1776,3,1,3,0,1,0,53.89
桃園縣,蘆竹鄉,五福村,355,1,851,6,857,1648,3,1,3,0,1,0,52.00
桃園縣,蘆竹鄉,五福村,356,1,719,5,724,1558,3,1,3,0,1,0,46.47
桃園縣,蘆竹鄉,五福村,357,1,605,2,607,1371,3,1,3,0,1,0,44.27
桃園縣,蘆竹鄉,羊稠村,358,1,715,8,723,1296,3,1,3,0,1,0,55.79
桃園縣,蘆竹鄉,羊稠村,359,1,737,4,741,1389,3,1,3,0,1,0,53.35
桃園縣,蘆竹鄉,羊稠村,360,1,797,3,800,1583,3,1,3,0,1,0,50.54
桃園縣,蘆竹鄉,羊稠村,361,1,929,7,936,1855,3,1,3,0,1,0,50.46
桃園縣,蘆竹鄉,營盤村,362,1,554,4,558,1160,3,1,3,0,1,0,48.10
桃園縣,蘆竹鄉,營盤村,363,1,641,7,648,1186,3,1,3,0,1,0,54.64
桃園縣,蘆竹鄉,營盤村,364,1,761,7,768,1483,3,1,3,0,1,0,51.79
桃園縣,蘆竹鄉,瓦窯村,365,1,865,11,876,1832,3,1,3,0,1,0,47.82
桃園縣,蘆竹鄉,內厝村,366,1,545,5,550,868,3,1,3,0,1,0,63.36
桃園縣,蘆竹鄉,內厝村,367,1,674,9,683,1022,3,1,3,0,1,0,66.83
桃園縣,蘆竹鄉,山鼻村,368,1,842,9,851,1455,3,1,3,0,1,0,58.49
桃園縣,蘆竹鄉,山腳村,369,1,657,4,661,1108,3,1,3,0,1,0,59.66
桃園縣,蘆竹鄉,山腳村,370,1,624,5,629,1092,3,1,3,0,1,0,57.60
桃園縣,蘆竹鄉,山腳村,371,1,688,5,693,1000,3,1,3,0,1,0,69.30
桃園縣,蘆竹鄉,外社村,372,1,831,7,838,1242,3,1,3,0,1,0,67.47
桃園縣,蘆竹鄉,坑子村,373,1,1026,11,1037,1552,3,1,3,0,1,0,66.82
桃園縣,蘆竹鄉,坑口村,374,1,555,9,564,882,3,1,3,0,1,0,63.95
桃園縣,蘆竹鄉,坑口村,375,1,867,13,880,1313,3,1,3,0,1,0,67.02
桃園縣,蘆竹鄉,海湖村,376,1,777,14,791,1456,3,1,3,0,1,0,54.33
桃園縣,蘆竹鄉,海湖村,377,1,744,7,751,1268,3,1,3,0,1,0,59.23
桃園縣,蘆竹鄉,海湖村,378,1,639,6,645,1182,3,1,3,0,1,0,54.57
桃園縣,大園鄉,大園村,379,1,815,6,821,1276,3,1,3,0,1,0,64.34
桃園縣,大園鄉,大園村,380,1,918,5,923,1331,3,1,3,0,1,0,69.35
桃園縣,大園鄉,大園村,381,1,876,5,881,1397,3,1,3,0,1,0,63.06
桃園縣,大園鄉,大園村,382,1,796,7,803,1208,3,1,3,0,1,0,66.47
桃園縣,大園鄉,田心村,383,1,911,4,915,1435,3,1,3,0,1,0,63.76
桃園縣,大園鄉,田心村,384,1,893,4,897,1458,3,1,3,0,1,0,61.52
桃園縣,大園鄉,田心村,385,1,912,10,922,1505,3,1,3,0,1,0,61.26
桃園縣,大園鄉,溪海村,386,1,935,11,946,1642,3,1,3,0,1,0,57.61
桃園縣,大園鄉,溪海村,387,1,913,12,925,1639,3,1,3,0,1,0,56.44
桃園縣,大園鄉,和平村,388,1,894,10,904,1442,3,1,3,0,1,0,62.69
桃園縣,大園鄉,橫峰村,389,1,716,10,726,1235,3,1,3,0,1,0,58.79
桃園縣,大園鄉,橫峰村,390,1,664,11,675,1193,3,1,3,0,1,0,56.58
桃園縣,大園鄉,橫峰村,391,1,724,13,737,1242,3,1,3,0,1,0,59.34
桃園縣,大園鄉,橫峰村,392,1,885,8,893,1432,3,1,3,0,1,0,62.36
桃園縣,大園鄉,五權村,393,1,726,7,733,1099,3,1,3,0,1,0,66.70
桃園縣,大園鄉,五權村,394,1,910,7,917,1384,3,1,3,0,1,0,66.26
桃園縣,大園鄉,五權村,395,1,791,9,800,1286,3,1,3,0,1,0,62.21
桃園縣,大園鄉,埔心村,396,1,1038,11,1049,1598,3,1,3,0,1,0,65.64
桃園縣,大園鄉,埔心村,397,1,790,6,796,1311,3,1,3,0,1,0,60.72
桃園縣,大園鄉,埔心村,398,1,912,13,925,1496,3,1,3,0,1,0,61.83
桃園縣,大園鄉,大海村,399,1,929,13,942,1341,3,1,3,0,1,0,70.25
桃園縣,大園鄉,建華村,400,1,477,4,481,694,3,1,3,0,1,0,69.31
桃園縣,大園鄉,三石村,401,1,717,7,724,1089,3,1,3,0,1,0,66.48
桃園縣,大園鄉,三石村,402,1,963,17,980,1446,3,1,3,0,1,0,67.77
桃園縣,大園鄉,果林村,403,1,848,7,855,1470,3,1,3,0,1,0,58.16
桃園縣,大園鄉,果林村,404,1,802,3,805,1412,3,1,3,0,1,0,57.01
桃園縣,大園鄉,果林村,405,1,825,14,839,1620,3,1,3,0,1,0,51.79
桃園縣,大園鄉,竹圍村,406,1,796,3,799,1238,3,1,3,0,1,0,64.54
桃園縣,大園鄉,竹圍村,407,1,682,8,690,1114,3,1,3,0,1,0,61.94
桃園縣,大園鄉,海口村,408,1,823,4,827,1414,3,1,3,0,1,0,58.49
桃園縣,大園鄉,沙崙村,409,1,704,5,709,1200,3,1,3,0,1,0,59.08
桃園縣,大園鄉,沙崙村,410,1,778,12,790,1339,3,1,3,0,1,0,59.00
桃園縣,大園鄉,後厝村,411,1,1102,8,1110,1764,3,1,3,0,1,0,62.93
桃園縣,大園鄉,圳頭村,412,1,562,5,567,892,3,1,3,0,1,0,63.57
桃園縣,大園鄉,圳頭村,413,1,692,5,697,1125,3,1,3,0,1,0,61.96
桃園縣,大園鄉,內海村,414,1,1062,12,1074,1738,3,1,3,0,1,0,61.80
桃園縣,大園鄉,北港村,415,1,747,4,751,1222,3,1,3,0,1,0,61.46
桃園縣,大園鄉,北港村,416,1,623,6,629,1132,3,1,3,0,1,0,55.57
桃園縣,大園鄉,南港村,417,1,700,12,712,1330,3,1,3,0,1,0,53.53
桃園縣,大園鄉,南港村,418,1,557,4,561,1216,3,1,3,0,1,0,46.13
桃園縣,大溪鎮,興和里,419,1,540,2,542,790,3,1,3,0,1,0,68.61
桃園縣,大溪鎮,興和里,420,1,521,10,531,834,3,1,3,0,1,0,63.67
桃園縣,大溪鎮,福仁里,421,1,675,5,680,1039,3,1,3,0,1,0,65.45
桃園縣,大溪鎮,田心里,422,1,845,5,850,1424,3,1,3,0,1,0,59.69
桃園縣,大溪鎮,田心里,423,1,670,4,674,1123,3,1,3,0,1,0,60.02
桃園縣,大溪鎮,田心里,424,1,717,3,720,1222,3,1,3,0,1,0,58.92
桃園縣,大溪鎮,一心里,425,1,644,7,651,1110,3,1,3,0,1,0,58.65
桃園縣,大溪鎮,一心里,426,1,730,9,739,1209,3,1,3,0,1,0,61.12
桃園縣,大溪鎮,一心里,427,1,646,7,653,1052,3,1,3,0,1,0,62.07
桃園縣,大溪鎮,一德里,428,1,890,8,898,1528,3,1,3,0,1,0,58.77
桃園縣,大溪鎮,一德里,429,1,728,4,732,1164,3,1,3,0,1,0,62.89
桃園縣,大溪鎮,一德里,430,1,748,7,755,1305,3,1,3,0,1,0,57.85
桃園縣,大溪鎮,月眉里,431,1,670,8,678,1078,3,1,3,0,1,0,62.89
桃園縣,大溪鎮,永福里,432,1,588,2,590,944,3,1,3,0,1,0,62.50
桃園縣,大溪鎮,康安里,433,1,723,9,732,1063,3,1,3,0,1,0,68.86
桃園縣,大溪鎮,義和里,434,1,597,9,606,960,3,1,3,0,1,0,63.13
桃園縣,大溪鎮,義和里,435,1,352,4,356,576,3,1,3,0,1,0,61.81
桃園縣,大溪鎮,美華里,436,1,609,2,611,1033,3,1,3,0,1,0,59.15
桃園縣,大溪鎮,美華里,437,1,624,14,638,990,3,1,3,0,1,0,64.44
桃園縣,大溪鎮,美華里,438,1,474,3,477,721,3,1,3,0,1,0,66.16
桃園縣,大溪鎮,福安里,439,1,699,6,705,1214,3,1,3,0,1,0,58.07
桃園縣,大溪鎮,福安里,440,1,575,7,582,932,3,1,3,0,1,0,62.45
桃園縣,大溪鎮,復興里,441,1,592,6,598,951,3,1,3,0,1,0,62.88
桃園縣,大溪鎮,新峰里,442,1,379,2,381,614,3,1,3,0,1,0,62.05
桃園縣,大溪鎮,新峰里,443,1,140,1,141,262,3,1,3,0,1,0,53.82
桃園縣,大溪鎮,中新里,444,1,554,8,562,812,3,1,3,0,1,0,69.21
桃園縣,大溪鎮,中新里,445,1,466,6,472,734,3,1,3,0,1,0,64.31
桃園縣,大溪鎮,瑞興里,446,1,854,14,868,1372,3,1,3,0,1,0,63.27
桃園縣,大溪鎮,瑞興里,447,1,416,3,419,675,3,1,3,0,1,0,62.07
桃園縣,大溪鎮,仁善里,448,1,666,9,675,1242,3,1,3,0,1,0,54.35
桃園縣,大溪鎮,仁善里,449,1,484,6,490,879,3,1,3,0,1,0,55.75
桃園縣,大溪鎮,仁善里,450,1,541,5,546,904,3,1,3,0,1,0,60.40
桃園縣,大溪鎮,僑愛里,451,1,1240,15,1255,1794,3,1,3,0,1,0,69.96
桃園縣,大溪鎮,仁義里,452,1,628,7,635,1015,3,1,3,0,1,0,62.56
桃園縣,大溪鎮,仁義里,453,1,513,10,523,776,3,1,3,0,1,0,67.40
桃園縣,大溪鎮,仁義里,454,1,537,2,539,797,3,1,3,0,1,0,67.63
桃園縣,大溪鎮,仁和里,455,1,508,4,512,896,3,1,3,0,1,0,57.14
桃園縣,大溪鎮,仁和里,456,1,818,7,825,1457,3,1,3,0,1,0,56.62
桃園縣,大溪鎮,仁愛里,457,1,868,5,873,1351,3,1,3,0,1,0,64.62
桃園縣,大溪鎮,仁愛里,458,1,368,5,373,723,3,1,3,0,1,0,51.59
桃園縣,大溪鎮,仁武里,459,1,539,5,544,914,3,1,3,0,1,0,59.52
桃園縣,大溪鎮,仁武里,460,1,696,7,703,1171,3,1,3,0,1,0,60.03
桃園縣,大溪鎮,仁文里,461,1,671,12,683,1197,3,1,3,0,1,0,57.06
桃園縣,大溪鎮,仁文里,462,1,503,5,508,882,3,1,3,0,1,0,57.60
桃園縣,大溪鎮,仁文里,463,1,494,11,505,810,3,1,3,0,1,0,62.35
桃園縣,大溪鎮,南興里,464,1,768,3,771,1194,3,1,3,0,1,0,64.57
桃園縣,大溪鎮,南興里,465,1,904,9,913,1486,3,1,3,0,1,0,61.44
桃園縣,大溪鎮,南興里,466,1,710,7,717,1235,3,1,3,0,1,0,58.06
桃園縣,大溪鎮,員林里,467,1,692,5,697,1129,3,1,3,0,1,0,61.74
桃園縣,大溪鎮,光明里,468,1,452,5,457,829,3,1,3,0,1,0,55.13
桃園縣,大溪鎮,光明里,469,1,633,10,643,1027,3,1,3,0,1,0,62.61
桃園縣,大溪鎮,瑞源里,470,1,507,2,509,827,3,1,3,0,1,0,61.55
桃園縣,大溪鎮,瑞源里,471,1,608,3,611,1015,3,1,3,0,1,0,60.20
桃園縣,大溪鎮,瑞源里,472,1,669,5,674,1134,3,1,3,0,1,0,59.44
桃園縣,大溪鎮,三元里,473,1,606,4,610,1013,3,1,3,0,1,0,60.22
桃園縣,大溪鎮,三元里,474,1,607,9,616,1026,3,1,3,0,1,0,60.04
桃園縣,大溪鎮,三元里,475,1,269,2,271,419,3,1,3,0,1,0,64.68
桃園縣,復興鄉,三民村,476,1,714,7,721,1205,3,1,3,0,1,0,59.83
桃園縣,復興鄉,澤仁村,477,1,373,1,374,618,3,1,3,0,1,0,60.52
桃園縣,復興鄉,霞雲村,478,1,29,0,29,49,3,1,3,0,1,0,59.18
桃園縣,復興鄉,義盛村,479,1,15,1,16,38,3,1,3,0,1,0,42.11
桃園縣,復興鄉,羅浮村,480,1,156,2,158,290,3,1,3,0,1,0,54.48
桃園縣,復興鄉,長興村,481,1,68,0,68,103,3,1,3,0,1,0,66.02
桃園縣,復興鄉,奎輝村,482,1,14,0,14,40,3,1,3,0,1,0,35.00
桃園縣,復興鄉,高義村,483,1,16,0,16,51,3,1,3,0,1,0,31.37
桃園縣,復興鄉,三光村,484,1,13,0,13,37,3,1,3,0,1,0,35.14
桃園縣,復興鄉,華陵村,485,1,138,2,140,326,3,1,3,0,1,0,42.94
桃園縣,中壢市,後寮里,486,1,838,8,846,1604,3,1,3,0,1,0,52.74
桃園縣,中壢市,後寮里,487,1,920,9,929,1794,3,1,3,0,1,0,51.78
桃園縣,中壢市,明德里,488,1,942,9,951,1733,3,1,3,0,1,0,54.88
桃園縣,中壢市,明德里,489,1,1078,4,1082,1782,3,1,3,0,1,0,60.72
桃園縣,中壢市,至善里,490,1,873,6,879,1724,3,1,3,0,1,0,50.99
桃園縣,中壢市,至善里,491,1,1029,4,1033,1742,3,1,3,0,1,0,59.30
桃園縣,中壢市,至善里,492,1,1043,8,1051,2060,3,1,3,0,1,0,51.02
桃園縣,中壢市,龍興里,493,1,817,6,823,1304,3,1,3,0,1,0,63.11
桃園縣,中壢市,龍興里,494,1,557,4,561,989,3,1,3,0,1,0,56.72
桃園縣,中壢市,龍興里,495,1,701,4,705,1152,3,1,3,0,1,0,61.20
桃園縣,中壢市,龍德里,496,1,824,7,831,1379,3,1,3,0,1,0,60.26
桃園縣,中壢市,龍德里,497,1,701,6,707,1101,3,1,3,0,1,0,64.21
桃園縣,中壢市,龍岡里,498,1,791,11,802,1328,3,1,3,0,1,0,60.39
桃園縣,中壢市,龍岡里,499,1,786,13,799,1192,3,1,3,0,1,0,67.03
桃園縣,中壢市,龍岡里,500,1,855,7,862,1332,3,1,3,0,1,0,64.71
桃園縣,中壢市,龍東里,501,1,871,5,876,1349,3,1,3,0,1,0,64.94
桃園縣,中壢市,龍東里,502,1,935,15,950,1441,3,1,3,0,1,0,65.93
桃園縣,中壢市,龍東里,503,1,875,8,883,1349,3,1,3,0,1,0,65.46
桃園縣,中壢市,龍昌里,504,1,928,16,944,1609,3,1,3,0,1,0,58.67
桃園縣,中壢市,龍昌里,505,1,904,5,909,1413,3,1,3,0,1,0,64.33
桃園縣,中壢市,龍昌里,506,1,976,10,986,1505,3,1,3,0,1,0,65.51
桃園縣,中壢市,龍平里,507,1,936,6,942,1339,3,1,3,0,1,0,70.35
桃園縣,中壢市,龍平里,508,1,993,11,1004,1500,3,1,3,0,1,0,66.93
桃園縣,中壢市,龍安里,509,1,464,5,469,673,3,1,3,0,1,0,69.69
桃園縣,中壢市,龍安里,510,1,908,6,914,1342,3,1,3,0,1,0,68.11
桃園縣,中壢市,仁美里,511,1,828,7,835,1424,3,1,3,0,1,0,58.64
桃園縣,中壢市,仁美里,512,1,804,2,806,1395,3,1,3,0,1,0,57.78
桃園縣,中壢市,仁美里,513,1,499,7,506,809,3,1,3,0,1,0,62.55
桃園縣,中壢市,仁福里,514,1,732,7,739,1246,3,1,3,0,1,0,59.31
桃園縣,中壢市,仁福里,515,1,588,3,591,993,3,1,3,0,1,0,59.52
桃園縣,中壢市,仁福里,516,1,661,4,665,1296,3,1,3,0,1,0,51.31
桃園縣,中壢市,仁愛里,517,1,537,7,544,852,3,1,3,0,1,0,63.85
桃園縣,中壢市,仁愛里,518,1,728,4,732,1238,3,1,3,0,1,0,59.13
桃園縣,中壢市,華愛里,519,1,619,12,631,1081,3,1,3,0,1,0,58.37
桃園縣,中壢市,華愛里,520,1,653,6,659,1108,3,1,3,0,1,0,59.48
桃園縣,中壢市,仁德里,521,1,761,10,771,1155,3,1,3,0,1,0,66.75
桃園縣,中壢市,仁德里,522,1,771,13,784,1254,3,1,3,0,1,0,62.52
桃園縣,中壢市,仁和里,523,1,687,9,696,1254,3,1,3,0,1,0,55.50
桃園縣,中壢市,仁和里,524,1,618,5,623,1080,3,1,3,0,1,0,57.69
桃園縣,中壢市,仁祥里,525,1,748,8,756,1293,3,1,3,0,1,0,58.47
桃園縣,中壢市,仁祥里,526,1,852,6,858,1309,3,1,3,0,1,0,65.55
桃園縣,中壢市,華勛里,527,1,955,11,966,1459,3,1,3,0,1,0,66.21
桃園縣,中壢市,華勛里,528,1,839,10,849,1336,3,1,3,0,1,0,63.55
桃園縣,中壢市,中堅里,529,1,444,6,450,804,3,1,3,0,1,0,55.97
桃園縣,中壢市,中堅里,530,1,463,8,471,840,3,1,3,0,1,0,56.07
桃園縣,中壢市,中堅里,531,1,394,3,397,611,3,1,3,0,1,0,64.98
桃園縣,中壢市,普仁里,532,1,629,3,632,1083,3,1,3,0,1,0,58.36
桃園縣,中壢市,普仁里,533,1,626,10,636,1124,3,1,3,0,1,0,56.58
桃園縣,中壢市,普仁里,534,1,669,5,674,1217,3,1,3,0,1,0,55.38
桃園縣,中壢市,普忠里,535,1,778,7,785,1322,3,1,3,0,1,0,59.38
桃園縣,中壢市,普忠里,536,1,662,3,665,1205,3,1,3,0,1,0,55.19
桃園縣,中壢市,普強里,537,1,900,7,907,1409,3,1,3,0,1,0,64.37
桃園縣,中壢市,普強里,538,1,894,4,898,1493,3,1,3,0,1,0,60.15
桃園縣,中壢市,信義里,539,1,997,2,999,1556,3,1,3,0,1,0,64.20
桃園縣,中壢市,信義里,540,1,981,12,993,1700,3,1,3,0,1,0,58.41
桃園縣,中壢市,正義里,541,1,1059,9,1068,1925,3,1,3,0,1,0,55.48
桃園縣,中壢市,正義里,542,1,948,4,952,1524,3,1,3,0,1,0,62.47
桃園縣,中壢市,普慶里,543,1,665,4,669,1093,3,1,3,0,1,0,61.21
桃園縣,中壢市,普慶里,544,1,796,6,802,1226,3,1,3,0,1,0,65.42
桃園縣,中壢市,普義里,545,1,598,6,604,980,3,1,3,0,1,0,61.63
桃園縣,中壢市,普義里,546,1,530,6,536,878,3,1,3,0,1,0,61.05
桃園縣,中壢市,德義里,547,1,622,1,623,981,3,1,3,0,1,0,63.51
桃園縣,中壢市,德義里,548,1,746,4,750,1295,3,1,3,0,1,0,57.92
桃園縣,中壢市,仁義里,549,1,853,10,863,1451,3,1,3,0,1,0,59.48
桃園縣,中壢市,仁義里,550,1,573,6,579,995,3,1,3,0,1,0,58.19
桃園縣,中壢市,忠義里,551,1,912,11,923,1511,3,1,3,0,1,0,61.09
桃園縣,中壢市,興仁里,552,1,742,2,744,1308,3,1,3,0,1,0,56.88
桃園縣,中壢市,興仁里,553,1,906,4,910,1502,3,1,3,0,1,0,60.59
桃園縣,中壢市,中正里,554,1,946,10,956,1649,3,1,3,0,1,0,57.97
桃園縣,中壢市,中正里,555,1,1023,11,1034,1805,3,1,3,0,1,0,57.29
桃園縣,中壢市,中山里,556,1,884,6,890,1642,3,1,3,0,1,0,54.20
桃園縣,中壢市,中山里,557,1,919,6,925,1772,3,1,3,0,1,0,52.20
桃園縣,中壢市,中山里,558,1,1006,8,1014,1974,3,1,3,0,1,0,51.37
桃園縣,中壢市,篤行里,559,1,594,3,597,1094,3,1,3,0,1,0,54.57
桃園縣,中壢市,自立里,560,1,995,7,1002,1320,3,1,3,0,1,0,75.91
桃園縣,中壢市,自立里,561,1,1224,15,1239,1728,3,1,3,0,1,0,71.70
桃園縣,中壢市,自立里,562,1,803,6,809,1434,3,1,3,0,1,0,56.42
桃園縣,中壢市,自立里,563,1,730,5,735,1415,3,1,3,0,1,0,51.94
桃園縣,中壢市,自強里,564,1,800,4,804,1307,3,1,3,0,1,0,61.51
桃園縣,中壢市,自強里,565,1,820,2,822,1408,3,1,3,0,1,0,58.38
桃園縣,中壢市,自治里,566,1,898,10,908,1362,3,1,3,0,1,0,66.67
桃園縣,中壢市,自治里,567,1,877,7,884,1350,3,1,3,0,1,0,65.48
桃園縣,中壢市,莊敬里,568,1,1379,15,1394,2042,3,1,3,0,1,0,68.27
桃園縣,中壢市,莊敬里,569,1,912,7,919,1391,3,1,3,0,1,0,66.07
桃園縣,中壢市,內壢里,570,1,719,10,729,1167,3,1,3,0,1,0,62.47
桃園縣,中壢市,內壢里,571,1,646,13,659,1134,3,1,3,0,1,0,58.11
桃園縣,中壢市,成功里,572,1,762,9,771,1291,3,1,3,0,1,0,59.72
桃園縣,中壢市,成功里,573,1,973,7,980,1719,3,1,3,0,1,0,57.01
桃園縣,中壢市,福德里,574,1,739,4,743,1227,3,1,3,0,1,0,60.55
桃園縣,中壢市,福德里,575,1,721,12,733,1188,3,1,3,0,1,0,61.70
桃園縣,中壢市,中原里,576,1,674,1,675,1005,3,1,3,0,1,0,67.16
桃園縣,中壢市,中原里,577,1,727,5,732,1126,3,1,3,0,1,0,65.01
桃園縣,中壢市,中原里,578,1,745,9,754,1343,3,1,3,0,1,0,56.14
桃園縣,中壢市,忠孝里,579,1,721,9,730,1232,3,1,3,0,1,0,59.25
桃園縣,中壢市,忠孝里,580,1,661,9,670,1185,3,1,3,0,1,0,56.54
桃園縣,中壢市,復興里,581,1,712,6,718,1253,3,1,3,0,1,0,57.30
桃園縣,中壢市,復興里,582,1,887,10,897,1533,3,1,3,0,1,0,58.51
桃園縣,中壢市,復興里,583,1,888,9,897,1679,3,1,3,0,1,0,53.42
桃園縣,中壢市,復華里,584,1,1054,7,1061,1721,3,1,3,0,1,0,61.65
桃園縣,中壢市,復華里,585,1,1049,10,1059,1658,3,1,3,0,1,0,63.87
桃園縣,中壢市,文化里,586,1,1194,8,1202,1959,3,1,3,0,1,0,61.36
桃園縣,中壢市,文化里,587,1,1050,10,1060,1823,3,1,3,0,1,0,58.15
桃園縣,中壢市,文化里,588,1,968,9,977,1641,3,1,3,0,1,0,59.54
桃園縣,中壢市,和平里,589,1,617,7,624,963,3,1,3,0,1,0,64.80
桃園縣,中壢市,和平里,590,1,667,6,673,1057,3,1,3,0,1,0,63.67
桃園縣,中壢市,內定里,591,1,1157,13,1170,1949,3,1,3,0,1,0,60.03
桃園縣,中壢市,內定里,592,1,1065,9,1074,1774,3,1,3,0,1,0,60.54
桃園縣,中壢市,石頭里,593,1,561,4,565,1005,3,1,3,0,1,0,56.22
桃園縣,中壢市,石頭里,594,1,475,3,478,1406,3,1,3,0,1,0,34.00
桃園縣,中壢市,中央里,595,1,748,4,752,1146,3,1,3,0,1,0,65.62
桃園縣,中壢市,中央里,596,1,600,3,603,999,3,1,3,0,1,0,60.36
桃園縣,中壢市,中央里,597,1,643,7,650,1035,3,1,3,0,1,0,62.80
桃園縣,中壢市,新興里,598,1,960,9,969,1659,3,1,3,0,1,0,58.41
桃園縣,中壢市,新興里,599,1,839,6,845,1490,3,1,3,0,1,0,56.71
桃園縣,中壢市,新興里,600,1,816,9,825,1515,3,1,3,0,1,0,54.46
桃園縣,中壢市,新興里,601,1,825,12,837,1461,3,1,3,0,1,0,57.29
桃園縣,中壢市,振興里,602,1,671,2,673,1067,3,1,3,0,1,0,63.07
桃園縣,中壢市,振興里,603,1,858,8,866,1462,3,1,3,0,1,0,59.23
桃園縣,中壢市,振興里,604,1,935,5,940,1549,3,1,3,0,1,0,60.68
桃園縣,中壢市,東興里,605,1,768,4,772,1357,3,1,3,0,1,0,56.89
桃園縣,中壢市,東興里,606,1,744,10,754,1247,3,1,3,0,1,0,60.47
桃園縣,中壢市,健行里,607,1,1057,7,1064,1768,3,1,3,0,1,0,60.18
桃園縣,中壢市,健行里,608,1,1022,4,1026,1858,3,1,3,0,1,0,55.22
桃園縣,中壢市,水尾里,609,1,821,5,826,1328,3,1,3,0,1,0,62.20
桃園縣,中壢市,水尾里,610,1,1013,11,1024,1692,3,1,3,0,1,0,60.52
桃園縣,中壢市,水尾里,611,1,589,1,590,982,3,1,3,0,1,0,60.08
桃園縣,中壢市,水尾里,612,1,666,3,669,1086,3,1,3,0,1,0,61.60
桃園縣,中壢市,忠福里,613,1,747,3,750,1163,3,1,3,0,1,0,64.49
桃園縣,中壢市,忠福里,614,1,799,4,803,1170,3,1,3,0,1,0,68.63
桃園縣,中壢市,忠福里,615,1,800,8,808,1363,3,1,3,0,1,0,59.28
桃園縣,中壢市,忠福里,616,1,949,6,955,1748,3,1,3,0,1,0,54.63
桃園縣,中壢市,幸福里,617,1,808,2,810,1318,3,1,3,0,1,0,61.46
桃園縣,中壢市,幸福里,618,1,762,9,771,1432,3,1,3,0,1,0,53.84
桃園縣,中壢市,幸福里,619,1,807,6,813,1512,3,1,3,0,1,0,53.77
桃園縣,中壢市,永福里,620,1,485,3,488,829,3,1,3,0,1,0,58.87
桃園縣,中壢市,永福里,621,1,1050,7,1057,1769,3,1,3,0,1,0,59.75
桃園縣,中壢市,永福里,622,1,1002,6,1008,1655,3,1,3,0,1,0,60.91
桃園縣,中壢市,青埔里,623,1,696,6,702,1080,3,1,3,0,1,0,65.00
桃園縣,中壢市,新街里,624,1,1055,5,1060,1898,3,1,3,0,1,0,55.85
桃園縣,中壢市,興南里,625,1,792,8,800,1386,3,1,3,0,1,0,57.72
桃園縣,中壢市,興南里,626,1,401,3,404,748,3,1,3,0,1,0,54.01
桃園縣,中壢市,興國里,627,1,773,6,779,1307,3,1,3,0,1,0,59.60
桃園縣,中壢市,興國里,628,1,880,9,889,1456,3,1,3,0,1,0,61.06
桃園縣,中壢市,興國里,629,1,1003,9,1012,1691,3,1,3,0,1,0,59.85
桃園縣,中壢市,興和里,630,1,713,5,718,1102,3,1,3,0,1,0,65.15
桃園縣,中壢市,興和里,631,1,864,9,873,1417,3,1,3,0,1,0,61.61
桃園縣,中壢市,永興里,632,1,607,3,610,1022,3,1,3,0,1,0,59.69
桃園縣,中壢市,中壢里,633,1,516,3,519,830,3,1,3,0,1,0,62.53
桃園縣,中壢市,中榮里,634,1,592,6,598,972,3,1,3,0,1,0,61.52
桃園縣,中壢市,中建里,635,1,643,3,646,1052,3,1,3,0,1,0,61.41
桃園縣,中壢市,舊明里,636,1,658,9,667,1011,3,1,3,0,1,0,65.97
桃園縣,中壢市,舊明里,637,1,669,6,675,1054,3,1,3,0,1,0,64.04
桃園縣,中壢市,新明里,638,1,640,9,649,1007,3,1,3,0,1,0,64.45
桃園縣,中壢市,新明里,639,1,680,6,686,1095,3,1,3,0,1,0,62.65
桃園縣,中壢市,新明里,640,1,883,8,891,1449,3,1,3,0,1,0,61.49
桃園縣,中壢市,光明里,641,1,718,7,725,1314,3,1,3,0,1,0,55.18
桃園縣,中壢市,光明里,642,1,848,5,853,1441,3,1,3,0,1,0,59.20
桃園縣,中壢市,光明里,643,1,958,6,964,1637,3,1,3,0,1,0,58.89
桃園縣,中壢市,永光里,644,1,845,7,852,1366,3,1,3,0,1,0,62.37
桃園縣,中壢市,永光里,645,1,1114,4,1118,1899,3,1,3,0,1,0,58.87
桃園縣,中壢市,三民里,646,1,848,8,856,1376,3,1,3,0,1,0,62.21
桃園縣,中壢市,三民里,647,1,754,5,759,1280,3,1,3,0,1,0,59.30
桃園縣,中壢市,五權里,648,1,665,6,671,1215,3,1,3,0,1,0,55.23
桃園縣,中壢市,五權里,649,1,748,1,749,1295,3,1,3,0,1,0,57.84
桃園縣,中壢市,五權里,650,1,982,10,992,1624,3,1,3,0,1,0,61.08
桃園縣,中壢市,五福里,651,1,1090,6,1096,1829,3,1,3,0,1,0,59.92
桃園縣,中壢市,五福里,652,1,858,6,864,1475,3,1,3,0,1,0,58.58
桃園縣,中壢市,芝芭里,653,1,542,6,548,844,3,1,3,0,1,0,64.93
桃園縣,中壢市,芝芭里,654,1,719,5,724,1167,3,1,3,0,1,0,62.04
桃園縣,中壢市,洽溪里,655,1,779,7,786,1260,3,1,3,0,1,0,62.38
桃園縣,中壢市,內厝里,656,1,1108,11,1119,1845,3,1,3,0,1,0,60.65
桃園縣,中壢市,內厝里,657,1,1062,2,1064,1664,3,1,3,0,1,0,63.94
桃園縣,中壢市,月眉里,658,1,941,4,945,1550,3,1,3,0,1,0,60.97
桃園縣,中壢市,月眉里,659,1,1080,10,1090,1614,3,1,3,0,1,0,67.53
桃園縣,中壢市,山東里,660,1,867,7,874,1353,3,1,3,0,1,0,64.60
桃園縣,中壢市,山東里,661,1,1035,8,1043,1515,3,1,3,0,1,0,68.84
桃園縣,中壢市,過嶺里,662,1,863,11,874,1331,3,1,3,0,1,0,65.66
桃園縣,中壢市,過嶺里,663,1,724,6,730,1216,3,1,3,0,1,0,60.03
桃園縣,平鎮市,平鎮里,664,1,522,8,530,977,3,1,3,0,1,0,54.25
桃園縣,平鎮市,平鎮里,665,1,753,11,764,1257,3,1,3,0,1,0,60.78
桃園縣,平鎮市,平鎮里,666,1,594,2,596,984,3,1,3,0,1,0,60.57
桃園縣,平鎮市,鎮興里,667,1,728,10,738,1212,3,1,3,0,1,0,60.89
桃園縣,平鎮市,鎮興里,668,1,836,15,851,1392,3,1,3,0,1,0,61.14
桃園縣,平鎮市,南勢里,669,1,719,5,724,1275,3,1,3,0,1,0,56.78
桃園縣,平鎮市,南勢里,670,1,725,7,732,1271,3,1,3,0,1,0,57.59
桃園縣,平鎮市,南勢里,671,1,709,5,714,1299,3,1,3,0,1,0,54.97
桃園縣,平鎮市,金星里,672,1,640,6,646,1182,3,1,3,0,1,0,54.65
桃園縣,平鎮市,金星里,673,1,598,12,610,1167,3,1,3,0,1,0,52.27
桃園縣,平鎮市,平安里,674,1,593,5,598,1008,3,1,3,0,1,0,59.33
桃園縣,平鎮市,平安里,675,1,675,6,681,1087,3,1,3,0,1,0,62.65
桃園縣,平鎮市,平安里,676,1,567,4,571,1005,3,1,3,0,1,0,56.82
桃園縣,平鎮市,平南里,677,1,608,1,609,1095,3,1,3,0,1,0,55.62
桃園縣,平鎮市,平南里,678,1,625,6,631,1177,3,1,3,0,1,0,53.61
桃園縣,平鎮市,平南里,679,1,683,4,687,1173,3,1,3,0,1,0,58.57
桃園縣,平鎮市,山峰里,680,1,625,9,634,1101,3,1,3,0,1,0,57.58
桃園縣,平鎮市,山峰里,681,1,725,11,736,1136,3,1,3,0,1,0,64.79
桃園縣,平鎮市,福林里,682,1,512,5,517,797,3,1,3,0,1,0,64.87
桃園縣,平鎮市,福林里,683,1,820,9,829,1329,3,1,3,0,1,0,62.38
桃園縣,平鎮市,湧光里,684,1,781,13,794,1308,3,1,3,0,1,0,60.70
桃園縣,平鎮市,湧光里,685,1,770,2,772,1270,3,1,3,0,1,0,60.79
桃園縣,平鎮市,湧光里,686,1,901,6,907,1522,3,1,3,0,1,0,59.59
桃園縣,平鎮市,莊敬里,687,1,609,10,619,967,3,1,3,0,1,0,64.01
桃園縣,平鎮市,莊敬里,688,1,616,4,620,1018,3,1,3,0,1,0,60.90
桃園縣,平鎮市,莊敬里,689,1,607,1,608,921,3,1,3,0,1,0,66.02
桃園縣,平鎮市,莊敬里,690,1,612,3,615,954,3,1,3,0,1,0,64.47
桃園縣,平鎮市,湧豐里,691,1,908,13,921,1508,3,1,3,0,1,0,61.07
桃園縣,平鎮市,湧安里,692,1,473,8,481,834,3,1,3,0,1,0,57.67
桃園縣,平鎮市,湧安里,693,1,609,3,612,1038,3,1,3,0,1,0,58.96
桃園縣,平鎮市,湧安里,694,1,573,6,579,1041,3,1,3,0,1,0,55.62
桃園縣,平鎮市,宋屋里,695,1,729,4,733,1402,3,1,3,0,1,0,52.28
桃園縣,平鎮市,宋屋里,696,1,855,5,860,1567,3,1,3,0,1,0,54.88
桃園縣,平鎮市,平興里,697,1,675,6,681,1284,3,1,3,0,1,0,53.04
桃園縣,平鎮市,平興里,698,1,700,8,708,1433,3,1,3,0,1,0,49.41
桃園縣,平鎮市,廣興里,699,1,776,7,783,1293,3,1,3,0,1,0,60.56
桃園縣,平鎮市,廣興里,700,1,790,4,794,1340,3,1,3,0,1,0,59.25
桃園縣,平鎮市,廣興里,701,1,841,6,847,1579,3,1,3,0,1,0,53.64
桃園縣,平鎮市,廣達里,702,1,578,6,584,976,3,1,3,0,1,0,59.84
桃園縣,平鎮市,廣達里,703,1,621,6,627,1044,3,1,3,0,1,0,60.06
桃園縣,平鎮市,廣達里,704,1,648,8,656,1066,3,1,3,0,1,0,61.54
桃園縣,平鎮市,廣仁里,705,1,637,8,645,1135,3,1,3,0,1,0,56.83
桃園縣,平鎮市,廣仁里,706,1,566,8,574,1104,3,1,3,0,1,0,51.99
桃園縣,平鎮市,廣仁里,707,1,637,7,644,1271,3,1,3,0,1,0,50.67
桃園縣,平鎮市,復旦里,708,1,665,4,669,1221,3,1,3,0,1,0,54.79
桃園縣,平鎮市,復旦里,709,1,594,1,595,1146,3,1,3,0,1,0,51.92
桃園縣,平鎮市,復旦里,710,1,587,6,593,1108,3,1,3,0,1,0,53.52
桃園縣,平鎮市,復興里,711,1,762,5,767,1309,3,1,3,0,1,0,58.59
桃園縣,平鎮市,復興里,712,1,479,4,483,911,3,1,3,0,1,0,53.02
桃園縣,平鎮市,復興里,713,1,868,8,876,1366,3,1,3,0,1,0,64.13
桃園縣,平鎮市,義民里,714,1,658,7,665,1139,3,1,3,0,1,0,58.38
桃園縣,平鎮市,義民里,715,1,705,6,711,1145,3,1,3,0,1,0,62.10
桃園縣,平鎮市,義民里,716,1,622,3,625,1188,3,1,3,0,1,0,52.61
桃園縣,平鎮市,義興里,717,1,846,8,854,1310,3,1,3,0,1,0,65.19
桃園縣,平鎮市,義興里,718,1,719,5,724,1165,3,1,3,0,1,0,62.15
桃園縣,平鎮市,義興里,719,1,627,11,638,1097,3,1,3,0,1,0,58.16
桃園縣,平鎮市,義興里,720,1,767,3,770,1371,3,1,3,0,1,0,56.16
桃園縣,平鎮市,雙連里,721,1,901,7,908,1407,3,1,3,0,1,0,64.53
桃園縣,平鎮市,雙連里,722,1,758,6,764,1235,3,1,3,0,1,0,61.86
桃園縣,平鎮市,雙連里,723,1,649,9,658,1105,3,1,3,0,1,0,59.55
桃園縣,平鎮市,高雙里,724,1,822,8,830,1315,3,1,3,0,1,0,63.12
桃園縣,平鎮市,高雙里,725,1,956,6,962,1600,3,1,3,0,1,0,60.12
桃園縣,平鎮市,北勢里,726,1,689,7,696,1090,3,1,3,0,1,0,63.85
桃園縣,平鎮市,北勢里,727,1,734,5,739,1185,3,1,3,0,1,0,62.36
桃園縣,平鎮市,北華里,728,1,821,7,828,1381,3,1,3,0,1,0,59.96
桃園縣,平鎮市,北華里,729,1,638,5,643,1066,3,1,3,0,1,0,60.32
桃園縣,平鎮市,新勢里,730,1,663,6,669,1111,3,1,3,0,1,0,60.22
桃園縣,平鎮市,新勢里,731,1,719,1,720,1202,3,1,3,0,1,0,59.90
桃園縣,平鎮市,新勢里,732,1,711,9,720,1182,3,1,3,0,1,0,60.91
桃園縣,平鎮市,北安里,733,1,458,4,462,734,3,1,3,0,1,0,62.94
桃園縣,平鎮市,北安里,734,1,506,7,513,820,3,1,3,0,1,0,62.56
桃園縣,平鎮市,新榮里,735,1,852,6,858,1439,3,1,3,0,1,0,59.62
桃園縣,平鎮市,新榮里,736,1,573,4,577,1162,3,1,3,0,1,0,49.66
桃園縣,平鎮市,新榮里,737,1,835,12,847,1375,3,1,3,0,1,0,61.60
桃園縣,平鎮市,新富里,738,1,761,3,764,1537,3,1,3,0,1,0,49.71
桃園縣,平鎮市,新富里,739,1,675,6,681,1090,3,1,3,0,1,0,62.48
桃園縣,平鎮市,新富里,740,1,386,0,386,695,3,1,3,0,1,0,55.54
桃園縣,平鎮市,新英里,741,1,665,7,672,1193,3,1,3,0,1,0,56.33
桃園縣,平鎮市,新英里,742,1,512,3,515,955,3,1,3,0,1,0,53.93
桃園縣,平鎮市,北興里,743,1,702,11,713,1159,3,1,3,0,1,0,61.52
桃園縣,平鎮市,北興里,744,1,774,5,779,1404,3,1,3,0,1,0,55.48
桃園縣,平鎮市,北興里,745,1,597,2,599,948,3,1,3,0,1,0,63.19
桃園縣,平鎮市,金陵里,746,1,598,8,606,942,3,1,3,0,1,0,64.33
桃園縣,平鎮市,金陵里,747,1,581,5,586,870,3,1,3,0,1,0,67.36
桃園縣,平鎮市,新貴里,748,1,845,16,861,1409,3,1,3,0,1,0,61.11
桃園縣,平鎮市,新貴里,749,1,827,8,835,1282,3,1,3,0,1,0,65.13
桃園縣,平鎮市,建安里,750,1,753,4,757,1289,3,1,3,0,1,0,58.73
桃園縣,平鎮市,建安里,751,1,673,11,684,1157,3,1,3,0,1,0,59.12
桃園縣,平鎮市,建安里,752,1,656,5,661,1053,3,1,3,0,1,0,62.77
桃園縣,平鎮市,華安里,753,1,671,8,679,1151,3,1,3,0,1,0,58.99
桃園縣,平鎮市,華安里,754,1,663,2,665,1070,3,1,3,0,1,0,62.15
桃園縣,平鎮市,華安里,755,1,584,6,590,1065,3,1,3,0,1,0,55.40
桃園縣,平鎮市,東安里,756,1,695,6,701,1096,3,1,3,0,1,0,63.96
桃園縣,平鎮市,東安里,757,1,647,6,653,1114,3,1,3,0,1,0,58.62
桃園縣,平鎮市,新安里,758,1,820,7,827,1507,3,1,3,0,1,0,54.88
桃園縣,平鎮市,新安里,759,1,891,12,903,1482,3,1,3,0,1,0,60.93
桃園縣,平鎮市,東勢里,760,1,535,3,538,826,3,1,3,0,1,0,65.13
桃園縣,平鎮市,東勢里,761,1,618,2,620,1000,3,1,3,0,1,0,62.00
桃園縣,平鎮市,東勢里,762,1,680,9,689,1126,3,1,3,0,1,0,61.19
桃園縣,平鎮市,東勢里,763,1,589,8,597,1062,3,1,3,0,1,0,56.21
桃園縣,平鎮市,北貴里,764,1,846,7,853,1462,3,1,3,0,1,0,58.34
桃園縣,平鎮市,北貴里,765,1,936,5,941,1681,3,1,3,0,1,0,55.98
桃園縣,平鎮市,北富里,766,1,497,8,505,919,3,1,3,0,1,0,54.95
桃園縣,平鎮市,北富里,767,1,695,6,701,1121,3,1,3,0,1,0,62.53
桃園縣,平鎮市,北富里,768,1,700,4,704,1173,3,1,3,0,1,0,60.02
桃園縣,平鎮市,龍恩里,769,1,913,17,930,1488,3,1,3,0,1,0,62.50
桃園縣,平鎮市,龍恩里,770,1,627,9,636,1073,3,1,3,0,1,0,59.27
桃園縣,平鎮市,東社里,771,1,948,8,956,1455,3,1,3,0,1,0,65.70
桃園縣,平鎮市,東社里,772,1,898,8,906,1559,3,1,3,0,1,0,58.11
桃園縣,平鎮市,忠貞里,773,1,527,8,535,881,3,1,3,0,1,0,60.73
桃園縣,平鎮市,貿易里,774,1,536,5,541,802,3,1,3,0,1,0,67.46
桃園縣,平鎮市,貿易里,775,1,447,11,458,696,3,1,3,0,1,0,65.80
桃園縣,平鎮市,龍興里,776,1,658,8,666,1073,3,1,3,0,1,0,62.07
桃園縣,平鎮市,龍興里,777,1,737,4,741,1148,3,1,3,0,1,0,64.55
桃園縣,平鎮市,中正里,778,1,636,6,642,1045,3,1,3,0,1,0,61.44
桃園縣,楊梅鎮,仁美里,779,1,639,10,649,1124,3,1,3,0,1,0,57.74
桃園縣,楊梅鎮,仁美里,780,1,903,9,912,1546,3,1,3,0,1,0,58.99
桃園縣,楊梅鎮,仁美里,781,1,722,9,731,1156,3,1,3,0,1,0,63.24
桃園縣,楊梅鎮,埔心里,782,1,951,6,957,1496,3,1,3,0,1,0,63.97
桃園縣,楊梅鎮,光華里,783,1,1079,9,1088,1566,3,1,3,0,1,0,69.48
桃園縣,楊梅鎮,光華里,784,1,903,7,910,1459,3,1,3,0,1,0,62.37
桃園縣,楊梅鎮,金龍里,785,1,449,5,454,685,3,1,3,0,1,0,66.28
桃園縣,楊梅鎮,四維里,786,1,657,5,662,1111,3,1,3,0,1,0,59.59
桃園縣,楊梅鎮,永平里,787,1,796,14,810,1387,3,1,3,0,1,0,58.40
桃園縣,楊梅鎮,瑞塘里,788,1,718,9,727,1216,3,1,3,0,1,0,59.79
桃園縣,楊梅鎮,瑞塘里,789,1,591,9,600,1138,3,1,3,0,1,0,52.72
桃園縣,楊梅鎮,瑞塘里,790,1,863,7,870,1555,3,1,3,0,1,0,55.95
桃園縣,楊梅鎮,瑞坪里,791,1,676,9,685,1166,3,1,3,0,1,0,58.75
桃園縣,楊梅鎮,瑞坪里,792,1,751,5,756,1384,3,1,3,0,1,0,54.62
桃園縣,楊梅鎮,梅溪里,793,1,875,12,887,1653,3,1,3,0,1,0,53.66
桃園縣,楊梅鎮,梅溪里,794,1,787,11,798,1570,3,1,3,0,1,0,50.83
桃園縣,楊梅鎮,金溪里,795,1,713,7,720,1371,3,1,3,0,1,0,52.52
桃園縣,楊梅鎮,金溪里,796,1,447,2,449,1006,3,1,3,0,1,0,44.63
桃園縣,楊梅鎮,金溪里,797,1,771,2,773,1396,3,1,3,0,1,0,55.37
桃園縣,楊梅鎮,楊明里,798,1,662,8,670,1187,3,1,3,0,1,0,56.44
桃園縣,楊梅鎮,楊明里,799,1,845,4,849,1482,3,1,3,0,1,0,57.29
桃園縣,楊梅鎮,裕成里,800,1,608,1,609,1067,3,1,3,0,1,0,57.08
桃園縣,楊梅鎮,裕成里,801,1,589,5,594,1171,3,1,3,0,1,0,50.73
桃園縣,楊梅鎮,裕成里,802,1,623,10,633,1445,3,1,3,0,1,0,43.81
桃園縣,楊梅鎮,大同里,803,1,871,2,873,1335,3,1,3,0,1,0,65.39
桃園縣,楊梅鎮,大同里,804,1,986,9,995,1522,3,1,3,0,1,0,65.37
桃園縣,楊梅鎮,中山里,805,1,601,7,608,1046,3,1,3,0,1,0,58.13
桃園縣,楊梅鎮,中山里,806,1,645,5,650,1143,3,1,3,0,1,0,56.87
桃園縣,楊梅鎮,楊梅里,807,1,1056,6,1062,1696,3,1,3,0,1,0,62.62
桃園縣,楊梅鎮,楊梅里,808,1,823,9,832,1277,3,1,3,0,1,0,65.15
桃園縣,楊梅鎮,楊江里,809,1,755,9,764,1164,3,1,3,0,1,0,65.64
桃園縣,楊梅鎮,梅新里,810,1,937,12,949,1574,3,1,3,0,1,0,60.29
桃園縣,楊梅鎮,紅梅里,811,1,522,3,525,884,3,1,3,0,1,0,59.39
桃園縣,楊梅鎮,紅梅里,812,1,737,3,740,1133,3,1,3,0,1,0,65.31
桃園縣,楊梅鎮,永寧里,813,1,1062,8,1070,1885,3,1,3,0,1,0,56.76
桃園縣,楊梅鎮,永寧里,814,1,1155,15,1170,2027,3,1,3,0,1,0,57.72
桃園縣,楊梅鎮,大平里,815,1,821,12,833,1384,3,1,3,0,1,0,60.19
桃園縣,楊梅鎮,大平里,816,1,962,10,972,1551,3,1,3,0,1,0,62.67
桃園縣,楊梅鎮,秀才里,817,1,886,13,899,1378,3,1,3,0,1,0,65.24
桃園縣,楊梅鎮,秀才里,818,1,848,6,854,1398,3,1,3,0,1,0,61.09
桃園縣,楊梅鎮,東流里,819,1,889,7,896,1489,3,1,3,0,1,0,60.17
桃園縣,楊梅鎮,東流里,820,1,446,11,457,772,3,1,3,0,1,0,59.20
桃園縣,楊梅鎮,豐野里,821,1,1039,16,1055,1714,3,1,3,0,1,0,61.55
桃園縣,楊梅鎮,豐野里,822,1,821,7,828,1327,3,1,3,0,1,0,62.40
桃園縣,楊梅鎮,富岡里,823,1,885,10,895,1351,3,1,3,0,1,0,66.25
桃園縣,楊梅鎮,富岡里,824,1,767,10,777,1210,3,1,3,0,1,0,64.21
桃園縣,楊梅鎮,富岡里,825,1,868,8,876,1507,3,1,3,0,1,0,58.13
桃園縣,楊梅鎮,員本里,826,1,599,8,607,1014,3,1,3,0,1,0,59.86
桃園縣,楊梅鎮,員本里,827,1,555,8,563,868,3,1,3,0,1,0,64.86
桃園縣,楊梅鎮,三湖里,828,1,827,11,838,1374,3,1,3,0,1,0,60.99
桃園縣,楊梅鎮,三湖里,829,1,900,9,909,1908,3,1,3,0,1,0,47.64
桃園縣,楊梅鎮,上湖里,830,1,899,36,935,1732,3,1,3,0,1,0,53.98
桃園縣,楊梅鎮,上湖里,831,1,836,5,841,1557,3,1,3,0,1,0,54.01
桃園縣,楊梅鎮,上田里,832,1,723,4,727,1131,3,1,3,0,1,0,64.28
桃園縣,楊梅鎮,上田里,833,1,696,4,700,1154,3,1,3,0,1,0,60.66
桃園縣,楊梅鎮,高山里,834,1,701,14,715,1246,3,1,3,0,1,0,57.38
桃園縣,楊梅鎮,高山里,835,1,893,13,906,1693,3,1,3,0,1,0,53.51
桃園縣,楊梅鎮,高山里,836,1,770,17,787,1259,3,1,3,0,1,0,62.51
桃園縣,楊梅鎮,青山里,837,1,847,10,857,1787,3,1,3,0,1,0,47.96
桃園縣,楊梅鎮,高榮里,838,1,825,12,837,1238,3,1,3,0,1,0,67.61
桃園縣,楊梅鎮,高榮里,839,1,481,9,490,850,3,1,3,0,1,0,57.65
桃園縣,楊梅鎮,雙榮里,840,1,1140,8,1148,1863,3,1,3,0,1,0,61.62
桃園縣,楊梅鎮,新榮里,841,1,704,7,711,1191,3,1,3,0,1,0,59.70
桃園縣,楊梅鎮,新榮里,842,1,657,8,665,1206,3,1,3,0,1,0,55.14
桃園縣,楊梅鎮,水美里,843,1,632,5,637,997,3,1,3,0,1,0,63.89
桃園縣,楊梅鎮,水美里,844,1,699,10,709,1069,3,1,3,0,1,0,66.32
桃園縣,楊梅鎮,水美里,845,1,690,1,691,1119,3,1,3,0,1,0,61.75
桃園縣,楊梅鎮,瑞原里,846,1,911,8,919,1444,3,1,3,0,1,0,63.64
桃園縣,楊梅鎮,瑞原里,847,1,915,11,926,1684,3,1,3,0,1,0,54.99
桃園縣,龍潭鄉,黃唐村,848,1,702,5,707,1250,3,1,3,0,1,0,56.56
桃園縣,龍潭鄉,黃唐村,849,1,668,9,677,1199,3,1,3,0,1,0,56.46
桃園縣,龍潭鄉,黃唐村,850,1,609,3,612,1085,3,1,3,0,1,0,56.41
桃園縣,龍潭鄉,永興村,851,1,794,6,800,1328,3,1,3,0,1,0,60.24
桃園縣,龍潭鄉,永興村,852,1,679,12,691,1153,3,1,3,0,1,0,59.93
桃園縣,龍潭鄉,中山村,853,1,773,3,776,1189,3,1,3,0,1,0,65.26
桃園縣,龍潭鄉,中山村,854,1,930,5,935,1513,3,1,3,0,1,0,61.80
桃園縣,龍潭鄉,中山村,855,1,730,4,734,1174,3,1,3,0,1,0,62.52
桃園縣,龍潭鄉,烏樹林村,856,1,492,3,495,974,3,1,3,0,1,0,50.82
桃園縣,龍潭鄉,烏樹林村,857,1,569,8,577,978,3,1,3,0,1,0,59.00
桃園縣,龍潭鄉,烏林村,858,1,827,13,840,1551,3,1,3,0,1,0,54.16
桃園縣,龍潭鄉,烏林村,859,1,952,19,971,1654,3,1,3,0,1,0,58.71
桃園縣,龍潭鄉,百年村,860,1,758,3,761,1309,3,1,3,0,1,0,58.14
桃園縣,龍潭鄉,百年村,861,1,611,3,614,1141,3,1,3,0,1,0,53.81
桃園縣,龍潭鄉,凌雲村,862,1,776,2,778,1355,3,1,3,0,1,0,57.42
桃園縣,龍潭鄉,凌雲村,863,1,892,11,903,1532,3,1,3,0,1,0,58.94
桃園縣,龍潭鄉,龍祥村,864,1,704,14,718,1196,3,1,3,0,1,0,60.03
桃園縣,龍潭鄉,龍祥村,865,1,733,10,743,1241,3,1,3,0,1,0,59.87
桃園縣,龍潭鄉,八德村,866,1,704,6,710,1179,3,1,3,0,1,0,60.22
桃園縣,龍潭鄉,八德村,867,1,514,8,522,907,3,1,3,0,1,0,57.55
桃園縣,龍潭鄉,八德村,868,1,602,2,604,1024,3,1,3,0,1,0,58.98
桃園縣,龍潭鄉,聖德村,869,1,643,5,648,1144,3,1,3,0,1,0,56.64
桃園縣,龍潭鄉,聖德村,870,1,606,3,609,1111,3,1,3,0,1,0,54.82
桃園縣,龍潭鄉,上林村,871,1,662,7,669,1229,3,1,3,0,1,0,54.43
桃園縣,龍潭鄉,上林村,872,1,972,12,984,1739,3,1,3,0,1,0,56.58
桃園縣,龍潭鄉,龍潭村,873,1,667,3,670,1046,3,1,3,0,1,0,64.05
桃園縣,龍潭鄉,龍潭村,874,1,575,4,579,888,3,1,3,0,1,0,65.20
桃園縣,龍潭鄉,龍星村,875,1,847,6,853,1350,3,1,3,0,1,0,63.19
桃園縣,龍潭鄉,龍星村,876,1,848,7,855,1559,3,1,3,0,1,0,54.84
桃園縣,龍潭鄉,中正村,877,1,803,7,810,1411,3,1,3,0,1,0,57.41
桃園縣,龍潭鄉,中正村,878,1,818,4,822,1429,3,1,3,0,1,0,57.52
桃園縣,龍潭鄉,上華村,879,1,621,6,627,1117,3,1,3,0,1,0,56.13
桃園縣,龍潭鄉,上華村,880,1,644,10,654,1080,3,1,3,0,1,0,60.56
桃園縣,龍潭鄉,九龍村,881,1,666,11,677,1180,3,1,3,0,1,0,57.37
桃園縣,龍潭鄉,九龍村,882,1,886,8,894,1644,3,1,3,0,1,0,54.38
桃園縣,龍潭鄉,武漢村,883,1,616,5,621,1057,3,1,3,0,1,0,58.75
桃園縣,龍潭鄉,武漢村,884,1,435,0,435,876,3,1,3,0,1,0,49.66
桃園縣,龍潭鄉,東興村,885,1,1020,11,1031,1673,3,1,3,0,1,0,61.63
桃園縣,龍潭鄉,東興村,886,1,1030,10,1040,1617,3,1,3,0,1,0,64.32
桃園縣,龍潭鄉,中興村,887,1,925,14,939,1650,3,1,3,0,1,0,56.91
桃園縣,龍潭鄉,中興村,888,1,941,7,948,1651,3,1,3,0,1,0,57.42
桃園縣,龍潭鄉,北興村,889,1,606,9,615,1067,3,1,3,0,1,0,57.64
桃園縣,龍潭鄉,北興村,890,1,475,8,483,838,3,1,3,0,1,0,57.64
桃園縣,龍潭鄉,佳安村,891,1,638,12,650,1056,3,1,3,0,1,0,61.55
桃園縣,龍潭鄉,佳安村,892,1,665,3,668,1116,3,1,3,0,1,0,59.86
桃園縣,龍潭鄉,佳安村,893,1,660,3,663,941,3,1,3,0,1,0,70.46
桃園縣,龍潭鄉,三坑村,894,1,748,10,758,1295,3,1,3,0,1,0,58.53
桃園縣,龍潭鄉,大平村,895,1,631,4,635,1144,3,1,3,0,1,0,55.51
桃園縣,龍潭鄉,三林村,896,1,602,2,604,1035,3,1,3,0,1,0,58.36
桃園縣,龍潭鄉,三林村,897,1,699,3,702,1107,3,1,3,0,1,0,63.41
桃園縣,龍潭鄉,建林村,898,1,905,4,909,1470,3,1,3,0,1,0,61.84
桃園縣,龍潭鄉,建林村,899,1,1036,4,1040,1624,3,1,3,0,1,0,64.04
桃園縣,龍潭鄉,富林村,900,1,978,7,985,1583,3,1,3,0,1,0,62.22
桃園縣,龍潭鄉,富林村,901,1,747,5,752,1197,3,1,3,0,1,0,62.82
桃園縣,龍潭鄉,高平村,902,1,668,5,673,1224,3,1,3,0,1,0,54.98
桃園縣,龍潭鄉,高平村,903,1,746,9,755,1338,3,1,3,0,1,0,56.43
桃園縣,龍潭鄉,高原村,904,1,772,10,782,1418,3,1,3,0,1,0,55.15
桃園縣,龍潭鄉,高原村,905,1,769,9,778,1471,3,1,3,0,1,0,52.89
桃園縣,龍潭鄉,三和村,906,1,763,2,765,1340,3,1,3,0,1,0,57.09
桃園縣,龍潭鄉,三水村,907,1,451,3,454,681,3,1,3,0,1,0,66.67
桃園縣,新屋鄉,新屋村,908,1,813,5,818,1183,3,1,3,0,1,0,69.15
桃園縣,新屋鄉,新屋村,909,1,813,1,814,1233,3,1,3,0,1,0,66.02
桃園縣,新屋鄉,新生村,910,1,990,9,999,1455,3,1,3,0,1,0,68.66
桃園縣,新屋鄉,新生村,911,1,1024,7,1031,1578,3,1,3,0,1,0,65.34
桃園縣,新屋鄉,後湖村,912,1,814,7,821,1246,3,1,3,0,1,0,65.89
桃園縣,新屋鄉,清華村,913,1,990,10,1000,1570,3,1,3,0,1,0,63.69
桃園縣,新屋鄉,清華村,914,1,888,4,892,1446,3,1,3,0,1,0,61.69
桃園縣,新屋鄉,石磊村,915,1,1122,15,1137,1689,3,1,3,0,1,0,67.32
桃園縣,新屋鄉,東明村,916,1,765,2,767,1193,3,1,3,0,1,0,64.29
桃園縣,新屋鄉,社子村,917,1,958,5,963,1326,3,1,3,0,1,0,72.62
桃園縣,新屋鄉,埔頂村,918,1,667,2,669,1032,3,1,3,0,1,0,64.83
桃園縣,新屋鄉,埔頂村,919,1,692,10,702,1067,3,1,3,0,1,0,65.79
桃園縣,新屋鄉,九斗村,920,1,1188,11,1199,1835,3,1,3,0,1,0,65.34
桃園縣,新屋鄉,頭洲村,921,1,896,5,901,1434,3,1,3,0,1,0,62.83
桃園縣,新屋鄉,頭洲村,922,1,858,7,865,1482,3,1,3,0,1,0,58.37
桃園縣,新屋鄉,大坡村,923,1,847,6,853,1318,3,1,3,0,1,0,64.72
桃園縣,新屋鄉,望間村,924,1,999,7,1006,1446,3,1,3,0,1,0,69.57
桃園縣,新屋鄉,後庄村,925,1,704,8,712,1087,3,1,3,0,1,0,65.50
桃園縣,新屋鄉,蚵間村,926,1,507,4,511,858,3,1,3,0,1,0,59.56
桃園縣,新屋鄉,深圳村,927,1,434,2,436,653,3,1,3,0,1,0,66.77
桃園縣,新屋鄉,康榔村,928,1,700,5,705,1042,3,1,3,0,1,0,67.66
桃園縣,新屋鄉,笨港村,929,1,676,7,683,1017,3,1,3,0,1,0,67.16
桃園縣,新屋鄉,永安村,930,1,670,4,674,894,3,1,3,0,1,0,75.39
桃園縣,新屋鄉,永安村,931,1,874,10,884,1331,3,1,3,0,1,0,66.42
桃園縣,新屋鄉,永興村,932,1,619,3,622,937,3,1,3,0,1,0,66.38
桃園縣,新屋鄉,下埔村,933,1,435,5,440,690,3,1,3,0,1,0,63.77
桃園縣,新屋鄉,石牌村,934,1,574,2,576,799,3,1,3,0,1,0,72.09
桃園縣,新屋鄉,下田村,935,1,1017,8,1025,1556,3,1,3,0,1,0,65.87
桃園縣,新屋鄉,赤欄村,936,1,705,10,715,1073,3,1,3,0,1,0,66.64
桃園縣,觀音鄉,觀音村,937,1,743,4,747,1189,3,1,3,0,1,0,62.83
桃園縣,觀音鄉,觀音村,938,1,762,5,767,1165,3,1,3,0,1,0,65.84
桃園縣,觀音鄉,白玉村,939,1,769,14,783,1094,3,1,3,0,1,0,71.57
桃園縣,觀音鄉,廣興村,940,1,816,8,824,1292,3,1,3,0,1,0,63.78
桃園縣,觀音鄉,大潭村,941,1,769,5,774,1179,3,1,3,0,1,0,65.65
桃園縣,觀音鄉,保生村,942,1,1055,5,1060,1570,3,1,3,0,1,0,67.52
桃園縣,觀音鄉,武威村,943,1,499,4,503,688,3,1,3,0,1,0,73.11
桃園縣,觀音鄉,三和村,944,1,520,9,529,746,3,1,3,0,1,0,70.91
桃園縣,觀音鄉,新興村,945,1,443,4,447,660,3,1,3,0,1,0,67.73
桃園縣,觀音鄉,坑尾村,946,1,738,9,747,1228,3,1,3,0,1,0,60.83
桃園縣,觀音鄉,金湖村,947,1,1134,3,1137,1905,3,1,3,0,1,0,59.69
桃園縣,觀音鄉,藍埔村,948,1,1261,8,1269,1947,3,1,3,0,1,0,65.18
桃園縣,觀音鄉,大同村,949,1,1123,13,1136,1796,3,1,3,0,1,0,63.25
桃園縣,觀音鄉,大堀村,950,1,702,13,715,1075,3,1,3,0,1,0,66.51
桃園縣,觀音鄉,崙坪村,951,1,1045,9,1054,1767,3,1,3,0,1,0,59.65
桃園縣,觀音鄉,崙坪村,952,1,1186,17,1203,1864,3,1,3,0,1,0,64.54
桃園縣,觀音鄉,富源村,953,1,1152,14,1166,1960,3,1,3,0,1,0,59.49
桃園縣,觀音鄉,上大村,954,1,1046,11,1057,1731,3,1,3,0,1,0,61.06
桃園縣,觀音鄉,新坡村,955,1,832,6,838,1287,3,1,3,0,1,0,65.11
桃園縣,觀音鄉,新坡村,956,1,800,5,805,1287,3,1,3,0,1,0,62.55
桃園縣,觀音鄉,廣福村,957,1,1196,6,1202,1831,3,1,3,0,1,0,65.65
桃園縣,觀音鄉,塔腳村,958,1,636,3,639,967,3,1,3,0,1,0,66.08
桃園縣,觀音鄉,保障村,959,1,1161,27,1188,1871,3,1,3,0,1,0,63.50
桃園縣,觀音鄉,草漯村,960,1,1032,10,1042,1564,3,1,3,0,1,0,66.62
桃園縣,觀音鄉,草漯村,961,1,1126,13,1139,1993,3,1,3,0,1,0,57.15
桃園縣,觀音鄉,樹林村,962,1,996,6,1002,1682,3,1,3,0,1,0,59.57
桃園縣,觀音鄉,富林村,963,1,881,14,895,1394,3,1,3,0,1,0,64.20
新竹縣,竹北市,鹿場里,1,1,371,1,372,669,3,1,3,0,1,0,55.61
新竹縣,竹北市,鹿場里,2,1,535,5,540,816,3,1,3,0,1,0,66.18
新竹縣,竹北市,東平里,3,1,183,0,183,254,3,1,3,0,1,0,72.05
新竹縣,竹北市,中興里,4,1,479,4,483,857,3,1,3,0,1,0,56.36
新竹縣,竹北市,中興里,5,1,476,13,489,823,3,1,3,0,1,0,59.42
新竹縣,竹北市,隘口里,6,1,398,4,402,571,3,1,3,0,1,0,70.40
新竹縣,竹北市,東海里,7,1,785,8,793,1277,3,1,3,0,1,0,62.10
新竹縣,竹北市,東海里,8,1,811,7,818,1246,3,1,3,0,1,0,65.65
新竹縣,竹北市,十興里,9,1,547,5,552,1002,3,1,3,0,1,0,55.09
新竹縣,竹北市,十興里,10,1,779,11,790,1288,3,1,3,0,1,0,61.34
新竹縣,竹北市,十興里,11,1,662,10,672,1234,3,1,3,0,1,0,54.46
新竹縣,竹北市,十興里,12,1,762,4,766,1419,3,1,3,0,1,0,53.98
新竹縣,竹北市,十興里,13,1,857,5,862,1442,3,1,3,0,1,0,59.78
新竹縣,竹北市,斗崙里,14,1,685,10,695,1106,3,1,3,0,1,0,62.84
新竹縣,竹北市,斗崙里,15,1,622,1,623,1249,3,1,3,0,1,0,49.88
新竹縣,竹北市,斗崙里,16,1,674,4,678,1211,3,1,3,0,1,0,55.99
新竹縣,竹北市,斗崙里,17,1,836,7,843,1483,3,1,3,0,1,0,56.84
新竹縣,竹北市,北崙里,18,1,758,4,762,1275,3,1,3,0,1,0,59.76
新竹縣,竹北市,北崙里,19,1,795,1,796,1337,3,1,3,0,1,0,59.54
新竹縣,竹北市,新崙里,20,1,624,4,628,1039,3,1,3,0,1,0,60.44
新竹縣,竹北市,新崙里,21,1,816,4,820,1385,3,1,3,0,1,0,59.21
新竹縣,竹北市,新崙里,22,1,733,4,737,1243,3,1,3,0,1,0,59.29
新竹縣,竹北市,竹北里,23,1,634,2,636,1159,3,1,3,0,1,0,54.87
新竹縣,竹北市,竹北里,24,1,700,3,703,1210,3,1,3,0,1,0,58.10
新竹縣,竹北市,竹北里,25,1,657,5,662,1183,3,1,3,0,1,0,55.96
新竹縣,竹北市,竹仁里,26,1,561,3,564,1021,3,1,3,0,1,0,55.24
新竹縣,竹北市,竹仁里,27,1,613,2,615,1057,3,1,3,0,1,0,58.18
新竹縣,竹北市,竹仁里,28,1,617,8,625,1141,3,1,3,0,1,0,54.78
新竹縣,竹北市,竹仁里,29,1,642,5,647,1148,3,1,3,0,1,0,56.36
新竹縣,竹北市,竹仁里,30,1,746,6,752,1352,3,1,3,0,1,0,55.62
新竹縣,竹北市,竹仁里,31,1,727,8,735,1123,3,1,3,0,1,0,65.45
新竹縣,竹北市,福德里,32,1,489,5,494,808,3,1,3,0,1,0,61.14
新竹縣,竹北市,福德里,33,1,680,6,686,1060,3,1,3,0,1,0,64.72
新竹縣,竹北市,福德里,34,1,551,5,556,1014,3,1,3,0,1,0,54.83
新竹縣,竹北市,竹義里,35,1,452,8,460,753,3,1,3,0,1,0,61.09
新竹縣,竹北市,竹義里,36,1,436,2,438,740,3,1,3,0,1,0,59.19
新竹縣,竹北市,竹義里,37,1,668,5,673,1184,3,1,3,0,1,0,56.84
新竹縣,竹北市,竹義里,38,1,649,6,655,1217,3,1,3,0,1,0,53.82
新竹縣,竹北市,泰和里,39,1,886,18,904,1505,3,1,3,0,1,0,60.07
新竹縣,竹北市,泰和里,40,1,631,7,638,1181,3,1,3,0,1,0,54.02
新竹縣,竹北市,泰和里,41,1,590,6,596,1060,3,1,3,0,1,0,56.23
新竹縣,竹北市,新社里,42,1,643,6,649,1106,3,1,3,0,1,0,58.68
新竹縣,竹北市,新社里,43,1,532,2,534,977,3,1,3,0,1,0,54.66
新竹縣,竹北市,新社里,44,1,583,7,590,1089,3,1,3,0,1,0,54.18
新竹縣,竹北市,新社里,45,1,648,6,654,1111,3,1,3,0,1,0,58.87
新竹縣,竹北市,新社里,46,1,612,4,616,1050,3,1,3,0,1,0,58.67
新竹縣,竹北市,新國里,47,1,700,6,706,1200,3,1,3,0,1,0,58.83
新竹縣,竹北市,新國里,48,1,790,10,800,1417,3,1,3,0,1,0,56.46
新竹縣,竹北市,新國里,49,1,613,7,620,1018,3,1,3,0,1,0,60.90
新竹縣,竹北市,聯興里,50,1,746,12,758,1268,3,1,3,0,1,0,59.78
新竹縣,竹北市,聯興里,51,1,628,5,633,1021,3,1,3,0,1,0,62.00
新竹縣,竹北市,聯興里,52,1,623,10,633,1055,3,1,3,0,1,0,60.00
新竹縣,竹北市,麻園里,53,1,812,6,818,1229,3,1,3,0,1,0,66.56
新竹縣,竹北市,溪州里,54,1,540,4,544,859,3,1,3,0,1,0,63.33
新竹縣,竹北市,溪州里,55,1,640,8,648,977,3,1,3,0,1,0,66.33
新竹縣,竹北市,新庄里,56,1,620,3,623,919,3,1,3,0,1,0,67.79
新竹縣,竹北市,白地里,57,1,494,4,498,732,3,1,3,0,1,0,68.03
新竹縣,竹北市,白地里,58,1,633,6,639,994,3,1,3,0,1,0,64.29
新竹縣,竹北市,新港里,59,1,710,7,717,1094,3,1,3,0,1,0,65.54
新竹縣,竹北市,大眉里,60,1,780,6,786,1425,3,1,3,0,1,0,55.16
新竹縣,竹北市,大義里,61,1,547,2,549,852,3,1,3,0,1,0,64.44
新竹縣,竹北市,大義里,62,1,361,4,365,583,3,1,3,0,1,0,62.61
新竹縣,竹北市,尚義里,63,1,474,1,475,660,3,1,3,0,1,0,71.97
新竹縣,竹北市,尚義里,64,1,418,3,421,654,3,1,3,0,1,0,64.37
新竹縣,竹北市,崇義里,65,1,613,6,619,899,3,1,3,0,1,0,68.85
新竹縣,竹北市,崇義里,66,1,533,5,538,809,3,1,3,0,1,0,66.50
新竹縣,竹東鎮,上坪里,67,1,221,2,223,379,3,1,3,0,1,0,58.84
新竹縣,竹東鎮,瑞峰里,68,1,217,1,218,344,3,1,3,0,1,0,63.37
新竹縣,竹東鎮,軟橋里,69,1,216,5,221,368,3,1,3,0,1,0,60.05
新竹縣,竹東鎮,員崠里,70,1,459,9,468,812,3,1,3,0,1,0,57.64
新竹縣,竹東鎮,員崠里,71,1,602,6,608,1054,3,1,3,0,1,0,57.69
新竹縣,竹東鎮,上館里,72,1,695,6,701,1307,3,1,3,0,1,0,53.63
新竹縣,竹東鎮,上館里,73,1,762,12,774,1475,3,1,3,0,1,0,52.47
新竹縣,竹東鎮,上館里,74,1,720,8,728,1392,3,1,3,0,1,0,52.30
新竹縣,竹東鎮,上館里,75,1,748,3,751,1301,3,1,3,0,1,0,57.72
新竹縣,竹東鎮,上館里,76,1,693,6,699,1155,3,1,3,0,1,0,60.52
新竹縣,竹東鎮,東寧里,77,1,573,7,580,959,3,1,3,0,1,0,60.48
新竹縣,竹東鎮,東寧里,78,1,546,6,552,885,3,1,3,0,1,0,62.37
新竹縣,竹東鎮,東寧里,79,1,561,7,568,966,3,1,3,0,1,0,58.80
新竹縣,竹東鎮,中正里,80,1,413,8,421,718,3,1,3,0,1,0,58.64
新竹縣,竹東鎮,中正里,81,1,493,7,500,836,3,1,3,0,1,0,59.81
新竹縣,竹東鎮,大鄉里,82,1,636,11,647,1230,3,1,3,0,1,0,52.60
新竹縣,竹東鎮,大鄉里,83,1,599,5,604,1085,3,1,3,0,1,0,55.67
新竹縣,竹東鎮,大鄉里,84,1,805,4,809,1366,3,1,3,0,1,0,59.22
新竹縣,竹東鎮,中山里,85,1,556,1,557,891,3,1,3,0,1,0,62.51
新竹縣,竹東鎮,中山里,86,1,567,2,569,867,3,1,3,0,1,0,65.63
新竹縣,竹東鎮,南華里,87,1,752,9,761,1132,3,1,3,0,1,0,67.23
新竹縣,竹東鎮,東華里,88,1,516,5,521,785,3,1,3,0,1,0,66.37
新竹縣,竹東鎮,商華里,89,1,733,5,738,1354,3,1,3,0,1,0,54.51
新竹縣,竹東鎮,商華里,90,1,628,2,630,1054,3,1,3,0,1,0,59.77
新竹縣,竹東鎮,雞林里,91,1,546,6,552,947,3,1,3,0,1,0,58.29
新竹縣,竹東鎮,雞林里,92,1,731,9,740,1239,3,1,3,0,1,0,59.73
新竹縣,竹東鎮,雞林里,93,1,599,6,605,1029,3,1,3,0,1,0,58.79
新竹縣,竹東鎮,仁愛里,94,1,746,11,757,1332,3,1,3,0,1,0,56.83
新竹縣,竹東鎮,仁愛里,95,1,903,6,909,1468,3,1,3,0,1,0,61.92
新竹縣,竹東鎮,竹東里,96,1,449,6,455,631,3,1,3,0,1,0,72.11
新竹縣,竹東鎮,竹東里,97,1,492,4,496,786,3,1,3,0,1,0,63.10
新竹縣,竹東鎮,忠孝里,98,1,808,7,815,1416,3,1,3,0,1,0,57.56
新竹縣,竹東鎮,榮樂里,99,1,431,5,436,715,3,1,3,0,1,0,60.98
新竹縣,竹東鎮,榮樂里,100,1,469,3,472,686,3,1,3,0,1,0,68.80
新竹縣,竹東鎮,榮華里,101,1,723,5,728,1153,3,1,3,0,1,0,63.14
新竹縣,竹東鎮,榮華里,102,1,668,8,676,1057,3,1,3,0,1,0,63.95
新竹縣,竹東鎮,榮華里,103,1,539,7,546,903,3,1,3,0,1,0,60.47
新竹縣,竹東鎮,榮華里,104,1,797,8,805,1386,3,1,3,0,1,0,58.08
新竹縣,竹東鎮,榮華里,105,1,569,8,577,1010,3,1,3,0,1,0,57.13
新竹縣,竹東鎮,五豐里,106,1,252,1,253,432,3,1,3,0,1,0,58.56
新竹縣,竹東鎮,五豐里,107,1,694,6,700,1453,3,1,3,0,1,0,48.18
新竹縣,竹東鎮,五豐里,108,1,605,13,618,1076,3,1,3,0,1,0,57.43
新竹縣,竹東鎮,五豐里,109,1,419,4,423,662,3,1,3,0,1,0,63.90
新竹縣,竹東鎮,五豐里,110,1,602,4,606,1123,3,1,3,0,1,0,53.96
新竹縣,竹東鎮,五豐里,111,1,496,10,506,943,3,1,3,0,1,0,53.66
新竹縣,竹東鎮,陸豐里,112,1,311,1,312,511,3,1,3,0,1,0,61.06
新竹縣,竹東鎮,三重里,113,1,652,3,655,1210,3,1,3,0,1,0,54.13
新竹縣,竹東鎮,三重里,114,1,581,6,587,1098,3,1,3,0,1,0,53.46
新竹縣,竹東鎮,三重里,115,1,548,6,554,926,3,1,3,0,1,0,59.83
新竹縣,竹東鎮,三重里,116,1,334,12,346,572,3,1,3,0,1,0,60.49
新竹縣,竹東鎮,三重里,117,1,654,8,662,1161,3,1,3,0,1,0,57.02
新竹縣,竹東鎮,二重里,118,1,663,7,670,1075,3,1,3,0,1,0,62.33
新竹縣,竹東鎮,二重里,119,1,768,8,776,1357,3,1,3,0,1,0,57.18
新竹縣,竹東鎮,二重里,120,1,646,8,654,1158,3,1,3,0,1,0,56.48
新竹縣,竹東鎮,二重里,121,1,322,2,324,857,3,1,3,0,1,0,37.81
新竹縣,竹東鎮,二重里,122,1,743,8,751,1442,3,1,3,0,1,0,52.08
新竹縣,竹東鎮,二重里,123,1,594,6,600,1008,3,1,3,0,1,0,59.52
新竹縣,竹東鎮,頭重里,124,1,629,3,632,1187,3,1,3,0,1,0,53.24
新竹縣,竹東鎮,頭重里,125,1,619,5,624,1108,3,1,3,0,1,0,56.32
新竹縣,竹東鎮,頭重里,126,1,728,2,730,1287,3,1,3,0,1,0,56.72
新竹縣,竹東鎮,員山里,127,1,863,7,870,1508,3,1,3,0,1,0,57.69
新竹縣,竹東鎮,柯湖里,128,1,366,4,370,651,3,1,3,0,1,0,56.84
新竹縣,新埔鎮,新埔里,129,1,709,5,714,1033,3,1,3,0,1,0,69.12
新竹縣,新埔鎮,新生里,130,1,425,6,431,679,3,1,3,0,1,0,63.48
新竹縣,新埔鎮,新民里,131,1,673,18,691,1059,3,1,3,0,1,0,65.25
新竹縣,新埔鎮,田新里,132,1,550,7,557,864,3,1,3,0,1,0,64.47
新竹縣,新埔鎮,田新里,133,1,433,6,439,737,3,1,3,0,1,0,59.57
新竹縣,新埔鎮,田新里,134,1,544,5,549,772,3,1,3,0,1,0,71.11
新竹縣,新埔鎮,旱坑里,135,1,518,5,523,928,3,1,3,0,1,0,56.36
新竹縣,新埔鎮,旱坑里,136,1,454,4,458,818,3,1,3,0,1,0,55.99
新竹縣,新埔鎮,五埔里,137,1,578,8,586,882,3,1,3,0,1,0,66.44
新竹縣,新埔鎮,五埔里,138,1,580,4,584,975,3,1,3,0,1,0,59.90
新竹縣,新埔鎮,四座里,139,1,599,9,608,950,3,1,3,0,1,0,64.00
新竹縣,新埔鎮,四座里,140,1,597,6,603,973,3,1,3,0,1,0,61.97
新竹縣,新埔鎮,四座里,141,1,639,7,646,998,3,1,3,0,1,0,64.73
新竹縣,新埔鎮,照門里,142,1,893,13,906,1374,3,1,3,0,1,0,65.94
新竹縣,新埔鎮,清水里,143,1,314,0,314,451,3,1,3,0,1,0,69.62
新竹縣,新埔鎮,鹿鳴里,144,1,469,6,475,716,3,1,3,0,1,0,66.34
新竹縣,新埔鎮,新北里,145,1,394,1,395,605,3,1,3,0,1,0,65.29
新竹縣,新埔鎮,巨埔里,146,1,777,10,787,1083,3,1,3,0,1,0,72.67
新竹縣,新埔鎮,內立里,147,1,728,8,736,1112,3,1,3,0,1,0,66.19
新竹縣,新埔鎮,寶石里,148,1,567,3,570,801,3,1,3,0,1,0,71.16
新竹縣,新埔鎮,文山里,149,1,804,8,812,1394,3,1,3,0,1,0,58.25
新竹縣,新埔鎮,文山里,150,1,675,4,679,1144,3,1,3,0,1,0,59.35
新竹縣,新埔鎮,文山里,151,1,789,12,801,1384,3,1,3,0,1,0,57.88
新竹縣,新埔鎮,上寮里,152,1,534,15,549,868,3,1,3,0,1,0,63.25
新竹縣,新埔鎮,上寮里,153,1,529,14,543,846,3,1,3,0,1,0,64.18
新竹縣,新埔鎮,下寮里,154,1,625,7,632,938,3,1,3,0,1,0,67.38
新竹縣,新埔鎮,下寮里,155,1,509,6,515,869,3,1,3,0,1,0,59.26
新竹縣,新埔鎮,南平里,156,1,652,5,657,1012,3,1,3,0,1,0,64.92
新竹縣,新埔鎮,北平里,157,1,460,2,462,666,3,1,3,0,1,0,69.37
新竹縣,關西鎮,東興里,158,1,386,5,391,544,3,1,3,0,1,0,71.88
新竹縣,關西鎮,西安里,159,1,441,3,444,701,3,1,3,0,1,0,63.34
新竹縣,關西鎮,西安里,160,1,604,8,612,1049,3,1,3,0,1,0,58.34
新竹縣,關西鎮,南雄里,161,1,519,7,526,750,3,1,3,0,1,0,70.13
新竹縣,關西鎮,北斗里,162,1,673,7,680,1126,3,1,3,0,1,0,60.39
新竹縣,關西鎮,北斗里,163,1,698,5,703,1127,3,1,3,0,1,0,62.38
新竹縣,關西鎮,北斗里,164,1,818,7,825,1363,3,1,3,0,1,0,60.53
新竹縣,關西鎮,北山里,165,1,481,5,486,740,3,1,3,0,1,0,65.68
新竹縣,關西鎮,仁安里,166,1,674,9,683,1080,3,1,3,0,1,0,63.24
新竹縣,關西鎮,南山里,167,1,633,12,645,1029,3,1,3,0,1,0,62.68
新竹縣,關西鎮,東安里,168,1,563,4,567,945,3,1,3,0,1,0,60.00
新竹縣,關西鎮,東安里,169,1,556,11,567,970,3,1,3,0,1,0,58.45
新竹縣,關西鎮,東安里,170,1,629,5,634,1034,3,1,3,0,1,0,61.32
新竹縣,關西鎮,東山里,171,1,485,3,488,775,3,1,3,0,1,0,62.97
新竹縣,關西鎮,東光里,172,1,741,18,759,1212,3,1,3,0,1,0,62.62
新竹縣,關西鎮,南新里,173,1,600,8,608,974,3,1,3,0,1,0,62.42
新竹縣,關西鎮,新富里,174,1,410,5,415,602,3,1,3,0,1,0,68.94
新竹縣,關西鎮,玉山里,175,1,330,4,334,530,3,1,3,0,1,0,63.02
新竹縣,關西鎮,金山里,176,1,380,4,384,638,3,1,3,0,1,0,60.19
新竹縣,關西鎮,錦山里,177,1,514,7,521,890,3,1,3,0,1,0,58.54
新竹縣,關西鎮,大同里,178,1,495,3,498,735,3,1,3,0,1,0,67.76
新竹縣,關西鎮,石光里,179,1,590,8,598,889,3,1,3,0,1,0,67.27
新竹縣,關西鎮,石光里,180,1,581,11,592,941,3,1,3,0,1,0,62.91
新竹縣,關西鎮,東平里,181,1,657,14,671,968,3,1,3,0,1,0,69.32
新竹縣,關西鎮,上林里,182,1,576,5,581,843,3,1,3,0,1,0,68.92
新竹縣,關西鎮,新力里,183,1,424,4,428,607,3,1,3,0,1,0,70.51
新竹縣,關西鎮,南和里,184,1,546,8,554,796,3,1,3,0,1,0,69.60
新竹縣,湖口鄉,和興村,185,1,828,8,836,1233,3,1,3,0,1,0,67.80
新竹縣,湖口鄉,和興村,186,1,721,8,729,1171,3,1,3,0,1,0,62.25
新竹縣,湖口鄉,東興村,187,1,726,10,736,1298,3,1,3,0,1,0,56.70
新竹縣,湖口鄉,東興村,188,1,942,11,953,1754,3,1,3,0,1,0,54.33
新竹縣,湖口鄉,德盛村,189,1,729,10,739,1122,3,1,3,0,1,0,65.86
新竹縣,湖口鄉,德盛村,190,1,735,4,739,1244,3,1,3,0,1,0,59.41
新竹縣,湖口鄉,德盛村,191,1,636,15,651,1195,3,1,3,0,1,0,54.48
新竹縣,湖口鄉,愛勢村,192,1,728,11,739,1110,3,1,3,0,1,0,66.58
新竹縣,湖口鄉,愛勢村,193,1,764,10,774,1317,3,1,3,0,1,0,58.77
新竹縣,湖口鄉,愛勢村,194,1,766,11,777,1434,3,1,3,0,1,0,54.18
新竹縣,湖口鄉,仁勢村,195,1,552,5,557,827,3,1,3,0,1,0,67.35
新竹縣,湖口鄉,孝勢村,196,1,775,10,785,1323,3,1,3,0,1,0,59.33
新竹縣,湖口鄉,中勢村,197,1,636,11,647,1046,3,1,3,0,1,0,61.85
新竹縣,湖口鄉,中勢村,198,1,840,5,845,1330,3,1,3,0,1,0,63.53
新竹縣,湖口鄉,中正村,199,1,741,7,748,1128,3,1,3,0,1,0,66.31
新竹縣,湖口鄉,中正村,200,1,656,2,658,1015,3,1,3,0,1,0,64.83
新竹縣,湖口鄉,信勢村,201,1,657,7,664,1022,3,1,3,0,1,0,64.97
新竹縣,湖口鄉,信勢村,202,1,638,5,643,1073,3,1,3,0,1,0,59.93
新竹縣,湖口鄉,信勢村,203,1,811,12,823,1418,3,1,3,0,1,0,58.04
新竹縣,湖口鄉,信義村,204,1,659,6,665,1115,3,1,3,0,1,0,59.64
新竹縣,湖口鄉,信義村,205,1,656,8,664,1072,3,1,3,0,1,0,61.94
新竹縣,湖口鄉,波羅村,206,1,899,12,911,1787,3,1,3,0,1,0,50.98
新竹縣,湖口鄉,長嶺村,207,1,719,10,729,1166,3,1,3,0,1,0,62.52
新竹縣,湖口鄉,長嶺村,208,1,824,10,834,1416,3,1,3,0,1,0,58.90
新竹縣,湖口鄉,長安村,209,1,648,7,655,1017,3,1,3,0,1,0,64.41
新竹縣,湖口鄉,湖口村,210,1,772,9,781,1321,3,1,3,0,1,0,59.12
新竹縣,湖口鄉,湖口村,211,1,605,3,608,1025,3,1,3,0,1,0,59.32
新竹縣,湖口鄉,湖鏡村,212,1,694,6,700,1188,3,1,3,0,1,0,58.92
新竹縣,湖口鄉,湖鏡村,213,1,610,6,616,983,3,1,3,0,1,0,62.67
新竹縣,湖口鄉,湖南村,214,1,758,12,770,1342,3,1,3,0,1,0,57.38
新竹縣,湖口鄉,中興村,215,1,703,11,714,1154,3,1,3,0,1,0,61.87
新竹縣,湖口鄉,中興村,216,1,682,12,694,1073,3,1,3,0,1,0,64.68
新竹縣,湖口鄉,中興村,217,1,694,14,708,1516,3,1,3,0,1,0,46.70
新竹縣,湖口鄉,鳳凰村,218,1,567,8,575,1032,3,1,3,0,1,0,55.72
新竹縣,湖口鄉,鳳凰村,219,1,720,8,728,1339,3,1,3,0,1,0,54.37
新竹縣,湖口鄉,鳳凰村,220,1,566,8,574,1070,3,1,3,0,1,0,53.64
新竹縣,湖口鄉,勝利村,221,1,716,14,730,1422,3,1,3,0,1,0,51.34
新竹縣,湖口鄉,勝利村,222,1,696,4,700,1044,3,1,3,0,1,0,67.05
新竹縣,湖口鄉,鳳山村,223,1,774,12,786,1482,3,1,3,0,1,0,53.04
新竹縣,湖口鄉,鳳山村,224,1,682,18,700,1157,3,1,3,0,1,0,60.50
新竹縣,新豐鄉,福興村,225,1,611,6,617,885,3,1,3,0,1,0,69.72
新竹縣,新豐鄉,後湖村,226,1,513,8,521,806,3,1,3,0,1,0,64.64
新竹縣,新豐鄉,後湖村,227,1,521,8,529,881,3,1,3,0,1,0,60.05
新竹縣,新豐鄉,青埔村,228,1,884,6,890,1375,3,1,3,0,1,0,64.73
新竹縣,新豐鄉,埔和村,229,1,750,8,758,1265,3,1,3,0,1,0,59.92
新竹縣,新豐鄉,埔和村,230,1,553,6,559,994,3,1,3,0,1,0,56.24
新竹縣,新豐鄉,坡頭村,231,1,487,7,494,786,3,1,3,0,1,0,62.85
新竹縣,新豐鄉,新豐村,232,1,643,10,653,1049,3,1,3,0,1,0,62.25
新竹縣,新豐鄉,新豐村,233,1,636,12,648,1017,3,1,3,0,1,0,63.72
新竹縣,新豐鄉,瑞興村,234,1,819,12,831,1370,3,1,3,0,1,0,60.66
新竹縣,新豐鄉,中崙村,235,1,815,7,822,1288,3,1,3,0,1,0,63.82
新竹縣,新豐鄉,中崙村,236,1,578,8,586,1093,3,1,3,0,1,0,53.61
新竹縣,新豐鄉,重興村,237,1,560,6,566,983,3,1,3,0,1,0,57.58
新竹縣,新豐鄉,重興村,238,1,532,2,534,1036,3,1,3,0,1,0,51.54
新竹縣,新豐鄉,重興村,239,1,483,2,485,822,3,1,3,0,1,0,59.00
新竹縣,新豐鄉,重興村,240,1,643,4,647,1126,3,1,3,0,1,0,57.46
新竹縣,新豐鄉,重興村,241,1,409,3,412,774,3,1,3,0,1,0,53.23
新竹縣,新豐鄉,重興村,242,1,620,7,627,1119,3,1,3,0,1,0,56.03
新竹縣,新豐鄉,上坑村,243,1,800,9,809,1492,3,1,3,0,1,0,54.22
新竹縣,新豐鄉,鳳坑村,244,1,612,9,621,972,3,1,3,0,1,0,63.89
新竹縣,新豐鄉,員山村,245,1,647,9,656,1100,3,1,3,0,1,0,59.64
新竹縣,新豐鄉,員山村,246,1,564,3,567,916,3,1,3,0,1,0,61.90
新竹縣,新豐鄉,員山村,247,1,610,4,614,1111,3,1,3,0,1,0,55.27
新竹縣,新豐鄉,員山村,248,1,530,6,536,1053,3,1,3,0,1,0,50.90
新竹縣,新豐鄉,員山村,249,1,546,4,550,970,3,1,3,0,1,0,56.70
新竹縣,新豐鄉,員山村,250,1,581,3,584,1072,3,1,3,0,1,0,54.48
新竹縣,新豐鄉,員山村,251,1,619,2,621,1102,3,1,3,0,1,0,56.35
新竹縣,新豐鄉,松林村,252,1,529,2,531,1019,3,1,3,0,1,0,52.11
新竹縣,新豐鄉,松林村,253,1,515,7,522,990,3,1,3,0,1,0,52.73
新竹縣,新豐鄉,松林村,254,1,550,3,553,1014,3,1,3,0,1,0,54.54
新竹縣,新豐鄉,松林村,255,1,470,8,478,846,3,1,3,0,1,0,56.50
新竹縣,新豐鄉,松林村,256,1,439,2,441,763,3,1,3,0,1,0,57.80
新竹縣,芎林鄉,華龍村,257,1,279,3,282,429,3,1,3,0,1,0,65.73
新竹縣,芎林鄉,五龍村,258,1,323,4,327,486,3,1,3,0,1,0,67.28
新竹縣,芎林鄉,秀湖村,259,1,548,7,555,858,3,1,3,0,1,0,64.69
新竹縣,芎林鄉,永興村,260,1,249,1,250,390,3,1,3,0,1,0,64.10
新竹縣,芎林鄉,石潭村,261,1,587,5,592,923,3,1,3,0,1,0,64.14
新竹縣,芎林鄉,石潭村,262,1,871,12,883,1406,3,1,3,0,1,0,62.80
新竹縣,芎林鄉,新鳳村,263,1,929,9,938,1428,3,1,3,0,1,0,65.69
新竹縣,芎林鄉,中坑村,264,1,357,0,357,535,3,1,3,0,1,0,66.73
新竹縣,芎林鄉,水坑村,265,1,380,4,384,647,3,1,3,0,1,0,59.35
新竹縣,芎林鄉,文林村,266,1,632,9,641,1061,3,1,3,0,1,0,60.41
新竹縣,芎林鄉,文林村,267,1,676,7,683,1060,3,1,3,0,1,0,64.43
新竹縣,芎林鄉,芎林村,268,1,938,12,950,1468,3,1,3,0,1,0,64.71
新竹縣,芎林鄉,上山村,269,1,825,7,832,1383,3,1,3,0,1,0,60.16
新竹縣,芎林鄉,上山村,270,1,436,4,440,772,3,1,3,0,1,0,56.99
新竹縣,芎林鄉,上山村,271,1,522,10,532,911,3,1,3,0,1,0,58.40
新竹縣,芎林鄉,下山村,272,1,696,9,705,1066,3,1,3,0,1,0,66.14
新竹縣,橫山鄉,橫山村,273,1,730,5,735,1166,3,1,3,0,1,0,63.04
新竹縣,橫山鄉,橫山村,274,1,574,4,578,966,3,1,3,0,1,0,59.83
新竹縣,橫山鄉,橫山村,275,1,653,5,658,1079,3,1,3,0,1,0,60.98
新竹縣,橫山鄉,田寮村,276,1,560,4,564,843,3,1,3,0,1,0,66.90
新竹縣,橫山鄉,南昌村,277,1,108,2,110,157,3,1,3,0,1,0,70.06
新竹縣,橫山鄉,豐鄉村,278,1,110,1,111,165,3,1,3,0,1,0,67.27
新竹縣,橫山鄉,豐田村,279,1,217,3,220,333,3,1,3,0,1,0,66.07
新竹縣,橫山鄉,內灣村,280,1,639,11,650,1048,3,1,3,0,1,0,62.02
新竹縣,橫山鄉,力行村,281,1,374,5,379,586,3,1,3,0,1,0,64.68
新竹縣,橫山鄉,力行村,282,1,178,2,180,260,3,1,3,0,1,0,69.23
新竹縣,橫山鄉,福興村,283,1,301,6,307,467,3,1,3,0,1,0,65.74
新竹縣,橫山鄉,沙坑村,284,1,485,6,491,742,3,1,3,0,1,0,66.17
新竹縣,橫山鄉,沙坑村,285,1,251,0,251,335,3,1,3,0,1,0,74.93
新竹縣,橫山鄉,新興村,286,1,465,5,470,729,3,1,3,0,1,0,64.47
新竹縣,橫山鄉,新興村,287,1,548,2,550,803,3,1,3,0,1,0,68.49
新竹縣,橫山鄉,大肚村,288,1,877,12,889,1338,3,1,3,0,1,0,66.44
新竹縣,北埔鄉,北埔村,289,1,734,8,742,1143,3,1,3,0,1,0,64.92
新竹縣,北埔鄉,南興村,290,1,799,16,815,1249,3,1,3,0,1,0,65.25
新竹縣,北埔鄉,大湖村,291,1,313,3,316,508,3,1,3,0,1,0,62.20
新竹縣,北埔鄉,埔尾村,292,1,600,6,606,898,3,1,3,0,1,0,67.48
新竹縣,北埔鄉,埔尾村,293,1,890,17,907,1462,3,1,3,0,1,0,62.04
新竹縣,北埔鄉,水際村,294,1,452,2,454,780,3,1,3,0,1,0,58.21
新竹縣,北埔鄉,南埔村,295,1,250,2,252,387,3,1,3,0,1,0,65.12
新竹縣,北埔鄉,大林村,296,1,453,6,459,664,3,1,3,0,1,0,69.13
新竹縣,北埔鄉,南坑村,297,1,205,4,209,362,3,1,3,0,1,0,57.73
新竹縣,北埔鄉,外坪村,298,1,187,3,190,301,3,1,3,0,1,0,63.12
新竹縣,寶山鄉,雙溪村,299,1,714,3,717,1231,3,1,3,0,1,0,58.25
新竹縣,寶山鄉,雙溪村,300,1,635,9,644,1232,3,1,3,0,1,0,52.27
新竹縣,寶山鄉,雙溪村,301,1,672,4,676,1240,3,1,3,0,1,0,54.52
新竹縣,寶山鄉,大崎村,302,1,597,4,601,1013,3,1,3,0,1,0,59.33
新竹縣,寶山鄉,三峰村,303,1,504,4,508,756,3,1,3,0,1,0,67.20
新竹縣,寶山鄉,新城村,304,1,696,4,700,1069,3,1,3,0,1,0,65.48
新竹縣,寶山鄉,寶斗村,305,1,425,6,431,638,3,1,3,0,1,0,67.55
新竹縣,寶山鄉,深井村,306,1,499,7,506,707,3,1,3,0,1,0,71.57
新竹縣,寶山鄉,寶山村,307,1,415,6,421,632,3,1,3,0,1,0,66.61
新竹縣,寶山鄉,油田村,308,1,361,1,362,557,3,1,3,0,1,0,64.99
新竹縣,寶山鄉,山湖村,309,1,268,2,270,448,3,1,3,0,1,0,60.27
新竹縣,峨眉鄉,峨眉村,310,1,606,9,615,865,3,1,3,0,1,0,71.10
新竹縣,峨眉鄉,中盛村,311,1,494,1,495,708,3,1,3,0,1,0,69.92
新竹縣,峨眉鄉,石井村,312,1,437,3,440,615,3,1,3,0,1,0,71.54
新竹縣,峨眉鄉,七星村,313,1,246,6,252,339,3,1,3,0,1,0,74.34
新竹縣,峨眉鄉,七星村,314,1,184,0,184,270,3,1,3,0,1,0,68.15
新竹縣,峨眉鄉,富興村,315,1,765,10,775,1209,3,1,3,0,1,0,64.10
新竹縣,峨眉鄉,湖光村,316,1,309,4,313,499,3,1,3,0,1,0,62.73
新竹縣,峨眉鄉,湖光村,317,1,270,12,282,401,3,1,3,0,1,0,70.32
新竹縣,尖石鄉,義興村,318,1,234,8,242,406,3,1,3,0,1,0,59.61
新竹縣,尖石鄉,義興村,319,1,10,1,11,39,3,1,3,0,1,0,28.21
新竹縣,尖石鄉,嘉樂村,320,1,67,0,67,122,3,1,3,0,1,0,54.92
新竹縣,尖石鄉,新樂村,321,1,76,1,77,165,3,1,3,0,1,0,46.67
新竹縣,尖石鄉,錦屏村,322,1,32,0,32,58,3,1,3,0,1,0,55.17
新竹縣,尖石鄉,錦屏村,323,1,30,0,30,70,3,1,3,0,1,0,42.86
新竹縣,尖石鄉,梅花村,324,1,27,0,27,40,3,1,3,0,1,0,67.50
新竹縣,尖石鄉,玉峰村,325,1,7,0,7,21,3,1,3,0,1,0,33.33
新竹縣,尖石鄉,玉峰村,326,1,1,0,1,4,3,1,3,0,1,0,25.00
新竹縣,尖石鄉,秀巒村,327,1,7,0,7,10,3,1,3,0,1,0,70.00
新竹縣,尖石鄉,秀巒村,328,1,14,0,14,37,3,1,3,0,1,0,37.84
新竹縣,尖石鄉,秀巒村,329,1,3,0,3,8,3,1,3,0,1,0,37.50
新竹縣,尖石鄉,玉峰村,330,1,2,0,2,2,3,1,3,0,1,0,100.00
新竹縣,五峰鄉,大隘村,331,1,70,1,71,111,3,1,3,0,1,0,63.96
新竹縣,五峰鄉,大隘村,332,1,10,0,10,32,3,1,3,0,1,0,31.25
新竹縣,五峰鄉,花園村,333,1,31,0,31,59,3,1,3,0,1,0,52.54
新竹縣,五峰鄉,竹林村,334,1,10,0,10,21,3,1,3,0,1,0,47.62
新竹縣,五峰鄉,桃山村,335,1,20,0,20,45,3,1,3,0,1,0,44.44
新竹縣,五峰鄉,桃山村,336,1,42,0,42,120,3,1,3,0,1,0,35.00
苗栗縣,苗栗市,中苗里,1,1,596,4,600,1015,3,1,3,0,1,0,59.11
苗栗縣,苗栗市,青苗里,2,1,602,5,607,1051,3,1,3,0,1,0,57.75
苗栗縣,苗栗市,維祥里,3,1,560,5,565,1013,3,1,3,0,1,0,55.77
苗栗縣,苗栗市,維祥里,4,1,643,6,649,1055,3,1,3,0,1,0,61.52
苗栗縣,苗栗市,維祥里,5,1,627,7,634,1033,3,1,3,0,1,0,61.37
苗栗縣,苗栗市,維新里,6,1,721,9,730,1248,3,1,3,0,1,0,58.49
苗栗縣,苗栗市,維新里,7,1,825,9,834,1344,3,1,3,0,1,0,62.05
苗栗縣,苗栗市,維新里,8,1,677,4,681,1198,3,1,3,0,1,0,56.84
苗栗縣,苗栗市,玉清里,9,1,675,0,675,1145,3,1,3,0,1,0,58.95
苗栗縣,苗栗市,玉清里,10,1,670,12,682,1158,3,1,3,0,1,0,58.89
苗栗縣,苗栗市,玉華里,11,1,593,10,603,1051,3,1,3,0,1,0,57.37
苗栗縣,苗栗市,玉華里,12,1,714,0,714,1248,3,1,3,0,1,0,57.21
苗栗縣,苗栗市,玉華里,13,1,666,7,673,1040,3,1,3,0,1,0,64.71
苗栗縣,苗栗市,綠苗里,14,1,524,6,530,894,3,1,3,0,1,0,59.28
苗栗縣,苗栗市,高苗里,15,1,731,5,736,1314,3,1,3,0,1,0,56.01
苗栗縣,苗栗市,高苗里,16,1,728,8,736,1413,3,1,3,0,1,0,52.09
苗栗縣,苗栗市,新苗里,17,1,594,10,604,960,3,1,3,0,1,0,62.92
苗栗縣,苗栗市,玉苗里,18,1,599,4,603,983,3,1,3,0,1,0,61.34
苗栗縣,苗栗市,大同里,19,1,383,7,390,647,3,1,3,0,1,0,60.28
苗栗縣,苗栗市,恭敬里,20,1,874,11,885,1475,3,1,3,0,1,0,60
苗栗縣,苗栗市,水源里,21,1,777,9,786,1390,3,1,3,0,1,0,56.55
苗栗縣,苗栗市,水源里,22,1,593,6,599,932,3,1,3,0,1,0,64.27
苗栗縣,苗栗市,勝利里,23,1,760,5,765,1281,3,1,3,0,1,0,59.72
苗栗縣,苗栗市,勝利里,24,1,835,4,839,1457,3,1,3,0,1,0,57.58
苗栗縣,苗栗市,勝利里,25,1,491,0,491,828,3,1,3,0,1,0,59.30
苗栗縣,苗栗市,清華里,26,1,528,4,532,893,3,1,3,0,1,0,59.57
苗栗縣,苗栗市,清華里,27,1,712,5,717,1192,3,1,3,0,1,0,60.15
苗栗縣,苗栗市,清華里,28,1,573,6,579,925,3,1,3,0,1,0,62.59
苗栗縣,苗栗市,上苗里,29,1,504,2,506,789,3,1,3,0,1,0,64.13
苗栗縣,苗栗市,上苗里,30,1,582,3,585,975,3,1,3,0,1,0,60.00
苗栗縣,苗栗市,北苗里,31,1,778,8,786,1254,3,1,3,0,1,0,62.68
苗栗縣,苗栗市,北苗里,32,1,589,4,593,1015,3,1,3,0,1,0,58.42
苗栗縣,苗栗市,北苗里,33,1,573,2,575,1008,3,1,3,0,1,0,57.04
苗栗縣,苗栗市,北苗里,34,1,647,7,654,1079,3,1,3,0,1,0,60.61
苗栗縣,苗栗市,嘉盛里,35,1,952,10,962,1612,3,1,3,0,1,0,59.68
苗栗縣,苗栗市,嘉盛里,36,1,858,8,866,1519,3,1,3,0,1,0,57.01
苗栗縣,苗栗市,嘉新里,37,1,850,7,857,1355,3,1,3,0,1,0,63.25
苗栗縣,苗栗市,嘉新里,38,1,780,6,786,1213,3,1,3,0,1,0,64.80
苗栗縣,苗栗市,福星里,39,1,882,8,890,1588,3,1,3,0,1,0,56.05
苗栗縣,苗栗市,福星里,40,1,968,4,972,1722,3,1,3,0,1,0,56.45
苗栗縣,苗栗市,福安里,41,1,725,7,732,1222,3,1,3,0,1,0,59.9
苗栗縣,苗栗市,福安里,42,1,776,10,786,1419,3,1,3,0,1,0,55.39
苗栗縣,苗栗市,建功里,43,1,503,6,509,824,3,1,3,0,1,0,61.77
苗栗縣,苗栗市,建功里,44,1,753,8,761,1248,3,1,3,0,1,0,60.98
苗栗縣,苗栗市,建功里,45,1,816,2,818,1471,3,1,3,0,1,0,55.61
苗栗縣,苗栗市,福麗里,46,1,793,5,798,1369,3,1,3,0,1,0,58.29
苗栗縣,苗栗市,福麗里,47,1,849,7,856,1529,3,1,3,0,1,0,55.98
苗栗縣,苗栗市,福麗里,48,1,737,7,744,1374,3,1,3,0,1,0,54.15
苗栗縣,苗栗市,文山里,49,1,742,8,750,1267,3,1,3,0,1,0,59.19
苗栗縣,苗栗市,文山里,50,1,602,7,609,1101,3,1,3,0,1,0,55.31
苗栗縣,苗栗市,文山里,51,1,691,6,697,1275,3,1,3,0,1,0,54.67
苗栗縣,苗栗市,文山里,52,1,733,7,740,1326,3,1,3,0,1,0,55.81
苗栗縣,苗栗市,新川里,53,1,615,6,621,1087,3,1,3,0,1,0,57.13
苗栗縣,苗栗市,新英里,54,1,825,4,829,1504,3,1,3,0,1,0,55.12
苗栗縣,苗栗市,南勢里,55,1,487,9,496,821,3,1,3,0,1,0,60.41
苗栗縣,苗栗市,南勢里,56,1,566,4,570,970,3,1,3,0,1,0,58.76
苗栗縣,苑裡鎮,苑東里,57,1,411,2,413,671,3,1,3,0,1,0,61.55
苗栗縣,苑裡鎮,苑東里,58,1,645,6,651,1096,3,1,3,0,1,0,59.40
苗栗縣,苑裡鎮,苑南里,59,1,621,1,622,968,3,1,3,0,1,0,64.26
苗栗縣,苑裡鎮,苑南里,60,1,375,1,376,695,3,1,3,0,1,0,54.10
苗栗縣,苑裡鎮,苑北里,61,1,512,7,519,896,3,1,3,0,1,0,57.92
苗栗縣,苑裡鎮,西平里,62,1,833,9,842,1328,3,1,3,0,1,0,63.40
苗栗縣,苑裡鎮,苑港里,63,1,709,9,718,1124,3,1,3,0,1,0,63.88
苗栗縣,苑裡鎮,西勢里,64,1,527,6,533,923,3,1,3,0,1,0,57.75
苗栗縣,苑裡鎮,西勢里,65,1,467,3,470,767,3,1,3,0,1,0,61.28
苗栗縣,苑裡鎮,海岸里,66,1,587,4,591,1029,3,1,3,0,1,0,57.43
苗栗縣,苑裡鎮,房裡里,67,1,651,3,654,1066,3,1,3,0,1,0,61.35
苗栗縣,苑裡鎮,房裡里,68,1,617,4,621,1098,3,1,3,0,1,0,56.56
苗栗縣,苑裡鎮,客庄里,69,1,664,8,672,1099,3,1,3,0,1,0,61.15
苗栗縣,苑裡鎮,客庄里,70,1,694,10,704,1147,3,1,3,0,1,0,61.38
苗栗縣,苑裡鎮,客庄里,71,1,681,2,683,1134,3,1,3,0,1,0,60.23
苗栗縣,苑裡鎮,中正里,72,1,588,3,591,905,3,1,3,0,1,0,65.30
苗栗縣,苑裡鎮,中正里,73,1,564,6,570,903,3,1,3,0,1,0,63.12
苗栗縣,苑裡鎮,苑坑里,74,1,602,7,609,1002,3,1,3,0,1,0,60.78
苗栗縣,苑裡鎮,水坡里,75,1,390,2,392,602,3,1,3,0,1,0,65.12
苗栗縣,苑裡鎮,新復里,76,1,683,3,686,1117,3,1,3,0,1,0,61.41
苗栗縣,苑裡鎮,山腳里,77,1,488,2,490,796,3,1,3,0,1,0,61.56
苗栗縣,苑裡鎮,山腳里,78,1,433,3,436,689,3,1,3,0,1,0,63.28
苗栗縣,苑裡鎮,舊社里,79,1,571,7,578,975,3,1,3,0,1,0,59.28
苗栗縣,苑裡鎮,舊社里,80,1,454,2,456,737,3,1,3,0,1,0,61.87
苗栗縣,苑裡鎮,福田里,81,1,731,7,738,1236,3,1,3,0,1,0,59.71
苗栗縣,苑裡鎮,石鎮里,82,1,430,4,434,607,3,1,3,0,1,0,71.50
苗栗縣,苑裡鎮,蕉埔里,83,1,575,3,578,882,3,1,3,0,1,0,65.53
苗栗縣,苑裡鎮,南勢里,84,1,428,9,437,713,3,1,3,0,1,0,61.29
苗栗縣,苑裡鎮,泰田里,85,1,471,3,474,789,3,1,3,0,1,0,60.08
苗栗縣,苑裡鎮,泰田里,86,1,390,4,394,680,3,1,3,0,1,0,57.94
苗栗縣,苑裡鎮,上館里,87,1,475,10,485,804,3,1,3,0,1,0,60.32
苗栗縣,苑裡鎮,上館里,88,1,427,10,437,738,3,1,3,0,1,0,59.21
苗栗縣,苑裡鎮,玉田里,89,1,459,6,465,780,3,1,3,0,1,0,59.62
苗栗縣,苑裡鎮,玉田里,90,1,453,7,460,853,3,1,3,0,1,0,53.93
苗栗縣,苑裡鎮,社苓里,91,1,624,7,631,1019,3,1,3,0,1,0,61.92
苗栗縣,苑裡鎮,社苓里,92,1,592,7,599,1014,3,1,3,0,1,0,59.07
苗栗縣,苑裡鎮,山柑里,93,1,772,4,776,1216,3,1,3,0,1,0,63.82
苗栗縣,苑裡鎮,田心里,94,1,804,6,810,1372,3,1,3,0,1,0,59.04
苗栗縣,通霄鎮,通東里,95,1,768,2,770,1251,3,1,3,0,1,0,61.55
苗栗縣,通霄鎮,通西里,96,1,621,8,629,943,3,1,3,0,1,0,66.7
苗栗縣,通霄鎮,通西里,97,1,744,10,754,1194,3,1,3,0,1,0,63.15
苗栗縣,通霄鎮,平元里,98,1,778,4,782,1179,3,1,3,0,1,0,66.33
苗栗縣,通霄鎮,平元里,99,1,809,5,814,1401,3,1,3,0,1,0,58.10
苗栗縣,通霄鎮,平元里,100,1,641,2,643,1206,3,1,3,0,1,0,53.32
苗栗縣,通霄鎮,圳頭里,101,1,521,1,522,752,3,1,3,0,1,0,69.41
苗栗縣,通霄鎮,梅南里,102,1,535,2,537,839,3,1,3,0,1,0,64.00
苗栗縣,通霄鎮,梅南里,103,1,398,4,402,666,3,1,3,0,1,0,60.36
苗栗縣,通霄鎮,通南里,104,1,715,5,720,1213,3,1,3,0,1,0,59.36
苗栗縣,通霄鎮,通南里,105,1,764,15,779,1360,3,1,3,0,1,0,57.28
苗栗縣,通霄鎮,內湖里,106,1,487,2,489,747,3,1,3,0,1,0,65.46
苗栗縣,通霄鎮,內湖里,107,1,637,4,641,1018,3,1,3,0,1,0,62.97
苗栗縣,通霄鎮,楓樹里,108,1,353,1,354,535,3,1,3,0,1,0,66.17
苗栗縣,通霄鎮,烏眉里,109,1,624,5,629,943,3,1,3,0,1,0,66.70
苗栗縣,通霄鎮,福龍里,110,1,297,2,299,468,3,1,3,0,1,0,63.89
苗栗縣,通霄鎮,福源里,111,1,515,7,522,789,3,1,3,0,1,0,66.16
苗栗縣,通霄鎮,城北里,112,1,419,3,422,689,3,1,3,0,1,0,61.25
苗栗縣,通霄鎮,城南里,113,1,625,2,627,988,3,1,3,0,1,0,63.46
苗栗縣,通霄鎮,南和里,114,1,535,5,540,825,3,1,3,0,1,0,65.45
苗栗縣,通霄鎮,福興里,115,1,411,3,414,643,3,1,3,0,1,0,64.39
苗栗縣,通霄鎮,坪頂里,116,1,766,9,775,1170,3,1,3,0,1,0,66.24
苗栗縣,通霄鎮,五南里,117,1,797,7,804,1330,3,1,3,0,1,0,60.45
苗栗縣,通霄鎮,五北里,118,1,420,5,425,693,3,1,3,0,1,0,61.33
苗栗縣,通霄鎮,五北里,119,1,523,2,525,777,3,1,3,0,1,0,67.57
苗栗縣,通霄鎮,通灣里,120,1,709,5,714,1146,3,1,3,0,1,0,62.30
苗栗縣,通霄鎮,通灣里,121,1,662,10,672,1067,3,1,3,0,1,0,62.98
苗栗縣,通霄鎮,新埔里,122,1,747,8,755,1249,3,1,3,0,1,0,60.45
苗栗縣,通霄鎮,內島里,123,1,439,7,446,747,3,1,3,0,1,0,59.71
苗栗縣,通霄鎮,白東里,124,1,379,6,385,669,3,1,3,0,1,0,57.55
苗栗縣,通霄鎮,白東里,125,1,416,2,418,709,3,1,3,0,1,0,58.96
苗栗縣,通霄鎮,白西里,126,1,456,5,461,796,3,1,3,0,1,0,57.91
苗栗縣,竹南鎮,竹南里,127,1,645,3,648,1046,3,1,3,0,1,0,61.95
苗栗縣,竹南鎮,竹南里,128,1,531,3,534,863,3,1,3,0,1,0,61.88
苗栗縣,竹南鎮,照南里,129,1,798,9,807,1319,3,1,3,0,1,0,61.18
苗栗縣,竹南鎮,照南里,130,1,680,3,683,1064,3,1,3,0,1,0,64.19
苗栗縣,竹南鎮,正南里,131,1,748,5,753,1227,3,1,3,0,1,0,61.37
苗栗縣,竹南鎮,正南里,132,1,617,7,624,1086,3,1,3,0,1,0,57.46
苗栗縣,竹南鎮,新南里,133,1,486,6,492,837,3,1,3,0,1,0,58.78
苗栗縣,竹南鎮,新南里,134,1,507,1,508,863,3,1,3,0,1,0,58.86
苗栗縣,竹南鎮,新南里,135,1,696,0,696,1169,3,1,3,0,1,0,59.54
苗栗縣,竹南鎮,大厝里,136,1,731,9,740,1201,3,1,3,0,1,0,61.62
苗栗縣,竹南鎮,大厝里,137,1,617,9,626,1082,3,1,3,0,1,0,57.86
苗栗縣,竹南鎮,大厝里,138,1,534,4,538,857,3,1,3,0,1,0,62.78
苗栗縣,竹南鎮,營盤里,139,1,735,11,746,1318,3,1,3,0,1,0,56.60
苗栗縣,竹南鎮,營盤里,140,1,840,8,848,1393,3,1,3,0,1,0,60.88
苗栗縣,竹南鎮,聖福里,141,1,598,5,603,1021,3,1,3,0,1,0,59.06
苗栗縣,竹南鎮,聖福里,142,1,710,5,715,1278,3,1,3,0,1,0,55.95
苗栗縣,竹南鎮,竹興里,143,1,483,2,485,903,3,1,3,0,1,0,53.71
苗栗縣,竹南鎮,竹興里,144,1,556,8,564,979,3,1,3,0,1,0,57.61
苗栗縣,竹南鎮,竹興里,145,1,544,6,550,956,3,1,3,0,1,0,57.53
苗栗縣,竹南鎮,龍鳳里,146,1,582,1,583,918,3,1,3,0,1,0,63.51
苗栗縣,竹南鎮,龍鳳里,147,1,524,8,532,854,3,1,3,0,1,0,62.30
苗栗縣,竹南鎮,龍鳳里,148,1,899,1,900,1442,3,1,3,0,1,0,62.41
苗栗縣,竹南鎮,龍鳳里,149,1,794,5,799,1304,3,1,3,0,1,0,61.27
苗栗縣,竹南鎮,山佳里,150,1,832,11,843,1448,3,1,3,0,1,0,58.22
苗栗縣,竹南鎮,山佳里,151,1,737,3,740,1595,3,1,3,0,1,0,46.39
苗栗縣,竹南鎮,佳興里,152,1,648,6,654,1118,3,1,3,0,1,0,58.50
苗栗縣,竹南鎮,佳興里,153,1,606,5,611,1032,3,1,3,0,1,0,59.21
苗栗縣,竹南鎮,中港里,154,1,565,7,572,968,3,1,3,0,1,0,59.09
苗栗縣,竹南鎮,中華里,155,1,520,5,525,824,3,1,3,0,1,0,63.71
苗栗縣,竹南鎮,中華里,156,1,820,7,827,1474,3,1,3,0,1,0,56.11
苗栗縣,竹南鎮,中英里,157,1,688,7,695,1257,3,1,3,0,1,0,55.29
苗栗縣,竹南鎮,中美里,158,1,956,9,965,1673,3,1,3,0,1,0,57.68
苗栗縣,竹南鎮,開元里,159,1,331,3,334,544,3,1,3,0,1,0,61.40
苗栗縣,竹南鎮,海口里,160,1,698,2,700,1222,3,1,3,0,1,0,57.28
苗栗縣,竹南鎮,海口里,161,1,620,6,626,1107,3,1,3,0,1,0,56.55
苗栗縣,竹南鎮,港墘里,162,1,953,17,970,1472,3,1,3,0,1,0,65.90
苗栗縣,竹南鎮,公館里,163,1,622,8,630,1125,3,1,3,0,1,0,56.00
苗栗縣,竹南鎮,大埔里,164,1,510,4,514,822,3,1,3,0,1,0,62.53
苗栗縣,竹南鎮,大埔里,165,1,637,6,643,1274,3,1,3,0,1,0,50.47
苗栗縣,竹南鎮,大埔里,166,1,597,9,606,1046,3,1,3,0,1,0,57.93
苗栗縣,竹南鎮,頂埔里,167,1,602,4,606,1127,3,1,3,0,1,0,53.77
苗栗縣,竹南鎮,頂埔里,168,1,563,2,565,1013,3,1,3,0,1,0,55.77
苗栗縣,竹南鎮,崎頂里,169,1,811,9,820,1514,3,1,3,0,1,0,54.16
苗栗縣,竹南鎮,崎頂里,170,1,670,5,675,1179,3,1,3,0,1,0,57.25
苗栗縣,竹南鎮,公義里,171,1,529,2,531,933,3,1,3,0,1,0,56.91
苗栗縣,頭份鎮,流東里,172,1,491,2,493,726,3,1,3,0,1,0,67.91
苗栗縣,頭份鎮,流東里,173,1,768,6,774,1347,3,1,3,0,1,0,57.46
苗栗縣,頭份鎮,珊湖里,174,1,575,3,578,916,3,1,3,0,1,0,63.10
苗栗縣,頭份鎮,珊湖里,175,1,571,5,576,860,3,1,3,0,1,0,66.98
苗栗縣,頭份鎮,斗煥里,176,1,591,4,595,1002,3,1,3,0,1,0,59.38
苗栗縣,頭份鎮,斗煥里,177,1,535,6,541,849,3,1,3,0,1,0,63.72
苗栗縣,頭份鎮,斗煥里,178,1,536,3,539,954,3,1,3,0,1,0,56.5
苗栗縣,頭份鎮,新華里,179,1,654,6,660,1022,3,1,3,0,1,0,64.58
苗栗縣,頭份鎮,新華里,180,1,651,1,652,1157,3,1,3,0,1,0,56.35
苗栗縣,頭份鎮,新華里,181,1,762,7,769,1296,3,1,3,0,1,0,59.34
苗栗縣,頭份鎮,興隆里,182,1,532,3,535,793,3,1,3,0,1,0,67.47
苗栗縣,頭份鎮,興隆里,183,1,549,3,552,1008,3,1,3,0,1,0,54.76
苗栗縣,頭份鎮,興隆里,184,1,639,7,646,1111,3,1,3,0,1,0,58.15
苗栗縣,頭份鎮,上埔里,185,1,827,8,835,1367,3,1,3,0,1,0,61.08
苗栗縣,頭份鎮,上埔里,186,1,577,2,579,1026,3,1,3,0,1,0,56.43
苗栗縣,頭份鎮,土牛里,187,1,486,5,491,788,3,1,3,0,1,0,62.31
苗栗縣,頭份鎮,頭份里,188,1,769,5,774,1412,3,1,3,0,1,0,54.82
苗栗縣,頭份鎮,頭份里,189,1,777,10,787,1362,3,1,3,0,1,0,57.78
苗栗縣,頭份鎮,忠孝里,190,1,573,3,576,1006,3,1,3,0,1,0,57.26
苗栗縣,頭份鎮,忠孝里,191,1,668,4,672,1154,3,1,3,0,1,0,58.23
苗栗縣,頭份鎮,忠孝里,192,1,640,7,647,1050,3,1,3,0,1,0,61.62
苗栗縣,頭份鎮,忠孝里,193,1,651,2,653,1143,3,1,3,0,1,0,57.13
苗栗縣,頭份鎮,仁愛里,194,1,510,2,512,838,3,1,3,0,1,0,61.1
苗栗縣,頭份鎮,仁愛里,195,1,424,3,427,690,3,1,3,0,1,0,61.88
苗栗縣,頭份鎮,信義里,196,1,506,3,509,798,3,1,3,0,1,0,63.78
苗栗縣,頭份鎮,和平里,197,1,614,6,620,976,3,1,3,0,1,0,63.52
苗栗縣,頭份鎮,上興里,198,1,722,9,731,1237,3,1,3,0,1,0,59.09
苗栗縣,頭份鎮,下興里,199,1,579,6,585,1063,3,1,3,0,1,0,55.03
苗栗縣,頭份鎮,下興里,200,1,606,2,608,1042,3,1,3,0,1,0,58.35
苗栗縣,頭份鎮,山下里,201,1,814,6,820,1460,3,1,3,0,1,0,56.16
苗栗縣,頭份鎮,山下里,202,1,614,6,620,1079,3,1,3,0,1,0,57.46
苗栗縣,頭份鎮,後庄里,203,1,842,8,850,1430,3,1,3,0,1,0,59.44
苗栗縣,頭份鎮,後庄里,204,1,668,5,673,1290,3,1,3,0,1,0,52.17
苗栗縣,頭份鎮,後庄里,205,1,746,4,750,1350,3,1,3,0,1,0,55.56
苗栗縣,頭份鎮,後庄里,206,1,823,8,831,1431,3,1,3,0,1,0,58.07
苗栗縣,頭份鎮,建國里,207,1,710,6,716,1288,3,1,3,0,1,0,55.59
苗栗縣,頭份鎮,建國里,208,1,777,8,785,1467,3,1,3,0,1,0,53.51
苗栗縣,頭份鎮,成功里,209,1,572,6,578,988,3,1,3,0,1,0,58.50
苗栗縣,頭份鎮,成功里,210,1,520,6,526,950,3,1,3,0,1,0,55.37
苗栗縣,頭份鎮,成功里,211,1,464,6,470,898,3,1,3,0,1,0,52.34
苗栗縣,頭份鎮,蟠桃里,212,1,687,4,691,1224,3,1,3,0,1,0,56.45
苗栗縣,頭份鎮,蟠桃里,213,1,708,9,717,1385,3,1,3,0,1,0,51.77
苗栗縣,頭份鎮,東庄里,214,1,622,4,626,1091,3,1,3,0,1,0,57.38
苗栗縣,頭份鎮,東庄里,215,1,675,7,682,1294,3,1,3,0,1,0,52.7
苗栗縣,頭份鎮,民族里,216,1,466,6,472,867,3,1,3,0,1,0,54.44
苗栗縣,頭份鎮,民族里,217,1,458,4,462,764,3,1,3,0,1,0,60.47
苗栗縣,頭份鎮,民權里,218,1,471,3,474,786,3,1,3,0,1,0,60.31
苗栗縣,頭份鎮,民權里,219,1,479,7,486,860,3,1,3,0,1,0,56.51
苗栗縣,頭份鎮,民生里,220,1,488,5,493,917,3,1,3,0,1,0,53.76
苗栗縣,頭份鎮,民生里,221,1,512,6,518,1007,3,1,3,0,1,0,51.44
苗栗縣,頭份鎮,田寮里,222,1,863,8,871,1441,3,1,3,0,1,0,60.44
苗栗縣,頭份鎮,田寮里,223,1,719,9,728,1313,3,1,3,0,1,0,55.45
苗栗縣,頭份鎮,蘆竹里,224,1,857,7,864,1319,3,1,3,0,1,0,65.50
苗栗縣,頭份鎮,尖山里,225,1,827,11,838,1316,3,1,3,0,1,0,63.68
苗栗縣,頭份鎮,廣興里,226,1,586,5,591,867,3,1,3,0,1,0,68.17
苗栗縣,頭份鎮,尖下里,227,1,648,5,653,1086,3,1,3,0,1,0,60.13
苗栗縣,頭份鎮,尖下里,228,1,811,11,822,1374,3,1,3,0,1,0,59.83
苗栗縣,頭份鎮,濫坑里,229,1,519,6,525,927,3,1,3,0,1,0,56.63
苗栗縣,頭份鎮,濫坑里,230,1,635,2,637,1034,3,1,3,0,1,0,61.61
苗栗縣,後龍鎮,南龍里,231,1,398,1,399,619,3,1,3,0,1,0,64.46
苗栗縣,後龍鎮,南龍里,232,1,496,3,499,758,3,1,3,0,1,0,65.83
苗栗縣,後龍鎮,中龍里,233,1,660,4,664,956,3,1,3,0,1,0,69.46
苗栗縣,後龍鎮,北龍里,234,1,881,5,886,1422,3,1,3,0,1,0,62.31
苗栗縣,後龍鎮,大庄里,235,1,802,6,808,1278,3,1,3,0,1,0,63.22
苗栗縣,後龍鎮,大庄里,236,1,729,8,737,1211,3,1,3,0,1,0,60.86
苗栗縣,後龍鎮,大庄里,237,1,589,2,591,973,3,1,3,0,1,0,60.74
苗栗縣,後龍鎮,溪洲里,238,1,659,4,663,1072,3,1,3,0,1,0,61.85
苗栗縣,後龍鎮,溪洲里,239,1,690,4,694,1150,3,1,3,0,1,0,60.35
苗栗縣,後龍鎮,豐富里,240,1,832,1,833,1272,3,1,3,0,1,0,65.49
苗栗縣,後龍鎮,校椅里,241,1,796,5,801,1220,3,1,3,0,1,0,65.66
苗栗縣,後龍鎮,埔頂里,242,1,718,5,723,1098,3,1,3,0,1,0,65.85
苗栗縣,後龍鎮,埔頂里,243,1,753,7,760,1316,3,1,3,0,1,0,57.75
苗栗縣,後龍鎮,新民里,244,1,921,9,930,1321,3,1,3,0,1,0,70.40
苗栗縣,後龍鎮,復興里,245,1,420,4,424,641,3,1,3,0,1,0,66.15
苗栗縣,後龍鎮,東明里,246,1,829,4,833,1381,3,1,3,0,1,0,60.32
苗栗縣,後龍鎮,大山里,247,1,445,3,448,763,3,1,3,0,1,0,58.72
苗栗縣,後龍鎮,大山里,248,1,467,2,469,800,3,1,3,0,1,0,58.63
苗栗縣,後龍鎮,灣寶里,249,1,750,5,755,1302,3,1,3,0,1,0,57.99
苗栗縣,後龍鎮,海寶里,250,1,557,6,563,1010,3,1,3,0,1,0,55.74
苗栗縣,後龍鎮,外埔里,251,1,619,10,629,1134,3,1,3,0,1,0,55.47
苗栗縣,後龍鎮,海埔里,252,1,544,5,549,993,3,1,3,0,1,0,55.29
苗栗縣,後龍鎮,秀水里,253,1,470,2,472,721,3,1,3,0,1,0,65.46
苗栗縣,後龍鎮,水尾里,254,1,653,5,658,1097,3,1,3,0,1,0,59.98
苗栗縣,後龍鎮,龍津里,255,1,409,4,413,644,3,1,3,0,1,0,64.13
苗栗縣,後龍鎮,龍坑里,256,1,797,11,808,1311,3,1,3,0,1,0,61.63
苗栗縣,後龍鎮,福寧里,257,1,488,4,492,813,3,1,3,0,1,0,60.52
苗栗縣,後龍鎮,中和里,258,1,651,5,656,1221,3,1,3,0,1,0,53.73
苗栗縣,後龍鎮,南港里,259,1,744,5,749,1285,3,1,3,0,1,0,58.29
苗栗縣,卓蘭鎮,老庄里,260,1,690,6,696,1053,3,1,3,0,1,0,66.1
苗栗縣,卓蘭鎮,老庄里,261,1,734,9,743,1107,3,1,3,0,1,0,67.12
苗栗縣,卓蘭鎮,新榮里,262,1,776,3,779,1168,3,1,3,0,1,0,66.70
苗栗縣,卓蘭鎮,中街里,263,1,544,2,546,814,3,1,3,0,1,0,67.08
苗栗縣,卓蘭鎮,新厝里,264,1,506,3,509,829,3,1,3,0,1,0,61.40
苗栗縣,卓蘭鎮,新厝里,265,1,477,2,479,775,3,1,3,0,1,0,61.81
苗栗縣,卓蘭鎮,豐田里,266,1,656,11,667,1033,3,1,3,0,1,0,64.57
苗栗縣,卓蘭鎮,西坪里,267,1,351,7,358,555,3,1,3,0,1,0,64.50
苗栗縣,卓蘭鎮,苗豐里,268,1,471,17,488,756,3,1,3,0,1,0,64.55
苗栗縣,卓蘭鎮,上新里,269,1,436,4,440,795,3,1,3,0,1,0,55.35
苗栗縣,卓蘭鎮,上新里,270,1,483,5,488,835,3,1,3,0,1,0,58.44
苗栗縣,卓蘭鎮,上新里,271,1,306,1,307,443,3,1,3,0,1,0,69.30
苗栗縣,卓蘭鎮,內灣里,272,1,396,6,402,677,3,1,3,0,1,0,59.38
苗栗縣,卓蘭鎮,內灣里,273,1,454,5,459,738,3,1,3,0,1,0,62.2
苗栗縣,卓蘭鎮,內灣里,274,1,446,5,451,727,3,1,3,0,1,0,62.04
苗栗縣,卓蘭鎮,坪林里,275,1,587,4,591,935,3,1,3,0,1,0,63.21
苗栗縣,卓蘭鎮,坪林里,276,1,335,5,340,488,3,1,3,0,1,0,69.67
苗栗縣,卓蘭鎮,景山里,277,1,424,4,428,701,3,1,3,0,1,0,61.06
苗栗縣,大湖鄉,大湖村,278,1,486,1,487,771,3,1,3,0,1,0,63.16
苗栗縣,大湖鄉,大湖村,279,1,568,4,572,922,3,1,3,0,1,0,62.04
苗栗縣,大湖鄉,明湖村,280,1,484,5,489,666,3,1,3,0,1,0,73.42
苗栗縣,大湖鄉,大寮村,281,1,728,5,733,1255,3,1,3,0,1,0,58.41
苗栗縣,大湖鄉,靜湖村,282,1,485,3,488,853,3,1,3,0,1,0,57.21
苗栗縣,大湖鄉,靜湖村,283,1,520,2,522,831,3,1,3,0,1,0,62.82
苗栗縣,大湖鄉,富興村,284,1,761,7,768,1365,3,1,3,0,1,0,56.26
苗栗縣,大湖鄉,大南村,285,1,351,7,358,623,3,1,3,0,1,0,57.46
苗栗縣,大湖鄉,南湖村,286,1,453,8,461,733,3,1,3,0,1,0,62.89
苗栗縣,大湖鄉,東興村,287,1,458,1,459,720,3,1,3,0,1,0,63.75
苗栗縣,大湖鄉,武榮村,288,1,330,4,334,512,3,1,3,0,1,0,65.23
苗栗縣,大湖鄉,義和村,289,1,400,2,402,715,3,1,3,0,1,0,56.22
苗栗縣,大湖鄉,義和村,290,1,492,4,496,873,3,1,3,0,1,0,56.82
苗栗縣,大湖鄉,栗林村,291,1,555,9,564,920,3,1,3,0,1,0,61.3
苗栗縣,大湖鄉,新開村,292,1,520,6,526,844,3,1,3,0,1,0,62.32
苗栗縣,公館鄉,館中村,293,1,524,8,532,819,3,1,3,0,1,0,64.96
苗栗縣,公館鄉,館中村,294,1,459,4,463,758,3,1,3,0,1,0,61.08
苗栗縣,公館鄉,館東村,295,1,619,5,624,1028,3,1,3,0,1,0,60.7
苗栗縣,公館鄉,館東村,296,1,673,6,679,1140,3,1,3,0,1,0,59.56
苗栗縣,公館鄉,館南村,297,1,740,6,746,1324,3,1,3,0,1,0,56.34
苗栗縣,公館鄉,館南村,298,1,834,6,840,1513,3,1,3,0,1,0,55.52
苗栗縣,公館鄉,中義村,299,1,586,5,591,1039,3,1,3,0,1,0,56.88
苗栗縣,公館鄉,中義村,300,1,547,3,550,946,3,1,3,0,1,0,58.14
苗栗縣,公館鄉,玉泉村,301,1,617,5,622,1060,3,1,3,0,1,0,58.68
苗栗縣,公館鄉,玉泉村,302,1,359,5,364,683,3,1,3,0,1,0,53.29
苗栗縣,公館鄉,大坑村,303,1,560,10,570,983,3,1,3,0,1,0,57.99
苗栗縣,公館鄉,福基村,304,1,664,6,670,1069,3,1,3,0,1,0,62.68
苗栗縣,公館鄉,福德村,305,1,269,2,271,396,3,1,3,0,1,0,68.43
苗栗縣,公館鄉,福星村,306,1,430,3,433,731,3,1,3,0,1,0,59.23
苗栗縣,公館鄉,福星村,307,1,544,5,549,959,3,1,3,0,1,0,57.25
苗栗縣,公館鄉,石墻村,308,1,434,5,439,734,3,1,3,0,1,0,59.81
苗栗縣,公館鄉,石墻村,309,1,373,8,381,710,3,1,3,0,1,0,53.66
苗栗縣,公館鄉,開礦村,310,1,218,1,219,308,3,1,3,0,1,0,71.1
苗栗縣,公館鄉,五穀村,311,1,545,1,546,939,3,1,3,0,1,0,58.15
苗栗縣,公館鄉,五穀村,312,1,527,8,535,871,3,1,3,0,1,0,61.42
苗栗縣,公館鄉,玉穀村,313,1,671,12,683,1139,3,1,3,0,1,0,59.96
苗栗縣,公館鄉,鶴岡村,314,1,816,7,823,1359,3,1,3,0,1,0,60.56
苗栗縣,公館鄉,鶴山村,315,1,809,7,816,1375,3,1,3,0,1,0,59.35
苗栗縣,公館鄉,尖山村,316,1,781,8,789,1381,3,1,3,0,1,0,57.13
苗栗縣,公館鄉,仁安村,317,1,699,4,703,1180,3,1,3,0,1,0,59.58
苗栗縣,公館鄉,南河村,318,1,147,3,150,252,3,1,3,0,1,0,59.52
苗栗縣,公館鄉,北河村,319,1,200,1,201,313,3,1,3,0,1,0,64.22
苗栗縣,銅鑼鄉,銅鑼村,320,1,579,4,583,870,3,1,3,0,1,0,67.01
苗栗縣,銅鑼鄉,銅鑼村,321,1,676,5,681,1022,3,1,3,0,1,0,66.63
苗栗縣,銅鑼鄉,銅鑼村,322,1,763,8,771,1287,3,1,3,0,1,0,59.91
苗栗縣,銅鑼鄉,銅鑼村,323,1,547,3,550,1008,3,1,3,0,1,0,54.56
苗栗縣,銅鑼鄉,樟樹村,324,1,769,8,777,1268,3,1,3,0,1,0,61.28
苗栗縣,銅鑼鄉,九湖村,325,1,757,5,762,1241,3,1,3,0,1,0,61.4
苗栗縣,銅鑼鄉,朝陽村,326,1,584,6,590,939,3,1,3,0,1,0,62.83
苗栗縣,銅鑼鄉,朝陽村,327,1,480,7,487,794,3,1,3,0,1,0,61.34
苗栗縣,銅鑼鄉,竹森村,328,1,642,5,647,1099,3,1,3,0,1,0,58.87
苗栗縣,銅鑼鄉,福興村,329,1,658,4,662,1059,3,1,3,0,1,0,62.51
苗栗縣,銅鑼鄉,中平村,330,1,628,5,633,1042,3,1,3,0,1,0,60.75
苗栗縣,銅鑼鄉,中平村,331,1,476,1,477,830,3,1,3,0,1,0,57.47
苗栗縣,銅鑼鄉,中平村,332,1,500,3,503,952,3,1,3,0,1,0,52.84
苗栗縣,銅鑼鄉,興隆村,333,1,416,3,419,628,3,1,3,0,1,0,66.72
苗栗縣,銅鑼鄉,盛隆村,334,1,275,5,280,494,3,1,3,0,1,0,56.68
苗栗縣,銅鑼鄉,新隆村,335,1,327,2,329,539,3,1,3,0,1,0,61.04
苗栗縣,南庄鄉,東村,336,1,294,5,299,499,3,1,3,0,1,0,59.92
苗栗縣,南庄鄉,東村,337,1,411,3,414,697,3,1,3,0,1,0,59.4
苗栗縣,南庄鄉,西村,338,1,399,9,408,651,3,1,3,0,1,0,62.67
苗栗縣,南庄鄉,南江村,339,1,321,2,323,543,3,1,3,0,1,0,59.48
苗栗縣,南庄鄉,南江村,340,1,279,1,280,490,3,1,3,0,1,0,57.14
苗栗縣,南庄鄉,田美村,341,1,505,5,510,851,3,1,3,0,1,0,59.93
苗栗縣,南庄鄉,獅山村,342,1,514,2,516,961,3,1,3,0,1,0,53.69
苗栗縣,南庄鄉,南富村,343,1,670,5,675,1054,3,1,3,0,1,0,64.04
苗栗縣,南庄鄉,員林村,344,1,612,9,621,1031,3,1,3,0,1,0,60.23
苗栗縣,南庄鄉,蓬萊村,345,1,234,1,235,473,3,1,3,0,1,0,49.68
苗栗縣,南庄鄉,東河村,346,1,148,0,148,281,3,1,3,0,1,0,52.67
苗栗縣,頭屋鄉,頭屋村,347,1,829,6,835,1321,3,1,3,0,1,0,63.21
苗栗縣,頭屋鄉,頭屋村,348,1,733,4,737,1098,3,1,3,0,1,0,67.12
苗栗縣,頭屋鄉,獅潭村,349,1,472,6,478,786,3,1,3,0,1,0,60.81
苗栗縣,頭屋鄉,獅潭村,350,1,533,7,540,795,3,1,3,0,1,0,67.92
苗栗縣,頭屋鄉,北坑村,351,1,426,4,430,683,3,1,3,0,1,0,62.96
苗栗縣,頭屋鄉,曲洞村,352,1,588,8,596,866,3,1,3,0,1,0,68.82
苗栗縣,頭屋鄉,飛鳳村,353,1,234,4,238,353,3,1,3,0,1,0,67.42
苗栗縣,頭屋鄉,象山村,354,1,509,5,514,881,3,1,3,0,1,0,58.34
苗栗縣,頭屋鄉,象山村,355,1,579,9,588,987,3,1,3,0,1,0,59.57
苗栗縣,頭屋鄉,明德村,356,1,583,2,585,890,3,1,3,0,1,0,65.73
苗栗縣,頭屋鄉,明德村,357,1,136,2,138,202,3,1,3,0,1,0,68.32
苗栗縣,頭屋鄉,鳴鳳村,358,1,222,2,224,346,3,1,3,0,1,0,64.74
苗栗縣,三義鄉,廣盛村,359,1,826,3,829,1241,3,1,3,0,1,0,66.8
苗栗縣,三義鄉,廣盛村,360,1,1018,6,1024,1610,3,1,3,0,1,0,63.6
苗栗縣,三義鄉,廣盛村,361,1,659,8,667,1117,3,1,3,0,1,0,59.71
苗栗縣,三義鄉,勝興村,362,1,568,9,577,949,3,1,3,0,1,0,60.8
苗栗縣,三義鄉,勝興村,363,1,576,7,583,1063,3,1,3,0,1,0,54.84
苗栗縣,三義鄉,勝興村,364,1,556,11,567,1014,3,1,3,0,1,0,55.92
苗栗縣,三義鄉,雙湖村,365,1,1044,13,1057,1650,3,1,3,0,1,0,64.06
苗栗縣,三義鄉,雙潭村,366,1,904,8,912,1366,3,1,3,0,1,0,66.76
苗栗縣,三義鄉,西湖村,367,1,842,5,847,1339,3,1,3,0,1,0,63.26
苗栗縣,三義鄉,龍騰村,368,1,274,5,279,399,3,1,3,0,1,0,69.92
苗栗縣,三義鄉,鯉魚潭村,369,1,786,10,796,1172,3,1,3,0,1,0,67.92
苗栗縣,西湖鄉,高埔村,370,1,372,7,379,603,3,1,3,0,1,0,62.85
苗栗縣,西湖鄉,下埔村,371,1,364,7,371,565,3,1,3,0,1,0,65.66
苗栗縣,西湖鄉,五湖村,372,1,521,6,527,883,3,1,3,0,1,0,59.68
苗栗縣,西湖鄉,四湖村,373,1,393,1,394,647,3,1,3,0,1,0,60.9
苗栗縣,西湖鄉,三湖村,374,1,537,7,544,945,3,1,3,0,1,0,57.57
苗栗縣,西湖鄉,龍洞村,375,1,309,2,311,511,3,1,3,0,1,0,60.86
苗栗縣,西湖鄉,金獅村,376,1,325,3,328,525,3,1,3,0,1,0,62.48
苗栗縣,西湖鄉,湖東村,377,1,652,4,656,1127,3,1,3,0,1,0,58.21
苗栗縣,西湖鄉,二湖村,378,1,426,5,431,686,3,1,3,0,1,0,62.83
苗栗縣,造橋鄉,造橋村,379,1,591,3,594,986,3,1,3,0,1,0,60.24
苗栗縣,造橋鄉,造橋村,380,1,466,4,470,801,3,1,3,0,1,0,58.68
苗栗縣,造橋鄉,平興村,381,1,310,2,312,478,3,1,3,0,1,0,65.27
苗栗縣,造橋鄉,豐湖村,382,1,577,0,577,960,3,1,3,0,1,0,60.1
苗栗縣,造橋鄉,大西村,383,1,958,8,966,1689,3,1,3,0,1,0,57.19
苗栗縣,造橋鄉,大西村,384,1,930,8,938,1417,3,1,3,0,1,0,66.2
苗栗縣,造橋鄉,錦水村,385,1,338,4,342,539,3,1,3,0,1,0,63.45
苗栗縣,造橋鄉,大龍村,386,1,298,1,299,496,3,1,3,0,1,0,60.28
苗栗縣,造橋鄉,朝陽村,387,1,804,13,817,1356,3,1,3,0,1,0,60.25
苗栗縣,造橋鄉,談文村,388,1,461,3,464,712,3,1,3,0,1,0,65.17
苗栗縣,造橋鄉,龍昇村,389,1,614,9,623,1003,3,1,3,0,1,0,62.11
苗栗縣,三灣鄉,三灣村,390,1,698,4,702,1017,3,1,3,0,1,0,69.03
苗栗縣,三灣鄉,三灣村,391,1,684,9,693,1110,3,1,3,0,1,0,62.43
苗栗縣,三灣鄉,內灣村,392,1,365,5,370,580,3,1,3,0,1,0,63.79
苗栗縣,三灣鄉,銅鏡村,393,1,510,8,518,849,3,1,3,0,1,0,61.01
苗栗縣,三灣鄉,頂寮村,394,1,148,2,150,230,3,1,3,0,1,0,65.22
苗栗縣,三灣鄉,北埔村,395,1,320,6,326,519,3,1,3,0,1,0,62.81
苗栗縣,三灣鄉,大河村,396,1,380,6,386,604,3,1,3,0,1,0,63.91
苗栗縣,三灣鄉,大坪村,397,1,278,2,280,462,3,1,3,0,1,0,60.61
苗栗縣,三灣鄉,永和村,398,1,226,5,231,366,3,1,3,0,1,0,63.11
苗栗縣,獅潭鄉,竹木村,399,1,448,5,453,755,3,1,3,0,1,0,60
苗栗縣,獅潭鄉,新豐村,400,1,246,1,247,358,3,1,3,0,1,0,68.99
苗栗縣,獅潭鄉,豐林村,401,1,387,3,390,629,3,1,3,0,1,0,62
苗栗縣,獅潭鄉,和興村,402,1,357,6,363,592,3,1,3,0,1,0,61.32
苗栗縣,獅潭鄉,新店村,403,1,555,10,565,928,3,1,3,0,1,0,60.88
苗栗縣,獅潭鄉,永興村,404,1,363,2,365,627,3,1,3,0,1,0,58.21
苗栗縣,獅潭鄉,百壽村,405,1,177,2,179,271,3,1,3,0,1,0,66.05
苗栗縣,泰安鄉,八卦村,406,1,91,2,93,139,3,1,3,0,1,0,66.91
苗栗縣,泰安鄉,錦水村,407,1,216,0,216,358,3,1,3,0,1,0,60.34
苗栗縣,泰安鄉,清安村,408,1,181,2,183,278,3,1,3,0,1,0,65.83
苗栗縣,泰安鄉,清安村,409,1,229,3,232,343,3,1,3,0,1,0,67.64
苗栗縣,泰安鄉,大興村,410,1,50,0,50,91,3,1,3,0,1,0,54.95
苗栗縣,泰安鄉,中興村,411,1,74,0,74,123,3,1,3,0,1,0,60.16
苗栗縣,泰安鄉,梅園村,412,1,18,0,18,27,3,1,3,0,1,0,66.67
苗栗縣,泰安鄉,象鼻村,413,1,20,0,20,51,3,1,3,0,1,0,39.22
苗栗縣,泰安鄉,士林村,414,1,14,0,14,27,3,1,3,0,1,0,51.85
臺中縣,豐原市,豐原里,1,1,504,11,515,885,3,1,3,0,1,0,58.19
臺中縣,豐原市,豐原里,2,1,669,8,677,1096,3,1,3,0,1,0,61.77
臺中縣,豐原市,豐榮里,3,1,590,5,595,1025,3,1,3,0,1,0,58.05
臺中縣,豐原市,頂街里,4,1,541,5,546,885,3,1,3,0,1,0,61.69
臺中縣,豐原市,中山里,5,1,609,3,612,916,3,1,3,0,1,0,66.81
臺中縣,豐原市,下街里,6,1,491,4,495,795,3,1,3,0,1,0,62.26
臺中縣,豐原市,中陽里,7,1,878,9,887,1460,3,1,3,0,1,0,60.75
臺中縣,豐原市,中陽里,8,1,780,9,789,1337,3,1,3,0,1,0,59.01
臺中縣,豐原市,中陽里,9,1,1062,13,1075,1730,3,1,3,0,1,0,62.14
臺中縣,豐原市,大湳里,10,1,660,11,671,1110,3,1,3,0,1,0,60.45
臺中縣,豐原市,大湳里,11,1,649,4,653,1154,3,1,3,0,1,0,56.59
臺中縣,豐原市,北湳里,12,1,691,12,703,1314,3,1,3,0,1,0,53.50
臺中縣,豐原市,北湳里,13,1,648,13,661,1188,3,1,3,0,1,0,55.64
臺中縣,豐原市,東湳里,14,1,755,9,764,1268,3,1,3,0,1,0,60.25
臺中縣,豐原市,東湳里,15,1,740,10,750,1357,3,1,3,0,1,0,55.27
臺中縣,豐原市,東湳里,16,1,761,12,773,1104,3,1,3,0,1,0,70.02
臺中縣,豐原市,西湳里,17,1,789,10,799,1408,3,1,3,0,1,0,56.75
臺中縣,豐原市,西湳里,18,1,777,8,785,1443,3,1,3,0,1,0,54.40
臺中縣,豐原市,西湳里,19,1,650,8,658,1198,3,1,3,0,1,0,54.92
臺中縣,豐原市,西湳里,20,1,646,5,651,1214,3,1,3,0,1,0,53.62
臺中縣,豐原市,西湳里,21,1,826,10,836,1438,3,1,3,0,1,0,58.14
臺中縣,豐原市,豐西里,22,1,1070,6,1076,1728,3,1,3,0,1,0,62.27
臺中縣,豐原市,圳寮里,23,1,733,2,735,1138,3,1,3,0,1,0,64.59
臺中縣,豐原市,豐圳里,24,1,769,0,769,1269,3,1,3,0,1,0,60.60
臺中縣,豐原市,豐圳里,25,1,893,12,905,1510,3,1,3,0,1,0,59.93
臺中縣,豐原市,富春里,26,1,563,7,570,833,3,1,3,0,1,0,68.43
臺中縣,豐原市,葫蘆里,27,1,493,5,498,792,3,1,3,0,1,0,62.88
臺中縣,豐原市,西安里,28,1,979,6,985,1504,3,1,3,0,1,0,65.49
臺中縣,豐原市,西安里,29,1,963,6,969,1729,3,1,3,0,1,0,56.04
臺中縣,豐原市,西安里,30,1,880,7,887,1601,3,1,3,0,1,0,55.40
臺中縣,豐原市,西勢里,31,1,695,4,699,1295,3,1,3,0,1,0,53.98
臺中縣,豐原市,西勢里,32,1,596,3,599,983,3,1,3,0,1,0,60.94
臺中縣,豐原市,中興里,33,1,738,6,744,1239,3,1,3,0,1,0,60.05
臺中縣,豐原市,中興里,34,1,876,13,889,1512,3,1,3,0,1,0,58.80
臺中縣,豐原市,社皮里,35,1,823,7,830,1516,3,1,3,0,1,0,54.75
臺中縣,豐原市,社皮里,36,1,730,13,743,1361,3,1,3,0,1,0,54.59
臺中縣,豐原市,社皮里,37,1,775,9,784,1541,3,1,3,0,1,0,50.88
臺中縣,豐原市,社皮里,38,1,697,4,701,1402,3,1,3,0,1,0,50.00
臺中縣,豐原市,社皮里,39,1,954,6,960,1839,3,1,3,0,1,0,52.20
臺中縣,豐原市,三村里,40,1,868,9,877,1628,3,1,3,0,1,0,53.87
臺中縣,豐原市,三村里,41,1,828,4,832,1512,3,1,3,0,1,0,55.03
臺中縣,豐原市,三村里,42,1,1027,11,1038,1855,3,1,3,0,1,0,55.96
臺中縣,豐原市,東勢里,43,1,802,4,806,1362,3,1,3,0,1,0,59.18
臺中縣,豐原市,民生里,44,1,589,5,594,1037,3,1,3,0,1,0,57.28
臺中縣,豐原市,田心里,45,1,1048,10,1058,1843,3,1,3,0,1,0,57.41
臺中縣,豐原市,田心里,46,1,838,4,842,1457,3,1,3,0,1,0,57.79
臺中縣,豐原市,田心里,47,1,764,18,782,1401,3,1,3,0,1,0,55.82
臺中縣,豐原市,豐田里,48,1,947,17,964,1770,3,1,3,0,1,0,54.46
臺中縣,豐原市,豐田里,49,1,934,12,946,1700,3,1,3,0,1,0,55.65
臺中縣,豐原市,豐田里,50,1,987,11,998,1732,3,1,3,0,1,0,57.62
臺中縣,豐原市,豐田里,51,1,946,15,961,1744,3,1,3,0,1,0,55.10
臺中縣,豐原市,豐田里,52,1,1033,6,1039,1851,3,1,3,0,1,0,56.13
臺中縣,豐原市,鎌村里,53,1,713,13,726,1214,3,1,3,0,1,0,59.80
臺中縣,豐原市,鎌村里,54,1,680,7,687,1169,3,1,3,0,1,0,58.77
臺中縣,豐原市,鎌村里,55,1,721,7,728,1176,3,1,3,0,1,0,61.90
臺中縣,豐原市,陽明里,56,1,710,9,719,1224,3,1,3,0,1,0,58.74
臺中縣,豐原市,陽明里,57,1,719,9,728,1226,3,1,3,0,1,0,59.38
臺中縣,豐原市,南陽里,58,1,842,9,851,1506,3,1,3,0,1,0,56.51
臺中縣,豐原市,南陽里,59,1,966,6,972,1808,3,1,3,0,1,0,53.76
臺中縣,豐原市,南陽里,60,1,736,5,741,1356,3,1,3,0,1,0,54.65
臺中縣,豐原市,南陽里,61,1,866,3,869,1451,3,1,3,0,1,0,59.89
臺中縣,豐原市,南陽里,62,1,717,14,731,1409,3,1,3,0,1,0,51.88
臺中縣,豐原市,北陽里,63,1,835,5,840,1556,3,1,3,0,1,0,53.98
臺中縣,豐原市,北陽里,64,1,945,7,952,1637,3,1,3,0,1,0,58.16
臺中縣,豐原市,北陽里,65,1,1041,18,1059,1995,3,1,3,0,1,0,53.08
臺中縣,豐原市,北陽里,66,1,924,7,931,1667,3,1,3,0,1,0,55.85
臺中縣,豐原市,北陽里,67,1,836,14,850,1530,3,1,3,0,1,0,55.56
臺中縣,豐原市,北陽里,68,1,956,11,967,1668,3,1,3,0,1,0,57.97
臺中縣,豐原市,東陽里,69,1,958,6,964,1495,3,1,3,0,1,0,64.48
臺中縣,豐原市,南村里,70,1,724,12,736,1221,3,1,3,0,1,0,60.28
臺中縣,豐原市,南村里,71,1,719,2,721,1323,3,1,3,0,1,0,54.50
臺中縣,豐原市,南村里,72,1,892,6,898,1528,3,1,3,0,1,0,58.77
臺中縣,豐原市,南田里,73,1,859,10,869,1578,3,1,3,0,1,0,55.07
臺中縣,豐原市,南田里,74,1,883,10,893,1394,3,1,3,0,1,0,64.06
臺中縣,豐原市,南嵩里,75,1,886,17,903,1525,3,1,3,0,1,0,59.21
臺中縣,豐原市,南嵩里,76,1,794,10,804,1323,3,1,3,0,1,0,60.77
臺中縣,豐原市,翁明里,77,1,1048,14,1062,1728,3,1,3,0,1,0,61.46
臺中縣,豐原市,翁子里,78,1,692,4,696,1220,3,1,3,0,1,0,57.05
臺中縣,豐原市,翁子里,79,1,716,12,728,1164,3,1,3,0,1,0,62.54
臺中縣,豐原市,翁社里,80,1,486,5,491,761,3,1,3,0,1,0,64.52
臺中縣,豐原市,翁社里,81,1,636,16,652,1080,3,1,3,0,1,0,60.37
臺中縣,豐原市,朴子里,82,1,575,17,592,987,3,1,3,0,1,0,59.98
臺中縣,豐原市,朴子里,83,1,622,7,629,1018,3,1,3,0,1,0,61.79
臺中縣,豐原市,朴子里,84,1,553,4,557,932,3,1,3,0,1,0,59.76
臺中縣,大里市,大里里,85,1,988,8,996,1576,3,1,3,0,1,0,63.20
臺中縣,大里市,大里里,86,1,862,10,872,1421,3,1,3,0,1,0,61.37
臺中縣,大里市,新里里,87,1,872,8,880,1526,3,1,3,0,1,0,57.67
臺中縣,大里市,新里里,88,1,1018,14,1032,2219,3,1,3,0,1,0,46.51
臺中縣,大里市,新里里,89,1,923,2,925,1644,3,1,3,0,1,0,56.27
臺中縣,大里市,新里里,90,1,781,7,788,1446,3,1,3,0,1,0,54.50
臺中縣,大里市,國光里,91,1,1136,11,1147,1899,3,1,3,0,1,0,60.40
臺中縣,大里市,國光里,92,1,1115,13,1128,1917,3,1,3,0,1,0,58.84
臺中縣,大里市,樹王里,93,1,831,21,852,1443,3,1,3,0,1,0,59.04
臺中縣,大里市,樹王里,94,1,897,11,908,1386,3,1,3,0,1,0,65.51
臺中縣,大里市,祥興里,95,1,532,6,538,969,3,1,3,0,1,0,55.52
臺中縣,大里市,祥興里,96,1,620,4,624,1146,3,1,3,0,1,0,54.45
臺中縣,大里市,祥興里,97,1,624,4,628,1245,3,1,3,0,1,0,50.44
臺中縣,大里市,祥興里,98,1,630,11,641,1244,3,1,3,0,1,0,51.53
臺中縣,大里市,祥興里,99,1,516,4,520,919,3,1,3,0,1,0,56.58
臺中縣,大里市,內新里,100,1,868,6,874,1656,3,1,3,0,1,0,52.78
臺中縣,大里市,內新里,101,1,611,5,616,1047,3,1,3,0,1,0,58.83
臺中縣,大里市,內新里,102,1,774,6,780,1426,3,1,3,0,1,0,54.70
臺中縣,大里市,內新里,103,1,715,2,717,1341,3,1,3,0,1,0,53.47
臺中縣,大里市,中新里,104,1,624,8,632,1075,3,1,3,0,1,0,58.79
臺中縣,大里市,中新里,105,1,617,6,623,1075,3,1,3,0,1,0,57.95
臺中縣,大里市,中新里,106,1,736,4,740,1398,3,1,3,0,1,0,52.93
臺中縣,大里市,東昇里,107,1,695,14,709,1163,3,1,3,0,1,0,60.96
臺中縣,大里市,東昇里,108,1,860,8,868,1451,3,1,3,0,1,0,59.82
臺中縣,大里市,大元里,109,1,578,10,588,923,3,1,3,0,1,0,63.71
臺中縣,大里市,大元里,110,1,904,4,908,1462,3,1,3,0,1,0,62.11
臺中縣,大里市,大元里,111,1,589,18,607,1030,3,1,3,0,1,0,58.93
臺中縣,大里市,西湖里,112,1,705,0,705,1095,3,1,3,0,1,0,64.38
臺中縣,大里市,西湖里,113,1,676,3,679,1063,3,1,3,0,1,0,63.88
臺中縣,大里市,夏田里,114,1,622,9,631,940,3,1,3,0,1,0,67.13
臺中縣,大里市,仁化里,115,1,871,3,874,1792,3,1,3,0,1,0,48.77
臺中縣,大里市,仁化里,116,1,1061,9,1070,1928,3,1,3,0,1,0,55.50
臺中縣,大里市,仁化里,117,1,1022,6,1028,1823,3,1,3,0,1,0,56.39
臺中縣,大里市,仁德里,118,1,857,8,865,1574,3,1,3,0,1,0,54.96
臺中縣,大里市,仁德里,119,1,962,5,967,1692,3,1,3,0,1,0,57.15
臺中縣,大里市,仁德里,120,1,803,13,816,1537,3,1,3,0,1,0,53.09
臺中縣,大里市,健民里,121,1,888,5,893,1521,3,1,3,0,1,0,58.71
臺中縣,大里市,健民里,122,1,891,7,898,1417,3,1,3,0,1,0,63.37
臺中縣,大里市,健民里,123,1,712,12,724,1337,3,1,3,0,1,0,54.15
臺中縣,大里市,塗城里,124,1,966,8,974,1794,3,1,3,0,1,0,54.29
臺中縣,大里市,塗城里,125,1,912,5,917,1545,3,1,3,0,1,0,59.35
臺中縣,大里市,塗城里,126,1,877,9,886,1661,3,1,3,0,1,0,53.34
臺中縣,大里市,塗城里,127,1,893,9,902,1746,3,1,3,0,1,0,51.66
臺中縣,大里市,東湖里,128,1,792,6,798,1477,3,1,3,0,1,0,54.03
臺中縣,大里市,東湖里,129,1,710,6,716,1372,3,1,3,0,1,0,52.19
臺中縣,大里市,東湖里,130,1,658,4,662,1219,3,1,3,0,1,0,54.31
臺中縣,大里市,東湖里,131,1,618,12,630,1066,3,1,3,0,1,0,59.10
臺中縣,大里市,東湖里,132,1,693,5,698,1231,3,1,3,0,1,0,56.70
臺中縣,大里市,東興里,133,1,799,4,803,1452,3,1,3,0,1,0,55.30
臺中縣,大里市,東興里,134,1,697,2,699,1287,3,1,3,0,1,0,54.31
臺中縣,大里市,東興里,135,1,988,12,1000,1646,3,1,3,0,1,0,60.75
臺中縣,大里市,東興里,136,1,743,6,749,1311,3,1,3,0,1,0,57.13
臺中縣,大里市,大明里,137,1,574,13,587,1113,3,1,3,0,1,0,52.74
臺中縣,大里市,大明里,138,1,646,5,651,1016,3,1,3,0,1,0,64.07
臺中縣,大里市,大明里,139,1,620,6,626,1170,3,1,3,0,1,0,53.50
臺中縣,大里市,永隆里,140,1,1271,10,1281,2369,3,1,3,0,1,0,54.07
臺中縣,大里市,永隆里,141,1,1219,4,1223,2029,3,1,3,0,1,0,60.28
臺中縣,大里市,日新里,142,1,1065,10,1075,1758,3,1,3,0,1,0,61.15
臺中縣,大里市,日新里,143,1,893,9,902,1484,3,1,3,0,1,0,60.78
臺中縣,大里市,西榮里,144,1,842,8,850,1650,3,1,3,0,1,0,51.52
臺中縣,大里市,西榮里,145,1,831,7,838,1466,3,1,3,0,1,0,57.16
臺中縣,大里市,西榮里,146,1,867,8,875,1468,3,1,3,0,1,0,59.60
臺中縣,大里市,長榮里,147,1,796,4,800,1408,3,1,3,0,1,0,56.82
臺中縣,大里市,長榮里,148,1,818,3,821,1593,3,1,3,0,1,0,51.54
臺中縣,大里市,長榮里,149,1,964,4,968,1615,3,1,3,0,1,0,59.94
臺中縣,大里市,長榮里,150,1,753,14,767,1300,3,1,3,0,1,0,59.00
臺中縣,大里市,金城里,151,1,880,4,884,1667,3,1,3,0,1,0,53.03
臺中縣,大里市,金城里,152,1,786,7,793,1453,3,1,3,0,1,0,54.58
臺中縣,大里市,金城里,153,1,987,7,994,1644,3,1,3,0,1,0,60.46
臺中縣,大里市,金城里,154,1,853,6,859,1588,3,1,3,0,1,0,54.09
臺中縣,大里市,金城里,155,1,789,5,794,1511,3,1,3,0,1,0,52.55
臺中縣,大里市,立仁里,156,1,663,4,667,1177,3,1,3,0,1,0,56.67
臺中縣,大里市,立仁里,157,1,708,7,715,1307,3,1,3,0,1,0,54.71
臺中縣,大里市,立仁里,158,1,704,6,710,1451,3,1,3,0,1,0,48.93
臺中縣,大里市,立德里,159,1,841,8,849,1460,3,1,3,0,1,0,58.15
臺中縣,大里市,立德里,160,1,741,5,746,1291,3,1,3,0,1,0,57.78
臺中縣,大里市,立德里,161,1,720,10,730,1388,3,1,3,0,1,0,52.59
臺中縣,大里市,新仁里,162,1,845,11,856,1462,3,1,3,0,1,0,58.55
臺中縣,大里市,新仁里,163,1,944,13,957,1675,3,1,3,0,1,0,57.13
臺中縣,大里市,新仁里,164,1,932,5,937,1564,3,1,3,0,1,0,59.91
臺中縣,大里市,新仁里,165,1,800,5,805,1416,3,1,3,0,1,0,56.85
臺中縣,大里市,瑞城里,166,1,795,7,802,1386,3,1,3,0,1,0,57.86
臺中縣,大里市,瑞城里,167,1,686,8,694,1247,3,1,3,0,1,0,55.65
臺中縣,大里市,瑞城里,168,1,718,4,722,1239,3,1,3,0,1,0,58.27
臺中縣,大里市,瑞城里,169,1,727,7,734,1299,3,1,3,0,1,0,56.51
臺中縣,大里市,瑞城里,170,1,766,4,770,1329,3,1,3,0,1,0,57.94
臺中縣,大里市,瑞城里,171,1,688,2,690,1348,3,1,3,0,1,0,51.19
臺中縣,大里市,瑞城里,172,1,620,7,627,1144,3,1,3,0,1,0,54.81
臺中縣,太平市,太平里,173,1,1267,7,1274,1964,3,1,3,0,1,0,64.87
臺中縣,太平市,太平里,174,1,1026,14,1040,1590,3,1,3,0,1,0,65.41
臺中縣,太平市,太平里,175,1,1016,9,1025,1683,3,1,3,0,1,0,60.90
臺中縣,太平市,長億里,176,1,936,5,941,1656,3,1,3,0,1,0,56.82
臺中縣,太平市,長億里,177,1,829,7,836,1420,3,1,3,0,1,0,58.87
臺中縣,太平市,長億里,178,1,636,4,640,1146,3,1,3,0,1,0,55.85
臺中縣,太平市,長億里,179,1,1135,18,1153,1974,3,1,3,0,1,0,58.41
臺中縣,太平市,長億里,180,1,956,11,967,1754,3,1,3,0,1,0,55.13
臺中縣,太平市,中平里,181,1,871,4,875,1509,3,1,3,0,1,0,57.99
臺中縣,太平市,中平里,182,1,843,7,850,1441,3,1,3,0,1,0,58.99
臺中縣,太平市,中平里,183,1,928,7,935,1655,3,1,3,0,1,0,56.50
臺中縣,太平市,中平里,184,1,923,10,933,1586,3,1,3,0,1,0,58.83
臺中縣,太平市,中興里,185,1,686,7,693,1258,3,1,3,0,1,0,55.09
臺中縣,太平市,中興里,186,1,875,9,884,1546,3,1,3,0,1,0,57.18
臺中縣,太平市,中興里,187,1,731,3,734,1339,3,1,3,0,1,0,54.82
臺中縣,太平市,中興里,188,1,748,5,753,1259,3,1,3,0,1,0,59.81
臺中縣,太平市,中興里,189,1,858,11,869,1402,3,1,3,0,1,0,61.98
臺中縣,太平市,東平里,190,1,1176,15,1191,1864,3,1,3,0,1,0,63.89
臺中縣,太平市,東平里,191,1,1189,8,1197,1852,3,1,3,0,1,0,64.63
臺中縣,太平市,東平里,192,1,1055,14,1069,1748,3,1,3,0,1,0,61.16
臺中縣,太平市,東平里,193,1,1028,7,1035,1781,3,1,3,0,1,0,58.11
臺中縣,太平市,東平里,194,1,1204,8,1212,2065,3,1,3,0,1,0,58.69
臺中縣,太平市,建國里,195,1,891,12,903,1591,3,1,3,0,1,0,56.76
臺中縣,太平市,建國里,196,1,886,13,899,1448,3,1,3,0,1,0,62.09
臺中縣,太平市,建國里,197,1,1212,10,1222,1979,3,1,3,0,1,0,61.75
臺中縣,太平市,坪林里,198,1,753,5,758,1135,3,1,3,0,1,0,66.78
臺中縣,太平市,坪林里,199,1,597,6,603,1039,3,1,3,0,1,0,58.04
臺中縣,太平市,坪林里,200,1,789,7,796,1262,3,1,3,0,1,0,63.07
臺中縣,太平市,坪林里,201,1,894,7,901,1333,3,1,3,0,1,0,67.59
臺中縣,太平市,坪林里,202,1,617,6,623,959,3,1,3,0,1,0,64.96
臺中縣,太平市,坪林里,203,1,765,7,772,1275,3,1,3,0,1,0,60.55
臺中縣,太平市,光華里,204,1,594,5,599,1026,3,1,3,0,1,0,58.38
臺中縣,太平市,光華里,205,1,1280,20,1300,2129,3,1,3,0,1,0,61.06
臺中縣,太平市,光華里,206,1,1160,12,1172,1862,3,1,3,0,1,0,62.94
臺中縣,太平市,光華里,207,1,1198,11,1209,1970,3,1,3,0,1,0,61.37
臺中縣,太平市,中山里,208,1,970,8,978,1589,3,1,3,0,1,0,61.55
臺中縣,太平市,中山里,209,1,756,9,765,1198,3,1,3,0,1,0,63.86
臺中縣,太平市,中山里,210,1,1015,8,1023,1641,3,1,3,0,1,0,62.34
臺中縣,太平市,中山里,211,1,1189,11,1200,2453,3,1,3,0,1,0,48.92
臺中縣,太平市,宜欣里,212,1,832,7,839,1489,3,1,3,0,1,0,56.35
臺中縣,太平市,宜欣里,213,1,1026,7,1033,1811,3,1,3,0,1,0,57.04
臺中縣,太平市,宜欣里,214,1,1143,7,1150,2236,3,1,3,0,1,0,51.43
臺中縣,太平市,宜欣里,215,1,1034,10,1044,1903,3,1,3,0,1,0,54.86
臺中縣,太平市,宜欣里,216,1,897,11,908,1700,3,1,3,0,1,0,53.41
臺中縣,太平市,宜欣里,217,1,1167,22,1189,1907,3,1,3,0,1,0,62.35
臺中縣,太平市,宜欣里,218,1,903,11,914,1528,3,1,3,0,1,0,59.82
臺中縣,太平市,新坪里,219,1,709,8,717,1214,3,1,3,0,1,0,59.06
臺中縣,太平市,新坪里,220,1,862,6,868,1506,3,1,3,0,1,0,57.64
臺中縣,太平市,新坪里,221,1,740,6,746,1289,3,1,3,0,1,0,57.87
臺中縣,太平市,新坪里,222,1,609,6,615,1069,3,1,3,0,1,0,57.53
臺中縣,太平市,新坪里,223,1,803,9,812,1603,3,1,3,0,1,0,50.66
臺中縣,太平市,新坪里,224,1,513,11,524,1107,3,1,3,0,1,0,47.34
臺中縣,太平市,新坪里,225,1,525,4,529,1218,3,1,3,0,1,0,43.43
臺中縣,太平市,新坪里,226,1,633,7,640,1339,3,1,3,0,1,0,47.80
臺中縣,太平市,新坪里,227,1,724,3,727,1388,3,1,3,0,1,0,52.38
臺中縣,太平市,新光里,228,1,1238,6,1244,2014,3,1,3,0,1,0,61.77
臺中縣,太平市,新光里,229,1,1085,10,1095,1950,3,1,3,0,1,0,56.15
臺中縣,太平市,新光里,230,1,1109,11,1120,1963,3,1,3,0,1,0,57.06
臺中縣,太平市,新光里,231,1,1040,20,1060,1811,3,1,3,0,1,0,58.53
臺中縣,太平市,新光里,232,1,869,8,877,1591,3,1,3,0,1,0,55.12
臺中縣,太平市,新福里,233,1,1108,10,1118,1773,3,1,3,0,1,0,63.06
臺中縣,太平市,新福里,234,1,587,10,597,1032,3,1,3,0,1,0,57.85
臺中縣,太平市,新福里,235,1,834,6,840,1441,3,1,3,0,1,0,58.29
臺中縣,太平市,頭汴里,236,1,706,12,718,1113,3,1,3,0,1,0,64.51
臺中縣,太平市,頭汴里,237,1,713,8,721,1102,3,1,3,0,1,0,65.43
臺中縣,太平市,頭汴里,238,1,674,9,683,1056,3,1,3,0,1,0,64.68
臺中縣,太平市,東汴里,239,1,776,4,780,1176,3,1,3,0,1,0,66.33
臺中縣,太平市,興隆里,240,1,1018,6,1024,1602,3,1,3,0,1,0,63.92
臺中縣,太平市,興隆里,241,1,976,4,980,1573,3,1,3,0,1,0,62.30
臺中縣,太平市,興隆里,242,1,892,3,895,1464,3,1,3,0,1,0,61.13
臺中縣,太平市,興隆里,243,1,713,6,719,1123,3,1,3,0,1,0,64.02
臺中縣,太平市,黃竹里,244,1,586,4,590,810,3,1,3,0,1,0,72.84
臺中縣,太平市,光隆里,245,1,968,13,981,1540,3,1,3,0,1,0,63.70
臺中縣,太平市,光隆里,246,1,1052,8,1060,1818,3,1,3,0,1,0,58.31
臺中縣,太平市,光隆里,247,1,770,3,773,1302,3,1,3,0,1,0,59.37
臺中縣,太平市,德隆里,248,1,1167,9,1176,1856,3,1,3,0,1,0,63.36
臺中縣,太平市,德隆里,249,1,959,13,972,1726,3,1,3,0,1,0,56.32
臺中縣,東勢鎮,北興里,250,1,762,10,772,1229,3,1,3,0,1,0,62.82
臺中縣,東勢鎮,中寧里,251,1,505,5,510,810,3,1,3,0,1,0,62.96
臺中縣,東勢鎮,東安里,252,1,741,10,751,1268,3,1,3,0,1,0,59.23
臺中縣,東勢鎮,南平里,253,1,499,7,506,792,3,1,3,0,1,0,63.89
臺中縣,東勢鎮,南平里,254,1,652,9,661,1097,3,1,3,0,1,0,60.26
臺中縣,東勢鎮,延平里,255,1,662,5,667,1123,3,1,3,0,1,0,59.39
臺中縣,東勢鎮,延平里,256,1,653,5,658,1065,3,1,3,0,1,0,61.78
臺中縣,東勢鎮,上新里,257,1,623,4,627,954,3,1,3,0,1,0,65.72
臺中縣,東勢鎮,廣興里,258,1,868,5,873,1460,3,1,3,0,1,0,59.79
臺中縣,東勢鎮,泰昌里,259,1,822,7,829,1415,3,1,3,0,1,0,58.59
臺中縣,東勢鎮,泰昌里,260,1,624,4,628,1018,3,1,3,0,1,0,61.69
臺中縣,東勢鎮,泰昌里,261,1,458,7,465,799,3,1,3,0,1,0,58.20
臺中縣,東勢鎮,中嵙里,262,1,547,6,553,924,3,1,3,0,1,0,59.85
臺中縣,東勢鎮,中嵙里,263,1,512,4,516,918,3,1,3,0,1,0,56.21
臺中縣,東勢鎮,福隆里,264,1,695,12,707,1272,3,1,3,0,1,0,55.58
臺中縣,東勢鎮,福隆里,265,1,1107,19,1126,1876,3,1,3,0,1,0,60.02
臺中縣,東勢鎮,隆興里,266,1,777,9,786,1422,3,1,3,0,1,0,55.27
臺中縣,東勢鎮,新盛里,267,1,786,18,804,1347,3,1,3,0,1,0,59.69
臺中縣,東勢鎮,新盛里,268,1,941,16,957,1637,3,1,3,0,1,0,58.46
臺中縣,東勢鎮,新盛里,269,1,948,14,962,1607,3,1,3,0,1,0,59.86
臺中縣,東勢鎮,詒福里,270,1,880,12,892,1468,3,1,3,0,1,0,60.76
臺中縣,東勢鎮,上城里,271,1,629,6,635,965,3,1,3,0,1,0,65.80
臺中縣,東勢鎮,下城里,272,1,578,3,581,888,3,1,3,0,1,0,65.43
臺中縣,東勢鎮,慶東里,273,1,651,7,658,1035,3,1,3,0,1,0,63.57
臺中縣,東勢鎮,慶東里,274,1,553,2,555,875,3,1,3,0,1,0,63.43
臺中縣,東勢鎮,慶福里,275,1,728,10,738,1397,3,1,3,0,1,0,52.83
臺中縣,東勢鎮,東新里,276,1,501,7,508,871,3,1,3,0,1,0,58.32
臺中縣,東勢鎮,東新里,277,1,590,7,597,1028,3,1,3,0,1,0,58.07
臺中縣,東勢鎮,粵寧里,278,1,655,7,662,1110,3,1,3,0,1,0,59.64
臺中縣,東勢鎮,粵寧里,279,1,363,5,368,636,3,1,3,0,1,0,57.86
臺中縣,東勢鎮,下新里,280,1,969,15,984,1647,3,1,3,0,1,0,59.74
臺中縣,東勢鎮,興隆里,281,1,691,5,696,1218,3,1,3,0,1,0,57.14
臺中縣,東勢鎮,茂興里,282,1,950,17,967,1757,3,1,3,0,1,0,55.04
臺中縣,東勢鎮,泰興里,283,1,433,4,437,746,3,1,3,0,1,0,58.58
臺中縣,東勢鎮,埤頭里,284,1,439,3,442,653,3,1,3,0,1,0,67.69
臺中縣,東勢鎮,明正里,285,1,758,8,766,1399,3,1,3,0,1,0,54.75
臺中縣,大甲鎮,朝陽里,286,1,811,8,819,1287,3,1,3,0,1,0,63.64
臺中縣,大甲鎮,大甲里,287,1,713,6,719,1203,3,1,3,0,1,0,59.77
臺中縣,大甲鎮,順天里,288,1,479,5,484,775,3,1,3,0,1,0,62.45
臺中縣,大甲鎮,順天里,289,1,506,7,513,871,3,1,3,0,1,0,58.90
臺中縣,大甲鎮,孔門里,290,1,497,6,503,779,3,1,3,0,1,0,64.57
臺中縣,大甲鎮,平安里,291,1,581,7,588,911,3,1,3,0,1,0,64.54
臺中縣,大甲鎮,平安里,292,1,658,3,661,1077,3,1,3,0,1,0,61.37
臺中縣,大甲鎮,庄美里,293,1,602,7,609,933,3,1,3,0,1,0,65.27
臺中縣,大甲鎮,庄美里,294,1,635,6,641,1053,3,1,3,0,1,0,60.87
臺中縣,大甲鎮,新美里,295,1,587,7,594,1020,3,1,3,0,1,0,58.24
臺中縣,大甲鎮,新美里,296,1,685,10,695,1078,3,1,3,0,1,0,64.47
臺中縣,大甲鎮,新美里,297,1,659,6,665,1033,3,1,3,0,1,0,64.38
臺中縣,大甲鎮,岷山里,298,1,548,3,551,890,3,1,3,0,1,0,61.91
臺中縣,大甲鎮,岷山里,299,1,617,1,618,972,3,1,3,0,1,0,63.58
臺中縣,大甲鎮,中山里,300,1,596,11,607,1082,3,1,3,0,1,0,56.10
臺中縣,大甲鎮,中山里,301,1,755,8,763,1212,3,1,3,0,1,0,62.95
臺中縣,大甲鎮,中山里,302,1,658,9,667,1183,3,1,3,0,1,0,56.38
臺中縣,大甲鎮,南陽里,303,1,544,9,553,863,3,1,3,0,1,0,64.08
臺中縣,大甲鎮,薰風里,304,1,585,2,587,936,3,1,3,0,1,0,62.71
臺中縣,大甲鎮,義和里,305,1,767,10,777,1278,3,1,3,0,1,0,60.80
臺中縣,大甲鎮,義和里,306,1,768,13,781,1373,3,1,3,0,1,0,56.88
臺中縣,大甲鎮,武陵里,307,1,838,9,847,1110,3,1,3,0,1,0,76.31
臺中縣,大甲鎮,文曲里,308,1,715,4,719,1096,3,1,3,0,1,0,65.60
臺中縣,大甲鎮,武曲里,309,1,561,9,570,826,3,1,3,0,1,0,69.01
臺中縣,大甲鎮,武曲里,310,1,463,6,469,763,3,1,3,0,1,0,61.47
臺中縣,大甲鎮,文武里,311,1,724,10,734,1191,3,1,3,0,1,0,61.63
臺中縣,大甲鎮,文武里,312,1,693,5,698,1103,3,1,3,0,1,0,63.28
臺中縣,大甲鎮,文武里,313,1,681,9,690,1142,3,1,3,0,1,0,60.42
臺中縣,大甲鎮,文武里,314,1,672,7,679,1191,3,1,3,0,1,0,57.01
臺中縣,大甲鎮,奉化里,315,1,871,11,882,1469,3,1,3,0,1,0,60.04
臺中縣,大甲鎮,德化里,316,1,485,3,488,783,3,1,3,0,1,0,62.32
臺中縣,大甲鎮,德化里,317,1,433,3,436,803,3,1,3,0,1,0,54.30
臺中縣,大甲鎮,江南里,318,1,619,13,632,1066,3,1,3,0,1,0,59.29
臺中縣,大甲鎮,頂店里,319,1,624,7,631,1033,3,1,3,0,1,0,61.08
臺中縣,大甲鎮,頂店里,320,1,674,8,682,1068,3,1,3,0,1,0,63.86
臺中縣,大甲鎮,頂店里,321,1,780,7,787,1319,3,1,3,0,1,0,59.67
臺中縣,大甲鎮,太白里,322,1,716,5,721,1231,3,1,3,0,1,0,58.57
臺中縣,大甲鎮,孟春里,323,1,742,4,746,1160,3,1,3,0,1,0,64.31
臺中縣,大甲鎮,孟春里,324,1,662,12,674,1071,3,1,3,0,1,0,62.93
臺中縣,大甲鎮,孟春里,325,1,564,11,575,1024,3,1,3,0,1,0,56.15
臺中縣,大甲鎮,幸福里,326,1,695,11,706,1118,3,1,3,0,1,0,63.15
臺中縣,大甲鎮,幸福里,327,1,736,14,750,1258,3,1,3,0,1,0,59.62
臺中縣,大甲鎮,日南里,328,1,556,8,564,1020,3,1,3,0,1,0,55.29
臺中縣,大甲鎮,日南里,329,1,497,9,506,946,3,1,3,0,1,0,53.49
臺中縣,大甲鎮,日南里,330,1,544,4,548,1021,3,1,3,0,1,0,53.67
臺中縣,大甲鎮,日南里,331,1,605,9,614,1135,3,1,3,0,1,0,54.10
臺中縣,大甲鎮,龍泉里,332,1,383,5,388,602,3,1,3,0,1,0,64.45
臺中縣,大甲鎮,龍泉里,333,1,506,8,514,784,3,1,3,0,1,0,65.56
臺中縣,大甲鎮,西岐里,334,1,465,5,470,788,3,1,3,0,1,0,59.64
臺中縣,大甲鎮,西岐里,335,1,463,4,467,707,3,1,3,0,1,0,66.05
臺中縣,大甲鎮,銅安里,336,1,720,6,726,1244,3,1,3,0,1,0,58.36
臺中縣,大甲鎮,福德里,337,1,722,10,732,1081,3,1,3,0,1,0,67.72
臺中縣,大甲鎮,建興里,338,1,856,8,864,1320,3,1,3,0,1,0,65.45
臺中縣,清水鎮,鰲峰里,339,1,810,10,820,1202,3,1,3,0,1,0,68.22
臺中縣,清水鎮,靈泉里,340,1,707,4,711,1075,3,1,3,0,1,0,66.14
臺中縣,清水鎮,清水里,341,1,579,6,585,961,3,1,3,0,1,0,60.87
臺中縣,清水鎮,清水里,342,1,670,4,674,1081,3,1,3,0,1,0,62.35
臺中縣,清水鎮,文昌里,343,1,465,5,470,730,3,1,3,0,1,0,64.38
臺中縣,清水鎮,南寧里,344,1,565,4,569,850,3,1,3,0,1,0,66.94
臺中縣,清水鎮,南寧里,345,1,616,3,619,934,3,1,3,0,1,0,66.27
臺中縣,清水鎮,西寧里,346,1,945,6,951,1478,3,1,3,0,1,0,64.34
臺中縣,清水鎮,北寧里,347,1,508,4,512,724,3,1,3,0,1,0,70.72
臺中縣,清水鎮,中興里,348,1,329,2,331,449,3,1,3,0,1,0,73.72
臺中縣,清水鎮,西社里,349,1,906,17,923,1429,3,1,3,0,1,0,64.59
臺中縣,清水鎮,西社里,350,1,633,7,640,981,3,1,3,0,1,0,65.24
臺中縣,清水鎮,南社里,351,1,712,8,720,1179,3,1,3,0,1,0,61.07
臺中縣,清水鎮,南社里,352,1,907,5,912,1477,3,1,3,0,1,0,61.75
臺中縣,清水鎮,南社里,353,1,878,8,886,1359,3,1,3,0,1,0,65.19
臺中縣,清水鎮,南社里,354,1,859,7,866,1449,3,1,3,0,1,0,59.77
臺中縣,清水鎮,裕嘉里,355,1,755,12,767,1296,3,1,3,0,1,0,59.18
臺中縣,清水鎮,臨江里,356,1,946,9,955,1488,3,1,3,0,1,0,64.18
臺中縣,清水鎮,秀水里,357,1,729,6,735,1252,3,1,3,0,1,0,58.71
臺中縣,清水鎮,秀水里,358,1,667,10,677,1211,3,1,3,0,1,0,55.90
臺中縣,清水鎮,秀水里,359,1,663,5,668,1159,3,1,3,0,1,0,57.64
臺中縣,清水鎮,武鹿里,360,1,845,8,853,1374,3,1,3,0,1,0,62.08
臺中縣,清水鎮,武鹿里,361,1,870,10,880,1396,3,1,3,0,1,0,63.04
臺中縣,清水鎮,海濱里,362,1,703,12,715,1078,3,1,3,0,1,0,66.33
臺中縣,清水鎮,海濱里,363,1,474,6,480,783,3,1,3,0,1,0,61.30
臺中縣,清水鎮,康榔里,364,1,794,7,801,1347,3,1,3,0,1,0,59.47
臺中縣,清水鎮,康榔里,365,1,605,9,614,1032,3,1,3,0,1,0,59.50
臺中縣,清水鎮,康榔里,366,1,710,10,720,1286,3,1,3,0,1,0,55.99
臺中縣,清水鎮,中社里,367,1,436,6,442,697,3,1,3,0,1,0,63.41
臺中縣,清水鎮,中社里,368,1,541,3,544,821,3,1,3,0,1,0,66.26
臺中縣,清水鎮,高西里,369,1,800,15,815,1312,3,1,3,0,1,0,62.12
臺中縣,清水鎮,高南里,370,1,894,8,902,1317,3,1,3,0,1,0,68.49
臺中縣,清水鎮,高東里,371,1,728,12,740,1275,3,1,3,0,1,0,58.04
臺中縣,清水鎮,高北里,372,1,691,12,703,1117,3,1,3,0,1,0,62.94
臺中縣,清水鎮,高美里,373,1,853,5,858,1285,3,1,3,0,1,0,66.77
臺中縣,清水鎮,國姓里,374,1,574,3,577,1088,3,1,3,0,1,0,53.03
臺中縣,清水鎮,國姓里,375,1,513,4,517,905,3,1,3,0,1,0,57.13
臺中縣,清水鎮,菁埔里,376,1,646,5,651,1050,3,1,3,0,1,0,62.00
臺中縣,清水鎮,菁埔里,377,1,638,3,641,1136,3,1,3,0,1,0,56.43
臺中縣,清水鎮,頂湳里,378,1,529,5,534,827,3,1,3,0,1,0,64.57
臺中縣,清水鎮,頂湳里,379,1,526,7,533,915,3,1,3,0,1,0,58.25
臺中縣,清水鎮,田寮里,380,1,664,13,677,1157,3,1,3,0,1,0,58.51
臺中縣,清水鎮,田寮里,381,1,518,5,523,998,3,1,3,0,1,0,52.40
臺中縣,清水鎮,橋頭里,382,1,895,7,902,1420,3,1,3,0,1,0,63.52
臺中縣,清水鎮,橋頭里,383,1,909,9,918,1448,3,1,3,0,1,0,63.40
臺中縣,清水鎮,橋頭里,384,1,792,10,802,1283,3,1,3,0,1,0,62.51
臺中縣,清水鎮,橋頭里,385,1,963,9,972,1694,3,1,3,0,1,0,57.38
臺中縣,清水鎮,下湳里,386,1,505,6,511,804,3,1,3,0,1,0,63.56
臺中縣,清水鎮,下湳里,387,1,456,3,459,801,3,1,3,0,1,0,57.30
臺中縣,清水鎮,下湳里,388,1,792,13,805,1266,3,1,3,0,1,0,63.59
臺中縣,清水鎮,東山里,389,1,806,12,818,1103,3,1,3,0,1,0,74.16
臺中縣,清水鎮,楊厝里,390,1,1024,14,1038,1328,3,1,3,0,1,0,78.16
臺中縣,清水鎮,海風里,391,1,669,11,680,1031,3,1,3,0,1,0,65.96
臺中縣,清水鎮,吳厝里,392,1,750,7,757,1219,3,1,3,0,1,0,62.10
臺中縣,沙鹿鎮,居仁里,393,1,806,10,816,1361,3,1,3,0,1,0,59.96
臺中縣,沙鹿鎮,洛泉里,394,1,630,3,633,955,3,1,3,0,1,0,66.28
臺中縣,沙鹿鎮,洛泉里,395,1,840,9,849,1223,3,1,3,0,1,0,69.42
臺中縣,沙鹿鎮,沙鹿里,396,1,706,7,713,1160,3,1,3,0,1,0,61.47
臺中縣,沙鹿鎮,美仁里,397,1,382,2,384,540,3,1,3,0,1,0,71.11
臺中縣,沙鹿鎮,興仁里,398,1,688,17,705,1198,3,1,3,0,1,0,58.85
臺中縣,沙鹿鎮,興仁里,399,1,700,8,708,1192,3,1,3,0,1,0,59.40
臺中縣,沙鹿鎮,興安里,400,1,680,12,692,1108,3,1,3,0,1,0,62.45
臺中縣,沙鹿鎮,興安里,401,1,930,5,935,1535,3,1,3,0,1,0,60.91
臺中縣,沙鹿鎮,斗抵里,402,1,640,8,648,1015,3,1,3,0,1,0,63.84
臺中縣,沙鹿鎮,斗抵里,403,1,728,5,733,1260,3,1,3,0,1,0,58.17
臺中縣,沙鹿鎮,斗抵里,404,1,872,5,877,1377,3,1,3,0,1,0,63.69
臺中縣,沙鹿鎮,鹿峰里,405,1,713,5,718,1232,3,1,3,0,1,0,58.28
臺中縣,沙鹿鎮,鹿峰里,406,1,727,8,735,1270,3,1,3,0,1,0,57.87
臺中縣,沙鹿鎮,鹿峰里,407,1,789,6,795,1369,3,1,3,0,1,0,58.07
臺中縣,沙鹿鎮,鹿寮里,408,1,980,10,990,1632,3,1,3,0,1,0,60.66
臺中縣,沙鹿鎮,鹿寮里,409,1,657,4,661,1078,3,1,3,0,1,0,61.32
臺中縣,沙鹿鎮,鹿寮里,410,1,613,4,617,1045,3,1,3,0,1,0,59.04
臺中縣,沙鹿鎮,鹿寮里,411,1,844,16,860,1373,3,1,3,0,1,0,62.64
臺中縣,沙鹿鎮,竹林里,412,1,834,15,849,1296,3,1,3,0,1,0,65.51
臺中縣,沙鹿鎮,竹林里,413,1,846,10,856,1407,3,1,3,0,1,0,60.84
臺中縣,沙鹿鎮,竹林里,414,1,851,17,868,1449,3,1,3,0,1,0,59.90
臺中縣,沙鹿鎮,竹林里,415,1,845,4,849,1393,3,1,3,0,1,0,60.95
臺中縣,沙鹿鎮,犁分里,416,1,543,5,548,844,3,1,3,0,1,0,64.93
臺中縣,沙鹿鎮,福興里,417,1,827,7,834,1436,3,1,3,0,1,0,58.08
臺中縣,沙鹿鎮,福興里,418,1,517,1,518,864,3,1,3,0,1,0,59.95
臺中縣,沙鹿鎮,北勢里,419,1,639,2,641,1085,3,1,3,0,1,0,59.08
臺中縣,沙鹿鎮,北勢里,420,1,590,5,595,1054,3,1,3,0,1,0,56.45
臺中縣,沙鹿鎮,北勢里,421,1,709,12,721,1246,3,1,3,0,1,0,57.87
臺中縣,沙鹿鎮,晉江里,422,1,809,8,817,1244,3,1,3,0,1,0,65.68
臺中縣,沙鹿鎮,六路里,423,1,686,2,688,1143,3,1,3,0,1,0,60.19
臺中縣,沙鹿鎮,六路里,424,1,700,12,712,1238,3,1,3,0,1,0,57.51
臺中縣,沙鹿鎮,南勢里,425,1,631,11,642,962,3,1,3,0,1,0,66.74
臺中縣,沙鹿鎮,南勢里,426,1,554,11,565,908,3,1,3,0,1,0,62.22
臺中縣,沙鹿鎮,埔子里,427,1,1426,16,1442,2171,3,1,3,0,1,0,66.42
臺中縣,沙鹿鎮,三鹿里,428,1,758,11,769,1153,3,1,3,0,1,0,66.70
臺中縣,沙鹿鎮,三鹿里,429,1,848,5,853,1275,3,1,3,0,1,0,66.90
臺中縣,沙鹿鎮,公明里,430,1,770,4,774,1301,3,1,3,0,1,0,59.49
臺中縣,沙鹿鎮,公明里,431,1,513,7,520,821,3,1,3,0,1,0,63.34
臺中縣,沙鹿鎮,公明里,432,1,834,8,842,1295,3,1,3,0,1,0,65.02
臺中縣,沙鹿鎮,清泉里,433,1,652,7,659,1084,3,1,3,0,1,0,60.79
臺中縣,沙鹿鎮,清泉里,434,1,447,6,453,761,3,1,3,0,1,0,59.53
臺中縣,沙鹿鎮,西勢里,435,1,654,15,669,1049,3,1,3,0,1,0,63.78
臺中縣,沙鹿鎮,西勢里,436,1,536,9,545,941,3,1,3,0,1,0,57.92
臺中縣,梧棲鎮,頂寮里,437,1,642,21,663,1069,3,1,3,0,1,0,62.02
臺中縣,梧棲鎮,頂寮里,438,1,830,2,832,1546,3,1,3,0,1,0,53.82
臺中縣,梧棲鎮,下寮里,439,1,555,26,581,888,3,1,3,0,1,0,65.43
臺中縣,梧棲鎮,下寮里,440,1,664,5,669,1095,3,1,3,0,1,0,61.10
臺中縣,梧棲鎮,中正里,441,1,592,8,600,1051,3,1,3,0,1,0,57.09
臺中縣,梧棲鎮,中正里,442,1,631,6,637,1123,3,1,3,0,1,0,56.72
臺中縣,梧棲鎮,中正里,443,1,636,8,644,1156,3,1,3,0,1,0,55.71
臺中縣,梧棲鎮,中和里,444,1,330,4,334,552,3,1,3,0,1,0,60.51
臺中縣,梧棲鎮,文化里,445,1,694,7,701,1120,3,1,3,0,1,0,62.59
臺中縣,梧棲鎮,安仁里,446,1,442,4,446,728,3,1,3,0,1,0,61.26
臺中縣,梧棲鎮,草湳里,447,1,642,15,657,1080,3,1,3,0,1,0,60.83
臺中縣,梧棲鎮,草湳里,448,1,844,16,860,1440,3,1,3,0,1,0,59.72
臺中縣,梧棲鎮,草湳里,449,1,742,7,749,1286,3,1,3,0,1,0,58.24
臺中縣,梧棲鎮,草湳里,450,1,893,17,910,1420,3,1,3,0,1,0,64.08
臺中縣,梧棲鎮,南簡里,451,1,718,6,724,1224,3,1,3,0,1,0,59.15
臺中縣,梧棲鎮,南簡里,452,1,775,6,781,1474,3,1,3,0,1,0,52.99
臺中縣,梧棲鎮,福德里,453,1,827,10,837,1419,3,1,3,0,1,0,58.99
臺中縣,梧棲鎮,福德里,454,1,809,8,817,1495,3,1,3,0,1,0,54.65
臺中縣,梧棲鎮,大庄里,455,1,604,11,615,1090,3,1,3,0,1,0,56.42
臺中縣,梧棲鎮,大庄里,456,1,577,5,582,1086,3,1,3,0,1,0,53.59
臺中縣,梧棲鎮,大庄里,457,1,820,6,826,1393,3,1,3,0,1,0,59.30
臺中縣,梧棲鎮,大庄里,458,1,442,7,449,767,3,1,3,0,1,0,58.54
臺中縣,梧棲鎮,大庄里,459,1,451,4,455,794,3,1,3,0,1,0,57.30
臺中縣,梧棲鎮,大村里,460,1,739,9,748,1366,3,1,3,0,1,0,54.76
臺中縣,梧棲鎮,大村里,461,1,749,7,756,1414,3,1,3,0,1,0,53.47
臺中縣,梧棲鎮,大村里,462,1,585,6,591,1053,3,1,3,0,1,0,56.13
臺中縣,梧棲鎮,興農里,463,1,583,8,591,1011,3,1,3,0,1,0,58.46
臺中縣,梧棲鎮,興農里,464,1,489,5,494,782,3,1,3,0,1,0,63.17
臺中縣,梧棲鎮,永寧里,465,1,590,2,592,1013,3,1,3,0,1,0,58.44
臺中縣,梧棲鎮,永寧里,466,1,642,5,647,1168,3,1,3,0,1,0,55.39
臺中縣,梧棲鎮,永安里,467,1,708,14,722,1154,3,1,3,0,1,0,62.56
臺中縣,梧棲鎮,永安里,468,1,650,3,653,1120,3,1,3,0,1,0,58.30
臺中縣,后里鄉,廣福村,469,1,560,9,569,810,3,1,3,0,1,0,70.25
臺中縣,后里鄉,廣福村,470,1,656,15,671,1037,3,1,3,0,1,0,64.71
臺中縣,后里鄉,仁里村,471,1,569,9,578,934,3,1,3,0,1,0,61.88
臺中縣,后里鄉,仁里村,472,1,308,2,310,521,3,1,3,0,1,0,59.50
臺中縣,后里鄉,義里村,473,1,839,8,847,1319,3,1,3,0,1,0,64.22
臺中縣,后里鄉,義里村,474,1,892,8,900,1380,3,1,3,0,1,0,65.22
臺中縣,后里鄉,義德村,475,1,795,12,807,1289,3,1,3,0,1,0,62.61
臺中縣,后里鄉,義德村,476,1,763,12,775,1251,3,1,3,0,1,0,61.95
臺中縣,后里鄉,后里村,477,1,752,11,763,1228,3,1,3,0,1,0,62.13
臺中縣,后里鄉,后里村,478,1,815,6,821,1209,3,1,3,0,1,0,67.91
臺中縣,后里鄉,后里村,479,1,562,8,570,893,3,1,3,0,1,0,63.83
臺中縣,后里鄉,厚里村,480,1,588,2,590,899,3,1,3,0,1,0,65.63
臺中縣,后里鄉,厚里村,481,1,677,13,690,1027,3,1,3,0,1,0,67.19
臺中縣,后里鄉,墩東村,482,1,941,7,948,1539,3,1,3,0,1,0,61.60
臺中縣,后里鄉,墩東村,483,1,792,13,805,1327,3,1,3,0,1,0,60.66
臺中縣,后里鄉,墩東村,484,1,843,8,851,1229,3,1,3,0,1,0,69.24
臺中縣,后里鄉,墩西村,485,1,568,2,570,872,3,1,3,0,1,0,65.37
臺中縣,后里鄉,墩西村,486,1,596,24,620,947,3,1,3,0,1,0,65.47
臺中縣,后里鄉,墩南村,487,1,805,4,809,1232,3,1,3,0,1,0,65.67
臺中縣,后里鄉,墩南村,488,1,920,10,930,1409,3,1,3,0,1,0,66.00
臺中縣,后里鄉,墩北村,489,1,819,4,823,1264,3,1,3,0,1,0,65.11
臺中縣,后里鄉,墩北村,490,1,986,17,1003,1577,3,1,3,0,1,0,63.60
臺中縣,后里鄉,中和村,491,1,621,7,628,961,3,1,3,0,1,0,65.35
臺中縣,后里鄉,中和村,492,1,698,7,705,1102,3,1,3,0,1,0,63.97
臺中縣,后里鄉,舊社村,493,1,877,17,894,1370,3,1,3,0,1,0,65.26
臺中縣,后里鄉,聯合村,494,1,950,12,962,1515,3,1,3,0,1,0,63.50
臺中縣,后里鄉,太平村,495,1,580,12,592,904,3,1,3,0,1,0,65.49
臺中縣,后里鄉,太平村,496,1,736,10,746,1114,3,1,3,0,1,0,66.97
臺中縣,后里鄉,眉山村,497,1,919,7,926,1457,3,1,3,0,1,0,63.56
臺中縣,后里鄉,眉山村,498,1,825,10,835,1378,3,1,3,0,1,0,60.60
臺中縣,后里鄉,月眉村,499,1,1002,11,1013,1546,3,1,3,0,1,0,65.52
臺中縣,后里鄉,公館村,500,1,1143,17,1160,1788,3,1,3,0,1,0,64.88
臺中縣,后里鄉,泰安村,501,1,826,12,838,1274,3,1,3,0,1,0,65.78
臺中縣,神岡鄉,神岡村,502,1,800,14,814,1284,3,1,3,0,1,0,63.40
臺中縣,神岡鄉,神岡村,503,1,783,6,789,1272,3,1,3,0,1,0,62.03
臺中縣,神岡鄉,庄前村,504,1,966,4,970,1604,3,1,3,0,1,0,60.47
臺中縣,神岡鄉,北庄村,505,1,600,3,603,950,3,1,3,0,1,0,63.47
臺中縣,神岡鄉,北庄村,506,1,750,16,766,1206,3,1,3,0,1,0,63.52
臺中縣,神岡鄉,庄後村,507,1,734,9,743,1148,3,1,3,0,1,0,64.72
臺中縣,神岡鄉,庄後村,508,1,558,2,560,848,3,1,3,0,1,0,66.04
臺中縣,神岡鄉,圳前村,509,1,773,8,781,1164,3,1,3,0,1,0,67.10
臺中縣,神岡鄉,圳前村,510,1,573,9,582,944,3,1,3,0,1,0,61.65
臺中縣,神岡鄉,圳堵村,511,1,541,8,549,798,3,1,3,0,1,0,68.80
臺中縣,神岡鄉,圳堵村,512,1,670,12,682,1094,3,1,3,0,1,0,62.34
臺中縣,神岡鄉,新庄村,513,1,808,13,821,1198,3,1,3,0,1,0,68.53
臺中縣,神岡鄉,新庄村,514,1,721,7,728,1193,3,1,3,0,1,0,61.02
臺中縣,神岡鄉,新庄村,515,1,652,8,660,1146,3,1,3,0,1,0,57.59
臺中縣,神岡鄉,山皮村,516,1,603,9,612,919,3,1,3,0,1,0,66.59
臺中縣,神岡鄉,社口村,517,1,863,5,868,1423,3,1,3,0,1,0,61.00
臺中縣,神岡鄉,社口村,518,1,724,6,730,1347,3,1,3,0,1,0,54.19
臺中縣,神岡鄉,社口村,519,1,764,10,774,1334,3,1,3,0,1,0,58.02
臺中縣,神岡鄉,社口村,520,1,799,7,806,1339,3,1,3,0,1,0,60.19
臺中縣,神岡鄉,社南村,521,1,790,16,806,1424,3,1,3,0,1,0,56.60
臺中縣,神岡鄉,社南村,522,1,798,10,808,1315,3,1,3,0,1,0,61.44
臺中縣,神岡鄉,社南村,523,1,765,10,775,1373,3,1,3,0,1,0,56.45
臺中縣,神岡鄉,三角村,524,1,809,7,816,1310,3,1,3,0,1,0,62.29
臺中縣,神岡鄉,三角村,525,1,514,6,520,801,3,1,3,0,1,0,64.92
臺中縣,神岡鄉,大社村,526,1,753,11,764,1259,3,1,3,0,1,0,60.68
臺中縣,神岡鄉,大社村,527,1,639,12,651,1192,3,1,3,0,1,0,54.61
臺中縣,神岡鄉,大社村,528,1,385,2,387,815,3,1,3,0,1,0,47.48
臺中縣,神岡鄉,岸裡村,529,1,761,10,771,1286,3,1,3,0,1,0,59.95
臺中縣,神岡鄉,岸裡村,530,1,773,7,780,1295,3,1,3,0,1,0,60.23
臺中縣,神岡鄉,豐洲村,531,1,877,15,892,1552,3,1,3,0,1,0,57.47
臺中縣,神岡鄉,豐洲村,532,1,951,12,963,1658,3,1,3,0,1,0,58.08
臺中縣,神岡鄉,豐洲村,533,1,850,11,861,1557,3,1,3,0,1,0,55.30
臺中縣,神岡鄉,豐洲村,534,1,815,8,823,1446,3,1,3,0,1,0,56.92
臺中縣,神岡鄉,神洲村,535,1,703,10,713,1102,3,1,3,0,1,0,64.70
臺中縣,神岡鄉,神洲村,536,1,705,8,713,1158,3,1,3,0,1,0,61.57
臺中縣,神岡鄉,溪洲村,537,1,858,23,881,1277,3,1,3,0,1,0,68.99
臺中縣,神岡鄉,溪洲村,538,1,803,17,820,1206,3,1,3,0,1,0,67.99
臺中縣,潭子鄉,潭秀村,539,1,849,8,857,1377,3,1,3,0,1,0,62.24
臺中縣,潭子鄉,潭北村,540,1,1221,16,1237,2066,3,1,3,0,1,0,59.87
臺中縣,潭子鄉,潭陽村,541,1,840,3,843,1531,3,1,3,0,1,0,55.06
臺中縣,潭子鄉,潭陽村,542,1,1153,15,1168,2005,3,1,3,0,1,0,58.25
臺中縣,潭子鄉,潭陽村,543,1,931,7,938,1979,3,1,3,0,1,0,47.40
臺中縣,潭子鄉,潭陽村,544,1,1087,11,1098,1951,3,1,3,0,1,0,56.28
臺中縣,潭子鄉,潭陽村,545,1,799,5,804,1292,3,1,3,0,1,0,62.23
臺中縣,潭子鄉,福仁村,546,1,1091,9,1100,1859,3,1,3,0,1,0,59.17
臺中縣,潭子鄉,福仁村,547,1,997,11,1008,2016,3,1,3,0,1,0,50.00
臺中縣,潭子鄉,福仁村,548,1,858,5,863,1598,3,1,3,0,1,0,54.01
臺中縣,潭子鄉,福仁村,549,1,1113,7,1120,1871,3,1,3,0,1,0,59.86
臺中縣,潭子鄉,頭家村,550,1,614,11,625,1013,3,1,3,0,1,0,61.70
臺中縣,潭子鄉,頭家村,551,1,837,5,842,1648,3,1,3,0,1,0,51.09
臺中縣,潭子鄉,頭家村,552,1,480,2,482,861,3,1,3,0,1,0,55.98
臺中縣,潭子鄉,頭家東村,553,1,1012,10,1022,1746,3,1,3,0,1,0,58.53
臺中縣,潭子鄉,頭家東村,554,1,727,6,733,1275,3,1,3,0,1,0,57.49
臺中縣,潭子鄉,家興村,555,1,915,11,926,1940,3,1,3,0,1,0,47.73
臺中縣,潭子鄉,家興村,556,1,1016,7,1023,1892,3,1,3,0,1,0,54.07
臺中縣,潭子鄉,家福村,557,1,872,5,877,1527,3,1,3,0,1,0,57.43
臺中縣,潭子鄉,家福村,558,1,792,12,804,1317,3,1,3,0,1,0,61.05
臺中縣,潭子鄉,甘蔗村,559,1,1289,11,1300,2289,3,1,3,0,1,0,56.79
臺中縣,潭子鄉,甘蔗村,560,1,1184,14,1198,2049,3,1,3,0,1,0,58.47
臺中縣,潭子鄉,甘蔗村,561,1,1172,8,1180,2253,3,1,3,0,1,0,52.37
臺中縣,潭子鄉,東寶村,562,1,714,8,722,1178,3,1,3,0,1,0,61.29
臺中縣,潭子鄉,東寶村,563,1,701,7,708,1127,3,1,3,0,1,0,62.82
臺中縣,潭子鄉,東寶村,564,1,636,11,647,1214,3,1,3,0,1,0,53.29
臺中縣,潭子鄉,東寶村,565,1,1029,14,1043,1764,3,1,3,0,1,0,59.13
臺中縣,潭子鄉,東寶村,566,1,1309,15,1324,2185,3,1,3,0,1,0,60.59
臺中縣,潭子鄉,東寶村,567,1,845,6,851,1429,3,1,3,0,1,0,59.55
臺中縣,潭子鄉,大富村,568,1,1022,10,1032,1783,3,1,3,0,1,0,57.88
臺中縣,潭子鄉,大豐村,569,1,1030,9,1039,1858,3,1,3,0,1,0,55.92
臺中縣,潭子鄉,大豐村,570,1,921,12,933,1669,3,1,3,0,1,0,55.90
臺中縣,潭子鄉,栗林村,571,1,992,8,1000,1644,3,1,3,0,1,0,60.83
臺中縣,潭子鄉,栗林村,572,1,746,10,756,1247,3,1,3,0,1,0,60.63
臺中縣,潭子鄉,栗林村,573,1,721,8,729,1168,3,1,3,0,1,0,62.41
臺中縣,潭子鄉,嘉仁村,574,1,1029,14,1043,1720,3,1,3,0,1,0,60.64
臺中縣,潭子鄉,嘉仁村,575,1,889,9,898,1496,3,1,3,0,1,0,60.03
臺中縣,潭子鄉,新田村,576,1,856,7,863,1422,3,1,3,0,1,0,60.69
臺中縣,潭子鄉,聚興村,577,1,835,9,844,1416,3,1,3,0,1,0,59.60
臺中縣,潭子鄉,聚興村,578,1,814,8,822,1411,3,1,3,0,1,0,58.26
臺中縣,大雅鄉,上雅村,579,1,1087,17,1104,1913,3,1,3,0,1,0,57.71
臺中縣,大雅鄉,上雅村,580,1,1001,24,1025,1847,3,1,3,0,1,0,55.50
臺中縣,大雅鄉,大雅村,581,1,1017,15,1032,1844,3,1,3,0,1,0,55.97
臺中縣,大雅鄉,大雅村,582,1,1065,8,1073,1925,3,1,3,0,1,0,55.74
臺中縣,大雅鄉,文雅村,583,1,847,3,850,1647,3,1,3,0,1,0,51.61
臺中縣,大雅鄉,文雅村,584,1,878,5,883,1515,3,1,3,0,1,0,58.28
臺中縣,大雅鄉,文雅村,585,1,672,7,679,1242,3,1,3,0,1,0,54.67
臺中縣,大雅鄉,三和村,586,1,684,9,693,1281,3,1,3,0,1,0,54.10
臺中縣,大雅鄉,三和村,587,1,686,4,690,1239,3,1,3,0,1,0,55.69
臺中縣,大雅鄉,三和村,588,1,704,6,710,1281,3,1,3,0,1,0,55.43
臺中縣,大雅鄉,二和村,589,1,991,11,1002,1850,3,1,3,0,1,0,54.16
臺中縣,大雅鄉,二和村,590,1,1068,6,1074,1932,3,1,3,0,1,0,55.59
臺中縣,大雅鄉,四德村,591,1,700,3,703,1339,3,1,3,0,1,0,52.50
臺中縣,大雅鄉,四德村,592,1,996,11,1007,1843,3,1,3,0,1,0,54.64
臺中縣,大雅鄉,西寶村,593,1,863,9,872,1496,3,1,3,0,1,0,58.29
臺中縣,大雅鄉,西寶村,594,1,849,18,867,1594,3,1,3,0,1,0,54.39
臺中縣,大雅鄉,上楓村,595,1,997,16,1013,1772,3,1,3,0,1,0,57.17
臺中縣,大雅鄉,上楓村,596,1,935,10,945,1809,3,1,3,0,1,0,52.24
臺中縣,大雅鄉,上楓村,597,1,651,10,661,1309,3,1,3,0,1,0,50.50
臺中縣,大雅鄉,上楓村,598,1,888,11,899,1548,3,1,3,0,1,0,58.07
臺中縣,大雅鄉,上楓村,599,1,829,14,843,1368,3,1,3,0,1,0,61.62
臺中縣,大雅鄉,上楓村,600,1,698,14,712,1222,3,1,3,0,1,0,58.27
臺中縣,大雅鄉,上楓村,601,1,549,4,553,1185,3,1,3,0,1,0,46.67
臺中縣,大雅鄉,員林村,602,1,877,14,891,1440,3,1,3,0,1,0,61.88
臺中縣,大雅鄉,員林村,603,1,956,11,967,1637,3,1,3,0,1,0,59.07
臺中縣,大雅鄉,員林村,604,1,795,3,798,1414,3,1,3,0,1,0,56.44
臺中縣,大雅鄉,員林村,605,1,928,9,937,1635,3,1,3,0,1,0,57.31
臺中縣,大雅鄉,六寶村,606,1,853,11,864,1374,3,1,3,0,1,0,62.88
臺中縣,大雅鄉,六寶村,607,1,839,18,857,1407,3,1,3,0,1,0,60.91
臺中縣,大雅鄉,六寶村,608,1,615,6,621,1103,3,1,3,0,1,0,56.30
臺中縣,大雅鄉,六寶村,609,1,782,14,796,1353,3,1,3,0,1,0,58.83
臺中縣,大雅鄉,秀山村,610,1,1078,13,1091,1656,3,1,3,0,1,0,65.88
臺中縣,大雅鄉,秀山村,611,1,708,7,715,1059,3,1,3,0,1,0,67.52
臺中縣,大雅鄉,橫山村,612,1,1158,23,1181,1803,3,1,3,0,1,0,65.50
臺中縣,大雅鄉,橫山村,613,1,978,15,993,1546,3,1,3,0,1,0,64.23
臺中縣,大雅鄉,忠義村,614,1,1024,3,1027,1559,3,1,3,0,1,0,65.88
臺中縣,大雅鄉,忠義村,615,1,961,10,971,1591,3,1,3,0,1,0,61.03
臺中縣,新社鄉,新社村,616,1,814,3,817,1326,3,1,3,0,1,0,61.61
臺中縣,新社鄉,新社村,617,1,912,9,921,1500,3,1,3,0,1,0,61.40
臺中縣,新社鄉,復盛村,618,1,1017,12,1029,1701,3,1,3,0,1,0,60.49
臺中縣,新社鄉,中正村,619,1,821,7,828,1261,3,1,3,0,1,0,65.66
臺中縣,新社鄉,月湖村,620,1,552,4,556,909,3,1,3,0,1,0,61.17
臺中縣,新社鄉,崑山村,621,1,724,11,735,1185,3,1,3,0,1,0,62.03
臺中縣,新社鄉,大南村,622,1,1192,9,1201,1922,3,1,3,0,1,0,62.49
臺中縣,新社鄉,永源村,623,1,1220,16,1236,1924,3,1,3,0,1,0,64.24
臺中縣,新社鄉,永源村,624,1,485,10,495,701,3,1,3,0,1,0,70.61
臺中縣,新社鄉,中興村,625,1,442,4,446,693,3,1,3,0,1,0,64.36
臺中縣,新社鄉,協成村,626,1,788,7,795,1200,3,1,3,0,1,0,66.25
臺中縣,新社鄉,協成村,627,1,863,7,870,1372,3,1,3,0,1,0,63.41
臺中縣,新社鄉,東興村,628,1,791,3,794,1265,3,1,3,0,1,0,62.77
臺中縣,新社鄉,慶西村,629,1,176,1,177,249,3,1,3,0,1,0,71.08
臺中縣,新社鄉,慶西村,630,1,374,3,377,641,3,1,3,0,1,0,58.81
臺中縣,新社鄉,中和村,631,1,363,2,365,586,3,1,3,0,1,0,62.29
臺中縣,新社鄉,福興村,632,1,629,3,632,1018,3,1,3,0,1,0,62.08
臺中縣,新社鄉,福興村,633,1,153,2,155,256,3,1,3,0,1,0,60.55
臺中縣,石岡鄉,石岡村,634,1,645,12,657,1052,3,1,3,0,1,0,62.45
臺中縣,石岡鄉,萬安村,635,1,729,8,737,1171,3,1,3,0,1,0,62.94
臺中縣,石岡鄉,九房村,636,1,655,16,671,1056,3,1,3,0,1,0,63.54
臺中縣,石岡鄉,金星村,637,1,733,15,748,1219,3,1,3,0,1,0,61.36
臺中縣,石岡鄉,龍興村,638,1,436,11,447,684,3,1,3,0,1,0,65.35
臺中縣,石岡鄉,萬興村,639,1,858,26,884,1386,3,1,3,0,1,0,63.78
臺中縣,石岡鄉,梅子村,640,1,1065,11,1076,1720,3,1,3,0,1,0,62.56
臺中縣,石岡鄉,土牛村,641,1,558,5,563,945,3,1,3,0,1,0,59.58
臺中縣,石岡鄉,德興村,642,1,768,9,777,1274,3,1,3,0,1,0,60.99
臺中縣,石岡鄉,和盛村,643,1,779,1,780,1224,3,1,3,0,1,0,63.73
臺中縣,外埔鄉,永豐村,644,1,632,13,645,991,3,1,3,0,1,0,65.09
臺中縣,外埔鄉,六分村,645,1,942,12,954,1544,3,1,3,0,1,0,61.79
臺中縣,外埔鄉,大同村,646,1,730,5,735,1184,3,1,3,0,1,0,62.08
臺中縣,外埔鄉,大同村,647,1,678,1,679,1146,3,1,3,0,1,0,59.25
臺中縣,外埔鄉,大同村,648,1,711,4,715,1219,3,1,3,0,1,0,58.65
臺中縣,外埔鄉,大東村,649,1,863,9,872,1389,3,1,3,0,1,0,62.78
臺中縣,外埔鄉,大東村,650,1,959,36,995,1644,3,1,3,0,1,0,60.52
臺中縣,外埔鄉,大東村,651,1,917,9,926,1675,3,1,3,0,1,0,55.28
臺中縣,外埔鄉,三崁村,652,1,983,12,995,1703,3,1,3,0,1,0,58.43
臺中縣,外埔鄉,水美村,653,1,943,11,954,1689,3,1,3,0,1,0,56.48
臺中縣,外埔鄉,水美村,654,1,737,9,746,1193,3,1,3,0,1,0,62.53
臺中縣,外埔鄉,鐵山村,655,1,616,8,624,964,3,1,3,0,1,0,64.73
臺中縣,外埔鄉,鐵山村,656,1,658,14,672,1105,3,1,3,0,1,0,60.81
臺中縣,外埔鄉,中山村,657,1,649,9,658,1050,3,1,3,0,1,0,62.67
臺中縣,外埔鄉,馬鳴村,658,1,875,8,883,1342,3,1,3,0,1,0,65.80
臺中縣,外埔鄉,土城村,659,1,1014,13,1027,1543,3,1,3,0,1,0,66.56
臺中縣,外埔鄉,部子村,660,1,738,19,757,1176,3,1,3,0,1,0,64.37
臺中縣,大安鄉,南埔村,661,1,662,6,668,1067,3,1,3,0,1,0,62.61
臺中縣,大安鄉,南庄村,662,1,697,13,710,1106,3,1,3,0,1,0,64.20
臺中縣,大安鄉,中庄村,663,1,668,9,677,1145,3,1,3,0,1,0,59.13
臺中縣,大安鄉,中庄村,664,1,680,8,688,1263,3,1,3,0,1,0,54.47
臺中縣,大安鄉,東安村,665,1,763,6,769,1196,3,1,3,0,1,0,64.30
臺中縣,大安鄉,福興村,666,1,723,12,735,1144,3,1,3,0,1,0,64.25
臺中縣,大安鄉,龜殼村,667,1,635,6,641,846,3,1,3,0,1,0,75.77
臺中縣,大安鄉,龜殼村,668,1,478,6,484,731,3,1,3,0,1,0,66.21
臺中縣,大安鄉,頂安村,669,1,531,4,535,877,3,1,3,0,1,0,61.00
臺中縣,大安鄉,永安村,670,1,666,10,676,1113,3,1,3,0,1,0,60.74
臺中縣,大安鄉,永安村,671,1,352,0,352,518,3,1,3,0,1,0,67.95
臺中縣,大安鄉,福住村,672,1,538,5,543,981,3,1,3,0,1,0,55.35
臺中縣,大安鄉,海墘村,673,1,852,14,866,1370,3,1,3,0,1,0,63.21
臺中縣,大安鄉,西安村,674,1,826,8,834,1379,3,1,3,0,1,0,60.48
臺中縣,大安鄉,松雅村,675,1,565,5,570,778,3,1,3,0,1,0,73.26
臺中縣,烏日鄉,烏日村,676,1,866,7,873,1392,3,1,3,0,1,0,62.72
臺中縣,烏日鄉,烏日村,677,1,926,4,930,1587,3,1,3,0,1,0,58.60
臺中縣,烏日鄉,烏日村,678,1,845,8,853,1386,3,1,3,0,1,0,61.54
臺中縣,烏日鄉,烏日村,679,1,1017,9,1026,1571,3,1,3,0,1,0,65.31
臺中縣,烏日鄉,湖日村,680,1,734,8,742,1156,3,1,3,0,1,0,64.19
臺中縣,烏日鄉,湖日村,681,1,519,4,523,955,3,1,3,0,1,0,54.76
臺中縣,烏日鄉,三和村,682,1,1028,10,1038,1644,3,1,3,0,1,0,63.14
臺中縣,烏日鄉,三和村,683,1,1082,23,1105,1670,3,1,3,0,1,0,66.17
臺中縣,烏日鄉,榮泉村,684,1,1040,13,1053,1476,3,1,3,0,1,0,71.34
臺中縣,烏日鄉,榮泉村,685,1,644,9,653,1065,3,1,3,0,1,0,61.31
臺中縣,烏日鄉,學田村,686,1,607,6,613,1006,3,1,3,0,1,0,60.93
臺中縣,烏日鄉,學田村,687,1,571,7,578,932,3,1,3,0,1,0,62.02
臺中縣,烏日鄉,九德村,688,1,993,8,1001,1776,3,1,3,0,1,0,56.36
臺中縣,烏日鄉,九德村,689,1,1039,9,1048,1719,3,1,3,0,1,0,60.97
臺中縣,烏日鄉,九德村,690,1,851,10,861,1556,3,1,3,0,1,0,55.33
臺中縣,烏日鄉,九德村,691,1,863,7,870,1534,3,1,3,0,1,0,56.71
臺中縣,烏日鄉,九德村,692,1,930,4,934,1517,3,1,3,0,1,0,61.57
臺中縣,烏日鄉,九德村,693,1,788,10,798,1477,3,1,3,0,1,0,54.03
臺中縣,烏日鄉,仁德村,694,1,1017,10,1027,1720,3,1,3,0,1,0,59.71
臺中縣,烏日鄉,仁德村,695,1,962,8,970,1720,3,1,3,0,1,0,56.40
臺中縣,烏日鄉,仁德村,696,1,1110,12,1122,1957,3,1,3,0,1,0,57.33
臺中縣,烏日鄉,前竹村,697,1,658,10,668,1014,3,1,3,0,1,0,65.88
臺中縣,烏日鄉,前竹村,698,1,717,10,727,1059,3,1,3,0,1,0,68.65
臺中縣,烏日鄉,五光村,699,1,988,9,997,1464,3,1,3,0,1,0,68.10
臺中縣,烏日鄉,光明村,700,1,568,6,574,887,3,1,3,0,1,0,64.71
臺中縣,烏日鄉,光明村,701,1,737,4,741,1112,3,1,3,0,1,0,66.64
臺中縣,烏日鄉,東園村,702,1,1113,11,1124,1635,3,1,3,0,1,0,68.75
臺中縣,烏日鄉,溪埧村,703,1,1162,19,1181,1798,3,1,3,0,1,0,65.68
臺中縣,烏日鄉,溪埧村,704,1,1059,18,1077,1854,3,1,3,0,1,0,58.09
臺中縣,烏日鄉,螺潭村,705,1,950,20,970,1495,3,1,3,0,1,0,64.88
臺中縣,烏日鄉,北里村,706,1,864,12,876,1412,3,1,3,0,1,0,62.04
臺中縣,烏日鄉,南里村,707,1,693,8,701,1093,3,1,3,0,1,0,64.14
臺中縣,烏日鄉,溪尾村,708,1,496,6,502,807,3,1,3,0,1,0,62.21
臺中縣,大肚鄉,王田村,709,1,998,3,1001,1571,3,1,3,0,1,0,63.72
臺中縣,大肚鄉,王田村,710,1,721,14,735,1135,3,1,3,0,1,0,64.76
臺中縣,大肚鄉,王田村,711,1,652,6,658,994,3,1,3,0,1,0,66.20
臺中縣,大肚鄉,中和村,712,1,557,4,561,802,3,1,3,0,1,0,69.95
臺中縣,大肚鄉,福山村,713,1,682,5,687,1070,3,1,3,0,1,0,64.21
臺中縣,大肚鄉,福山村,714,1,686,10,696,1110,3,1,3,0,1,0,62.70
臺中縣,大肚鄉,福山村,715,1,665,8,673,1077,3,1,3,0,1,0,62.49
臺中縣,大肚鄉,營埔村,716,1,881,13,894,1292,3,1,3,0,1,0,69.20
臺中縣,大肚鄉,社腳村,717,1,741,19,760,1075,3,1,3,0,1,0,70.70
臺中縣,大肚鄉,社腳村,718,1,729,3,732,1165,3,1,3,0,1,0,62.83
臺中縣,大肚鄉,新興村,719,1,718,5,723,1180,3,1,3,0,1,0,61.27
臺中縣,大肚鄉,新興村,720,1,599,5,604,1064,3,1,3,0,1,0,56.77
臺中縣,大肚鄉,大東村,721,1,786,5,791,1364,3,1,3,0,1,0,57.99
臺中縣,大肚鄉,大東村,722,1,791,4,795,1229,3,1,3,0,1,0,64.69
臺中縣,大肚鄉,大肚村,723,1,538,6,544,820,3,1,3,0,1,0,66.34
臺中縣,大肚鄉,大肚村,724,1,661,5,666,1001,3,1,3,0,1,0,66.53
臺中縣,大肚鄉,永和村,725,1,529,8,537,832,3,1,3,0,1,0,64.54
臺中縣,大肚鄉,磺溪村,726,1,922,12,934,1336,3,1,3,0,1,0,69.91
臺中縣,大肚鄉,永順村,727,1,1013,10,1023,1471,3,1,3,0,1,0,69.54
臺中縣,大肚鄉,成功村,728,1,608,9,617,885,3,1,3,0,1,0,69.72
臺中縣,大肚鄉,山陽村,729,1,842,8,850,1324,3,1,3,0,1,0,64.20
臺中縣,大肚鄉,頂街村,730,1,969,13,982,1576,3,1,3,0,1,0,62.31
臺中縣,大肚鄉,頂街村,731,1,956,11,967,1669,3,1,3,0,1,0,57.94
臺中縣,大肚鄉,頂街村,732,1,1016,5,1021,1707,3,1,3,0,1,0,59.81
臺中縣,大肚鄉,瑞井村,733,1,911,5,916,1323,3,1,3,0,1,0,69.24
臺中縣,大肚鄉,瑞井村,734,1,828,11,839,1365,3,1,3,0,1,0,61.47
臺中縣,大肚鄉,瑞井村,735,1,642,16,658,1132,3,1,3,0,1,0,58.13
臺中縣,大肚鄉,蔗部村,736,1,724,7,731,1263,3,1,3,0,1,0,57.88
臺中縣,大肚鄉,蔗部村,737,1,683,14,697,1197,3,1,3,0,1,0,58.23
臺中縣,大肚鄉,蔗部村,738,1,536,7,543,1001,3,1,3,0,1,0,54.25
臺中縣,大肚鄉,自強村,739,1,938,16,954,1558,3,1,3,0,1,0,61.23
臺中縣,大肚鄉,自強村,740,1,899,10,909,1386,3,1,3,0,1,0,65.58
臺中縣,龍井鄉,竹坑村,741,1,789,7,796,1327,3,1,3,0,1,0,59.98
臺中縣,龍井鄉,竹坑村,742,1,583,6,589,945,3,1,3,0,1,0,62.33
臺中縣,龍井鄉,龍東村,743,1,758,3,761,1256,3,1,3,0,1,0,60.59
臺中縣,龍井鄉,龍東村,744,1,664,7,671,1147,3,1,3,0,1,0,58.50
臺中縣,龍井鄉,龍西村,745,1,1062,14,1076,1612,3,1,3,0,1,0,66.75
臺中縣,龍井鄉,田中村,746,1,833,12,845,1378,3,1,3,0,1,0,61.32
臺中縣,龍井鄉,田中村,747,1,701,6,707,1225,3,1,3,0,1,0,57.71
臺中縣,龍井鄉,福田村,748,1,639,6,645,994,3,1,3,0,1,0,64.89
臺中縣,龍井鄉,麗水村,749,1,807,5,812,1149,3,1,3,0,1,0,70.67
臺中縣,龍井鄉,麗水村,750,1,566,6,572,824,3,1,3,0,1,0,69.42
臺中縣,龍井鄉,龍津村,751,1,896,7,903,1447,3,1,3,0,1,0,62.40
臺中縣,龍井鄉,龍津村,752,1,657,5,662,1006,3,1,3,0,1,0,65.81
臺中縣,龍井鄉,龍津村,753,1,655,11,666,1014,3,1,3,0,1,0,65.68
臺中縣,龍井鄉,龍津村,754,1,562,6,568,850,3,1,3,0,1,0,66.82
臺中縣,龍井鄉,三德村,755,1,875,6,881,1451,3,1,3,0,1,0,60.72
臺中縣,龍井鄉,三德村,756,1,623,31,654,1087,3,1,3,0,1,0,60.17
臺中縣,龍井鄉,忠和村,757,1,753,6,759,1195,3,1,3,0,1,0,63.51
臺中縣,龍井鄉,忠和村,758,1,882,7,889,1397,3,1,3,0,1,0,63.64
臺中縣,龍井鄉,忠和村,759,1,833,17,850,1325,3,1,3,0,1,0,64.15
臺中縣,龍井鄉,山腳村,760,1,703,4,707,1293,3,1,3,0,1,0,54.68
臺中縣,龍井鄉,山腳村,761,1,679,7,686,1261,3,1,3,0,1,0,54.40
臺中縣,龍井鄉,山腳村,762,1,850,8,858,1379,3,1,3,0,1,0,62.22
臺中縣,龍井鄉,龍泉村,763,1,685,8,693,1192,3,1,3,0,1,0,58.14
臺中縣,龍井鄉,龍泉村,764,1,717,14,731,1316,3,1,3,0,1,0,55.55
臺中縣,龍井鄉,龍泉村,765,1,678,2,680,1143,3,1,3,0,1,0,59.49
臺中縣,龍井鄉,龍泉村,766,1,484,6,490,802,3,1,3,0,1,0,61.10
臺中縣,龍井鄉,龍崗村,767,1,682,7,689,1269,3,1,3,0,1,0,54.29
臺中縣,龍井鄉,龍崗村,768,1,506,8,514,790,3,1,3,0,1,0,65.06
臺中縣,龍井鄉,新庄村,769,1,861,7,868,1499,3,1,3,0,1,0,57.91
臺中縣,龍井鄉,新庄村,770,1,861,10,871,1542,3,1,3,0,1,0,56.49
臺中縣,龍井鄉,新庄村,771,1,913,7,920,1616,3,1,3,0,1,0,56.93
臺中縣,龍井鄉,南寮村,772,1,900,8,908,1364,3,1,3,0,1,0,66.57
臺中縣,龍井鄉,東海村,773,1,762,6,768,1459,3,1,3,0,1,0,52.64
臺中縣,龍井鄉,東海村,774,1,783,5,788,1451,3,1,3,0,1,0,54.31
臺中縣,龍井鄉,東海村,775,1,802,7,809,1404,3,1,3,0,1,0,57.62
臺中縣,龍井鄉,東海村,776,1,698,6,704,1295,3,1,3,0,1,0,54.36
臺中縣,龍井鄉,新東村,777,1,881,14,895,1569,3,1,3,0,1,0,57.04
臺中縣,龍井鄉,新東村,778,1,867,2,869,1632,3,1,3,0,1,0,53.25
臺中縣,霧峰鄉,桐林村,779,1,732,7,739,1121,3,1,3,0,1,0,65.92
臺中縣,霧峰鄉,吉峰村,780,1,955,14,969,1719,3,1,3,0,1,0,56.37
臺中縣,霧峰鄉,吉峰村,781,1,880,7,887,1491,3,1,3,0,1,0,59.49
臺中縣,霧峰鄉,吉峰村,782,1,755,10,765,1251,3,1,3,0,1,0,61.15
臺中縣,霧峰鄉,吉峰村,783,1,820,5,825,1525,3,1,3,0,1,0,54.10
臺中縣,霧峰鄉,吉峰村,784,1,849,10,859,1490,3,1,3,0,1,0,57.65
臺中縣,霧峰鄉,甲寅村,785,1,902,8,910,1450,3,1,3,0,1,0,62.76
臺中縣,霧峰鄉,甲寅村,786,1,766,10,776,1420,3,1,3,0,1,0,54.65
臺中縣,霧峰鄉,甲寅村,787,1,636,9,645,1120,3,1,3,0,1,0,57.59
臺中縣,霧峰鄉,本鄉村,788,1,1158,14,1172,1809,3,1,3,0,1,0,64.79
臺中縣,霧峰鄉,中正村,789,1,1027,9,1036,1586,3,1,3,0,1,0,65.32
臺中縣,霧峰鄉,錦榮村,790,1,583,8,591,937,3,1,3,0,1,0,63.07
臺中縣,霧峰鄉,萊園村,791,1,653,4,657,1077,3,1,3,0,1,0,61.00
臺中縣,霧峰鄉,本堂村,792,1,975,5,980,1640,3,1,3,0,1,0,59.76
臺中縣,霧峰鄉,本堂村,793,1,965,14,979,1767,3,1,3,0,1,0,55.40
臺中縣,霧峰鄉,本堂村,794,1,882,11,893,1459,3,1,3,0,1,0,61.21
臺中縣,霧峰鄉,北柳村,795,1,893,10,903,1497,3,1,3,0,1,0,60.32
臺中縣,霧峰鄉,北柳村,796,1,970,9,979,1576,3,1,3,0,1,0,62.12
臺中縣,霧峰鄉,南柳村,797,1,896,12,908,1458,3,1,3,0,1,0,62.28
臺中縣,霧峰鄉,四德村,798,1,618,5,623,1019,3,1,3,0,1,0,61.14
臺中縣,霧峰鄉,四德村,799,1,623,4,627,981,3,1,3,0,1,0,63.91
臺中縣,霧峰鄉,五福村,800,1,800,11,811,1160,3,1,3,0,1,0,69.91
臺中縣,霧峰鄉,五福村,801,1,793,12,805,1228,3,1,3,0,1,0,65.55
臺中縣,霧峰鄉,丁臺村,802,1,708,6,714,1040,3,1,3,0,1,0,68.65
臺中縣,霧峰鄉,丁臺村,803,1,528,6,534,942,3,1,3,0,1,0,56.69
臺中縣,霧峰鄉,北勢村,804,1,1038,14,1052,1685,3,1,3,0,1,0,62.43
臺中縣,霧峰鄉,南勢村,805,1,721,6,727,1163,3,1,3,0,1,0,62.51
臺中縣,霧峰鄉,萬豐村,806,1,760,16,776,1239,3,1,3,0,1,0,62.63
臺中縣,霧峰鄉,萬豐村,807,1,703,7,710,1161,3,1,3,0,1,0,61.15
臺中縣,霧峰鄉,舊正村,808,1,698,4,702,1051,3,1,3,0,1,0,66.79
臺中縣,霧峰鄉,舊正村,809,1,538,13,551,916,3,1,3,0,1,0,60.15
臺中縣,霧峰鄉,坑口村,810,1,693,8,701,1029,3,1,3,0,1,0,68.12
臺中縣,霧峰鄉,坑口村,811,1,564,7,571,940,3,1,3,0,1,0,60.74
臺中縣,霧峰鄉,坑口村,812,1,569,2,571,881,3,1,3,0,1,0,64.81
臺中縣,霧峰鄉,峰谷村,813,1,650,2,652,1039,3,1,3,0,1,0,62.75
臺中縣,霧峰鄉,六股村,814,1,823,20,843,1247,3,1,3,0,1,0,67.60
臺中縣,霧峰鄉,六股村,815,1,624,10,634,951,3,1,3,0,1,0,66.67
臺中縣,和平鄉,南勢村,816,1,538,4,542,872,3,1,3,0,1,0,62.16
臺中縣,和平鄉,南勢村,817,1,313,1,314,533,3,1,3,0,1,0,58.91
臺中縣,和平鄉,天輪村,818,1,249,1,250,459,3,1,3,0,1,0,54.47
臺中縣,和平鄉,博愛村,819,1,354,5,359,625,3,1,3,0,1,0,57.44
臺中縣,和平鄉,博愛村,820,1,226,2,228,406,3,1,3,0,1,0,56.16
臺中縣,和平鄉,自由村,821,1,60,0,60,105,3,1,3,0,1,0,57.14
臺中縣,和平鄉,自由村,822,1,56,0,56,121,3,1,3,0,1,0,46.28
臺中縣,和平鄉,自由村,823,1,163,1,164,300,3,1,3,0,1,0,54.67
臺中縣,和平鄉,達觀村,824,1,226,1,227,429,3,1,3,0,1,0,52.91
臺中縣,和平鄉,達觀村,825,1,68,0,68,112,3,1,3,0,1,0,60.71
臺中縣,和平鄉,中坑村,826,1,226,1,227,371,3,1,3,0,1,0,61.19
臺中縣,和平鄉,梨山村,827,1,64,1,65,190,3,1,3,0,1,0,34.21
臺中縣,和平鄉,梨山村,828,1,319,2,321,789,3,1,3,0,1,0,40.68
臺中縣,和平鄉,梨山村,829,1,64,0,64,232,3,1,3,0,1,0,27.59
臺中縣,和平鄉,梨山村,830,1,27,0,27,93,3,1,3,0,1,0,29.03
臺中縣,和平鄉,平等村,831,1,68,0,68,190,3,1,3,0,1,0,35.79
臺中縣,和平鄉,平等村,832,1,76,0,76,183,3,1,3,0,1,0,41.53
彰化縣,彰化市,桃源里,1,1,811,7,818,1257,3,1,3,0,1,0,65.08
彰化縣,彰化市,桃源里,2,1,952,8,960,1477,3,1,3,0,1,0,65.00
彰化縣,彰化市,東興里,3,1,1045,7,1052,1591,3,1,3,0,1,0,66.12
彰化縣,彰化市,華北里,4,1,957,6,963,1519,3,1,3,0,1,0,63.40
彰化縣,彰化市,華陽里,5,1,659,7,666,973,3,1,3,0,1,0,68.45
彰化縣,彰化市,華陽里,6,1,698,2,700,1087,3,1,3,0,1,0,64.40
彰化縣,彰化市,大同里,7,1,692,6,698,1002,3,1,3,0,1,0,69.66
彰化縣,彰化市,永生里,8,1,1001,11,1012,1381,3,1,3,0,1,0,73.28
彰化縣,彰化市,卦山里,9,1,695,5,700,1032,3,1,3,0,1,0,67.83
彰化縣,彰化市,卦山里,10,1,810,9,819,1312,3,1,3,0,1,0,62.42
彰化縣,彰化市,光復里,11,1,493,6,499,758,3,1,3,0,1,0,65.83
彰化縣,彰化市,永福里,12,1,623,8,631,930,3,1,3,0,1,0,67.85
彰化縣,彰化市,光華里,13,1,533,0,533,799,3,1,3,0,1,0,66.71
彰化縣,彰化市,中正里,14,1,910,14,924,1423,3,1,3,0,1,0,64.93
彰化縣,彰化市,中山里,15,1,508,6,514,792,3,1,3,0,1,0,64.90
彰化縣,彰化市,龍山里,16,1,700,2,702,1102,3,1,3,0,1,0,63.70
彰化縣,彰化市,龍山里,17,1,760,5,765,1130,3,1,3,0,1,0,67.70
彰化縣,彰化市,建寶里,18,1,744,6,750,1048,3,1,3,0,1,0,71.56
彰化縣,彰化市,建寶里,19,1,880,3,883,1275,3,1,3,0,1,0,69.25
彰化縣,彰化市,光南里,20,1,1000,13,1013,1397,3,1,3,0,1,0,72.51
彰化縣,彰化市,介壽里,21,1,706,8,714,999,3,1,3,0,1,0,71.47
彰化縣,彰化市,介壽里,22,1,582,9,591,1145,3,1,3,0,1,0,51.62
彰化縣,彰化市,延平里,23,1,957,8,965,1527,3,1,3,0,1,0,63.20
彰化縣,彰化市,延平里,24,1,1008,13,1021,1646,3,1,3,0,1,0,62.03
彰化縣,彰化市,延平里,25,1,1013,8,1021,1568,3,1,3,0,1,0,65.11
彰化縣,彰化市,延平里,26,1,940,7,947,1507,3,1,3,0,1,0,62.84
彰化縣,彰化市,延和里,27,1,1220,10,1230,1812,3,1,3,0,1,0,67.88
彰化縣,彰化市,延和里,28,1,1265,12,1277,1817,3,1,3,0,1,0,70.28
彰化縣,彰化市,南興里,29,1,1135,5,1140,1773,3,1,3,0,1,0,64.30
彰化縣,彰化市,南興里,30,1,1078,8,1086,1741,3,1,3,0,1,0,62.38
彰化縣,彰化市,南興里,31,1,1132,11,1143,1741,3,1,3,0,1,0,65.65
彰化縣,彰化市,南瑤里,32,1,1089,7,1096,1585,3,1,3,0,1,0,69.15
彰化縣,彰化市,南瑤里,33,1,1069,9,1078,1725,3,1,3,0,1,0,62.49
彰化縣,彰化市,南瑤里,34,1,994,8,1002,1675,3,1,3,0,1,0,59.82
彰化縣,彰化市,南瑤里,35,1,952,22,974,1527,3,1,3,0,1,0,63.79
彰化縣,彰化市,成功里,36,1,1012,9,1021,1500,3,1,3,0,1,0,68.07
彰化縣,彰化市,福安里,37,1,746,6,752,1062,3,1,3,0,1,0,70.81
彰化縣,彰化市,西安里,38,1,968,6,974,1355,3,1,3,0,1,0,71.88
彰化縣,彰化市,西安里,39,1,922,17,939,1428,3,1,3,0,1,0,65.76
彰化縣,彰化市,彰安里,40,1,952,7,959,1458,3,1,3,0,1,0,65.78
彰化縣,彰化市,彰安里,41,1,1044,9,1053,1609,3,1,3,0,1,0,65.44
彰化縣,彰化市,中央里,42,1,626,6,632,884,3,1,3,0,1,0,71.49
彰化縣,彰化市,富貴里,43,1,647,6,653,972,3,1,3,0,1,0,67.18
彰化縣,彰化市,民權里,44,1,839,13,852,1198,3,1,3,0,1,0,71.12
彰化縣,彰化市,萬壽里,45,1,657,7,664,968,3,1,3,0,1,0,68.60
彰化縣,彰化市,西興里,46,1,615,8,623,892,3,1,3,0,1,0,69.84
彰化縣,彰化市,西興里,47,1,1027,10,1037,1577,3,1,3,0,1,0,65.76
彰化縣,彰化市,長樂里,48,1,845,7,852,1229,3,1,3,0,1,0,69.32
彰化縣,彰化市,西勢里,49,1,878,7,885,1302,3,1,3,0,1,0,67.97
彰化縣,彰化市,西勢里,50,1,932,12,944,1360,3,1,3,0,1,0,69.41
彰化縣,彰化市,忠權里,51,1,838,8,846,1316,3,1,3,0,1,0,64.29
彰化縣,彰化市,忠權里,52,1,945,8,953,1453,3,1,3,0,1,0,65.59
彰化縣,彰化市,忠孝里,53,1,777,10,787,1178,3,1,3,0,1,0,66.81
彰化縣,彰化市,五權里,54,1,1073,12,1085,1712,3,1,3,0,1,0,63.38
彰化縣,彰化市,五權里,55,1,992,10,1002,1615,3,1,3,0,1,0,62.04
彰化縣,彰化市,平和里,56,1,1088,10,1098,1685,3,1,3,0,1,0,65.16
彰化縣,彰化市,平和里,57,1,1161,8,1169,1854,3,1,3,0,1,0,63.05
彰化縣,彰化市,崙平里,58,1,1030,16,1046,1516,3,1,3,0,1,0,69.00
彰化縣,彰化市,崙平里,59,1,852,8,860,1298,3,1,3,0,1,0,66.26
彰化縣,彰化市,崙平里,60,1,1040,7,1047,1654,3,1,3,0,1,0,63.30
彰化縣,彰化市,向陽里,61,1,1116,5,1121,1664,3,1,3,0,1,0,67.37
彰化縣,彰化市,向陽里,62,1,880,14,894,1384,3,1,3,0,1,0,64.60
彰化縣,彰化市,莿桐里,63,1,819,5,824,1213,3,1,3,0,1,0,67.93
彰化縣,彰化市,莿桐里,64,1,855,12,867,1298,3,1,3,0,1,0,66.80
彰化縣,彰化市,南美里,65,1,1056,14,1070,1511,3,1,3,0,1,0,70.81
彰化縣,彰化市,南安里,66,1,1173,7,1180,1781,3,1,3,0,1,0,66.25
彰化縣,彰化市,東芳里,67,1,894,7,901,1279,3,1,3,0,1,0,70.45
彰化縣,彰化市,東芳里,68,1,1024,15,1039,1576,3,1,3,0,1,0,65.93
彰化縣,彰化市,磚窯里,69,1,772,8,780,1232,3,1,3,0,1,0,63.31
彰化縣,彰化市,磚窯里,70,1,1043,15,1058,1515,3,1,3,0,1,0,69.83
彰化縣,彰化市,新興里,71,1,818,10,828,1213,3,1,3,0,1,0,68.26
彰化縣,彰化市,新興里,72,1,980,12,992,1504,3,1,3,0,1,0,65.96
彰化縣,彰化市,新興里,73,1,794,16,810,1281,3,1,3,0,1,0,63.23
彰化縣,彰化市,新華里,74,1,544,5,549,843,3,1,3,0,1,0,65.12
彰化縣,彰化市,新華里,75,1,627,6,633,949,3,1,3,0,1,0,66.70
彰化縣,彰化市,興北里,76,1,1019,9,1028,1589,3,1,3,0,1,0,64.69
彰化縣,彰化市,信義里,77,1,641,8,649,951,3,1,3,0,1,0,68.24
彰化縣,彰化市,民生里,78,1,964,9,973,1496,3,1,3,0,1,0,65.04
彰化縣,彰化市,文化里,79,1,940,5,945,1445,3,1,3,0,1,0,65.40
彰化縣,彰化市,陽明里,80,1,585,3,588,823,3,1,3,0,1,0,71.45
彰化縣,彰化市,陽明里,81,1,587,4,591,904,3,1,3,0,1,0,65.38
彰化縣,彰化市,萬安里,82,1,1221,5,1226,1803,3,1,3,0,1,0,68.00
彰化縣,彰化市,萬安里,83,1,1281,12,1293,1977,3,1,3,0,1,0,65.40
彰化縣,彰化市,下部里,84,1,1277,13,1290,1907,3,1,3,0,1,0,67.65
彰化縣,彰化市,下部里,85,1,1222,3,1225,1840,3,1,3,0,1,0,66.58
彰化縣,彰化市,茄苳里,86,1,580,9,589,818,3,1,3,0,1,0,72.00
彰化縣,彰化市,茄南里,87,1,832,7,839,1169,3,1,3,0,1,0,71.77
彰化縣,彰化市,茄南里,88,1,733,3,736,1055,3,1,3,0,1,0,69.76
彰化縣,彰化市,寶部里,89,1,746,6,752,1042,3,1,3,0,1,0,72.17
彰化縣,彰化市,古夷里,90,1,699,10,709,1061,3,1,3,0,1,0,66.82
彰化縣,彰化市,古夷里,91,1,758,6,764,1197,3,1,3,0,1,0,63.83
彰化縣,彰化市,阿夷里,92,1,1107,8,1115,1787,3,1,3,0,1,0,62.40
彰化縣,彰化市,阿夷里,93,1,1370,25,1395,2082,3,1,3,0,1,0,67.00
彰化縣,彰化市,阿夷里,94,1,1246,12,1258,1959,3,1,3,0,1,0,64.22
彰化縣,彰化市,和調里,95,1,669,15,684,1070,3,1,3,0,1,0,63.93
彰化縣,彰化市,和調里,96,1,769,2,771,1218,3,1,3,0,1,0,63.30
彰化縣,彰化市,復興里,97,1,1152,15,1167,1774,3,1,3,0,1,0,65.78
彰化縣,彰化市,復興里,98,1,1056,6,1062,1564,3,1,3,0,1,0,67.90
彰化縣,彰化市,復興里,99,1,441,8,449,644,3,1,3,0,1,0,69.72
彰化縣,彰化市,中庄里,100,1,803,15,818,1227,3,1,3,0,1,0,66.67
彰化縣,彰化市,中庄里,101,1,586,4,590,918,3,1,3,0,1,0,64.27
彰化縣,彰化市,竹中里,102,1,1065,18,1083,1631,3,1,3,0,1,0,66.40
彰化縣,彰化市,香山里,103,1,981,11,992,1540,3,1,3,0,1,0,64.42
彰化縣,彰化市,香山里,104,1,802,8,810,1086,3,1,3,0,1,0,74.59
彰化縣,彰化市,牛埔里,105,1,1153,13,1166,1613,3,1,3,0,1,0,72.29
彰化縣,彰化市,牛埔里,106,1,840,5,845,1207,3,1,3,0,1,0,70.01
彰化縣,彰化市,台鳳里,107,1,1292,8,1300,2059,3,1,3,0,1,0,63.14
彰化縣,彰化市,台鳳里,108,1,1029,9,1038,1595,3,1,3,0,1,0,65.08
彰化縣,彰化市,國聖里,109,1,966,5,971,1385,3,1,3,0,1,0,70.11
彰化縣,彰化市,國聖里,110,1,661,7,668,857,3,1,3,0,1,0,77.95
彰化縣,彰化市,福山里,111,1,876,16,892,1339,3,1,3,0,1,0,66.62
彰化縣,彰化市,福山里,112,1,969,13,982,1534,3,1,3,0,1,0,64.02
彰化縣,彰化市,福山里,113,1,953,6,959,1570,3,1,3,0,1,0,61.08
彰化縣,彰化市,福山里,114,1,963,8,971,1568,3,1,3,0,1,0,61.93
彰化縣,彰化市,安溪里,115,1,716,26,742,1109,3,1,3,0,1,0,66.91
彰化縣,彰化市,三村里,116,1,731,4,735,987,3,1,3,0,1,0,74.47
彰化縣,彰化市,大竹里,117,1,826,8,834,1210,3,1,3,0,1,0,68.93
彰化縣,彰化市,大竹里,118,1,995,12,1007,1509,3,1,3,0,1,0,66.73
彰化縣,彰化市,田中里,119,1,652,3,655,803,3,1,3,0,1,0,81.57
彰化縣,彰化市,快官里,120,1,686,7,693,993,3,1,3,0,1,0,69.79
彰化縣,彰化市,竹巷里,121,1,570,3,573,782,3,1,3,0,1,0,73.27
彰化縣,彰化市,福田里,122,1,882,6,888,1201,3,1,3,0,1,0,73.94
彰化縣,彰化市,石牌里,123,1,812,12,824,1133,3,1,3,0,1,0,72.73
彰化縣,花壇鄉,花壇村,124,1,819,7,826,1199,3,1,3,0,1,0,68.89
彰化縣,花壇鄉,花壇村,125,1,1178,5,1183,1606,3,1,3,0,1,0,73.66
彰化縣,花壇鄉,金墩村,126,1,1124,15,1139,1611,3,1,3,0,1,0,70.70
彰化縣,花壇鄉,中庄村,127,1,631,4,635,943,3,1,3,0,1,0,67.34
彰化縣,花壇鄉,中庄村,128,1,880,10,890,1273,3,1,3,0,1,0,69.91
彰化縣,花壇鄉,劉厝村,129,1,712,11,723,1015,3,1,3,0,1,0,71.23
彰化縣,花壇鄉,崙雅村,130,1,964,9,973,1332,3,1,3,0,1,0,73.05
彰化縣,花壇鄉,南口村,131,1,1018,15,1033,1472,3,1,3,0,1,0,70.18
彰化縣,花壇鄉,中口村,132,1,498,2,500,681,3,1,3,0,1,0,73.42
彰化縣,花壇鄉,北口村,133,1,653,6,659,894,3,1,3,0,1,0,73.71
彰化縣,花壇鄉,北口村,134,1,491,5,496,674,3,1,3,0,1,0,73.59
彰化縣,花壇鄉,長沙村,135,1,870,12,882,1227,3,1,3,0,1,0,71.88
彰化縣,花壇鄉,長沙村,136,1,943,10,953,1383,3,1,3,0,1,0,68.91
彰化縣,花壇鄉,長沙村,137,1,912,8,920,1347,3,1,3,0,1,0,68.30
彰化縣,花壇鄉,文德村,138,1,831,10,841,1239,3,1,3,0,1,0,67.88
彰化縣,花壇鄉,文德村,139,1,730,9,739,1110,3,1,3,0,1,0,66.58
彰化縣,花壇鄉,白沙村,140,1,1092,12,1104,1625,3,1,3,0,1,0,67.94
彰化縣,花壇鄉,白沙村,141,1,1289,11,1300,2069,3,1,3,0,1,0,62.83
彰化縣,花壇鄉,岩竹村,142,1,900,10,910,1299,3,1,3,0,1,0,70.05
彰化縣,花壇鄉,橋頭村,143,1,1173,11,1184,1849,3,1,3,0,1,0,64.03
彰化縣,花壇鄉,橋頭村,144,1,771,17,788,1095,3,1,3,0,1,0,71.96
彰化縣,花壇鄉,灣雅村,145,1,561,5,566,832,3,1,3,0,1,0,68.03
彰化縣,花壇鄉,灣東村,146,1,592,5,597,952,3,1,3,0,1,0,62.71
彰化縣,花壇鄉,三春村,147,1,1026,7,1033,1623,3,1,3,0,1,0,63.65
彰化縣,花壇鄉,永春村,148,1,882,9,891,1472,3,1,3,0,1,0,60.53
彰化縣,花壇鄉,長春村,149,1,953,8,961,1460,3,1,3,0,1,0,65.82
彰化縣,芬園鄉,舊社村,150,1,1201,21,1222,1692,3,1,3,0,1,0,72.22
彰化縣,芬園鄉,大埔村,151,1,981,12,993,1339,3,1,3,0,1,0,74.16
彰化縣,芬園鄉,竹林村,152,1,1155,23,1178,1616,3,1,3,0,1,0,72.90
彰化縣,芬園鄉,楓坑村,153,1,429,3,432,561,3,1,3,0,1,0,77.01
彰化縣,芬園鄉,社口村,154,1,804,7,811,1102,3,1,3,0,1,0,73.59
彰化縣,芬園鄉,社口村,155,1,804,9,813,1149,3,1,3,0,1,0,70.76
彰化縣,芬園鄉,茄荖村,156,1,726,11,737,1140,3,1,3,0,1,0,64.65
彰化縣,芬園鄉,茄荖村,157,1,747,12,759,1038,3,1,3,0,1,0,73.12
彰化縣,芬園鄉,嘉興村,158,1,1045,24,1069,1539,3,1,3,0,1,0,69.46
彰化縣,芬園鄉,芬園村,159,1,621,19,640,887,3,1,3,0,1,0,72.15
彰化縣,芬園鄉,進芬村,160,1,673,9,682,937,3,1,3,0,1,0,72.79
彰化縣,芬園鄉,縣庄村,161,1,726,9,735,1054,3,1,3,0,1,0,69.73
彰化縣,芬園鄉,圳墘村,162,1,468,5,473,672,3,1,3,0,1,0,70.39
彰化縣,芬園鄉,溪頭村,163,1,1036,11,1047,1470,3,1,3,0,1,0,71.22
彰化縣,芬園鄉,同安村,164,1,871,9,880,1240,3,1,3,0,1,0,70.97
彰化縣,芬園鄉,中崙村,165,1,651,8,659,973,3,1,3,0,1,0,67.73
彰化縣,芬園鄉,大竹村,166,1,678,10,688,1046,3,1,3,0,1,0,65.77
彰化縣,鹿港鎮,大有里,167,1,805,7,812,1167,3,1,3,0,1,0,69.58
彰化縣,鹿港鎮,中興里,168,1,373,4,377,556,3,1,3,0,1,0,67.81
彰化縣,鹿港鎮,洛津里,169,1,662,7,669,976,3,1,3,0,1,0,68.55
彰化縣,鹿港鎮,順興里,170,1,611,6,617,856,3,1,3,0,1,0,72.08
彰化縣,鹿港鎮,菜園里,171,1,679,6,685,978,3,1,3,0,1,0,70.04
彰化縣,鹿港鎮,街尾里,172,1,1265,14,1279,1919,3,1,3,0,1,0,66.65
彰化縣,鹿港鎮,泰興里,173,1,761,15,776,1176,3,1,3,0,1,0,65.99
彰化縣,鹿港鎮,長興里,174,1,209,2,211,322,3,1,3,0,1,0,65.53
彰化縣,鹿港鎮,興化里,175,1,497,5,502,648,3,1,3,0,1,0,77.47
彰化縣,鹿港鎮,龍山里,176,1,548,4,552,753,3,1,3,0,1,0,73.31
彰化縣,鹿港鎮,景福里,177,1,824,15,839,1125,3,1,3,0,1,0,74.58
彰化縣,鹿港鎮,郭厝里,178,1,398,4,402,595,3,1,3,0,1,0,67.56
彰化縣,鹿港鎮,新宮里,179,1,665,1,666,925,3,1,3,0,1,0,72.00
彰化縣,鹿港鎮,玉順里,180,1,864,11,875,1268,3,1,3,0,1,0,69.01
彰化縣,鹿港鎮,東石里,181,1,1002,13,1015,1513,3,1,3,0,1,0,67.09
彰化縣,鹿港鎮,東石里,182,1,1260,3,1263,1844,3,1,3,0,1,0,68.49
彰化縣,鹿港鎮,永安里,183,1,1222,10,1232,1804,3,1,3,0,1,0,68.29
彰化縣,鹿港鎮,永安里,184,1,1330,8,1338,1914,3,1,3,0,1,0,69.91
彰化縣,鹿港鎮,埔崙里,185,1,1120,13,1133,1747,3,1,3,0,1,0,64.85
彰化縣,鹿港鎮,埔崙里,186,1,1090,11,1101,1638,3,1,3,0,1,0,67.22
彰化縣,鹿港鎮,頂厝里,187,1,1318,13,1331,1950,3,1,3,0,1,0,68.26
彰化縣,鹿港鎮,頂厝里,188,1,1100,13,1113,1571,3,1,3,0,1,0,70.85
彰化縣,鹿港鎮,頂厝里,189,1,1399,12,1411,2013,3,1,3,0,1,0,70.09
彰化縣,鹿港鎮,東崎里,190,1,1280,15,1295,1824,3,1,3,0,1,0,71.00
彰化縣,鹿港鎮,東崎里,191,1,851,12,863,1259,3,1,3,0,1,0,68.55
彰化縣,鹿港鎮,東崎里,192,1,647,5,652,1119,3,1,3,0,1,0,58.27
彰化縣,鹿港鎮,廖厝里,193,1,1007,8,1015,1493,3,1,3,0,1,0,67.98
彰化縣,鹿港鎮,廖厝里,194,1,1264,21,1285,1694,3,1,3,0,1,0,75.86
彰化縣,鹿港鎮,詔安里,195,1,1142,14,1156,1651,3,1,3,0,1,0,70.02
彰化縣,鹿港鎮,海埔里,196,1,1100,14,1114,1508,3,1,3,0,1,0,73.87
彰化縣,鹿港鎮,海埔里,197,1,1004,10,1014,1397,3,1,3,0,1,0,72.58
彰化縣,鹿港鎮,洋厝里,198,1,636,3,639,879,3,1,3,0,1,0,72.70
彰化縣,鹿港鎮,洋厝里,199,1,1051,8,1059,1454,3,1,3,0,1,0,72.83
彰化縣,鹿港鎮,草中里,200,1,966,8,974,1390,3,1,3,0,1,0,70.07
彰化縣,鹿港鎮,草中里,201,1,1057,13,1070,1483,3,1,3,0,1,0,72.15
彰化縣,鹿港鎮,山崙里,202,1,726,8,734,1016,3,1,3,0,1,0,72.24
彰化縣,鹿港鎮,山崙里,203,1,1373,13,1386,1871,3,1,3,0,1,0,74.08
彰化縣,鹿港鎮,頭南里,204,1,1260,17,1277,1807,3,1,3,0,1,0,70.67
彰化縣,鹿港鎮,頭崙里,205,1,1026,5,1031,1391,3,1,3,0,1,0,74.12
彰化縣,鹿港鎮,頭崙里,206,1,641,7,648,827,3,1,3,0,1,0,78.36
彰化縣,鹿港鎮,頂番里,207,1,914,6,920,1362,3,1,3,0,1,0,67.55
彰化縣,鹿港鎮,頂番里,208,1,1219,12,1231,1757,3,1,3,0,1,0,70.06
彰化縣,鹿港鎮,溝墘里,209,1,985,4,989,1365,3,1,3,0,1,0,72.45
彰化縣,鹿港鎮,溝墘里,210,1,944,19,963,1341,3,1,3,0,1,0,71.81
彰化縣,鹿港鎮,溝墘里,211,1,599,6,605,769,3,1,3,0,1,0,78.67
彰化縣,褔興鄉,番婆村,212,1,809,9,818,1178,3,1,3,0,1,0,69.44
彰化縣,褔興鄉,番婆村,213,1,647,11,658,904,3,1,3,0,1,0,72.79
彰化縣,褔興鄉,大崙村,214,1,804,7,811,1099,3,1,3,0,1,0,73.79
彰化縣,褔興鄉,外埔村,215,1,796,21,817,1077,3,1,3,0,1,0,75.86
彰化縣,褔興鄉,三汴村,216,1,920,17,937,1242,3,1,3,0,1,0,75.44
彰化縣,褔興鄉,萬豐村,217,1,517,10,527,727,3,1,3,0,1,0,72.49
彰化縣,褔興鄉,外中村,218,1,887,14,901,1159,3,1,3,0,1,0,77.74
彰化縣,褔興鄉,元中村,219,1,795,14,809,1081,3,1,3,0,1,0,74.84
彰化縣,褔興鄉,橋頭村,220,1,735,8,743,968,3,1,3,0,1,0,76.76
彰化縣,褔興鄉,橋頭村,221,1,840,9,849,1233,3,1,3,0,1,0,68.86
彰化縣,褔興鄉,社尾村,222,1,1021,26,1047,1342,3,1,3,0,1,0,78.02
彰化縣,褔興鄉,番社村,223,1,975,14,989,1273,3,1,3,0,1,0,77.69
彰化縣,褔興鄉,同安村,224,1,747,11,758,985,3,1,3,0,1,0,76.95
彰化縣,褔興鄉,同安村,225,1,779,8,787,1108,3,1,3,0,1,0,71.03
彰化縣,褔興鄉,西勢村,226,1,697,3,700,971,3,1,3,0,1,0,72.09
彰化縣,褔興鄉,西勢村,227,1,510,8,518,715,3,1,3,0,1,0,72.45
彰化縣,褔興鄉,秀厝村,228,1,615,8,623,906,3,1,3,0,1,0,68.76
彰化縣,褔興鄉,秀厝村,229,1,845,13,858,1186,3,1,3,0,1,0,72.34
彰化縣,褔興鄉,鎮平村,230,1,817,10,827,1100,3,1,3,0,1,0,75.18
彰化縣,褔興鄉,三和村,231,1,782,7,789,1033,3,1,3,0,1,0,76.38
彰化縣,褔興鄉,麥厝村,232,1,765,8,773,1026,3,1,3,0,1,0,75.34
彰化縣,褔興鄉,麥厝村,233,1,753,14,767,1076,3,1,3,0,1,0,71.28
彰化縣,褔興鄉,廈粘村,234,1,680,3,683,884,3,1,3,0,1,0,77.26
彰化縣,褔興鄉,廈粘村,235,1,679,13,692,942,3,1,3,0,1,0,73.46
彰化縣,褔興鄉,頂粘村,236,1,708,11,719,917,3,1,3,0,1,0,78.41
彰化縣,褔興鄉,頂粘村,237,1,853,13,866,1171,3,1,3,0,1,0,73.95
彰化縣,褔興鄉,福寶村,238,1,872,11,883,1192,3,1,3,0,1,0,74.08
彰化縣,褔興鄉,二港村,239,1,958,14,972,1272,3,1,3,0,1,0,76.42
彰化縣,褔興鄉,福興村,240,1,1069,15,1084,1581,3,1,3,0,1,0,68.56
彰化縣,褔興鄉,福興村,241,1,903,8,911,1281,3,1,3,0,1,0,71.12
彰化縣,褔興鄉,福南村,242,1,741,4,745,1013,3,1,3,0,1,0,73.54
彰化縣,褔興鄉,福南村,243,1,865,13,878,1164,3,1,3,0,1,0,75.43
彰化縣,秀水鄉,秀水村,244,1,687,5,692,1015,3,1,3,0,1,0,68.18
彰化縣,秀水鄉,秀水村,245,1,431,8,439,601,3,1,3,0,1,0,73.04
彰化縣,秀水鄉,安溪村,246,1,1037,18,1055,1480,3,1,3,0,1,0,71.28
彰化縣,秀水鄉,莊雅村,247,1,577,6,583,904,3,1,3,0,1,0,64.49
彰化縣,秀水鄉,莊雅村,248,1,836,6,842,1165,3,1,3,0,1,0,72.27
彰化縣,秀水鄉,陝西村,249,1,877,11,888,1186,3,1,3,0,1,0,74.87
彰化縣,秀水鄉,金興村,250,1,613,12,625,878,3,1,3,0,1,0,71.18
彰化縣,秀水鄉,金興村,251,1,556,6,562,780,3,1,3,0,1,0,72.05
彰化縣,秀水鄉,安東村,252,1,794,13,807,1173,3,1,3,0,1,0,68.80
彰化縣,秀水鄉,安東村,253,1,652,9,661,949,3,1,3,0,1,0,69.65
彰化縣,秀水鄉,安東村,254,1,755,16,771,1140,3,1,3,0,1,0,67.63
彰化縣,秀水鄉,鶴鳴村,255,1,1091,9,1100,1486,3,1,3,0,1,0,74.02
彰化縣,秀水鄉,鶴鳴村,256,1,800,10,810,1166,3,1,3,0,1,0,69.47
彰化縣,秀水鄉,馬興村,257,1,851,9,860,1146,3,1,3,0,1,0,75.04
彰化縣,秀水鄉,馬興村,258,1,613,6,619,853,3,1,3,0,1,0,72.57
彰化縣,秀水鄉,義興村,259,1,847,8,855,1129,3,1,3,0,1,0,75.73
彰化縣,秀水鄉,福安村,260,1,863,7,870,1268,3,1,3,0,1,0,68.61
彰化縣,秀水鄉,福安村,261,1,866,15,881,1241,3,1,3,0,1,0,70.99
彰化縣,秀水鄉,福安村,262,1,709,13,722,1064,3,1,3,0,1,0,67.86
彰化縣,秀水鄉,埔崙村,263,1,461,7,468,658,3,1,3,0,1,0,71.12
彰化縣,秀水鄉,埔崙村,264,1,724,6,730,1098,3,1,3,0,1,0,66.48
彰化縣,秀水鄉,曾厝村,265,1,1035,15,1050,1366,3,1,3,0,1,0,76.87
彰化縣,秀水鄉,金陵村,266,1,1022,10,1032,1428,3,1,3,0,1,0,72.27
彰化縣,秀水鄉,下崙村,267,1,864,11,875,1151,3,1,3,0,1,0,76.02
彰化縣,秀水鄉,下崙村,268,1,547,6,553,757,3,1,3,0,1,0,73.05
彰化縣,和美鎮,竹營里,269,1,1273,15,1288,1874,3,1,3,0,1,0,68.73
彰化縣,和美鎮,竹營里,270,1,1452,18,1470,2308,3,1,3,0,1,0,63.69
彰化縣,和美鎮,和東里,271,1,1274,10,1284,1985,3,1,3,0,1,0,64.69
彰化縣,和美鎮,和東里,272,1,997,7,1004,1572,3,1,3,0,1,0,63.87
彰化縣,和美鎮,和南里,273,1,351,2,353,444,3,1,3,0,1,0,79.50
彰化縣,和美鎮,和北里,274,1,934,10,944,1401,3,1,3,0,1,0,67.38
彰化縣,和美鎮,和西里,275,1,899,9,908,1430,3,1,3,0,1,0,63.50
彰化縣,和美鎮,和西里,276,1,1092,8,1100,1685,3,1,3,0,1,0,65.28
彰化縣,和美鎮,四張里,277,1,711,7,718,1115,3,1,3,0,1,0,64.39
彰化縣,和美鎮,四張里,278,1,854,8,862,1311,3,1,3,0,1,0,65.75
彰化縣,和美鎮,頭前里,279,1,990,17,1007,1389,3,1,3,0,1,0,72.50
彰化縣,和美鎮,還社里,280,1,609,1,610,778,3,1,3,0,1,0,78.41
彰化縣,和美鎮,面前里,281,1,429,8,437,567,3,1,3,0,1,0,77.07
彰化縣,和美鎮,面前里,282,1,809,11,820,1159,3,1,3,0,1,0,70.75
彰化縣,和美鎮,鎮平里,283,1,864,9,873,1154,3,1,3,0,1,0,75.65
彰化縣,和美鎮,鎮平里,284,1,801,10,811,1292,3,1,3,0,1,0,62.77
彰化縣,和美鎮,大霞里,285,1,917,6,923,1246,3,1,3,0,1,0,74.08
彰化縣,和美鎮,源埤里,286,1,1141,14,1155,1543,3,1,3,0,1,0,74.85
彰化縣,和美鎮,南佃里,287,1,1198,13,1211,1760,3,1,3,0,1,0,68.81
彰化縣,和美鎮,雅溝里,288,1,872,11,883,1238,3,1,3,0,1,0,71.32
彰化縣,和美鎮,山犁里,289,1,1188,8,1196,1818,3,1,3,0,1,0,65.79
彰化縣,和美鎮,山犁里,290,1,1131,16,1147,1771,3,1,3,0,1,0,64.77
彰化縣,和美鎮,山犁里,291,1,1322,5,1327,2083,3,1,3,0,1,0,63.71
彰化縣,和美鎮,嘉犁里,292,1,1027,15,1042,1544,3,1,3,0,1,0,67.49
彰化縣,和美鎮,詔安里,293,1,1120,9,1129,1715,3,1,3,0,1,0,65.83
彰化縣,和美鎮,鐵山里,294,1,942,14,956,1334,3,1,3,0,1,0,71.66
彰化縣,和美鎮,鐵山里,295,1,707,6,713,1083,3,1,3,0,1,0,65.84
彰化縣,和美鎮,柑井里,296,1,975,10,985,1344,3,1,3,0,1,0,73.29
彰化縣,和美鎮,柑井里,297,1,966,8,974,1317,3,1,3,0,1,0,73.96
彰化縣,和美鎮,竹園里,298,1,620,10,630,793,3,1,3,0,1,0,79.45
彰化縣,和美鎮,新庄里,299,1,762,11,773,1190,3,1,3,0,1,0,64.96
彰化縣,和美鎮,新庄里,300,1,721,9,730,1081,3,1,3,0,1,0,67.53
彰化縣,和美鎮,犁盛里,301,1,748,10,758,1056,3,1,3,0,1,0,71.78
彰化縣,和美鎮,犁盛里,302,1,729,9,738,1014,3,1,3,0,1,0,72.78
彰化縣,和美鎮,中寮里,303,1,802,10,812,1083,3,1,3,0,1,0,74.98
彰化縣,和美鎮,中圍里,304,1,746,12,758,1009,3,1,3,0,1,0,75.12
彰化縣,和美鎮,中圍里,305,1,968,14,982,1569,3,1,3,0,1,0,62.59
彰化縣,和美鎮,糖友里,306,1,1065,10,1075,1572,3,1,3,0,1,0,68.38
彰化縣,和美鎮,糖友里,307,1,864,7,871,1200,3,1,3,0,1,0,72.58
彰化縣,和美鎮,塗厝里,308,1,1118,10,1128,1652,3,1,3,0,1,0,68.28
彰化縣,和美鎮,地潭里,309,1,584,9,593,856,3,1,3,0,1,0,69.28
彰化縣,和美鎮,湖內里,310,1,833,8,841,1205,3,1,3,0,1,0,69.79
彰化縣,和美鎮,嘉寶里,311,1,1259,26,1285,1714,3,1,3,0,1,0,74.97
彰化縣,和美鎮,月眉里,312,1,1089,13,1102,1679,3,1,3,0,1,0,65.63
彰化縣,和美鎮,月眉里,313,1,816,9,825,1176,3,1,3,0,1,0,70.15
彰化縣,和美鎮,好修里,314,1,687,6,693,947,3,1,3,0,1,0,73.18
彰化縣,和美鎮,好修里,315,1,514,4,518,696,3,1,3,0,1,0,74.43
彰化縣,線西鄉,線西村,316,1,1332,22,1354,1930,3,1,3,0,1,0,70.16
彰化縣,線西鄉,頂庄村,317,1,780,15,795,1148,3,1,3,0,1,0,69.25
彰化縣,線西鄉,寓埔村,318,1,1336,26,1362,2019,3,1,3,0,1,0,67.46
彰化縣,線西鄉,塭仔村,319,1,872,10,882,1157,3,1,3,0,1,0,76.23
彰化縣,線西鄉,溝內村,320,1,710,6,716,1034,3,1,3,0,1,0,69.25
彰化縣,線西鄉,下犁村,321,1,1188,13,1201,1679,3,1,3,0,1,0,71.53
彰化縣,線西鄉,頂犁村,322,1,939,7,946,1296,3,1,3,0,1,0,72.99
彰化縣,線西鄉,頂犁村,323,1,592,8,600,871,3,1,3,0,1,0,68.89
彰化縣,線西鄉,德興村,324,1,794,7,801,1096,3,1,3,0,1,0,73.08
彰化縣,伸港鄉,新港村,325,1,780,12,792,1238,3,1,3,0,1,0,63.97
彰化縣,伸港鄉,新港村,326,1,978,8,986,1509,3,1,3,0,1,0,65.34
彰化縣,伸港鄉,新港村,327,1,982,15,997,1533,3,1,3,0,1,0,65.04
彰化縣,伸港鄉,什股村,328,1,1074,16,1090,1545,3,1,3,0,1,0,70.55
彰化縣,伸港鄉,大同村,329,1,873,10,883,1224,3,1,3,0,1,0,72.14
彰化縣,伸港鄉,海尾村,330,1,1210,19,1229,1630,3,1,3,0,1,0,75.40
彰化縣,伸港鄉,全興村,331,1,1109,9,1118,1550,3,1,3,0,1,0,72.13
彰化縣,伸港鄉,溪底村,332,1,1100,12,1112,1582,3,1,3,0,1,0,70.29
彰化縣,伸港鄉,定興村,333,1,699,7,706,1038,3,1,3,0,1,0,68.02
彰化縣,伸港鄉,定興村,334,1,719,6,725,1179,3,1,3,0,1,0,61.49
彰化縣,伸港鄉,泉州村,335,1,1214,18,1232,1692,3,1,3,0,1,0,72.81
彰化縣,伸港鄉,泉厝村,336,1,823,9,832,1200,3,1,3,0,1,0,69.33
彰化縣,伸港鄉,曾家村,337,1,1010,18,1028,1491,3,1,3,0,1,0,68.95
彰化縣,伸港鄉,蚵寮村,338,1,814,11,825,1144,3,1,3,0,1,0,72.12
彰化縣,伸港鄉,埤墘村,339,1,651,7,658,974,3,1,3,0,1,0,67.56
彰化縣,伸港鄉,七嘉村,340,1,1428,13,1441,2000,3,1,3,0,1,0,72.05
彰化縣,伸港鄉,汴頭村,341,1,1433,21,1454,1986,3,1,3,0,1,0,73.21
彰化縣,員林鎮,東和里,342,1,709,12,721,1105,3,1,3,0,1,0,65.25
彰化縣,員林鎮,民生里,343,1,699,7,706,1064,3,1,3,0,1,0,66.35
彰化縣,員林鎮,民生里,344,1,1005,10,1015,1547,3,1,3,0,1,0,65.61
彰化縣,員林鎮,中正里,345,1,877,16,893,1370,3,1,3,0,1,0,65.18
彰化縣,員林鎮,中正里,346,1,902,8,910,1532,3,1,3,0,1,0,59.40
彰化縣,員林鎮,仁美里,347,1,862,6,868,1325,3,1,3,0,1,0,65.51
彰化縣,員林鎮,仁美里,348,1,873,5,878,1342,3,1,3,0,1,0,65.42
彰化縣,員林鎮,新興里,349,1,544,6,550,799,3,1,3,0,1,0,68.84
彰化縣,員林鎮,和平里,350,1,647,8,655,1049,3,1,3,0,1,0,62.44
彰化縣,員林鎮,和平里,351,1,1064,13,1077,1658,3,1,3,0,1,0,64.96
彰化縣,員林鎮,光明里,352,1,636,4,640,933,3,1,3,0,1,0,68.60
彰化縣,員林鎮,中山里,353,1,497,3,500,695,3,1,3,0,1,0,71.94
彰化縣,員林鎮,黎明里,354,1,578,5,583,832,3,1,3,0,1,0,70.07
彰化縣,員林鎮,黎明里,355,1,598,6,604,891,3,1,3,0,1,0,67.79
彰化縣,員林鎮,惠來里,356,1,1075,12,1087,1799,3,1,3,0,1,0,60.42
彰化縣,員林鎮,惠來里,357,1,869,8,877,1415,3,1,3,0,1,0,61.98
彰化縣,員林鎮,惠來里,358,1,888,15,903,1383,3,1,3,0,1,0,65.29
彰化縣,員林鎮,三義里,359,1,648,8,656,1012,3,1,3,0,1,0,64.82
彰化縣,員林鎮,三義里,360,1,803,10,813,1271,3,1,3,0,1,0,63.97
彰化縣,員林鎮,新生里,361,1,735,10,745,1104,3,1,3,0,1,0,67.48
彰化縣,員林鎮,新生里,362,1,679,8,687,1040,3,1,3,0,1,0,66.06
彰化縣,員林鎮,新生里,363,1,533,3,536,793,3,1,3,0,1,0,67.59
彰化縣,員林鎮,新生里,364,1,552,6,558,829,3,1,3,0,1,0,67.31
彰化縣,員林鎮,南平里,365,1,632,5,637,1010,3,1,3,0,1,0,63.07
彰化縣,員林鎮,南平里,366,1,753,8,761,1196,3,1,3,0,1,0,63.63
彰化縣,員林鎮,南平里,367,1,921,10,931,1367,3,1,3,0,1,0,68.11
彰化縣,員林鎮,南興里,368,1,966,11,977,1516,3,1,3,0,1,0,64.45
彰化縣,員林鎮,南興里,369,1,904,10,914,1384,3,1,3,0,1,0,66.04
彰化縣,員林鎮,南興里,370,1,827,9,836,1295,3,1,3,0,1,0,64.56
彰化縣,員林鎮,源潭里,371,1,1013,6,1019,1525,3,1,3,0,1,0,66.82
彰化縣,員林鎮,大埔里,372,1,1207,18,1225,1796,3,1,3,0,1,0,68.21
彰化縣,員林鎮,仁愛里,373,1,889,6,895,1304,3,1,3,0,1,0,68.63
彰化縣,員林鎮,忠孝里,374,1,673,11,684,1030,3,1,3,0,1,0,66.41
彰化縣,員林鎮,忠孝里,375,1,538,3,541,832,3,1,3,0,1,0,65.02
彰化縣,員林鎮,三條里,376,1,639,7,646,1048,3,1,3,0,1,0,61.64
彰化縣,員林鎮,三條里,377,1,659,5,664,1030,3,1,3,0,1,0,64.47
彰化縣,員林鎮,三和里,378,1,1037,15,1052,1875,3,1,3,0,1,0,56.11
彰化縣,員林鎮,三和里,379,1,942,14,956,1638,3,1,3,0,1,0,58.36
彰化縣,員林鎮,三和里,380,1,1002,6,1008,1617,3,1,3,0,1,0,62.34
彰化縣,員林鎮,三橋里,381,1,773,7,780,1159,3,1,3,0,1,0,67.30
彰化縣,員林鎮,三橋里,382,1,848,12,860,1386,3,1,3,0,1,0,62.05
彰化縣,員林鎮,三愛里,383,1,774,2,776,1316,3,1,3,0,1,0,58.97
彰化縣,員林鎮,三愛里,384,1,752,10,762,1158,3,1,3,0,1,0,65.80
彰化縣,員林鎮,三信里,385,1,595,7,602,943,3,1,3,0,1,0,63.84
彰化縣,員林鎮,三信里,386,1,610,7,617,966,3,1,3,0,1,0,63.87
彰化縣,員林鎮,三多里,387,1,678,12,690,1122,3,1,3,0,1,0,61.50
彰化縣,員林鎮,三多里,388,1,552,7,559,889,3,1,3,0,1,0,62.88
彰化縣,員林鎮,中央里,389,1,968,18,986,1576,3,1,3,0,1,0,62.56
彰化縣,員林鎮,溝皂里,390,1,718,8,726,1129,3,1,3,0,1,0,64.30
彰化縣,員林鎮,溝皂里,391,1,666,3,669,981,3,1,3,0,1,0,68.20
彰化縣,員林鎮,大饒里,392,1,796,10,806,1195,3,1,3,0,1,0,67.45
彰化縣,員林鎮,大饒里,393,1,846,12,858,1312,3,1,3,0,1,0,65.40
彰化縣,員林鎮,大明里,394,1,728,3,731,1091,3,1,3,0,1,0,67.00
彰化縣,員林鎮,大明里,395,1,631,10,641,927,3,1,3,0,1,0,69.15
彰化縣,員林鎮,萬年里,396,1,572,3,575,836,3,1,3,0,1,0,68.78
彰化縣,員林鎮,萬年里,397,1,634,9,643,999,3,1,3,0,1,0,64.36
彰化縣,員林鎮,萬年里,398,1,860,2,862,1282,3,1,3,0,1,0,67.24
彰化縣,員林鎮,崙雅里,399,1,773,11,784,1055,3,1,3,0,1,0,74.31
彰化縣,員林鎮,崙雅里,400,1,829,6,835,1194,3,1,3,0,1,0,69.93
彰化縣,員林鎮,振興里,401,1,695,10,705,1102,3,1,3,0,1,0,63.97
彰化縣,員林鎮,振興里,402,1,744,13,757,1152,3,1,3,0,1,0,65.71
彰化縣,員林鎮,林厝里,403,1,636,4,640,1044,3,1,3,0,1,0,61.30
彰化縣,員林鎮,林厝里,404,1,784,6,790,1234,3,1,3,0,1,0,64.02
彰化縣,員林鎮,出水里,405,1,1141,14,1155,1695,3,1,3,0,1,0,68.14
彰化縣,員林鎮,湖水里,406,1,774,8,782,1264,3,1,3,0,1,0,61.87
彰化縣,員林鎮,大峰里,407,1,451,6,457,733,3,1,3,0,1,0,62.35
彰化縣,員林鎮,鎮興里,408,1,654,6,660,1010,3,1,3,0,1,0,65.35
彰化縣,員林鎮,鎮興里,409,1,550,6,556,843,3,1,3,0,1,0,65.95
彰化縣,員林鎮,浮圳里,410,1,723,12,735,1121,3,1,3,0,1,0,65.57
彰化縣,員林鎮,浮圳里,411,1,554,2,556,919,3,1,3,0,1,0,60.50
彰化縣,員林鎮,西東里,412,1,1043,12,1055,1685,3,1,3,0,1,0,62.61
彰化縣,員林鎮,南東里,413,1,629,9,638,955,3,1,3,0,1,0,66.81
彰化縣,員林鎮,南東里,414,1,447,2,449,688,3,1,3,0,1,0,65.26
彰化縣,員林鎮,中東里,415,1,917,17,934,1527,3,1,3,0,1,0,61.17
彰化縣,員林鎮,東北里,416,1,654,14,668,996,3,1,3,0,1,0,67.07
彰化縣,員林鎮,東北里,417,1,661,7,668,1037,3,1,3,0,1,0,64.42
彰化縣,大村鄉,大村村,418,1,780,8,788,1071,3,1,3,0,1,0,73.58
彰化縣,大村鄉,大村村,419,1,707,7,714,1054,3,1,3,0,1,0,67.74
彰化縣,大村鄉,茄苳村,420,1,1055,14,1069,1553,3,1,3,0,1,0,68.83
彰化縣,大村鄉,田洋村,421,1,655,9,664,925,3,1,3,0,1,0,71.78
彰化縣,大村鄉,貢旗村,422,1,946,7,953,1373,3,1,3,0,1,0,69.41
彰化縣,大村鄉,加錫村,423,1,908,11,919,1281,3,1,3,0,1,0,71.74
彰化縣,大村鄉,大崙村,424,1,953,7,960,1453,3,1,3,0,1,0,66.07
彰化縣,大村鄉,新興村,425,1,732,6,738,1099,3,1,3,0,1,0,67.15
彰化縣,大村鄉,南勢村,426,1,836,7,843,1187,3,1,3,0,1,0,71.02
彰化縣,大村鄉,擺塘村,427,1,901,4,905,1268,3,1,3,0,1,0,71.37
彰化縣,大村鄉,擺塘村,428,1,551,5,556,895,3,1,3,0,1,0,62.12
彰化縣,大村鄉,過溝村,429,1,748,4,752,1035,3,1,3,0,1,0,72.66
彰化縣,大村鄉,過溝村,430,1,710,8,718,1124,3,1,3,0,1,0,63.88
彰化縣,大村鄉,大橋村,431,1,1201,17,1218,1800,3,1,3,0,1,0,67.67
彰化縣,大村鄉,村上村,432,1,922,5,927,1243,3,1,3,0,1,0,74.58
彰化縣,大村鄉,美港村,433,1,940,5,945,1439,3,1,3,0,1,0,65.67
彰化縣,大村鄉,美港村,434,1,722,3,725,1101,3,1,3,0,1,0,65.85
彰化縣,大村鄉,黃厝村,435,1,1164,15,1179,1791,3,1,3,0,1,0,65.83
彰化縣,大村鄉,福興村,436,1,1123,11,1134,1760,3,1,3,0,1,0,64.43
彰化縣,大村鄉,平和村,437,1,742,9,751,1137,3,1,3,0,1,0,66.05
彰化縣,大村鄉,平和村,438,1,597,12,609,887,3,1,3,0,1,0,68.66
彰化縣,永靖鄉,永東村,439,1,588,5,593,794,3,1,3,0,1,0,74.69
彰化縣,永靖鄉,永西村,440,1,975,4,979,1469,3,1,3,0,1,0,66.64
彰化縣,永靖鄉,永南村,441,1,1228,13,1241,1846,3,1,3,0,1,0,67.23
彰化縣,永靖鄉,永北村,442,1,1276,6,1282,1910,3,1,3,0,1,0,67.12
彰化縣,永靖鄉,港西村,443,1,1091,12,1103,1634,3,1,3,0,1,0,67.50
彰化縣,永靖鄉,五福村,444,1,870,17,887,1374,3,1,3,0,1,0,64.56
彰化縣,永靖鄉,湳港村,445,1,693,7,700,955,3,1,3,0,1,0,73.30
彰化縣,永靖鄉,新莊村,446,1,628,13,641,875,3,1,3,0,1,0,73.26
彰化縣,永靖鄉,瑚璉村,447,1,737,7,744,1081,3,1,3,0,1,0,68.83
彰化縣,永靖鄉,瑚璉村,448,1,695,11,706,1026,3,1,3,0,1,0,68.81
彰化縣,永靖鄉,五汴村,449,1,912,8,920,1356,3,1,3,0,1,0,67.85
彰化縣,永靖鄉,浮圳村,450,1,802,12,814,1065,3,1,3,0,1,0,76.43
彰化縣,永靖鄉,光雲村,451,1,1070,20,1090,1550,3,1,3,0,1,0,70.32
彰化縣,永靖鄉,東寧村,452,1,1156,17,1173,1657,3,1,3,0,1,0,70.79
彰化縣,永靖鄉,永興村,453,1,1077,9,1086,1524,3,1,3,0,1,0,71.26
彰化縣,永靖鄉,崙子村,454,1,805,7,812,1206,3,1,3,0,1,0,67.33
彰化縣,永靖鄉,獨鰲村,455,1,612,3,615,866,3,1,3,0,1,0,71.02
彰化縣,永靖鄉,敦厚村,456,1,497,10,507,720,3,1,3,0,1,0,70.42
彰化縣,永靖鄉,崙美村,457,1,532,3,535,740,3,1,3,0,1,0,72.30
彰化縣,永靖鄉,同安村,458,1,477,8,485,687,3,1,3,0,1,0,70.60
彰化縣,永靖鄉,同仁村,459,1,651,8,659,951,3,1,3,0,1,0,69.30
彰化縣,永靖鄉,湳墘村,460,1,614,8,622,835,3,1,3,0,1,0,74.49
彰化縣,永靖鄉,四芳村,461,1,462,3,465,681,3,1,3,0,1,0,68.28
彰化縣,永靖鄉,福興村,462,1,809,10,819,1130,3,1,3,0,1,0,72.48
彰化縣,永靖鄉,竹子村,463,1,969,5,974,1348,3,1,3,0,1,0,72.26
彰化縣,溪湖鎮,光平里,464,1,866,4,870,1245,3,1,3,0,1,0,69.88
彰化縣,溪湖鎮,平和里,465,1,562,5,567,748,3,1,3,0,1,0,75.80
彰化縣,溪湖鎮,太平里,466,1,978,14,992,1404,3,1,3,0,1,0,70.66
彰化縣,溪湖鎮,光華里,467,1,350,1,351,479,3,1,3,0,1,0,73.28
彰化縣,溪湖鎮,東寮里,468,1,908,8,916,1338,3,1,3,0,1,0,68.46
彰化縣,溪湖鎮,東寮里,469,1,960,11,971,1517,3,1,3,0,1,0,64.01
彰化縣,溪湖鎮,西寮里,470,1,614,5,619,872,3,1,3,0,1,0,70.99
彰化縣,溪湖鎮,西寮里,471,1,703,6,709,979,3,1,3,0,1,0,72.42
彰化縣,溪湖鎮,大突里,472,1,775,8,783,1142,3,1,3,0,1,0,68.56
彰化縣,溪湖鎮,大突里,473,1,789,12,801,1113,3,1,3,0,1,0,71.97
彰化縣,溪湖鎮,北勢里,474,1,901,5,906,1255,3,1,3,0,1,0,72.19
彰化縣,溪湖鎮,汴頭里,475,1,924,5,929,1285,3,1,3,0,1,0,72.30
彰化縣,溪湖鎮,汴頭里,476,1,742,4,746,1086,3,1,3,0,1,0,68.69
彰化縣,溪湖鎮,大竹里,477,1,809,9,818,1182,3,1,3,0,1,0,69.20
彰化縣,溪湖鎮,大竹里,478,1,756,5,761,1073,3,1,3,0,1,0,70.92
彰化縣,溪湖鎮,湖西里,479,1,635,3,638,934,3,1,3,0,1,0,68.31
彰化縣,溪湖鎮,湖西里,480,1,695,4,699,1035,3,1,3,0,1,0,67.54
彰化縣,溪湖鎮,田中里,481,1,567,6,573,755,3,1,3,0,1,0,75.89
彰化縣,溪湖鎮,河東里,482,1,1123,11,1134,1650,3,1,3,0,1,0,68.73
彰化縣,溪湖鎮,中山里,483,1,793,12,805,1102,3,1,3,0,1,0,73.05
彰化縣,溪湖鎮,中山里,484,1,752,7,759,1118,3,1,3,0,1,0,67.89
彰化縣,溪湖鎮,中竹里,485,1,542,4,546,777,3,1,3,0,1,0,70.27
彰化縣,溪湖鎮,東溪里,486,1,850,11,861,1262,3,1,3,0,1,0,68.23
彰化縣,溪湖鎮,西溪里,487,1,1029,10,1039,1553,3,1,3,0,1,0,66.90
彰化縣,溪湖鎮,湖東里,488,1,816,8,824,1233,3,1,3,0,1,0,66.83
彰化縣,溪湖鎮,湖東里,489,1,875,1,876,1261,3,1,3,0,1,0,69.47
彰化縣,溪湖鎮,湖東里,490,1,765,7,772,1149,3,1,3,0,1,0,67.19
彰化縣,溪湖鎮,頂庄里,491,1,463,10,473,640,3,1,3,0,1,0,73.91
彰化縣,溪湖鎮,忠覺里,492,1,927,7,934,1254,3,1,3,0,1,0,74.48
彰化縣,溪湖鎮,湳底里,493,1,522,9,531,721,3,1,3,0,1,0,73.65
彰化縣,溪湖鎮,大庭里,494,1,866,11,877,1271,3,1,3,0,1,0,69.00
彰化縣,溪湖鎮,媽厝里,495,1,942,8,950,1325,3,1,3,0,1,0,71.70
彰化縣,溪湖鎮,西勢里,496,1,535,5,540,744,3,1,3,0,1,0,72.58
彰化縣,溪湖鎮,西勢里,497,1,782,10,792,1177,3,1,3,0,1,0,67.29
彰化縣,溪湖鎮,番婆里,498,1,1021,8,1029,1540,3,1,3,0,1,0,66.82
彰化縣,埔鹽鄉,埔鹽村,499,1,1074,17,1091,1520,3,1,3,0,1,0,71.78
彰化縣,埔鹽鄉,埔南村,500,1,1072,14,1086,1473,3,1,3,0,1,0,73.73
彰化縣,埔鹽鄉,部子村,501,1,907,9,916,1168,3,1,3,0,1,0,78.42
彰化縣,埔鹽鄉,出水村,502,1,650,10,660,834,3,1,3,0,1,0,79.14
彰化縣,埔鹽鄉,南港村,503,1,1251,13,1264,1631,3,1,3,0,1,0,77.50
彰化縣,埔鹽鄉,打廉村,504,1,726,7,733,924,3,1,3,0,1,0,79.33
彰化縣,埔鹽鄉,豐澤村,505,1,902,23,925,1283,3,1,3,0,1,0,72.10
彰化縣,埔鹽鄉,崑崙村,506,1,780,10,790,1036,3,1,3,0,1,0,76.25
彰化縣,埔鹽鄉,角樹村,507,1,558,6,564,702,3,1,3,0,1,0,80.34
彰化縣,埔鹽鄉,瓦窯村,508,1,889,9,898,1158,3,1,3,0,1,0,77.55
彰化縣,埔鹽鄉,好修村,509,1,1000,25,1025,1365,3,1,3,0,1,0,75.09
彰化縣,埔鹽鄉,西湖村,510,1,1506,10,1516,1949,3,1,3,0,1,0,77.78
彰化縣,埔鹽鄉,大有村,511,1,956,9,965,1241,3,1,3,0,1,0,77.76
彰化縣,埔鹽鄉,新興村,512,1,298,3,301,393,3,1,3,0,1,0,76.59
彰化縣,埔鹽鄉,永平村,513,1,762,9,771,1058,3,1,3,0,1,0,72.87
彰化縣,埔鹽鄉,永樂村,514,1,609,7,616,770,3,1,3,0,1,0,80.00
彰化縣,埔鹽鄉,石埤村,515,1,978,12,990,1315,3,1,3,0,1,0,75.29
彰化縣,埔鹽鄉,天盛村,516,1,666,3,669,826,3,1,3,0,1,0,80.99
彰化縣,埔鹽鄉,太平村,517,1,1056,10,1066,1463,3,1,3,0,1,0,72.86
彰化縣,埔鹽鄉,新水村,518,1,1053,9,1062,1369,3,1,3,0,1,0,77.57
彰化縣,埔鹽鄉,三省村,519,1,1003,11,1014,1264,3,1,3,0,1,0,80.22
彰化縣,埔鹽鄉,南新村,520,1,936,14,950,1244,3,1,3,0,1,0,76.37
彰化縣,埔心鄉,東門村,521,1,832,11,843,1225,3,1,3,0,1,0,68.82
彰化縣,埔心鄉,東門村,522,1,995,11,1006,1500,3,1,3,0,1,0,67.07
彰化縣,埔心鄉,埔心村,523,1,831,7,838,1211,3,1,3,0,1,0,69.20
彰化縣,埔心鄉,義民村,524,1,996,10,1006,1450,3,1,3,0,1,0,69.38
彰化縣,埔心鄉,油車村,525,1,817,12,829,1132,3,1,3,0,1,0,73.23
彰化縣,埔心鄉,瓦北村,526,1,1093,21,1114,1621,3,1,3,0,1,0,68.72
彰化縣,埔心鄉,瓦中村,527,1,1144,11,1155,1733,3,1,3,0,1,0,66.65
彰化縣,埔心鄉,瓦南村,528,1,910,7,917,1329,3,1,3,0,1,0,69.00
彰化縣,埔心鄉,經口村,529,1,1089,7,1096,1688,3,1,3,0,1,0,64.93
彰化縣,埔心鄉,太平村,530,1,1240,17,1257,1794,3,1,3,0,1,0,70.07
彰化縣,埔心鄉,大華村,531,1,430,7,437,589,3,1,3,0,1,0,74.19
彰化縣,埔心鄉,仁里村,532,1,714,9,723,1070,3,1,3,0,1,0,67.57
彰化縣,埔心鄉,舊館村,533,1,792,7,799,1159,3,1,3,0,1,0,68.94
彰化縣,埔心鄉,南館村,534,1,530,5,535,839,3,1,3,0,1,0,63.77
彰化縣,埔心鄉,新館村,535,1,597,8,605,891,3,1,3,0,1,0,67.90
彰化縣,埔心鄉,芎蕉村,536,1,1168,12,1180,1704,3,1,3,0,1,0,69.25
彰化縣,埔心鄉,羅厝村,537,1,932,9,941,1322,3,1,3,0,1,0,71.18
彰化縣,埔心鄉,梧鳳村,538,1,634,5,639,868,3,1,3,0,1,0,73.62
彰化縣,埔心鄉,二重村,539,1,891,9,900,1202,3,1,3,0,1,0,74.88
彰化縣,埔心鄉,埤霞村,540,1,545,4,549,766,3,1,3,0,1,0,71.67
彰化縣,埔心鄉,埤腳村,541,1,608,10,618,844,3,1,3,0,1,0,73.22
彰化縣,田中鎮,香山里,542,1,579,7,586,868,3,1,3,0,1,0,67.51
彰化縣,田中鎮,碧峰里,543,1,609,9,618,1003,3,1,3,0,1,0,61.62
彰化縣,田中鎮,碧峰里,544,1,439,7,446,995,3,1,3,0,1,0,44.82
彰化縣,田中鎮,東源里,545,1,397,3,400,624,3,1,3,0,1,0,64.10
彰化縣,田中鎮,復興里,546,1,997,15,1012,1487,3,1,3,0,1,0,68.06
彰化縣,田中鎮,平和里,547,1,979,11,990,1468,3,1,3,0,1,0,67.44
彰化縣,田中鎮,頂潭里,548,1,804,6,810,1232,3,1,3,0,1,0,65.75
彰化縣,田中鎮,中潭里,549,1,1069,9,1078,1691,3,1,3,0,1,0,63.75
彰化縣,田中鎮,龍潭里,550,1,454,6,460,646,3,1,3,0,1,0,71.21
彰化縣,田中鎮,北路里,551,1,1089,10,1099,1695,3,1,3,0,1,0,64.84
彰化縣,田中鎮,北路里,552,1,811,6,817,1153,3,1,3,0,1,0,70.86
彰化縣,田中鎮,西路里,553,1,555,1,556,857,3,1,3,0,1,0,64.88
彰化縣,田中鎮,西路里,554,1,881,14,895,1295,3,1,3,0,1,0,69.11
彰化縣,田中鎮,東路里,555,1,718,6,724,1100,3,1,3,0,1,0,65.82
彰化縣,田中鎮,南路里,556,1,869,9,878,1282,3,1,3,0,1,0,68.49
彰化縣,田中鎮,中路里,557,1,588,6,594,891,3,1,3,0,1,0,66.67
彰化縣,田中鎮,中路里,558,1,733,6,739,1088,3,1,3,0,1,0,67.92
彰化縣,田中鎮,新庄里,559,1,613,14,627,993,3,1,3,0,1,0,63.14
彰化縣,田中鎮,新庄里,560,1,697,4,701,1076,3,1,3,0,1,0,65.15
彰化縣,田中鎮,三安里,561,1,1090,19,1109,1609,3,1,3,0,1,0,68.92
彰化縣,田中鎮,大崙里,562,1,897,7,904,1316,3,1,3,0,1,0,68.69
彰化縣,田中鎮,沙崙里,563,1,998,20,1018,1644,3,1,3,0,1,0,61.92
彰化縣,田中鎮,新民里,564,1,1143,6,1149,1705,3,1,3,0,1,0,67.39
彰化縣,田中鎮,新民里,565,1,1089,11,1100,1752,3,1,3,0,1,0,62.79
彰化縣,田中鎮,梅州里,566,1,884,8,892,1323,3,1,3,0,1,0,67.42
彰化縣,田中鎮,三民里,567,1,987,11,998,1520,3,1,3,0,1,0,65.66
彰化縣,田中鎮,三光里,568,1,611,7,618,888,3,1,3,0,1,0,69.59
彰化縣,田中鎮,大社里,569,1,560,1,561,815,3,1,3,0,1,0,68.83
彰化縣,社頭鄉,社頭村,570,1,853,4,857,1277,3,1,3,0,1,0,67.11
彰化縣,社頭鄉,社頭村,571,1,896,4,900,1304,3,1,3,0,1,0,69.02
彰化縣,社頭鄉,廣興村,572,1,801,13,814,1160,3,1,3,0,1,0,70.17
彰化縣,社頭鄉,廣興村,573,1,921,16,937,1388,3,1,3,0,1,0,67.51
彰化縣,社頭鄉,廣興村,574,1,843,7,850,1284,3,1,3,0,1,0,66.20
彰化縣,社頭鄉,仁雅村,575,1,679,4,683,1027,3,1,3,0,1,0,66.50
彰化縣,社頭鄉,仁雅村,576,1,936,4,940,1451,3,1,3,0,1,0,64.78
彰化縣,社頭鄉,崙雅村,577,1,509,10,519,785,3,1,3,0,1,0,66.11
彰化縣,社頭鄉,美雅村,578,1,724,6,730,1041,3,1,3,0,1,0,70.12
彰化縣,社頭鄉,里仁村,579,1,754,6,760,1079,3,1,3,0,1,0,70.44
彰化縣,社頭鄉,舊社村,580,1,962,13,975,1433,3,1,3,0,1,0,68.04
彰化縣,社頭鄉,松竹村,581,1,673,12,685,986,3,1,3,0,1,0,69.47
彰化縣,社頭鄉,東興村,582,1,816,14,830,1243,3,1,3,0,1,0,66.77
彰化縣,社頭鄉,廣福村,583,1,582,10,592,829,3,1,3,0,1,0,71.41
彰化縣,社頭鄉,橋頭村,584,1,1281,14,1295,1905,3,1,3,0,1,0,67.98
彰化縣,社頭鄉,湳底村,585,1,1015,11,1026,1473,3,1,3,0,1,0,69.65
彰化縣,社頭鄉,新厝村,586,1,980,13,993,1398,3,1,3,0,1,0,71.03
彰化縣,社頭鄉,張厝村,587,1,822,13,835,1114,3,1,3,0,1,0,74.96
彰化縣,社頭鄉,埤斗村,588,1,684,2,686,980,3,1,3,0,1,0,70.00
彰化縣,社頭鄉,清水村,589,1,745,8,753,1061,3,1,3,0,1,0,70.97
彰化縣,社頭鄉,山湖村,590,1,700,7,707,998,3,1,3,0,1,0,70.84
彰化縣,社頭鄉,朝興村,591,1,730,11,741,1032,3,1,3,0,1,0,71.80
彰化縣,社頭鄉,仁和村,592,1,498,3,501,684,3,1,3,0,1,0,73.25
彰化縣,社頭鄉,泰安村,593,1,640,2,642,887,3,1,3,0,1,0,72.38
彰化縣,社頭鄉,平和村,594,1,668,9,677,945,3,1,3,0,1,0,71.64
彰化縣,社頭鄉,龍井村,595,1,554,6,560,808,3,1,3,0,1,0,69.31
彰化縣,社頭鄉,湳雅村,596,1,952,14,966,1354,3,1,3,0,1,0,71.34
彰化縣,社頭鄉,協和村,597,1,1306,17,1323,1949,3,1,3,0,1,0,67.88
彰化縣,二水鄉,復興村,598,1,717,10,727,1022,3,1,3,0,1,0,71.14
彰化縣,二水鄉,十五村,599,1,507,4,511,718,3,1,3,0,1,0,71.17
彰化縣,二水鄉,合和村,600,1,575,10,585,874,3,1,3,0,1,0,66.93
彰化縣,二水鄉,上豊村,601,1,710,7,717,1026,3,1,3,0,1,0,69.88
彰化縣,二水鄉,過圳村,602,1,442,2,444,647,3,1,3,0,1,0,68.62
彰化縣,二水鄉,五伯村,603,1,486,6,492,660,3,1,3,0,1,0,74.55
彰化縣,二水鄉,光化村,604,1,702,6,708,999,3,1,3,0,1,0,70.87
彰化縣,二水鄉,文化村,605,1,714,5,719,1038,3,1,3,0,1,0,69.27
彰化縣,二水鄉,二水村,606,1,631,7,638,880,3,1,3,0,1,0,72.50
彰化縣,二水鄉,聖化村,607,1,363,1,364,489,3,1,3,0,1,0,74.44
彰化縣,二水鄉,裕民村,608,1,620,9,629,951,3,1,3,0,1,0,66.14
彰化縣,二水鄉,惠民村,609,1,576,11,587,863,3,1,3,0,1,0,68.02
彰化縣,二水鄉,大園村,610,1,585,6,591,798,3,1,3,0,1,0,74.06
彰化縣,二水鄉,修仁村,611,1,574,4,578,792,3,1,3,0,1,0,72.98
彰化縣,二水鄉,合興村,612,1,533,2,535,729,3,1,3,0,1,0,73.39
彰化縣,二水鄉,源泉村,613,1,477,6,483,666,3,1,3,0,1,0,72.52
彰化縣,二水鄉,倡和村,614,1,467,4,471,617,3,1,3,0,1,0,76.34
彰化縣,北斗鎮,中寮里,615,1,799,9,808,1150,3,1,3,0,1,0,70.26
彰化縣,北斗鎮,中寮里,616,1,793,8,801,1175,3,1,3,0,1,0,68.17
彰化縣,北斗鎮,大道里,617,1,1212,4,1216,1725,3,1,3,0,1,0,70.49
彰化縣,北斗鎮,西德里,618,1,905,10,915,1320,3,1,3,0,1,0,69.32
彰化縣,北斗鎮,西德里,619,1,828,9,837,1184,3,1,3,0,1,0,70.69
彰化縣,北斗鎮,西德里,620,1,950,14,964,1398,3,1,3,0,1,0,68.96
彰化縣,北斗鎮,西安里,621,1,1040,17,1057,1590,3,1,3,0,1,0,66.48
彰化縣,北斗鎮,光復里,622,1,923,11,934,1400,3,1,3,0,1,0,66.71
彰化縣,北斗鎮,新政里,623,1,531,7,538,807,3,1,3,0,1,0,66.67
彰化縣,北斗鎮,重慶里,624,1,446,4,450,629,3,1,3,0,1,0,71.54
彰化縣,北斗鎮,五權里,625,1,515,2,517,743,3,1,3,0,1,0,69.58
彰化縣,北斗鎮,七星里,626,1,909,8,917,1395,3,1,3,0,1,0,65.73
彰化縣,北斗鎮,居仁里,627,1,845,8,853,1287,3,1,3,0,1,0,66.28
彰化縣,北斗鎮,東光里,628,1,1066,8,1074,1729,3,1,3,0,1,0,62.12
彰化縣,北斗鎮,文昌里,629,1,653,14,667,1000,3,1,3,0,1,0,66.70
彰化縣,北斗鎮,文昌里,630,1,816,11,827,1309,3,1,3,0,1,0,63.18
彰化縣,北斗鎮,中和里,631,1,720,10,730,1058,3,1,3,0,1,0,69.00
彰化縣,北斗鎮,新生里,632,1,1099,15,1114,1741,3,1,3,0,1,0,63.99
彰化縣,北斗鎮,大新里,633,1,953,10,963,1540,3,1,3,0,1,0,62.53
彰化縣,溪州鄉,溪厝村,634,1,446,10,456,765,3,1,3,0,1,0,59.61
彰化縣,溪州鄉,溪厝村,635,1,601,9,610,987,3,1,3,0,1,0,61.80
彰化縣,溪州鄉,坑厝村,636,1,423,4,427,677,3,1,3,0,1,0,63.07
彰化縣,溪州鄉,瓦厝村,637,1,605,4,609,942,3,1,3,0,1,0,64.65
彰化縣,溪州鄉,溪州村,638,1,492,4,496,747,3,1,3,0,1,0,66.40
彰化縣,溪州鄉,溪州村,639,1,538,7,545,877,3,1,3,0,1,0,62.14
彰化縣,溪州鄉,尾厝村,640,1,931,17,948,1429,3,1,3,0,1,0,66.34
彰化縣,溪州鄉,東州村,641,1,520,8,528,819,3,1,3,0,1,0,64.47
彰化縣,溪州鄉,東州村,642,1,585,11,596,889,3,1,3,0,1,0,67.04
彰化縣,溪州鄉,舊眉村,643,1,893,16,909,1316,3,1,3,0,1,0,69.07
彰化縣,溪州鄉,圳寮村,644,1,885,12,897,1462,3,1,3,0,1,0,61.35
彰化縣,溪州鄉,西畔村,645,1,735,10,745,1128,3,1,3,0,1,0,66.05
彰化縣,溪州鄉,西畔村,646,1,591,16,607,936,3,1,3,0,1,0,64.85
彰化縣,溪州鄉,成功村,647,1,632,7,639,949,3,1,3,0,1,0,67.33
彰化縣,溪州鄉,成功村,648,1,564,3,567,899,3,1,3,0,1,0,63.07
彰化縣,溪州鄉,大庄村,649,1,645,5,650,938,3,1,3,0,1,0,69.30
彰化縣,溪州鄉,大庄村,650,1,583,5,588,978,3,1,3,0,1,0,60.12
彰化縣,溪州鄉,榮光村,651,1,507,9,516,802,3,1,3,0,1,0,64.34
彰化縣,溪州鄉,柑園村,652,1,744,3,747,1119,3,1,3,0,1,0,66.76
彰化縣,溪州鄉,潮洋村,653,1,571,10,581,970,3,1,3,0,1,0,59.90
彰化縣,溪州鄉,張厝村,654,1,458,9,467,737,3,1,3,0,1,0,63.36
彰化縣,溪州鄉,菜公村,655,1,605,2,607,896,3,1,3,0,1,0,67.75
彰化縣,溪州鄉,三圳村,656,1,837,8,845,1199,3,1,3,0,1,0,70.48
彰化縣,溪州鄉,三條村,657,1,600,8,608,883,3,1,3,0,1,0,68.86
彰化縣,溪州鄉,水尾村,658,1,801,6,807,1281,3,1,3,0,1,0,63.00
彰化縣,田尾鄉,田尾村,659,1,817,9,826,1233,3,1,3,0,1,0,66.99
彰化縣,田尾鄉,豐田村,660,1,504,3,507,669,3,1,3,0,1,0,75.78
彰化縣,田尾鄉,饒平村,661,1,1389,18,1407,2063,3,1,3,0,1,0,68.20
彰化縣,田尾鄉,北曾村,662,1,860,5,865,1283,3,1,3,0,1,0,67.42
彰化縣,田尾鄉,南曾村,663,1,827,6,833,1206,3,1,3,0,1,0,69.07
彰化縣,田尾鄉,睦宜村,664,1,687,6,693,1000,3,1,3,0,1,0,69.30
彰化縣,田尾鄉,新生村,665,1,782,10,792,1140,3,1,3,0,1,0,69.47
彰化縣,田尾鄉,北鎮村,666,1,671,5,676,1024,3,1,3,0,1,0,66.02
彰化縣,田尾鄉,南鎮村,667,1,451,9,460,653,3,1,3,0,1,0,70.44
彰化縣,田尾鄉,福田村,668,1,609,7,616,851,3,1,3,0,1,0,72.39
彰化縣,田尾鄉,新興村,669,1,737,6,743,1014,3,1,3,0,1,0,73.27
彰化縣,田尾鄉,溪畔村,670,1,832,14,846,1235,3,1,3,0,1,0,68.50
彰化縣,田尾鄉,打簾村,671,1,1050,11,1061,1697,3,1,3,0,1,0,62.52
彰化縣,田尾鄉,柳鳳村,672,1,609,11,620,826,3,1,3,0,1,0,75.06
彰化縣,田尾鄉,陸豐村,673,1,635,6,641,861,3,1,3,0,1,0,74.45
彰化縣,田尾鄉,海豐村,674,1,985,9,994,1457,3,1,3,0,1,0,68.22
彰化縣,田尾鄉,仁里村,675,1,1061,10,1071,1553,3,1,3,0,1,0,68.96
彰化縣,田尾鄉,新厝村,676,1,200,1,201,287,3,1,3,0,1,0,70.03
彰化縣,田尾鄉,溪頂村,677,1,407,12,419,637,3,1,3,0,1,0,65.78
彰化縣,田尾鄉,正義村,678,1,519,7,526,751,3,1,3,0,1,0,70.04
彰化縣,埤頭鄉,和豊村,679,1,644,6,650,1001,3,1,3,0,1,0,64.94
彰化縣,埤頭鄉,和豊村,680,1,794,15,809,1285,3,1,3,0,1,0,62.96
彰化縣,埤頭鄉,興農村,681,1,964,10,974,1583,3,1,3,0,1,0,61.53
彰化縣,埤頭鄉,埤頭村,682,1,1056,7,1063,1597,3,1,3,0,1,0,66.56
彰化縣,埤頭鄉,豊崙村,683,1,646,11,657,951,3,1,3,0,1,0,69.09
彰化縣,埤頭鄉,豊崙村,684,1,796,3,799,1203,3,1,3,0,1,0,66.42
彰化縣,埤頭鄉,崙子村,685,1,789,12,801,1168,3,1,3,0,1,0,68.58
彰化縣,埤頭鄉,永豊村,686,1,942,22,964,1459,3,1,3,0,1,0,66.07
彰化縣,埤頭鄉,合興村,687,1,899,10,909,1344,3,1,3,0,1,0,67.63
彰化縣,埤頭鄉,合興村,688,1,1065,14,1079,1642,3,1,3,0,1,0,65.71
彰化縣,埤頭鄉,平原村,689,1,1074,13,1087,1618,3,1,3,0,1,0,67.18
彰化縣,埤頭鄉,崙腳村,690,1,474,8,482,701,3,1,3,0,1,0,68.76
彰化縣,埤頭鄉,元埔村,691,1,370,2,372,594,3,1,3,0,1,0,62.63
彰化縣,埤頭鄉,芙朝村,692,1,1025,17,1042,1627,3,1,3,0,1,0,64.04
彰化縣,埤頭鄉,新庄村,693,1,692,9,701,1161,3,1,3,0,1,0,60.38
彰化縣,埤頭鄉,陸嘉村,694,1,518,14,532,809,3,1,3,0,1,0,65.76
彰化縣,埤頭鄉,竹圍村,695,1,590,6,596,900,3,1,3,0,1,0,66.22
彰化縣,埤頭鄉,中和村,696,1,812,5,817,1353,3,1,3,0,1,0,60.38
彰化縣,埤頭鄉,庄內村,697,1,610,4,614,969,3,1,3,0,1,0,63.36
彰化縣,埤頭鄉,大湖村,698,1,671,5,676,992,3,1,3,0,1,0,68.15
彰化縣,二林鎮,東和里,699,1,609,7,616,842,3,1,3,0,1,0,73.16
彰化縣,二林鎮,東和里,700,1,827,9,836,1229,3,1,3,0,1,0,68.02
彰化縣,二林鎮,南光里,701,1,879,13,892,1318,3,1,3,0,1,0,67.68
彰化縣,二林鎮,南光里,702,1,1074,8,1082,1555,3,1,3,0,1,0,69.58
彰化縣,二林鎮,西平里,703,1,933,21,954,1324,3,1,3,0,1,0,72.05
彰化縣,二林鎮,北平里,704,1,825,5,830,1249,3,1,3,0,1,0,66.45
彰化縣,二林鎮,北平里,705,1,957,15,972,1513,3,1,3,0,1,0,64.24
彰化縣,二林鎮,中西里,706,1,1143,15,1158,1636,3,1,3,0,1,0,70.78
彰化縣,二林鎮,廣興里,707,1,974,12,986,1462,3,1,3,0,1,0,67.44
彰化縣,二林鎮,香田里,708,1,823,6,829,1202,3,1,3,0,1,0,68.97
彰化縣,二林鎮,外竹里,709,1,805,11,816,1077,3,1,3,0,1,0,75.77
彰化縣,二林鎮,興華里,710,1,765,8,773,1105,3,1,3,0,1,0,69.95
彰化縣,二林鎮,東興里,711,1,845,7,852,1205,3,1,3,0,1,0,70.71
彰化縣,二林鎮,後厝里,712,1,792,10,802,1253,3,1,3,0,1,0,64.01
彰化縣,二林鎮,後厝里,713,1,832,9,841,1192,3,1,3,0,1,0,70.55
彰化縣,二林鎮,豐田里,714,1,497,8,505,705,3,1,3,0,1,0,71.63
彰化縣,二林鎮,豐田里,715,1,940,12,952,1390,3,1,3,0,1,0,68.49
彰化縣,二林鎮,頂厝里,716,1,930,17,947,1407,3,1,3,0,1,0,67.31
彰化縣,二林鎮,趙甲里,717,1,1192,19,1211,1659,3,1,3,0,1,0,73.00
彰化縣,二林鎮,振興里,718,1,921,14,935,1293,3,1,3,0,1,0,72.31
彰化縣,二林鎮,萬興里,719,1,593,2,595,817,3,1,3,0,1,0,72.83
彰化縣,二林鎮,永興里,720,1,1083,30,1113,1545,3,1,3,0,1,0,72.04
彰化縣,二林鎮,西庄里,721,1,928,11,939,1275,3,1,3,0,1,0,73.65
彰化縣,二林鎮,梅芳里,722,1,774,11,785,1090,3,1,3,0,1,0,72.02
彰化縣,二林鎮,華崙里,723,1,877,11,888,1210,3,1,3,0,1,0,73.39
彰化縣,二林鎮,華崙里,724,1,783,7,790,1163,3,1,3,0,1,0,67.93
彰化縣,二林鎮,華崙里,725,1,881,10,891,1154,3,1,3,0,1,0,77.21
彰化縣,二林鎮,萬合里,726,1,933,12,945,1320,3,1,3,0,1,0,71.59
彰化縣,二林鎮,東勢里,727,1,738,10,748,1015,3,1,3,0,1,0,73.69
彰化縣,二林鎮,大永里,728,1,637,5,642,875,3,1,3,0,1,0,73.37
彰化縣,二林鎮,原斗里,729,1,913,10,923,1232,3,1,3,0,1,0,74.92
彰化縣,二林鎮,西斗里,730,1,717,14,731,1036,3,1,3,0,1,0,70.56
彰化縣,二林鎮,東華里,731,1,753,5,758,1030,3,1,3,0,1,0,73.59
彰化縣,二林鎮,復豐里,732,1,541,8,549,733,3,1,3,0,1,0,74.90
彰化縣,芳苑鄉,芳苑村,733,1,628,4,632,1033,3,1,3,0,1,0,61.18
彰化縣,芳苑鄉,芳中村,734,1,286,4,290,510,3,1,3,0,1,0,56.86
彰化縣,芳苑鄉,仁愛村,735,1,523,6,529,870,3,1,3,0,1,0,60.80
彰化縣,芳苑鄉,信義村,736,1,350,6,356,637,3,1,3,0,1,0,55.89
彰化縣,芳苑鄉,後寮村,737,1,654,7,661,947,3,1,3,0,1,0,69.80
彰化縣,芳苑鄉,三合村,738,1,1264,13,1277,1867,3,1,3,0,1,0,68.40
彰化縣,芳苑鄉,永興村,739,1,871,15,886,1392,3,1,3,0,1,0,63.65
彰化縣,芳苑鄉,新街村,740,1,497,7,504,994,3,1,3,0,1,0,50.70
彰化縣,芳苑鄉,路上村,741,1,479,7,486,729,3,1,3,0,1,0,66.67
彰化縣,芳苑鄉,路平村,742,1,509,7,516,725,3,1,3,0,1,0,71.17
彰化縣,芳苑鄉,三成村,743,1,678,6,684,996,3,1,3,0,1,0,68.67
彰化縣,芳苑鄉,福榮村,744,1,450,6,456,675,3,1,3,0,1,0,67.56
彰化縣,芳苑鄉,頂部村,745,1,367,4,371,606,3,1,3,0,1,0,61.22
彰化縣,芳苑鄉,王功村,746,1,735,11,746,1184,3,1,3,0,1,0,63.01
彰化縣,芳苑鄉,王功村,747,1,560,9,569,905,3,1,3,0,1,0,62.87
彰化縣,芳苑鄉,博愛村,748,1,547,6,553,795,3,1,3,0,1,0,69.56
彰化縣,芳苑鄉,和平村,749,1,507,4,511,804,3,1,3,0,1,0,63.56
彰化縣,芳苑鄉,興仁村,750,1,871,12,883,1389,3,1,3,0,1,0,63.57
彰化縣,芳苑鄉,民生村,751,1,470,3,473,782,3,1,3,0,1,0,60.49
彰化縣,芳苑鄉,新寶村,752,1,960,10,970,1368,3,1,3,0,1,0,70.91
彰化縣,芳苑鄉,五俊村,753,1,294,5,299,547,3,1,3,0,1,0,54.66
彰化縣,芳苑鄉,草湖村,754,1,1016,7,1023,1438,3,1,3,0,1,0,71.14
彰化縣,芳苑鄉,建平村,755,1,612,5,617,913,3,1,3,0,1,0,67.58
彰化縣,芳苑鄉,建平村,756,1,768,9,777,1166,3,1,3,0,1,0,66.64
彰化縣,芳苑鄉,崙腳村,757,1,505,0,505,721,3,1,3,0,1,0,70.04
彰化縣,芳苑鄉,文津村,758,1,738,5,743,1042,3,1,3,0,1,0,71.31
彰化縣,芳苑鄉,新生村,759,1,883,4,887,1349,3,1,3,0,1,0,65.75
彰化縣,芳苑鄉,漢寶村,760,1,1118,11,1129,1598,3,1,3,0,1,0,70.65
彰化縣,芳苑鄉,漢寶村,761,1,877,9,886,1335,3,1,3,0,1,0,66.37
彰化縣,大城鄉,潭墘村,762,1,833,10,843,1313,3,1,3,0,1,0,64.20
彰化縣,大城鄉,山腳村,763,1,892,18,910,1426,3,1,3,0,1,0,63.81
彰化縣,大城鄉,西城村,764,1,573,6,579,869,3,1,3,0,1,0,66.63
彰化縣,大城鄉,東城村,765,1,803,8,811,1265,3,1,3,0,1,0,64.11
彰化縣,大城鄉,大城村,766,1,689,8,697,1062,3,1,3,0,1,0,65.63
彰化縣,大城鄉,上山村,767,1,411,3,414,643,3,1,3,0,1,0,64.39
彰化縣,大城鄉,上山村,768,1,406,4,410,562,3,1,3,0,1,0,72.95
彰化縣,大城鄉,永和村,769,1,509,4,513,767,3,1,3,0,1,0,66.88
彰化縣,大城鄉,公館村,770,1,289,3,292,454,3,1,3,0,1,0,64.32
彰化縣,大城鄉,公館村,771,1,438,3,441,761,3,1,3,0,1,0,57.95
彰化縣,大城鄉,豐美村,772,1,610,7,617,904,3,1,3,0,1,0,68.25
彰化縣,大城鄉,三豐村,773,1,433,5,438,747,3,1,3,0,1,0,58.63
彰化縣,大城鄉,菜寮村,774,1,792,9,801,1168,3,1,3,0,1,0,68.58
彰化縣,大城鄉,東港村,775,1,843,7,850,1328,3,1,3,0,1,0,64.01
彰化縣,大城鄉,西港村,776,1,610,9,619,1067,3,1,3,0,1,0,58.01
彰化縣,大城鄉,頂庄村,777,1,455,2,457,803,3,1,3,0,1,0,56.91
彰化縣,大城鄉,臺西村,778,1,593,6,599,1001,3,1,3,0,1,0,59.84
彰化縣,竹塘鄉,竹元村,779,1,749,9,758,1100,3,1,3,0,1,0,68.91
彰化縣,竹塘鄉,竹塘村,780,1,1205,25,1230,1725,3,1,3,0,1,0,71.30
彰化縣,竹塘鄉,小西村,781,1,564,3,567,804,3,1,3,0,1,0,70.52
彰化縣,竹塘鄉,民靖村,782,1,522,5,527,798,3,1,3,0,1,0,66.04
彰化縣,竹塘鄉,五庄村,783,1,1081,14,1095,1512,3,1,3,0,1,0,72.42
彰化縣,竹塘鄉,樹腳村,784,1,465,6,471,655,3,1,3,0,1,0,71.91
彰化縣,竹塘鄉,田頭村,785,1,685,2,687,971,3,1,3,0,1,0,70.75
彰化縣,竹塘鄉,新廣村,786,1,803,13,816,1163,3,1,3,0,1,0,70.16
彰化縣,竹塘鄉,溪墘村,787,1,356,2,358,555,3,1,3,0,1,0,64.50
彰化縣,竹塘鄉,竹林村,788,1,611,5,616,889,3,1,3,0,1,0,69.29
彰化縣,竹塘鄉,土庫村,789,1,460,2,462,719,3,1,3,0,1,0,64.26
彰化縣,竹塘鄉,內新村,790,1,423,3,426,655,3,1,3,0,1,0,65.04
彰化縣,竹塘鄉,長安村,791,1,537,3,540,784,3,1,3,0,1,0,68.88
彰化縣,竹塘鄉,永安村,792,1,441,0,441,677,3,1,3,0,1,0,65.14
南投縣,南投市,龍泉里,1,1,564,4,568,942,3,1,3,0,1,0,60.30
南投縣,南投市,康壽里,2,1,849,4,853,1377,3,1,3,0,1,0,61.95
南投縣,南投市,三民里,3,1,557,2,559,813,3,1,3,0,1,0,68.76
南投縣,南投市,仁和里,4,1,378,0,378,547,3,1,3,0,1,0,69.10
南投縣,南投市,南投里,5,1,424,2,426,677,3,1,3,0,1,0,62.92
南投縣,南投市,彰仁里,6,1,306,0,306,440,3,1,3,0,1,0,69.55
南投縣,南投市,崇文里,7,1,654,1,655,1036,3,1,3,0,1,0,63.22
南投縣,南投市,三興里,8,1,783,7,790,1408,3,1,3,0,1,0,56.11
南投縣,南投市,三興里,9,1,838,5,843,1439,3,1,3,0,1,0,58.58
南投縣,南投市,三興里,10,1,883,9,892,1497,3,1,3,0,1,0,59.59
南投縣,南投市,三和里,11,1,773,10,783,1311,3,1,3,0,1,0,59.73
南投縣,南投市,三和里,12,1,941,5,946,1456,3,1,3,0,1,0,64.97
南投縣,南投市,嘉興里,13,1,1178,12,1190,1799,3,1,3,0,1,0,66.15
南投縣,南投市,嘉和里,14,1,1024,11,1035,1698,3,1,3,0,1,0,60.95
南投縣,南投市,嘉和里,15,1,924,11,935,1619,3,1,3,0,1,0,57.75
南投縣,南投市,平和里,16,1,656,2,658,1180,3,1,3,0,1,0,55.76
南投縣,南投市,平和里,17,1,795,5,800,1316,3,1,3,0,1,0,60.79
南投縣,南投市,平和里,18,1,793,2,795,1293,3,1,3,0,1,0,61.48
南投縣,南投市,平和里,19,1,799,2,801,1377,3,1,3,0,1,0,58.17
南投縣,南投市,振興里,20,1,355,2,357,547,3,1,3,0,1,0,65.27
南投縣,南投市,振興里,21,1,880,3,883,1441,3,1,3,0,1,0,61.28
南投縣,南投市,千秋里,22,1,517,2,519,884,3,1,3,0,1,0,58.71
南投縣,南投市,軍功里,23,1,1074,13,1087,1768,3,1,3,0,1,0,61.48
南投縣,南投市,軍功里,24,1,966,6,972,1759,3,1,3,0,1,0,55.26
南投縣,南投市,軍功里,25,1,240,2,242,354,3,1,3,0,1,0,68.36
南投縣,南投市,東山里,26,1,234,3,237,406,3,1,3,0,1,0,58.37
南投縣,南投市,營南里,27,1,688,5,693,1078,3,1,3,0,1,0,64.29
南投縣,南投市,營南里,28,1,571,0,571,908,3,1,3,0,1,0,62.89
南投縣,南投市,營北里,29,1,973,4,977,1589,3,1,3,0,1,0,61.49
南投縣,南投市,營北里,30,1,1113,8,1121,1719,3,1,3,0,1,0,65.21
南投縣,南投市,營北里,31,1,983,7,990,1550,3,1,3,0,1,0,63.87
南投縣,南投市,內興里,32,1,684,4,688,1096,3,1,3,0,1,0,62.77
南投縣,南投市,內興里,33,1,865,6,871,1458,3,1,3,0,1,0,59.74
南投縣,南投市,內興里,34,1,1124,3,1127,1901,3,1,3,0,1,0,59.28
南投縣,南投市,內興里,35,1,366,4,370,587,3,1,3,0,1,0,63.03
南投縣,南投市,內新里,36,1,863,9,872,1361,3,1,3,0,1,0,64.07
南投縣,南投市,光輝里,37,1,334,3,337,575,3,1,3,0,1,0,58.61
南投縣,南投市,光榮里,38,1,477,2,479,723,3,1,3,0,1,0,66.25
南投縣,南投市,光榮里,39,1,655,2,657,1033,3,1,3,0,1,0,63.60
南投縣,南投市,光明里,40,1,632,2,634,924,3,1,3,0,1,0,68.61
南投縣,南投市,光明里,41,1,603,3,606,875,3,1,3,0,1,0,69.26
南投縣,南投市,光華里,42,1,452,3,455,682,3,1,3,0,1,0,66.72
南投縣,南投市,光華里,43,1,529,5,534,775,3,1,3,0,1,0,68.90
南投縣,南投市,漳興里,44,1,623,4,627,1055,3,1,3,0,1,0,59.43
南投縣,南投市,漳興里,45,1,802,4,806,1283,3,1,3,0,1,0,62.82
南投縣,南投市,漳和里,46,1,731,9,740,1272,3,1,3,0,1,0,58.18
南投縣,南投市,漳和里,47,1,1070,7,1077,1845,3,1,3,0,1,0,58.37
南投縣,南投市,漳和里,48,1,778,8,786,1191,3,1,3,0,1,0,65.99
南投縣,南投市,漳和里,49,1,888,3,891,1571,3,1,3,0,1,0,56.72
南投縣,南投市,平山里,50,1,852,15,867,1585,3,1,3,0,1,0,54.70
南投縣,南投市,平山里,51,1,764,7,771,1313,3,1,3,0,1,0,58.72
南投縣,南投市,平山里,52,1,688,6,694,1255,3,1,3,0,1,0,55.3
南投縣,南投市,新興里,53,1,1070,10,1080,1945,3,1,3,0,1,0,55.53
南投縣,南投市,新興里,54,1,1067,9,1076,1904,3,1,3,0,1,0,56.51
南投縣,南投市,永豐里,55,1,759,6,765,1268,3,1,3,0,1,0,60.33
南投縣,南投市,永豐里,56,1,646,6,652,1196,3,1,3,0,1,0,54.52
南投縣,南投市,福興里,57,1,790,11,801,1307,3,1,3,0,1,0,61.29
南投縣,南投市,福興里,58,1,687,3,690,1200,3,1,3,0,1,0,57.50
南投縣,南投市,鳳山里,59,1,665,3,668,1234,3,1,3,0,1,0,54.13
南投縣,南投市,永興里,60,1,473,9,482,744,3,1,3,0,1,0,64.78
南投縣,南投市,鳳鳴里,61,1,422,4,426,719,3,1,3,0,1,0,59.25
南投縣,南投市,福山里,62,1,981,3,984,1780,3,1,3,0,1,0,55.28
南投縣,埔里鎮,東門里,63,1,457,3,460,855,3,1,3,0,1,0,53.80
南投縣,埔里鎮,東門里,64,1,514,3,517,888,3,1,3,0,1,0,58.22
南投縣,埔里鎮,東門里,65,1,619,3,622,1177,3,1,3,0,1,0,52.85
南投縣,埔里鎮,西門里,66,1,547,2,549,986,3,1,3,0,1,0,55.68
南投縣,埔里鎮,西門里,67,1,525,3,528,1030,3,1,3,0,1,0,51.26
南投縣,埔里鎮,西門里,68,1,558,3,561,1061,3,1,3,0,1,0,52.87
南投縣,埔里鎮,南門里,69,1,538,8,546,909,3,1,3,0,1,0,60.07
南投縣,埔里鎮,北門里,70,1,664,5,669,1226,3,1,3,0,1,0,54.57
南投縣,埔里鎮,北門里,71,1,585,6,591,1149,3,1,3,0,1,0,51.44
南投縣,埔里鎮,北安里,72,1,931,6,937,1638,3,1,3,0,1,0,57.20
南投縣,埔里鎮,北安里,73,1,806,5,811,1495,3,1,3,0,1,0,54.25
南投縣,埔里鎮,泰安里,74,1,549,5,554,979,3,1,3,0,1,0,56.59
南投縣,埔里鎮,泰安里,75,1,506,2,508,946,3,1,3,0,1,0,53.70
南投縣,埔里鎮,北梅里,76,1,501,4,505,1007,3,1,3,0,1,0,50.15
南投縣,埔里鎮,北梅里,77,1,612,6,618,1157,3,1,3,0,1,0,53.41
南投縣,埔里鎮,同聲里,78,1,665,4,669,1188,3,1,3,0,1,0,56.31
南投縣,埔里鎮,同聲里,79,1,566,4,570,1058,3,1,3,0,1,0,53.88
南投縣,埔里鎮,清新里,80,1,538,4,542,1015,3,1,3,0,1,0,53.40
南投縣,埔里鎮,清新里,81,1,546,2,548,1008,3,1,3,0,1,0,54.37
南投縣,埔里鎮,清新里,82,1,680,5,685,1431,3,1,3,0,1,0,47.87
南投縣,埔里鎮,薰化里,83,1,728,4,732,1181,3,1,3,0,1,0,61.98
南投縣,埔里鎮,大城里,84,1,736,6,742,1395,3,1,3,0,1,0,53.19
南投縣,埔里鎮,大城里,85,1,765,8,773,1379,3,1,3,0,1,0,56.06
南投縣,埔里鎮,大城里,86,1,645,1,646,1241,3,1,3,0,1,0,52.05
南投縣,埔里鎮,大城里,87,1,790,5,795,1616,3,1,3,0,1,0,49.20
南投縣,埔里鎮,籃城里,88,1,554,1,555,940,3,1,3,0,1,0,59.04
南投縣,埔里鎮,杷城里,89,1,602,3,605,1089,3,1,3,0,1,0,55.56
南投縣,埔里鎮,杷城里,90,1,610,5,615,1193,3,1,3,0,1,0,51.55
南投縣,埔里鎮,枇杷里,91,1,644,7,651,1342,3,1,3,0,1,0,48.51
南投縣,埔里鎮,枇杷里,92,1,370,1,371,705,3,1,3,0,1,0,52.62
南投縣,埔里鎮,枇杷里,93,1,605,10,615,1222,3,1,3,0,1,0,50.33
南投縣,埔里鎮,枇杷里,94,1,807,5,812,1538,3,1,3,0,1,0,52.80
南投縣,埔里鎮,枇杷里,95,1,476,2,478,990,3,1,3,0,1,0,48.28
南投縣,埔里鎮,水頭里,96,1,480,4,484,945,3,1,3,0,1,0,51.22
南投縣,埔里鎮,水頭里,97,1,426,4,430,946,3,1,3,0,1,0,45.45
南投縣,埔里鎮,水頭里,98,1,571,6,577,1160,3,1,3,0,1,0,49.74
南投縣,埔里鎮,麒麟里,99,1,522,6,528,996,3,1,3,0,1,0,53.01
南投縣,埔里鎮,珠格里,100,1,528,6,534,972,3,1,3,0,1,0,54.94
南投縣,埔里鎮,溪南里,101,1,535,9,544,904,3,1,3,0,1,0,60.18
南投縣,埔里鎮,桃米里,102,1,542,3,545,1023,3,1,3,0,1,0,53.27
南投縣,埔里鎮,成功里,103,1,205,1,206,372,3,1,3,0,1,0,55.38
南投縣,埔里鎮,南村里,104,1,619,4,623,1277,3,1,3,0,1,0,48.79
南投縣,埔里鎮,愛蘭里,105,1,708,5,713,1313,3,1,3,0,1,0,54.30
南投縣,埔里鎮,鐵山里,106,1,808,5,813,1542,3,1,3,0,1,0,52.72
南投縣,埔里鎮,房里里,107,1,489,3,492,875,3,1,3,0,1,0,56.23
南投縣,埔里鎮,房里里,108,1,174,0,174,337,3,1,3,0,1,0,51.63
南投縣,埔里鎮,向善里,109,1,419,2,421,659,3,1,3,0,1,0,63.88
南投縣,埔里鎮,一新里,110,1,434,2,436,794,3,1,3,0,1,0,54.91
南投縣,埔里鎮,合成里,111,1,739,3,742,1293,3,1,3,0,1,0,57.39
南投縣,埔里鎮,合成里,112,1,152,0,152,254,3,1,3,0,1,0,59.84
南投縣,埔里鎮,廣成里,113,1,676,10,686,1195,3,1,3,0,1,0,57.41
南投縣,埔里鎮,史港里,114,1,415,0,415,674,3,1,3,0,1,0,61.57
南投縣,埔里鎮,福興里,115,1,477,7,484,973,3,1,3,0,1,0,49.74
南投縣,埔里鎮,牛眠里,116,1,616,4,620,1090,3,1,3,0,1,0,56.88
南投縣,埔里鎮,牛眠里,117,1,744,11,755,1332,3,1,3,0,1,0,56.68
南投縣,埔里鎮,大湳里,118,1,633,4,637,1154,3,1,3,0,1,0,55.20
南投縣,埔里鎮,蜈蚣里,119,1,571,2,573,1030,3,1,3,0,1,0,55.63
南投縣,埔里鎮,蜈蚣里,120,1,471,4,475,892,3,1,3,0,1,0,53.25
南投縣,埔里鎮,蜈蚣里,121,1,298,4,302,549,3,1,3,0,1,0,55.01
南投縣,草屯鎮,玉峰里,122,1,510,6,516,870,3,1,3,0,1,0,59.31
南投縣,草屯鎮,玉峰里,123,1,686,5,691,1116,3,1,3,0,1,0,61.92
南投縣,草屯鎮,明正里,124,1,1063,10,1073,1730,3,1,3,0,1,0,62.02
南投縣,草屯鎮,明正里,125,1,1016,4,1020,1745,3,1,3,0,1,0,58.45
南投縣,草屯鎮,炎峰里,126,1,602,5,607,925,3,1,3,0,1,0,65.62
南投縣,草屯鎮,炎峰里,127,1,682,3,685,1108,3,1,3,0,1,0,61.82
南投縣,草屯鎮,中正里,128,1,458,7,465,717,3,1,3,0,1,0,64.85
南投縣,草屯鎮,和平里,129,1,773,4,777,1256,3,1,3,0,1,0,61.86
南投縣,草屯鎮,中山里,130,1,587,2,589,917,3,1,3,0,1,0,64.23
南投縣,草屯鎮,中山里,131,1,787,7,794,1332,3,1,3,0,1,0,59.61
南投縣,草屯鎮,敦和里,132,1,669,4,673,1166,3,1,3,0,1,0,57.72
南投縣,草屯鎮,敦和里,133,1,782,9,791,1389,3,1,3,0,1,0,56.95
南投縣,草屯鎮,敦和里,134,1,735,5,740,1287,3,1,3,0,1,0,57.50
南投縣,草屯鎮,敦和里,135,1,932,8,940,1581,3,1,3,0,1,0,59.46
南投縣,草屯鎮,山腳里,136,1,975,6,981,1672,3,1,3,0,1,0,58.67
南投縣,草屯鎮,山腳里,137,1,912,5,917,1573,3,1,3,0,1,0,58.3
南投縣,草屯鎮,山腳里,138,1,814,2,816,1340,3,1,3,0,1,0,60.90
南投縣,草屯鎮,山腳里,139,1,966,1,967,1568,3,1,3,0,1,0,61.67
南投縣,草屯鎮,新厝里,140,1,860,3,863,1359,3,1,3,0,1,0,63.50
南投縣,草屯鎮,新厝里,141,1,804,6,810,1392,3,1,3,0,1,0,58.19
南投縣,草屯鎮,上林里,142,1,885,6,891,1498,3,1,3,0,1,0,59.48
南投縣,草屯鎮,上林里,143,1,596,6,602,979,3,1,3,0,1,0,61.49
南投縣,草屯鎮,碧峰里,144,1,659,7,666,1102,3,1,3,0,1,0,60.44
南投縣,草屯鎮,碧峰里,145,1,720,6,726,1208,3,1,3,0,1,0,60.1
南投縣,草屯鎮,碧峰里,146,1,580,3,583,1194,3,1,3,0,1,0,48.83
南投縣,草屯鎮,碧洲里,147,1,693,4,697,1087,3,1,3,0,1,0,64.12
南投縣,草屯鎮,碧洲里,148,1,447,2,449,734,3,1,3,0,1,0,61.17
南投縣,草屯鎮,復興里,149,1,729,13,742,1263,3,1,3,0,1,0,58.75
南投縣,草屯鎮,復興里,150,1,868,6,874,1548,3,1,3,0,1,0,56.46
南投縣,草屯鎮,御史里,151,1,811,7,818,1407,3,1,3,0,1,0,58.14
南投縣,草屯鎮,御史里,152,1,914,6,920,1672,3,1,3,0,1,0,55.02
南投縣,草屯鎮,御史里,153,1,443,7,450,818,3,1,3,0,1,0,55.01
南投縣,草屯鎮,御史里,154,1,657,6,663,1221,3,1,3,0,1,0,54.30
南投縣,草屯鎮,新豐里,155,1,786,2,788,1290,3,1,3,0,1,0,61.09
南投縣,草屯鎮,新豐里,156,1,656,5,661,1111,3,1,3,0,1,0,59.50
南投縣,草屯鎮,新豐里,157,1,549,3,552,978,3,1,3,0,1,0,56.44
南投縣,草屯鎮,新庄里,158,1,876,6,882,1496,3,1,3,0,1,0,58.96
南投縣,草屯鎮,新庄里,159,1,813,7,820,1426,3,1,3,0,1,0,57.50
南投縣,草屯鎮,加老里,160,1,460,7,467,727,3,1,3,0,1,0,64.24
南投縣,草屯鎮,加老里,161,1,824,4,828,1318,3,1,3,0,1,0,62.82
南投縣,草屯鎮,石川里,162,1,748,12,760,1240,3,1,3,0,1,0,61.29
南投縣,草屯鎮,北投里,163,1,737,5,742,1170,3,1,3,0,1,0,63.42
南投縣,草屯鎮,北投里,164,1,694,7,701,1237,3,1,3,0,1,0,56.67
南投縣,草屯鎮,富寮里,165,1,939,2,941,1534,3,1,3,0,1,0,61.34
南投縣,草屯鎮,富寮里,166,1,795,7,802,1460,3,1,3,0,1,0,54.93
南投縣,草屯鎮,富寮里,167,1,579,3,582,1011,3,1,3,0,1,0,57.57
南投縣,草屯鎮,富寮里,168,1,318,0,318,520,3,1,3,0,1,0,61.15
南投縣,草屯鎮,北勢里,169,1,868,7,875,1426,3,1,3,0,1,0,61.36
南投縣,草屯鎮,北勢里,170,1,273,1,274,483,3,1,3,0,1,0,56.73
南投縣,草屯鎮,中原里,171,1,633,3,636,1087,3,1,3,0,1,0,58.51
南投縣,草屯鎮,中原里,172,1,464,10,474,823,3,1,3,0,1,0,57.59
南投縣,草屯鎮,南埔里,173,1,840,5,845,1426,3,1,3,0,1,0,59.26
南投縣,草屯鎮,南埔里,174,1,624,4,628,1091,3,1,3,0,1,0,57.56
南投縣,草屯鎮,南埔里,175,1,592,4,596,962,3,1,3,0,1,0,61.95
南投縣,草屯鎮,坪頂里,176,1,580,4,584,923,3,1,3,0,1,0,63.27
南投縣,草屯鎮,土城里,177,1,342,7,349,641,3,1,3,0,1,0,54.45
南投縣,草屯鎮,土城里,178,1,561,10,571,1020,3,1,3,0,1,0,55.98
南投縣,草屯鎮,平林里,179,1,601,3,604,1019,3,1,3,0,1,0,59.27
南投縣,草屯鎮,雙冬里,180,1,602,10,612,1125,3,1,3,0,1,0,54.40
南投縣,草屯鎮,雙冬里,181,1,669,4,673,1167,3,1,3,0,1,0,57.67
南投縣,竹山鎮,竹山里,182,1,730,2,732,1213,3,1,3,0,1,0,60.35
南投縣,竹山鎮,竹山里,183,1,551,1,552,893,3,1,3,0,1,0,61.81
南投縣,竹山鎮,中正里,184,1,446,2,448,689,3,1,3,0,1,0,65.02
南投縣,竹山鎮,中山里,185,1,620,3,623,1099,3,1,3,0,1,0,56.69
南投縣,竹山鎮,中山里,186,1,771,5,776,1441,3,1,3,0,1,0,53.85
南投縣,竹山鎮,中山里,187,1,981,10,991,1883,3,1,3,0,1,0,52.63
南投縣,竹山鎮,雲林里,188,1,800,6,806,1334,3,1,3,0,1,0,60.42
南投縣,竹山鎮,雲林里,189,1,1052,6,1058,1845,3,1,3,0,1,0,57.34
南投縣,竹山鎮,竹圍里,190,1,413,5,418,668,3,1,3,0,1,0,62.57
南投縣,竹山鎮,竹圍里,191,1,770,9,779,1520,3,1,3,0,1,0,51.25
南投縣,竹山鎮,桂林里,192,1,957,16,973,1765,3,1,3,0,1,0,55.13
南投縣,竹山鎮,桂林里,193,1,916,4,920,1627,3,1,3,0,1,0,56.55
南投縣,竹山鎮,下坪里,194,1,307,2,309,503,3,1,3,0,1,0,61.43
南投縣,竹山鎮,下坪里,195,1,316,1,317,548,3,1,3,0,1,0,57.85
南投縣,竹山鎮,中和里,196,1,663,1,664,1087,3,1,3,0,1,0,61.09
南投縣,竹山鎮,中崎里,197,1,752,4,756,1312,3,1,3,0,1,0,57.62
南投縣,竹山鎮,秀林里,198,1,150,2,152,244,3,1,3,0,1,0,62.30
南投縣,竹山鎮,秀林里,199,1,298,0,298,504,3,1,3,0,1,0,59.13
南投縣,竹山鎮,大鞍里,200,1,261,0,261,425,3,1,3,0,1,0,61.41
南投縣,竹山鎮,延和里,201,1,772,3,775,1477,3,1,3,0,1,0,52.47
南投縣,竹山鎮,延和里,202,1,836,4,840,1544,3,1,3,0,1,0,54.40
南投縣,竹山鎮,延和里,203,1,699,2,701,1256,3,1,3,0,1,0,55.81
南投縣,竹山鎮,延祥里,204,1,959,6,965,1792,3,1,3,0,1,0,53.85
南投縣,竹山鎮,延祥里,205,1,773,7,780,1499,3,1,3,0,1,0,52.03
南投縣,竹山鎮,延正里,206,1,503,1,504,865,3,1,3,0,1,0,58.27
南投縣,竹山鎮,延正里,207,1,443,5,448,778,3,1,3,0,1,0,57.58
南投縣,竹山鎮,延平里,208,1,653,6,659,1223,3,1,3,0,1,0,53.88
南投縣,竹山鎮,延平里,209,1,507,3,510,905,3,1,3,0,1,0,56.35
南投縣,竹山鎮,延平里,210,1,378,2,380,577,3,1,3,0,1,0,65.86
南投縣,竹山鎮,延山里,211,1,363,6,369,661,3,1,3,0,1,0,55.82
南投縣,竹山鎮,山崇里,212,1,600,6,606,1158,3,1,3,0,1,0,52.33
南投縣,竹山鎮,山崇里,213,1,354,1,355,672,3,1,3,0,1,0,52.83
南投縣,竹山鎮,社寮里,214,1,563,4,567,992,3,1,3,0,1,0,57.16
南投縣,竹山鎮,中央里,215,1,769,9,778,1322,3,1,3,0,1,0,58.85
南投縣,竹山鎮,富州里,216,1,399,4,403,715,3,1,3,0,1,0,56.36
南投縣,竹山鎮,田子里,217,1,275,3,278,436,3,1,3,0,1,0,63.76
南投縣,竹山鎮,田子里,218,1,90,0,90,182,3,1,3,0,1,0,49.45
南投縣,竹山鎮,回窯里,219,1,814,7,821,1459,3,1,3,0,1,0,56.27
南投縣,竹山鎮,德興里,220,1,221,2,223,384,3,1,3,0,1,0,58.07
南投縣,竹山鎮,德興里,221,1,346,1,347,505,3,1,3,0,1,0,68.71
南投縣,竹山鎮,福興里,222,1,123,0,123,205,3,1,3,0,1,0,60.00
南投縣,竹山鎮,福興里,223,1,222,1,223,370,3,1,3,0,1,0,60.27
南投縣,竹山鎮,鯉魚里,224,1,288,0,288,518,3,1,3,0,1,0,55.60
南投縣,竹山鎮,鯉魚里,225,1,188,0,188,349,3,1,3,0,1,0,53.87
南投縣,竹山鎮,坪頂里,226,1,275,4,279,532,3,1,3,0,1,0,52.44
南投縣,竹山鎮,瑞竹里,227,1,401,3,404,710,3,1,3,0,1,0,56.90
南投縣,竹山鎮,桶頭里,228,1,297,4,301,581,3,1,3,0,1,0,51.81
南投縣,竹山鎮,桶頭里,229,1,233,2,235,456,3,1,3,0,1,0,51.54
南投縣,集集鎮,集集里,230,1,587,7,594,951,3,1,3,0,1,0,62.46
南投縣,集集鎮,和平里,231,1,542,4,546,932,3,1,3,0,1,0,58.58
南投縣,集集鎮,林尾里,232,1,339,1,340,558,3,1,3,0,1,0,60.93
南投縣,集集鎮,田寮里,233,1,644,11,655,1219,3,1,3,0,1,0,53.73
南投縣,集集鎮,隘寮里,234,1,365,1,366,562,3,1,3,0,1,0,65.12
南投縣,集集鎮,玉映里,235,1,288,1,289,448,3,1,3,0,1,0,64.51
南投縣,集集鎮,吳厝里,236,1,601,3,604,894,3,1,3,0,1,0,67.56
南投縣,集集鎮,八張里,237,1,766,6,772,1401,3,1,3,0,1,0,55.10
南投縣,集集鎮,永昌里,238,1,542,1,543,907,3,1,3,0,1,0,59.87
南投縣,集集鎮,廣明里,239,1,327,0,327,622,3,1,3,0,1,0,52.57
南投縣,集集鎮,廣明里,240,1,226,2,228,442,3,1,3,0,1,0,51.58
南投縣,集集鎮,富山里,241,1,211,1,212,414,3,1,3,0,1,0,51.21
南投縣,名間鄉,南雅村,242,1,557,4,561,1018,3,1,3,0,1,0,55.11
南投縣,名間鄉,中正村,243,1,683,7,690,1288,3,1,3,0,1,0,53.57
南投縣,名間鄉,中正村,244,1,913,7,920,1665,3,1,3,0,1,0,55.26
南投縣,名間鄉,中山村,245,1,387,3,390,759,3,1,3,0,1,0,51.38
南投縣,名間鄉,中山村,246,1,726,5,731,1265,3,1,3,0,1,0,57.79
南投縣,名間鄉,濁水村,247,1,860,5,865,1557,3,1,3,0,1,0,55.56
南投縣,名間鄉,新民村,248,1,607,4,611,1031,3,1,3,0,1,0,59.26
南投縣,名間鄉,炭寮村,249,1,605,3,608,1003,3,1,3,0,1,0,60.62
南投縣,名間鄉,新街村,250,1,972,6,978,1654,3,1,3,0,1,0,59.13
南投縣,名間鄉,新街村,251,1,529,2,531,905,3,1,3,0,1,0,58.67
南投縣,名間鄉,新街村,252,1,566,3,569,1087,3,1,3,0,1,0,52.35
南投縣,名間鄉,東湖村,253,1,460,4,464,789,3,1,3,0,1,0,58.81
南投縣,名間鄉,東湖村,254,1,438,3,441,840,3,1,3,0,1,0,52.50
南投縣,名間鄉,仁和村,255,1,497,8,505,850,3,1,3,0,1,0,59.41
南投縣,名間鄉,萬丹村,256,1,611,12,623,988,3,1,3,0,1,0,63.06
南投縣,名間鄉,田仔村,257,1,618,5,623,1044,3,1,3,0,1,0,59.67
南投縣,名間鄉,田仔村,258,1,478,5,483,836,3,1,3,0,1,0,57.78
南投縣,名間鄉,大庄村,259,1,605,9,614,1025,3,1,3,0,1,0,59.9
南投縣,名間鄉,大庄村,260,1,532,3,535,929,3,1,3,0,1,0,57.59
南投縣,名間鄉,部下村,261,1,431,5,436,757,3,1,3,0,1,0,57.60
南投縣,名間鄉,赤水村,262,1,431,3,434,686,3,1,3,0,1,0,63.27
南投縣,名間鄉,赤水村,263,1,327,4,331,557,3,1,3,0,1,0,59.43
南投縣,名間鄉,竹圍村,264,1,549,9,558,932,3,1,3,0,1,0,59.87
南投縣,名間鄉,三崙村,265,1,586,10,596,1029,3,1,3,0,1,0,57.92
南投縣,名間鄉,三崙村,266,1,269,4,273,457,3,1,3,0,1,0,59.74
南投縣,名間鄉,松山村,267,1,766,4,770,1497,3,1,3,0,1,0,51.44
南投縣,名間鄉,松柏村,268,1,641,9,650,1132,3,1,3,0,1,0,57.42
南投縣,名間鄉,崁腳村,269,1,469,6,475,808,3,1,3,0,1,0,58.79
南投縣,名間鄉,埔中村,270,1,516,6,522,880,3,1,3,0,1,0,59.32
南投縣,名間鄉,新厝村,271,1,459,3,462,814,3,1,3,0,1,0,56.76
南投縣,名間鄉,新光村,272,1,468,4,472,767,3,1,3,0,1,0,61.54
南投縣,名間鄉,新光村,273,1,512,8,520,870,3,1,3,0,1,0,59.77
南投縣,鹿谷鄉,初鄉村,274,1,812,7,819,1573,3,1,3,0,1,0,52.07
南投縣,鹿谷鄉,鹿谷村,275,1,990,6,996,1672,3,1,3,0,1,0,59.57
南投縣,鹿谷鄉,彰雅村,276,1,505,3,508,764,3,1,3,0,1,0,66.49
南投縣,鹿谷鄉,彰雅村,277,1,244,0,244,416,3,1,3,0,1,0,58.65
南投縣,鹿谷鄉,廣興村,278,1,534,8,542,773,3,1,3,0,1,0,70.12
南投縣,鹿谷鄉,廣興村,279,1,692,3,695,1073,3,1,3,0,1,0,64.77
南投縣,鹿谷鄉,內湖村,280,1,319,2,321,566,3,1,3,0,1,0,56.71
南投縣,鹿谷鄉,內湖村,281,1,273,1,274,451,3,1,3,0,1,0,60.75
南投縣,鹿谷鄉,和雅村,282,1,382,1,383,603,3,1,3,0,1,0,63.52
南投縣,鹿谷鄉,竹林村,283,1,861,3,864,1524,3,1,3,0,1,0,56.69
南投縣,鹿谷鄉,竹豐村,284,1,539,5,544,895,3,1,3,0,1,0,60.78
南投縣,鹿谷鄉,鳳凰村,285,1,804,5,809,1352,3,1,3,0,1,0,59.84
南投縣,鹿谷鄉,永隆村,286,1,847,3,850,1343,3,1,3,0,1,0,63.29
南投縣,鹿谷鄉,秀峰村,287,1,316,3,319,642,3,1,3,0,1,0,49.69
南投縣,鹿谷鄉,秀峰村,288,1,237,0,237,428,3,1,3,0,1,0,55.37
南投縣,鹿谷鄉,清水村,289,1,417,3,420,714,3,1,3,0,1,0,58.82
南投縣,鹿谷鄉,瑞田村,290,1,397,0,397,768,3,1,3,0,1,0,51.69
南投縣,中寮鄉,廣興村,291,1,473,7,480,840,3,1,3,0,1,0,57.14
南投縣,中寮鄉,崁頂村,292,1,154,3,157,271,3,1,3,0,1,0,57.93
南投縣,中寮鄉,崁頂村,293,1,130,3,133,245,3,1,3,0,1,0,54.29
南投縣,中寮鄉,八仙村,294,1,220,1,221,375,3,1,3,0,1,0,58.93
南投縣,中寮鄉,八仙村,295,1,210,0,210,359,3,1,3,0,1,0,58.5
南投縣,中寮鄉,福盛村,296,1,258,1,259,436,3,1,3,0,1,0,59.4
南投縣,中寮鄉,福盛村,297,1,169,2,171,356,3,1,3,0,1,0,48.03
南投縣,中寮鄉,和興村,298,1,369,5,374,683,3,1,3,0,1,0,54.76
南投縣,中寮鄉,永平村,299,1,528,6,534,974,3,1,3,0,1,0,54.83
南投縣,中寮鄉,永平村,300,1,462,1,463,781,3,1,3,0,1,0,59.28
南投縣,中寮鄉,復興村,301,1,145,0,145,263,3,1,3,0,1,0,55.13
南投縣,中寮鄉,中寮村,302,1,425,2,427,711,3,1,3,0,1,0,60.06
南投縣,中寮鄉,廣福村,303,1,303,3,306,545,3,1,3,0,1,0,56.15
南投縣,中寮鄉,永福村,304,1,216,3,219,366,3,1,3,0,1,0,59.84
南投縣,中寮鄉,永福村,305,1,441,4,445,790,3,1,3,0,1,0,56.33
南投縣,中寮鄉,義和村,306,1,280,3,283,470,3,1,3,0,1,0,60.21
南投縣,中寮鄉,義和村,307,1,363,7,370,640,3,1,3,0,1,0,57.81
南投縣,中寮鄉,清水村,308,1,534,4,538,945,3,1,3,0,1,0,56.93
南投縣,中寮鄉,內城村,309,1,253,4,257,470,3,1,3,0,1,0,54.68
南投縣,中寮鄉,龍安村,310,1,430,1,431,706,3,1,3,0,1,0,61.05
南投縣,中寮鄉,爽文村,311,1,314,4,318,538,3,1,3,0,1,0,59.11
南投縣,中寮鄉,龍岩村,312,1,357,3,360,673,3,1,3,0,1,0,53.49
南投縣,中寮鄉,永芳村,313,1,283,1,284,436,3,1,3,0,1,0,65.14
南投縣,中寮鄉,永和村,314,1,324,3,327,543,3,1,3,0,1,0,60.22
南投縣,魚池鄉,魚池村,315,1,970,13,983,1894,3,1,3,0,1,0,51.9
南投縣,魚池鄉,東池村,316,1,785,10,795,1514,3,1,3,0,1,0,52.51
南投縣,魚池鄉,大林村,317,1,269,3,272,517,3,1,3,0,1,0,52.61
南投縣,魚池鄉,大林村,318,1,286,2,288,552,3,1,3,0,1,0,52.17
南投縣,魚池鄉,東光村,319,1,614,5,619,1224,3,1,3,0,1,0,50.57
南投縣,魚池鄉,共和村,320,1,144,1,145,228,3,1,3,0,1,0,63.6
南投縣,魚池鄉,共和村,321,1,247,2,249,519,3,1,3,0,1,0,47.98
南投縣,魚池鄉,共和村,322,1,101,2,103,200,3,1,3,0,1,0,51.5
南投縣,魚池鄉,新城村,323,1,388,4,392,746,3,1,3,0,1,0,52.55
南投縣,魚池鄉,新城村,324,1,161,1,162,286,3,1,3,0,1,0,56.64
南投縣,魚池鄉,新城村,325,1,161,1,162,290,3,1,3,0,1,0,55.86
南投縣,魚池鄉,大雁村,326,1,163,3,166,287,3,1,3,0,1,0,57.84
南投縣,魚池鄉,大雁村,327,1,198,1,199,378,3,1,3,0,1,0,52.65
南投縣,魚池鄉,五城村,328,1,323,1,324,553,3,1,3,0,1,0,58.59
南投縣,魚池鄉,五城村,329,1,103,1,104,168,3,1,3,0,1,0,61.9
南投縣,魚池鄉,中明村,330,1,336,2,338,638,3,1,3,0,1,0,52.98
南投縣,魚池鄉,中明村,331,1,212,1,213,382,3,1,3,0,1,0,55.76
南投縣,魚池鄉,水社村,332,1,405,4,409,809,3,1,3,0,1,0,50.56
南投縣,魚池鄉,日月村,333,1,257,1,258,522,3,1,3,0,1,0,49.43
南投縣,魚池鄉,頭社村,334,1,220,1,221,418,3,1,3,0,1,0,52.87
南投縣,魚池鄉,頭社村,335,1,313,5,318,535,3,1,3,0,1,0,59.44
南投縣,魚池鄉,武登村,336,1,245,1,246,425,3,1,3,0,1,0,57.88
南投縣,魚池鄉,武登村,337,1,168,0,168,314,3,1,3,0,1,0,53.5
南投縣,國姓鄉,國姓村,338,1,483,5,488,879,3,1,3,0,1,0,55.52
南投縣,國姓鄉,國姓村,339,1,385,0,385,751,3,1,3,0,1,0,51.26
南投縣,國姓鄉,石門村,340,1,433,1,434,879,3,1,3,0,1,0,49.37
南投縣,國姓鄉,石門村,341,1,454,4,458,802,3,1,3,0,1,0,57.11
南投縣,國姓鄉,大旗村,342,1,408,3,411,756,3,1,3,0,1,0,54.37
南投縣,國姓鄉,長流村,343,1,720,7,727,1503,3,1,3,0,1,0,48.37
南投縣,國姓鄉,長福村,344,1,337,7,344,694,3,1,3,0,1,0,49.57
南投縣,國姓鄉,長豐村,345,1,405,8,413,824,3,1,3,0,1,0,50.12
南投縣,國姓鄉,北港村,346,1,564,6,570,1075,3,1,3,0,1,0,53.02
南投縣,國姓鄉,北港村,347,1,391,5,396,902,3,1,3,0,1,0,43.9
南投縣,國姓鄉,福龜村,348,1,477,4,481,897,3,1,3,0,1,0,53.62
南投縣,國姓鄉,福龜村,349,1,510,13,523,947,3,1,3,0,1,0,55.23
南投縣,國姓鄉,乾溝村,350,1,462,3,465,854,3,1,3,0,1,0,54.45
南投縣,國姓鄉,柑林村,351,1,678,10,688,1198,3,1,3,0,1,0,57.43
南投縣,國姓鄉,大石村,352,1,390,5,395,754,3,1,3,0,1,0,52.39
南投縣,國姓鄉,北山村,353,1,619,5,624,1115,3,1,3,0,1,0,55.96
南投縣,國姓鄉,北山村,354,1,238,0,238,490,3,1,3,0,1,0,48.57
南投縣,國姓鄉,南港村,355,1,567,12,579,1193,3,1,3,0,1,0,48.53
南投縣,國姓鄉,南港村,356,1,347,3,350,677,3,1,3,0,1,0,51.7
南投縣,水里鄉,水里村,357,1,485,4,489,895,3,1,3,0,1,0,54.64
南投縣,水里鄉,新城村,358,1,295,2,297,555,3,1,3,0,1,0,53.51
南投縣,水里鄉,新城村,359,1,569,5,574,1069,3,1,3,0,1,0,53.7
南投縣,水里鄉,中央村,360,1,441,2,443,720,3,1,3,0,1,0,61.53
南投縣,水里鄉,城中村,361,1,602,3,605,1029,3,1,3,0,1,0,58.79
南投縣,水里鄉,農富村,362,1,298,3,301,529,3,1,3,0,1,0,56.9
南投縣,水里鄉,北埔村,363,1,560,2,562,990,3,1,3,0,1,0,56.77
南投縣,水里鄉,南光村,364,1,769,5,774,1391,3,1,3,0,1,0,55.64
南投縣,水里鄉,鉅工村,365,1,667,5,672,1061,3,1,3,0,1,0,63.34
南投縣,水里鄉,永豐村,366,1,797,4,801,1367,3,1,3,0,1,0,58.6
南投縣,水里鄉,民和村,367,1,518,7,525,1041,3,1,3,0,1,0,50.43
南投縣,水里鄉,頂崁村,368,1,582,4,586,1151,3,1,3,0,1,0,50.91
南投縣,水里鄉,新山村,369,1,182,2,184,370,3,1,3,0,1,0,49.73
南投縣,水里鄉,郡坑村,370,1,209,2,211,365,3,1,3,0,1,0,57.81
南投縣,水里鄉,上安村,371,1,592,3,595,1161,3,1,3,0,1,0,51.25
南投縣,水里鄉,興隆村,372,1,189,4,193,347,3,1,3,0,1,0,55.62
南投縣,水里鄉,永興村,373,1,213,2,215,361,3,1,3,0,1,0,59.56
南投縣,水里鄉,玉峰村,374,1,517,1,518,914,3,1,3,0,1,0,56.67
南投縣,水里鄉,車埕村,375,1,307,3,310,541,3,1,3,0,1,0,57.3
南投縣,水里鄉,新興村,376,1,367,3,370,690,3,1,3,0,1,0,53.62
南投縣,信義鄉,雙龍村,377,1,8,0,8,16,3,1,3,0,1,0,50
南投縣,信義鄉,地利村,378,1,40,0,40,76,3,1,3,0,1,0,52.63
南投縣,信義鄉,潭南村,379,1,13,0,13,33,3,1,3,0,1,0,39.39
南投縣,信義鄉,人和村,380,1,20,0,20,58,3,1,3,0,1,0,34.48
南投縣,信義鄉,人和村,381,1,69,0,69,164,3,1,3,0,1,0,42.07
南投縣,信義鄉,明德村,382,1,435,5,440,725,3,1,3,0,1,0,60.69
南投縣,信義鄉,明德村,383,1,206,1,207,375,3,1,3,0,1,0,55.2
南投縣,信義鄉,自強村,384,1,196,2,198,337,3,1,3,0,1,0,58.75
南投縣,信義鄉,自強村,385,1,256,3,259,408,3,1,3,0,1,0,63.48
南投縣,信義鄉,愛國村,386,1,311,7,318,530,3,1,3,0,1,0,60
南投縣,信義鄉,豐丘村,387,1,181,2,183,327,3,1,3,0,1,0,55.96
南投縣,信義鄉,新鄉村,388,1,32,0,32,63,3,1,3,0,1,0,50.79
南投縣,信義鄉,羅娜村,389,1,109,0,109,230,3,1,3,0,1,0,47.39
南投縣,信義鄉,望美村,390,1,13,0,13,33,3,1,3,0,1,0,39.39
南投縣,信義鄉,望美村,391,1,138,1,139,267,3,1,3,0,1,0,52.06
南投縣,信義鄉,同富村,392,1,568,3,571,924,3,1,3,0,1,0,61.8
南投縣,信義鄉,同富村,393,1,207,1,208,441,3,1,3,0,1,0,47.17
南投縣,信義鄉,神木村,394,1,233,5,238,470,3,1,3,0,1,0,50.64
南投縣,信義鄉,神木村,395,1,147,0,147,264,3,1,3,0,1,0,55.68
南投縣,信義鄉,東埔村,396,1,155,2,157,285,3,1,3,0,1,0,55.09
南投縣,仁愛鄉,南豐村,397,1,117,0,117,233,3,1,3,0,1,0,50.21
南投縣,仁愛鄉,南豐村,398,1,162,1,163,308,3,1,3,0,1,0,52.92
南投縣,仁愛鄉,大同村,399,1,247,0,247,516,3,1,3,0,1,0,47.87
南投縣,仁愛鄉,大同村,400,1,216,2,218,362,3,1,3,0,1,0,60.22
南投縣,仁愛鄉,大同村,401,1,127,1,128,229,3,1,3,0,1,0,55.9
南投縣,仁愛鄉,榮興村,402,1,46,0,46,76,3,1,3,0,1,0,60.53
南投縣,仁愛鄉,春陽村,403,1,34,0,34,66,3,1,3,0,1,0,51.52
南投縣,仁愛鄉,精英村,404,1,72,0,72,147,3,1,3,0,1,0,48.98
南投縣,仁愛鄉,精英村,405,1,4,0,4,19,3,1,3,0,1,0,21.05
南投縣,仁愛鄉,合作村,406,1,10,0,10,26,3,1,3,0,1,0,38.46
南投縣,仁愛鄉,發祥村,407,1,9,1,10,22,3,1,3,0,1,0,45.45
南投縣,仁愛鄉,發祥村,408,1,7,0,7,10,3,1,3,0,1,0,70
南投縣,仁愛鄉,發祥村,409,1,10,0,10,27,3,1,3,0,1,0,37.04
南投縣,仁愛鄉,力行村,410,1,7,0,7,13,3,1,3,0,1,0,53.85
南投縣,仁愛鄉,翠華村,411,1,18,0,18,35,3,1,3,0,1,0,51.43
南投縣,仁愛鄉,翠華村,412,1,55,2,57,216,3,1,3,0,1,0,26.39
南投縣,仁愛鄉,親愛村,413,1,11,0,11,34,3,1,3,0,1,0,32.35
南投縣,仁愛鄉,親愛村,414,1,4,0,4,13,3,1,3,0,1,0,30.77
南投縣,仁愛鄉,親愛村,415,1,15,0,15,43,3,1,3,0,1,0,34.88
南投縣,仁愛鄉,萬豐村,416,1,19,0,19,50,3,1,3,0,1,0,38
南投縣,仁愛鄉,法治村,417,1,10,0,10,29,3,1,3,0,1,0,34.48
南投縣,仁愛鄉,中正村,418,1,34,0,34,85,3,1,3,0,1,0,40
南投縣,仁愛鄉,互助村,419,1,26,0,26,88,3,1,3,0,1,0,29.55
南投縣,仁愛鄉,互助村,420,1,17,0,17,33,3,1,3,0,1,0,51.52
南投縣,仁愛鄉,新生村,421,1,20,1,21,47,3,1,3,0,1,0,44.68
雲林縣,斗六市,信義里,1,1,524,0,524,761,3,1,3,0,1,0,68.86
雲林縣,斗六市,四維里,2,1,485,5,490,695,3,1,3,0,1,0,70.50
雲林縣,斗六市,太平里,3,1,522,3,525,753,3,1,3,0,1,0,69.72
雲林縣,斗六市,中和里,4,1,666,8,674,914,3,1,3,0,1,0,73.74
雲林縣,斗六市,光興里,5,1,588,5,593,908,3,1,3,0,1,0,65.31
雲林縣,斗六市,鎮西里,6,1,813,7,820,1245,3,1,3,0,1,0,65.86
雲林縣,斗六市,鎮西里,7,1,1031,13,1044,1696,3,1,3,0,1,0,61.56
雲林縣,斗六市,鎮東里,8,1,736,4,740,1173,3,1,3,0,1,0,63.09
雲林縣,斗六市,鎮東里,9,1,737,7,744,1148,3,1,3,0,1,0,64.81
雲林縣,斗六市,鎮東里,10,1,882,14,896,1331,3,1,3,0,1,0,67.32
雲林縣,斗六市,三平里,11,1,911,7,918,1438,3,1,3,0,1,0,63.84
雲林縣,斗六市,三平里,12,1,1096,14,1110,1645,3,1,3,0,1,0,67.48
雲林縣,斗六市,明德里,13,1,658,7,665,1130,3,1,3,0,1,0,58.85
雲林縣,斗六市,明德里,14,1,775,12,787,1251,3,1,3,0,1,0,62.91
雲林縣,斗六市,鎮北里,15,1,775,8,783,1124,3,1,3,0,1,0,69.66
雲林縣,斗六市,鎮北里,16,1,782,19,801,1234,3,1,3,0,1,0,64.91
雲林縣,斗六市,公誠里,17,1,591,5,596,919,3,1,3,0,1,0,64.85
雲林縣,斗六市,公誠里,18,1,541,3,544,898,3,1,3,0,1,0,60.58
雲林縣,斗六市,忠孝里,19,1,516,9,525,784,3,1,3,0,1,0,66.96
雲林縣,斗六市,忠孝里,20,1,454,6,460,659,3,1,3,0,1,0,69.80
雲林縣,斗六市,仁愛里,21,1,713,5,718,1125,3,1,3,0,1,0,63.82
雲林縣,斗六市,八德里,22,1,942,7,949,1408,3,1,3,0,1,0,67.40
雲林縣,斗六市,八德里,23,1,814,6,820,1301,3,1,3,0,1,0,63.03
雲林縣,斗六市,公正里,24,1,710,9,719,1163,3,1,3,0,1,0,61.82
雲林縣,斗六市,公正里,25,1,830,11,841,1188,3,1,3,0,1,0,70.79
雲林縣,斗六市,重光里,26,1,617,7,624,898,3,1,3,0,1,0,69.49
雲林縣,斗六市,重光里,27,1,661,10,671,1128,3,1,3,0,1,0,59.49
雲林縣,斗六市,林頭里,28,1,996,12,1008,1505,3,1,3,0,1,0,66.98
雲林縣,斗六市,林頭里,29,1,648,6,654,1139,3,1,3,0,1,0,57.42
雲林縣,斗六市,林頭里,30,1,600,6,606,902,3,1,3,0,1,0,67.18
雲林縣,斗六市,成功里,31,1,638,8,646,977,3,1,3,0,1,0,66.12
雲林縣,斗六市,成功里,32,1,703,5,708,1052,3,1,3,0,1,0,67.30
雲林縣,斗六市,鎮南里,33,1,747,4,751,1121,3,1,3,0,1,0,66.99
雲林縣,斗六市,鎮南里,34,1,693,2,695,1102,3,1,3,0,1,0,63.07
雲林縣,斗六市,鎮南里,35,1,626,2,628,1027,3,1,3,0,1,0,61.15
雲林縣,斗六市,社口里,36,1,623,3,626,924,3,1,3,0,1,0,67.75
雲林縣,斗六市,社口里,37,1,781,6,787,1196,3,1,3,0,1,0,65.80
雲林縣,斗六市,龍潭里,38,1,804,8,812,1169,3,1,3,0,1,0,69.46
雲林縣,斗六市,嘉東里,39,1,507,22,529,752,3,1,3,0,1,0,70.35
雲林縣,斗六市,崙峰里,40,1,741,8,749,1111,3,1,3,0,1,0,67.42
雲林縣,斗六市,崙峰里,41,1,429,4,433,669,3,1,3,0,1,0,64.72
雲林縣,斗六市,溝埧里,42,1,416,4,420,598,3,1,3,0,1,0,70.23
雲林縣,斗六市,江厝里,43,1,991,19,1010,1622,3,1,3,0,1,0,62.27
雲林縣,斗六市,三光里,44,1,397,5,402,565,3,1,3,0,1,0,71.15
雲林縣,斗六市,久安里,45,1,842,5,847,1209,3,1,3,0,1,0,70.06
雲林縣,斗六市,久安里,46,1,442,6,448,703,3,1,3,0,1,0,63.73
雲林縣,斗六市,虎溪里,47,1,902,6,908,1291,3,1,3,0,1,0,70.33
雲林縣,斗六市,虎溪里,48,1,1017,10,1027,1603,3,1,3,0,1,0,64.07
雲林縣,斗六市,虎溪里,49,1,1095,11,1106,1585,3,1,3,0,1,0,69.78
雲林縣,斗六市,保庄里,50,1,1143,6,1149,1717,3,1,3,0,1,0,66.92
雲林縣,斗六市,保庄里,51,1,950,6,956,1429,3,1,3,0,1,0,66.90
雲林縣,斗六市,長平里,52,1,1065,6,1071,1565,3,1,3,0,1,0,68.43
雲林縣,斗六市,榴中里,53,1,811,12,823,1204,3,1,3,0,1,0,68.36
雲林縣,斗六市,榴中里,54,1,769,9,778,1220,3,1,3,0,1,0,63.77
雲林縣,斗六市,榴中里,55,1,865,9,874,1382,3,1,3,0,1,0,63.24
雲林縣,斗六市,榴北里,56,1,626,6,632,944,3,1,3,0,1,0,66.95
雲林縣,斗六市,榴南里,57,1,770,11,781,1239,3,1,3,0,1,0,63.03
雲林縣,斗六市,梅林里,58,1,538,7,545,736,3,1,3,0,1,0,74.05
雲林縣,斗六市,梅林里,59,1,670,4,674,972,3,1,3,0,1,0,69.34
雲林縣,斗六市,湖山里,60,1,883,14,897,1258,3,1,3,0,1,0,71.30
雲林縣,斗六市,長安里,61,1,693,11,704,1052,3,1,3,0,1,0,66.92
雲林縣,斗六市,長安里,62,1,932,6,938,1514,3,1,3,0,1,0,61.96
雲林縣,斗六市,溪洲里,63,1,660,7,667,984,3,1,3,0,1,0,67.78
雲林縣,斗六市,溪洲里,64,1,983,11,994,1487,3,1,3,0,1,0,66.85
雲林縣,斗六市,十三里,65,1,801,4,805,1131,3,1,3,0,1,0,71.18
雲林縣,斗南鎮,東仁里,66,1,726,8,734,1131,3,1,3,0,1,0,64.90
雲林縣,斗南鎮,西岐里,67,1,1004,8,1012,1586,3,1,3,0,1,0,63.81
雲林縣,斗南鎮,西岐里,68,1,962,5,967,1532,3,1,3,0,1,0,63.12
雲林縣,斗南鎮,西岐里,69,1,869,2,871,1442,3,1,3,0,1,0,60.40
雲林縣,斗南鎮,南昌里,70,1,616,1,617,1105,3,1,3,0,1,0,55.84
雲林縣,斗南鎮,南昌里,71,1,604,2,606,915,3,1,3,0,1,0,66.23
雲林縣,斗南鎮,北銘里,72,1,846,6,852,1315,3,1,3,0,1,0,64.79
雲林縣,斗南鎮,中天里,73,1,814,4,818,1249,3,1,3,0,1,0,65.49
雲林縣,斗南鎮,林子里,74,1,826,1,827,1258,3,1,3,0,1,0,65.74
雲林縣,斗南鎮,石龜里,75,1,618,2,620,871,3,1,3,0,1,0,71.18
雲林縣,斗南鎮,石溪里,76,1,604,5,609,924,3,1,3,0,1,0,65.91
雲林縣,斗南鎮,靖興里,77,1,665,5,670,911,3,1,3,0,1,0,73.55
雲林縣,斗南鎮,新南里,78,1,480,6,486,736,3,1,3,0,1,0,66.03
雲林縣,斗南鎮,阿丹里,79,1,878,9,887,1175,3,1,3,0,1,0,75.49
雲林縣,斗南鎮,將軍里,80,1,963,9,972,1472,3,1,3,0,1,0,66.03
雲林縣,斗南鎮,舊社里,81,1,819,12,831,1374,3,1,3,0,1,0,60.48
雲林縣,斗南鎮,舊社里,82,1,380,5,385,636,3,1,3,0,1,0,60.53
雲林縣,斗南鎮,明昌里,83,1,932,9,941,1428,3,1,3,0,1,0,65.90
雲林縣,斗南鎮,明昌里,84,1,906,6,912,1398,3,1,3,0,1,0,65.24
雲林縣,斗南鎮,明昌里,85,1,950,7,957,1533,3,1,3,0,1,0,62.43
雲林縣,斗南鎮,大東里,86,1,611,10,621,913,3,1,3,0,1,0,68.02
雲林縣,斗南鎮,埤麻里,87,1,575,4,579,828,3,1,3,0,1,0,69.93
雲林縣,斗南鎮,西伯里,88,1,672,3,675,940,3,1,3,0,1,0,71.81
雲林縣,斗南鎮,新崙里,89,1,549,4,553,841,3,1,3,0,1,0,65.76
雲林縣,斗南鎮,新崙里,90,1,481,8,489,744,3,1,3,0,1,0,65.73
雲林縣,斗南鎮,東明里,91,1,643,13,656,968,3,1,3,0,1,0,67.77
雲林縣,斗南鎮,新光里,92,1,732,4,736,1050,3,1,3,0,1,0,70.10
雲林縣,斗南鎮,新光里,93,1,899,7,906,1398,3,1,3,0,1,0,64.81
雲林縣,斗南鎮,田頭里,94,1,742,7,749,1040,3,1,3,0,1,0,72.02
雲林縣,斗南鎮,田頭里,95,1,682,9,691,1022,3,1,3,0,1,0,67.61
雲林縣,斗南鎮,小東里,96,1,1020,8,1028,1578,3,1,3,0,1,0,65.15
雲林縣,虎尾鎮,東仁里,97,1,708,9,717,1121,3,1,3,0,1,0,63.96
雲林縣,虎尾鎮,東仁里,98,1,715,7,722,1182,3,1,3,0,1,0,61.08
雲林縣,虎尾鎮,新興里,99,1,432,2,434,684,3,1,3,0,1,0,63.45
雲林縣,虎尾鎮,新興里,100,1,634,3,637,1011,3,1,3,0,1,0,63.01
雲林縣,虎尾鎮,公安里,101,1,782,7,789,1209,3,1,3,0,1,0,65.26
雲林縣,虎尾鎮,公安里,102,1,900,8,908,1443,3,1,3,0,1,0,62.92
雲林縣,虎尾鎮,德興里,103,1,601,2,603,1017,3,1,3,0,1,0,59.29
雲林縣,虎尾鎮,德興里,104,1,776,7,783,1393,3,1,3,0,1,0,56.21
雲林縣,虎尾鎮,中山里,105,1,657,5,662,1045,3,1,3,0,1,0,63.35
雲林縣,虎尾鎮,西安里,106,1,869,5,874,1428,3,1,3,0,1,0,61.20
雲林縣,虎尾鎮,西安里,107,1,932,11,943,1540,3,1,3,0,1,0,61.23
雲林縣,虎尾鎮,立仁里,108,1,720,5,725,1157,3,1,3,0,1,0,62.66
雲林縣,虎尾鎮,立仁里,109,1,771,9,780,1243,3,1,3,0,1,0,62.75
雲林縣,虎尾鎮,立仁里,110,1,635,1,636,1102,3,1,3,0,1,0,57.71
雲林縣,虎尾鎮,安慶里,111,1,875,13,888,1349,3,1,3,0,1,0,65.83
雲林縣,虎尾鎮,平和里,112,1,995,7,1002,1632,3,1,3,0,1,0,61.40
雲林縣,虎尾鎮,興南里,113,1,559,4,563,960,3,1,3,0,1,0,58.65
雲林縣,虎尾鎮,興南里,114,1,526,10,536,822,3,1,3,0,1,0,65.21
雲林縣,虎尾鎮,新吉里,115,1,926,12,938,1534,3,1,3,0,1,0,61.15
雲林縣,虎尾鎮,新吉里,116,1,615,11,626,1092,3,1,3,0,1,0,57.33
雲林縣,虎尾鎮,穎川里,117,1,1055,9,1064,1663,3,1,3,0,1,0,63.98
雲林縣,虎尾鎮,延平里,118,1,604,10,614,942,3,1,3,0,1,0,65.18
雲林縣,虎尾鎮,建國里,119,1,365,2,367,631,3,1,3,0,1,0,58.16
雲林縣,虎尾鎮,埒內里,120,1,799,7,806,1259,3,1,3,0,1,0,64.02
雲林縣,虎尾鎮,埒內里,121,1,698,8,706,1092,3,1,3,0,1,0,64.65
雲林縣,虎尾鎮,堀頭里,122,1,552,9,561,789,3,1,3,0,1,0,71.10
雲林縣,虎尾鎮,安溪里,123,1,479,10,489,823,3,1,3,0,1,0,59.42
雲林縣,虎尾鎮,安溪里,124,1,594,11,605,904,3,1,3,0,1,0,66.92
雲林縣,虎尾鎮,興中里,125,1,1058,6,1064,1575,3,1,3,0,1,0,67.56
雲林縣,虎尾鎮,廉使里,126,1,939,14,953,1433,3,1,3,0,1,0,66.50
雲林縣,虎尾鎮,廉使里,127,1,870,9,879,1405,3,1,3,0,1,0,62.56
雲林縣,虎尾鎮,惠來里,128,1,759,16,775,1222,3,1,3,0,1,0,63.42
雲林縣,虎尾鎮,惠來里,129,1,656,8,664,1049,3,1,3,0,1,0,63.30
雲林縣,虎尾鎮,頂溪里,130,1,874,8,882,1214,3,1,3,0,1,0,72.65
雲林縣,虎尾鎮,頂溪里,131,1,760,9,769,1253,3,1,3,0,1,0,61.37
雲林縣,虎尾鎮,中溪里,132,1,839,7,846,1307,3,1,3,0,1,0,64.73
雲林縣,虎尾鎮,下溪里,133,1,967,5,972,1319,3,1,3,0,1,0,73.69
雲林縣,虎尾鎮,東屯里,134,1,724,4,728,1181,3,1,3,0,1,0,61.64
雲林縣,虎尾鎮,西屯里,135,1,973,15,988,1497,3,1,3,0,1,0,66.00
雲林縣,虎尾鎮,芳草里,136,1,521,9,530,870,3,1,3,0,1,0,60.92
雲林縣,虎尾鎮,墾地里,137,1,588,6,594,976,3,1,3,0,1,0,60.86
雲林縣,虎尾鎮,北溪里,138,1,532,9,541,773,3,1,3,0,1,0,69.99
雲林縣,虎尾鎮,三合里,139,1,688,3,691,1041,3,1,3,0,1,0,66.38
雲林縣,西螺鎮,振興里,140,1,1075,6,1081,1603,3,1,3,0,1,0,67.44
雲林縣,西螺鎮,大園里,141,1,1002,10,1012,1509,3,1,3,0,1,0,67.06
雲林縣,西螺鎮,廣福里,142,1,1088,5,1093,1672,3,1,3,0,1,0,65.37
雲林縣,西螺鎮,正興里,143,1,852,4,856,1287,3,1,3,0,1,0,66.51
雲林縣,西螺鎮,正興里,144,1,946,8,954,1609,3,1,3,0,1,0,59.29
雲林縣,西螺鎮,永安里,145,1,294,3,297,441,3,1,3,0,1,0,67.35
雲林縣,西螺鎮,中和里,146,1,463,7,470,684,3,1,3,0,1,0,68.71
雲林縣,西螺鎮,福興里,147,1,409,1,410,632,3,1,3,0,1,0,64.87
雲林縣,西螺鎮,光華里,148,1,635,5,640,994,3,1,3,0,1,0,64.39
雲林縣,西螺鎮,中興里,149,1,656,5,661,1068,3,1,3,0,1,0,61.89
雲林縣,西螺鎮,中興里,150,1,792,6,798,1206,3,1,3,0,1,0,66.17
雲林縣,西螺鎮,漢光里,151,1,791,11,802,1297,3,1,3,0,1,0,61.84
雲林縣,西螺鎮,漢光里,152,1,618,5,623,994,3,1,3,0,1,0,62.68
雲林縣,西螺鎮,漢光里,153,1,724,8,732,1186,3,1,3,0,1,0,61.72
雲林縣,西螺鎮,新安里,154,1,870,5,875,1294,3,1,3,0,1,0,67.62
雲林縣,西螺鎮,新豐里,155,1,1003,15,1018,1501,3,1,3,0,1,0,67.82
雲林縣,西螺鎮,大新里,156,1,633,5,638,917,3,1,3,0,1,0,69.57
雲林縣,西螺鎮,大新里,157,1,573,7,580,818,3,1,3,0,1,0,70.90
雲林縣,西螺鎮,埤頭里,158,1,601,6,607,891,3,1,3,0,1,0,68.13
雲林縣,西螺鎮,東興里,159,1,698,9,707,1105,3,1,3,0,1,0,63.98
雲林縣,西螺鎮,鹿場里,160,1,1003,10,1013,1499,3,1,3,0,1,0,67.58
雲林縣,西螺鎮,廣興里,161,1,628,6,634,859,3,1,3,0,1,0,73.81
雲林縣,西螺鎮,頂湳里,162,1,709,9,718,974,3,1,3,0,1,0,73.72
雲林縣,西螺鎮,吳厝里,163,1,872,9,881,1360,3,1,3,0,1,0,64.78
雲林縣,西螺鎮,九隆里,164,1,544,4,548,760,3,1,3,0,1,0,72.11
雲林縣,西螺鎮,下湳里,165,1,584,1,585,813,3,1,3,0,1,0,71.96
雲林縣,西螺鎮,七座里,166,1,652,10,662,965,3,1,3,0,1,0,68.60
雲林縣,西螺鎮,公館里,167,1,863,13,876,1371,3,1,3,0,1,0,63.89
雲林縣,西螺鎮,詔安里,168,1,634,5,639,970,3,1,3,0,1,0,65.88
雲林縣,西螺鎮,河南里,169,1,573,6,579,916,3,1,3,0,1,0,63.21
雲林縣,西螺鎮,安定里,170,1,583,8,591,929,3,1,3,0,1,0,63.62
雲林縣,西螺鎮,安定里,171,1,533,5,538,861,3,1,3,0,1,0,62.49
雲林縣,西螺鎮,福田里,172,1,965,15,980,1438,3,1,3,0,1,0,68.15
雲林縣,土庫鎮,忠正里,173,1,624,5,629,917,3,1,3,0,1,0,68.59
雲林縣,土庫鎮,順天里,174,1,711,12,723,1018,3,1,3,0,1,0,71.02
雲林縣,土庫鎮,宮北里,175,1,922,11,933,1390,3,1,3,0,1,0,67.12
雲林縣,土庫鎮,越港里,176,1,649,8,657,922,3,1,3,0,1,0,71.26
雲林縣,土庫鎮,溪邊里,177,1,489,8,497,707,3,1,3,0,1,0,70.30
雲林縣,土庫鎮,溪邊里,178,1,308,6,314,448,3,1,3,0,1,0,70.09
雲林縣,土庫鎮,石廟里,179,1,1071,14,1085,1659,3,1,3,0,1,0,65.40
雲林縣,土庫鎮,興新里,180,1,384,2,386,620,3,1,3,0,1,0,62.26
雲林縣,土庫鎮,興新里,181,1,459,5,464,714,3,1,3,0,1,0,64.99
雲林縣,土庫鎮,奮起里,182,1,459,4,463,822,3,1,3,0,1,0,56.33
雲林縣,土庫鎮,奮起里,183,1,397,6,403,592,3,1,3,0,1,0,68.07
雲林縣,土庫鎮,埤腳里,184,1,534,8,542,880,3,1,3,0,1,0,61.59
雲林縣,土庫鎮,埤腳里,185,1,403,5,408,559,3,1,3,0,1,0,72.99
雲林縣,土庫鎮,後埔里,186,1,790,5,795,1333,3,1,3,0,1,0,59.64
雲林縣,土庫鎮,後埔里,187,1,645,4,649,1019,3,1,3,0,1,0,63.69
雲林縣,土庫鎮,崙內里,188,1,545,4,549,813,3,1,3,0,1,0,67.53
雲林縣,土庫鎮,崙內里,189,1,416,8,424,712,3,1,3,0,1,0,59.55
雲林縣,土庫鎮,大荖里,190,1,578,13,591,883,3,1,3,0,1,0,66.93
雲林縣,土庫鎮,東平里,191,1,629,8,637,1043,3,1,3,0,1,0,61.07
雲林縣,土庫鎮,東平里,192,1,500,1,501,839,3,1,3,0,1,0,59.71
雲林縣,土庫鎮,南平里,193,1,604,2,606,965,3,1,3,0,1,0,62.80
雲林縣,土庫鎮,南平里,194,1,533,6,539,856,3,1,3,0,1,0,62.97
雲林縣,土庫鎮,西平里,195,1,602,2,604,923,3,1,3,0,1,0,65.44
雲林縣,土庫鎮,西平里,196,1,529,4,533,865,3,1,3,0,1,0,61.62
雲林縣,土庫鎮,北平里,197,1,626,3,629,993,3,1,3,0,1,0,63.34
雲林縣,土庫鎮,新庄里,198,1,898,9,907,1475,3,1,3,0,1,0,61.49
雲林縣,北港鎮,東陽里,199,1,545,7,552,789,3,1,3,0,1,0,69.96
雲林縣,北港鎮,光民里,200,1,510,3,513,749,3,1,3,0,1,0,68.49
雲林縣,北港鎮,東華里,201,1,337,4,341,512,3,1,3,0,1,0,66.60
雲林縣,北港鎮,南安里,202,1,702,6,708,998,3,1,3,0,1,0,70.94
雲林縣,北港鎮,中和里,203,1,267,4,271,430,3,1,3,0,1,0,63.02
雲林縣,北港鎮,義民里,204,1,305,3,308,452,3,1,3,0,1,0,68.14
雲林縣,北港鎮,共榮里,205,1,292,1,293,417,3,1,3,0,1,0,70.26
雲林縣,北港鎮,西勢里,206,1,616,6,622,949,3,1,3,0,1,0,65.54
雲林縣,北港鎮,仁和里,207,1,374,0,374,551,3,1,3,0,1,0,67.88
雲林縣,北港鎮,賜福里,208,1,247,0,247,382,3,1,3,0,1,0,64.66
雲林縣,北港鎮,公館里,209,1,421,6,427,669,3,1,3,0,1,0,63.83
雲林縣,北港鎮,大同里,210,1,347,2,349,545,3,1,3,0,1,0,64.04
雲林縣,北港鎮,大同里,211,1,491,8,499,811,3,1,3,0,1,0,61.53
雲林縣,北港鎮,仁安里,212,1,341,3,344,528,3,1,3,0,1,0,65.15
雲林縣,北港鎮,華勝里,213,1,738,6,744,1182,3,1,3,0,1,0,62.94
雲林縣,北港鎮,華勝里,214,1,778,14,792,1249,3,1,3,0,1,0,63.41
雲林縣,北港鎮,華勝里,215,1,752,12,764,1177,3,1,3,0,1,0,64.91
雲林縣,北港鎮,華勝里,216,1,781,4,785,1247,3,1,3,0,1,0,62.95
雲林縣,北港鎮,光復里,217,1,898,8,906,1448,3,1,3,0,1,0,62.57
雲林縣,北港鎮,新街里,218,1,841,13,854,1345,3,1,3,0,1,0,63.49
雲林縣,北港鎮,新街里,219,1,718,6,724,1209,3,1,3,0,1,0,59.88
雲林縣,北港鎮,新街里,220,1,751,7,758,1253,3,1,3,0,1,0,60.49
雲林縣,北港鎮,新街里,221,1,806,4,810,1291,3,1,3,0,1,0,62.74
雲林縣,北港鎮,劉厝里,222,1,746,6,752,1190,3,1,3,0,1,0,63.19
雲林縣,北港鎮,後溝里,223,1,366,7,373,583,3,1,3,0,1,0,63.98
雲林縣,北港鎮,後溝里,224,1,256,0,256,394,3,1,3,0,1,0,64.97
雲林縣,北港鎮,新厝里,225,1,264,4,268,436,3,1,3,0,1,0,61.47
雲林縣,北港鎮,府番里,226,1,537,2,539,853,3,1,3,0,1,0,63.19
雲林縣,北港鎮,草湖里,227,1,830,12,842,1427,3,1,3,0,1,0,59.00
雲林縣,北港鎮,溝皂里,228,1,722,5,727,1213,3,1,3,0,1,0,59.93
雲林縣,北港鎮,番溝里,229,1,550,3,553,1013,3,1,3,0,1,0,54.59
雲林縣,北港鎮,大北里,230,1,339,6,345,644,3,1,3,0,1,0,53.57
雲林縣,北港鎮,好收里,231,1,690,11,701,1030,3,1,3,0,1,0,68.06
雲林縣,北港鎮,好收里,232,1,401,3,404,620,3,1,3,0,1,0,65.16
雲林縣,北港鎮,樹腳里,233,1,727,4,731,1203,3,1,3,0,1,0,60.76
雲林縣,北港鎮,樹腳里,234,1,942,15,957,1595,3,1,3,0,1,0,60.00
雲林縣,北港鎮,扶朝里,235,1,647,4,651,1025,3,1,3,0,1,0,63.51
雲林縣,北港鎮,水埔里,236,1,348,0,348,562,3,1,3,0,1,0,61.92
雲林縣,古坑鄉,棋盤村,237,1,717,8,725,1136,3,1,3,0,1,0,63.82
雲林縣,古坑鄉,棋盤村,238,1,659,9,668,953,3,1,3,0,1,0,70.09
雲林縣,古坑鄉,新庄村,239,1,963,12,975,1545,3,1,3,0,1,0,63.11
雲林縣,古坑鄉,東和村,240,1,805,11,816,1288,3,1,3,0,1,0,63.35
雲林縣,古坑鄉,東和村,241,1,877,14,891,1557,3,1,3,0,1,0,57.23
雲林縣,古坑鄉,荷苞村,242,1,714,6,720,1122,3,1,3,0,1,0,64.17
雲林縣,古坑鄉,荷苞村,243,1,186,1,187,314,3,1,3,0,1,0,59.55
雲林縣,古坑鄉,高林村,244,1,789,10,799,1167,3,1,3,0,1,0,68.47
雲林縣,古坑鄉,水碓村,245,1,788,10,798,1212,3,1,3,0,1,0,65.84
雲林縣,古坑鄉,田心村,246,1,644,6,650,979,3,1,3,0,1,0,66.39
雲林縣,古坑鄉,古坑村,247,1,617,2,619,933,3,1,3,0,1,0,66.35
雲林縣,古坑鄉,古坑村,248,1,662,11,673,1124,3,1,3,0,1,0,59.88
雲林縣,古坑鄉,朝陽村,249,1,601,6,607,911,3,1,3,0,1,0,66.63
雲林縣,古坑鄉,朝陽村,250,1,699,6,705,1041,3,1,3,0,1,0,67.72
雲林縣,古坑鄉,西平村,251,1,926,5,931,1399,3,1,3,0,1,0,66.55
雲林縣,古坑鄉,湳仔村,252,1,504,6,510,688,3,1,3,0,1,0,74.13
雲林縣,古坑鄉,永光村,253,1,544,16,560,988,3,1,3,0,1,0,56.68
雲林縣,古坑鄉,永光村,254,1,567,15,582,936,3,1,3,0,1,0,62.18
雲林縣,古坑鄉,永昌村,255,1,629,7,636,1070,3,1,3,0,1,0,59.44
雲林縣,古坑鄉,永昌村,256,1,540,6,546,948,3,1,3,0,1,0,57.59
雲林縣,古坑鄉,麻園村,257,1,465,11,476,660,3,1,3,0,1,0,72.12
雲林縣,古坑鄉,崁腳村,258,1,785,10,795,1266,3,1,3,0,1,0,62.80
雲林縣,古坑鄉,華南村,259,1,219,2,221,321,3,1,3,0,1,0,68.85
雲林縣,古坑鄉,華山村,260,1,434,9,443,788,3,1,3,0,1,0,56.22
雲林縣,古坑鄉,桂林村,261,1,676,3,679,1167,3,1,3,0,1,0,58.18
雲林縣,古坑鄉,樟湖村,262,1,328,2,330,537,3,1,3,0,1,0,61.45
雲林縣,古坑鄉,草嶺村,263,1,456,4,460,675,3,1,3,0,1,0,68.15
雲林縣,大埤鄉,北和村,264,1,521,3,524,785,3,1,3,0,1,0,66.75
雲林縣,大埤鄉,南和村,265,1,978,14,992,1511,3,1,3,0,1,0,65.65
雲林縣,大埤鄉,南和村,266,1,385,3,388,575,3,1,3,0,1,0,67.48
雲林縣,大埤鄉,大德村,267,1,719,7,726,1096,3,1,3,0,1,0,66.24
雲林縣,大埤鄉,松竹村,268,1,659,4,663,990,3,1,3,0,1,0,66.97
雲林縣,大埤鄉,尚義村,269,1,866,10,876,1400,3,1,3,0,1,0,62.57
雲林縣,大埤鄉,尚義村,270,1,318,3,321,482,3,1,3,0,1,0,66.60
雲林縣,大埤鄉,嘉興村,271,1,842,12,854,1326,3,1,3,0,1,0,64.40
雲林縣,大埤鄉,嘉興村,272,1,330,4,334,489,3,1,3,0,1,0,68.30
雲林縣,大埤鄉,豐田村,273,1,833,10,843,1385,3,1,3,0,1,0,60.87
雲林縣,大埤鄉,三結村,274,1,786,5,791,1254,3,1,3,0,1,0,63.08
雲林縣,大埤鄉,吉田村,275,1,495,5,500,804,3,1,3,0,1,0,62.19
雲林縣,大埤鄉,豐岡村,276,1,429,8,437,684,3,1,3,0,1,0,63.89
雲林縣,大埤鄉,聯美村,277,1,777,6,783,1227,3,1,3,0,1,0,63.81
雲林縣,大埤鄉,怡然村,278,1,573,8,581,832,3,1,3,0,1,0,69.83
雲林縣,大埤鄉,北鎮村,279,1,443,5,448,716,3,1,3,0,1,0,62.57
雲林縣,大埤鄉,興安村,280,1,518,5,523,781,3,1,3,0,1,0,66.97
雲林縣,大埤鄉,西鎮村,281,1,533,5,538,788,3,1,3,0,1,0,68.27
雲林縣,莿桐鄉,莿桐村,282,1,849,8,857,1308,3,1,3,0,1,0,65.52
雲林縣,莿桐鄉,莿桐村,283,1,797,9,806,1163,3,1,3,0,1,0,69.30
雲林縣,莿桐鄉,莿桐村,284,1,678,9,687,1079,3,1,3,0,1,0,63.67
雲林縣,莿桐鄉,甘厝村,285,1,614,6,620,917,3,1,3,0,1,0,67.61
雲林縣,莿桐鄉,甘西村,286,1,995,9,1004,1619,3,1,3,0,1,0,62.01
雲林縣,莿桐鄉,興桐村,287,1,374,3,377,582,3,1,3,0,1,0,64.78
雲林縣,莿桐鄉,興桐村,288,1,490,3,493,687,3,1,3,0,1,0,71.76
雲林縣,莿桐鄉,義和村,289,1,798,9,807,1149,3,1,3,0,1,0,70.23
雲林縣,莿桐鄉,埔子村,290,1,587,6,593,838,3,1,3,0,1,0,70.76
雲林縣,莿桐鄉,埔子村,291,1,586,7,593,911,3,1,3,0,1,0,65.09
雲林縣,莿桐鄉,大美村,292,1,898,3,901,1354,3,1,3,0,1,0,66.54
雲林縣,莿桐鄉,大美村,293,1,766,0,766,1163,3,1,3,0,1,0,65.86
雲林縣,莿桐鄉,埔尾村,294,1,892,10,902,1282,3,1,3,0,1,0,70.36
雲林縣,莿桐鄉,興貴村,295,1,565,4,569,894,3,1,3,0,1,0,63.65
雲林縣,莿桐鄉,興貴村,296,1,685,2,687,1000,3,1,3,0,1,0,68.70
雲林縣,莿桐鄉,饒平村,297,1,782,11,793,1170,3,1,3,0,1,0,67.78
雲林縣,莿桐鄉,四合村,298,1,623,4,627,891,3,1,3,0,1,0,70.37
雲林縣,莿桐鄉,四合村,299,1,598,13,611,868,3,1,3,0,1,0,70.39
雲林縣,莿桐鄉,麻園村,300,1,1141,9,1150,1588,3,1,3,0,1,0,72.42
雲林縣,莿桐鄉,五華村,301,1,937,16,953,1335,3,1,3,0,1,0,71.39
雲林縣,莿桐鄉,六合村,302,1,758,3,761,1158,3,1,3,0,1,0,65.72
雲林縣,莿桐鄉,六合村,303,1,401,3,404,605,3,1,3,0,1,0,66.78
雲林縣,林內鄉,林南村,304,1,730,8,738,1054,3,1,3,0,1,0,70.02
雲林縣,林內鄉,林中村,305,1,1113,11,1124,1755,3,1,3,0,1,0,64.05
雲林縣,林內鄉,林中村,306,1,1066,10,1076,1665,3,1,3,0,1,0,64.62
雲林縣,林內鄉,林北村,307,1,899,13,912,1404,3,1,3,0,1,0,64.96
雲林縣,林內鄉,林北村,308,1,468,2,470,721,3,1,3,0,1,0,65.19
雲林縣,林內鄉,坪頂村,309,1,437,4,441,594,3,1,3,0,1,0,74.24
雲林縣,林內鄉,林茂村,310,1,649,7,656,927,3,1,3,0,1,0,70.77
雲林縣,林內鄉,九芎村,311,1,740,4,744,1036,3,1,3,0,1,0,71.81
雲林縣,林內鄉,九芎村,312,1,1022,12,1034,1503,3,1,3,0,1,0,68.80
雲林縣,林內鄉,湖本村,313,1,473,8,481,654,3,1,3,0,1,0,73.55
雲林縣,林內鄉,烏塗村,314,1,791,3,794,1111,3,1,3,0,1,0,71.47
雲林縣,林內鄉,烏麻村,315,1,734,9,743,1044,3,1,3,0,1,0,71.17
雲林縣,林內鄉,重興村,316,1,661,6,667,918,3,1,3,0,1,0,72.66
雲林縣,林內鄉,重興村,317,1,609,3,612,858,3,1,3,0,1,0,71.33
雲林縣,二崙鄉,崙東村,318,1,940,10,950,1446,3,1,3,0,1,0,65.70
雲林縣,二崙鄉,崙西村,319,1,1054,3,1057,1654,3,1,3,0,1,0,63.91
雲林縣,二崙鄉,來惠村,320,1,476,2,478,697,3,1,3,0,1,0,68.58
雲林縣,二崙鄉,來惠村,321,1,673,6,679,1075,3,1,3,0,1,0,63.16
雲林縣,二崙鄉,三和村,322,1,342,2,344,492,3,1,3,0,1,0,69.92
雲林縣,二崙鄉,三和村,323,1,699,4,703,1134,3,1,3,0,1,0,61.99
雲林縣,二崙鄉,湳仔村,324,1,863,4,867,1244,3,1,3,0,1,0,69.69
雲林縣,二崙鄉,田尾村,325,1,657,2,659,1023,3,1,3,0,1,0,64.42
雲林縣,二崙鄉,田尾村,326,1,621,3,624,964,3,1,3,0,1,0,64.73
雲林縣,二崙鄉,定安村,327,1,597,5,602,969,3,1,3,0,1,0,62.13
雲林縣,二崙鄉,永定村,328,1,854,7,861,1373,3,1,3,0,1,0,62.71
雲林縣,二崙鄉,大華村,329,1,592,3,595,918,3,1,3,0,1,0,64.81
雲林縣,二崙鄉,義庄村,330,1,505,0,505,769,3,1,3,0,1,0,65.67
雲林縣,二崙鄉,楊賢村,331,1,979,11,990,1528,3,1,3,0,1,0,64.79
雲林縣,二崙鄉,港後村,332,1,740,8,748,1222,3,1,3,0,1,0,61.21
雲林縣,二崙鄉,港後村,333,1,487,4,491,731,3,1,3,0,1,0,67.17
雲林縣,二崙鄉,大義村,334,1,599,5,604,928,3,1,3,0,1,0,65.09
雲林縣,二崙鄉,油車村,335,1,709,6,715,1119,3,1,3,0,1,0,63.90
雲林縣,二崙鄉,油車村,336,1,390,4,394,675,3,1,3,0,1,0,58.37
雲林縣,二崙鄉,大庄村,337,1,856,6,862,1426,3,1,3,0,1,0,60.45
雲林縣,二崙鄉,庄西村,338,1,558,2,560,1001,3,1,3,0,1,0,55.94
雲林縣,二崙鄉,大同村,339,1,543,6,549,862,3,1,3,0,1,0,63.69
雲林縣,二崙鄉,復興村,340,1,699,8,707,1067,3,1,3,0,1,0,66.26
雲林縣,崙背鄉,東明村,341,1,841,10,851,1274,3,1,3,0,1,0,66.80
雲林縣,崙背鄉,西榮村,342,1,888,8,896,1408,3,1,3,0,1,0,63.64
雲林縣,崙背鄉,南陽村,343,1,614,5,619,1004,3,1,3,0,1,0,61.65
雲林縣,崙背鄉,南陽村,344,1,843,8,851,1273,3,1,3,0,1,0,66.85
雲林縣,崙背鄉,崙前村,345,1,724,7,731,1095,3,1,3,0,1,0,66.76
雲林縣,崙背鄉,崙前村,346,1,590,5,595,968,3,1,3,0,1,0,61.47
雲林縣,崙背鄉,羅厝村,347,1,589,9,598,977,3,1,3,0,1,0,61.21
雲林縣,崙背鄉,羅厝村,348,1,671,7,678,1067,3,1,3,0,1,0,63.54
雲林縣,崙背鄉,港尾村,349,1,870,10,880,1370,3,1,3,0,1,0,64.23
雲林縣,崙背鄉,阿勸村,350,1,706,17,723,1076,3,1,3,0,1,0,67.19
雲林縣,崙背鄉,阿勸村,351,1,686,5,691,976,3,1,3,0,1,0,70.80
雲林縣,崙背鄉,五魁村,352,1,595,5,600,913,3,1,3,0,1,0,65.72
雲林縣,崙背鄉,大有村,353,1,507,18,525,798,3,1,3,0,1,0,65.79
雲林縣,崙背鄉,大有村,354,1,575,5,580,950,3,1,3,0,1,0,61.05
雲林縣,崙背鄉,豐榮村,355,1,611,6,617,995,3,1,3,0,1,0,62.01
雲林縣,崙背鄉,豐榮村,356,1,598,5,603,1065,3,1,3,0,1,0,56.62
雲林縣,崙背鄉,草湖村,357,1,954,7,961,1518,3,1,3,0,1,0,63.31
雲林縣,崙背鄉,舊庄村,358,1,761,21,782,1214,3,1,3,0,1,0,64.42
雲林縣,崙背鄉,水尾村,359,1,838,10,848,1282,3,1,3,0,1,0,66.15
雲林縣,崙背鄉,枋南村,360,1,591,4,595,854,3,1,3,0,1,0,69.67
雲林縣,麥寮鄉,麥豐村,361,1,436,3,439,652,3,1,3,0,1,0,67.33
雲林縣,麥寮鄉,麥豐村,362,1,1034,12,1046,1627,3,1,3,0,1,0,64.29
雲林縣,麥寮鄉,麥豐村,363,1,755,7,762,1170,3,1,3,0,1,0,65.13
雲林縣,麥寮鄉,麥津村,364,1,831,7,838,1242,3,1,3,0,1,0,67.47
雲林縣,麥寮鄉,麥津村,365,1,854,17,871,1369,3,1,3,0,1,0,63.62
雲林縣,麥寮鄉,瓦窯村,366,1,286,4,290,503,3,1,3,0,1,0,57.65
雲林縣,麥寮鄉,瓦窯村,367,1,574,2,576,853,3,1,3,0,1,0,67.53
雲林縣,麥寮鄉,興華村,368,1,462,4,466,733,3,1,3,0,1,0,63.57
雲林縣,麥寮鄉,興華村,369,1,708,5,713,1088,3,1,3,0,1,0,65.53
雲林縣,麥寮鄉,海豐村,370,1,501,2,503,851,3,1,3,0,1,0,59.11
雲林縣,麥寮鄉,海豐村,371,1,377,2,379,616,3,1,3,0,1,0,61.53
雲林縣,麥寮鄉,後安村,372,1,628,5,633,1013,3,1,3,0,1,0,62.49
雲林縣,麥寮鄉,後安村,373,1,686,4,690,1132,3,1,3,0,1,0,60.95
雲林縣,麥寮鄉,三盛村,374,1,638,9,647,999,3,1,3,0,1,0,64.76
雲林縣,麥寮鄉,三盛村,375,1,800,8,808,1296,3,1,3,0,1,0,62.35
雲林縣,麥寮鄉,崙後村,376,1,525,2,527,900,3,1,3,0,1,0,58.56
雲林縣,麥寮鄉,崙後村,377,1,564,1,565,952,3,1,3,0,1,0,59.35
雲林縣,麥寮鄉,橋頭村,378,1,619,4,623,999,3,1,3,0,1,0,62.36
雲林縣,麥寮鄉,橋頭村,379,1,994,11,1005,1610,3,1,3,0,1,0,62.42
雲林縣,麥寮鄉,新吉村,380,1,487,6,493,789,3,1,3,0,1,0,62.48
雲林縣,麥寮鄉,施厝村,381,1,749,8,757,1209,3,1,3,0,1,0,62.61
雲林縣,麥寮鄉,施厝村,382,1,628,11,639,1022,3,1,3,0,1,0,62.52
雲林縣,麥寮鄉,雷厝村,383,1,814,12,826,1479,3,1,3,0,1,0,55.85
雲林縣,東勢鄉,月眉村,384,1,772,8,780,1280,3,1,3,0,1,0,60.94
雲林縣,東勢鄉,復興村,385,1,325,4,329,501,3,1,3,0,1,0,65.67
雲林縣,東勢鄉,嘉隆村,386,1,600,9,609,1032,3,1,3,0,1,0,59.01
雲林縣,東勢鄉,嘉隆村,387,1,482,5,487,762,3,1,3,0,1,0,63.91
雲林縣,東勢鄉,東南村,388,1,990,6,996,1466,3,1,3,0,1,0,67.94
雲林縣,東勢鄉,東北村,389,1,769,8,777,1213,3,1,3,0,1,0,64.06
雲林縣,東勢鄉,龍潭村,390,1,519,3,522,995,3,1,3,0,1,0,52.46
雲林縣,東勢鄉,程海村,391,1,384,6,390,611,3,1,3,0,1,0,63.83
雲林縣,東勢鄉,昌南村,392,1,645,4,649,966,3,1,3,0,1,0,67.18
雲林縣,東勢鄉,安南村,393,1,527,8,535,923,3,1,3,0,1,0,57.96
雲林縣,東勢鄉,同安村,394,1,684,5,689,1024,3,1,3,0,1,0,67.29
雲林縣,東勢鄉,同安村,395,1,755,3,758,1150,3,1,3,0,1,0,65.91
雲林縣,東勢鄉,四美村,396,1,492,4,496,817,3,1,3,0,1,0,60.71
雲林縣,東勢鄉,四美村,397,1,285,1,286,460,3,1,3,0,1,0,62.17
雲林縣,東勢鄉,新坤村,398,1,764,3,767,1252,3,1,3,0,1,0,61.26
雲林縣,褒忠鄉,中民村,399,1,695,7,702,972,3,1,3,0,1,0,72.22
雲林縣,褒忠鄉,中民村,400,1,676,5,681,942,3,1,3,0,1,0,72.29
雲林縣,褒忠鄉,埔姜村,401,1,987,6,993,1411,3,1,3,0,1,0,70.38
雲林縣,褒忠鄉,中勝村,402,1,968,9,977,1446,3,1,3,0,1,0,67.57
雲林縣,褒忠鄉,馬鳴村,403,1,321,2,323,430,3,1,3,0,1,0,75.12
雲林縣,褒忠鄉,馬鳴村,404,1,705,9,714,981,3,1,3,0,1,0,72.78
雲林縣,褒忠鄉,新湖村,405,1,384,4,388,516,3,1,3,0,1,0,75.19
雲林縣,褒忠鄉,新湖村,406,1,549,3,552,787,3,1,3,0,1,0,70.14
雲林縣,褒忠鄉,有才村,407,1,636,2,638,970,3,1,3,0,1,0,65.77
雲林縣,褒忠鄉,田洋村,408,1,549,2,551,804,3,1,3,0,1,0,68.53
雲林縣,褒忠鄉,龍岩村,409,1,793,8,801,1281,3,1,3,0,1,0,62.53
雲林縣,褒忠鄉,潮厝村,410,1,609,5,614,979,3,1,3,0,1,0,62.72
雲林縣,台西鄉,臺西村,411,1,822,10,832,1251,3,1,3,0,1,0,66.51
雲林縣,台西鄉,海南村,412,1,669,9,678,1051,3,1,3,0,1,0,64.51
雲林縣,台西鄉,海北村,413,1,663,3,666,1059,3,1,3,0,1,0,62.89
雲林縣,台西鄉,海口村,414,1,611,6,617,1009,3,1,3,0,1,0,61.15
雲林縣,台西鄉,海口村,415,1,592,4,596,966,3,1,3,0,1,0,61.70
雲林縣,台西鄉,山寮村,416,1,487,11,498,903,3,1,3,0,1,0,55.15
雲林縣,台西鄉,溪頂村,417,1,809,7,816,1525,3,1,3,0,1,0,53.51
雲林縣,台西鄉,牛厝村,418,1,708,10,718,1251,3,1,3,0,1,0,57.39
雲林縣,台西鄉,牛厝村,419,1,421,3,424,698,3,1,3,0,1,0,60.74
雲林縣,台西鄉,泉州村,420,1,365,4,369,659,3,1,3,0,1,0,55.99
雲林縣,台西鄉,五榔村,421,1,250,2,252,487,3,1,3,0,1,0,51.75
雲林縣,台西鄉,光華村,422,1,405,6,411,699,3,1,3,0,1,0,58.80
雲林縣,台西鄉,五港村,423,1,752,7,759,1284,3,1,3,0,1,0,59.11
雲林縣,台西鄉,五港村,424,1,410,1,411,642,3,1,3,0,1,0,64.02
雲林縣,台西鄉,富琦村,425,1,676,7,683,1064,3,1,3,0,1,0,64.19
雲林縣,台西鄉,富琦村,426,1,309,3,312,515,3,1,3,0,1,0,60.58
雲林縣,台西鄉,永豐村,427,1,930,6,936,1473,3,1,3,0,1,0,63.54
雲林縣,台西鄉,和豐村,428,1,680,1,681,1062,3,1,3,0,1,0,64.12
雲林縣,台西鄉,和豐村,429,1,630,5,635,1053,3,1,3,0,1,0,60.30
雲林縣,台西鄉,和豐村,430,1,629,5,634,1145,3,1,3,0,1,0,55.37
雲林縣,台西鄉,蚊港村,431,1,888,6,894,1335,3,1,3,0,1,0,66.97
雲林縣,台西鄉,蚊港村,432,1,490,7,497,706,3,1,3,0,1,0,70.40
雲林縣,元長鄉,長南村,433,1,548,5,553,860,3,1,3,0,1,0,64.30
雲林縣,元長鄉,長南村,434,1,748,11,759,1144,3,1,3,0,1,0,66.35
雲林縣,元長鄉,長南村,435,1,712,9,721,1218,3,1,3,0,1,0,59.20
雲林縣,元長鄉,長北村,436,1,498,6,504,835,3,1,3,0,1,0,60.36
雲林縣,元長鄉,長北村,437,1,490,5,495,822,3,1,3,0,1,0,60.22
雲林縣,元長鄉,子茂村,438,1,912,10,922,1503,3,1,3,0,1,0,61.34
雲林縣,元長鄉,後湖村,439,1,521,4,525,809,3,1,3,0,1,0,64.89
雲林縣,元長鄉,山內村,440,1,696,7,703,1066,3,1,3,0,1,0,65.95
雲林縣,元長鄉,合和村,441,1,681,5,686,1216,3,1,3,0,1,0,56.41
雲林縣,元長鄉,五塊村,442,1,626,3,629,1054,3,1,3,0,1,0,59.68
雲林縣,元長鄉,潭西村,443,1,468,1,469,921,3,1,3,0,1,0,50.92
雲林縣,元長鄉,潭東村,444,1,383,3,386,669,3,1,3,0,1,0,57.70
雲林縣,元長鄉,客厝村,445,1,542,6,548,877,3,1,3,0,1,0,62.49
雲林縣,元長鄉,卓運村,446,1,255,3,258,459,3,1,3,0,1,0,56.21
雲林縣,元長鄉,頂寮村,447,1,718,7,725,1223,3,1,3,0,1,0,59.28
雲林縣,元長鄉,下寮村,448,1,952,14,966,1533,3,1,3,0,1,0,63.01
雲林縣,元長鄉,龍岩村,449,1,691,5,696,1102,3,1,3,0,1,0,63.16
雲林縣,元長鄉,西莊村,450,1,532,9,541,923,3,1,3,0,1,0,58.61
雲林縣,元長鄉,鹿北村,451,1,820,9,829,1329,3,1,3,0,1,0,62.38
雲林縣,元長鄉,鹿南村,452,1,625,12,637,1023,3,1,3,0,1,0,62.27
雲林縣,元長鄉,瓦窯村,453,1,490,3,493,772,3,1,3,0,1,0,63.86
雲林縣,元長鄉,瓦窯村,454,1,544,8,552,887,3,1,3,0,1,0,62.23
雲林縣,元長鄉,內寮村,455,1,432,3,435,667,3,1,3,0,1,0,65.22
雲林縣,元長鄉,崙仔村,456,1,576,7,583,918,3,1,3,0,1,0,63.51
雲林縣,元長鄉,新吉村,457,1,515,4,519,740,3,1,3,0,1,0,70.14
雲林縣,四湖鄉,四湖村,458,1,617,9,626,1025,3,1,3,0,1,0,61.07
雲林縣,四湖鄉,四湖村,459,1,472,7,479,732,3,1,3,0,1,0,65.44
雲林縣,四湖鄉,湖西村,460,1,1048,14,1062,1587,3,1,3,0,1,0,66.92
雲林縣,四湖鄉,湖西村,461,1,345,4,349,572,3,1,3,0,1,0,61.01
雲林縣,四湖鄉,新庄村,462,1,443,2,445,716,3,1,3,0,1,0,62.15
雲林縣,四湖鄉,溪底村,463,1,638,5,643,1080,3,1,3,0,1,0,59.54
雲林縣,四湖鄉,鹿場村,464,1,633,3,636,1094,3,1,3,0,1,0,58.14
雲林縣,四湖鄉,蔡厝村,465,1,520,9,529,969,3,1,3,0,1,0,54.59
雲林縣,四湖鄉,湖寮村,466,1,451,6,457,874,3,1,3,0,1,0,52.29
雲林縣,四湖鄉,施湖村,467,1,721,9,730,1209,3,1,3,0,1,0,60.38
雲林縣,四湖鄉,羊調村,468,1,601,4,605,1141,3,1,3,0,1,0,53.02
雲林縣,四湖鄉,內湖村,469,1,462,2,464,953,3,1,3,0,1,0,48.69
雲林縣,四湖鄉,飛東村,470,1,337,6,343,647,3,1,3,0,1,0,53.01
雲林縣,四湖鄉,飛沙村,471,1,514,4,518,986,3,1,3,0,1,0,52.54
雲林縣,四湖鄉,三姓村,472,1,228,4,232,414,3,1,3,0,1,0,56.04
雲林縣,四湖鄉,崙北村,473,1,525,4,529,980,3,1,3,0,1,0,53.98
雲林縣,四湖鄉,崙北村,474,1,511,6,517,814,3,1,3,0,1,0,63.51
雲林縣,四湖鄉,崙南村,475,1,486,5,491,895,3,1,3,0,1,0,54.86
雲林縣,四湖鄉,廣溝村,476,1,386,5,391,814,3,1,3,0,1,0,48.03
雲林縣,四湖鄉,箔子村,477,1,488,7,495,1021,3,1,3,0,1,0,48.48
雲林縣,四湖鄉,箔東村,478,1,552,6,558,1141,3,1,3,0,1,0,48.90
雲林縣,四湖鄉,林厝村,479,1,677,3,680,1283,3,1,3,0,1,0,53.00
雲林縣,四湖鄉,林東村,480,1,534,6,540,1086,3,1,3,0,1,0,49.72
雲林縣,四湖鄉,溪尾村,481,1,409,1,410,829,3,1,3,0,1,0,49.46
雲林縣,口湖鄉,口湖村,482,1,712,5,717,1084,3,1,3,0,1,0,66.14
雲林縣,口湖鄉,湖東村,483,1,868,10,878,1319,3,1,3,0,1,0,66.57
雲林縣,口湖鄉,頂湖村,484,1,411,0,411,693,3,1,3,0,1,0,59.31
雲林縣,口湖鄉,埔南村,485,1,430,3,433,678,3,1,3,0,1,0,63.86
雲林縣,口湖鄉,埔北村,486,1,449,7,456,931,3,1,3,0,1,0,48.98
雲林縣,口湖鄉,謝厝村,487,1,605,11,616,1001,3,1,3,0,1,0,61.54
雲林縣,口湖鄉,蚵寮村,488,1,927,6,933,1472,3,1,3,0,1,0,63.38
雲林縣,口湖鄉,下崙村,489,1,447,2,449,901,3,1,3,0,1,0,49.83
雲林縣,口湖鄉,下崙村,490,1,649,3,652,1194,3,1,3,0,1,0,54.61
雲林縣,口湖鄉,崙中村,491,1,451,2,453,874,3,1,3,0,1,0,51.83
雲林縣,口湖鄉,崙中村,492,1,473,3,476,879,3,1,3,0,1,0,54.15
雲林縣,口湖鄉,崙東村,493,1,848,9,857,1525,3,1,3,0,1,0,56.20
雲林縣,口湖鄉,青蚶村,494,1,281,4,285,572,3,1,3,0,1,0,49.83
雲林縣,口湖鄉,港東村,495,1,876,8,884,1530,3,1,3,0,1,0,57.78
雲林縣,口湖鄉,港西村,496,1,464,8,472,803,3,1,3,0,1,0,58.78
雲林縣,口湖鄉,臺子村,497,1,235,2,237,350,3,1,3,0,1,0,67.71
雲林縣,口湖鄉,臺子村,498,1,863,7,870,1352,3,1,3,0,1,0,64.35
雲林縣,口湖鄉,成龍村,499,1,675,0,675,1033,3,1,3,0,1,0,65.34
雲林縣,口湖鄉,梧南村,500,1,597,4,601,910,3,1,3,0,1,0,66.04
雲林縣,口湖鄉,梧南村,501,1,573,3,576,956,3,1,3,0,1,0,60.25
雲林縣,口湖鄉,梧北村,502,1,776,3,779,1317,3,1,3,0,1,0,59.15
雲林縣,口湖鄉,水井村,503,1,686,6,692,1060,3,1,3,0,1,0,65.28
雲林縣,口湖鄉,後厝村,504,1,513,3,516,789,3,1,3,0,1,0,65.40
雲林縣,口湖鄉,湖口村,505,1,641,7,648,1057,3,1,3,0,1,0,61.31
雲林縣,口湖鄉,過港村,506,1,447,4,451,754,3,1,3,0,1,0,59.81
雲林縣,水林鄉,水北村,507,1,851,5,856,1374,3,1,3,0,1,0,62.30
雲林縣,水林鄉,水北村,508,1,652,4,656,904,3,1,3,0,1,0,72.57
雲林縣,水林鄉,水南村,509,1,803,5,808,1154,3,1,3,0,1,0,70.02
雲林縣,水林鄉,水南村,510,1,520,7,527,789,3,1,3,0,1,0,66.79
雲林縣,水林鄉,萬興村,511,1,495,3,498,762,3,1,3,0,1,0,65.35
雲林縣,水林鄉,尖山村,512,1,473,5,478,745,3,1,3,0,1,0,64.16
雲林縣,水林鄉,大溝村,513,1,712,5,717,1080,3,1,3,0,1,0,66.39
雲林縣,水林鄉,順興村,514,1,567,6,573,927,3,1,3,0,1,0,61.81
雲林縣,水林鄉,大山村,515,1,774,8,782,1173,3,1,3,0,1,0,66.67
雲林縣,水林鄉,後寮村,516,1,496,3,499,794,3,1,3,0,1,0,62.85
雲林縣,水林鄉,春埔村,517,1,644,5,649,1068,3,1,3,0,1,0,60.77
雲林縣,水林鄉,西井村,518,1,442,9,451,751,3,1,3,0,1,0,60.05
雲林縣,水林鄉,車港村,519,1,410,2,412,683,3,1,3,0,1,0,60.32
雲林縣,水林鄉,蘇秦村,520,1,673,9,682,1204,3,1,3,0,1,0,56.64
雲林縣,水林鄉,灣東村,521,1,459,5,464,753,3,1,3,0,1,0,61.62
雲林縣,水林鄉,灣西村,522,1,650,8,658,1060,3,1,3,0,1,0,62.08
雲林縣,水林鄉,蕃薯村,523,1,644,10,654,1039,3,1,3,0,1,0,62.95
雲林縣,水林鄉,山腳村,524,1,536,5,541,892,3,1,3,0,1,0,60.65
雲林縣,水林鄉,松北村,525,1,887,6,893,1228,3,1,3,0,1,0,72.72
雲林縣,水林鄉,松中村,526,1,410,4,414,608,3,1,3,0,1,0,68.09
雲林縣,水林鄉,松西村,527,1,521,8,529,786,3,1,3,0,1,0,67.30
雲林縣,水林鄉,舊埔村,528,1,516,8,524,854,3,1,3,0,1,0,61.36
雲林縣,水林鄉,塭底村,529,1,523,5,528,838,3,1,3,0,1,0,63.01
雲林縣,水林鄉,海埔村,530,1,701,8,709,1060,3,1,3,0,1,0,66.89
雲林縣,水林鄉,土厝村,531,1,807,6,813,1257,3,1,3,0,1,0,64.68
雲林縣,水林鄉,溪墘村,532,1,574,2,576,828,3,1,3,0,1,0,69.57
嘉義縣,太保市,太保里,1,1,993,9,1002,1791,3,1,3,0,1,0,55.95
嘉義縣,太保市,後庄里,2,1,293,3,296,499,3,1,3,0,1,0,59.32
嘉義縣,太保市,前潭里,3,1,832,9,841,1372,3,1,3,0,1,0,61.30
嘉義縣,太保市,後潭里,4,1,980,8,988,1516,3,1,3,0,1,0,65.17
嘉義縣,太保市,梅埔里,5,1,470,1,471,716,3,1,3,0,1,0,65.78
嘉義縣,太保市,梅埔里,6,1,263,4,267,384,3,1,3,0,1,0,69.53
嘉義縣,太保市,春珠里,7,1,502,9,511,868,3,1,3,0,1,0,58.87
嘉義縣,太保市,崙頂里,8,1,557,10,567,822,3,1,3,0,1,0,68.98
嘉義縣,太保市,安仁里,9,1,145,2,147,212,3,1,3,0,1,0,69.34
嘉義縣,太保市,安仁里,10,1,317,2,319,488,3,1,3,0,1,0,65.37
嘉義縣,太保市,安仁里,11,1,296,6,302,508,3,1,3,0,1,0,59.45
嘉義縣,太保市,東勢里,12,1,575,5,580,894,3,1,3,0,1,0,64.88
嘉義縣,太保市,新埤里,13,1,746,5,751,1206,3,1,3,0,1,0,62.27
嘉義縣,太保市,舊埤里,14,1,536,1,537,891,3,1,3,0,1,0,60.27
嘉義縣,太保市,舊埤里,15,1,430,7,437,964,3,1,3,0,1,0,45.33
嘉義縣,太保市,田尾里,16,1,287,3,290,493,3,1,3,0,1,0,58.82
嘉義縣,太保市,田尾里,17,1,136,1,137,223,3,1,3,0,1,0,61.43
嘉義縣,太保市,港尾里,18,1,228,1,229,308,3,1,3,0,1,0,74.35
嘉義縣,太保市,港尾里,19,1,162,3,165,256,3,1,3,0,1,0,64.45
嘉義縣,太保市,過溝里,20,1,414,2,416,623,3,1,3,0,1,0,66.77
嘉義縣,太保市,過溝里,21,1,932,5,937,1566,3,1,3,0,1,0,59.83
嘉義縣,太保市,麻寮里,22,1,834,17,851,1510,3,1,3,0,1,0,56.36
嘉義縣,太保市,麻寮里,23,1,734,9,743,1437,3,1,3,0,1,0,51.70
嘉義縣,太保市,南新里,24,1,1012,9,1021,1770,3,1,3,0,1,0,57.68
嘉義縣,太保市,北新里,25,1,635,5,640,1058,3,1,3,0,1,0,60.49
嘉義縣,太保市,北新里,26,1,617,9,626,1211,3,1,3,0,1,0,51.69
嘉義縣,太保市,埤鄉里,27,1,424,3,427,712,3,1,3,0,1,0,59.97
嘉義縣,朴子市,安福里,28,1,566,7,573,986,3,1,3,0,1,0,58.11
嘉義縣,朴子市,安福里,29,1,533,3,536,826,3,1,3,0,1,0,64.89
嘉義縣,朴子市,平和里,30,1,1133,13,1146,1866,3,1,3,0,1,0,61.41
嘉義縣,朴子市,內厝里,31,1,673,4,677,1107,3,1,3,0,1,0,61.16
嘉義縣,朴子市,開元里,32,1,305,1,306,481,3,1,3,0,1,0,63.62
嘉義縣,朴子市,順天里,33,1,438,6,444,710,3,1,3,0,1,0,62.54
嘉義縣,朴子市,中正里,34,1,428,4,432,699,3,1,3,0,1,0,61.8
嘉義縣,朴子市,博厚里,35,1,510,4,514,781,3,1,3,0,1,0,65.81
嘉義縣,朴子市,文化里,36,1,536,4,540,843,3,1,3,0,1,0,64.06
嘉義縣,朴子市,文化里,37,1,614,3,617,999,3,1,3,0,1,0,61.76
嘉義縣,朴子市,永和里,38,1,539,8,547,909,3,1,3,0,1,0,60.18
嘉義縣,朴子市,永和里,39,1,900,14,914,1535,3,1,3,0,1,0,59.54
嘉義縣,朴子市,竹圍里,40,1,1209,14,1223,2143,3,1,3,0,1,0,57.07
嘉義縣,朴子市,竹圍里,41,1,1000,7,1007,1643,3,1,3,0,1,0,61.29
嘉義縣,朴子市,新寮里,42,1,429,7,436,667,3,1,3,0,1,0,65.37
嘉義縣,朴子市,雙溪里,43,1,428,1,429,694,3,1,3,0,1,0,61.82
嘉義縣,朴子市,溪口里,44,1,510,7,517,814,3,1,3,0,1,0,63.51
嘉義縣,朴子市,德興里,45,1,692,4,696,1069,3,1,3,0,1,0,65.11
嘉義縣,朴子市,仁和里,46,1,423,3,426,641,3,1,3,0,1,0,66.46
嘉義縣,朴子市,大鄉里,47,1,838,12,850,1386,3,1,3,0,1,0,61.33
嘉義縣,朴子市,大鄉里,48,1,815,10,825,1274,3,1,3,0,1,0,64.76
嘉義縣,朴子市,大葛里,49,1,1129,18,1147,1838,3,1,3,0,1,0,62.40
嘉義縣,朴子市,佳禾里,50,1,389,1,390,626,3,1,3,0,1,0,62.30
嘉義縣,朴子市,竹村里,51,1,558,1,559,988,3,1,3,0,1,0,56.58
嘉義縣,朴子市,崁前里,52,1,668,8,676,971,3,1,3,0,1,0,69.62
嘉義縣,朴子市,崁後里,53,1,494,4,498,815,3,1,3,0,1,0,61.1
嘉義縣,朴子市,順安里,54,1,191,1,192,278,3,1,3,0,1,0,69.06
嘉義縣,朴子市,德家里,55,1,502,6,508,792,3,1,3,0,1,0,64.14
嘉義縣,朴子市,新庄里,56,1,379,5,384,617,3,1,3,0,1,0,62.24
嘉義縣,朴子市,梅華里,57,1,653,10,663,1127,3,1,3,0,1,0,58.83
嘉義縣,朴子市,松華里,58,1,891,12,903,1426,3,1,3,0,1,0,63.32
嘉義縣,朴子市,南竹里,59,1,336,2,338,556,3,1,3,0,1,0,60.79
嘉義縣,布袋鎮,岱江里,60,1,452,9,461,717,3,1,3,0,1,0,64.30
嘉義縣,布袋鎮,九龍里,61,1,249,3,252,442,3,1,3,0,1,0,57.01
嘉義縣,布袋鎮,岑海里,62,1,248,2,250,396,3,1,3,0,1,0,63.13
嘉義縣,布袋鎮,岑海里,63,1,855,7,862,1310,3,1,3,0,1,0,65.80
嘉義縣,布袋鎮,興中里,64,1,735,11,746,1203,3,1,3,0,1,0,62.01
嘉義縣,布袋鎮,光復里,65,1,674,14,688,1103,3,1,3,0,1,0,62.38
嘉義縣,布袋鎮,光復里,66,1,442,8,450,706,3,1,3,0,1,0,63.74
嘉義縣,布袋鎮,見龍里,67,1,545,3,548,982,3,1,3,0,1,0,55.80
嘉義縣,布袋鎮,新厝里,68,1,472,4,476,783,3,1,3,0,1,0,60.79
嘉義縣,布袋鎮,龍江里,69,1,503,13,516,818,3,1,3,0,1,0,63.08
嘉義縣,布袋鎮,西安里,70,1,863,6,869,1371,3,1,3,0,1,0,63.38
嘉義縣,布袋鎮,中安里,71,1,993,11,1004,1607,3,1,3,0,1,0,62.48
嘉義縣,布袋鎮,東安里,72,1,929,11,940,1521,3,1,3,0,1,0,61.80
嘉義縣,布袋鎮,樹林里,73,1,219,0,219,301,3,1,3,0,1,0,72.76
嘉義縣,布袋鎮,樹林里,74,1,180,4,184,264,3,1,3,0,1,0,69.7
嘉義縣,布袋鎮,貴舍里,75,1,310,3,313,490,3,1,3,0,1,0,63.88
嘉義縣,布袋鎮,貴舍里,76,1,201,0,201,273,3,1,3,0,1,0,73.63
嘉義縣,布袋鎮,永安里,77,1,648,13,661,1166,3,1,3,0,1,0,56.69
嘉義縣,布袋鎮,東港里,78,1,582,6,588,962,3,1,3,0,1,0,61.12
嘉義縣,布袋鎮,東港里,79,1,598,5,603,982,3,1,3,0,1,0,61.41
嘉義縣,布袋鎮,江山里,80,1,215,1,216,326,3,1,3,0,1,0,66.26
嘉義縣,布袋鎮,菜舖里,81,1,105,1,106,201,3,1,3,0,1,0,52.74
嘉義縣,布袋鎮,菜舖里,82,1,158,3,161,241,3,1,3,0,1,0,66.80
嘉義縣,布袋鎮,考試里,83,1,86,0,86,138,3,1,3,0,1,0,62.32
嘉義縣,布袋鎮,考試里,84,1,120,1,121,200,3,1,3,0,1,0,60.50
嘉義縣,布袋鎮,振寮里,85,1,508,4,512,808,3,1,3,0,1,0,63.37
嘉義縣,布袋鎮,新岑里,86,1,617,9,626,1050,3,1,3,0,1,0,59.62
嘉義縣,布袋鎮,新民里,87,1,657,4,661,1239,3,1,3,0,1,0,53.35
嘉義縣,布袋鎮,復興里,88,1,662,13,675,1162,3,1,3,0,1,0,58.09
嘉義縣,布袋鎮,復興里,89,1,742,6,748,1277,3,1,3,0,1,0,58.57
嘉義縣,布袋鎮,好美里,90,1,596,10,606,1110,3,1,3,0,1,0,54.59
嘉義縣,大林鎮,東林里,91,1,338,4,342,494,3,1,3,0,1,0,69.23
嘉義縣,大林鎮,西林里,92,1,1183,9,1192,1988,3,1,3,0,1,0,59.96
嘉義縣,大林鎮,吉林里,93,1,610,5,615,1012,3,1,3,0,1,0,60.77
嘉義縣,大林鎮,平林里,94,1,1082,12,1094,1853,3,1,3,0,1,0,59.04
嘉義縣,大林鎮,平林里,95,1,799,4,803,1326,3,1,3,0,1,0,60.56
嘉義縣,大林鎮,平林里,96,1,1004,4,1008,1801,3,1,3,0,1,0,55.97
嘉義縣,大林鎮,明華里,97,1,697,11,708,1132,3,1,3,0,1,0,62.54
嘉義縣,大林鎮,明和里,98,1,860,5,865,1414,3,1,3,0,1,0,61.17
嘉義縣,大林鎮,排路里,99,1,437,2,439,682,3,1,3,0,1,0,64.37
嘉義縣,大林鎮,西結里,100,1,466,3,469,808,3,1,3,0,1,0,58.04
嘉義縣,大林鎮,湖北里,101,1,436,2,438,666,3,1,3,0,1,0,65.77
嘉義縣,大林鎮,大糖里,102,1,179,1,180,303,3,1,3,0,1,0,59.41
嘉義縣,大林鎮,大美里,103,1,1126,14,1140,1751,3,1,3,0,1,0,65.11
嘉義縣,大林鎮,過溪里,104,1,907,11,918,1458,3,1,3,0,1,0,62.96
嘉義縣,大林鎮,中坑里,105,1,688,5,693,1093,3,1,3,0,1,0,63.40
嘉義縣,大林鎮,中坑里,106,1,219,3,222,403,3,1,3,0,1,0,55.09
嘉義縣,大林鎮,上林里,107,1,510,3,513,837,3,1,3,0,1,0,61.29
嘉義縣,大林鎮,中林里,108,1,900,10,910,1529,3,1,3,0,1,0,59.52
嘉義縣,大林鎮,三和里,109,1,1137,10,1147,1920,3,1,3,0,1,0,59.74
嘉義縣,大林鎮,溝背里,110,1,617,5,622,972,3,1,3,0,1,0,63.99
嘉義縣,大林鎮,義和里,111,1,473,0,473,689,3,1,3,0,1,0,68.65
嘉義縣,大林鎮,內林里,112,1,489,1,490,735,3,1,3,0,1,0,66.67
嘉義縣,大林鎮,三角里,113,1,531,6,537,848,3,1,3,0,1,0,63.33
嘉義縣,大林鎮,三村里,114,1,502,3,505,782,3,1,3,0,1,0,64.58
嘉義縣,民雄鄉,東榮村,115,1,661,6,667,1090,3,1,3,0,1,0,61.19
嘉義縣,民雄鄉,東榮村,116,1,522,3,525,983,3,1,3,0,1,0,53.41
嘉義縣,民雄鄉,中樂村,117,1,999,7,1006,1594,3,1,3,0,1,0,63.11
嘉義縣,民雄鄉,西安村,118,1,842,13,855,1508,3,1,3,0,1,0,56.70
嘉義縣,民雄鄉,西安村,119,1,928,4,932,1488,3,1,3,0,1,0,62.63
嘉義縣,民雄鄉,寮頂村,120,1,603,1,604,992,3,1,3,0,1,0,60.89
嘉義縣,民雄鄉,寮頂村,121,1,577,7,584,1089,3,1,3,0,1,0,53.63
嘉義縣,民雄鄉,福權村,122,1,827,9,836,1357,3,1,3,0,1,0,61.61
嘉義縣,民雄鄉,東湖村,123,1,1110,8,1118,1791,3,1,3,0,1,0,62.42
嘉義縣,民雄鄉,頂崙村,124,1,812,7,819,1368,3,1,3,0,1,0,59.87
嘉義縣,民雄鄉,菁埔村,125,1,1072,12,1084,1669,3,1,3,0,1,0,64.95
嘉義縣,民雄鄉,中和村,126,1,470,2,472,755,3,1,3,0,1,0,62.52
嘉義縣,民雄鄉,平和村,127,1,412,9,421,721,3,1,3,0,1,0,58.39
嘉義縣,民雄鄉,西昌村,128,1,451,11,462,770,3,1,3,0,1,0,60.00
嘉義縣,民雄鄉,豊收村,129,1,887,8,895,1499,3,1,3,0,1,0,59.71
嘉義縣,民雄鄉,豊收村,130,1,252,1,253,399,3,1,3,0,1,0,63.41
嘉義縣,民雄鄉,三興村,131,1,537,4,541,908,3,1,3,0,1,0,59.58
嘉義縣,民雄鄉,東興村,132,1,342,3,345,568,3,1,3,0,1,0,60.74
嘉義縣,民雄鄉,鎮北村,133,1,532,6,538,912,3,1,3,0,1,0,58.99
嘉義縣,民雄鄉,北斗村,134,1,1159,9,1168,2025,3,1,3,0,1,0,57.68
嘉義縣,民雄鄉,北斗村,135,1,433,3,436,743,3,1,3,0,1,0,58.68
嘉義縣,民雄鄉,北斗村,136,1,478,5,483,896,3,1,3,0,1,0,53.91
嘉義縣,民雄鄉,雙福村,137,1,995,10,1005,1787,3,1,3,0,1,0,56.24
嘉義縣,民雄鄉,福樂村,138,1,815,8,823,1532,3,1,3,0,1,0,53.72
嘉義縣,民雄鄉,福樂村,139,1,695,10,705,1272,3,1,3,0,1,0,55.42
嘉義縣,民雄鄉,福樂村,140,1,893,3,896,1581,3,1,3,0,1,0,56.67
嘉義縣,民雄鄉,大崎村,141,1,566,4,570,1022,3,1,3,0,1,0,55.77
嘉義縣,民雄鄉,大崎村,142,1,656,6,662,1146,3,1,3,0,1,0,57.77
嘉義縣,民雄鄉,秀林村,143,1,734,9,743,1404,3,1,3,0,1,0,52.92
嘉義縣,民雄鄉,秀林村,144,1,479,5,484,827,3,1,3,0,1,0,58.52
嘉義縣,民雄鄉,松山村,145,1,895,17,912,1629,3,1,3,0,1,0,55.99
嘉義縣,民雄鄉,興中村,146,1,1016,7,1023,1754,3,1,3,0,1,0,58.32
嘉義縣,民雄鄉,興南村,147,1,697,8,705,1186,3,1,3,0,1,0,59.44
嘉義縣,民雄鄉,興南村,148,1,507,6,513,1082,3,1,3,0,1,0,47.41
嘉義縣,民雄鄉,金興村,149,1,736,18,754,1242,3,1,3,0,1,0,60.71
嘉義縣,民雄鄉,金興村,150,1,750,14,764,1372,3,1,3,0,1,0,55.69
嘉義縣,民雄鄉,福興村,151,1,1017,12,1029,1764,3,1,3,0,1,0,58.33
嘉義縣,民雄鄉,文隆村,152,1,1167,10,1177,2015,3,1,3,0,1,0,58.41
嘉義縣,民雄鄉,山中村,153,1,923,4,927,1599,3,1,3,0,1,0,57.97
嘉義縣,民雄鄉,山中村,154,1,965,11,976,1872,3,1,3,0,1,0,52.14
嘉義縣,民雄鄉,中央村,155,1,766,5,771,1243,3,1,3,0,1,0,62.03
嘉義縣,溪口鄉,溪東村,156,1,846,10,856,1410,3,1,3,0,1,0,60.71
嘉義縣,溪口鄉,溪西村,157,1,423,5,428,725,3,1,3,0,1,0,59.03
嘉義縣,溪口鄉,溪北村,158,1,235,0,235,390,3,1,3,0,1,0,60.26
嘉義縣,溪口鄉,溪北村,159,1,160,1,161,292,3,1,3,0,1,0,55.14
嘉義縣,溪口鄉,柴林村,160,1,469,4,473,817,3,1,3,0,1,0,57.89
嘉義縣,溪口鄉,林腳村,161,1,512,6,518,872,3,1,3,0,1,0,59.40
嘉義縣,溪口鄉,美南村,162,1,709,2,711,1236,3,1,3,0,1,0,57.52
嘉義縣,溪口鄉,美北村,163,1,533,4,537,930,3,1,3,0,1,0,57.74
嘉義縣,溪口鄉,本厝村,164,1,350,4,354,591,3,1,3,0,1,0,59.90
嘉義縣,溪口鄉,本厝村,165,1,246,3,249,398,3,1,3,0,1,0,62.56
嘉義縣,溪口鄉,游東村,166,1,607,5,612,1080,3,1,3,0,1,0,56.67
嘉義縣,溪口鄉,游西村,167,1,435,4,439,786,3,1,3,0,1,0,55.85
嘉義縣,溪口鄉,柳溝村,168,1,534,6,540,901,3,1,3,0,1,0,59.93
嘉義縣,溪口鄉,柳溝村,169,1,224,2,226,374,3,1,3,0,1,0,60.43
嘉義縣,溪口鄉,疊溪村,170,1,585,2,587,1013,3,1,3,0,1,0,57.95
嘉義縣,溪口鄉,妙崙村,171,1,428,3,431,739,3,1,3,0,1,0,58.32
嘉義縣,溪口鄉,坪頂村,172,1,548,6,554,868,3,1,3,0,1,0,63.82
嘉義縣,新港鄉,宮前村,173,1,515,2,517,807,3,1,3,0,1,0,64.06
嘉義縣,新港鄉,宮前村,174,1,640,7,647,968,3,1,3,0,1,0,66.84
嘉義縣,新港鄉,宮後村,175,1,473,5,478,798,3,1,3,0,1,0,59.90
嘉義縣,新港鄉,宮後村,176,1,507,3,510,834,3,1,3,0,1,0,61.15
嘉義縣,新港鄉,大興村,177,1,879,9,888,1448,3,1,3,0,1,0,61.33
嘉義縣,新港鄉,福德村,178,1,911,3,914,1532,3,1,3,0,1,0,59.66
嘉義縣,新港鄉,古民村,179,1,716,6,722,1170,3,1,3,0,1,0,61.71
嘉義縣,新港鄉,中庄村,180,1,466,9,475,786,3,1,3,0,1,0,60.43
嘉義縣,新港鄉,中庄村,181,1,453,1,454,729,3,1,3,0,1,0,62.28
嘉義縣,新港鄉,大潭村,182,1,416,4,420,717,3,1,3,0,1,0,58.58
嘉義縣,新港鄉,大潭村,183,1,564,1,565,897,3,1,3,0,1,0,62.99
嘉義縣,新港鄉,西庄村,184,1,581,4,585,970,3,1,3,0,1,0,60.31
嘉義縣,新港鄉,月眉村,185,1,517,2,519,888,3,1,3,0,1,0,58.45
嘉義縣,新港鄉,月眉村,186,1,523,3,526,831,3,1,3,0,1,0,63.3
嘉義縣,新港鄉,月潭村,187,1,921,7,928,1436,3,1,3,0,1,0,64.62
嘉義縣,新港鄉,溪北村,188,1,847,8,855,1429,3,1,3,0,1,0,59.83
嘉義縣,新港鄉,菜公村,189,1,576,3,579,963,3,1,3,0,1,0,60.12
嘉義縣,新港鄉,中洋村,190,1,660,12,672,988,3,1,3,0,1,0,68.02
嘉義縣,新港鄉,三間村,191,1,615,9,624,983,3,1,3,0,1,0,63.48
嘉義縣,新港鄉,安和村,192,1,698,6,704,1120,3,1,3,0,1,0,62.86
嘉義縣,新港鄉,潭大村,193,1,672,3,675,1148,3,1,3,0,1,0,58.80
嘉義縣,新港鄉,南港村,194,1,645,5,650,1116,3,1,3,0,1,0,58.24
嘉義縣,新港鄉,板頭村,195,1,363,8,371,596,3,1,3,0,1,0,62.25
嘉義縣,新港鄉,共和村,196,1,498,3,501,848,3,1,3,0,1,0,59.08
嘉義縣,新港鄉,埤子村,197,1,388,1,389,598,3,1,3,0,1,0,65.05
嘉義縣,新港鄉,南崙村,198,1,588,4,592,942,3,1,3,0,1,0,62.85
嘉義縣,新港鄉,北崙村,199,1,350,7,357,580,3,1,3,0,1,0,61.55
嘉義縣,新港鄉,海瀛村,200,1,351,2,353,500,3,1,3,0,1,0,70.60
嘉義縣,六腳鄉,蒜頭村,201,1,743,10,753,1291,3,1,3,0,1,0,58.33
嘉義縣,六腳鄉,蒜東村,202,1,505,5,510,940,3,1,3,0,1,0,54.26
嘉義縣,六腳鄉,蒜南村,203,1,521,3,524,903,3,1,3,0,1,0,58.03
嘉義縣,六腳鄉,工廠村,204,1,187,5,192,294,3,1,3,0,1,0,65.31
嘉義縣,六腳鄉,灣南村,205,1,729,6,735,1233,3,1,3,0,1,0,59.61
嘉義縣,六腳鄉,灣北村,206,1,760,5,765,1287,3,1,3,0,1,0,59.44
嘉義縣,六腳鄉,雙涵村,207,1,528,2,530,895,3,1,3,0,1,0,59.22
嘉義縣,六腳鄉,塗師村,208,1,422,2,424,745,3,1,3,0,1,0,56.91
嘉義縣,六腳鄉,三義村,209,1,339,5,344,587,3,1,3,0,1,0,58.60
嘉義縣,六腳鄉,三義村,210,1,91,2,93,192,3,1,3,0,1,0,48.44
嘉義縣,六腳鄉,正義村,211,1,147,0,147,250,3,1,3,0,1,0,58.80
嘉義縣,六腳鄉,正義村,212,1,164,2,166,282,3,1,3,0,1,0,58.87
嘉義縣,六腳鄉,正義村,213,1,236,3,239,380,3,1,3,0,1,0,62.89
嘉義縣,六腳鄉,正義村,214,1,302,2,304,519,3,1,3,0,1,0,58.57
嘉義縣,六腳鄉,溪厝村,215,1,343,2,345,628,3,1,3,0,1,0,54.94
嘉義縣,六腳鄉,港美村,216,1,505,7,512,791,3,1,3,0,1,0,64.73
嘉義縣,六腳鄉,豐美村,217,1,671,6,677,1085,3,1,3,0,1,0,62.40
嘉義縣,六腳鄉,六斗村,218,1,562,6,568,919,3,1,3,0,1,0,61.81
嘉義縣,六腳鄉,崙陽村,219,1,582,6,588,991,3,1,3,0,1,0,59.33
嘉義縣,六腳鄉,蘇厝村,220,1,896,6,902,1453,3,1,3,0,1,0,62.08
嘉義縣,六腳鄉,竹本村,221,1,399,6,405,719,3,1,3,0,1,0,56.33
嘉義縣,六腳鄉,永賢村,222,1,274,10,284,561,3,1,3,0,1,0,50.62
嘉義縣,六腳鄉,魚寮村,223,1,434,3,437,758,3,1,3,0,1,0,57.65
嘉義縣,六腳鄉,潭墘村,224,1,492,6,498,954,3,1,3,0,1,0,52.20
嘉義縣,六腳鄉,六腳村,225,1,488,4,492,879,3,1,3,0,1,0,55.97
嘉義縣,六腳鄉,六南村,226,1,328,3,331,630,3,1,3,0,1,0,52.54
嘉義縣,六腳鄉,崩山村,227,1,460,4,464,787,3,1,3,0,1,0,58.96
嘉義縣,六腳鄉,古林村,228,1,505,3,508,838,3,1,3,0,1,0,60.62
嘉義縣,六腳鄉,更寮村,229,1,233,1,234,429,3,1,3,0,1,0,54.55
嘉義縣,六腳鄉,更寮村,230,1,101,2,103,184,3,1,3,0,1,0,55.98
嘉義縣,東石鄉,東石村,231,1,1053,10,1063,1822,3,1,3,0,1,0,58.34
嘉義縣,東石鄉,猿樹村,232,1,602,8,610,1016,3,1,3,0,1,0,60.04
嘉義縣,東石鄉,塭港村,233,1,996,7,1003,1623,3,1,3,0,1,0,61.80
嘉義縣,東石鄉,型厝村,234,1,888,9,897,1475,3,1,3,0,1,0,60.81
嘉義縣,東石鄉,三家村,235,1,755,4,759,1267,3,1,3,0,1,0,59.91
嘉義縣,東石鄉,永屯村,236,1,457,0,457,712,3,1,3,0,1,0,64.19
嘉義縣,東石鄉,海埔村,237,1,285,1,286,455,3,1,3,0,1,0,62.86
嘉義縣,東石鄉,龍港村,238,1,591,4,595,976,3,1,3,0,1,0,60.96
嘉義縣,東石鄉,副瀨村,239,1,625,3,628,1145,3,1,3,0,1,0,54.85
嘉義縣,東石鄉,下揖村,240,1,502,4,506,871,3,1,3,0,1,0,58.09
嘉義縣,東石鄉,頂揖村,241,1,137,0,137,191,3,1,3,0,1,0,71.73
嘉義縣,東石鄉,頂揖村,242,1,136,0,136,240,3,1,3,0,1,0,56.67
嘉義縣,東石鄉,溪下村,243,1,641,8,649,1076,3,1,3,0,1,0,60.32
嘉義縣,東石鄉,港口村,244,1,215,2,217,381,3,1,3,0,1,0,56.96
嘉義縣,東石鄉,鰲鼓村,245,1,640,5,645,1087,3,1,3,0,1,0,59.34
嘉義縣,東石鄉,鰲鼓村,246,1,192,2,194,283,3,1,3,0,1,0,68.55
嘉義縣,東石鄉,港墘村,247,1,889,15,904,1310,3,1,3,0,1,0,69.01
嘉義縣,東石鄉,蔦松村,248,1,556,9,565,902,3,1,3,0,1,0,62.64
嘉義縣,東石鄉,圍潭村,249,1,413,9,422,772,3,1,3,0,1,0,54.66
嘉義縣,東石鄉,洲仔村,250,1,547,11,558,958,3,1,3,0,1,0,58.25
嘉義縣,東石鄉,東崙村,251,1,234,1,235,399,3,1,3,0,1,0,58.90
嘉義縣,東石鄉,東崙村,252,1,232,3,235,416,3,1,3,0,1,0,56.49
嘉義縣,東石鄉,西崙村,253,1,677,11,688,1138,3,1,3,0,1,0,60.46
嘉義縣,東石鄉,塭仔村,254,1,619,4,623,995,3,1,3,0,1,0,62.61
嘉義縣,東石鄉,網寮村,255,1,769,18,787,1311,3,1,3,0,1,0,60.03
嘉義縣,東石鄉,掌潭村,256,1,280,3,283,446,3,1,3,0,1,0,63.45
嘉義縣,東石鄉,掌潭村,257,1,241,2,243,360,3,1,3,0,1,0,67.50
嘉義縣,義竹鄉,岸腳村,258,1,382,8,390,561,3,1,3,0,1,0,69.52
嘉義縣,義竹鄉,岸腳村,259,1,181,2,183,229,3,1,3,0,1,0,79.91
嘉義縣,義竹鄉,義竹村,260,1,1041,17,1058,1532,3,1,3,0,1,0,69.06
嘉義縣,義竹鄉,六桂村,261,1,888,11,899,1291,3,1,3,0,1,0,69.64
嘉義縣,義竹鄉,仁里村,262,1,653,6,659,903,3,1,3,0,1,0,72.98
嘉義縣,義竹鄉,傳芳村,263,1,502,9,511,714,3,1,3,0,1,0,71.57
嘉義縣,義竹鄉,頭竹村,264,1,949,9,958,1305,3,1,3,0,1,0,73.41
嘉義縣,義竹鄉,五厝村,265,1,277,1,278,429,3,1,3,0,1,0,64.8
嘉義縣,義竹鄉,中平村,266,1,251,2,253,346,3,1,3,0,1,0,73.12
嘉義縣,義竹鄉,中平村,267,1,90,0,90,126,3,1,3,0,1,0,71.43
嘉義縣,義竹鄉,埤前村,268,1,572,13,585,803,3,1,3,0,1,0,72.85
嘉義縣,義竹鄉,平溪村,269,1,291,3,294,445,3,1,3,0,1,0,66.07
嘉義縣,義竹鄉,後鎮村,270,1,328,3,331,483,3,1,3,0,1,0,68.53
嘉義縣,義竹鄉,北華村,271,1,400,8,408,595,3,1,3,0,1,0,68.57
嘉義縣,義竹鄉,新店村,272,1,1031,11,1042,1534,3,1,3,0,1,0,67.93
嘉義縣,義竹鄉,東過村,273,1,573,5,578,862,3,1,3,0,1,0,67.05
嘉義縣,義竹鄉,西過村,274,1,633,5,638,891,3,1,3,0,1,0,71.6
嘉義縣,義竹鄉,官和村,275,1,567,9,576,860,3,1,3,0,1,0,66.98
嘉義縣,義竹鄉,官順村,276,1,331,5,336,524,3,1,3,0,1,0,64.12
嘉義縣,義竹鄉,新富村,277,1,421,2,423,585,3,1,3,0,1,0,72.31
嘉義縣,義竹鄉,東光村,278,1,490,1,491,668,3,1,3,0,1,0,73.5
嘉義縣,義竹鄉,東光村,279,1,89,2,91,160,3,1,3,0,1,0,56.88
嘉義縣,義竹鄉,東榮村,280,1,312,2,314,475,3,1,3,0,1,0,66.11
嘉義縣,義竹鄉,龍蛟村,281,1,456,6,462,673,3,1,3,0,1,0,68.65
嘉義縣,義竹鄉,溪洲村,282,1,386,6,392,606,3,1,3,0,1,0,64.69
嘉義縣,義竹鄉,溪洲村,283,1,89,0,89,144,3,1,3,0,1,0,61.81
嘉義縣,鹿草鄉,後寮村,284,1,328,5,333,512,3,1,3,0,1,0,65.04
嘉義縣,鹿草鄉,鹿東村,285,1,449,2,451,652,3,1,3,0,1,0,69.17
嘉義縣,鹿草鄉,鹿草村,286,1,858,11,869,1334,3,1,3,0,1,0,65.14
嘉義縣,鹿草鄉,西井村,287,1,788,6,794,1163,3,1,3,0,1,0,68.27
嘉義縣,鹿草鄉,豊稠村,288,1,200,2,202,303,3,1,3,0,1,0,66.67
嘉義縣,鹿草鄉,豊稠村,289,1,108,0,108,161,3,1,3,0,1,0,67.08
嘉義縣,鹿草鄉,重寮村,290,1,735,9,744,1155,3,1,3,0,1,0,64.42
嘉義縣,鹿草鄉,施家村,291,1,334,3,337,517,3,1,3,0,1,0,65.18
嘉義縣,鹿草鄉,下潭村,292,1,561,0,561,903,3,1,3,0,1,0,62.13
嘉義縣,鹿草鄉,光潭村,293,1,710,7,717,1116,3,1,3,0,1,0,64.25
嘉義縣,鹿草鄉,碧潭村,294,1,679,7,686,1078,3,1,3,0,1,0,63.64
嘉義縣,鹿草鄉,松竹村,295,1,557,1,558,922,3,1,3,0,1,0,60.52
嘉義縣,鹿草鄉,竹山村,296,1,455,7,462,698,3,1,3,0,1,0,66.19
嘉義縣,鹿草鄉,竹山村,297,1,145,2,147,227,3,1,3,0,1,0,64.76
嘉義縣,鹿草鄉,後堀村,298,1,683,8,691,980,3,1,3,0,1,0,70.51
嘉義縣,鹿草鄉,後堀村,299,1,231,0,231,322,3,1,3,0,1,0,71.74
嘉義縣,鹿草鄉,三角村,300,1,768,4,772,1126,3,1,3,0,1,0,68.56
嘉義縣,鹿草鄉,三角村,301,1,278,3,281,402,3,1,3,0,1,0,69.9
嘉義縣,鹿草鄉,下麻村,302,1,211,2,213,287,3,1,3,0,1,0,74.22
嘉義縣,鹿草鄉,下麻村,303,1,192,2,194,281,3,1,3,0,1,0,69.04
嘉義縣,水上鄉,水上村,304,1,377,3,380,610,3,1,3,0,1,0,62.3
嘉義縣,水上鄉,水上村,305,1,537,4,541,807,3,1,3,0,1,0,67.04
嘉義縣,水上鄉,水上村,306,1,1077,10,1087,1732,3,1,3,0,1,0,62.76
嘉義縣,水上鄉,水頭村,307,1,1076,4,1080,1645,3,1,3,0,1,0,65.65
嘉義縣,水上鄉,水頭村,308,1,353,2,355,515,3,1,3,0,1,0,68.93
嘉義縣,水上鄉,粗溪村,309,1,752,10,762,1131,3,1,3,0,1,0,67.37
嘉義縣,水上鄉,粗溪村,310,1,253,0,253,354,3,1,3,0,1,0,71.47
嘉義縣,水上鄉,下寮村,311,1,287,3,290,494,3,1,3,0,1,0,58.7
嘉義縣,水上鄉,下寮村,312,1,716,8,724,1134,3,1,3,0,1,0,63.84
嘉義縣,水上鄉,三和村,313,1,681,9,690,1126,3,1,3,0,1,0,61.28
嘉義縣,水上鄉,三和村,314,1,464,4,468,670,3,1,3,0,1,0,69.85
嘉義縣,水上鄉,回歸村,315,1,406,10,416,642,3,1,3,0,1,0,64.8
嘉義縣,水上鄉,大堀村,316,1,415,1,416,539,3,1,3,0,1,0,77.18
嘉義縣,水上鄉,大堀村,317,1,430,4,434,586,3,1,3,0,1,0,74.06
嘉義縣,水上鄉,大堀村,318,1,247,3,250,360,3,1,3,0,1,0,69.44
嘉義縣,水上鄉,大崙村,319,1,1217,13,1230,1954,3,1,3,0,1,0,62.95
嘉義縣,水上鄉,塗溝村,320,1,557,4,561,839,3,1,3,0,1,0,66.87
嘉義縣,水上鄉,龍德村,321,1,1304,12,1316,1835,3,1,3,0,1,0,71.72
嘉義縣,水上鄉,溪洲村,322,1,702,4,706,1104,3,1,3,0,1,0,63.95
嘉義縣,水上鄉,三鎮村,323,1,463,3,466,681,3,1,3,0,1,0,68.43
嘉義縣,水上鄉,靖和村,324,1,392,1,393,529,3,1,3,0,1,0,74.29
嘉義縣,水上鄉,南和村,325,1,523,9,532,811,3,1,3,0,1,0,65.6
嘉義縣,水上鄉,南和村,326,1,290,3,293,491,3,1,3,0,1,0,59.67
嘉義縣,水上鄉,柳新村,327,1,849,8,857,1371,3,1,3,0,1,0,62.51
嘉義縣,水上鄉,柳新村,328,1,492,8,500,828,3,1,3,0,1,0,60.39
嘉義縣,水上鄉,柳林村,329,1,1101,17,1118,1727,3,1,3,0,1,0,64.74
嘉義縣,水上鄉,柳鄉村,330,1,1161,10,1171,1863,3,1,3,0,1,0,62.86
嘉義縣,水上鄉,內溪村,331,1,612,11,623,996,3,1,3,0,1,0,62.55
嘉義縣,水上鄉,寬士村,332,1,968,9,977,1798,3,1,3,0,1,0,54.34
嘉義縣,水上鄉,寬士村,333,1,958,11,969,1825,3,1,3,0,1,0,53.1
嘉義縣,水上鄉,民生村,334,1,750,11,761,1323,3,1,3,0,1,0,57.52
嘉義縣,水上鄉,民生村,335,1,906,12,918,1557,3,1,3,0,1,0,58.96
嘉義縣,水上鄉,義興村,336,1,545,8,553,778,3,1,3,0,1,0,71.08
嘉義縣,水上鄉,中庄村,337,1,1115,16,1131,1848,3,1,3,0,1,0,61.2
嘉義縣,水上鄉,忠和村,338,1,1065,12,1077,1847,3,1,3,0,1,0,58.31
嘉義縣,水上鄉,南鄉村,339,1,532,4,536,796,3,1,3,0,1,0,67.34
嘉義縣,水上鄉,三界村,340,1,665,5,670,1023,3,1,3,0,1,0,65.49
嘉義縣,水上鄉,國姓村,341,1,779,7,786,1315,3,1,3,0,1,0,59.77
嘉義縣,中埔鄉,中埔村,342,1,1003,7,1010,1635,3,1,3,0,1,0,61.77
嘉義縣,中埔鄉,鹽館村,343,1,522,7,529,857,3,1,3,0,1,0,61.73
嘉義縣,中埔鄉,龍門村,344,1,475,3,478,749,3,1,3,0,1,0,63.82
嘉義縣,中埔鄉,裕民村,345,1,503,6,509,882,3,1,3,0,1,0,57.71
嘉義縣,中埔鄉,金蘭村,346,1,762,4,766,1353,3,1,3,0,1,0,56.61
嘉義縣,中埔鄉,富收村,347,1,586,5,591,1054,3,1,3,0,1,0,56.07
嘉義縣,中埔鄉,富收村,348,1,824,10,834,1575,3,1,3,0,1,0,52.95
嘉義縣,中埔鄉,和睦村,349,1,808,4,812,1517,3,1,3,0,1,0,53.53
嘉義縣,中埔鄉,和睦村,350,1,673,3,676,1192,3,1,3,0,1,0,56.71
嘉義縣,中埔鄉,和美村,351,1,1030,8,1038,1822,3,1,3,0,1,0,56.97
嘉義縣,中埔鄉,和美村,352,1,906,12,918,1785,3,1,3,0,1,0,51.43
嘉義縣,中埔鄉,和美村,353,1,1013,9,1022,1975,3,1,3,0,1,0,51.75
嘉義縣,中埔鄉,和興村,354,1,1054,11,1065,2269,3,1,3,0,1,0,46.94
嘉義縣,中埔鄉,和興村,355,1,748,12,760,1568,3,1,3,0,1,0,48.47
嘉義縣,中埔鄉,和興村,356,1,625,5,630,1141,3,1,3,0,1,0,55.21
嘉義縣,中埔鄉,隆興村,357,1,1031,11,1042,1690,3,1,3,0,1,0,61.66
嘉義縣,中埔鄉,義仁村,358,1,790,9,799,1348,3,1,3,0,1,0,59.27
嘉義縣,中埔鄉,社口村,359,1,881,17,898,1621,3,1,3,0,1,0,55.4
嘉義縣,中埔鄉,社口村,360,1,273,3,276,471,3,1,3,0,1,0,58.6
嘉義縣,中埔鄉,灣潭村,361,1,644,7,651,1084,3,1,3,0,1,0,60.06
嘉義縣,中埔鄉,石弄村,362,1,525,3,528,914,3,1,3,0,1,0,57.77
嘉義縣,中埔鄉,石弄村,363,1,211,1,212,304,3,1,3,0,1,0,69.74
嘉義縣,中埔鄉,頂埔村,364,1,579,6,585,963,3,1,3,0,1,0,60.75
嘉義縣,中埔鄉,同仁村,365,1,817,10,827,1333,3,1,3,0,1,0,62.04
嘉義縣,中埔鄉,同仁村,366,1,393,4,397,678,3,1,3,0,1,0,58.55
嘉義縣,中埔鄉,深坑村,367,1,506,7,513,738,3,1,3,0,1,0,69.51
嘉義縣,中埔鄉,三層村,368,1,355,2,357,636,3,1,3,0,1,0,56.13
嘉義縣,中埔鄉,瑞豐村,369,1,454,3,457,721,3,1,3,0,1,0,63.38
嘉義縣,中埔鄉,沄水村,370,1,333,5,338,548,3,1,3,0,1,0,61.68
嘉義縣,中埔鄉,沄水村,371,1,343,3,346,556,3,1,3,0,1,0,62.23
嘉義縣,中埔鄉,東興村,372,1,246,0,246,332,3,1,3,0,1,0,74.1
嘉義縣,中埔鄉,中崙村,373,1,216,3,219,327,3,1,3,0,1,0,66.97
嘉義縣,竹崎鄉,竹崎村,374,1,639,5,644,1225,3,1,3,0,1,0,52.57
嘉義縣,竹崎鄉,竹崎村,375,1,632,4,636,1099,3,1,3,0,1,0,57.87
嘉義縣,竹崎鄉,和平村,376,1,1079,11,1090,1910,3,1,3,0,1,0,57.07
嘉義縣,竹崎鄉,坑頭村,377,1,452,5,457,784,3,1,3,0,1,0,58.29
嘉義縣,竹崎鄉,沙坑村,378,1,532,9,541,872,3,1,3,0,1,0,62.04
嘉義縣,竹崎鄉,獅埜村,379,1,825,15,840,1303,3,1,3,0,1,0,64.47
嘉義縣,竹崎鄉,義和村,380,1,378,2,380,553,3,1,3,0,1,0,68.72
嘉義縣,竹崎鄉,義仁村,381,1,581,5,586,1054,3,1,3,0,1,0,55.6
嘉義縣,竹崎鄉,灣橋村,382,1,705,4,709,1216,3,1,3,0,1,0,58.31
嘉義縣,竹崎鄉,灣橋村,383,1,1019,15,1034,1818,3,1,3,0,1,0,56.88
嘉義縣,竹崎鄉,灣橋村,384,1,893,6,899,1759,3,1,3,0,1,0,51.11
嘉義縣,竹崎鄉,鹿滿村,385,1,762,9,771,1270,3,1,3,0,1,0,60.71
嘉義縣,竹崎鄉,紫雲村,386,1,752,10,762,1342,3,1,3,0,1,0,56.78
嘉義縣,竹崎鄉,內埔村,387,1,960,7,967,1597,3,1,3,0,1,0,60.55
嘉義縣,竹崎鄉,昇平村,388,1,425,4,429,690,3,1,3,0,1,0,62.17
嘉義縣,竹崎鄉,昇平村,389,1,660,5,665,1045,3,1,3,0,1,0,63.64
嘉義縣,竹崎鄉,桃源村,390,1,432,1,433,716,3,1,3,0,1,0,60.47
嘉義縣,竹崎鄉,桃源村,391,1,188,0,188,336,3,1,3,0,1,0,55.95
嘉義縣,竹崎鄉,白杞村,392,1,451,8,459,777,3,1,3,0,1,0,59.07
嘉義縣,竹崎鄉,塘興村,393,1,335,2,337,518,3,1,3,0,1,0,65.06
嘉義縣,竹崎鄉,塘興村,394,1,231,1,232,395,3,1,3,0,1,0,58.73
嘉義縣,竹崎鄉,義隆村,395,1,349,3,352,560,3,1,3,0,1,0,62.86
嘉義縣,竹崎鄉,龍山村,396,1,132,1,133,241,3,1,3,0,1,0,55.19
嘉義縣,竹崎鄉,龍山村,397,1,896,9,905,1478,3,1,3,0,1,0,61.23
嘉義縣,竹崎鄉,文峰村,398,1,432,12,444,755,3,1,3,0,1,0,58.81
嘉義縣,竹崎鄉,金獅村,399,1,288,0,288,473,3,1,3,0,1,0,60.89
嘉義縣,竹崎鄉,復金村,400,1,568,16,584,948,3,1,3,0,1,0,61.6
嘉義縣,竹崎鄉,復金村,401,1,579,3,582,948,3,1,3,0,1,0,61.39
嘉義縣,竹崎鄉,緞繻村,402,1,478,8,486,875,3,1,3,0,1,0,55.54
嘉義縣,竹崎鄉,緞繻村,403,1,74,3,77,127,3,1,3,0,1,0,60.63
嘉義縣,竹崎鄉,仁壽村,404,1,138,2,140,281,3,1,3,0,1,0,49.82
嘉義縣,竹崎鄉,中和村,405,1,199,2,201,423,3,1,3,0,1,0,47.52
嘉義縣,竹崎鄉,中和村,406,1,254,1,255,391,3,1,3,0,1,0,65.22
嘉義縣,竹崎鄉,光華村,407,1,305,2,307,476,3,1,3,0,1,0,64.5
嘉義縣,竹崎鄉,光華村,408,1,155,0,155,300,3,1,3,0,1,0,51.67
嘉義縣,梅山鄉,梅東村,409,1,649,10,659,1131,3,1,3,0,1,0,58.27
嘉義縣,梅山鄉,梅東村,410,1,633,6,639,1216,3,1,3,0,1,0,52.55
嘉義縣,梅山鄉,梅南村,411,1,600,2,602,1006,3,1,3,0,1,0,59.84
嘉義縣,梅山鄉,梅北村,412,1,672,5,677,1159,3,1,3,0,1,0,58.41
嘉義縣,梅山鄉,梅北村,413,1,686,7,693,1264,3,1,3,0,1,0,54.83
嘉義縣,梅山鄉,梅北村,414,1,899,7,906,1484,3,1,3,0,1,0,61.05
嘉義縣,梅山鄉,過山村,415,1,360,4,364,580,3,1,3,0,1,0,62.76
嘉義縣,梅山鄉,圳南村,416,1,312,0,312,498,3,1,3,0,1,0,62.65
嘉義縣,梅山鄉,圳北村,417,1,385,4,389,673,3,1,3,0,1,0,57.8
嘉義縣,梅山鄉,雙溪村,418,1,398,2,400,572,3,1,3,0,1,0,69.93
嘉義縣,梅山鄉,大南村,419,1,963,11,974,1698,3,1,3,0,1,0,57.36
嘉義縣,梅山鄉,安靖村,420,1,513,4,517,941,3,1,3,0,1,0,54.94
嘉義縣,梅山鄉,永興村,421,1,292,5,297,519,3,1,3,0,1,0,57.23
嘉義縣,梅山鄉,半天村,422,1,267,3,270,440,3,1,3,0,1,0,61.36
嘉義縣,梅山鄉,太平村,423,1,279,1,280,494,3,1,3,0,1,0,56.68
嘉義縣,梅山鄉,太興村,424,1,284,1,285,392,3,1,3,0,1,0,72.7
嘉義縣,梅山鄉,龍眼村,425,1,263,3,266,465,3,1,3,0,1,0,57.2
嘉義縣,梅山鄉,碧湖村,426,1,162,3,165,285,3,1,3,0,1,0,57.89
嘉義縣,梅山鄉,瑞峰村,427,1,456,4,460,759,3,1,3,0,1,0,60.61
嘉義縣,梅山鄉,瑞里村,428,1,447,17,464,729,3,1,3,0,1,0,63.65
嘉義縣,梅山鄉,太和村,429,1,344,5,349,599,3,1,3,0,1,0,58.26
嘉義縣,梅山鄉,太和村,430,1,280,2,282,441,3,1,3,0,1,0,63.95
嘉義縣,番路鄉,江西村,431,1,637,9,646,1066,3,1,3,0,1,0,60.6
嘉義縣,番路鄉,內甕村,432,1,214,1,215,410,3,1,3,0,1,0,52.44
嘉義縣,番路鄉,新福村,433,1,470,0,470,821,3,1,3,0,1,0,57.25
嘉義縣,番路鄉,下坑村,434,1,943,10,953,1675,3,1,3,0,1,0,56.9
嘉義縣,番路鄉,番路村,435,1,482,5,487,831,3,1,3,0,1,0,58.6
嘉義縣,番路鄉,民和村,436,1,512,5,517,807,3,1,3,0,1,0,64.06
嘉義縣,番路鄉,觸口村,437,1,288,2,290,427,3,1,3,0,1,0,67.92
嘉義縣,番路鄉,觸口村,438,1,299,2,301,403,3,1,3,0,1,0,74.69
嘉義縣,番路鄉,大湖村,439,1,461,4,465,830,3,1,3,0,1,0,56.02
嘉義縣,番路鄉,公田村,440,1,239,2,241,406,3,1,3,0,1,0,59.36
嘉義縣,番路鄉,公田村,441,1,289,4,293,547,3,1,3,0,1,0,53.56
嘉義縣,番路鄉,公興村,442,1,292,1,293,542,3,1,3,0,1,0,54.06
嘉義縣,番路鄉,草山村,443,1,114,1,115,176,3,1,3,0,1,0,65.34
嘉義縣,番路鄉,草山村,444,1,117,1,118,232,3,1,3,0,1,0,50.86
嘉義縣,大埔鄉,大埔村,445,1,512,3,515,976,3,1,3,0,1,0,52.77
嘉義縣,大埔鄉,和平村,446,1,123,0,123,233,3,1,3,0,1,0,52.79
嘉義縣,大埔鄉,和平村,447,1,130,0,130,236,3,1,3,0,1,0,55.08
嘉義縣,大埔鄉,永樂村,448,1,82,2,84,148,3,1,3,0,1,0,56.76
嘉義縣,大埔鄉,永樂村,449,1,97,1,98,152,3,1,3,0,1,0,64.47
嘉義縣,大埔鄉,茄苳村,450,1,176,2,178,330,3,1,3,0,1,0,53.94
嘉義縣,大埔鄉,茄苳村,451,1,88,0,88,148,3,1,3,0,1,0,59.46
嘉義縣,大埔鄉,茄苳村,452,1,114,0,114,230,3,1,3,0,1,0,49.57
嘉義縣,大埔鄉,西興村,453,1,199,1,200,376,3,1,3,0,1,0,53.19
嘉義縣,阿里山鄉,中山村,454,1,188,0,188,335,3,1,3,0,1,0,56.12
嘉義縣,阿里山鄉,中正村,455,1,92,0,92,170,3,1,3,0,1,0,54.12
嘉義縣,阿里山鄉,香林村,456,1,85,1,86,210,3,1,3,0,1,0,40.95
嘉義縣,阿里山鄉,十字村,457,1,132,2,134,238,3,1,3,0,1,0,56.3
嘉義縣,阿里山鄉,十字村,458,1,42,0,42,69,3,1,3,0,1,0,60.87
嘉義縣,阿里山鄉,豐山村,459,1,172,4,176,307,3,1,3,0,1,0,57.33
嘉義縣,阿里山鄉,來吉村,460,1,5,0,5,19,3,1,3,0,1,0,26.32
嘉義縣,阿里山鄉,樂野村,461,1,153,1,154,275,3,1,3,0,1,0,56
嘉義縣,阿里山鄉,達邦村,462,1,40,0,40,115,3,1,3,0,1,0,34.78
嘉義縣,阿里山鄉,里佳村,463,1,5,0,5,14,3,1,3,0,1,0,35.71
嘉義縣,阿里山鄉,山美村,464,1,8,0,8,30,3,1,3,0,1,0,26.67
嘉義縣,阿里山鄉,新美村,465,1,9,0,9,21,3,1,3,0,1,0,42.86
嘉義縣,阿里山鄉,茶山村,466,1,49,1,50,89,3,1,3,0,1,0,56.18
臺南縣,新營市,忠政里,1,1,834,2,836,1518,3,1,3,0,1,0,55.07
臺南縣,新營市,忠政里,2,1,818,4,822,1392,3,1,3,0,1,0,59.05
臺南縣,新營市,忠政里,3,1,886,7,893,1541,3,1,3,0,1,0,57.95
臺南縣,新營市,民權里,4,1,740,3,743,1215,3,1,3,0,1,0,61.15
臺南縣,新營市,民權里,5,1,711,4,715,1184,3,1,3,0,1,0,60.39
臺南縣,新營市,三仙里,6,1,749,29,778,1338,3,1,3,0,1,0,58.15
臺南縣,新營市,三仙里,7,1,787,7,794,1370,3,1,3,0,1,0,57.96
臺南縣,新營市,好平里,8,1,505,2,507,863,3,1,3,0,1,0,58.75
臺南縣,新營市,延平里,9,1,795,6,801,1253,3,1,3,0,1,0,63.93
臺南縣,新營市,永生里,10,1,647,5,652,986,3,1,3,0,1,0,66.13
臺南縣,新營市,大宏里,11,1,583,4,587,1028,3,1,3,0,1,0,57.10
臺南縣,新營市,大宏里,12,1,533,6,539,941,3,1,3,0,1,0,57.28
臺南縣,新營市,大宏里,13,1,681,5,686,1166,3,1,3,0,1,0,58.83
臺南縣,新營市,王公里,14,1,674,8,682,1160,3,1,3,0,1,0,58.79
臺南縣,新營市,王公里,15,1,677,6,683,1219,3,1,3,0,1,0,56.03
臺南縣,新營市,王公里,16,1,677,3,680,1190,3,1,3,0,1,0,57.14
臺南縣,新營市,王公里,17,1,775,4,779,1332,3,1,3,0,1,0,58.48
臺南縣,新營市,王公里,18,1,1024,6,1030,1746,3,1,3,0,1,0,58.99
臺南縣,新營市,中營里,19,1,627,3,630,1078,3,1,3,0,1,0,58.44
臺南縣,新營市,土庫里,20,1,840,8,848,1434,3,1,3,0,1,0,59.14
臺南縣,新營市,興安里,21,1,270,3,273,444,3,1,3,0,1,0,61.49
臺南縣,新營市,南興里,22,1,710,3,713,1138,3,1,3,0,1,0,62.65
臺南縣,新營市,南興里,23,1,698,6,704,1233,3,1,3,0,1,0,57.10
臺南縣,新營市,興業里,24,1,883,7,890,1509,3,1,3,0,1,0,58.98
臺南縣,新營市,民生里,25,1,831,10,841,1519,3,1,3,0,1,0,55.37
臺南縣,新營市,民生里,26,1,897,3,900,1563,3,1,3,0,1,0,57.58
臺南縣,新營市,新北里,27,1,945,6,951,1701,3,1,3,0,1,0,55.91
臺南縣,新營市,新北里,28,1,950,10,960,1782,3,1,3,0,1,0,53.87
臺南縣,新營市,新南里,29,1,733,10,743,1255,3,1,3,0,1,0,59.20
臺南縣,新營市,新南里,30,1,837,5,842,1600,3,1,3,0,1,0,52.63
臺南縣,新營市,民榮里,31,1,618,4,622,1041,3,1,3,0,1,0,59.75
臺南縣,新營市,民榮里,32,1,680,3,683,1240,3,1,3,0,1,0,55.08
臺南縣,新營市,民榮里,33,1,924,9,933,1737,3,1,3,0,1,0,53.71
臺南縣,新營市,埤寮里,34,1,971,5,976,1594,3,1,3,0,1,0,61.23
臺南縣,新營市,護鎮里,35,1,798,10,808,1296,3,1,3,0,1,0,62.35
臺南縣,新營市,太南里,36,1,915,5,920,1482,3,1,3,0,1,0,62.08
臺南縣,新營市,太北里,37,1,1001,6,1007,1594,3,1,3,0,1,0,63.17
臺南縣,新營市,南紙里,38,1,895,7,902,1400,3,1,3,0,1,0,64.43
臺南縣,新營市,南紙里,39,1,913,4,917,1680,3,1,3,0,1,0,54.58
臺南縣,新營市,嘉芳里,40,1,851,9,860,1499,3,1,3,0,1,0,57.37
臺南縣,新營市,舊埔里,41,1,205,1,206,359,3,1,3,0,1,0,57.38
臺南縣,新營市,角帶里,42,1,331,2,333,444,3,1,3,0,1,0,75.00
臺南縣,新營市,鐵線里,43,1,480,4,484,734,3,1,3,0,1,0,65.94
臺南縣,新營市,五興里,44,1,647,9,656,997,3,1,3,0,1,0,65.80
臺南縣,新營市,姑爺里,45,1,389,8,397,587,3,1,3,0,1,0,67.63
臺南縣,鹽水鎮,水秀里,46,1,598,1,599,925,3,1,3,0,1,0,64.76
臺南縣,鹽水鎮,水秀里,47,1,310,1,311,486,3,1,3,0,1,0,63.99
臺南縣,鹽水鎮,福得里,48,1,389,3,392,619,3,1,3,0,1,0,63.33
臺南縣,鹽水鎮,三生里,49,1,275,3,278,379,3,1,3,0,1,0,73.35
臺南縣,鹽水鎮,武廟里,50,1,374,4,378,551,3,1,3,0,1,0,68.60
臺南縣,鹽水鎮,中境里,51,1,341,4,345,532,3,1,3,0,1,0,64.85
臺南縣,鹽水鎮,水仙里,52,1,246,3,249,391,3,1,3,0,1,0,63.68
臺南縣,鹽水鎮,水正里,53,1,503,2,505,784,3,1,3,0,1,0,64.41
臺南縣,鹽水鎮,橋南里,54,1,431,6,437,755,3,1,3,0,1,0,57.88
臺南縣,鹽水鎮,橋南里,55,1,659,2,661,1194,3,1,3,0,1,0,55.36
臺南縣,鹽水鎮,橋南里,56,1,670,5,675,1313,3,1,3,0,1,0,51.41
臺南縣,鹽水鎮,舊營里,57,1,517,6,523,768,3,1,3,0,1,0,68.10
臺南縣,鹽水鎮,汫水里,58,1,588,8,596,968,3,1,3,0,1,0,61.57
臺南縣,鹽水鎮,岸內里,59,1,590,4,594,1082,3,1,3,0,1,0,54.90
臺南縣,鹽水鎮,岸內里,60,1,717,8,725,1195,3,1,3,0,1,0,60.67
臺南縣,鹽水鎮,岸內里,61,1,636,7,643,1006,3,1,3,0,1,0,63.92
臺南縣,鹽水鎮,義稠里,62,1,500,2,502,777,3,1,3,0,1,0,64.61
臺南縣,鹽水鎮,下中里,63,1,488,5,493,769,3,1,3,0,1,0,64.11
臺南縣,鹽水鎮,歡雅里,64,1,559,5,564,879,3,1,3,0,1,0,64.16
臺南縣,鹽水鎮,歡雅里,65,1,477,4,481,754,3,1,3,0,1,0,63.79
臺南縣,鹽水鎮,大莊里,66,1,302,3,305,490,3,1,3,0,1,0,62.24
臺南縣,鹽水鎮,桐寮里,67,1,221,4,225,297,3,1,3,0,1,0,75.76
臺南縣,鹽水鎮,後宅里,68,1,431,4,435,670,3,1,3,0,1,0,64.93
臺南縣,鹽水鎮,孫厝里,69,1,274,1,275,474,3,1,3,0,1,0,58.02
臺南縣,鹽水鎮,竹埔里,70,1,533,3,536,785,3,1,3,0,1,0,68.28
臺南縣,鹽水鎮,下林里,71,1,284,3,287,416,3,1,3,0,1,0,68.99
臺南縣,鹽水鎮,田寮里,72,1,181,3,184,272,3,1,3,0,1,0,67.65
臺南縣,鹽水鎮,大豐里,73,1,273,0,273,374,3,1,3,0,1,0,72.99
臺南縣,鹽水鎮,飯店里,74,1,261,1,262,411,3,1,3,0,1,0,63.75
臺南縣,鹽水鎮,河南里,75,1,359,2,361,545,3,1,3,0,1,0,66.24
臺南縣,鹽水鎮,南港里,76,1,636,7,643,949,3,1,3,0,1,0,67.76
臺南縣,白河鎮,白河里,77,1,720,8,728,1212,3,1,3,0,1,0,60.07
臺南縣,白河鎮,白河里,78,1,357,5,362,589,3,1,3,0,1,0,61.46
臺南縣,白河鎮,永安里,79,1,471,4,475,786,3,1,3,0,1,0,60.43
臺南縣,白河鎮,永安里,80,1,685,2,687,1096,3,1,3,0,1,0,62.68
臺南縣,白河鎮,永安里,81,1,576,5,581,937,3,1,3,0,1,0,62.01
臺南縣,白河鎮,外角里,82,1,934,6,940,1471,3,1,3,0,1,0,63.90
臺南縣,白河鎮,庄內里,83,1,483,3,486,748,3,1,3,0,1,0,64.97
臺南縣,白河鎮,庄內里,84,1,485,4,489,810,3,1,3,0,1,0,60.37
臺南縣,白河鎮,秀祐里,85,1,575,2,577,859,3,1,3,0,1,0,67.17
臺南縣,白河鎮,河東里,86,1,487,3,490,830,3,1,3,0,1,0,59.04
臺南縣,白河鎮,河東里,87,1,298,6,304,530,3,1,3,0,1,0,57.36
臺南縣,白河鎮,虎山里,88,1,315,3,318,455,3,1,3,0,1,0,69.89
臺南縣,白河鎮,大林里,89,1,365,6,371,622,3,1,3,0,1,0,59.65
臺南縣,白河鎮,崁頭里,90,1,298,5,303,460,3,1,3,0,1,0,65.87
臺南縣,白河鎮,六溪里,91,1,335,0,335,646,3,1,3,0,1,0,51.86
臺南縣,白河鎮,關嶺里,92,1,474,6,480,794,3,1,3,0,1,0,60.45
臺南縣,白河鎮,關嶺里,93,1,265,1,266,433,3,1,3,0,1,0,61.43
臺南縣,白河鎮,仙草里,94,1,429,4,433,743,3,1,3,0,1,0,58.28
臺南縣,白河鎮,仙草里,95,1,323,5,328,549,3,1,3,0,1,0,59.74
臺南縣,白河鎮,仙草里,96,1,337,8,345,581,3,1,3,0,1,0,59.38
臺南縣,白河鎮,玉豐里,97,1,792,6,798,1235,3,1,3,0,1,0,64.62
臺南縣,白河鎮,大竹里,98,1,927,5,932,1406,3,1,3,0,1,0,66.29
臺南縣,白河鎮,詔安里,99,1,581,4,585,870,3,1,3,0,1,0,67.24
臺南縣,白河鎮,廣安里,100,1,462,5,467,681,3,1,3,0,1,0,68.58
臺南縣,白河鎮,蓮潭里,101,1,581,9,590,883,3,1,3,0,1,0,66.82
臺南縣,白河鎮,竹門里,102,1,579,4,583,932,3,1,3,0,1,0,62.55
臺南縣,白河鎮,崎內里,103,1,500,2,502,782,3,1,3,0,1,0,64.19
臺南縣,白河鎮,昇安里,104,1,784,7,791,1257,3,1,3,0,1,0,62.93
臺南縣,白河鎮,汴頭里,105,1,474,5,479,704,3,1,3,0,1,0,68.04
臺南縣,白河鎮,內角里,106,1,515,2,517,774,3,1,3,0,1,0,66.80
臺南縣,白河鎮,草店里,107,1,557,1,558,913,3,1,3,0,1,0,61.12
臺南縣,白河鎮,甘宅里,108,1,380,5,385,658,3,1,3,0,1,0,58.51
臺南縣,柳營鄉,士林村,109,1,476,4,480,795,3,1,3,0,1,0,60.38
臺南縣,柳營鄉,士林村,110,1,444,5,449,750,3,1,3,0,1,0,59.87
臺南縣,柳營鄉,光福村,111,1,529,2,531,810,3,1,3,0,1,0,65.56
臺南縣,柳營鄉,光福村,112,1,632,8,640,1005,3,1,3,0,1,0,63.68
臺南縣,柳營鄉,中埕村,113,1,494,4,498,717,3,1,3,0,1,0,69.46
臺南縣,柳營鄉,東昇村,114,1,752,8,760,1224,3,1,3,0,1,0,62.09
臺南縣,柳營鄉,東昇村,115,1,788,0,788,1270,3,1,3,0,1,0,62.05
臺南縣,柳營鄉,八翁村,116,1,850,5,855,1291,3,1,3,0,1,0,66.23
臺南縣,柳營鄉,人和村,117,1,271,1,272,458,3,1,3,0,1,0,59.39
臺南縣,柳營鄉,人和村,118,1,203,3,206,313,3,1,3,0,1,0,65.81
臺南縣,柳營鄉,太康村,119,1,526,5,531,808,3,1,3,0,1,0,65.72
臺南縣,柳營鄉,太康村,120,1,433,5,438,702,3,1,3,0,1,0,62.39
臺南縣,柳營鄉,重溪村,121,1,497,1,498,759,3,1,3,0,1,0,65.61
臺南縣,柳營鄉,重溪村,122,1,469,6,475,733,3,1,3,0,1,0,64.80
臺南縣,柳營鄉,重溪村,123,1,204,3,207,292,3,1,3,0,1,0,70.89
臺南縣,柳營鄉,篤農村,124,1,433,2,435,693,3,1,3,0,1,0,62.77
臺南縣,柳營鄉,篤農村,125,1,472,2,474,716,3,1,3,0,1,0,66.20
臺南縣,柳營鄉,大農村,126,1,431,4,435,666,3,1,3,0,1,0,65.32
臺南縣,柳營鄉,神農村,127,1,725,5,730,1177,3,1,3,0,1,0,62.02
臺南縣,柳營鄉,神農村,128,1,158,1,159,214,3,1,3,0,1,0,74.30
臺南縣,柳營鄉,果毅村,129,1,651,4,655,1102,3,1,3,0,1,0,59.44
臺南縣,柳營鄉,果毅村,130,1,112,0,112,153,3,1,3,0,1,0,73.20
臺南縣,柳營鄉,旭山村,131,1,574,9,583,962,3,1,3,0,1,0,60.60
臺南縣,柳營鄉,旭山村,132,1,349,1,350,493,3,1,3,0,1,0,70.99
臺南縣,柳營鄉,旭山村,133,1,123,2,125,195,3,1,3,0,1,0,64.10
臺南縣,後壁鄉,後壁村,134,1,443,5,448,688,3,1,3,0,1,0,65.12
臺南縣,後壁鄉,後壁村,135,1,562,5,567,838,3,1,3,0,1,0,67.66
臺南縣,後壁鄉,侯伯村,136,1,483,4,487,765,3,1,3,0,1,0,63.66
臺南縣,後壁鄉,侯伯村,137,1,326,4,330,530,3,1,3,0,1,0,62.26
臺南縣,後壁鄉,嘉苳村,138,1,649,4,653,1021,3,1,3,0,1,0,63.96
臺南縣,後壁鄉,嘉苳村,139,1,149,1,150,232,3,1,3,0,1,0,64.66
臺南縣,後壁鄉,土溝村,140,1,392,3,395,600,3,1,3,0,1,0,65.83
臺南縣,後壁鄉,土溝村,141,1,466,2,468,733,3,1,3,0,1,0,63.85
臺南縣,後壁鄉,嘉田村,142,1,711,5,716,1180,3,1,3,0,1,0,60.68
臺南縣,後壁鄉,嘉民村,143,1,747,9,756,1278,3,1,3,0,1,0,59.15
臺南縣,後壁鄉,菁豊村,144,1,475,3,478,800,3,1,3,0,1,0,59.75
臺南縣,後壁鄉,崁頂村,145,1,333,4,337,479,3,1,3,0,1,0,70.35
臺南縣,後壁鄉,後部村,146,1,298,8,306,550,3,1,3,0,1,0,55.64
臺南縣,後壁鄉,墨林村,147,1,489,7,496,777,3,1,3,0,1,0,63.84
臺南縣,後壁鄉,菁寮村,148,1,282,2,284,448,3,1,3,0,1,0,63.39
臺南縣,後壁鄉,新嘉村,149,1,366,2,368,581,3,1,3,0,1,0,63.34
臺南縣,後壁鄉,新嘉村,150,1,331,2,333,548,3,1,3,0,1,0,60.77
臺南縣,後壁鄉,頂長村,151,1,372,1,373,545,3,1,3,0,1,0,68.44
臺南縣,後壁鄉,平安村,152,1,632,5,637,1048,3,1,3,0,1,0,60.78
臺南縣,後壁鄉,仕安村,153,1,400,5,405,569,3,1,3,0,1,0,71.18
臺南縣,後壁鄉,竹新村,154,1,691,5,696,985,3,1,3,0,1,0,70.66
臺南縣,後壁鄉,竹新村,155,1,290,2,292,452,3,1,3,0,1,0,64.60
臺南縣,後壁鄉,新東村,156,1,444,3,447,646,3,1,3,0,1,0,69.20
臺南縣,後壁鄉,新東村,157,1,525,7,532,868,3,1,3,0,1,0,61.29
臺南縣,後壁鄉,頂安村,158,1,757,6,763,1228,3,1,3,0,1,0,62.13
臺南縣,後壁鄉,長安村,159,1,438,5,443,682,3,1,3,0,1,0,64.96
臺南縣,後壁鄉,長安村,160,1,380,0,380,651,3,1,3,0,1,0,58.37
臺南縣,後壁鄉,福安村,161,1,731,13,744,1163,3,1,3,0,1,0,63.97
臺南縣,後壁鄉,烏樹村,162,1,484,6,490,813,3,1,3,0,1,0,60.27
臺南縣,東山鄉,東山村,163,1,783,6,789,1455,3,1,3,0,1,0,54.23
臺南縣,東山鄉,東中村,164,1,684,5,689,1184,3,1,3,0,1,0,58.19
臺南縣,東山鄉,東中村,165,1,674,7,681,1170,3,1,3,0,1,0,58.21
臺南縣,東山鄉,東正村,166,1,431,5,436,777,3,1,3,0,1,0,56.11
臺南縣,東山鄉,東正村,167,1,443,5,448,765,3,1,3,0,1,0,58.56
臺南縣,東山鄉,大客村,168,1,589,6,595,1166,3,1,3,0,1,0,51.03
臺南縣,東山鄉,三榮村,169,1,565,3,568,923,3,1,3,0,1,0,61.54
臺南縣,東山鄉,科里村,170,1,452,5,457,748,3,1,3,0,1,0,61.10
臺南縣,東山鄉,科里村,171,1,399,3,402,588,3,1,3,0,1,0,68.37
臺南縣,東山鄉,東河村,172,1,520,5,525,902,3,1,3,0,1,0,58.20
臺南縣,東山鄉,聖賢村,173,1,513,7,520,765,3,1,3,0,1,0,67.97
臺南縣,東山鄉,聖賢村,174,1,312,3,315,471,3,1,3,0,1,0,66.88
臺南縣,東山鄉,聖賢村,175,1,423,3,426,639,3,1,3,0,1,0,66.67
臺南縣,東山鄉,南溪村,176,1,294,6,300,500,3,1,3,0,1,0,60.00
臺南縣,東山鄉,水雲村,177,1,252,1,253,467,3,1,3,0,1,0,54.18
臺南縣,東山鄉,林安村,178,1,246,5,251,403,3,1,3,0,1,0,62.28
臺南縣,東山鄉,東原村,179,1,624,2,626,1124,3,1,3,0,1,0,55.69
臺南縣,東山鄉,東原村,180,1,621,4,625,1177,3,1,3,0,1,0,53.10
臺南縣,東山鄉,嶺南村,181,1,108,0,108,773,3,1,3,0,1,0,13.97
臺南縣,東山鄉,南勢村,182,1,625,5,630,1161,3,1,3,0,1,0,54.26
臺南縣,東山鄉,青山村,183,1,609,2,611,1129,3,1,3,0,1,0,54.12
臺南縣,東山鄉,高原村,184,1,564,3,567,955,3,1,3,0,1,0,59.37
臺南縣,麻豆鎮,穀興里,185,1,448,0,448,617,3,1,3,0,1,0,72.61
臺南縣,麻豆鎮,保安里,186,1,403,1,404,585,3,1,3,0,1,0,69.06
臺南縣,麻豆鎮,東角里,187,1,793,4,797,1193,3,1,3,0,1,0,66.81
臺南縣,麻豆鎮,東角里,188,1,583,2,585,923,3,1,3,0,1,0,63.38
臺南縣,麻豆鎮,晉江里,189,1,767,4,771,1126,3,1,3,0,1,0,68.47
臺南縣,麻豆鎮,晉江里,190,1,752,8,760,1185,3,1,3,0,1,0,64.14
臺南縣,麻豆鎮,巷口里,191,1,912,7,919,1408,3,1,3,0,1,0,65.27
臺南縣,麻豆鎮,中興里,192,1,611,3,614,967,3,1,3,0,1,0,63.50
臺南縣,麻豆鎮,中興里,193,1,590,2,592,940,3,1,3,0,1,0,62.98
臺南縣,麻豆鎮,興農里,194,1,886,10,896,1330,3,1,3,0,1,0,67.37
臺南縣,麻豆鎮,新建里,195,1,680,2,682,1002,3,1,3,0,1,0,68.06
臺南縣,麻豆鎮,油車里,196,1,988,11,999,1489,3,1,3,0,1,0,67.09
臺南縣,麻豆鎮,油車里,197,1,1005,7,1012,1489,3,1,3,0,1,0,67.97
臺南縣,麻豆鎮,北勢里,198,1,773,2,775,1145,3,1,3,0,1,0,67.69
臺南縣,麻豆鎮,大埕里,199,1,923,7,930,1409,3,1,3,0,1,0,66.00
臺南縣,麻豆鎮,大埕里,200,1,754,8,762,1122,3,1,3,0,1,0,67.91
臺南縣,麻豆鎮,總榮里,201,1,459,5,464,660,3,1,3,0,1,0,70.30
臺南縣,麻豆鎮,龍泉里,202,1,510,2,512,738,3,1,3,0,1,0,69.38
臺南縣,麻豆鎮,南勢里,203,1,436,3,439,655,3,1,3,0,1,0,67.02
臺南縣,麻豆鎮,南勢里,204,1,1037,5,1042,1586,3,1,3,0,1,0,65.70
臺南縣,麻豆鎮,寮部里,205,1,1051,11,1062,1555,3,1,3,0,1,0,68.30
臺南縣,麻豆鎮,小埤里,206,1,635,2,637,952,3,1,3,0,1,0,66.91
臺南縣,麻豆鎮,埤頭里,207,1,911,3,914,1322,3,1,3,0,1,0,69.14
臺南縣,麻豆鎮,大山里,208,1,397,3,400,531,3,1,3,0,1,0,75.33
臺南縣,麻豆鎮,海埔里,209,1,655,9,664,959,3,1,3,0,1,0,69.24
臺南縣,麻豆鎮,莊禮里,210,1,376,3,379,528,3,1,3,0,1,0,71.78
臺南縣,麻豆鎮,港尾里,211,1,796,9,805,1078,3,1,3,0,1,0,74.68
臺南縣,麻豆鎮,麻口里,212,1,705,4,709,1037,3,1,3,0,1,0,68.37
臺南縣,麻豆鎮,安東里,213,1,394,0,394,627,3,1,3,0,1,0,62.84
臺南縣,麻豆鎮,安業里,214,1,440,0,440,666,3,1,3,0,1,0,66.07
臺南縣,麻豆鎮,安西里,215,1,516,2,518,741,3,1,3,0,1,0,69.91
臺南縣,麻豆鎮,謝安里,216,1,643,5,648,935,3,1,3,0,1,0,69.30
臺南縣,麻豆鎮,中民里,217,1,581,2,583,842,3,1,3,0,1,0,69.24
臺南縣,麻豆鎮,安正里,218,1,564,3,567,839,3,1,3,0,1,0,67.58
臺南縣,麻豆鎮,磚井里,219,1,752,5,757,1138,3,1,3,0,1,0,66.52
臺南縣,下營鄉,下營村,220,1,641,4,645,958,3,1,3,0,1,0,67.33
臺南縣,下營鄉,仁里村,221,1,920,3,923,1373,3,1,3,0,1,0,67.23
臺南縣,下營鄉,仁里村,222,1,799,1,800,1260,3,1,3,0,1,0,63.49
臺南縣,下營鄉,宅內村,223,1,725,6,731,1138,3,1,3,0,1,0,64.24
臺南縣,下營鄉,後街村,224,1,1023,8,1031,1539,3,1,3,0,1,0,66.99
臺南縣,下營鄉,新興村,225,1,684,5,689,1075,3,1,3,0,1,0,64.09
臺南縣,下營鄉,新興村,226,1,701,7,708,1105,3,1,3,0,1,0,64.07
臺南縣,下營鄉,營前村,227,1,664,1,665,1042,3,1,3,0,1,0,63.82
臺南縣,下營鄉,營前村,228,1,714,3,717,1084,3,1,3,0,1,0,66.14
臺南縣,下營鄉,大屯村,229,1,560,2,562,802,3,1,3,0,1,0,70.07
臺南縣,下營鄉,大埤村,230,1,543,1,544,766,3,1,3,0,1,0,71.02
臺南縣,下營鄉,茅港村,231,1,805,9,814,1220,3,1,3,0,1,0,66.72
臺南縣,下營鄉,中營村,232,1,726,3,729,1140,3,1,3,0,1,0,63.95
臺南縣,下營鄉,開化村,233,1,655,2,657,997,3,1,3,0,1,0,65.90
臺南縣,下營鄉,開化村,234,1,550,3,553,861,3,1,3,0,1,0,64.23
臺南縣,下營鄉,西連村,235,1,602,9,611,872,3,1,3,0,1,0,70.07
臺南縣,下營鄉,賀建村,236,1,860,4,864,1334,3,1,3,0,1,0,64.77
臺南縣,下營鄉,甲中村,237,1,761,4,765,1173,3,1,3,0,1,0,65.22
臺南縣,下營鄉,紅厝村,238,1,846,8,854,1261,3,1,3,0,1,0,67.72
臺南縣,六甲鄉,六甲村,239,1,519,5,524,825,3,1,3,0,1,0,63.52
臺南縣,六甲鄉,六甲村,240,1,472,6,478,763,3,1,3,0,1,0,62.65
臺南縣,六甲鄉,六甲村,241,1,756,5,761,1222,3,1,3,0,1,0,62.27
臺南縣,六甲鄉,甲東村,242,1,828,8,836,1394,3,1,3,0,1,0,59.97
臺南縣,六甲鄉,甲東村,243,1,722,9,731,1187,3,1,3,0,1,0,61.58
臺南縣,六甲鄉,甲南村,244,1,825,4,829,1300,3,1,3,0,1,0,63.77
臺南縣,六甲鄉,龍湖村,245,1,617,8,625,1023,3,1,3,0,1,0,61.09
臺南縣,六甲鄉,七甲村,246,1,574,6,580,889,3,1,3,0,1,0,65.24
臺南縣,六甲鄉,二甲村,247,1,560,4,564,904,3,1,3,0,1,0,62.39
臺南縣,六甲鄉,二甲村,248,1,588,6,594,998,3,1,3,0,1,0,59.52
臺南縣,六甲鄉,二甲村,249,1,630,5,635,1034,3,1,3,0,1,0,61.41
臺南縣,六甲鄉,水林村,250,1,660,5,665,989,3,1,3,0,1,0,67.24
臺南縣,六甲鄉,水林村,251,1,609,6,615,957,3,1,3,0,1,0,64.26
臺南縣,六甲鄉,中社村,252,1,525,4,529,758,3,1,3,0,1,0,69.79
臺南縣,六甲鄉,中社村,253,1,520,4,524,827,3,1,3,0,1,0,63.36
臺南縣,六甲鄉,龜港村,254,1,666,9,675,1088,3,1,3,0,1,0,62.04
臺南縣,六甲鄉,菁埔村,255,1,420,4,424,600,3,1,3,0,1,0,70.67
臺南縣,六甲鄉,王爺村,256,1,521,6,527,830,3,1,3,0,1,0,63.49
臺南縣,六甲鄉,大丘村,257,1,467,2,469,731,3,1,3,0,1,0,64.16
臺南縣,官田鄉,官田村,258,1,635,3,638,955,3,1,3,0,1,0,66.81
臺南縣,官田鄉,官田村,259,1,607,9,616,964,3,1,3,0,1,0,63.90
臺南縣,官田鄉,二鎮村,260,1,815,11,826,1312,3,1,3,0,1,0,62.96
臺南縣,官田鄉,二鎮村,261,1,758,3,761,1176,3,1,3,0,1,0,64.71
臺南縣,官田鄉,湖山村,262,1,644,4,648,989,3,1,3,0,1,0,65.52
臺南縣,官田鄉,嘉南村,263,1,178,2,180,305,3,1,3,0,1,0,59.02
臺南縣,官田鄉,大崎村,264,1,316,0,316,476,3,1,3,0,1,0,66.39
臺南縣,官田鄉,隆田村,265,1,586,5,591,908,3,1,3,0,1,0,65.09
臺南縣,官田鄉,隆田村,266,1,593,6,599,954,3,1,3,0,1,0,62.79
臺南縣,官田鄉,隆本村,267,1,511,3,514,822,3,1,3,0,1,0,62.53
臺南縣,官田鄉,隆本村,268,1,698,4,702,1049,3,1,3,0,1,0,66.92
臺南縣,官田鄉,隆本村,269,1,665,5,670,1030,3,1,3,0,1,0,65.05
臺南縣,官田鄉,南部村,270,1,624,11,635,1110,3,1,3,0,1,0,57.21
臺南縣,官田鄉,東庄村,271,1,982,6,988,1396,3,1,3,0,1,0,70.77
臺南縣,官田鄉,西庄村,272,1,484,4,488,693,3,1,3,0,1,0,70.42
臺南縣,官田鄉,拔林村,273,1,415,2,417,592,3,1,3,0,1,0,70.44
臺南縣,官田鄉,渡頭村,274,1,544,1,545,788,3,1,3,0,1,0,69.16
臺南縣,官田鄉,渡頭村,275,1,584,5,589,824,3,1,3,0,1,0,71.48
臺南縣,官田鄉,渡頭村,276,1,368,3,371,560,3,1,3,0,1,0,66.25
臺南縣,官田鄉,社子村,277,1,557,5,562,906,3,1,3,0,1,0,62.03
臺南縣,大內鄉,石湖村,278,1,536,3,539,848,3,1,3,0,1,0,63.56
臺南縣,大內鄉,石湖村,279,1,176,2,178,267,3,1,3,0,1,0,66.67
臺南縣,大內鄉,石林村,280,1,509,5,514,782,3,1,3,0,1,0,65.73
臺南縣,大內鄉,石城村,281,1,894,10,904,1525,3,1,3,0,1,0,59.28
臺南縣,大內鄉,內江村,282,1,662,8,670,1072,3,1,3,0,1,0,62.50
臺南縣,大內鄉,大內村,283,1,552,2,554,843,3,1,3,0,1,0,65.72
臺南縣,大內鄉,內郭村,284,1,421,4,425,688,3,1,3,0,1,0,61.77
臺南縣,大內鄉,頭社村,285,1,616,7,623,1050,3,1,3,0,1,0,59.33
臺南縣,大內鄉,環湖村,286,1,535,2,537,901,3,1,3,0,1,0,59.60
臺南縣,大內鄉,二溪村,287,1,580,3,583,937,3,1,3,0,1,0,62.22
臺南縣,大內鄉,曲溪村,288,1,456,4,460,638,3,1,3,0,1,0,72.10
臺南縣,佳里鎮,東寧里,289,1,555,4,559,874,3,1,3,0,1,0,63.96
臺南縣,佳里鎮,東寧里,290,1,551,7,558,886,3,1,3,0,1,0,62.98
臺南縣,佳里鎮,忠仁里,291,1,738,5,743,1240,3,1,3,0,1,0,59.92
臺南縣,佳里鎮,忠仁里,292,1,942,6,948,1546,3,1,3,0,1,0,61.32
臺南縣,佳里鎮,鎮山里,293,1,667,6,673,1086,3,1,3,0,1,0,61.97
臺南縣,佳里鎮,鎮山里,294,1,769,4,773,1234,3,1,3,0,1,0,62.64
臺南縣,佳里鎮,鎮山里,295,1,725,3,728,1127,3,1,3,0,1,0,64.60
臺南縣,佳里鎮,鎮山里,296,1,827,6,833,1346,3,1,3,0,1,0,61.89
臺南縣,佳里鎮,建南里,297,1,889,5,894,1447,3,1,3,0,1,0,61.78
臺南縣,佳里鎮,建南里,298,1,887,7,894,1411,3,1,3,0,1,0,63.36
臺南縣,佳里鎮,建南里,299,1,980,4,984,1578,3,1,3,0,1,0,62.36
臺南縣,佳里鎮,建南里,300,1,944,8,952,1620,3,1,3,0,1,0,58.77
臺南縣,佳里鎮,安西里,301,1,746,6,752,1241,3,1,3,0,1,0,60.60
臺南縣,佳里鎮,安西里,302,1,744,2,746,1235,3,1,3,0,1,0,60.40
臺南縣,佳里鎮,安西里,303,1,772,5,777,1342,3,1,3,0,1,0,57.90
臺南縣,佳里鎮,安西里,304,1,1013,6,1019,1699,3,1,3,0,1,0,59.98
臺南縣,佳里鎮,安西里,305,1,757,3,760,1195,3,1,3,0,1,0,63.60
臺南縣,佳里鎮,安西里,306,1,635,2,637,1082,3,1,3,0,1,0,58.87
臺南縣,佳里鎮,安西里,307,1,695,1,696,1345,3,1,3,0,1,0,51.75
臺南縣,佳里鎮,六安里,308,1,680,8,688,1062,3,1,3,0,1,0,64.78
臺南縣,佳里鎮,六安里,309,1,645,5,650,1065,3,1,3,0,1,0,61.03
臺南縣,佳里鎮,六安里,310,1,705,3,708,1172,3,1,3,0,1,0,60.41
臺南縣,佳里鎮,佳化里,311,1,650,2,652,1009,3,1,3,0,1,0,64.62
臺南縣,佳里鎮,佳化里,312,1,588,2,590,956,3,1,3,0,1,0,61.72
臺南縣,佳里鎮,禮化里,313,1,605,6,611,861,3,1,3,0,1,0,70.96
臺南縣,佳里鎮,興化里,314,1,867,3,870,1349,3,1,3,0,1,0,64.49
臺南縣,佳里鎮,營頂里,315,1,423,4,427,685,3,1,3,0,1,0,62.34
臺南縣,佳里鎮,溪洲里,316,1,256,1,257,392,3,1,3,0,1,0,65.56
臺南縣,佳里鎮,海澄里,317,1,840,8,848,1371,3,1,3,0,1,0,61.85
臺南縣,佳里鎮,漳洲里,318,1,431,4,435,693,3,1,3,0,1,0,62.77
臺南縣,佳里鎮,頂部里,319,1,570,3,573,855,3,1,3,0,1,0,67.02
臺南縣,佳里鎮,嘉福里,320,1,598,3,601,958,3,1,3,0,1,0,62.73
臺南縣,佳里鎮,通興里,321,1,699,6,705,1062,3,1,3,0,1,0,66.38
臺南縣,佳里鎮,蚶寮里,322,1,574,5,579,843,3,1,3,0,1,0,68.68
臺南縣,佳里鎮,龍安里,323,1,670,10,680,978,3,1,3,0,1,0,69.53
臺南縣,佳里鎮,民安里,324,1,848,6,854,1291,3,1,3,0,1,0,66.15
臺南縣,佳里鎮,子龍里,325,1,507,1,508,762,3,1,3,0,1,0,66.67
臺南縣,佳里鎮,子龍里,326,1,513,1,514,782,3,1,3,0,1,0,65.73
臺南縣,佳里鎮,三協里,327,1,588,4,592,889,3,1,3,0,1,0,66.59
臺南縣,學甲鎮,一秀里,328,1,498,2,500,757,3,1,3,0,1,0,66.05
臺南縣,學甲鎮,一秀里,329,1,358,2,360,536,3,1,3,0,1,0,67.16
臺南縣,學甲鎮,西明里,330,1,786,5,791,1299,3,1,3,0,1,0,60.89
臺南縣,學甲鎮,宜民里,331,1,329,3,332,510,3,1,3,0,1,0,65.10
臺南縣,學甲鎮,煥昌里,332,1,564,3,567,911,3,1,3,0,1,0,62.24
臺南縣,學甲鎮,慈生里,333,1,391,3,394,581,3,1,3,0,1,0,67.81
臺南縣,學甲鎮,仁得里,334,1,762,5,767,1238,3,1,3,0,1,0,61.95
臺南縣,學甲鎮,仁得里,335,1,670,4,674,1021,3,1,3,0,1,0,66.01
臺南縣,學甲鎮,仁得里,336,1,859,4,863,1369,3,1,3,0,1,0,63.04
臺南縣,學甲鎮,新生里,337,1,918,6,924,1491,3,1,3,0,1,0,61.97
臺南縣,學甲鎮,百福里,338,1,530,5,535,808,3,1,3,0,1,0,66.21
臺南縣,學甲鎮,百福里,339,1,343,3,346,542,3,1,3,0,1,0,63.84
臺南縣,學甲鎮,新榮里,340,1,459,2,461,717,3,1,3,0,1,0,64.30
臺南縣,學甲鎮,新榮里,341,1,509,3,512,824,3,1,3,0,1,0,62.14
臺南縣,學甲鎮,文化里,342,1,391,2,393,569,3,1,3,0,1,0,69.07
臺南縣,學甲鎮,大安里,343,1,334,3,337,528,3,1,3,0,1,0,63.83
臺南縣,學甲鎮,美豐里,344,1,538,10,548,873,3,1,3,0,1,0,62.77
臺南縣,學甲鎮,美和里,345,1,206,2,208,335,3,1,3,0,1,0,62.09
臺南縣,學甲鎮,達明里,346,1,437,1,438,644,3,1,3,0,1,0,68.01
臺南縣,學甲鎮,光明里,347,1,220,2,222,336,3,1,3,0,1,0,66.07
臺南縣,學甲鎮,民吉里,348,1,296,1,297,424,3,1,3,0,1,0,70.05
臺南縣,學甲鎮,西進里,349,1,303,2,305,472,3,1,3,0,1,0,64.62
臺南縣,學甲鎮,白渚里,350,1,208,1,209,330,3,1,3,0,1,0,63.33
臺南縣,學甲鎮,光華里,351,1,373,4,377,591,3,1,3,0,1,0,63.79
臺南縣,學甲鎮,光華里,352,1,195,0,195,307,3,1,3,0,1,0,63.52
臺南縣,學甲鎮,頭港里,353,1,269,2,271,440,3,1,3,0,1,0,61.59
臺南縣,學甲鎮,宅港里,354,1,679,3,682,1088,3,1,3,0,1,0,62.68
臺南縣,學甲鎮,平東里,355,1,312,2,314,478,3,1,3,0,1,0,65.69
臺南縣,學甲鎮,平西里,356,1,477,1,478,676,3,1,3,0,1,0,70.71
臺南縣,學甲鎮,頂洲里,357,1,508,4,512,673,3,1,3,0,1,0,76.08
臺南縣,學甲鎮,紅茄里,358,1,314,3,317,479,3,1,3,0,1,0,66.18
臺南縣,學甲鎮,新芳里,359,1,294,4,298,450,3,1,3,0,1,0,66.22
臺南縣,西港鄉,西港村,360,1,558,8,566,882,3,1,3,0,1,0,64.17
臺南縣,西港鄉,西港村,361,1,562,5,567,798,3,1,3,0,1,0,71.05
臺南縣,西港鄉,西港村,362,1,739,13,752,1126,3,1,3,0,1,0,66.79
臺南縣,西港鄉,慶安村,363,1,842,10,852,1309,3,1,3,0,1,0,65.09
臺南縣,西港鄉,慶安村,364,1,627,7,634,945,3,1,3,0,1,0,67.09
臺南縣,西港鄉,慶安村,365,1,869,7,876,1386,3,1,3,0,1,0,63.20
臺南縣,西港鄉,南海村,366,1,866,11,877,1318,3,1,3,0,1,0,66.54
臺南縣,西港鄉,南海村,367,1,463,5,468,649,3,1,3,0,1,0,72.11
臺南縣,西港鄉,港東村,368,1,655,6,661,999,3,1,3,0,1,0,66.17
臺南縣,西港鄉,港東村,369,1,274,1,275,384,3,1,3,0,1,0,71.61
臺南縣,西港鄉,檨林村,370,1,498,2,500,744,3,1,3,0,1,0,67.20
臺南縣,西港鄉,檨林村,371,1,526,7,533,794,3,1,3,0,1,0,67.13
臺南縣,西港鄉,後營村,372,1,909,10,919,1329,3,1,3,0,1,0,69.15
臺南縣,西港鄉,營西村,373,1,850,8,858,1327,3,1,3,0,1,0,64.66
臺南縣,西港鄉,金砂村,374,1,603,8,611,817,3,1,3,0,1,0,74.79
臺南縣,西港鄉,劉厝村,375,1,798,4,802,1196,3,1,3,0,1,0,67.06
臺南縣,西港鄉,竹林村,376,1,818,6,824,1176,3,1,3,0,1,0,70.07
臺南縣,西港鄉,永樂村,377,1,605,6,611,886,3,1,3,0,1,0,68.96
臺南縣,西港鄉,新復村,378,1,297,3,300,389,3,1,3,0,1,0,77.12
臺南縣,西港鄉,永樂村、南海村、新復村,379,1,503,1,504,748,3,1,3,0,1,0,67.38
臺南縣,七股鄉,後港村,380,1,354,0,354,547,3,1,3,0,1,0,64.72
臺南縣,七股鄉,大潭村,381,1,457,6,463,714,3,1,3,0,1,0,64.85
臺南縣,七股鄉,城內村,382,1,349,3,352,498,3,1,3,0,1,0,70.68
臺南縣,七股鄉,篤加村,383,1,561,4,565,841,3,1,3,0,1,0,67.18
臺南縣,七股鄉,頂山村,384,1,686,4,690,940,3,1,3,0,1,0,73.40
臺南縣,七股鄉,西寮村,385,1,381,1,382,564,3,1,3,0,1,0,67.73
臺南縣,七股鄉,鹽埕村,386,1,314,3,317,435,3,1,3,0,1,0,72.87
臺南縣,七股鄉,中寮村,387,1,543,2,545,785,3,1,3,0,1,0,69.43
臺南縣,七股鄉,龍山村,388,1,506,4,510,792,3,1,3,0,1,0,64.39
臺南縣,七股鄉,龍山村,389,1,626,1,627,915,3,1,3,0,1,0,68.52
臺南縣,七股鄉,溪南村,390,1,249,0,249,356,3,1,3,0,1,0,69.94
臺南縣,七股鄉,七股村,391,1,548,4,552,880,3,1,3,0,1,0,62.73
臺南縣,七股鄉,玉成村,392,1,527,3,530,842,3,1,3,0,1,0,62.95
臺南縣,七股鄉,大埕村,393,1,869,13,882,1428,3,1,3,0,1,0,61.76
臺南縣,七股鄉,大寮村,394,1,587,4,591,959,3,1,3,0,1,0,61.63
臺南縣,七股鄉,看坪村,395,1,418,2,420,615,3,1,3,0,1,0,68.29
臺南縣,七股鄉,樹林村,396,1,687,6,693,1045,3,1,3,0,1,0,66.32
臺南縣,七股鄉,竹港村,397,1,392,4,396,570,3,1,3,0,1,0,69.47
臺南縣,七股鄉,竹橋村,398,1,517,8,525,724,3,1,3,0,1,0,72.51
臺南縣,七股鄉,義合村,399,1,694,5,699,1067,3,1,3,0,1,0,65.51
臺南縣,七股鄉,康榔村,400,1,488,3,491,690,3,1,3,0,1,0,71.16
臺南縣,七股鄉,永吉村,401,1,610,2,612,912,3,1,3,0,1,0,67.11
臺南縣,七股鄉,三股村,402,1,934,15,949,1609,3,1,3,0,1,0,58.98
臺南縣,七股鄉,十份村,403,1,856,5,861,1319,3,1,3,0,1,0,65.28
臺南縣,將軍鄉,長榮村,404,1,670,7,677,970,3,1,3,0,1,0,69.79
臺南縣,將軍鄉,西華村,405,1,850,5,855,1342,3,1,3,0,1,0,63.71
臺南縣,將軍鄉,西和村,406,1,691,8,699,1032,3,1,3,0,1,0,67.73
臺南縣,將軍鄉,忠興村,407,1,363,2,365,517,3,1,3,0,1,0,70.60
臺南縣,將軍鄉,忠興村,408,1,642,3,645,972,3,1,3,0,1,0,66.36
臺南縣,將軍鄉,嘉昌村,409,1,395,3,398,584,3,1,3,0,1,0,68.15
臺南縣,將軍鄉,嘉昌村,410,1,231,4,235,328,3,1,3,0,1,0,71.65
臺南縣,將軍鄉,保源村,411,1,417,3,420,580,3,1,3,0,1,0,72.41
臺南縣,將軍鄉,保源村,412,1,304,3,307,451,3,1,3,0,1,0,68.07
臺南縣,將軍鄉,苓和村,413,1,428,3,431,662,3,1,3,0,1,0,65.11
臺南縣,將軍鄉,苓和村,414,1,256,3,259,416,3,1,3,0,1,0,62.26
臺南縣,將軍鄉,仁和村,415,1,446,2,448,743,3,1,3,0,1,0,60.30
臺南縣,將軍鄉,北埔村,416,1,461,1,462,634,3,1,3,0,1,0,72.87
臺南縣,將軍鄉,將富村,417,1,440,2,442,719,3,1,3,0,1,0,61.47
臺南縣,將軍鄉,將貴村,418,1,264,1,265,394,3,1,3,0,1,0,67.26
臺南縣,將軍鄉,將貴村,419,1,163,1,164,225,3,1,3,0,1,0,72.89
臺南縣,將軍鄉,三吉村,420,1,279,1,280,438,3,1,3,0,1,0,63.93
臺南縣,將軍鄉,玉山村,421,1,587,1,588,909,3,1,3,0,1,0,64.69
臺南縣,將軍鄉,廣山村,422,1,423,4,427,692,3,1,3,0,1,0,61.71
臺南縣,將軍鄉,長沙村,423,1,516,0,516,820,3,1,3,0,1,0,62.93
臺南縣,將軍鄉,長沙村,424,1,394,2,396,646,3,1,3,0,1,0,61.30
臺南縣,將軍鄉,平沙村,425,1,787,5,792,1268,3,1,3,0,1,0,62.46
臺南縣,將軍鄉,鯤鯓村,426,1,494,4,498,861,3,1,3,0,1,0,57.84
臺南縣,將軍鄉,鯤鯓村,427,1,680,5,685,1173,3,1,3,0,1,0,58.40
臺南縣,將軍鄉,鯤溟村,428,1,609,1,610,1009,3,1,3,0,1,0,60.46
臺南縣,北門鄉,北門村,429,1,362,6,368,517,3,1,3,0,1,0,71.18
臺南縣,北門鄉,北門村,430,1,270,5,275,374,3,1,3,0,1,0,73.53
臺南縣,北門鄉,永隆村,431,1,359,2,361,532,3,1,3,0,1,0,67.86
臺南縣,北門鄉,永華村,432,1,246,4,250,379,3,1,3,0,1,0,65.96
臺南縣,北門鄉,玉港村,433,1,319,3,322,468,3,1,3,0,1,0,68.80
臺南縣,北門鄉,玉港村,434,1,199,1,200,312,3,1,3,0,1,0,64.10
臺南縣,北門鄉,保吉村,435,1,512,6,518,813,3,1,3,0,1,0,63.71
臺南縣,北門鄉,保吉村,436,1,360,4,364,535,3,1,3,0,1,0,68.04
臺南縣,北門鄉,東壁村,437,1,520,5,525,774,3,1,3,0,1,0,67.83
臺南縣,北門鄉,鯤江村,438,1,269,1,270,401,3,1,3,0,1,0,67.33
臺南縣,北門鄉,鯤江村,439,1,251,1,252,370,3,1,3,0,1,0,68.11
臺南縣,北門鄉,雙春村,440,1,421,1,422,600,3,1,3,0,1,0,70.33
臺南縣,北門鄉,錦湖村,441,1,663,0,663,1055,3,1,3,0,1,0,62.84
臺南縣,北門鄉,慈安村,442,1,441,2,443,675,3,1,3,0,1,0,65.63
臺南縣,北門鄉,三光村,443,1,445,4,449,647,3,1,3,0,1,0,69.40
臺南縣,北門鄉,三光村,444,1,336,4,340,523,3,1,3,0,1,0,65.01
臺南縣,北門鄉,中樞村,445,1,440,1,441,696,3,1,3,0,1,0,63.36
臺南縣,北門鄉,仁里村,446,1,459,4,463,689,3,1,3,0,1,0,67.20
臺南縣,新化鎮,武安里,447,1,437,3,440,713,3,1,3,0,1,0,61.71
臺南縣,新化鎮,武安里,448,1,568,6,574,922,3,1,3,0,1,0,62.26
臺南縣,新化鎮,東榮里,449,1,544,1,545,950,3,1,3,0,1,0,57.37
臺南縣,新化鎮,東榮里,450,1,664,3,667,1056,3,1,3,0,1,0,63.16
臺南縣,新化鎮,東榮里,451,1,504,5,509,821,3,1,3,0,1,0,62.00
臺南縣,新化鎮,東榮里,452,1,551,1,552,974,3,1,3,0,1,0,56.67
臺南縣,新化鎮,護國里,453,1,496,2,498,818,3,1,3,0,1,0,60.88
臺南縣,新化鎮,護國里,454,1,404,0,404,845,3,1,3,0,1,0,47.81
臺南縣,新化鎮,太平里,455,1,678,0,678,1101,3,1,3,0,1,0,61.58
臺南縣,新化鎮,太平里,456,1,525,7,532,867,3,1,3,0,1,0,61.36
臺南縣,新化鎮,太平里,457,1,595,7,602,1047,3,1,3,0,1,0,57.50
臺南縣,新化鎮,太平里,458,1,496,7,503,799,3,1,3,0,1,0,62.95
臺南縣,新化鎮,中央里,459,1,285,1,286,437,3,1,3,0,1,0,65.45
臺南縣,新化鎮,觀音里,460,1,365,0,365,614,3,1,3,0,1,0,59.45
臺南縣,新化鎮,竹林里,461,1,287,4,291,441,3,1,3,0,1,0,65.99
臺南縣,新化鎮,清水里,462,1,622,4,626,983,3,1,3,0,1,0,63.68
臺南縣,新化鎮,協興里,463,1,520,7,527,849,3,1,3,0,1,0,62.07
臺南縣,新化鎮,協興里,464,1,681,5,686,1126,3,1,3,0,1,0,60.92
臺南縣,新化鎮,協興里,465,1,630,7,637,1046,3,1,3,0,1,0,60.90
臺南縣,新化鎮,唪口里,466,1,532,3,535,837,3,1,3,0,1,0,63.92
臺南縣,新化鎮,唪口里,467,1,572,3,575,874,3,1,3,0,1,0,65.79
臺南縣,新化鎮,北勢里,468,1,736,8,744,1175,3,1,3,0,1,0,63.32
臺南縣,新化鎮,豐榮里,469,1,598,1,599,903,3,1,3,0,1,0,66.33
臺南縣,新化鎮,豐榮里,470,1,410,5,415,600,3,1,3,0,1,0,69.17
臺南縣,新化鎮,豐榮里,471,1,570,4,574,992,3,1,3,0,1,0,57.86
臺南縣,新化鎮,全興里,472,1,691,4,695,1108,3,1,3,0,1,0,62.73
臺南縣,新化鎮,全興里,473,1,612,2,614,960,3,1,3,0,1,0,63.96
臺南縣,新化鎮,崙頂里,474,1,654,5,659,938,3,1,3,0,1,0,70.26
臺南縣,新化鎮,崙頂里,475,1,523,6,529,809,3,1,3,0,1,0,65.39
臺南縣,新化鎮,知義里,476,1,747,5,752,1089,3,1,3,0,1,0,69.05
臺南縣,新化鎮,知義里,477,1,625,10,635,1047,3,1,3,0,1,0,60.65
臺南縣,新化鎮,山腳里,478,1,858,8,866,1318,3,1,3,0,1,0,65.71
臺南縣,新化鎮,大坑里,479,1,315,4,319,477,3,1,3,0,1,0,66.88
臺南縣,新化鎮,那拔里,480,1,586,5,591,1043,3,1,3,0,1,0,56.66
臺南縣,新化鎮,那拔里,481,1,683,5,688,1047,3,1,3,0,1,0,65.71
臺南縣,新化鎮,羊林里,482,1,509,5,514,847,3,1,3,0,1,0,60.68
臺南縣,新化鎮,礁坑里,483,1,664,3,667,1032,3,1,3,0,1,0,64.63
臺南縣,善化鎮,東關里,484,1,599,3,602,921,3,1,3,0,1,0,65.36
臺南縣,善化鎮,坐駕里,485,1,780,13,793,1265,3,1,3,0,1,0,62.69
臺南縣,善化鎮,坐駕里,486,1,922,3,925,1492,3,1,3,0,1,0,62.00
臺南縣,善化鎮,光文里,487,1,647,9,656,1099,3,1,3,0,1,0,59.69
臺南縣,善化鎮,光文里,488,1,872,9,881,1515,3,1,3,0,1,0,58.15
臺南縣,善化鎮,光文里,489,1,1003,7,1010,1625,3,1,3,0,1,0,62.15
臺南縣,善化鎮,文昌里,490,1,620,5,625,979,3,1,3,0,1,0,63.84
臺南縣,善化鎮,文昌里,491,1,701,6,707,1173,3,1,3,0,1,0,60.27
臺南縣,善化鎮,南關里,492,1,785,7,792,1282,3,1,3,0,1,0,61.78
臺南縣,善化鎮,西關里,493,1,419,2,421,676,3,1,3,0,1,0,62.28
臺南縣,善化鎮,北關里,494,1,283,1,284,445,3,1,3,0,1,0,63.82
臺南縣,善化鎮,文正里,495,1,724,11,735,1171,3,1,3,0,1,0,62.77
臺南縣,善化鎮,胡家里,496,1,873,3,876,1248,3,1,3,0,1,0,70.19
臺南縣,善化鎮,胡厝里,497,1,812,7,819,1282,3,1,3,0,1,0,63.88
臺南縣,善化鎮,胡厝里,498,1,392,11,403,601,3,1,3,0,1,0,67.05
臺南縣,善化鎮,什乃里,499,1,602,7,609,916,3,1,3,0,1,0,66.48
臺南縣,善化鎮,溪美里,500,1,540,7,547,874,3,1,3,0,1,0,62.59
臺南縣,善化鎮,溪美里,501,1,446,3,449,706,3,1,3,0,1,0,63.60
臺南縣,善化鎮,六分里,502,1,422,5,427,664,3,1,3,0,1,0,64.31
臺南縣,善化鎮,六德里,503,1,650,9,659,1054,3,1,3,0,1,0,62.52
臺南縣,善化鎮,田寮里,504,1,449,10,459,739,3,1,3,0,1,0,62.11
臺南縣,善化鎮,田寮里,505,1,646,8,654,1021,3,1,3,0,1,0,64.05
臺南縣,善化鎮,東隆里,506,1,573,4,577,861,3,1,3,0,1,0,67.02
臺南縣,善化鎮,東昌里,507,1,615,9,624,999,3,1,3,0,1,0,62.46
臺南縣,善化鎮,牛庄里,508,1,883,8,891,1389,3,1,3,0,1,0,64.15
臺南縣,善化鎮,嘉北里,509,1,898,9,907,1392,3,1,3,0,1,0,65.16
臺南縣,善化鎮,嘉南里,510,1,611,5,616,1027,3,1,3,0,1,0,59.98
臺南縣,善化鎮,小新里,511,1,778,7,785,1292,3,1,3,0,1,0,60.76
臺南縣,善化鎮,小新里,512,1,872,3,875,1510,3,1,3,0,1,0,57.95
臺南縣,新市鄉,新市村,513,1,530,4,534,912,3,1,3,0,1,0,58.55
臺南縣,新市鄉,新市村,514,1,399,6,405,697,3,1,3,0,1,0,58.11
臺南縣,新市鄉,新市村,515,1,484,6,490,854,3,1,3,0,1,0,57.38
臺南縣,新市鄉,新和村,516,1,617,3,620,1045,3,1,3,0,1,0,59.33
臺南縣,新市鄉,新和村,517,1,675,9,684,1106,3,1,3,0,1,0,61.84
臺南縣,新市鄉,新和村,518,1,502,3,505,823,3,1,3,0,1,0,61.36
臺南縣,新市鄉,新和村,519,1,696,5,701,1127,3,1,3,0,1,0,62.20
臺南縣,新市鄉,新和村,520,1,711,0,711,1251,3,1,3,0,1,0,56.83
臺南縣,新市鄉,社內村,521,1,525,4,529,866,3,1,3,0,1,0,61.09
臺南縣,新市鄉,社內村,522,1,718,2,720,1145,3,1,3,0,1,0,62.88
臺南縣,新市鄉,大洲村,523,1,467,1,468,653,3,1,3,0,1,0,71.67
臺南縣,新市鄉,豊華村,524,1,542,3,545,920,3,1,3,0,1,0,59.24
臺南縣,新市鄉,三舍村,525,1,799,5,804,1221,3,1,3,0,1,0,65.85
臺南縣,新市鄉,大營村,526,1,688,3,691,1053,3,1,3,0,1,0,65.62
臺南縣,新市鄉,大營村,527,1,461,2,463,680,3,1,3,0,1,0,68.09
臺南縣,新市鄉,大營村,528,1,442,3,445,695,3,1,3,0,1,0,64.03
臺南縣,新市鄉,大社村,529,1,650,6,656,1111,3,1,3,0,1,0,59.05
臺南縣,新市鄉,大社村,530,1,670,6,676,1090,3,1,3,0,1,0,62.02
臺南縣,新市鄉,大社村,531,1,773,5,778,1234,3,1,3,0,1,0,63.05
臺南縣,新市鄉,潭頂村,532,1,485,2,487,753,3,1,3,0,1,0,64.67
臺南縣,新市鄉,潭頂村,533,1,484,3,487,782,3,1,3,0,1,0,62.28
臺南縣,新市鄉,港墘村,534,1,476,0,476,771,3,1,3,0,1,0,61.74
臺南縣,新市鄉,港墘村,535,1,718,8,726,1106,3,1,3,0,1,0,65.64
臺南縣,新市鄉,港墘村,536,1,660,3,663,1068,3,1,3,0,1,0,62.08
臺南縣,新市鄉,永就村,537,1,298,4,302,465,3,1,3,0,1,0,64.95
臺南縣,新市鄉,永就村,538,1,447,4,451,920,3,1,3,0,1,0,49.02
臺南縣,新市鄉,永就村,539,1,610,2,612,869,3,1,3,0,1,0,70.43
臺南縣,安定鄉,蘇林村,540,1,784,9,793,1187,3,1,3,0,1,0,66.81
臺南縣,安定鄉,蘇林村,541,1,552,6,558,865,3,1,3,0,1,0,64.51
臺南縣,安定鄉,蘇厝村,542,1,632,5,637,996,3,1,3,0,1,0,63.96
臺南縣,安定鄉,蘇厝村,543,1,486,13,499,802,3,1,3,0,1,0,62.22
臺南縣,安定鄉,安定村,544,1,888,5,893,1375,3,1,3,0,1,0,64.95
臺南縣,安定鄉,安加村,545,1,773,11,784,1138,3,1,3,0,1,0,68.89
臺南縣,安定鄉,保西村,546,1,532,3,535,764,3,1,3,0,1,0,70.03
臺南縣,安定鄉,港尾村,547,1,619,3,622,777,3,1,3,0,1,0,80.05
臺南縣,安定鄉,港尾村,548,1,569,7,576,745,3,1,3,0,1,0,77.32
臺南縣,安定鄉,中榮村,549,1,609,16,625,1025,3,1,3,0,1,0,60.98
臺南縣,安定鄉,港口村,550,1,653,3,656,1019,3,1,3,0,1,0,64.38
臺南縣,安定鄉,港口村,551,1,798,3,801,1187,3,1,3,0,1,0,67.48
臺南縣,安定鄉,港南村,552,1,763,8,771,1219,3,1,3,0,1,0,63.25
臺南縣,安定鄉,港南村,553,1,636,3,639,990,3,1,3,0,1,0,64.55
臺南縣,安定鄉,大同村,554,1,427,3,430,636,3,1,3,0,1,0,67.61
臺南縣,安定鄉,六嘉村,555,1,871,8,879,1390,3,1,3,0,1,0,63.24
臺南縣,安定鄉,中沙村,556,1,475,2,477,695,3,1,3,0,1,0,68.63
臺南縣,安定鄉,新吉村,557,1,582,8,590,994,3,1,3,0,1,0,59.36
臺南縣,安定鄉,新吉村,558,1,532,4,536,866,3,1,3,0,1,0,61.89
臺南縣,安定鄉,海寮村,559,1,745,11,756,1131,3,1,3,0,1,0,66.84
臺南縣,安定鄉,海寮村,560,1,663,7,670,1120,3,1,3,0,1,0,59.82
臺南縣,安定鄉,管寮村,561,1,646,2,648,909,3,1,3,0,1,0,71.29
臺南縣,安定鄉,南安村,562,1,368,6,374,504,3,1,3,0,1,0,74.21
臺南縣,山上鄉,明和村,563,1,576,3,579,886,3,1,3,0,1,0,65.35
臺南縣,山上鄉,明和村,564,1,561,7,568,917,3,1,3,0,1,0,61.94
臺南縣,山上鄉,南洲村,565,1,495,1,496,741,3,1,3,0,1,0,66.94
臺南縣,山上鄉,南洲村,566,1,560,4,564,817,3,1,3,0,1,0,69.03
臺南縣,山上鄉,山上村,567,1,559,9,568,873,3,1,3,0,1,0,65.06
臺南縣,山上鄉,新莊村,568,1,508,2,510,775,3,1,3,0,1,0,65.81
臺南縣,山上鄉,玉峰村,569,1,378,0,378,559,3,1,3,0,1,0,67.62
臺南縣,山上鄉,平陽村,570,1,255,2,257,358,3,1,3,0,1,0,71.79
臺南縣,山上鄉,豐德村,571,1,218,2,220,371,3,1,3,0,1,0,59.30
臺南縣,玉井鄉,玉井村,572,1,599,4,603,903,3,1,3,0,1,0,66.78
臺南縣,玉井鄉,玉田村,573,1,603,4,607,1001,3,1,3,0,1,0,60.64
臺南縣,玉井鄉,玉田村,574,1,620,9,629,1058,3,1,3,0,1,0,59.45
臺南縣,玉井鄉,玉田村,575,1,646,4,650,1026,3,1,3,0,1,0,63.35
臺南縣,玉井鄉,玉田村,576,1,601,3,604,1024,3,1,3,0,1,0,58.98
臺南縣,玉井鄉,中正村,577,1,422,3,425,637,3,1,3,0,1,0,66.72
臺南縣,玉井鄉,中正村,578,1,432,4,436,647,3,1,3,0,1,0,67.39
臺南縣,玉井鄉,竹圍村,579,1,577,2,579,912,3,1,3,0,1,0,63.49
臺南縣,玉井鄉,竹圍村,580,1,309,3,312,509,3,1,3,0,1,0,61.30
臺南縣,玉井鄉,沙田村,581,1,326,3,329,502,3,1,3,0,1,0,65.54
臺南縣,玉井鄉,三埔村,582,1,312,1,313,512,3,1,3,0,1,0,61.13
臺南縣,玉井鄉,三和村,583,1,526,4,530,770,3,1,3,0,1,0,68.83
臺南縣,玉井鄉,望明村,584,1,492,6,498,692,3,1,3,0,1,0,71.97
臺南縣,玉井鄉,望明村,585,1,569,6,575,868,3,1,3,0,1,0,66.24
臺南縣,玉井鄉,層林村,586,1,443,2,445,688,3,1,3,0,1,0,64.68
臺南縣,玉井鄉,豐里村,587,1,615,6,621,1001,3,1,3,0,1,0,62.04
臺南縣,楠西鄉,楠西村,588,1,597,6,603,958,3,1,3,0,1,0,62.94
臺南縣,楠西鄉,楠西村,589,1,568,6,574,928,3,1,3,0,1,0,61.85
臺南縣,楠西鄉,灣丘村,590,1,723,6,729,1265,3,1,3,0,1,0,57.63
臺南縣,楠西鄉,密枝村,591,1,482,2,484,808,3,1,3,0,1,0,59.90
臺南縣,楠西鄉,照興村,592,1,646,10,656,1046,3,1,3,0,1,0,62.72
臺南縣,楠西鄉,鹿田村,593,1,644,2,646,1000,3,1,3,0,1,0,64.60
臺南縣,楠西鄉,龜丹村,594,1,464,3,467,712,3,1,3,0,1,0,65.59
臺南縣,楠西鄉,東勢村,595,1,698,7,705,1052,3,1,3,0,1,0,67.02
臺南縣,楠西鄉,東勢村,596,1,713,9,722,1198,3,1,3,0,1,0,60.27
臺南縣,南化鄉,南化村,597,1,465,1,466,686,3,1,3,0,1,0,67.93
臺南縣,南化鄉,南化村,598,1,477,4,481,677,3,1,3,0,1,0,71.05
臺南縣,南化鄉,小崙村,599,1,562,4,566,796,3,1,3,0,1,0,71.11
臺南縣,南化鄉,東和村,600,1,450,0,450,656,3,1,3,0,1,0,68.60
臺南縣,南化鄉,中坑村,601,1,334,2,336,481,3,1,3,0,1,0,69.85
臺南縣,南化鄉,北平村,602,1,424,0,424,600,3,1,3,0,1,0,70.67
臺南縣,南化鄉,西埔村,603,1,514,4,518,792,3,1,3,0,1,0,65.40
臺南縣,南化鄉,北寮村,604,1,753,4,757,1173,3,1,3,0,1,0,64.54
臺南縣,南化鄉,玉山村,605,1,602,2,604,880,3,1,3,0,1,0,68.64
臺南縣,南化鄉,關山村,606,1,271,3,274,554,3,1,3,0,1,0,49.46
臺南縣,左鎮鄉,光和村,607,1,262,5,267,426,3,1,3,0,1,0,62.68
臺南縣,左鎮鄉,榮和村,608,1,448,3,451,677,3,1,3,0,1,0,66.62
臺南縣,左鎮鄉,左鎮村,609,1,351,3,354,514,3,1,3,0,1,0,68.87
臺南縣,左鎮鄉,中正村,610,1,577,2,579,858,3,1,3,0,1,0,67.48
臺南縣,左鎮鄉,睦光村,611,1,253,6,259,381,3,1,3,0,1,0,67.98
臺南縣,左鎮鄉,內庄村,612,1,307,3,310,454,3,1,3,0,1,0,68.28
臺南縣,左鎮鄉,岡林村,613,1,289,1,290,440,3,1,3,0,1,0,65.91
臺南縣,左鎮鄉,草山村,614,1,204,1,205,314,3,1,3,0,1,0,65.29
臺南縣,左鎮鄉,二寮村,615,1,132,0,132,225,3,1,3,0,1,0,58.67
臺南縣,左鎮鄉,澄山村,616,1,332,2,334,547,3,1,3,0,1,0,61.06
臺南縣,仁德鄉,太子村,617,1,632,6,638,1071,3,1,3,0,1,0,59.57
臺南縣,仁德鄉,太子村,618,1,675,1,676,1027,3,1,3,0,1,0,65.82
臺南縣,仁德鄉,太子村,619,1,650,5,655,1077,3,1,3,0,1,0,60.82
臺南縣,仁德鄉,太子村,620,1,567,5,572,919,3,1,3,0,1,0,62.24
臺南縣,仁德鄉,土庫村,621,1,713,4,717,1048,3,1,3,0,1,0,68.42
臺南縣,仁德鄉,土庫村,622,1,749,6,755,1205,3,1,3,0,1,0,62.66
臺南縣,仁德鄉,一甲村,623,1,552,1,553,873,3,1,3,0,1,0,63.34
臺南縣,仁德鄉,一甲村,624,1,636,3,639,1077,3,1,3,0,1,0,59.33
臺南縣,仁德鄉,仁德村,625,1,550,3,553,1055,3,1,3,0,1,0,52.42
臺南縣,仁德鄉,仁德村,626,1,564,5,569,1017,3,1,3,0,1,0,55.95
臺南縣,仁德鄉,仁德村,627,1,395,1,396,775,3,1,3,0,1,0,51.10
臺南縣,仁德鄉,仁德村,628,1,431,6,437,850,3,1,3,0,1,0,51.41
臺南縣,仁德鄉,仁德村,629,1,464,1,465,888,3,1,3,0,1,0,52.36
臺南縣,仁德鄉,仁義村,630,1,668,6,674,1046,3,1,3,0,1,0,64.44
臺南縣,仁德鄉,仁義村,631,1,729,2,731,1186,3,1,3,0,1,0,61.64
臺南縣,仁德鄉,仁義村,632,1,594,4,598,972,3,1,3,0,1,0,61.52
臺南縣,仁德鄉,仁義村,633,1,510,3,513,917,3,1,3,0,1,0,55.94
臺南縣,仁德鄉,仁義村,634,1,615,2,617,1102,3,1,3,0,1,0,55.99
臺南縣,仁德鄉,仁義村,635,1,573,3,576,965,3,1,3,0,1,0,59.69
臺南縣,仁德鄉,仁義村,636,1,488,5,493,846,3,1,3,0,1,0,58.27
臺南縣,仁德鄉,新田村,637,1,501,4,505,866,3,1,3,0,1,0,58.31
臺南縣,仁德鄉,新田村,638,1,386,3,389,666,3,1,3,0,1,0,58.41
臺南縣,仁德鄉,新田村,639,1,649,5,654,1104,3,1,3,0,1,0,59.24
臺南縣,仁德鄉,後壁村,640,1,631,7,638,1035,3,1,3,0,1,0,61.64
臺南縣,仁德鄉,後壁村,641,1,713,4,717,1134,3,1,3,0,1,0,63.23
臺南縣,仁德鄉,後壁村,642,1,677,9,686,1134,3,1,3,0,1,0,60.49
臺南縣,仁德鄉,後壁村,643,1,621,5,626,1067,3,1,3,0,1,0,58.67
臺南縣,仁德鄉,後壁村,644,1,592,1,593,1160,3,1,3,0,1,0,51.12
臺南縣,仁德鄉,後壁村,645,1,618,7,625,1098,3,1,3,0,1,0,56.92
臺南縣,仁德鄉,上崙村,646,1,617,7,624,1124,3,1,3,0,1,0,55.52
臺南縣,仁德鄉,上崙村,647,1,684,1,685,1133,3,1,3,0,1,0,60.46
臺南縣,仁德鄉,上崙村,648,1,710,4,714,1111,3,1,3,0,1,0,64.27
臺南縣,仁德鄉,上崙村,649,1,456,5,461,783,3,1,3,0,1,0,58.88
臺南縣,仁德鄉,田厝村,650,1,914,5,919,1323,3,1,3,0,1,0,69.46
臺南縣,仁德鄉,三甲村,651,1,483,3,486,699,3,1,3,0,1,0,69.53
臺南縣,仁德鄉,保安村,652,1,704,5,709,1102,3,1,3,0,1,0,64.34
臺南縣,仁德鄉,保安村,653,1,665,5,670,1124,3,1,3,0,1,0,59.61
臺南縣,仁德鄉,成功村,654,1,648,9,657,1101,3,1,3,0,1,0,59.67
臺南縣,仁德鄉,成功村,655,1,699,0,699,1150,3,1,3,0,1,0,60.78
臺南縣,仁德鄉,成功村,656,1,673,6,679,1088,3,1,3,0,1,0,62.41
臺南縣,仁德鄉,成功村,657,1,176,1,177,318,3,1,3,0,1,0,55.66
臺南縣,仁德鄉,仁和村,658,1,724,13,737,1080,3,1,3,0,1,0,68.24
臺南縣,仁德鄉,仁愛村,659,1,601,6,607,930,3,1,3,0,1,0,65.27
臺南縣,仁德鄉,仁愛村,660,1,623,4,627,1068,3,1,3,0,1,0,58.71
臺南縣,仁德鄉,二行村,661,1,662,7,669,1097,3,1,3,0,1,0,60.98
臺南縣,仁德鄉,二行村,662,1,571,10,581,940,3,1,3,0,1,0,61.81
臺南縣,仁德鄉,大甲村,663,1,599,3,602,858,3,1,3,0,1,0,70.16
臺南縣,仁德鄉,大甲村,664,1,692,12,704,1120,3,1,3,0,1,0,62.86
臺南縣,仁德鄉,中洲村,665,1,867,4,871,1270,3,1,3,0,1,0,68.58
臺南縣,仁德鄉,中生村,666,1,939,5,944,1384,3,1,3,0,1,0,68.21
臺南縣,歸仁鄉,南保村,667,1,845,10,855,1434,3,1,3,0,1,0,59.62
臺南縣,歸仁鄉,南保村,668,1,879,7,886,1517,3,1,3,0,1,0,58.40
臺南縣,歸仁鄉,南保村,669,1,525,5,530,878,3,1,3,0,1,0,60.36
臺南縣,歸仁鄉,南保村,670,1,629,2,631,1041,3,1,3,0,1,0,60.61
臺南縣,歸仁鄉,南興村,671,1,943,8,951,1558,3,1,3,0,1,0,61.04
臺南縣,歸仁鄉,南興村,672,1,816,4,820,1364,3,1,3,0,1,0,60.12
臺南縣,歸仁鄉,六甲村,673,1,656,2,658,1044,3,1,3,0,1,0,63.03
臺南縣,歸仁鄉,六甲村,674,1,634,4,638,1047,3,1,3,0,1,0,60.94
臺南縣,歸仁鄉,六甲村,675,1,604,2,606,1003,3,1,3,0,1,0,60.42
臺南縣,歸仁鄉,歸南村,676,1,690,7,697,1089,3,1,3,0,1,0,64.00
臺南縣,歸仁鄉,歸南村,677,1,556,8,564,972,3,1,3,0,1,0,58.02
臺南縣,歸仁鄉,後市村,678,1,842,3,845,1244,3,1,3,0,1,0,67.93
臺南縣,歸仁鄉,後市村,679,1,588,4,592,871,3,1,3,0,1,0,67.97
臺南縣,歸仁鄉,後市村,680,1,478,3,481,880,3,1,3,0,1,0,54.66
臺南縣,歸仁鄉,文化村,681,1,826,4,830,1374,3,1,3,0,1,0,60.41
臺南縣,歸仁鄉,文化村,682,1,578,6,584,981,3,1,3,0,1,0,59.53
臺南縣,歸仁鄉,辜厝村,683,1,485,2,487,831,3,1,3,0,1,0,58.60
臺南縣,歸仁鄉,辜厝村,684,1,542,1,543,870,3,1,3,0,1,0,62.41
臺南縣,歸仁鄉,辜厝村,685,1,661,7,668,1055,3,1,3,0,1,0,63.32
臺南縣,歸仁鄉,新厝村,686,1,651,3,654,998,3,1,3,0,1,0,65.53
臺南縣,歸仁鄉,新厝村,687,1,682,2,684,1104,3,1,3,0,1,0,61.96
臺南縣,歸仁鄉,許厝村,688,1,539,1,540,930,3,1,3,0,1,0,58.06
臺南縣,歸仁鄉,許厝村,689,1,568,2,570,988,3,1,3,0,1,0,57.69
臺南縣,歸仁鄉,許厝村,690,1,562,2,564,886,3,1,3,0,1,0,63.66
臺南縣,歸仁鄉,看西村,691,1,920,8,928,1383,3,1,3,0,1,0,67.10
臺南縣,歸仁鄉,看東村,692,1,838,3,841,1325,3,1,3,0,1,0,63.47
臺南縣,歸仁鄉,崙頂村,693,1,733,7,740,1114,3,1,3,0,1,0,66.43
臺南縣,歸仁鄉,崙頂村,694,1,572,3,575,908,3,1,3,0,1,0,63.33
臺南縣,歸仁鄉,沙崙村,695,1,383,4,387,607,3,1,3,0,1,0,63.76
臺南縣,歸仁鄉,大潭村,696,1,499,2,501,761,3,1,3,0,1,0,65.83
臺南縣,歸仁鄉,大潭村,697,1,595,2,597,911,3,1,3,0,1,0,65.53
臺南縣,歸仁鄉,武東村,698,1,739,7,746,1196,3,1,3,0,1,0,62.37
臺南縣,歸仁鄉,歸仁村,699,1,658,2,660,1034,3,1,3,0,1,0,63.83
臺南縣,歸仁鄉,歸仁村,700,1,544,3,547,932,3,1,3,0,1,0,58.69
臺南縣,歸仁鄉,八甲村,701,1,674,4,678,1110,3,1,3,0,1,0,61.08
臺南縣,歸仁鄉,八甲村,702,1,644,2,646,1007,3,1,3,0,1,0,64.15
臺南縣,歸仁鄉,七甲村,703,1,757,4,761,1088,3,1,3,0,1,0,69.94
臺南縣,歸仁鄉,七甲村,704,1,635,5,640,1102,3,1,3,0,1,0,58.08
臺南縣,歸仁鄉,媽廟村,705,1,646,5,651,1045,3,1,3,0,1,0,62.30
臺南縣,歸仁鄉,媽廟村,706,1,536,3,539,885,3,1,3,0,1,0,60.90
臺南縣,歸仁鄉,西埔村,707,1,473,5,478,761,3,1,3,0,1,0,62.81
臺南縣,歸仁鄉,西埔村,708,1,382,4,386,593,3,1,3,0,1,0,65.09
臺南縣,歸仁鄉,大廟村,709,1,669,4,673,1120,3,1,3,0,1,0,60.09
臺南縣,歸仁鄉,大廟村,710,1,677,9,686,1112,3,1,3,0,1,0,61.69
臺南縣,關廟鄉,關廟村,711,1,581,0,581,870,3,1,3,0,1,0,66.78
臺南縣,關廟鄉,關廟村,712,1,696,5,701,1077,3,1,3,0,1,0,65.09
臺南縣,關廟鄉,山西村,713,1,546,1,547,829,3,1,3,0,1,0,65.98
臺南縣,關廟鄉,山西村,714,1,696,8,704,1063,3,1,3,0,1,0,66.23
臺南縣,關廟鄉,香洋村,715,1,684,8,692,1019,3,1,3,0,1,0,67.91
臺南縣,關廟鄉,香洋村,716,1,684,4,688,1063,3,1,3,0,1,0,64.72
臺南縣,關廟鄉,香洋村,717,1,811,14,825,1308,3,1,3,0,1,0,63.07
臺南縣,關廟鄉,北勢村,718,1,836,5,841,1212,3,1,3,0,1,0,69.39
臺南縣,關廟鄉,北勢村,719,1,841,6,847,1258,3,1,3,0,1,0,67.33
臺南縣,關廟鄉,新埔村,720,1,608,2,610,882,3,1,3,0,1,0,69.16
臺南縣,關廟鄉,新光村,721,1,495,5,500,758,3,1,3,0,1,0,65.96
臺南縣,關廟鄉,五甲村,722,1,839,11,850,1400,3,1,3,0,1,0,60.71
臺南縣,關廟鄉,五甲村,723,1,900,5,905,1341,3,1,3,0,1,0,67.49
臺南縣,關廟鄉,東勢村,724,1,668,3,671,1059,3,1,3,0,1,0,63.36
臺南縣,關廟鄉,東勢村,725,1,578,4,582,967,3,1,3,0,1,0,60.19
臺南縣,關廟鄉,東勢村,726,1,684,6,690,995,3,1,3,0,1,0,69.35
臺南縣,關廟鄉,松腳村,727,1,538,4,542,839,3,1,3,0,1,0,64.60
臺南縣,關廟鄉,松腳村,728,1,694,6,700,1077,3,1,3,0,1,0,65.00
臺南縣,關廟鄉,南花村,729,1,484,5,489,730,3,1,3,0,1,0,66.99
臺南縣,關廟鄉,南花村,730,1,469,4,473,718,3,1,3,0,1,0,65.88
臺南縣,關廟鄉,北花村,731,1,634,3,637,1007,3,1,3,0,1,0,63.26
臺南縣,關廟鄉,北花村,732,1,697,10,707,1112,3,1,3,0,1,0,63.58
臺南縣,關廟鄉,深坑村,733,1,528,2,530,741,3,1,3,0,1,0,71.52
臺南縣,關廟鄉,深坑村,734,1,515,8,523,795,3,1,3,0,1,0,65.79
臺南縣,關廟鄉,布袋村,735,1,595,7,602,867,3,1,3,0,1,0,69.43
臺南縣,關廟鄉,布袋村,736,1,255,3,258,352,3,1,3,0,1,0,73.30
臺南縣,關廟鄉,田中村,737,1,524,5,529,767,3,1,3,0,1,0,68.97
臺南縣,關廟鄉,龜洞村,738,1,573,4,577,775,3,1,3,0,1,0,74.45
臺南縣,關廟鄉,埤頭村,739,1,518,6,524,826,3,1,3,0,1,0,63.44
臺南縣,關廟鄉,埤頭村,740,1,489,3,492,729,3,1,3,0,1,0,67.49
臺南縣,關廟鄉,下湖村,741,1,288,6,294,404,3,1,3,0,1,0,72.77
臺南縣,龍崎鄉,崎頂村,742,1,829,6,835,1185,3,1,3,0,1,0,70.46
臺南縣,龍崎鄉,土崎村,743,1,452,3,455,690,3,1,3,0,1,0,65.94
臺南縣,龍崎鄉,中坑村,744,1,103,1,104,201,3,1,3,0,1,0,51.74
臺南縣,龍崎鄉,楠坑村,745,1,217,3,220,311,3,1,3,0,1,0,70.74
臺南縣,龍崎鄉,牛埔村,746,1,187,1,188,271,3,1,3,0,1,0,69.37
臺南縣,龍崎鄉,大坪村,747,1,203,1,204,297,3,1,3,0,1,0,68.69
臺南縣,龍崎鄉,龍船村,748,1,308,2,310,423,3,1,3,0,1,0,73.29
臺南縣,龍崎鄉,石曹村,749,1,256,1,257,383,3,1,3,0,1,0,67.10
臺南縣,永康市,五王里,750,1,541,4,545,1046,3,1,3,0,1,0,52.10
臺南縣,永康市,五王里,751,1,577,2,579,1090,3,1,3,0,1,0,53.12
臺南縣,永康市,五王里,752,1,565,2,567,1119,3,1,3,0,1,0,50.67
臺南縣,永康市,五王里,753,1,474,1,475,1055,3,1,3,0,1,0,45.02
臺南縣,永康市,三合里,754,1,548,5,553,969,3,1,3,0,1,0,57.07
臺南縣,永康市,三合里,755,1,541,2,543,947,3,1,3,0,1,0,57.34
臺南縣,永康市,三合里,756,1,531,4,535,1047,3,1,3,0,1,0,51.10
臺南縣,永康市,六合里,757,1,529,0,529,1163,3,1,3,0,1,0,45.49
臺南縣,永康市,六合里,758,1,397,5,402,713,3,1,3,0,1,0,56.38
臺南縣,永康市,六合里,759,1,416,3,419,757,3,1,3,0,1,0,55.35
臺南縣,永康市,六合里,760,1,484,3,487,991,3,1,3,0,1,0,49.14
臺南縣,永康市,網寮里,761,1,687,6,693,1182,3,1,3,0,1,0,58.63
臺南縣,永康市,網寮里,762,1,499,2,501,1044,3,1,3,0,1,0,47.99
臺南縣,永康市,網寮里,763,1,605,8,613,1099,3,1,3,0,1,0,55.78
臺南縣,永康市,網寮里,764,1,577,1,578,1068,3,1,3,0,1,0,54.12
臺南縣,永康市,二王里,765,1,648,2,650,1129,3,1,3,0,1,0,57.57
臺南縣,永康市,二王里,766,1,635,7,642,1259,3,1,3,0,1,0,50.99
臺南縣,永康市,二王里,767,1,748,2,750,1270,3,1,3,0,1,0,59.06
臺南縣,永康市,二王里,768,1,628,4,632,1158,3,1,3,0,1,0,54.58
臺南縣,永康市,二王里,769,1,701,8,709,1187,3,1,3,0,1,0,59.73
臺南縣,永康市,永康里,770,1,588,4,592,1016,3,1,3,0,1,0,58.27
臺南縣,永康市,永康里,771,1,583,4,587,1104,3,1,3,0,1,0,53.17
臺南縣,永康市,永康里,772,1,654,2,656,1222,3,1,3,0,1,0,53.68
臺南縣,永康市,永康里,773,1,726,2,728,1547,3,1,3,0,1,0,47.06
臺南縣,永康市,永康里,774,1,530,3,533,1417,3,1,3,0,1,0,37.61
臺南縣,永康市,埔園里,775,1,723,5,728,1306,3,1,3,0,1,0,55.74
臺南縣,永康市,埔園里,776,1,796,2,798,1451,3,1,3,0,1,0,55.00
臺南縣,永康市,埔園里,777,1,779,7,786,1418,3,1,3,0,1,0,55.43
臺南縣,永康市,埔園里,778,1,835,4,839,1638,3,1,3,0,1,0,51.22
臺南縣,永康市,正強里,779,1,768,3,771,1303,3,1,3,0,1,0,59.17
臺南縣,永康市,正強里,780,1,678,8,686,1232,3,1,3,0,1,0,55.68
臺南縣,永康市,正強里,781,1,599,7,606,1011,3,1,3,0,1,0,59.94
臺南縣,永康市,正強里,782,1,609,2,611,1187,3,1,3,0,1,0,51.47
臺南縣,永康市,正強里,783,1,535,4,539,1057,3,1,3,0,1,0,50.99
臺南縣,永康市,大橋里,784,1,597,5,602,1182,3,1,3,0,1,0,50.93
臺南縣,永康市,大橋里,785,1,580,4,584,1086,3,1,3,0,1,0,53.78
臺南縣,永康市,大橋里,786,1,543,4,547,1078,3,1,3,0,1,0,50.74
臺南縣,永康市,大橋里,787,1,594,2,596,1147,3,1,3,0,1,0,51.96
臺南縣,永康市,東橋里,788,1,459,1,460,830,3,1,3,0,1,0,55.42
臺南縣,永康市,東橋里,789,1,405,2,407,672,3,1,3,0,1,0,60.57
臺南縣,永康市,東橋里,790,1,421,4,425,712,3,1,3,0,1,0,59.69
臺南縣,永康市,西橋里,791,1,699,7,706,1282,3,1,3,0,1,0,55.07
臺南縣,永康市,西橋里,792,1,655,2,657,1317,3,1,3,0,1,0,49.89
臺南縣,永康市,安康里,793,1,637,4,641,1222,3,1,3,0,1,0,52.45
臺南縣,永康市,安康里,794,1,722,8,730,1337,3,1,3,0,1,0,54.60
臺南縣,永康市,安康里,795,1,535,1,536,1316,3,1,3,0,1,0,40.73
臺南縣,永康市,蔦松里,796,1,501,1,502,846,3,1,3,0,1,0,59.34
臺南縣,永康市,蔦松里,797,1,419,4,423,677,3,1,3,0,1,0,62.48
臺南縣,永康市,三民里,798,1,421,5,426,659,3,1,3,0,1,0,64.64
臺南縣,永康市,三民里,799,1,282,2,284,431,3,1,3,0,1,0,65.89
臺南縣,永康市,鹽行里,800,1,694,9,703,1277,3,1,3,0,1,0,55.05
臺南縣,永康市,鹽行里,801,1,690,4,694,1243,3,1,3,0,1,0,55.83
臺南縣,永康市,鹽行里,802,1,506,2,508,964,3,1,3,0,1,0,52.70
臺南縣,永康市,鹽行里,803,1,406,1,407,853,3,1,3,0,1,0,47.71
臺南縣,永康市,鹽行里,804,1,488,0,488,859,3,1,3,0,1,0,56.81
臺南縣,永康市,鹽行里,805,1,670,2,672,1223,3,1,3,0,1,0,54.95
臺南縣,永康市,鹽洲里,806,1,524,6,530,950,3,1,3,0,1,0,55.79
臺南縣,永康市,鹽洲里,807,1,668,4,672,1131,3,1,3,0,1,0,59.42
臺南縣,永康市,鹽洲里,808,1,647,6,653,1054,3,1,3,0,1,0,61.95
臺南縣,永康市,鹽洲里,809,1,782,5,787,1298,3,1,3,0,1,0,60.63
臺南縣,永康市,甲頂里,810,1,416,7,423,778,3,1,3,0,1,0,54.37
臺南縣,永康市,甲頂里,811,1,591,3,594,948,3,1,3,0,1,0,62.66
臺南縣,永康市,甲頂里,812,1,348,2,350,530,3,1,3,0,1,0,66.04
臺南縣,永康市,尚頂里,813,1,711,5,716,1146,3,1,3,0,1,0,62.48
臺南縣,永康市,尚頂里,814,1,687,5,692,1136,3,1,3,0,1,0,60.92
臺南縣,永康市,尚頂里,815,1,595,7,602,1244,3,1,3,0,1,0,48.39
臺南縣,永康市,龍潭里,816,1,605,4,609,1039,3,1,3,0,1,0,58.61
臺南縣,永康市,龍潭里,817,1,544,8,552,938,3,1,3,0,1,0,58.85
臺南縣,永康市,龍潭里,818,1,611,7,618,1195,3,1,3,0,1,0,51.72
臺南縣,永康市,龍潭里,819,1,598,1,599,1040,3,1,3,0,1,0,57.60
臺南縣,永康市,龍潭里,820,1,658,3,661,1277,3,1,3,0,1,0,51.76
臺南縣,永康市,龍潭里,821,1,513,2,515,1091,3,1,3,0,1,0,47.20
臺南縣,永康市,王行里,822,1,824,4,828,1323,3,1,3,0,1,0,62.59
臺南縣,永康市,王行里,823,1,333,1,334,556,3,1,3,0,1,0,60.07
臺南縣,永康市,烏竹里,824,1,521,4,525,827,3,1,3,0,1,0,63.48
臺南縣,永康市,烏竹里,825,1,500,5,505,906,3,1,3,0,1,0,55.74
臺南縣,永康市,西勢里,826,1,633,2,635,1056,3,1,3,0,1,0,60.13
臺南縣,永康市,西勢里,827,1,620,2,622,1076,3,1,3,0,1,0,57.81
臺南縣,永康市,西勢里,828,1,619,7,626,1085,3,1,3,0,1,0,57.70
臺南縣,永康市,西勢里,829,1,543,1,544,1065,3,1,3,0,1,0,51.08
臺南縣,永康市,新樹里,830,1,347,5,352,551,3,1,3,0,1,0,63.88
臺南縣,永康市,新樹里,831,1,449,3,452,750,3,1,3,0,1,0,60.27
臺南縣,永康市,大灣里,832,1,624,3,627,1043,3,1,3,0,1,0,60.12
臺南縣,永康市,大灣里,833,1,632,6,638,984,3,1,3,0,1,0,64.84
臺南縣,永康市,大灣里,834,1,602,5,607,982,3,1,3,0,1,0,61.81
臺南縣,永康市,東灣里,835,1,653,5,658,1032,3,1,3,0,1,0,63.76
臺南縣,永康市,東灣里,836,1,650,6,656,1126,3,1,3,0,1,0,58.26
臺南縣,永康市,東灣里,837,1,586,4,590,1097,3,1,3,0,1,0,53.78
臺南縣,永康市,西灣里,838,1,706,3,709,1237,3,1,3,0,1,0,57.32
臺南縣,永康市,西灣里,839,1,669,2,671,1248,3,1,3,0,1,0,53.77
臺南縣,永康市,西灣里,840,1,551,2,553,917,3,1,3,0,1,0,60.31
臺南縣,永康市,西灣里,841,1,541,1,542,940,3,1,3,0,1,0,57.66
臺南縣,永康市,西灣里,842,1,691,2,693,1165,3,1,3,0,1,0,59.48
臺南縣,永康市,南灣里,843,1,784,7,791,1349,3,1,3,0,1,0,58.64
臺南縣,永康市,南灣里,844,1,741,5,746,1188,3,1,3,0,1,0,62.79
臺南縣,永康市,南灣里,845,1,611,8,619,988,3,1,3,0,1,0,62.65
臺南縣,永康市,崑山里,846,1,657,3,660,1161,3,1,3,0,1,0,56.85
臺南縣,永康市,崑山里,847,1,804,5,809,1356,3,1,3,0,1,0,59.66
臺南縣,永康市,崑山里,848,1,773,4,777,1334,3,1,3,0,1,0,58.25
臺南縣,永康市,崑山里,849,1,801,11,812,1504,3,1,3,0,1,0,53.99
臺南縣,永康市,北灣里,850,1,661,0,661,1138,3,1,3,0,1,0,58.08
臺南縣,永康市,北灣里,851,1,630,5,635,1055,3,1,3,0,1,0,60.19
臺南縣,永康市,北灣里,852,1,793,6,799,1412,3,1,3,0,1,0,56.59
臺南縣,永康市,北灣里,853,1,627,5,632,1095,3,1,3,0,1,0,57.72
臺南縣,永康市,北灣里,854,1,738,6,744,1239,3,1,3,0,1,0,60.05
臺南縣,永康市,復興里,855,1,483,1,484,793,3,1,3,0,1,0,61.03
臺南縣,永康市,復興里,856,1,593,5,598,957,3,1,3,0,1,0,62.49
臺南縣,永康市,光復里,857,1,607,5,612,960,3,1,3,0,1,0,63.75
臺南縣,永康市,建國里,858,1,355,4,359,626,3,1,3,0,1,0,57.35
臺南縣,永康市,建國里,859,1,579,4,583,920,3,1,3,0,1,0,63.37
臺南縣,永康市,復國里,860,1,647,6,653,1060,3,1,3,0,1,0,61.60
臺南縣,永康市,復國里,861,1,663,1,664,1103,3,1,3,0,1,0,60.20
臺南縣,永康市,復華里,862,1,544,3,547,1177,3,1,3,0,1,0,46.47
臺南縣,永康市,復華里,863,1,718,6,724,1454,3,1,3,0,1,0,49.79
臺南縣,永康市,復華里,864,1,649,3,652,1147,3,1,3,0,1,0,56.84
臺南縣,永康市,復華里,865,1,572,1,573,1125,3,1,3,0,1,0,50.93
臺南縣,永康市,復華里,866,1,629,4,633,1215,3,1,3,0,1,0,52.10
臺南縣,永康市,復華里,867,1,568,7,575,1182,3,1,3,0,1,0,48.65
臺南縣,永康市,復華里,868,1,526,4,530,1049,3,1,3,0,1,0,50.52
臺南縣,永康市,復華里,869,1,500,4,504,888,3,1,3,0,1,0,56.76
臺南縣,永康市,復華里,870,1,653,6,659,1205,3,1,3,0,1,0,54.69
臺南縣,永康市,神洲里,871,1,570,4,574,888,3,1,3,0,1,0,64.64
臺南縣,永康市,神洲里,872,1,442,3,445,787,3,1,3,0,1,0,56.54
臺南縣,永康市,成功里,873,1,349,1,350,556,3,1,3,0,1,0,62.95
臺南縣,永康市,成功里,874,1,504,5,509,994,3,1,3,0,1,0,51.21
臺南縣,永康市,中華里,875,1,623,6,629,1057,3,1,3,0,1,0,59.51
臺南縣,永康市,中華里,876,1,614,3,617,1108,3,1,3,0,1,0,55.69
臺南縣,永康市,中興里,877,1,780,6,786,1361,3,1,3,0,1,0,57.75
臺南縣,永康市,中興里,878,1,919,9,928,1482,3,1,3,0,1,0,62.62
臺南縣,永康市,勝利里,879,1,508,4,512,1157,3,1,3,0,1,0,44.25
臺南縣,永康市,勝利里,880,1,506,6,512,1100,3,1,3,0,1,0,46.55
臺南縣,永康市,勝利里,881,1,553,7,560,983,3,1,3,0,1,0,56.97
臺南縣,永康市,勝利里,882,1,671,2,673,1073,3,1,3,0,1,0,62.72
臺南縣,永康市,勝利里,883,1,577,1,578,1069,3,1,3,0,1,0,54.07
高雄縣,鳳山市,鳳崗里,1,1,391,4,395,626,3,1,3,0,1,0,63.10
高雄縣,鳳山市,鳳崗里,2,1,387,0,387,652,3,1,3,0,1,0,59.36
高雄縣,鳳山市,縣衙里,3,1,493,1,494,865,3,1,3,0,1,0,57.11
高雄縣,鳳山市,曹公里,4,1,821,4,825,1346,3,1,3,0,1,0,61.29
高雄縣,鳳山市,曹公里,5,1,574,6,580,952,3,1,3,0,1,0,60.92
高雄縣,鳳山市,鎮西里,6,1,844,17,861,1424,3,1,3,0,1,0,60.46
高雄縣,鳳山市,鎮西里,7,1,724,4,728,1257,3,1,3,0,1,0,57.92
高雄縣,鳳山市,鎮西里,8,1,666,6,672,1121,3,1,3,0,1,0,59.95
高雄縣,鳳山市,鎮西里,9,1,725,9,734,1192,3,1,3,0,1,0,61.58
高雄縣,鳳山市,北門里,10,1,622,3,625,1089,3,1,3,0,1,0,57.39
高雄縣,鳳山市,北門里,11,1,625,8,633,1079,3,1,3,0,1,0,58.67
高雄縣,鳳山市,北門里,12,1,401,3,404,680,3,1,3,0,1,0,59.41
高雄縣,鳳山市,北門里,13,1,686,6,692,1148,3,1,3,0,1,0,60.28
高雄縣,鳳山市,鎮北里,14,1,624,1,625,1082,3,1,3,0,1,0,57.76
高雄縣,鳳山市,鎮北里,15,1,751,7,758,1330,3,1,3,0,1,0,56.99
高雄縣,鳳山市,鎮北里,16,1,436,3,439,840,3,1,3,0,1,0,52.26
高雄縣,鳳山市,鎮北里,17,1,683,6,689,1183,3,1,3,0,1,0,58.24
高雄縣,鳳山市,武松里,18,1,661,0,661,1248,3,1,3,0,1,0,52.96
高雄縣,鳳山市,武松里,19,1,726,6,732,1193,3,1,3,0,1,0,61.36
高雄縣,鳳山市,忠誠里,20,1,647,6,653,1121,3,1,3,0,1,0,58.25
高雄縣,鳳山市,忠誠里,21,1,962,12,974,1704,3,1,3,0,1,0,57.16
高雄縣,鳳山市,文英里,22,1,625,7,632,1047,3,1,3,0,1,0,60.36
高雄縣,鳳山市,文英里,23,1,499,4,503,955,3,1,3,0,1,0,52.67
高雄縣,鳳山市,文英里,24,1,548,2,550,978,3,1,3,0,1,0,56.24
高雄縣,鳳山市,文華里,25,1,1070,5,1075,1560,3,1,3,0,1,0,68.91
高雄縣,鳳山市,文華里,26,1,532,2,534,911,3,1,3,0,1,0,58.62
高雄縣,鳳山市,文華里,27,1,639,4,643,1026,3,1,3,0,1,0,62.67
高雄縣,鳳山市,文華里,28,1,673,3,676,1181,3,1,3,0,1,0,57.24
高雄縣,鳳山市,文華里,29,1,803,8,811,1273,3,1,3,0,1,0,63.71
高雄縣,鳳山市,文山里,30,1,562,3,565,995,3,1,3,0,1,0,56.78
高雄縣,鳳山市,文山里,31,1,851,5,856,1476,3,1,3,0,1,0,57.99
高雄縣,鳳山市,文山里,32,1,607,1,608,1048,3,1,3,0,1,0,58.02
高雄縣,鳳山市,文山里,33,1,572,7,579,966,3,1,3,0,1,0,59.94
高雄縣,鳳山市,文山里,34,1,472,2,474,808,3,1,3,0,1,0,58.66
高雄縣,鳳山市,文德里,35,1,733,5,738,1372,3,1,3,0,1,0,53.79
高雄縣,鳳山市,文德里,36,1,719,7,726,1376,3,1,3,0,1,0,52.76
高雄縣,鳳山市,文德里,37,1,708,3,711,1322,3,1,3,0,1,0,53.78
高雄縣,鳳山市,文德里,38,1,868,2,870,1695,3,1,3,0,1,0,51.33
高雄縣,鳳山市,文衡里,39,1,695,5,700,1197,3,1,3,0,1,0,58.48
高雄縣,鳳山市,文衡里,40,1,674,6,680,1214,3,1,3,0,1,0,56.01
高雄縣,鳳山市,文福里,41,1,681,9,690,1282,3,1,3,0,1,0,53.82
高雄縣,鳳山市,文福里,42,1,649,2,651,1206,3,1,3,0,1,0,53.98
高雄縣,鳳山市,文福里,43,1,582,0,582,1050,3,1,3,0,1,0,55.43
高雄縣,鳳山市,文福里,44,1,609,3,612,1301,3,1,3,0,1,0,47.04
高雄縣,鳳山市,文福里,45,1,583,5,588,1070,3,1,3,0,1,0,54.95
高雄縣,鳳山市,成功里,46,1,499,4,503,789,3,1,3,0,1,0,63.75
高雄縣,鳳山市,縣口里,47,1,293,4,297,484,3,1,3,0,1,0,61.36
高雄縣,鳳山市,光明里,48,1,308,1,309,523,3,1,3,0,1,0,59.08
高雄縣,鳳山市,光明里,49,1,502,3,505,788,3,1,3,0,1,0,64.09
高雄縣,鳳山市,和德里,50,1,503,5,508,847,3,1,3,0,1,0,59.98
高雄縣,鳳山市,和德里,51,1,465,2,467,796,3,1,3,0,1,0,58.67
高雄縣,鳳山市,和興里,52,1,725,3,728,1266,3,1,3,0,1,0,57.50
高雄縣,鳳山市,和興里,53,1,772,7,779,1250,3,1,3,0,1,0,62.32
高雄縣,鳳山市,和興里,54,1,687,4,691,1183,3,1,3,0,1,0,58.41
高雄縣,鳳山市,和興里,55,1,713,2,715,1175,3,1,3,0,1,0,60.85
高雄縣,鳳山市,南興里,56,1,638,5,643,1054,3,1,3,0,1,0,61.01
高雄縣,鳳山市,三民里,57,1,694,8,702,1086,3,1,3,0,1,0,64.64
高雄縣,鳳山市,新興里,58,1,762,6,768,1442,3,1,3,0,1,0,53.26
高雄縣,鳳山市,興仁里,59,1,676,3,679,1155,3,1,3,0,1,0,58.79
高雄縣,鳳山市,興仁里,60,1,497,6,503,855,3,1,3,0,1,0,58.83
高雄縣,鳳山市,興仁里,61,1,547,3,550,864,3,1,3,0,1,0,63.66
高雄縣,鳳山市,興仁里,62,1,566,2,568,906,3,1,3,0,1,0,62.69
高雄縣,鳳山市,興中里,63,1,465,4,469,814,3,1,3,0,1,0,57.62
高雄縣,鳳山市,協和里,64,1,632,4,636,1059,3,1,3,0,1,0,60.06
高雄縣,鳳山市,協和里,65,1,623,2,625,1089,3,1,3,0,1,0,57.39
高雄縣,鳳山市,協和里,66,1,794,6,800,1349,3,1,3,0,1,0,59.30
高雄縣,鳳山市,忠義里,67,1,586,1,587,925,3,1,3,0,1,0,63.46
高雄縣,鳳山市,忠義里,68,1,501,3,504,922,3,1,3,0,1,0,54.66
高雄縣,鳳山市,忠義里,69,1,499,4,503,962,3,1,3,0,1,0,52.29
高雄縣,鳳山市,忠義里,70,1,767,7,774,1304,3,1,3,0,1,0,59.36
高雄縣,鳳山市,忠孝里,71,1,657,8,665,1142,3,1,3,0,1,0,58.23
高雄縣,鳳山市,忠孝里,72,1,623,0,623,1048,3,1,3,0,1,0,59.45
高雄縣,鳳山市,忠孝里,73,1,605,2,607,1064,3,1,3,0,1,0,57.05
高雄縣,鳳山市,忠孝里,74,1,644,6,650,1159,3,1,3,0,1,0,56.08
高雄縣,鳳山市,忠孝里,75,1,600,3,603,944,3,1,3,0,1,0,63.88
高雄縣,鳳山市,中和里,76,1,669,10,679,1138,3,1,3,0,1,0,59.67
高雄縣,鳳山市,中和里,77,1,563,6,569,983,3,1,3,0,1,0,57.88
高雄縣,鳳山市,中和里,78,1,690,7,697,1139,3,1,3,0,1,0,61.19
高雄縣,鳳山市,誠正里,79,1,285,3,288,439,3,1,3,0,1,0,65.60
高雄縣,鳳山市,誠正里,80,1,314,5,319,473,3,1,3,0,1,0,67.44
高雄縣,鳳山市,誠義里,81,1,922,8,930,1586,3,1,3,0,1,0,58.64
高雄縣,鳳山市,生明里,82,1,989,10,999,1582,3,1,3,0,1,0,63.15
高雄縣,鳳山市,鎮東里,83,1,621,3,624,1125,3,1,3,0,1,0,55.47
高雄縣,鳳山市,鎮東里,84,1,554,5,559,959,3,1,3,0,1,0,58.29
高雄縣,鳳山市,瑞竹里,85,1,693,4,697,1026,3,1,3,0,1,0,67.93
高雄縣,鳳山市,瑞竹里,86,1,627,3,630,983,3,1,3,0,1,0,64.09
高雄縣,鳳山市,瑞竹里,87,1,652,3,655,1053,3,1,3,0,1,0,62.20
高雄縣,鳳山市,瑞竹里,88,1,501,3,504,834,3,1,3,0,1,0,60.43
高雄縣,鳳山市,瑞竹里,89,1,532,5,537,927,3,1,3,0,1,0,57.93
高雄縣,鳳山市,瑞興里,90,1,770,3,773,1326,3,1,3,0,1,0,58.30
高雄縣,鳳山市,瑞興里,91,1,755,8,763,1340,3,1,3,0,1,0,56.94
高雄縣,鳳山市,瑞興里,92,1,735,3,738,1221,3,1,3,0,1,0,60.44
高雄縣,鳳山市,東門里,93,1,786,8,794,1304,3,1,3,0,1,0,60.89
高雄縣,鳳山市,東門里,94,1,825,3,828,1160,3,1,3,0,1,0,71.38
高雄縣,鳳山市,東門里,95,1,622,2,624,1074,3,1,3,0,1,0,58.10
高雄縣,鳳山市,東門里,96,1,774,4,778,1264,3,1,3,0,1,0,61.55
高雄縣,鳳山市,誠德里,97,1,605,4,609,958,3,1,3,0,1,0,63.57
高雄縣,鳳山市,誠德里,98,1,644,6,650,1069,3,1,3,0,1,0,60.80
高雄縣,鳳山市,誠信里,99,1,460,7,467,815,3,1,3,0,1,0,57.30
高雄縣,鳳山市,誠信里,100,1,456,3,459,847,3,1,3,0,1,0,54.19
高雄縣,鳳山市,誠智里,101,1,654,7,661,1237,3,1,3,0,1,0,53.44
高雄縣,鳳山市,誠智里,102,1,586,5,591,1017,3,1,3,0,1,0,58.11
高雄縣,鳳山市,鳳東里,103,1,806,6,812,1378,3,1,3,0,1,0,58.93
高雄縣,鳳山市,鳳東里,104,1,749,5,754,1287,3,1,3,0,1,0,58.59
高雄縣,鳳山市,鳳東里,105,1,807,5,812,1413,3,1,3,0,1,0,57.47
高雄縣,鳳山市,埤頂里,106,1,603,2,605,1013,3,1,3,0,1,0,59.72
高雄縣,鳳山市,埤頂里,107,1,764,5,769,1250,3,1,3,0,1,0,61.52
高雄縣,鳳山市,埤頂里,108,1,643,3,646,1087,3,1,3,0,1,0,59.43
高雄縣,鳳山市,埤頂里,109,1,757,6,763,1289,3,1,3,0,1,0,59.19
高雄縣,鳳山市,美齡里,110,1,71,1,72,155,3,1,3,0,1,0,46.45
高雄縣,鳳山市,中正里,111,1,680,1,681,1148,3,1,3,0,1,0,59.32
高雄縣,鳳山市,海光里,112,1,532,8,540,796,3,1,3,0,1,0,67.84
高雄縣,鳳山市,海光里,113,1,417,13,430,703,3,1,3,0,1,0,61.17
高雄縣,鳳山市,海光里,114,1,540,2,542,903,3,1,3,0,1,0,60.02
高雄縣,鳳山市,海光里,115,1,776,7,783,1346,3,1,3,0,1,0,58.17
高雄縣,鳳山市,海風里,116,1,434,2,436,656,3,1,3,0,1,0,66.46
高雄縣,鳳山市,海風里,117,1,514,7,521,736,3,1,3,0,1,0,70.79
高雄縣,鳳山市,海風里,118,1,585,2,587,852,3,1,3,0,1,0,68.90
高雄縣,鳳山市,國泰里,119,1,548,2,550,951,3,1,3,0,1,0,57.83
高雄縣,鳳山市,國泰里,120,1,457,0,457,823,3,1,3,0,1,0,55.53
高雄縣,鳳山市,國泰里,121,1,477,5,482,916,3,1,3,0,1,0,52.62
高雄縣,鳳山市,國泰里,122,1,700,6,706,1233,3,1,3,0,1,0,57.26
高雄縣,鳳山市,國光里,123,1,647,2,649,1209,3,1,3,0,1,0,53.68
高雄縣,鳳山市,國光里,124,1,679,2,681,1306,3,1,3,0,1,0,52.14
高雄縣,鳳山市,國光里,125,1,638,5,643,1163,3,1,3,0,1,0,55.29
高雄縣,鳳山市,國隆里,126,1,557,4,561,1040,3,1,3,0,1,0,53.94
高雄縣,鳳山市,國隆里,127,1,487,2,489,931,3,1,3,0,1,0,52.52
高雄縣,鳳山市,國隆里,128,1,382,3,385,704,3,1,3,0,1,0,54.69
高雄縣,鳳山市,國富里,129,1,646,3,649,1168,3,1,3,0,1,0,55.57
高雄縣,鳳山市,國富里,130,1,599,2,601,1056,3,1,3,0,1,0,56.91
高雄縣,鳳山市,武慶里,131,1,514,4,518,1035,3,1,3,0,1,0,50.05
高雄縣,鳳山市,武慶里,132,1,637,5,642,1090,3,1,3,0,1,0,58.90
高雄縣,鳳山市,武漢里,133,1,484,4,488,866,3,1,3,0,1,0,56.35
高雄縣,鳳山市,武漢里,134,1,562,7,569,1055,3,1,3,0,1,0,53.93
高雄縣,鳳山市,武漢里,135,1,510,1,511,938,3,1,3,0,1,0,54.48
高雄縣,鳳山市,武漢里,136,1,527,3,530,1013,3,1,3,0,1,0,52.32
高雄縣,鳳山市,新甲里,137,1,503,4,507,885,3,1,3,0,1,0,57.29
高雄縣,鳳山市,新甲里,138,1,396,0,396,776,3,1,3,0,1,0,51.03
高雄縣,鳳山市,新甲里,139,1,402,4,406,712,3,1,3,0,1,0,57.02
高雄縣,鳳山市,新武里,140,1,586,6,592,1019,3,1,3,0,1,0,58.10
高雄縣,鳳山市,新武里,141,1,552,2,554,939,3,1,3,0,1,0,59.00
高雄縣,鳳山市,新泰里,142,1,535,4,539,959,3,1,3,0,1,0,56.20
高雄縣,鳳山市,新泰里,143,1,478,1,479,901,3,1,3,0,1,0,53.16
高雄縣,鳳山市,新泰里,144,1,449,1,450,862,3,1,3,0,1,0,52.20
高雄縣,鳳山市,新樂里,145,1,478,3,481,927,3,1,3,0,1,0,51.89
高雄縣,鳳山市,新樂里,146,1,643,6,649,1124,3,1,3,0,1,0,57.74
高雄縣,鳳山市,新樂里,147,1,716,4,720,1310,3,1,3,0,1,0,54.96
高雄縣,鳳山市,新強里,148,1,701,5,706,1253,3,1,3,0,1,0,56.34
高雄縣,鳳山市,新強里,149,1,788,3,791,1297,3,1,3,0,1,0,60.99
高雄縣,鳳山市,新強里,150,1,805,4,809,1525,3,1,3,0,1,0,53.05
高雄縣,鳳山市,海洋里,151,1,485,7,492,848,3,1,3,0,1,0,58.02
高雄縣,鳳山市,海洋里,152,1,520,3,523,978,3,1,3,0,1,0,53.48
高雄縣,鳳山市,海洋里,153,1,768,4,772,1315,3,1,3,0,1,0,58.71
高雄縣,鳳山市,新富里,154,1,640,3,643,1213,3,1,3,0,1,0,53.01
高雄縣,鳳山市,新富里,155,1,615,5,620,1182,3,1,3,0,1,0,52.45
高雄縣,鳳山市,新富里,156,1,642,3,645,1253,3,1,3,0,1,0,51.48
高雄縣,鳳山市,老爺里,157,1,689,2,691,1297,3,1,3,0,1,0,53.28
高雄縣,鳳山市,老爺里,158,1,729,1,730,1316,3,1,3,0,1,0,55.47
高雄縣,鳳山市,老爺里,159,1,786,19,805,1359,3,1,3,0,1,0,59.23
高雄縣,鳳山市,老爺里,160,1,608,2,610,1139,3,1,3,0,1,0,53.56
高雄縣,鳳山市,老爺里,161,1,526,1,527,1002,3,1,3,0,1,0,52.59
高雄縣,鳳山市,中民里,162,1,514,1,515,941,3,1,3,0,1,0,54.73
高雄縣,鳳山市,中民里,163,1,427,3,430,852,3,1,3,0,1,0,50.47
高雄縣,鳳山市,中民里,164,1,428,2,430,830,3,1,3,0,1,0,51.81
高雄縣,鳳山市,中民里,165,1,403,1,404,815,3,1,3,0,1,0,49.57
高雄縣,鳳山市,中崙里,166,1,539,7,546,916,3,1,3,0,1,0,59.61
高雄縣,鳳山市,中崙里,167,1,621,6,627,1067,3,1,3,0,1,0,58.76
高雄縣,鳳山市,中榮里,168,1,501,1,502,977,3,1,3,0,1,0,51.38
高雄縣,鳳山市,中榮里,169,1,537,4,541,1050,3,1,3,0,1,0,51.52
高雄縣,鳳山市,中榮里,170,1,424,5,429,756,3,1,3,0,1,0,56.75
高雄縣,鳳山市,中榮里,171,1,552,1,553,1107,3,1,3,0,1,0,49.95
高雄縣,鳳山市,過埤里,172,1,743,4,747,1254,3,1,3,0,1,0,59.57
高雄縣,鳳山市,過埤里,173,1,646,7,653,1207,3,1,3,0,1,0,54.10
高雄縣,鳳山市,過埤里,174,1,532,3,535,1139,3,1,3,0,1,0,46.97
高雄縣,鳳山市,正義里,175,1,688,7,695,1397,3,1,3,0,1,0,49.75
高雄縣,鳳山市,正義里,176,1,774,5,779,1470,3,1,3,0,1,0,52.99
高雄縣,鳳山市,正義里,177,1,813,8,821,1537,3,1,3,0,1,0,53.42
高雄縣,鳳山市,正義里,178,1,769,5,774,1362,3,1,3,0,1,0,56.83
高雄縣,鳳山市,正義里,179,1,763,3,766,1442,3,1,3,0,1,0,53.12
高雄縣,鳳山市,正義里,180,1,633,1,634,1397,3,1,3,0,1,0,45.38
高雄縣,鳳山市,一甲里,181,1,536,5,541,950,3,1,3,0,1,0,56.95
高雄縣,鳳山市,一甲里,182,1,623,2,625,1115,3,1,3,0,1,0,56.05
高雄縣,鳳山市,一甲里,183,1,580,5,585,1086,3,1,3,0,1,0,53.87
高雄縣,鳳山市,二甲里,184,1,758,8,766,1248,3,1,3,0,1,0,61.38
高雄縣,鳳山市,二甲里,185,1,518,6,524,1019,3,1,3,0,1,0,51.42
高雄縣,鳳山市,二甲里,186,1,776,2,778,1382,3,1,3,0,1,0,56.30
高雄縣,鳳山市,龍成里,187,1,793,6,799,1485,3,1,3,0,1,0,53.80
高雄縣,鳳山市,龍成里,188,1,623,8,631,1189,3,1,3,0,1,0,53.07
高雄縣,鳳山市,鎮南里,189,1,575,1,576,983,3,1,3,0,1,0,58.60
高雄縣,鳳山市,鎮南里,190,1,413,5,418,772,3,1,3,0,1,0,54.15
高雄縣,鳳山市,鎮南里,191,1,635,4,639,1152,3,1,3,0,1,0,55.47
高雄縣,鳳山市,鎮南里,192,1,571,5,576,1029,3,1,3,0,1,0,55.98
高雄縣,鳳山市,富甲里,193,1,334,3,337,924,3,1,3,0,1,0,36.47
高雄縣,鳳山市,富甲里,194,1,321,4,325,608,3,1,3,0,1,0,53.45
高雄縣,鳳山市,富甲里,195,1,321,3,324,587,3,1,3,0,1,0,55.20
高雄縣,鳳山市,善美里,196,1,582,5,587,1101,3,1,3,0,1,0,53.32
高雄縣,鳳山市,善美里,197,1,568,5,573,1029,3,1,3,0,1,0,55.69
高雄縣,鳳山市,善美里,198,1,564,7,571,1151,3,1,3,0,1,0,49.61
高雄縣,鳳山市,善美里,199,1,587,6,593,1330,3,1,3,0,1,0,44.59
高雄縣,鳳山市,富榮里,200,1,514,8,522,967,3,1,3,0,1,0,53.98
高雄縣,鳳山市,富榮里,201,1,553,0,553,1003,3,1,3,0,1,0,55.13
高雄縣,鳳山市,南和里,202,1,413,2,415,715,3,1,3,0,1,0,58.04
高雄縣,鳳山市,南和里,203,1,405,3,408,787,3,1,3,0,1,0,51.84
高雄縣,鳳山市,南和里,204,1,529,1,530,968,3,1,3,0,1,0,54.75
高雄縣,鳳山市,南成里,205,1,544,2,546,947,3,1,3,0,1,0,57.66
高雄縣,鳳山市,南成里,206,1,523,3,526,1007,3,1,3,0,1,0,52.23
高雄縣,鳳山市,南成里,207,1,622,8,630,1066,3,1,3,0,1,0,59.10
高雄縣,鳳山市,南成里,208,1,614,4,618,1098,3,1,3,0,1,0,56.28
高雄縣,鳳山市,天興里,209,1,458,5,463,777,3,1,3,0,1,0,59.59
高雄縣,鳳山市,天興里,210,1,506,2,508,915,3,1,3,0,1,0,55.52
高雄縣,鳳山市,天興里,211,1,507,3,510,911,3,1,3,0,1,0,55.98
高雄縣,鳳山市,天興里,212,1,490,1,491,801,3,1,3,0,1,0,61.30
高雄縣,鳳山市,大德里,213,1,659,5,664,1219,3,1,3,0,1,0,54.47
高雄縣,鳳山市,大德里,214,1,676,6,682,1214,3,1,3,0,1,0,56.18
高雄縣,鳳山市,大德里,215,1,637,2,639,1134,3,1,3,0,1,0,56.35
高雄縣,鳳山市,五福里,216,1,563,3,566,899,3,1,3,0,1,0,62.96
高雄縣,鳳山市,五福里,217,1,563,2,565,1005,3,1,3,0,1,0,56.22
高雄縣,鳳山市,五福里,218,1,644,5,649,1090,3,1,3,0,1,0,59.54
高雄縣,鳳山市,福興里,219,1,620,4,624,1067,3,1,3,0,1,0,58.48
高雄縣,鳳山市,福興里,220,1,592,3,595,1006,3,1,3,0,1,0,59.15
高雄縣,鳳山市,福興里,221,1,554,2,556,1106,3,1,3,0,1,0,50.27
高雄縣,鳳山市,福興里,222,1,501,2,503,941,3,1,3,0,1,0,53.45
高雄縣,鳳山市,福興里,223,1,563,12,575,1125,3,1,3,0,1,0,51.11
高雄縣,鳳山市,福祥里,224,1,595,8,603,1100,3,1,3,0,1,0,54.82
高雄縣,鳳山市,福祥里,225,1,759,9,768,1409,3,1,3,0,1,0,54.51
高雄縣,鳳山市,福誠里,226,1,535,3,538,922,3,1,3,0,1,0,58.35
高雄縣,鳳山市,福誠里,227,1,521,5,526,914,3,1,3,0,1,0,57.55
高雄縣,鳳山市,福誠里,228,1,480,3,483,1014,3,1,3,0,1,0,47.63
高雄縣,林園鄉,仁愛村,229,1,808,7,815,1362,3,1,3,0,1,0,59.84
高雄縣,林園鄉,仁愛村,230,1,753,8,761,1262,3,1,3,0,1,0,60.30
高雄縣,林園鄉,林園村,231,1,632,2,634,1011,3,1,3,0,1,0,62.71
高雄縣,林園鄉,林園村,232,1,588,6,594,978,3,1,3,0,1,0,60.74
高雄縣,林園鄉,林園村,233,1,566,4,570,987,3,1,3,0,1,0,57.75
高雄縣,林園鄉,文賢村,234,1,689,3,692,1132,3,1,3,0,1,0,61.13
高雄縣,林園鄉,文賢村,235,1,576,5,581,944,3,1,3,0,1,0,61.55
高雄縣,林園鄉,東林村,236,1,743,5,748,1175,3,1,3,0,1,0,63.66
高雄縣,林園鄉,東林村,237,1,724,2,726,1316,3,1,3,0,1,0,55.17
高雄縣,林園鄉,溪州村,238,1,729,1,730,1173,3,1,3,0,1,0,62.23
高雄縣,林園鄉,溪州村,239,1,653,2,655,1106,3,1,3,0,1,0,59.22
高雄縣,林園鄉,溪州村,240,1,623,7,630,1083,3,1,3,0,1,0,58.17
高雄縣,林園鄉,五福村,241,1,600,6,606,1011,3,1,3,0,1,0,59.94
高雄縣,林園鄉,五福村,242,1,441,3,444,863,3,1,3,0,1,0,51.45
高雄縣,林園鄉,潭頭村,243,1,763,5,768,1271,3,1,3,0,1,0,60.42
高雄縣,林園鄉,潭頭村,244,1,659,6,665,1110,3,1,3,0,1,0,59.91
高雄縣,林園鄉,中厝村,245,1,813,16,829,1428,3,1,3,0,1,0,58.05
高雄縣,林園鄉,中厝村,246,1,716,6,722,1121,3,1,3,0,1,0,64.41
高雄縣,林園鄉,林內村,247,1,535,3,538,903,3,1,3,0,1,0,59.58
高雄縣,林園鄉,林內村,248,1,463,37,500,787,3,1,3,0,1,0,63.53
高雄縣,林園鄉,王公村,249,1,601,4,605,1064,3,1,3,0,1,0,56.86
高雄縣,林園鄉,王公村,250,1,618,2,620,1022,3,1,3,0,1,0,60.67
高雄縣,林園鄉,王公村,251,1,662,6,668,1045,3,1,3,0,1,0,63.92
高雄縣,林園鄉,廣應村,252,1,571,3,574,950,3,1,3,0,1,0,60.42
高雄縣,林園鄉,廣應村,253,1,653,4,657,1072,3,1,3,0,1,0,61.29
高雄縣,林園鄉,廣應村,254,1,508,4,512,875,3,1,3,0,1,0,58.51
高雄縣,林園鄉,林家村,255,1,810,7,817,1193,3,1,3,0,1,0,68.48
高雄縣,林園鄉,龔厝村,256,1,501,13,514,831,3,1,3,0,1,0,61.85
高雄縣,林園鄉,龔厝村,257,1,540,4,544,812,3,1,3,0,1,0,67.00
高雄縣,林園鄉,中門村,258,1,527,5,532,828,3,1,3,0,1,0,64.25
高雄縣,林園鄉,中門村,259,1,678,8,686,1130,3,1,3,0,1,0,60.71
高雄縣,林園鄉,頂厝村,260,1,512,3,515,958,3,1,3,0,1,0,53.76
高雄縣,林園鄉,頂厝村,261,1,638,6,644,1038,3,1,3,0,1,0,62.04
高雄縣,林園鄉,頂厝村,262,1,902,13,915,1532,3,1,3,0,1,0,59.73
高雄縣,林園鄉,港埔村,263,1,511,2,513,861,3,1,3,0,1,0,59.58
高雄縣,林園鄉,港埔村,264,1,448,4,452,768,3,1,3,0,1,0,58.85
高雄縣,林園鄉,港嘴村,265,1,902,15,917,1359,3,1,3,0,1,0,67.48
高雄縣,林園鄉,西溪村,266,1,556,3,559,896,3,1,3,0,1,0,62.39
高雄縣,林園鄉,西溪村,267,1,562,0,562,913,3,1,3,0,1,0,61.56
高雄縣,林園鄉,西溪村,268,1,676,1,677,1001,3,1,3,0,1,0,67.63
高雄縣,林園鄉,中芸村,269,1,590,6,596,950,3,1,3,0,1,0,62.74
高雄縣,林園鄉,中芸村,270,1,510,4,514,764,3,1,3,0,1,0,67.28
高雄縣,林園鄉,鳳芸村,271,1,495,4,499,728,3,1,3,0,1,0,68.54
高雄縣,林園鄉,鳳芸村,272,1,590,4,594,932,3,1,3,0,1,0,63.73
高雄縣,林園鄉,東汕村,273,1,537,4,541,880,3,1,3,0,1,0,61.48
高雄縣,林園鄉,西汕村,274,1,449,8,457,743,3,1,3,0,1,0,61.51
高雄縣,林園鄉,中汕村,275,1,641,9,650,1080,3,1,3,0,1,0,60.19
高雄縣,林園鄉,中汕村,276,1,572,9,581,1009,3,1,3,0,1,0,57.58
高雄縣,林園鄉,北汕村,277,1,334,1,335,582,3,1,3,0,1,0,57.56
高雄縣,林園鄉,北汕村,278,1,478,8,486,867,3,1,3,0,1,0,56.06
高雄縣,大寮鄉,義和村,279,1,609,4,613,959,3,1,3,0,1,0,63.92
高雄縣,大寮鄉,義和村,280,1,638,9,647,1060,3,1,3,0,1,0,61.04
高雄縣,大寮鄉,溪寮村,281,1,445,6,451,696,3,1,3,0,1,0,64.80
高雄縣,大寮鄉,溪寮村,282,1,460,3,463,696,3,1,3,0,1,0,66.52
高雄縣,大寮鄉,江山村,283,1,479,3,482,698,3,1,3,0,1,0,69.05
高雄縣,大寮鄉,江山村,284,1,580,5,585,849,3,1,3,0,1,0,68.90
高雄縣,大寮鄉,中庄村,285,1,594,16,610,1085,3,1,3,0,1,0,56.22
高雄縣,大寮鄉,中庄村,286,1,616,2,618,1019,3,1,3,0,1,0,60.65
高雄縣,大寮鄉,中庄村,287,1,489,3,492,855,3,1,3,0,1,0,57.54
高雄縣,大寮鄉,中庄村,288,1,678,5,683,1161,3,1,3,0,1,0,58.83
高雄縣,大寮鄉,中庄村,289,1,565,4,569,932,3,1,3,0,1,0,61.05
高雄縣,大寮鄉,中庄村,290,1,681,3,684,1141,3,1,3,0,1,0,59.95
高雄縣,大寮鄉,中庄村,291,1,608,19,627,1016,3,1,3,0,1,0,61.71
高雄縣,大寮鄉,中庄村,292,1,628,0,628,1131,3,1,3,0,1,0,55.53
高雄縣,大寮鄉,後庄村,293,1,656,7,663,1104,3,1,3,0,1,0,60.05
高雄縣,大寮鄉,後庄村,294,1,608,6,614,1059,3,1,3,0,1,0,57.98
高雄縣,大寮鄉,後庄村,295,1,496,3,499,970,3,1,3,0,1,0,51.44
高雄縣,大寮鄉,後庄村,296,1,658,5,663,1255,3,1,3,0,1,0,52.83
高雄縣,大寮鄉,後庄村,297,1,550,4,554,954,3,1,3,0,1,0,58.07
高雄縣,大寮鄉,前庄村,298,1,567,3,570,907,3,1,3,0,1,0,62.84
高雄縣,大寮鄉,前庄村,299,1,597,14,611,1056,3,1,3,0,1,0,57.86
高雄縣,大寮鄉,中興村,300,1,921,8,929,1470,3,1,3,0,1,0,63.20
高雄縣,大寮鄉,中興村,301,1,719,3,722,1221,3,1,3,0,1,0,59.13
高雄縣,大寮鄉,中興村,302,1,659,7,666,1145,3,1,3,0,1,0,58.17
高雄縣,大寮鄉,中興村,303,1,617,3,620,971,3,1,3,0,1,0,63.85
高雄縣,大寮鄉,中興村,304,1,601,4,605,916,3,1,3,0,1,0,66.05
高雄縣,大寮鄉,忠義村,305,1,521,6,527,762,3,1,3,0,1,0,69.16
高雄縣,大寮鄉,忠義村,306,1,476,4,480,711,3,1,3,0,1,0,67.51
高雄縣,大寮鄉,光武村,307,1,284,5,289,473,3,1,3,0,1,0,61.10
高雄縣,大寮鄉,光武村,308,1,424,8,432,655,3,1,3,0,1,0,65.95
高雄縣,大寮鄉,復興村,309,1,296,5,301,470,3,1,3,0,1,0,64.04
高雄縣,大寮鄉,復興村,310,1,395,4,399,695,3,1,3,0,1,0,57.41
高雄縣,大寮鄉,翁園村,311,1,731,5,736,1174,3,1,3,0,1,0,62.69
高雄縣,大寮鄉,翁園村,312,1,525,1,526,866,3,1,3,0,1,0,60.74
高雄縣,大寮鄉,翁園村,313,1,532,12,544,890,3,1,3,0,1,0,61.12
高雄縣,大寮鄉,琉球村,314,1,473,3,476,842,3,1,3,0,1,0,56.53
高雄縣,大寮鄉,琉球村,315,1,603,8,611,1008,3,1,3,0,1,0,60.62
高雄縣,大寮鄉,琉球村,316,1,819,8,827,1259,3,1,3,0,1,0,65.69
高雄縣,大寮鄉,永芳村,317,1,538,3,541,977,3,1,3,0,1,0,55.37
高雄縣,大寮鄉,永芳村,318,1,557,6,563,950,3,1,3,0,1,0,59.26
高雄縣,大寮鄉,永芳村,319,1,559,4,563,1021,3,1,3,0,1,0,55.14
高雄縣,大寮鄉,永芳村,320,1,533,3,536,908,3,1,3,0,1,0,59.03
高雄縣,大寮鄉,永芳村,321,1,664,6,670,1158,3,1,3,0,1,0,57.86
高雄縣,大寮鄉,永芳村,322,1,588,6,594,996,3,1,3,0,1,0,59.64
高雄縣,大寮鄉,山頂村,323,1,537,6,543,910,3,1,3,0,1,0,59.67
高雄縣,大寮鄉,山頂村,324,1,638,5,643,1038,3,1,3,0,1,0,61.95
高雄縣,大寮鄉,山頂村,325,1,459,3,462,962,3,1,3,0,1,0,48.02
高雄縣,大寮鄉,山頂村,326,1,588,4,592,997,3,1,3,0,1,0,59.38
高雄縣,大寮鄉,山頂村,327,1,632,6,638,969,3,1,3,0,1,0,65.84
高雄縣,大寮鄉,山頂村,328,1,566,3,569,1014,3,1,3,0,1,0,56.11
高雄縣,大寮鄉,會社村,329,1,526,4,530,1002,3,1,3,0,1,0,52.89
高雄縣,大寮鄉,會社村,330,1,668,2,670,1074,3,1,3,0,1,0,62.38
高雄縣,大寮鄉,會社村,331,1,891,4,895,1590,3,1,3,0,1,0,56.29
高雄縣,大寮鄉,會社村,332,1,744,7,751,1188,3,1,3,0,1,0,63.22
高雄縣,大寮鄉,三隆村,333,1,840,5,845,1325,3,1,3,0,1,0,63.77
高雄縣,大寮鄉,三隆村,334,1,813,6,819,1388,3,1,3,0,1,0,59.01
高雄縣,大寮鄉,三隆村,335,1,753,3,756,1278,3,1,3,0,1,0,59.15
高雄縣,大寮鄉,上寮村,336,1,652,5,657,1107,3,1,3,0,1,0,59.35
高雄縣,大寮鄉,上寮村,337,1,617,2,619,980,3,1,3,0,1,0,63.16
高雄縣,大寮鄉,大寮村,338,1,607,4,611,1137,3,1,3,0,1,0,53.74
高雄縣,大寮鄉,大寮村,339,1,717,11,728,1263,3,1,3,0,1,0,57.64
高雄縣,大寮鄉,大寮村,340,1,596,7,603,1088,3,1,3,0,1,0,55.42
高雄縣,大寮鄉,大寮村,341,1,682,7,689,1197,3,1,3,0,1,0,57.56
高雄縣,大寮鄉,大寮村,342,1,526,5,531,952,3,1,3,0,1,0,55.78
高雄縣,大寮鄉,拷潭村,343,1,500,6,506,758,3,1,3,0,1,0,66.75
高雄縣,大寮鄉,拷潭村,344,1,339,1,340,582,3,1,3,0,1,0,58.42
高雄縣,大寮鄉,內坑村,345,1,619,10,629,1336,3,1,3,0,1,0,47.08
高雄縣,大寮鄉,內坑村,346,1,626,6,632,1072,3,1,3,0,1,0,58.96
高雄縣,大寮鄉,內坑村,347,1,537,4,541,1135,3,1,3,0,1,0,47.67
高雄縣,大寮鄉,內坑村,348,1,281,2,283,425,3,1,3,0,1,0,66.59
高雄縣,大寮鄉,新厝村,349,1,514,11,525,764,3,1,3,0,1,0,68.72
高雄縣,大寮鄉,新厝村,350,1,367,3,370,663,3,1,3,0,1,0,55.81
高雄縣,大寮鄉,過溪村,351,1,663,8,671,1098,3,1,3,0,1,0,61.11
高雄縣,大寮鄉,過溪村,352,1,453,7,460,702,3,1,3,0,1,0,65.53
高雄縣,大寮鄉,潮寮村,353,1,804,4,808,1253,3,1,3,0,1,0,64.49
高雄縣,大寮鄉,潮寮村,354,1,887,15,902,1306,3,1,3,0,1,0,69.07
高雄縣,大寮鄉,會結村,355,1,847,7,854,1269,3,1,3,0,1,0,67.30
高雄縣,大寮鄉,昭明村,356,1,642,5,647,1106,3,1,3,0,1,0,58.50
高雄縣,大寮鄉,昭明村,357,1,558,3,561,949,3,1,3,0,1,0,59.11
高雄縣,大寮鄉,昭明村,358,1,504,2,506,966,3,1,3,0,1,0,52.38
高雄縣,大寮鄉,義仁村,359,1,616,1,617,1011,3,1,3,0,1,0,61.03
高雄縣,大寮鄉,義仁村,360,1,469,7,476,793,3,1,3,0,1,0,60.03
高雄縣,大樹鄉,竹寮村,361,1,657,2,659,1052,3,1,3,0,1,0,62.64
高雄縣,大樹鄉,竹寮村,362,1,624,5,629,1100,3,1,3,0,1,0,57.18
高雄縣,大樹鄉,九曲村,363,1,904,3,907,1727,3,1,3,0,1,0,52.52
高雄縣,大樹鄉,九曲村,364,1,785,9,794,1240,3,1,3,0,1,0,64.03
高雄縣,大樹鄉,九曲村,365,1,663,3,666,1103,3,1,3,0,1,0,60.38
高雄縣,大樹鄉,久堂村,366,1,815,8,823,1307,3,1,3,0,1,0,62.97
高雄縣,大樹鄉,久堂村,367,1,713,5,718,1064,3,1,3,0,1,0,67.48
高雄縣,大樹鄉,久堂村,368,1,976,15,991,1510,3,1,3,0,1,0,65.63
高雄縣,大樹鄉,水安村,369,1,740,5,745,1091,3,1,3,0,1,0,68.29
高雄縣,大樹鄉,水安村,370,1,668,4,672,1080,3,1,3,0,1,0,62.22
高雄縣,大樹鄉,水寮村,371,1,723,8,731,1098,3,1,3,0,1,0,66.58
高雄縣,大樹鄉,水寮村,372,1,783,3,786,1180,3,1,3,0,1,0,66.61
高雄縣,大樹鄉,井腳村,373,1,530,5,535,766,3,1,3,0,1,0,69.84
高雄縣,大樹鄉,井腳村,374,1,486,8,494,742,3,1,3,0,1,0,66.58
高雄縣,大樹鄉,小坪村,375,1,799,11,810,1234,3,1,3,0,1,0,65.64
高雄縣,大樹鄉,龍目村,376,1,496,2,498,703,3,1,3,0,1,0,70.84
高雄縣,大樹鄉,龍目村,377,1,581,2,583,874,3,1,3,0,1,0,66.70
高雄縣,大樹鄉,大樹村,378,1,747,6,753,1134,3,1,3,0,1,0,66.40
高雄縣,大樹鄉,大樹村,379,1,743,4,747,1125,3,1,3,0,1,0,66.40
高雄縣,大樹鄉,檨腳村,380,1,738,2,740,1180,3,1,3,0,1,0,62.71
高雄縣,大樹鄉,檨腳村,381,1,595,3,598,981,3,1,3,0,1,0,60.96
高雄縣,大樹鄉,檨腳村,382,1,681,6,687,1104,3,1,3,0,1,0,62.23
高雄縣,大樹鄉,興山村,383,1,705,5,710,1088,3,1,3,0,1,0,65.26
高雄縣,大樹鄉,和山村,384,1,668,1,669,944,3,1,3,0,1,0,70.87
高雄縣,大樹鄉,姑山村,385,1,603,7,610,955,3,1,3,0,1,0,63.87
高雄縣,大樹鄉,三和村,386,1,518,5,523,814,3,1,3,0,1,0,64.25
高雄縣,大樹鄉,大坑村,387,1,862,1,863,1342,3,1,3,0,1,0,64.31
高雄縣,大樹鄉,溪埔村,388,1,507,0,507,773,3,1,3,0,1,0,65.59
高雄縣,大樹鄉,溪埔村,389,1,569,3,572,897,3,1,3,0,1,0,63.77
高雄縣,大樹鄉,興田村,390,1,618,7,625,989,3,1,3,0,1,0,63.20
高雄縣,大樹鄉,興田村,391,1,537,6,543,872,3,1,3,0,1,0,62.27
高雄縣,大樹鄉,統嶺村,392,1,433,6,439,611,3,1,3,0,1,0,71.85
高雄縣,大社鄉,嘉誠村,393,1,588,10,598,947,3,1,3,0,1,0,63.15
高雄縣,大社鄉,保社村,394,1,739,5,744,1090,3,1,3,0,1,0,68.26
高雄縣,大社鄉,保社村,395,1,522,5,527,886,3,1,3,0,1,0,59.48
高雄縣,大社鄉,大社村,396,1,590,6,596,995,3,1,3,0,1,0,59.90
高雄縣,大社鄉,大社村,397,1,551,4,555,976,3,1,3,0,1,0,56.86
高雄縣,大社鄉,大社村,398,1,673,4,677,1062,3,1,3,0,1,0,63.75
高雄縣,大社鄉,大社村,399,1,645,7,652,1072,3,1,3,0,1,0,60.82
高雄縣,大社鄉,保安村,400,1,731,8,739,1186,3,1,3,0,1,0,62.31
高雄縣,大社鄉,保安村,401,1,797,4,801,1323,3,1,3,0,1,0,60.54
高雄縣,大社鄉,三奶村,402,1,935,5,940,1469,3,1,3,0,1,0,63.99
高雄縣,大社鄉,三奶村,403,1,606,2,608,1012,3,1,3,0,1,0,60.08
高雄縣,大社鄉,觀音村,404,1,617,4,621,900,3,1,3,0,1,0,69.00
高雄縣,大社鄉,觀音村,405,1,867,9,876,1413,3,1,3,0,1,0,62.00
高雄縣,大社鄉,觀音村,406,1,713,12,725,1120,3,1,3,0,1,0,64.73
高雄縣,大社鄉,觀音村,407,1,649,1,650,1104,3,1,3,0,1,0,58.88
高雄縣,大社鄉,神農村,408,1,686,7,693,1216,3,1,3,0,1,0,56.99
高雄縣,大社鄉,神農村,409,1,707,13,720,1172,3,1,3,0,1,0,61.43
高雄縣,大社鄉,神農村,410,1,716,5,721,1130,3,1,3,0,1,0,63.81
高雄縣,大社鄉,中里村,411,1,890,5,895,1369,3,1,3,0,1,0,65.38
高雄縣,大社鄉,中里村,412,1,772,10,782,1295,3,1,3,0,1,0,60.39
高雄縣,大社鄉,翠屏村,413,1,887,7,894,1440,3,1,3,0,1,0,62.08
高雄縣,仁武鄉,仁武村,414,1,865,9,874,1486,3,1,3,0,1,0,58.82
高雄縣,仁武鄉,仁武村,415,1,775,9,784,1291,3,1,3,0,1,0,60.73
高雄縣,仁武鄉,仁武村,416,1,929,10,939,1457,3,1,3,0,1,0,64.45
高雄縣,仁武鄉,文武村,417,1,752,8,760,1154,3,1,3,0,1,0,65.86
高雄縣,仁武鄉,文武村,418,1,718,8,726,1183,3,1,3,0,1,0,61.37
高雄縣,仁武鄉,文武村,419,1,798,3,801,1391,3,1,3,0,1,0,57.58
高雄縣,仁武鄉,文武村,420,1,858,5,863,1671,3,1,3,0,1,0,51.65
高雄縣,仁武鄉,後安村,421,1,599,3,602,1000,3,1,3,0,1,0,60.20
高雄縣,仁武鄉,後安村,422,1,640,11,651,1104,3,1,3,0,1,0,58.97
高雄縣,仁武鄉,竹後村,423,1,712,7,719,1089,3,1,3,0,1,0,66.02
高雄縣,仁武鄉,竹後村,424,1,669,6,675,1077,3,1,3,0,1,0,62.67
高雄縣,仁武鄉,中華村,425,1,795,8,803,1328,3,1,3,0,1,0,60.47
高雄縣,仁武鄉,八卦村,426,1,717,12,729,1172,3,1,3,0,1,0,62.20
高雄縣,仁武鄉,八卦村,427,1,658,4,662,1173,3,1,3,0,1,0,56.44
高雄縣,仁武鄉,八卦村,428,1,537,4,541,1190,3,1,3,0,1,0,45.46
高雄縣,仁武鄉,八卦村,429,1,934,11,945,1717,3,1,3,0,1,0,55.04
高雄縣,仁武鄉,八卦村,430,1,890,4,894,1930,3,1,3,0,1,0,46.32
高雄縣,仁武鄉,五和村,431,1,681,3,684,1216,3,1,3,0,1,0,56.25
高雄縣,仁武鄉,五和村,432,1,632,5,637,1106,3,1,3,0,1,0,57.59
高雄縣,仁武鄉,高楠村,433,1,557,8,565,881,3,1,3,0,1,0,64.13
高雄縣,仁武鄉,高楠村,434,1,574,13,587,814,3,1,3,0,1,0,72.11
高雄縣,仁武鄉,大灣村,435,1,734,2,736,1216,3,1,3,0,1,0,60.53
高雄縣,仁武鄉,大灣村,436,1,406,4,410,792,3,1,3,0,1,0,51.77
高雄縣,仁武鄉,赤山村,437,1,669,6,675,1175,3,1,3,0,1,0,57.45
高雄縣,仁武鄉,赤山村,438,1,809,2,811,1462,3,1,3,0,1,0,55.47
高雄縣,仁武鄉,仁和村,439,1,693,2,695,1122,3,1,3,0,1,0,61.94
高雄縣,仁武鄉,仁和村,440,1,531,2,533,966,3,1,3,0,1,0,55.18
高雄縣,仁武鄉,灣內村,441,1,907,8,915,1584,3,1,3,0,1,0,57.77
高雄縣,仁武鄉,灣內村,442,1,869,8,877,1556,3,1,3,0,1,0,56.36
高雄縣,仁武鄉,仁慈村,443,1,813,10,823,1316,3,1,3,0,1,0,62.54
高雄縣,仁武鄉,考潭村,444,1,837,14,851,1494,3,1,3,0,1,0,56.96
高雄縣,仁武鄉,考潭村,445,1,590,3,593,868,3,1,3,0,1,0,68.32
高雄縣,仁武鄉,烏林村,446,1,838,12,850,1300,3,1,3,0,1,0,65.38
高雄縣,仁武鄉,烏林村,447,1,297,2,299,465,3,1,3,0,1,0,64.30
高雄縣,仁武鄉,烏林村,448,1,684,7,691,1168,3,1,3,0,1,0,59.16
高雄縣,仁武鄉,仁福村,449,1,400,1,401,614,3,1,3,0,1,0,65.31
高雄縣,鳥松鄉,鳥松村,450,1,983,9,992,1647,3,1,3,0,1,0,60.23
高雄縣,鳥松鄉,鳥松村,451,1,940,3,943,1498,3,1,3,0,1,0,62.95
高雄縣,鳥松鄉,鳥松村,452,1,749,7,756,1747,3,1,3,0,1,0,43.27
高雄縣,鳥松鄉,鳥松村,453,1,864,3,867,1612,3,1,3,0,1,0,53.78
高雄縣,鳥松鄉,鳥松村,454,1,879,8,887,1439,3,1,3,0,1,0,61.64
高雄縣,鳥松鄉,夢裡村,455,1,825,6,831,1224,3,1,3,0,1,0,67.89
高雄縣,鳥松鄉,夢裡村,456,1,946,7,953,1615,3,1,3,0,1,0,59.01
高雄縣,鳥松鄉,大華村,457,1,927,5,932,1485,3,1,3,0,1,0,62.76
高雄縣,鳥松鄉,大華村,458,1,916,9,925,1552,3,1,3,0,1,0,59.60
高雄縣,鳥松鄉,大華村,459,1,847,4,851,1476,3,1,3,0,1,0,57.66
高雄縣,鳥松鄉,大華村,460,1,881,4,885,1665,3,1,3,0,1,0,53.15
高雄縣,鳥松鄉,大華村,461,1,848,4,852,1401,3,1,3,0,1,0,60.81
高雄縣,鳥松鄉,濫埔村,462,1,934,11,945,1416,3,1,3,0,1,0,66.74
高雄縣,鳥松鄉,濫埔村,463,1,932,5,937,1504,3,1,3,0,1,0,62.30
高雄縣,鳥松鄉,仁美村,464,1,787,5,792,1256,3,1,3,0,1,0,63.06
高雄縣,鳥松鄉,仁美村,465,1,865,8,873,1241,3,1,3,0,1,0,70.35
高雄縣,鳥松鄉,仁美村,466,1,982,4,986,1675,3,1,3,0,1,0,58.87
高雄縣,鳥松鄉,仁美村,467,1,826,11,837,1451,3,1,3,0,1,0,57.68
高雄縣,鳥松鄉,華美村,468,1,979,14,993,1584,3,1,3,0,1,0,62.69
高雄縣,鳥松鄉,華美村,469,1,954,15,969,1656,3,1,3,0,1,0,58.51
高雄縣,鳥松鄉,大竹村,470,1,485,6,491,690,3,1,3,0,1,0,71.16
高雄縣,岡山鎮,岡山里,471,1,804,7,811,1371,3,1,3,0,1,0,59.15
高雄縣,岡山鎮,岡山里,472,1,656,4,660,1202,3,1,3,0,1,0,54.91
高雄縣,岡山鎮,岡山里,473,1,604,9,613,1211,3,1,3,0,1,0,50.62
高雄縣,岡山鎮,平安里,474,1,727,5,732,1207,3,1,3,0,1,0,60.65
高雄縣,岡山鎮,壽天里,475,1,799,5,804,1325,3,1,3,0,1,0,60.68
高雄縣,岡山鎮,壽天里,476,1,691,4,695,1180,3,1,3,0,1,0,58.90
高雄縣,岡山鎮,壽天里,477,1,387,1,388,642,3,1,3,0,1,0,60.44
高雄縣,岡山鎮,維仁里,478,1,337,2,339,565,3,1,3,0,1,0,60.00
高雄縣,岡山鎮,維仁里,479,1,357,3,360,592,3,1,3,0,1,0,60.81
高雄縣,岡山鎮,灣裡里,480,1,961,3,964,1440,3,1,3,0,1,0,66.94
高雄縣,岡山鎮,大遼里,481,1,824,8,832,1244,3,1,3,0,1,0,66.88
高雄縣,岡山鎮,後紅里,482,1,750,9,759,1230,3,1,3,0,1,0,61.71
高雄縣,岡山鎮,後紅里,483,1,512,4,516,917,3,1,3,0,1,0,56.27
高雄縣,岡山鎮,後紅里,484,1,419,3,422,865,3,1,3,0,1,0,48.79
高雄縣,岡山鎮,碧紅里,485,1,898,8,906,1573,3,1,3,0,1,0,57.60
高雄縣,岡山鎮,碧紅里,486,1,780,5,785,1398,3,1,3,0,1,0,56.15
高雄縣,岡山鎮,程香里,487,1,943,7,950,1560,3,1,3,0,1,0,60.90
高雄縣,岡山鎮,程香里,488,1,867,9,876,1515,3,1,3,0,1,0,57.82
高雄縣,岡山鎮,竹圍里,489,1,848,5,853,1529,3,1,3,0,1,0,55.79
高雄縣,岡山鎮,竹圍里,490,1,941,3,944,1579,3,1,3,0,1,0,59.78
高雄縣,岡山鎮,竹圍里,491,1,820,8,828,1403,3,1,3,0,1,0,59.02
高雄縣,岡山鎮,臺上里,492,1,710,8,718,1259,3,1,3,0,1,0,57.03
高雄縣,岡山鎮,臺上里,493,1,645,7,652,1098,3,1,3,0,1,0,59.38
高雄縣,岡山鎮,臺上里,494,1,864,7,871,1437,3,1,3,0,1,0,60.61
高雄縣,岡山鎮,為隨里,495,1,416,4,420,588,3,1,3,0,1,0,71.43
高雄縣,岡山鎮,前峰里,496,1,745,7,752,1137,3,1,3,0,1,0,66.14
高雄縣,岡山鎮,前峰里,497,1,804,6,810,1299,3,1,3,0,1,0,62.36
高雄縣,岡山鎮,壽峰里,498,1,620,3,623,1063,3,1,3,0,1,0,58.61
高雄縣,岡山鎮,壽峰里,499,1,612,4,616,915,3,1,3,0,1,0,67.32
高雄縣,岡山鎮,仁壽里,500,1,650,6,656,1047,3,1,3,0,1,0,62.66
高雄縣,岡山鎮,仁壽里,501,1,604,5,609,948,3,1,3,0,1,0,64.24
高雄縣,岡山鎮,仁壽里,502,1,765,4,769,1265,3,1,3,0,1,0,60.79
高雄縣,岡山鎮,協和里,503,1,783,5,788,1328,3,1,3,0,1,0,59.34
高雄縣,岡山鎮,協和里,504,1,888,3,891,1416,3,1,3,0,1,0,62.92
高雄縣,岡山鎮,協和里,505,1,343,0,343,498,3,1,3,0,1,0,68.88
高雄縣,岡山鎮,本洲里,506,1,993,14,1007,1470,3,1,3,0,1,0,68.50
高雄縣,岡山鎮,後協里,507,1,621,5,626,1116,3,1,3,0,1,0,56.09
高雄縣,岡山鎮,後協里,508,1,705,7,712,1083,3,1,3,0,1,0,65.74
高雄縣,岡山鎮,後協里,509,1,648,7,655,1105,3,1,3,0,1,0,59.28
高雄縣,岡山鎮,後協里,510,1,786,6,792,1437,3,1,3,0,1,0,55.11
高雄縣,岡山鎮,協榮里,511,1,702,8,710,1167,3,1,3,0,1,0,60.84
高雄縣,岡山鎮,協榮里,512,1,477,3,480,788,3,1,3,0,1,0,60.91
高雄縣,岡山鎮,劉厝里,513,1,837,5,842,1321,3,1,3,0,1,0,63.74
高雄縣,岡山鎮,白米里,514,1,783,6,789,1306,3,1,3,0,1,0,60.41
高雄縣,岡山鎮,石潭里,515,1,865,6,871,1277,3,1,3,0,1,0,68.21
高雄縣,岡山鎮,福興里,516,1,697,4,701,994,3,1,3,0,1,0,70.52
高雄縣,岡山鎮,嘉興里,517,1,689,4,693,1079,3,1,3,0,1,0,64.23
高雄縣,岡山鎮,嘉興里,518,1,609,3,612,987,3,1,3,0,1,0,62.01
高雄縣,岡山鎮,嘉興里,519,1,712,7,719,1122,3,1,3,0,1,0,64.08
高雄縣,岡山鎮,嘉峰里,520,1,905,7,912,1338,3,1,3,0,1,0,68.16
高雄縣,岡山鎮,嘉峰里,521,1,238,1,239,302,3,1,3,0,1,0,79.14
高雄縣,岡山鎮,潭底里,522,1,523,9,532,731,3,1,3,0,1,0,72.78
高雄縣,岡山鎮,華崗里,523,1,984,16,1000,1374,3,1,3,0,1,0,72.78
高雄縣,岡山鎮,三和里,524,1,510,7,517,790,3,1,3,0,1,0,65.44
高雄縣,岡山鎮,大莊里,525,1,527,7,534,849,3,1,3,0,1,0,62.90
高雄縣,岡山鎮,忠孝里,526,1,277,2,279,419,3,1,3,0,1,0,66.59
高雄縣,岡山鎮,和平里,527,1,580,4,584,915,3,1,3,0,1,0,63.83
高雄縣,岡山鎮,信義里,528,1,604,8,612,917,3,1,3,0,1,0,66.74
高雄縣,岡山鎮,信義里,529,1,744,0,744,1183,3,1,3,0,1,0,62.89
高雄縣,岡山鎮,仁愛里,530,1,378,1,379,572,3,1,3,0,1,0,66.26
高雄縣,岡山鎮,仁愛里,531,1,500,2,502,732,3,1,3,0,1,0,68.58
高雄縣,岡山鎮,四維里,532,1,369,1,370,507,3,1,3,0,1,0,72.98
高雄縣,岡山鎮,四維里,533,1,424,7,431,615,3,1,3,0,1,0,70.08
高雄縣,岡山鎮,復興里,534,1,254,4,258,425,3,1,3,0,1,0,60.71
高雄縣,橋頭鄉,橋頭村,535,1,650,8,658,1032,3,1,3,0,1,0,63.76
高雄縣,橋頭鄉,橋頭村,536,1,448,3,451,732,3,1,3,0,1,0,61.61
高雄縣,橋頭鄉,橋南村,537,1,750,7,757,1134,3,1,3,0,1,0,66.75
高雄縣,橋頭鄉,仕隆村,538,1,668,8,676,1006,3,1,3,0,1,0,67.20
高雄縣,橋頭鄉,仕隆村,539,1,699,12,711,1105,3,1,3,0,1,0,64.34
高雄縣,橋頭鄉,仕豐村,540,1,671,7,678,1051,3,1,3,0,1,0,64.51
高雄縣,橋頭鄉,仕豐村,541,1,674,4,678,1125,3,1,3,0,1,0,60.27
高雄縣,橋頭鄉,仕和村,542,1,741,7,748,1156,3,1,3,0,1,0,64.71
高雄縣,橋頭鄉,仕和村,543,1,724,5,729,1128,3,1,3,0,1,0,64.63
高雄縣,橋頭鄉,仕和村,544,1,661,1,662,998,3,1,3,0,1,0,66.33
高雄縣,橋頭鄉,新莊村,545,1,533,5,538,777,3,1,3,0,1,0,69.24
高雄縣,橋頭鄉,新莊村,546,1,203,2,205,308,3,1,3,0,1,0,66.56
高雄縣,橋頭鄉,新莊村,547,1,134,1,135,181,3,1,3,0,1,0,74.59
高雄縣,橋頭鄉,甲北村,548,1,737,8,745,1109,3,1,3,0,1,0,67.18
高雄縣,橋頭鄉,甲北村,549,1,472,12,484,841,3,1,3,0,1,0,57.55
高雄縣,橋頭鄉,甲南村,550,1,681,3,684,1098,3,1,3,0,1,0,62.30
高雄縣,橋頭鄉,甲南村,551,1,657,6,663,1034,3,1,3,0,1,0,64.12
高雄縣,橋頭鄉,頂鹽村,552,1,687,15,702,1055,3,1,3,0,1,0,66.54
高雄縣,橋頭鄉,白樹村,553,1,580,4,584,1099,3,1,3,0,1,0,53.14
高雄縣,橋頭鄉,白樹村,554,1,680,5,685,1170,3,1,3,0,1,0,58.55
高雄縣,橋頭鄉,白樹村,555,1,341,3,344,458,3,1,3,0,1,0,75.11
高雄縣,橋頭鄉,芋寮村,556,1,819,3,822,1146,3,1,3,0,1,0,71.73
高雄縣,橋頭鄉,三德村,557,1,451,3,454,739,3,1,3,0,1,0,61.43
高雄縣,橋頭鄉,西林村,558,1,491,2,493,722,3,1,3,0,1,0,68.28
高雄縣,橋頭鄉,西林村,559,1,483,2,485,732,3,1,3,0,1,0,66.26
高雄縣,橋頭鄉,東林村,560,1,636,8,644,1058,3,1,3,0,1,0,60.87
高雄縣,橋頭鄉,東林村,561,1,715,4,719,1087,3,1,3,0,1,0,66.15
高雄縣,橋頭鄉,德松村,562,1,687,6,693,1068,3,1,3,0,1,0,64.89
高雄縣,橋頭鄉,筆秀村,563,1,404,3,407,586,3,1,3,0,1,0,69.45
高雄縣,橋頭鄉,筆秀村,564,1,645,4,649,902,3,1,3,0,1,0,71.95
高雄縣,橋頭鄉,中崎村,565,1,424,2,426,646,3,1,3,0,1,0,65.94
高雄縣,燕巢鄉,金山村,566,1,296,1,297,429,3,1,3,0,1,0,69.23
高雄縣,燕巢鄉,尖山村,567,1,725,12,737,1113,3,1,3,0,1,0,66.22
高雄縣,燕巢鄉,東燕村,568,1,901,19,920,1337,3,1,3,0,1,0,68.81
高雄縣,燕巢鄉,東燕村,569,1,609,7,616,882,3,1,3,0,1,0,69.84
高雄縣,燕巢鄉,西燕村,570,1,690,6,696,1060,3,1,3,0,1,0,65.66
高雄縣,燕巢鄉,西燕村,571,1,591,5,596,935,3,1,3,0,1,0,63.74
高雄縣,燕巢鄉,西燕村,572,1,669,4,673,1069,3,1,3,0,1,0,62.96
高雄縣,燕巢鄉,南燕村,573,1,873,4,877,1360,3,1,3,0,1,0,64.49
高雄縣,燕巢鄉,南燕村,574,1,926,8,934,1411,3,1,3,0,1,0,66.19
高雄縣,燕巢鄉,瓊林村,575,1,507,2,509,809,3,1,3,0,1,0,62.92
高雄縣,燕巢鄉,瓊林村,576,1,699,6,705,1008,3,1,3,0,1,0,69.94
高雄縣,燕巢鄉,安招村,577,1,893,4,897,1418,3,1,3,0,1,0,63.26
高雄縣,燕巢鄉,安招村,578,1,878,8,886,1391,3,1,3,0,1,0,63.70
高雄縣,燕巢鄉,安招村,579,1,284,7,291,504,3,1,3,0,1,0,57.74
高雄縣,燕巢鄉,安招村,580,1,274,7,281,540,3,1,3,0,1,0,52.04
高雄縣,燕巢鄉,角宿村,581,1,583,3,586,890,3,1,3,0,1,0,65.84
高雄縣,燕巢鄉,角宿村,582,1,365,1,366,565,3,1,3,0,1,0,64.78
高雄縣,燕巢鄉,角宿村,583,1,468,6,474,808,3,1,3,0,1,0,58.66
高雄縣,燕巢鄉,鳳雄村,584,1,667,8,675,1061,3,1,3,0,1,0,63.62
高雄縣,燕巢鄉,鳳雄村,585,1,772,8,780,1232,3,1,3,0,1,0,63.31
高雄縣,燕巢鄉,橫山村,586,1,562,2,564,945,3,1,3,0,1,0,59.68
高雄縣,燕巢鄉,橫山村,587,1,458,8,466,840,3,1,3,0,1,0,55.48
高雄縣,燕巢鄉,深水村,588,1,802,11,813,1242,3,1,3,0,1,0,65.46
高雄縣,燕巢鄉,深水村,589,1,690,5,695,1139,3,1,3,0,1,0,61.02
高雄縣,田寮鄉,鹿埔村,590,1,275,0,275,365,3,1,3,0,1,0,75.34
高雄縣,田寮鄉,古亭村,591,1,383,6,389,648,3,1,3,0,1,0,60.03
高雄縣,田寮鄉,崇德村,592,1,685,3,688,945,3,1,3,0,1,0,72.80
高雄縣,田寮鄉,三和村,593,1,288,1,289,418,3,1,3,0,1,0,69.14
高雄縣,田寮鄉,西德村,594,1,564,6,570,892,3,1,3,0,1,0,63.90
高雄縣,田寮鄉,南安村,595,1,498,5,503,776,3,1,3,0,1,0,64.82
高雄縣,田寮鄉,南安村,596,1,379,4,383,540,3,1,3,0,1,0,70.93
高雄縣,田寮鄉,大同村,597,1,261,3,264,414,3,1,3,0,1,0,63.77
高雄縣,田寮鄉,田寮村,598,1,285,3,288,420,3,1,3,0,1,0,68.57
高雄縣,田寮鄉,七星村,599,1,572,6,578,842,3,1,3,0,1,0,68.65
高雄縣,田寮鄉,新興村,600,1,895,6,901,1296,3,1,3,0,1,0,69.52
高雄縣,阿蓮鄉,阿蓮村,601,1,632,7,639,1024,3,1,3,0,1,0,62.40
高雄縣,阿蓮鄉,阿蓮村,602,1,656,3,659,1104,3,1,3,0,1,0,59.69
高雄縣,阿蓮鄉,阿蓮村,603,1,636,3,639,1102,3,1,3,0,1,0,57.99
高雄縣,阿蓮鄉,阿蓮村,604,1,565,6,571,995,3,1,3,0,1,0,57.39
高雄縣,阿蓮鄉,南蓮村,605,1,920,4,924,1457,3,1,3,0,1,0,63.42
高雄縣,阿蓮鄉,南蓮村,606,1,753,4,757,1248,3,1,3,0,1,0,60.66
高雄縣,阿蓮鄉,清蓮村,607,1,847,15,862,1455,3,1,3,0,1,0,59.24
高雄縣,阿蓮鄉,清蓮村,608,1,640,4,644,1104,3,1,3,0,1,0,58.33
高雄縣,阿蓮鄉,和蓮村,609,1,574,8,582,940,3,1,3,0,1,0,61.91
高雄縣,阿蓮鄉,和蓮村,610,1,613,7,620,1113,3,1,3,0,1,0,55.71
高雄縣,阿蓮鄉,青旗村,611,1,766,4,770,1331,3,1,3,0,1,0,57.85
高雄縣,阿蓮鄉,石安村,612,1,736,6,742,1294,3,1,3,0,1,0,57.34
高雄縣,阿蓮鄉,中路村,613,1,611,8,619,1006,3,1,3,0,1,0,61.53
高雄縣,阿蓮鄉,中路村,614,1,541,7,548,927,3,1,3,0,1,0,59.12
高雄縣,阿蓮鄉,峰山村,615,1,691,9,700,1123,3,1,3,0,1,0,62.33
高雄縣,阿蓮鄉,港後村,616,1,822,17,839,1346,3,1,3,0,1,0,62.33
高雄縣,阿蓮鄉,港後村,617,1,310,3,313,511,3,1,3,0,1,0,61.25
高雄縣,阿蓮鄉,崗山村,618,1,441,5,446,725,3,1,3,0,1,0,61.52
高雄縣,阿蓮鄉,復安村,619,1,506,7,513,825,3,1,3,0,1,0,62.18
高雄縣,阿蓮鄉,復安村,620,1,465,8,473,762,3,1,3,0,1,0,62.07
高雄縣,阿蓮鄉,玉庫村,621,1,596,6,602,979,3,1,3,0,1,0,61.49
高雄縣,路竹鄉,竹園村,622,1,537,6,543,796,3,1,3,0,1,0,68.22
高雄縣,路竹鄉,竹園村,623,1,583,4,587,918,3,1,3,0,1,0,63.94
高雄縣,路竹鄉,下坑村,624,1,784,7,791,1223,3,1,3,0,1,0,64.68
高雄縣,路竹鄉,下坑村,625,1,782,8,790,1291,3,1,3,0,1,0,61.19
高雄縣,路竹鄉,甲南村,626,1,615,8,623,954,3,1,3,0,1,0,65.30
高雄縣,路竹鄉,甲南村,627,1,602,10,612,921,3,1,3,0,1,0,66.45
高雄縣,路竹鄉,甲南村,628,1,646,49,695,1061,3,1,3,0,1,0,65.50
高雄縣,路竹鄉,甲北村,629,1,541,4,545,931,3,1,3,0,1,0,58.54
高雄縣,路竹鄉,甲北村,630,1,680,8,688,1020,3,1,3,0,1,0,67.45
高雄縣,路竹鄉,社東村,631,1,465,4,469,782,3,1,3,0,1,0,59.97
高雄縣,路竹鄉,社東村,632,1,520,4,524,790,3,1,3,0,1,0,66.33
高雄縣,路竹鄉,社中村,633,1,596,4,600,891,3,1,3,0,1,0,67.34
高雄縣,路竹鄉,社西村,634,1,680,9,689,1052,3,1,3,0,1,0,65.49
高雄縣,路竹鄉,社西村,635,1,723,7,730,1146,3,1,3,0,1,0,63.70
高雄縣,路竹鄉,社南村,636,1,684,14,698,1114,3,1,3,0,1,0,62.66
高雄縣,路竹鄉,社南村,637,1,721,1,722,1176,3,1,3,0,1,0,61.39
高雄縣,路竹鄉,社南村,638,1,744,7,751,1276,3,1,3,0,1,0,58.86
高雄縣,路竹鄉,竹東村,639,1,923,8,931,1534,3,1,3,0,1,0,60.69
高雄縣,路竹鄉,竹東村,640,1,854,7,861,1368,3,1,3,0,1,0,62.94
高雄縣,路竹鄉,竹南村,641,1,908,10,918,1485,3,1,3,0,1,0,61.82
高雄縣,路竹鄉,竹南村,642,1,735,11,746,1202,3,1,3,0,1,0,62.06
高雄縣,路竹鄉,竹西村,643,1,705,11,716,1049,3,1,3,0,1,0,68.26
高雄縣,路竹鄉,竹西村,644,1,737,9,746,1141,3,1,3,0,1,0,65.38
高雄縣,路竹鄉,文南村,645,1,698,7,705,1093,3,1,3,0,1,0,64.50
高雄縣,路竹鄉,文南村,646,1,677,7,684,1055,3,1,3,0,1,0,64.83
高雄縣,路竹鄉,文北村,647,1,814,8,822,1264,3,1,3,0,1,0,65.03
高雄縣,路竹鄉,文北村,648,1,926,9,935,1508,3,1,3,0,1,0,62.00
高雄縣,路竹鄉,竹滬村,649,1,760,4,764,1279,3,1,3,0,1,0,59.73
高雄縣,路竹鄉,竹滬村,650,1,777,13,790,1354,3,1,3,0,1,0,58.35
高雄縣,路竹鄉,頂寮村,651,1,687,3,690,1158,3,1,3,0,1,0,59.59
高雄縣,路竹鄉,新達村,652,1,774,15,789,1190,3,1,3,0,1,0,66.30
高雄縣,路竹鄉,後鄉村,653,1,626,10,636,933,3,1,3,0,1,0,68.17
高雄縣,路竹鄉,北嶺村,654,1,788,7,795,1105,3,1,3,0,1,0,71.95
高雄縣,路竹鄉,三爺村,655,1,644,11,655,879,3,1,3,0,1,0,74.52
高雄縣,路竹鄉,鴨寮村,656,1,985,6,991,1542,3,1,3,0,1,0,64.27
高雄縣,湖內鄉,大湖村,657,1,451,6,457,672,3,1,3,0,1,0,68.01
高雄縣,湖內鄉,大湖村,658,1,479,9,488,787,3,1,3,0,1,0,62.01
高雄縣,湖內鄉,大湖村,659,1,693,0,693,1106,3,1,3,0,1,0,62.66
高雄縣,湖內鄉,田尾村,660,1,645,5,650,1053,3,1,3,0,1,0,61.73
高雄縣,湖內鄉,湖內村,661,1,457,7,464,728,3,1,3,0,1,0,63.74
高雄縣,湖內鄉,湖內村,662,1,505,2,507,776,3,1,3,0,1,0,65.34
高雄縣,湖內鄉,湖內村,663,1,792,9,801,1272,3,1,3,0,1,0,62.97
高雄縣,湖內鄉,湖東村,664,1,644,8,652,1009,3,1,3,0,1,0,64.62
高雄縣,湖內鄉,湖東村,665,1,502,6,508,910,3,1,3,0,1,0,55.82
高雄縣,湖內鄉,海埔村,666,1,495,5,500,817,3,1,3,0,1,0,61.20
高雄縣,湖內鄉,海埔村,667,1,531,2,533,956,3,1,3,0,1,0,55.75
高雄縣,湖內鄉,海山村,668,1,740,7,747,1159,3,1,3,0,1,0,64.45
高雄縣,湖內鄉,劉家村,669,1,669,4,673,1065,3,1,3,0,1,0,63.19
高雄縣,湖內鄉,太爺村,670,1,480,3,483,828,3,1,3,0,1,0,58.33
高雄縣,湖內鄉,公館村,671,1,417,3,420,680,3,1,3,0,1,0,61.76
高雄縣,湖內鄉,公館村,672,1,581,6,587,1013,3,1,3,0,1,0,57.95
高雄縣,湖內鄉,葉厝村,673,1,558,6,564,892,3,1,3,0,1,0,63.23
高雄縣,湖內鄉,葉厝村,674,1,589,4,593,989,3,1,3,0,1,0,59.96
高雄縣,湖內鄉,文賢村,675,1,704,11,715,1179,3,1,3,0,1,0,60.64
高雄縣,湖內鄉,中賢村,676,1,558,2,560,894,3,1,3,0,1,0,62.64
高雄縣,湖內鄉,中賢村,677,1,660,5,665,1116,3,1,3,0,1,0,59.59
高雄縣,湖內鄉,逸賢村,678,1,563,10,573,997,3,1,3,0,1,0,57.47
高雄縣,湖內鄉,忠興村,679,1,494,5,499,753,3,1,3,0,1,0,66.27
高雄縣,茄萣鄉,福德村,680,1,684,4,688,1048,3,1,3,0,1,0,65.65
高雄縣,茄萣鄉,萬福村,681,1,560,2,562,894,3,1,3,0,1,0,62.86
高雄縣,茄萣鄉,白雲村,682,1,984,6,990,1605,3,1,3,0,1,0,61.68
高雄縣,茄萣鄉,嘉賜村,683,1,733,4,737,1372,3,1,3,0,1,0,53.72
高雄縣,茄萣鄉,嘉賜村,684,1,830,3,833,1461,3,1,3,0,1,0,57.02
高雄縣,茄萣鄉,嘉安村,685,1,824,9,833,1479,3,1,3,0,1,0,56.32
高雄縣,茄萣鄉,嘉樂村,686,1,1110,5,1115,1859,3,1,3,0,1,0,59.98
高雄縣,茄萣鄉,嘉泰村,687,1,713,4,717,1174,3,1,3,0,1,0,61.07
高雄縣,茄萣鄉,嘉福村,688,1,574,1,575,983,3,1,3,0,1,0,58.49
高雄縣,茄萣鄉,和協村,689,1,719,7,726,1197,3,1,3,0,1,0,60.65
高雄縣,茄萣鄉,嘉定村,690,1,755,7,762,1278,3,1,3,0,1,0,59.62
高雄縣,茄萣鄉,保定村,691,1,716,13,729,1247,3,1,3,0,1,0,58.46
高雄縣,茄萣鄉,保定村,692,1,973,11,984,1715,3,1,3,0,1,0,57.38
高雄縣,茄萣鄉,大定村,693,1,750,3,753,1190,3,1,3,0,1,0,63.28
高雄縣,茄萣鄉,光定村,694,1,641,10,651,1061,3,1,3,0,1,0,61.36
高雄縣,茄萣鄉,吉定村,695,1,743,19,762,1270,3,1,3,0,1,0,60.00
高雄縣,茄萣鄉,崎漏村,696,1,1018,6,1024,1715,3,1,3,0,1,0,59.71
高雄縣,茄萣鄉,崎漏村,697,1,933,9,942,1959,3,1,3,0,1,0,48.09
高雄縣,永安鄉,永安村,698,1,443,4,447,698,3,1,3,0,1,0,64.04
高雄縣,永安鄉,永安村,699,1,509,5,514,786,3,1,3,0,1,0,65.39
高雄縣,永安鄉,永華村,700,1,567,4,571,861,3,1,3,0,1,0,66.32
高雄縣,永安鄉,永華村,701,1,525,7,532,887,3,1,3,0,1,0,59.98
高雄縣,永安鄉,新港村,702,1,596,6,602,959,3,1,3,0,1,0,62.77
高雄縣,永安鄉,新港村,703,1,367,14,381,713,3,1,3,0,1,0,53.44
高雄縣,永安鄉,新港村,704,1,369,0,369,706,3,1,3,0,1,0,52.27
高雄縣,永安鄉,鹽田村,705,1,213,1,214,382,3,1,3,0,1,0,56.02
高雄縣,永安鄉,保寧村,706,1,749,13,762,1048,3,1,3,0,1,0,72.71
高雄縣,永安鄉,保寧村,707,1,570,6,576,983,3,1,3,0,1,0,58.60
高雄縣,永安鄉,維新村,708,1,824,7,831,1280,3,1,3,0,1,0,64.92
高雄縣,永安鄉,維新村,709,1,813,5,818,1366,3,1,3,0,1,0,59.88
高雄縣,彌陀鄉,舊港村,710,1,1063,9,1072,1514,3,1,3,0,1,0,70.81
高雄縣,彌陀鄉,文安村,711,1,1261,13,1274,1773,3,1,3,0,1,0,71.86
高雄縣,彌陀鄉,鹽埕村,712,1,1285,12,1297,1918,3,1,3,0,1,0,67.62
高雄縣,彌陀鄉,過港村,713,1,694,4,698,966,3,1,3,0,1,0,72.26
高雄縣,彌陀鄉,光和村,714,1,697,5,702,1083,3,1,3,0,1,0,64.82
高雄縣,彌陀鄉,彌靖村,715,1,1285,9,1294,1818,3,1,3,0,1,0,71.18
高雄縣,彌陀鄉,彌仁村,716,1,430,1,431,584,3,1,3,0,1,0,73.80
高雄縣,彌陀鄉,彌壽村,717,1,503,1,504,717,3,1,3,0,1,0,70.29
高雄縣,彌陀鄉,彌陀村,718,1,1058,8,1066,1555,3,1,3,0,1,0,68.55
高雄縣,彌陀鄉,海尾村,719,1,565,5,570,859,3,1,3,0,1,0,66.36
高雄縣,彌陀鄉,漯底村,720,1,756,14,770,1015,3,1,3,0,1,0,75.86
高雄縣,彌陀鄉,南寮村,721,1,854,11,865,1181,3,1,3,0,1,0,73.24
高雄縣,彌陀鄉,南寮村,722,1,574,6,580,850,3,1,3,0,1,0,68.24
高雄縣,梓官鄉,梓信村,723,1,624,3,627,1017,3,1,3,0,1,0,61.65
高雄縣,梓官鄉,梓信村,724,1,616,6,622,979,3,1,3,0,1,0,63.53
高雄縣,梓官鄉,梓義村,725,1,552,3,555,940,3,1,3,0,1,0,59.04
高雄縣,梓官鄉,梓義村,726,1,614,1,615,1042,3,1,3,0,1,0,59.02
高雄縣,梓官鄉,梓和村,727,1,498,4,502,826,3,1,3,0,1,0,60.77
高雄縣,梓官鄉,梓和村,728,1,433,2,435,650,3,1,3,0,1,0,66.92
高雄縣,梓官鄉,梓和村,729,1,475,3,478,782,3,1,3,0,1,0,61.13
高雄縣,梓官鄉,梓平村,730,1,794,1,795,1153,3,1,3,0,1,0,68.95
高雄縣,梓官鄉,中崙村,731,1,621,5,626,1046,3,1,3,0,1,0,59.85
高雄縣,梓官鄉,同安村,732,1,614,6,620,926,3,1,3,0,1,0,66.95
高雄縣,梓官鄉,大舍村,733,1,724,7,731,1153,3,1,3,0,1,0,63.40
高雄縣,梓官鄉,大舍村,734,1,709,7,716,1168,3,1,3,0,1,0,61.30
高雄縣,梓官鄉,大舍村,735,1,626,6,632,1096,3,1,3,0,1,0,57.66
高雄縣,梓官鄉,赤崁村,736,1,721,4,725,1135,3,1,3,0,1,0,63.88
高雄縣,梓官鄉,赤崁村,737,1,480,6,486,738,3,1,3,0,1,0,65.85
高雄縣,梓官鄉,赤東村,738,1,901,4,905,1359,3,1,3,0,1,0,66.59
高雄縣,梓官鄉,赤東村,739,1,574,8,582,963,3,1,3,0,1,0,60.44
高雄縣,梓官鄉,赤西村,740,1,412,3,415,694,3,1,3,0,1,0,59.80
高雄縣,梓官鄉,禮蚵村,741,1,668,1,669,1087,3,1,3,0,1,0,61.55
高雄縣,梓官鄉,禮蚵村,742,1,683,2,685,1183,3,1,3,0,1,0,57.90
高雄縣,梓官鄉,智蚵村,743,1,624,3,627,1113,3,1,3,0,1,0,56.33
高雄縣,梓官鄉,智蚵村,744,1,783,6,789,1352,3,1,3,0,1,0,58.36
高雄縣,梓官鄉,信蚵村,745,1,514,4,518,866,3,1,3,0,1,0,59.82
高雄縣,梓官鄉,信蚵村,746,1,445,5,450,855,3,1,3,0,1,0,52.63
高雄縣,梓官鄉,茄苳村,747,1,766,16,782,1159,3,1,3,0,1,0,67.47
高雄縣,梓官鄉,茄苳村,748,1,570,4,574,1013,3,1,3,0,1,0,56.66
高雄縣,梓官鄉,典寶村,749,1,729,6,735,1121,3,1,3,0,1,0,65.57
高雄縣,梓官鄉,典寶村,750,1,787,9,796,1342,3,1,3,0,1,0,59.31
高雄縣,旗山鎮,太平里,751,1,691,4,695,1145,3,1,3,0,1,0,60.70
高雄縣,旗山鎮,太平里,752,1,639,3,642,1132,3,1,3,0,1,0,56.71
高雄縣,旗山鎮,大德里,753,1,845,3,848,1299,3,1,3,0,1,0,65.28
高雄縣,旗山鎮,大德里,754,1,694,4,698,1118,3,1,3,0,1,0,62.43
高雄縣,旗山鎮,湄洲里,755,1,513,2,515,888,3,1,3,0,1,0,58.00
高雄縣,旗山鎮,鼓山里,756,1,389,3,392,583,3,1,3,0,1,0,67.24
高雄縣,旗山鎮,新山里,757,1,490,7,497,751,3,1,3,0,1,0,66.18
高雄縣,旗山鎮,和平里,758,1,457,5,462,749,3,1,3,0,1,0,61.68
高雄縣,旗山鎮,竹峰里,759,1,367,1,368,577,3,1,3,0,1,0,63.78
高雄縣,旗山鎮,瑞吉里,760,1,497,3,500,905,3,1,3,0,1,0,55.25
高雄縣,旗山鎮,瑞吉里,761,1,626,2,628,1040,3,1,3,0,1,0,60.38
高雄縣,旗山鎮,永和里,762,1,930,12,942,1615,3,1,3,0,1,0,58.33
高雄縣,旗山鎮,永和里,763,1,840,11,851,1424,3,1,3,0,1,0,59.76
高雄縣,旗山鎮,三協里,764,1,603,6,609,1046,3,1,3,0,1,0,58.22
高雄縣,旗山鎮,三協里,765,1,334,5,339,574,3,1,3,0,1,0,59.06
高雄縣,旗山鎮,三協里,766,1,180,1,181,281,3,1,3,0,1,0,64.41
高雄縣,旗山鎮,圓富里,767,1,602,9,611,1007,3,1,3,0,1,0,60.68
高雄縣,旗山鎮,圓富里,768,1,516,6,522,844,3,1,3,0,1,0,61.85
高雄縣,旗山鎮,中正里,769,1,712,8,720,1101,3,1,3,0,1,0,65.40
高雄縣,旗山鎮,中正里,770,1,311,3,314,435,3,1,3,0,1,0,72.18
高雄縣,旗山鎮,大林里,771,1,549,5,554,934,3,1,3,0,1,0,59.31
高雄縣,旗山鎮,大林里,772,1,309,3,312,519,3,1,3,0,1,0,60.12
高雄縣,旗山鎮,上洲里,773,1,660,7,667,1004,3,1,3,0,1,0,66.43
高雄縣,旗山鎮,鯤洲里,774,1,599,7,606,889,3,1,3,0,1,0,68.17
高雄縣,旗山鎮,大山里,775,1,880,7,887,1306,3,1,3,0,1,0,67.92
高雄縣,旗山鎮,中洲里,776,1,635,3,638,920,3,1,3,0,1,0,69.35
高雄縣,旗山鎮,南洲里,777,1,957,8,965,1358,3,1,3,0,1,0,71.06
高雄縣,旗山鎮,新光里,778,1,617,5,622,863,3,1,3,0,1,0,72.07
高雄縣,旗山鎮,南勝里,779,1,834,5,839,1230,3,1,3,0,1,0,68.21
高雄縣,旗山鎮,南勝里,780,1,726,2,728,1103,3,1,3,0,1,0,66.00
高雄縣,旗山鎮,東平里,781,1,529,6,535,924,3,1,3,0,1,0,57.90
高雄縣,旗山鎮,東平里,782,1,559,3,562,983,3,1,3,0,1,0,57.17
高雄縣,旗山鎮,東昌里,783,1,393,4,397,659,3,1,3,0,1,0,60.24
高雄縣,旗山鎮,糖廠里,784,1,246,2,248,379,3,1,3,0,1,0,65.44
高雄縣,旗山鎮,廣福里,785,1,425,5,430,640,3,1,3,0,1,0,67.19
高雄縣,旗山鎮,中寮里,786,1,136,1,137,206,3,1,3,0,1,0,66.50
高雄縣,美濃鎮,中圳里,787,1,546,3,549,917,3,1,3,0,1,0,59.87
高雄縣,美濃鎮,中圳里,788,1,551,8,559,919,3,1,3,0,1,0,60.83
高雄縣,美濃鎮,東門里,789,1,822,7,829,1361,3,1,3,0,1,0,60.91
高雄縣,美濃鎮,泰安里,790,1,914,3,917,1482,3,1,3,0,1,0,61.88
高雄縣,美濃鎮,合和里,791,1,547,9,556,947,3,1,3,0,1,0,58.71
高雄縣,美濃鎮,合和里,792,1,755,1,756,1307,3,1,3,0,1,0,57.84
高雄縣,美濃鎮,瀰濃里,793,1,710,4,714,1171,3,1,3,0,1,0,60.97
高雄縣,美濃鎮,瀰濃里,794,1,612,3,615,1000,3,1,3,0,1,0,61.50
高雄縣,美濃鎮,福安里,795,1,744,7,751,1171,3,1,3,0,1,0,64.13
高雄縣,美濃鎮,福安里,796,1,798,13,811,1351,3,1,3,0,1,0,60.03
高雄縣,美濃鎮,祿興里,797,1,766,6,772,1275,3,1,3,0,1,0,60.55
高雄縣,美濃鎮,祿興里,798,1,764,8,772,1232,3,1,3,0,1,0,62.66
高雄縣,美濃鎮,中壇里,799,1,636,3,639,1007,3,1,3,0,1,0,63.46
高雄縣,美濃鎮,中壇里,800,1,597,3,600,1010,3,1,3,0,1,0,59.41
高雄縣,美濃鎮,德興里,801,1,956,6,962,1478,3,1,3,0,1,0,65.09
高雄縣,美濃鎮,清水里,802,1,580,7,587,969,3,1,3,0,1,0,60.58
高雄縣,美濃鎮,清水里,803,1,469,4,473,735,3,1,3,0,1,0,64.35
高雄縣,美濃鎮,吉和里,804,1,868,6,874,1407,3,1,3,0,1,0,62.12
高雄縣,美濃鎮,吉洋里,805,1,600,11,611,978,3,1,3,0,1,0,62.47
高雄縣,美濃鎮,吉洋里,806,1,597,3,600,1014,3,1,3,0,1,0,59.17
高雄縣,美濃鎮,吉東里,807,1,522,2,524,844,3,1,3,0,1,0,62.09
高雄縣,美濃鎮,吉東里,808,1,513,6,519,848,3,1,3,0,1,0,61.20
高雄縣,美濃鎮,龍山里,809,1,593,3,596,1048,3,1,3,0,1,0,56.87
高雄縣,美濃鎮,龍肚里,810,1,676,10,686,1123,3,1,3,0,1,0,61.09
高雄縣,美濃鎮,獅山里,811,1,851,2,853,1359,3,1,3,0,1,0,62.77
高雄縣,美濃鎮,獅山里,812,1,668,3,671,1007,3,1,3,0,1,0,66.63
高雄縣,美濃鎮,龍肚里,813,1,504,1,505,756,3,1,3,0,1,0,66.80
高雄縣,美濃鎮,龍肚里,814,1,518,5,523,869,3,1,3,0,1,0,60.18
高雄縣,美濃鎮,廣德里,815,1,845,5,850,1387,3,1,3,0,1,0,61.28
高雄縣,美濃鎮,興隆里,816,1,742,3,745,1218,3,1,3,0,1,0,61.17
高雄縣,美濃鎮,廣林里,817,1,535,4,539,859,3,1,3,0,1,0,62.75
高雄縣,美濃鎮,廣林里,818,1,473,2,475,834,3,1,3,0,1,0,56.95
高雄縣,六龜鄉,六龜村,819,1,528,13,541,1043,3,1,3,0,1,0,51.87
高雄縣,六龜鄉,義寶村,820,1,745,9,754,1141,3,1,3,0,1,0,66.08
高雄縣,六龜鄉,文武村,821,1,746,11,757,1551,3,1,3,0,1,0,48.81
高雄縣,六龜鄉,中興村,822,1,728,3,731,1311,3,1,3,0,1,0,55.76
高雄縣,六龜鄉,興龍村,823,1,507,3,510,885,3,1,3,0,1,0,57.63
高雄縣,六龜鄉,新威村,824,1,470,6,476,808,3,1,3,0,1,0,58.91
高雄縣,六龜鄉,新興村,825,1,400,7,407,735,3,1,3,0,1,0,55.37
高雄縣,六龜鄉,新寮村,826,1,435,6,441,623,3,1,3,0,1,0,70.79
高雄縣,六龜鄉,大津村,827,1,207,3,210,344,3,1,3,0,1,0,61.05
高雄縣,六龜鄉,新發村,828,1,686,12,698,1352,3,1,3,0,1,0,51.63
高雄縣,六龜鄉,荖濃村,829,1,723,9,732,1496,3,1,3,0,1,0,48.93
高雄縣,六龜鄉,寶來村,830,1,655,4,659,1096,3,1,3,0,1,0,60.13
高雄縣,甲仙鄉,東安村,831,1,362,0,362,606,3,1,3,0,1,0,59.74
高雄縣,甲仙鄉,西安村,832,1,685,3,688,1042,3,1,3,0,1,0,66.03
高雄縣,甲仙鄉,和安村,833,1,530,4,534,833,3,1,3,0,1,0,64.11
高雄縣,甲仙鄉,大田村,834,1,980,8,988,1591,3,1,3,0,1,0,62.10
高雄縣,甲仙鄉,寶隆村,835,1,468,2,470,714,3,1,3,0,1,0,65.83
高雄縣,甲仙鄉,關山村,836,1,447,6,453,715,3,1,3,0,1,0,63.36
高雄縣,甲仙鄉,小林村,837,1,622,6,628,1126,3,1,3,0,1,0,55.77
高雄縣,杉林鄉,杉林村,838,1,433,0,433,750,3,1,3,0,1,0,57.73
高雄縣,杉林鄉,木梓村,839,1,371,4,375,773,3,1,3,0,1,0,48.51
高雄縣,杉林鄉,集來村,840,1,627,4,631,1098,3,1,3,0,1,0,57.47
高雄縣,杉林鄉,集來村,841,1,429,5,434,788,3,1,3,0,1,0,55.08
高雄縣,杉林鄉,新庄村,842,1,657,11,668,1126,3,1,3,0,1,0,59.33
高雄縣,杉林鄉,新庄村,843,1,370,6,376,612,3,1,3,0,1,0,61.44
高雄縣,杉林鄉,上平村,844,1,922,8,930,1506,3,1,3,0,1,0,61.75
高雄縣,杉林鄉,月眉村,845,1,1013,9,1022,1758,3,1,3,0,1,0,58.13
高雄縣,杉林鄉,月美村,846,1,738,9,747,1305,3,1,3,0,1,0,57.24
高雄縣,內門鄉,金竹村,847,1,467,2,469,787,3,1,3,0,1,0,59.59
高雄縣,內門鄉,溝坪村,848,1,567,7,574,1029,3,1,3,0,1,0,55.78
高雄縣,內門鄉,永興村,849,1,269,2,271,483,3,1,3,0,1,0,56.11
高雄縣,內門鄉,永吉村,850,1,289,1,290,465,3,1,3,0,1,0,62.37
高雄縣,內門鄉,永富村,851,1,600,9,609,1030,3,1,3,0,1,0,59.13
高雄縣,內門鄉,觀亭村,852,1,447,2,449,692,3,1,3,0,1,0,64.88
高雄縣,內門鄉,觀亭村,853,1,632,18,650,1055,3,1,3,0,1,0,61.61
高雄縣,內門鄉,中埔村,854,1,380,5,385,608,3,1,3,0,1,0,63.32
高雄縣,內門鄉,瑞山村,855,1,234,1,235,363,3,1,3,0,1,0,64.74
高雄縣,內門鄉,內南村,856,1,259,3,262,405,3,1,3,0,1,0,64.69
高雄縣,內門鄉,內東村,857,1,559,5,564,783,3,1,3,0,1,0,72.03
高雄縣,內門鄉,光興村,858,1,418,2,420,644,3,1,3,0,1,0,65.22
高雄縣,內門鄉,東埔村,859,1,334,2,336,497,3,1,3,0,1,0,67.61
高雄縣,內門鄉,內豊村,860,1,814,4,818,1158,3,1,3,0,1,0,70.64
高雄縣,內門鄉,內門村,861,1,663,1,664,981,3,1,3,0,1,0,67.69
高雄縣,內門鄉,石坑村,862,1,323,1,324,505,3,1,3,0,1,0,64.16
高雄縣,內門鄉,三平村,863,1,462,3,465,676,3,1,3,0,1,0,68.79
高雄縣,內門鄉,木柵村,864,1,457,3,460,693,3,1,3,0,1,0,66.38
高雄縣,內門鄉,內興村,865,1,419,8,427,622,3,1,3,0,1,0,68.65
高雄縣,茂林鄉,茂林村,866,1,23,0,23,58,3,1,3,0,1,0,39.66
高雄縣,茂林鄉,萬山村,867,1,11,0,11,23,3,1,3,0,1,0,47.83
高雄縣,茂林鄉,多納村,868,1,9,0,9,25,3,1,3,0,1,0,36.00
高雄縣,桃源鄉,寶山村,869,1,12,0,12,28,3,1,3,0,1,0,42.86
高雄縣,桃源鄉,寶山村,870,1,7,0,7,14,3,1,3,0,1,0,50.00
高雄縣,桃源鄉,建山村,871,1,43,0,43,86,3,1,3,0,1,0,50.00
高雄縣,桃源鄉,高中村,872,1,24,0,24,59,3,1,3,0,1,0,40.68
高雄縣,桃源鄉,桃源村,873,1,44,0,44,107,3,1,3,0,1,0,41.12
高雄縣,桃源鄉,勤和村,874,1,6,2,8,18,3,1,3,0,1,0,44.44
高雄縣,桃源鄉,復興村,875,1,8,0,8,15,3,1,3,0,1,0,53.33
高雄縣,桃源鄉,梅蘭村,876,1,4,0,4,10,3,1,3,0,1,0,40.00
高雄縣,桃源鄉,梅山村,877,1,11,0,11,19,3,1,3,0,1,0,57.89
高雄縣,三民鄉,民族村,878,1,61,0,61,187,3,1,3,0,1,0,32.62
高雄縣,三民鄉,民權村,879,1,14,1,15,45,3,1,3,0,1,0,33.33
高雄縣,三民鄉,民生村,880,1,55,1,56,98,3,1,3,0,1,0,57.14
屏東縣,屏東市,大同里、端正里、武廟里,1,1,946,2,948,1465,3,1,3,0,1,0,64.71
屏東縣,屏東市,民權里、光榮里,2,1,932,1,933,1470,3,1,3,0,1,0,63.47
屏東縣,屏東市,泰安里、文明里,3,1,668,5,673,1058,3,1,3,0,1,0,63.61
屏東縣,屏東市,維新里,4,1,880,4,884,1387,3,1,3,0,1,0,63.73
屏東縣,屏東市,維新里,5,1,822,5,827,1405,3,1,3,0,1,0,58.86
屏東縣,屏東市,大埔里、必信里,6,1,918,4,922,1456,3,1,3,0,1,0,63.32
屏東縣,屏東市,崇禮里、崇智里,7,1,558,0,558,845,3,1,3,0,1,0,66.04
屏東縣,屏東市,平和里、安樂里,8,1,923,5,928,1387,3,1,3,0,1,0,66.91
屏東縣,屏東市,楠樹里、扶風里,9,1,892,3,895,1391,3,1,3,0,1,0,64.34
屏東縣,屏東市,勝豐里、金泉里,10,1,762,3,765,1283,3,1,3,0,1,0,59.63
屏東縣,屏東市,橋南里,11,1,897,2,899,1560,3,1,3,0,1,0,57.63
屏東縣,屏東市,橋北里,12,1,574,5,579,909,3,1,3,0,1,0,63.70
屏東縣,屏東市,大連里,13,1,1038,5,1043,1676,3,1,3,0,1,0,62.23
屏東縣,屏東市,大連里,14,1,1114,7,1121,1850,3,1,3,0,1,0,60.59
屏東縣,屏東市,大連里,15,1,996,7,1003,1693,3,1,3,0,1,0,59.24
屏東縣,屏東市,大連里,16,1,1015,6,1021,1726,3,1,3,0,1,0,59.15
屏東縣,屏東市,大連里,17,1,1013,6,1019,1677,3,1,3,0,1,0,60.76
屏東縣,屏東市,豐田里,18,1,663,3,666,1086,3,1,3,0,1,0,61.33
屏東縣,屏東市,豐田里,19,1,846,2,848,1406,3,1,3,0,1,0,60.31
屏東縣,屏東市,豐田里,20,1,890,7,897,1428,3,1,3,0,1,0,62.82
屏東縣,屏東市,豐榮里,21,1,769,1,770,1191,3,1,3,0,1,0,64.65
屏東縣,屏東市,豐榮里,22,1,747,4,751,1205,3,1,3,0,1,0,62.32
屏東縣,屏東市,豐源里,23,1,743,4,747,1179,3,1,3,0,1,0,63.36
屏東縣,屏東市,豐源里,24,1,793,9,802,1273,3,1,3,0,1,0,63.00
屏東縣,屏東市,豐源里,25,1,761,3,764,1149,3,1,3,0,1,0,66.49
屏東縣,屏東市,長春里,26,1,643,2,645,1080,3,1,3,0,1,0,59.72
屏東縣,屏東市,長春里,27,1,574,1,575,968,3,1,3,0,1,0,59.40
屏東縣,屏東市,瑞光里,28,1,924,5,929,1604,3,1,3,0,1,0,57.92
屏東縣,屏東市,瑞光里,29,1,964,18,982,1647,3,1,3,0,1,0,59.62
屏東縣,屏東市,瑞光里,30,1,932,8,940,1589,3,1,3,0,1,0,59.16
屏東縣,屏東市,瑞光里,31,1,959,3,962,1597,3,1,3,0,1,0,60.24
屏東縣,屏東市,湖南里,32,1,651,1,652,993,3,1,3,0,1,0,65.66
屏東縣,屏東市,湖西里,33,1,914,7,921,1390,3,1,3,0,1,0,66.26
屏東縣,屏東市,歸心里,34,1,689,3,692,1113,3,1,3,0,1,0,62.17
屏東縣,屏東市,清溪里,35,1,890,4,894,1483,3,1,3,0,1,0,60.28
屏東縣,屏東市,清溪里,36,1,885,1,886,1537,3,1,3,0,1,0,57.64
屏東縣,屏東市,大武里,37,1,1155,8,1163,1940,3,1,3,0,1,0,59.95
屏東縣,屏東市,大武里,38,1,910,4,914,1514,3,1,3,0,1,0,60.37
屏東縣,屏東市,大武里,39,1,1093,4,1097,1801,3,1,3,0,1,0,60.91
屏東縣,屏東市,大武里,40,1,1055,5,1060,1836,3,1,3,0,1,0,57.73
屏東縣,屏東市,凌雲里,41,1,856,4,860,1316,3,1,3,0,1,0,65.35
屏東縣,屏東市,永順里、永昌里,42,1,769,3,772,1230,3,1,3,0,1,0,62.76
屏東縣,屏東市,鵬程里,43,1,897,5,902,1382,3,1,3,0,1,0,65.27
屏東縣,屏東市,安鎮里,44,1,596,5,601,959,3,1,3,0,1,0,62.67
屏東縣,屏東市,安鎮里,45,1,659,3,662,1017,3,1,3,0,1,0,65.09
屏東縣,屏東市,永光里,46,1,731,2,733,1134,3,1,3,0,1,0,64.64
屏東縣,屏東市,長安里,47,1,614,3,617,993,3,1,3,0,1,0,62.13
屏東縣,屏東市,長安里,48,1,580,8,588,946,3,1,3,0,1,0,62.16
屏東縣,屏東市,前進里,49,1,954,1,955,1554,3,1,3,0,1,0,61.45
屏東縣,屏東市,前進里,50,1,804,11,815,1226,3,1,3,0,1,0,66.48
屏東縣,屏東市,大洲里,51,1,733,3,736,1119,3,1,3,0,1,0,65.77
屏東縣,屏東市,新興里,52,1,960,7,967,1364,3,1,3,0,1,0,70.89
屏東縣,屏東市,新興里,53,1,468,1,469,859,3,1,3,0,1,0,54.6
屏東縣,屏東市,公館里,54,1,1033,11,1044,1465,3,1,3,0,1,0,71.26
屏東縣,屏東市,新生里,55,1,900,6,906,1412,3,1,3,0,1,0,64.16
屏東縣,屏東市,新生里,56,1,968,5,973,1740,3,1,3,0,1,0,55.92
屏東縣,屏東市,新生里,57,1,1022,11,1033,1570,3,1,3,0,1,0,65.80
屏東縣,屏東市,頂宅里,58,1,328,1,329,526,3,1,3,0,1,0,62.55
屏東縣,屏東市,頂柳里,59,1,741,1,742,1038,3,1,3,0,1,0,71.48
屏東縣,屏東市,大湖里,60,1,1030,12,1042,1559,3,1,3,0,1,0,66.84
屏東縣,屏東市,龍華里,61,1,804,5,809,1257,3,1,3,0,1,0,64.36
屏東縣,屏東市,龍華里,62,1,688,7,695,1131,3,1,3,0,1,0,61.45
屏東縣,屏東市,玉成里,63,1,914,5,919,1359,3,1,3,0,1,0,67.62
屏東縣,屏東市,建國里、擇仁里,64,1,996,6,1002,1716,3,1,3,0,1,0,58.39
屏東縣,屏東市,萬年里,65,1,494,3,497,771,3,1,3,0,1,0,64.46
屏東縣,屏東市,厚生里,66,1,808,2,810,1362,3,1,3,0,1,0,59.47
屏東縣,屏東市,厚生里,67,1,1038,2,1040,1658,3,1,3,0,1,0,62.73
屏東縣,屏東市,義勇里、一心里,68,1,1055,8,1063,1778,3,1,3,0,1,0,59.79
屏東縣,屏東市,光華里,69,1,448,5,453,740,3,1,3,0,1,0,61.22
屏東縣,屏東市,永安里,70,1,799,8,807,1386,3,1,3,0,1,0,58.23
屏東縣,屏東市,永安里,71,1,1006,6,1012,1591,3,1,3,0,1,0,63.61
屏東縣,屏東市,永安里,72,1,1032,7,1039,1831,3,1,3,0,1,0,56.74
屏東縣,屏東市,永安里,73,1,1058,4,1062,1847,3,1,3,0,1,0,57.5
屏東縣,屏東市,崇蘭里,74,1,943,6,949,1509,3,1,3,0,1,0,62.89
屏東縣,屏東市,崇蘭里,75,1,903,3,906,1539,3,1,3,0,1,0,58.87
屏東縣,屏東市,崇蘭里,76,1,1081,7,1088,1780,3,1,3,0,1,0,61.12
屏東縣,屏東市,崇蘭里,77,1,896,9,905,1510,3,1,3,0,1,0,59.93
屏東縣,屏東市,崇蘭里,78,1,919,5,924,1522,3,1,3,0,1,0,60.71
屏東縣,屏東市,潭墘里,79,1,774,6,780,1397,3,1,3,0,1,0,55.83
屏東縣,屏東市,潭墘里,80,1,939,6,945,1666,3,1,3,0,1,0,56.72
屏東縣,屏東市,潭墘里,81,1,846,2,848,1472,3,1,3,0,1,0,57.61
屏東縣,屏東市,潭墘里,82,1,848,3,851,1405,3,1,3,0,1,0,60.57
屏東縣,屏東市,潭墘里,83,1,990,4,994,1916,3,1,3,0,1,0,51.88
屏東縣,屏東市,永城里,84,1,710,1,711,1182,3,1,3,0,1,0,60.15
屏東縣,屏東市,永城里,85,1,642,7,649,1115,3,1,3,0,1,0,58.21
屏東縣,屏東市,空翔里,86,1,994,4,998,1548,3,1,3,0,1,0,64.47
屏東縣,屏東市,廣興里,87,1,623,1,624,986,3,1,3,0,1,0,63.29
屏東縣,屏東市,廣興里,88,1,659,5,664,996,3,1,3,0,1,0,66.67
屏東縣,屏東市,勝利里,89,1,868,5,873,1692,3,1,3,0,1,0,51.60
屏東縣,屏東市,勝利里,90,1,881,4,885,1479,3,1,3,0,1,0,59.84
屏東縣,屏東市,勝利里,91,1,850,4,854,1492,3,1,3,0,1,0,57.24
屏東縣,屏東市,斯文里,92,1,627,2,629,1004,3,1,3,0,1,0,62.65
屏東縣,屏東市,斯文里,93,1,687,4,691,1062,3,1,3,0,1,0,65.07
屏東縣,屏東市,華山里,94,1,940,3,943,1440,3,1,3,0,1,0,65.49
屏東縣,屏東市,華山里,95,1,881,3,884,1441,3,1,3,0,1,0,61.35
屏東縣,屏東市,華山里,96,1,1111,7,1118,1785,3,1,3,0,1,0,62.63
屏東縣,屏東市,溝美里,97,1,882,4,886,1355,3,1,3,0,1,0,65.39
屏東縣,屏東市,溝美里,98,1,819,3,822,1362,3,1,3,0,1,0,60.35
屏東縣,屏東市,三山里,99,1,861,3,864,1258,3,1,3,0,1,0,68.68
屏東縣,屏東市,海豐里,100,1,581,4,585,851,3,1,3,0,1,0,68.74
屏東縣,屏東市,仁義里,101,1,657,4,661,1000,3,1,3,0,1,0,66.10
屏東縣,屏東市,北興里,102,1,846,5,851,1354,3,1,3,0,1,0,62.85
屏東縣,屏東市,北興里,103,1,752,3,755,1261,3,1,3,0,1,0,59.87
屏東縣,屏東市,北興里,104,1,904,6,910,1581,3,1,3,0,1,0,57.56
屏東縣,屏東市,北興里,105,1,764,3,767,1327,3,1,3,0,1,0,57.80
屏東縣,屏東市,北勢里,106,1,809,4,813,1258,3,1,3,0,1,0,64.63
屏東縣,屏東市,北勢里,107,1,711,4,715,1106,3,1,3,0,1,0,64.65
屏東縣,屏東市,中正里,108,1,1029,2,1031,1760,3,1,3,0,1,0,58.58
屏東縣,屏東市,中正里,109,1,1020,4,1024,1718,3,1,3,0,1,0,59.60
屏東縣,屏東市,興樂里,110,1,574,6,580,936,3,1,3,0,1,0,61.97
屏東縣,屏東市,明正里、太平里,111,1,1093,5,1098,1750,3,1,3,0,1,0,62.74
屏東縣,屏東市,信和里,112,1,953,7,960,1470,3,1,3,0,1,0,65.31
屏東縣,屏東市,和興里,113,1,616,1,617,933,3,1,3,0,1,0,66.13
屏東縣,屏東市,仁愛里,114,1,705,6,711,1157,3,1,3,0,1,0,61.45
屏東縣,屏東市,仁愛里,115,1,657,4,661,1129,3,1,3,0,1,0,58.55
屏東縣,潮州鎮,潮州里,116,1,393,4,397,587,3,1,3,0,1,0,67.63
屏東縣,潮州鎮,光華里,117,1,841,2,843,1487,3,1,3,0,1,0,56.69
屏東縣,潮州鎮,光華里,118,1,797,7,804,1357,3,1,3,0,1,0,59.25
屏東縣,潮州鎮,光華里,119,1,645,1,646,1176,3,1,3,0,1,0,54.93
屏東縣,潮州鎮,同榮里,120,1,497,1,498,709,3,1,3,0,1,0,70.24
屏東縣,潮州鎮,新生里,121,1,723,2,725,1137,3,1,3,0,1,0,63.76
屏東縣,潮州鎮,新榮里,122,1,863,6,869,1431,3,1,3,0,1,0,60.73
屏東縣,潮州鎮,彭城里,123,1,540,1,541,813,3,1,3,0,1,0,66.54
屏東縣,潮州鎮,三星里,124,1,780,3,783,1268,3,1,3,0,1,0,61.75
屏東縣,潮州鎮,三星里,125,1,820,4,824,1449,3,1,3,0,1,0,56.87
屏東縣,潮州鎮,三星里,126,1,968,3,971,1559,3,1,3,0,1,0,62.28
屏東縣,潮州鎮,三共里,127,1,1070,6,1076,1659,3,1,3,0,1,0,64.86
屏東縣,潮州鎮,三共里,128,1,1133,7,1140,1875,3,1,3,0,1,0,60.80
屏東縣,潮州鎮,三共里,129,1,1099,3,1102,1913,3,1,3,0,1,0,57.61
屏東縣,潮州鎮,三和里,130,1,1085,8,1093,1832,3,1,3,0,1,0,59.66
屏東縣,潮州鎮,五魁里,131,1,712,4,716,1197,3,1,3,0,1,0,59.82
屏東縣,潮州鎮,蓬萊里,132,1,1073,6,1079,1821,3,1,3,0,1,0,59.25
屏東縣,潮州鎮,八爺里,133,1,1223,7,1230,2058,3,1,3,0,1,0,59.77
屏東縣,潮州鎮,永春里,134,1,1145,11,1156,2038,3,1,3,0,1,0,56.72
屏東縣,潮州鎮,永春里,135,1,925,4,929,1561,3,1,3,0,1,0,59.51
屏東縣,潮州鎮,永春里,136,1,954,6,960,1601,3,1,3,0,1,0,59.96
屏東縣,潮州鎮,富春里,137,1,812,3,815,1381,3,1,3,0,1,0,59.02
屏東縣,潮州鎮,光春里,138,1,765,7,772,1300,3,1,3,0,1,0,59.38
屏東縣,潮州鎮,興美里,139,1,508,5,513,864,3,1,3,0,1,0,59.38
屏東縣,潮州鎮,檨子里,140,1,327,4,331,580,3,1,3,0,1,0,57.07
屏東縣,潮州鎮,九塊里,141,1,882,3,885,1586,3,1,3,0,1,0,55.80
屏東縣,潮州鎮,泗林里,142,1,1018,7,1025,1523,3,1,3,0,1,0,67.30
屏東縣,潮州鎮,四春里,143,1,1228,10,1238,1895,3,1,3,0,1,0,65.33
屏東縣,潮州鎮,崙東里,144,1,941,11,952,1584,3,1,3,0,1,0,60.1
屏東縣,東港鎮,新勝里,145,1,660,5,665,1110,3,1,3,0,1,0,59.91
屏東縣,東港鎮,新勝里,146,1,743,5,748,1184,3,1,3,0,1,0,63.18
屏東縣,東港鎮,頂新里,147,1,344,0,344,564,3,1,3,0,1,0,60.99
屏東縣,東港鎮,頂中里,148,1,301,0,301,454,3,1,3,0,1,0,66.30
屏東縣,東港鎮,東和里,149,1,461,6,467,760,3,1,3,0,1,0,61.45
屏東縣,東港鎮,興台里,150,1,324,2,326,533,3,1,3,0,1,0,61.16
屏東縣,東港鎮,興東里,151,1,804,5,809,1302,3,1,3,0,1,0,62.14
屏東縣,東港鎮,興東里,152,1,545,2,547,940,3,1,3,0,1,0,58.19
屏東縣,東港鎮,興東里,153,1,765,14,779,1351,3,1,3,0,1,0,57.66
屏東縣,東港鎮,興東里,154,1,754,4,758,1453,3,1,3,0,1,0,52.17
屏東縣,東港鎮,興東里,155,1,643,4,647,1027,3,1,3,0,1,0,63.00
屏東縣,東港鎮,興農里,156,1,513,0,513,731,3,1,3,0,1,0,70.18
屏東縣,東港鎮,中興里,157,1,462,5,467,814,3,1,3,0,1,0,57.37
屏東縣,東港鎮,朝安里,158,1,715,5,720,1286,3,1,3,0,1,0,55.99
屏東縣,東港鎮,朝安里,159,1,372,1,373,593,3,1,3,0,1,0,62.90
屏東縣,東港鎮,八德里,160,1,515,0,515,898,3,1,3,0,1,0,57.35
屏東縣,東港鎮,東隆里,161,1,856,9,865,1340,3,1,3,0,1,0,64.55
屏東縣,東港鎮,豐漁里,162,1,412,0,412,724,3,1,3,0,1,0,56.91
屏東縣,東港鎮,盛漁里,163,1,698,2,700,1336,3,1,3,0,1,0,52.40
屏東縣,東港鎮,興漁里,164,1,459,3,462,809,3,1,3,0,1,0,57.11
屏東縣,東港鎮,興漁里,165,1,585,4,589,1123,3,1,3,0,1,0,52.45
屏東縣,東港鎮,鎮海里,166,1,696,1,697,1223,3,1,3,0,1,0,56.99
屏東縣,東港鎮,鎮海里,167,1,750,3,753,1415,3,1,3,0,1,0,53.22
屏東縣,東港鎮,嘉蓮里,168,1,903,4,907,1598,3,1,3,0,1,0,56.76
屏東縣,東港鎮,南平里,169,1,298,2,300,503,3,1,3,0,1,0,59.64
屏東縣,東港鎮,南平里,170,1,822,4,826,1283,3,1,3,0,1,0,64.38
屏東縣,東港鎮,船頭里,171,1,576,3,579,1060,3,1,3,0,1,0,54.62
屏東縣,東港鎮,船頭里,172,1,784,0,784,1404,3,1,3,0,1,0,55.84
屏東縣,東港鎮,船頭里,173,1,767,2,769,1539,3,1,3,0,1,0,49.97
屏東縣,東港鎮,下部里,174,1,697,1,698,1089,3,1,3,0,1,0,64.10
屏東縣,東港鎮,下部里,175,1,448,5,453,736,3,1,3,0,1,0,61.55
屏東縣,東港鎮,大潭里,176,1,1005,7,1012,1608,3,1,3,0,1,0,62.94
屏東縣,東港鎮,興和里,177,1,616,5,621,911,3,1,3,0,1,0,68.17
屏東縣,東港鎮,共和里,178,1,461,2,463,736,3,1,3,0,1,0,62.91
屏東縣,東港鎮,大鵬里,179,1,189,0,189,304,3,1,3,0,1,0,62.17
屏東縣,恆春鎮,城南里,180,1,587,5,592,976,3,1,3,0,1,0,60.66
屏東縣,恆春鎮,城北里,181,1,542,6,548,918,3,1,3,0,1,0,59.69
屏東縣,恆春鎮,城北里,182,1,585,7,592,1059,3,1,3,0,1,0,55.90
屏東縣,恆春鎮,城西里,183,1,622,3,625,1087,3,1,3,0,1,0,57.50
屏東縣,恆春鎮,山腳里,184,1,620,7,627,1143,3,1,3,0,1,0,54.86
屏東縣,恆春鎮,山腳里,185,1,571,5,576,1060,3,1,3,0,1,0,54.34
屏東縣,恆春鎮,山腳里,186,1,641,6,647,1256,3,1,3,0,1,0,51.51
屏東縣,恆春鎮,網紗里,187,1,787,7,794,1441,3,1,3,0,1,0,55.10
屏東縣,恆春鎮,網紗里,188,1,613,6,619,1196,3,1,3,0,1,0,51.76
屏東縣,恆春鎮,仁壽里,189,1,408,8,416,770,3,1,3,0,1,0,54.03
屏東縣,恆春鎮,茄湖里,190,1,271,6,277,476,3,1,3,0,1,0,58.19
屏東縣,恆春鎮,頭溝里,191,1,245,3,248,466,3,1,3,0,1,0,53.22
屏東縣,恆春鎮,四溝里,192,1,497,3,500,916,3,1,3,0,1,0,54.59
屏東縣,恆春鎮,德和里,193,1,440,6,446,727,3,1,3,0,1,0,61.35
屏東縣,恆春鎮,龍水里,194,1,568,5,573,982,3,1,3,0,1,0,58.35
屏東縣,恆春鎮,山海里,195,1,434,0,434,762,3,1,3,0,1,0,56.96
屏東縣,恆春鎮,山海里,196,1,402,4,406,747,3,1,3,0,1,0,54.35
屏東縣,恆春鎮,大光里,197,1,541,4,545,935,3,1,3,0,1,0,58.29
屏東縣,恆春鎮,大光里,198,1,477,3,480,928,3,1,3,0,1,0,51.72
屏東縣,恆春鎮,水泉里,199,1,386,1,387,695,3,1,3,0,1,0,55.68
屏東縣,恆春鎮,水泉里,200,1,353,4,357,659,3,1,3,0,1,0,54.17
屏東縣,恆春鎮,南灣里,201,1,329,4,333,642,3,1,3,0,1,0,51.87
屏東縣,恆春鎮,南灣里,202,1,440,2,442,725,3,1,3,0,1,0,60.97
屏東縣,恆春鎮,墾丁里,203,1,777,6,783,1218,3,1,3,0,1,0,64.29
屏東縣,恆春鎮,鵝鑾里,204,1,598,7,605,1023,3,1,3,0,1,0,59.14
屏東縣,萬丹鄉,香社村,205,1,1014,4,1018,1434,3,1,3,0,1,0,70.99
屏東縣,萬丹鄉,新庄村,206,1,1344,11,1355,1841,3,1,3,0,1,0,73.60
屏東縣,萬丹鄉,新鐘村,207,1,667,6,673,933,3,1,3,0,1,0,72.13
屏東縣,萬丹鄉,新鐘村,208,1,638,4,642,924,3,1,3,0,1,0,69.48
屏東縣,萬丹鄉,水仙村,209,1,388,1,389,527,3,1,3,0,1,0,73.81
屏東縣,萬丹鄉,興全村,210,1,870,10,880,1123,3,1,3,0,1,0,78.36
屏東縣,萬丹鄉,興安村,211,1,565,2,567,816,3,1,3,0,1,0,69.49
屏東縣,萬丹鄉,甘棠村,212,1,270,4,274,364,3,1,3,0,1,0,75.27
屏東縣,萬丹鄉,萬惠村,213,1,548,2,550,778,3,1,3,0,1,0,70.69
屏東縣,萬丹鄉,萬全村,214,1,1194,10,1204,1792,3,1,3,0,1,0,67.19
屏東縣,萬丹鄉,萬全村,215,1,1068,8,1076,1510,3,1,3,0,1,0,71.26
屏東縣,萬丹鄉,萬後村,216,1,365,0,365,500,3,1,3,0,1,0,73
屏東縣,萬丹鄉,萬安村,217,1,386,3,389,548,3,1,3,0,1,0,70.99
屏東縣,萬丹鄉,萬生村,218,1,903,8,911,1265,3,1,3,0,1,0,72.02
屏東縣,萬丹鄉,寶厝村,219,1,660,8,668,1009,3,1,3,0,1,0,66.2
屏東縣,萬丹鄉,寶厝村,220,1,716,9,725,1056,3,1,3,0,1,0,68.66
屏東縣,萬丹鄉,四維村,221,1,1156,10,1166,1735,3,1,3,0,1,0,67.20
屏東縣,萬丹鄉,竹林村,222,1,966,6,972,1506,3,1,3,0,1,0,64.54
屏東縣,萬丹鄉,水泉村,223,1,972,3,975,1400,3,1,3,0,1,0,69.64
屏東縣,萬丹鄉,田厝村,224,1,628,2,630,895,3,1,3,0,1,0,70.39
屏東縣,萬丹鄉,崙頂村,225,1,1149,6,1155,1685,3,1,3,0,1,0,68.55
屏東縣,萬丹鄉,廈北村,226,1,1135,9,1144,1604,3,1,3,0,1,0,71.32
屏東縣,萬丹鄉,廈南村,227,1,978,6,984,1397,3,1,3,0,1,0,70.44
屏東縣,萬丹鄉,後村村,228,1,783,3,786,995,3,1,3,0,1,0,78.99
屏東縣,萬丹鄉,灣內村,229,1,909,5,914,1267,3,1,3,0,1,0,72.14
屏東縣,萬丹鄉,上村村,230,1,526,3,529,678,3,1,3,0,1,0,78.02
屏東縣,萬丹鄉,加興村,231,1,816,8,824,1107,3,1,3,0,1,0,74.44
屏東縣,萬丹鄉,社口村,232,1,946,4,950,1233,3,1,3,0,1,0,77.05
屏東縣,萬丹鄉,磚寮村,233,1,693,7,700,919,3,1,3,0,1,0,76.17
屏東縣,萬丹鄉,社皮村,234,1,607,0,607,812,3,1,3,0,1,0,74.75
屏東縣,萬丹鄉,社皮村,235,1,706,4,710,993,3,1,3,0,1,0,71.50
屏東縣,萬丹鄉,社中村,236,1,1015,6,1021,1493,3,1,3,0,1,0,68.39
屏東縣,萬丹鄉,社上村,237,1,944,6,950,1452,3,1,3,0,1,0,65.43
屏東縣,萬丹鄉,廣安村,238,1,637,1,638,910,3,1,3,0,1,0,70.11
屏東縣,萬丹鄉,廣安村,239,1,721,6,727,1084,3,1,3,0,1,0,67.07
屏東縣,長治鄉,進興村,240,1,596,5,601,943,3,1,3,0,1,0,63.73
屏東縣,長治鄉,進興村,241,1,813,3,816,1320,3,1,3,0,1,0,61.82
屏東縣,長治鄉,新潭村,242,1,743,3,746,1187,3,1,3,0,1,0,62.85
屏東縣,長治鄉,新潭村,243,1,1003,7,1010,1632,3,1,3,0,1,0,61.89
屏東縣,長治鄉,潭頭村,244,1,1058,6,1064,1524,3,1,3,0,1,0,69.82
屏東縣,長治鄉,香楊村,245,1,403,0,403,614,3,1,3,0,1,0,65.64
屏東縣,長治鄉,香楊村,246,1,790,3,793,1293,3,1,3,0,1,0,61.33
屏東縣,長治鄉,長興村,247,1,682,3,685,968,3,1,3,0,1,0,70.76
屏東縣,長治鄉,崙上村,248,1,1014,7,1021,1447,3,1,3,0,1,0,70.56
屏東縣,長治鄉,德榮村,249,1,713,9,722,1042,3,1,3,0,1,0,69.29
屏東縣,長治鄉,德和村,250,1,526,2,528,777,3,1,3,0,1,0,67.95
屏東縣,長治鄉,復興村,251,1,941,3,944,1445,3,1,3,0,1,0,65.33
屏東縣,長治鄉,德成村,252,1,635,4,639,880,3,1,3,0,1,0,72.61
屏東縣,長治鄉,德協村,253,1,732,6,738,1124,3,1,3,0,1,0,65.66
屏東縣,長治鄉,繁榮村,254,1,783,8,791,1321,3,1,3,0,1,0,59.88
屏東縣,長治鄉,繁昌村,255,1,1024,3,1027,1707,3,1,3,0,1,0,60.16
屏東縣,長治鄉,繁隆村,256,1,729,4,733,1079,3,1,3,0,1,0,67.93
屏東縣,長治鄉,繁華村,257,1,777,4,781,1226,3,1,3,0,1,0,63.70
屏東縣,長治鄉,繁華村,258,1,594,7,601,1006,3,1,3,0,1,0,59.74
屏東縣,長治鄉,榮華村,259,1,318,2,320,498,3,1,3,0,1,0,64.26
屏東縣,麟洛鄉,新田村,260,1,479,1,480,701,3,1,3,0,1,0,68.47
屏東縣,麟洛鄉,新田村,261,1,763,9,772,1108,3,1,3,0,1,0,69.68
屏東縣,麟洛鄉,麟頂村,262,1,568,1,569,827,3,1,3,0,1,0,68.80
屏東縣,麟洛鄉,麟蹄村,263,1,534,2,536,786,3,1,3,0,1,0,68.19
屏東縣,麟洛鄉,麟蹄村,264,1,545,5,550,786,3,1,3,0,1,0,69.97
屏東縣,麟洛鄉,麟趾村,265,1,683,2,685,1078,3,1,3,0,1,0,63.54
屏東縣,麟洛鄉,麟趾村,266,1,792,2,794,1205,3,1,3,0,1,0,65.89
屏東縣,麟洛鄉,田中村,267,1,765,9,774,1112,3,1,3,0,1,0,69.60
屏東縣,麟洛鄉,田心村,268,1,574,2,576,843,3,1,3,0,1,0,68.33
屏東縣,麟洛鄉,田道村,269,1,474,2,476,684,3,1,3,0,1,0,69.59
屏東縣,九如鄉,九清村,270,1,1089,7,1096,1553,3,1,3,0,1,0,70.57
屏東縣,九如鄉,九塊村,271,1,885,1,886,1278,3,1,3,0,1,0,69.33
屏東縣,九如鄉,九明村,272,1,964,6,970,1419,3,1,3,0,1,0,68.36
屏東縣,九如鄉,大坵村,273,1,691,5,696,1037,3,1,3,0,1,0,67.12
屏東縣,九如鄉,玉水村,274,1,878,7,885,1235,3,1,3,0,1,0,71.66
屏東縣,九如鄉,玉泉村,275,1,958,2,960,1452,3,1,3,0,1,0,66.12
屏東縣,九如鄉,東寧村,276,1,470,1,471,618,3,1,3,0,1,0,76.21
屏東縣,九如鄉,東寧村,277,1,1101,7,1108,1691,3,1,3,0,1,0,65.52
屏東縣,九如鄉,東寧村,278,1,815,6,821,1320,3,1,3,0,1,0,62.2
屏東縣,九如鄉,三塊村,279,1,959,3,962,1422,3,1,3,0,1,0,67.65
屏東縣,九如鄉,耆老村,280,1,931,8,939,1252,3,1,3,0,1,0,75
屏東縣,九如鄉,後庄村,281,1,1262,8,1270,1692,3,1,3,0,1,0,75.06
屏東縣,九如鄉,洽興村,282,1,955,5,960,1317,3,1,3,0,1,0,72.89
屏東縣,里港鄉,玉田村,283,1,637,2,639,1006,3,1,3,0,1,0,63.52
屏東縣,里港鄉,玉田村,284,1,739,7,746,1200,3,1,3,0,1,0,62.17
屏東縣,里港鄉,塔樓村,285,1,947,6,953,1394,3,1,3,0,1,0,68.36
屏東縣,里港鄉,潮厝村,286,1,983,7,990,1384,3,1,3,0,1,0,71.53
屏東縣,里港鄉,大平村,287,1,800,7,807,1125,3,1,3,0,1,0,71.73
屏東縣,里港鄉,永春村,288,1,517,5,522,790,3,1,3,0,1,0,66.08
屏東縣,里港鄉,春林村,289,1,744,3,747,1198,3,1,3,0,1,0,62.35
屏東縣,里港鄉,過江村,290,1,560,4,564,863,3,1,3,0,1,0,65.35
屏東縣,里港鄉,過江村,291,1,519,8,527,866,3,1,3,0,1,0,60.85
屏東縣,里港鄉,鐵店村,292,1,863,2,865,1214,3,1,3,0,1,0,71.25
屏東縣,里港鄉,茄苳村,293,1,301,1,302,406,3,1,3,0,1,0,74.38
屏東縣,里港鄉,茄苳村,294,1,837,4,841,1169,3,1,3,0,1,0,71.94
屏東縣,里港鄉,載興村,295,1,727,3,730,1004,3,1,3,0,1,0,72.71
屏東縣,里港鄉,載興村,296,1,903,3,906,1313,3,1,3,0,1,0,69
屏東縣,里港鄉,土庫村,297,1,1015,17,1032,1461,3,1,3,0,1,0,70.64
屏東縣,里港鄉,土庫村,298,1,340,4,344,494,3,1,3,0,1,0,69.64
屏東縣,里港鄉,三部村,299,1,546,7,553,842,3,1,3,0,1,0,65.68
屏東縣,里港鄉,三部村,300,1,621,5,626,899,3,1,3,0,1,0,69.63
屏東縣,里港鄉,中和村,301,1,530,4,534,823,3,1,3,0,1,0,64.88
屏東縣,里港鄉,瀰力村,302,1,310,2,312,453,3,1,3,0,1,0,68.87
屏東縣,鹽埔鄉,鹽北村,303,1,1187,3,1190,1758,3,1,3,0,1,0,67.69
屏東縣,鹽埔鄉,鹽中村,304,1,736,7,743,1134,3,1,3,0,1,0,65.52
屏東縣,鹽埔鄉,鹽中村,305,1,735,6,741,1150,3,1,3,0,1,0,64.43
屏東縣,鹽埔鄉,鹽南村,306,1,1043,7,1050,1628,3,1,3,0,1,0,64.5
屏東縣,鹽埔鄉,仕絨村,307,1,652,5,657,908,3,1,3,0,1,0,72.36
屏東縣,鹽埔鄉,高朗村,308,1,857,9,866,1357,3,1,3,0,1,0,63.82
屏東縣,鹽埔鄉,高朗村,309,1,888,9,897,1342,3,1,3,0,1,0,66.84
屏東縣,鹽埔鄉,振興村,310,1,1126,13,1139,1851,3,1,3,0,1,0,61.53
屏東縣,鹽埔鄉,久愛村,311,1,549,5,554,864,3,1,3,0,1,0,64.12
屏東縣,鹽埔鄉,新圍村,312,1,883,0,883,1436,3,1,3,0,1,0,61.49
屏東縣,鹽埔鄉,新圍村,313,1,874,16,890,1471,3,1,3,0,1,0,60.5
屏東縣,鹽埔鄉,新二村,314,1,888,3,891,1473,3,1,3,0,1,0,60.49
屏東縣,鹽埔鄉,新二村,315,1,816,4,820,1491,3,1,3,0,1,0,55
屏東縣,鹽埔鄉,彭厝村,316,1,650,4,654,971,3,1,3,0,1,0,67.35
屏東縣,鹽埔鄉,洛陽村,317,1,913,9,922,1483,3,1,3,0,1,0,62.17
屏東縣,鹽埔鄉,永隆村,318,1,376,7,383,556,3,1,3,0,1,0,68.88
屏東縣,高樹鄉,高樹村,319,1,572,2,574,933,3,1,3,0,1,0,61.52
屏東縣,高樹鄉,高樹村,320,1,735,6,741,1219,3,1,3,0,1,0,60.79
屏東縣,高樹鄉,長榮村,321,1,896,3,899,1360,3,1,3,0,1,0,66.1
屏東縣,高樹鄉,東興村,322,1,551,5,556,819,3,1,3,0,1,0,67.89
屏東縣,高樹鄉,東振村,323,1,400,2,402,612,3,1,3,0,1,0,65.69
屏東縣,高樹鄉,源泉村,324,1,657,3,660,1019,3,1,3,0,1,0,64.77
屏東縣,高樹鄉,建興村,325,1,716,5,721,1156,3,1,3,0,1,0,62.37
屏東縣,高樹鄉,大埔村,326,1,405,4,409,673,3,1,3,0,1,0,60.77
屏東縣,高樹鄉,菜寮村,327,1,506,6,512,806,3,1,3,0,1,0,63.52
屏東縣,高樹鄉,司馬村,328,1,454,1,455,712,3,1,3,0,1,0,63.9
屏東縣,高樹鄉,舊寮村,329,1,774,1,775,1313,3,1,3,0,1,0,59.03
屏東縣,高樹鄉,新豐村,330,1,876,4,880,1547,3,1,3,0,1,0,56.88
屏東縣,高樹鄉,泰山村,331,1,555,10,565,955,3,1,3,0,1,0,59.16
屏東縣,高樹鄉,泰山村,332,1,612,4,616,993,3,1,3,0,1,0,62.03
屏東縣,高樹鄉,南華村,333,1,786,4,790,1248,3,1,3,0,1,0,63.3
屏東縣,高樹鄉,廣福村,334,1,590,1,591,939,3,1,3,0,1,0,62.94
屏東縣,高樹鄉,廣興村,335,1,695,5,700,1047,3,1,3,0,1,0,66.86
屏東縣,高樹鄉,舊庄村,336,1,687,6,693,1027,3,1,3,0,1,0,67.48
屏東縣,高樹鄉,田子村,337,1,726,5,731,1104,3,1,3,0,1,0,66.21
屏東縣,高樹鄉,鹽樹村,338,1,505,2,507,733,3,1,3,0,1,0,69.17
屏東縣,高樹鄉,鹽樹村,339,1,370,7,377,597,3,1,3,0,1,0,63.15
屏東縣,高樹鄉,新南村,340,1,926,2,928,1471,3,1,3,0,1,0,63.09
屏東縣,萬巒鄉,萬巒村,341,1,828,3,831,1251,3,1,3,0,1,0,66.43
屏東縣,萬巒鄉,萬全村,342,1,539,1,540,783,3,1,3,0,1,0,68.97
屏東縣,萬巒鄉,萬和村,343,1,924,6,930,1440,3,1,3,0,1,0,64.58
屏東縣,萬巒鄉,鹿寮村,344,1,595,5,600,903,3,1,3,0,1,0,66.45
屏東縣,萬巒鄉,硫黃村,345,1,347,2,349,523,3,1,3,0,1,0,66.73
屏東縣,萬巒鄉,泗溝村,346,1,809,10,819,1232,3,1,3,0,1,0,66.48
屏東縣,萬巒鄉,五溝村,347,1,833,9,842,1142,3,1,3,0,1,0,73.73
屏東縣,萬巒鄉,成德村,348,1,898,4,902,1334,3,1,3,0,1,0,67.62
屏東縣,萬巒鄉,赤山村,349,1,471,5,476,852,3,1,3,0,1,0,55.87
屏東縣,萬巒鄉,赤山村,350,1,467,10,477,799,3,1,3,0,1,0,59.7
屏東縣,萬巒鄉,萬金村,351,1,605,6,611,994,3,1,3,0,1,0,61.47
屏東縣,萬巒鄉,萬金村,352,1,577,11,588,911,3,1,3,0,1,0,64.54
屏東縣,萬巒鄉,佳佐村,353,1,1020,3,1023,1566,3,1,3,0,1,0,65.33
屏東縣,萬巒鄉,佳和村,354,1,1065,9,1074,1476,3,1,3,0,1,0,72.76
屏東縣,萬巒鄉,新厝村,355,1,669,8,677,1063,3,1,3,0,1,0,63.69
屏東縣,萬巒鄉,新置村,356,1,338,2,340,555,3,1,3,0,1,0,61.26
屏東縣,萬巒鄉,新置村,357,1,377,2,379,615,3,1,3,0,1,0,61.63
屏東縣,內埔鄉,內埔村,358,1,838,7,845,1349,3,1,3,0,1,0,62.64
屏東縣,內埔鄉,內埔村,359,1,1190,7,1197,1919,3,1,3,0,1,0,62.38
屏東縣,內埔鄉,內田村,360,1,638,5,643,1064,3,1,3,0,1,0,60.43
屏東縣,內埔鄉,內田村,361,1,1010,4,1014,1679,3,1,3,0,1,0,60.39
屏東縣,內埔鄉,興南村,362,1,916,6,922,1314,3,1,3,0,1,0,70.17
屏東縣,內埔鄉,義亭村,363,1,394,3,397,592,3,1,3,0,1,0,67.06
屏東縣,內埔鄉,美和村,364,1,660,3,663,1021,3,1,3,0,1,0,64.94
屏東縣,內埔鄉,美和村,365,1,671,5,676,1090,3,1,3,0,1,0,62.02
屏東縣,內埔鄉,和興村,366,1,558,1,559,821,3,1,3,0,1,0,68.09
屏東縣,內埔鄉,和興村,367,1,697,3,700,1173,3,1,3,0,1,0,59.68
屏東縣,內埔鄉,東寧村,368,1,694,3,697,1041,3,1,3,0,1,0,66.95
屏東縣,內埔鄉,東寧村,369,1,847,8,855,1348,3,1,3,0,1,0,63.43
屏東縣,內埔鄉,東寧村,370,1,1031,4,1035,1655,3,1,3,0,1,0,62.54
屏東縣,內埔鄉,豐田村,371,1,741,8,749,1233,3,1,3,0,1,0,60.75
屏東縣,內埔鄉,豐田村,372,1,739,3,742,1225,3,1,3,0,1,0,60.57
屏東縣,內埔鄉,振豐村,373,1,496,3,499,725,3,1,3,0,1,0,68.83
屏東縣,內埔鄉,振豐村,374,1,621,4,625,896,3,1,3,0,1,0,69.75
屏東縣,內埔鄉,富田村,375,1,528,6,534,778,3,1,3,0,1,0,68.64
屏東縣,內埔鄉,富田村,376,1,749,2,751,1127,3,1,3,0,1,0,66.64
屏東縣,內埔鄉,竹圍村,377,1,928,7,935,1566,3,1,3,0,1,0,59.71
屏東縣,內埔鄉,東勢村,378,1,715,1,716,1104,3,1,3,0,1,0,64.86
屏東縣,內埔鄉,東勢村,379,1,1111,6,1117,1764,3,1,3,0,1,0,63.32
屏東縣,內埔鄉,東片村,380,1,603,2,605,902,3,1,3,0,1,0,67.07
屏東縣,內埔鄉,上樹村,381,1,746,1,747,1099,3,1,3,0,1,0,67.97
屏東縣,內埔鄉,老埤村,382,1,635,1,636,1138,3,1,3,0,1,0,55.89
屏東縣,內埔鄉,老埤村,383,1,710,7,717,1236,3,1,3,0,1,0,58.01
屏東縣,內埔鄉,中林村,384,1,887,14,901,1465,3,1,3,0,1,0,61.5
屏東縣,內埔鄉,龍泉村,385,1,814,6,820,1337,3,1,3,0,1,0,61.33
屏東縣,內埔鄉,龍泉村,386,1,636,6,642,1136,3,1,3,0,1,0,56.51
屏東縣,內埔鄉,龍潭村,387,1,822,7,829,1417,3,1,3,0,1,0,58.5
屏東縣,內埔鄉,龍潭村,388,1,596,6,602,1057,3,1,3,0,1,0,56.95
屏東縣,內埔鄉,建興村,389,1,421,0,421,656,3,1,3,0,1,0,64.18
屏東縣,內埔鄉,建興村,390,1,409,12,421,888,3,1,3,0,1,0,47.41
屏東縣,內埔鄉,大新村,391,1,765,6,771,1253,3,1,3,0,1,0,61.53
屏東縣,內埔鄉,大新村,392,1,316,3,319,503,3,1,3,0,1,0,63.42
屏東縣,內埔鄉,黎明村,393,1,664,9,673,1156,3,1,3,0,1,0,58.22
屏東縣,內埔鄉,黎明村,394,1,595,5,600,1086,3,1,3,0,1,0,55.25
屏東縣,內埔鄉,隘寮村,395,1,587,4,591,1143,3,1,3,0,1,0,51.71
屏東縣,內埔鄉,水門村,396,1,452,2,454,747,3,1,3,0,1,0,60.78
屏東縣,竹田鄉,竹田村,397,1,1028,4,1032,1463,3,1,3,0,1,0,70.54
屏東縣,竹田鄉,竹南村,398,1,569,3,572,850,3,1,3,0,1,0,67.29
屏東縣,竹田鄉,糶糴村,399,1,503,2,505,674,3,1,3,0,1,0,74.93
屏東縣,竹田鄉,履豐村,400,1,438,2,440,613,3,1,3,0,1,0,71.78
屏東縣,竹田鄉,頭崙村,401,1,905,4,909,1328,3,1,3,0,1,0,68.45
屏東縣,竹田鄉,二崙村,402,1,689,5,694,959,3,1,3,0,1,0,72.37
屏東縣,竹田鄉,美崙村,403,1,446,1,447,605,3,1,3,0,1,0,73.88
屏東縣,竹田鄉,南勢村,404,1,335,3,338,477,3,1,3,0,1,0,70.86
屏東縣,竹田鄉,西勢村,405,1,933,9,942,1343,3,1,3,0,1,0,70.14
屏東縣,竹田鄉,西勢村,406,1,841,7,848,1233,3,1,3,0,1,0,68.78
屏東縣,竹田鄉,福田村,407,1,335,1,336,451,3,1,3,0,1,0,74.5
屏東縣,竹田鄉,永豐村,408,1,431,0,431,614,3,1,3,0,1,0,70.2
屏東縣,竹田鄉,六巷村,409,1,516,1,517,698,3,1,3,0,1,0,74.07
屏東縣,竹田鄉,泗洲村,410,1,671,5,676,1088,3,1,3,0,1,0,62.13
屏東縣,竹田鄉,大湖村,411,1,787,5,792,1150,3,1,3,0,1,0,68.87
屏東縣,竹田鄉,鳳明村,412,1,707,6,713,1033,3,1,3,0,1,0,69.02
屏東縣,新埤鄉,新埤村,413,1,949,6,955,1601,3,1,3,0,1,0,59.65
屏東縣,新埤鄉,新埤村,414,1,229,0,229,340,3,1,3,0,1,0,67.35
屏東縣,新埤鄉,建功村,415,1,519,3,522,801,3,1,3,0,1,0,65.17
屏東縣,新埤鄉,建功村,416,1,253,1,254,382,3,1,3,0,1,0,66.49
屏東縣,新埤鄉,打鐵村,417,1,697,4,701,988,3,1,3,0,1,0,70.95
屏東縣,新埤鄉,南豐村,418,1,494,2,496,743,3,1,3,0,1,0,66.76
屏東縣,新埤鄉,萬隆村,419,1,413,3,416,674,3,1,3,0,1,0,61.72
屏東縣,新埤鄉,萬隆村,420,1,245,1,246,358,3,1,3,0,1,0,68.72
屏東縣,新埤鄉,萬隆村,421,1,377,0,377,648,3,1,3,0,1,0,58.18
屏東縣,新埤鄉,餉潭村,422,1,740,8,748,1339,3,1,3,0,1,0,55.86
屏東縣,新埤鄉,箕湖村,423,1,306,4,310,550,3,1,3,0,1,0,56.36
屏東縣,新埤鄉,箕湖村,424,1,330,0,330,534,3,1,3,0,1,0,61.8
屏東縣,枋寮鄉,枋寮村,425,1,664,2,666,1219,3,1,3,0,1,0,54.63
屏東縣,枋寮鄉,新龍村,426,1,500,6,506,856,3,1,3,0,1,0,59.11
屏東縣,枋寮鄉,保生村,427,1,632,3,635,975,3,1,3,0,1,0,65.13
屏東縣,枋寮鄉,中寮村,428,1,416,1,417,659,3,1,3,0,1,0,63.28
屏東縣,枋寮鄉,安樂村,429,1,546,4,550,898,3,1,3,0,1,0,61.25
屏東縣,枋寮鄉,安樂村,430,1,539,3,542,915,3,1,3,0,1,0,59.23
屏東縣,枋寮鄉,隆山村,431,1,662,3,665,1267,3,1,3,0,1,0,52.49
屏東縣,枋寮鄉,隆山村,432,1,707,5,712,1261,3,1,3,0,1,0,56.46
屏東縣,枋寮鄉,隆山村,433,1,684,6,690,1225,3,1,3,0,1,0,56.33
屏東縣,枋寮鄉,天時村,434,1,579,0,579,974,3,1,3,0,1,0,59.45
屏東縣,枋寮鄉,天時村,435,1,685,3,688,1086,3,1,3,0,1,0,63.35
屏東縣,枋寮鄉,地利村,436,1,1065,7,1072,1642,3,1,3,0,1,0,65.29
屏東縣,枋寮鄉,人和村,437,1,647,1,648,1050,3,1,3,0,1,0,61.71
屏東縣,枋寮鄉,人和村,438,1,665,7,672,1122,3,1,3,0,1,0,59.89
屏東縣,枋寮鄉,內寮村,439,1,394,2,396,740,3,1,3,0,1,0,53.51
屏東縣,枋寮鄉,新開村,440,1,503,6,509,962,3,1,3,0,1,0,52.91
屏東縣,枋寮鄉,東海村,441,1,872,5,877,1411,3,1,3,0,1,0,62.15
屏東縣,枋寮鄉,東海村,442,1,889,5,894,1382,3,1,3,0,1,0,64.69
屏東縣,枋寮鄉,大庄村,443,1,425,0,425,632,3,1,3,0,1,0,67.25
屏東縣,枋寮鄉,太源村,444,1,522,6,528,949,3,1,3,0,1,0,55.64
屏東縣,枋寮鄉,玉泉村,445,1,259,4,263,418,3,1,3,0,1,0,62.92
屏東縣,新園鄉,瓦窯村,446,1,654,2,656,897,3,1,3,0,1,0,73.13
屏東縣,新園鄉,瓦窯村,447,1,526,0,526,735,3,1,3,0,1,0,71.56
屏東縣,新園鄉,仙吉村,448,1,698,0,698,1085,3,1,3,0,1,0,64.33
屏東縣,新園鄉,仙吉村,449,1,850,5,855,1297,3,1,3,0,1,0,65.92
屏東縣,新園鄉,田洋村,450,1,670,0,670,1012,3,1,3,0,1,0,66.21
屏東縣,新園鄉,田洋村,451,1,712,3,715,1030,3,1,3,0,1,0,69.42
屏東縣,新園鄉,港墘村,452,1,517,3,520,764,3,1,3,0,1,0,68.06
屏東縣,新園鄉,內庄村,453,1,573,4,577,809,3,1,3,0,1,0,71.32
屏東縣,新園鄉,新東村,454,1,812,5,817,1226,3,1,3,0,1,0,66.64
屏東縣,新園鄉,新東村,455,1,627,3,630,1006,3,1,3,0,1,0,62.62
屏東縣,新園鄉,新園村,456,1,628,2,630,972,3,1,3,0,1,0,64.81
屏東縣,新園鄉,新園村,457,1,717,3,720,1075,3,1,3,0,1,0,66.98
屏東縣,新園鄉,港西村,458,1,782,3,785,1048,3,1,3,0,1,0,74.9
屏東縣,新園鄉,港西村,459,1,786,3,789,1124,3,1,3,0,1,0,70.2
屏東縣,新園鄉,五房村,460,1,655,6,661,956,3,1,3,0,1,0,69.14
屏東縣,新園鄉,五房村,461,1,559,2,561,854,3,1,3,0,1,0,65.69
屏東縣,新園鄉,五房村,462,1,684,2,686,1101,3,1,3,0,1,0,62.31
屏東縣,新園鄉,烏龍村,463,1,890,5,895,1265,3,1,3,0,1,0,70.75
屏東縣,新園鄉,興龍村,464,1,633,9,642,1014,3,1,3,0,1,0,63.31
屏東縣,新園鄉,興龍村,465,1,750,2,752,1175,3,1,3,0,1,0,64
屏東縣,新園鄉,中洲村,466,1,607,4,611,923,3,1,3,0,1,0,66.2
屏東縣,新園鄉,中洲村,467,1,481,4,485,772,3,1,3,0,1,0,62.82
屏東縣,新園鄉,南龍村,468,1,895,9,904,1421,3,1,3,0,1,0,63.62
屏東縣,新園鄉,鹽埔村,469,1,809,4,813,1424,3,1,3,0,1,0,57.09
屏東縣,新園鄉,鹽埔村,470,1,828,5,833,1388,3,1,3,0,1,0,60.01
屏東縣,新園鄉,鹽埔村,471,1,750,0,750,1303,3,1,3,0,1,0,57.56
屏東縣,新園鄉,共和村,472,1,626,6,632,1074,3,1,3,0,1,0,58.85
屏東縣,新園鄉,共和村,473,1,674,7,681,1166,3,1,3,0,1,0,58.4
屏東縣,崁頂鄉,崁頂村,474,1,1292,5,1297,2062,3,1,3,0,1,0,62.9
屏東縣,崁頂鄉,園寮村,475,1,980,4,984,1695,3,1,3,0,1,0,58.05
屏東縣,崁頂鄉,力社村,476,1,778,10,788,1157,3,1,3,0,1,0,68.11
屏東縣,崁頂鄉,圍內村,477,1,783,4,787,1161,3,1,3,0,1,0,67.79
屏東縣,崁頂鄉,洲子村,478,1,636,5,641,931,3,1,3,0,1,0,68.85
屏東縣,崁頂鄉,北勢村,479,1,969,11,980,1488,3,1,3,0,1,0,65.86
屏東縣,崁頂鄉,越溪村,480,1,534,2,536,818,3,1,3,0,1,0,65.53
屏東縣,崁頂鄉,港東村,481,1,1079,9,1088,1786,3,1,3,0,1,0,60.92
屏東縣,林邊鄉,林邊村,482,1,885,2,887,1473,3,1,3,0,1,0,60.22
屏東縣,林邊鄉,光林村,483,1,944,7,951,1628,3,1,3,0,1,0,58.42
屏東縣,林邊鄉,中林村,484,1,506,4,510,822,3,1,3,0,1,0,62.04
屏東縣,林邊鄉,仁和村,485,1,972,2,974,1558,3,1,3,0,1,0,62.52
屏東縣,林邊鄉,永樂村,486,1,963,6,969,1525,3,1,3,0,1,0,63.54
屏東縣,林邊鄉,永樂村,487,1,1070,5,1075,1734,3,1,3,0,1,0,62
屏東縣,林邊鄉,田厝村,488,1,587,4,591,911,3,1,3,0,1,0,64.87
屏東縣,林邊鄉,崎峰村,489,1,658,6,664,1344,3,1,3,0,1,0,49.4
屏東縣,林邊鄉,水利村,490,1,1029,10,1039,1895,3,1,3,0,1,0,54.83
屏東縣,林邊鄉,竹林村,491,1,979,2,981,1508,3,1,3,0,1,0,65.05
屏東縣,林邊鄉,竹林村,492,1,745,10,755,1294,3,1,3,0,1,0,58.35
屏東縣,林邊鄉,鎮安村,493,1,749,5,754,1146,3,1,3,0,1,0,65.79
屏東縣,南州鄉,溪洲村,494,1,1185,8,1193,1775,3,1,3,0,1,0,67.21
屏東縣,南州鄉,溪南村,495,1,651,7,658,986,3,1,3,0,1,0,66.73
屏東縣,南州鄉,仁里村,496,1,350,0,350,526,3,1,3,0,1,0,66.54
屏東縣,南州鄉,溪北村,497,1,496,4,500,761,3,1,3,0,1,0,65.7
屏東縣,南州鄉,七塊村,498,1,656,5,661,1051,3,1,3,0,1,0,62.89
屏東縣,南州鄉,萬華村,499,1,638,8,646,1001,3,1,3,0,1,0,64.54
屏東縣,南州鄉,米崙村,500,1,641,2,643,1015,3,1,3,0,1,0,63.35
屏東縣,南州鄉,壽元村,501,1,693,5,698,1149,3,1,3,0,1,0,60.75
屏東縣,南州鄉,同安村,502,1,587,8,595,965,3,1,3,0,1,0,61.66
屏東縣,南州鄉,南安村,503,1,381,1,382,586,3,1,3,0,1,0,65.19
屏東縣,佳冬鄉,佳冬村,504,1,1020,5,1025,1492,3,1,3,0,1,0,68.7
屏東縣,佳冬鄉,六根村,505,1,1044,14,1058,1622,3,1,3,0,1,0,65.23
屏東縣,佳冬鄉,賴家村,506,1,614,1,615,922,3,1,3,0,1,0,66.7
屏東縣,佳冬鄉,萬建村,507,1,1091,4,1095,1672,3,1,3,0,1,0,65.49
屏東縣,佳冬鄉,石光村,508,1,1210,3,1213,1958,3,1,3,0,1,0,61.95
屏東縣,佳冬鄉,玉光村,509,1,611,4,615,952,3,1,3,0,1,0,64.6
屏東縣,佳冬鄉,玉光村,510,1,774,3,777,1268,3,1,3,0,1,0,61.28
屏東縣,佳冬鄉,昌隆村,511,1,818,7,825,1122,3,1,3,0,1,0,73.53
屏東縣,佳冬鄉,豐隆村,512,1,583,5,588,830,3,1,3,0,1,0,70.84
屏東縣,佳冬鄉,大同村,513,1,820,3,823,1187,3,1,3,0,1,0,69.33
屏東縣,佳冬鄉,羌園村,514,1,695,5,700,1038,3,1,3,0,1,0,67.44
屏東縣,佳冬鄉,燄溫村,515,1,719,5,724,1131,3,1,3,0,1,0,64.01
屏東縣,佳冬鄉,塭豐村,516,1,634,0,634,1074,3,1,3,0,1,0,59.03
屏東縣,佳冬鄉,塭豐村,517,1,766,3,769,1216,3,1,3,0,1,0,63.24
屏東縣,琉球鄉,本福村,518,1,1001,8,1009,1963,3,1,3,0,1,0,51.4
屏東縣,琉球鄉,中福村,519,1,586,2,588,1101,3,1,3,0,1,0,53.41
屏東縣,琉球鄉,漁福村,520,1,472,3,475,928,3,1,3,0,1,0,51.19
屏東縣,琉球鄉,大福村,521,1,703,0,703,1521,3,1,3,0,1,0,46.22
屏東縣,琉球鄉,南福村,522,1,525,6,531,1169,3,1,3,0,1,0,45.42
屏東縣,琉球鄉,天福村,523,1,460,3,463,1048,3,1,3,0,1,0,44.18
屏東縣,琉球鄉,上福村,524,1,685,5,690,1496,3,1,3,0,1,0,46.12
屏東縣,琉球鄉,杉福村,525,1,391,4,395,778,3,1,3,0,1,0,50.77
屏東縣,車城鄉,福興村,526,1,365,1,366,536,3,1,3,0,1,0,68.28
屏東縣,車城鄉,福興村,527,1,531,6,537,813,3,1,3,0,1,0,66.05
屏東縣,車城鄉,福安村,528,1,425,3,428,589,3,1,3,0,1,0,72.67
屏東縣,車城鄉,田中村,529,1,430,6,436,711,3,1,3,0,1,0,61.32
屏東縣,車城鄉,海口村,530,1,468,6,474,763,3,1,3,0,1,0,62.12
屏東縣,車城鄉,統埔村,531,1,262,1,263,428,3,1,3,0,1,0,61.45
屏東縣,車城鄉,溫泉村,532,1,547,11,558,965,3,1,3,0,1,0,57.82
屏東縣,車城鄉,保力村,533,1,372,7,379,655,3,1,3,0,1,0,57.86
屏東縣,車城鄉,保力村,534,1,354,3,357,658,3,1,3,0,1,0,54.26
屏東縣,車城鄉,新街村,535,1,281,1,282,415,3,1,3,0,1,0,67.95
屏東縣,車城鄉,埔墘村,536,1,265,1,266,455,3,1,3,0,1,0,58.46
屏東縣,車城鄉,射寮村,537,1,312,3,315,513,3,1,3,0,1,0,61.4
屏東縣,車城鄉,後灣村,538,1,288,3,291,477,3,1,3,0,1,0,61.01
屏東縣,滿州鄉,滿州村,539,1,649,5,654,1246,3,1,3,0,1,0,52.49
屏東縣,滿州鄉,永靖村,540,1,539,25,564,1073,3,1,3,0,1,0,52.56
屏東縣,滿州鄉,港口村,541,1,570,20,590,1056,3,1,3,0,1,0,55.87
屏東縣,滿州鄉,響林村,542,1,248,1,249,435,3,1,3,0,1,0,57.24
屏東縣,滿州鄉,里德村,543,1,116,8,124,251,3,1,3,0,1,0,49.4
屏東縣,滿州鄉,長樂村,544,1,294,4,298,612,3,1,3,0,1,0,48.69
屏東縣,滿州鄉,九棚村,545,1,110,1,111,238,3,1,3,0,1,0,46.64
屏東縣,滿州鄉,港仔村,546,1,164,7,171,306,3,1,3,0,1,0,55.88
屏東縣,枋山鄉,加祿村,547,1,578,2,580,883,3,1,3,0,1,0,65.69
屏東縣,枋山鄉,加祿村,548,1,575,6,581,886,3,1,3,0,1,0,65.58
屏東縣,枋山鄉,枋山村,549,1,359,0,359,564,3,1,3,0,1,0,63.65
屏東縣,枋山鄉,枋山村,550,1,272,0,272,462,3,1,3,0,1,0,58.87
屏東縣,枋山鄉,楓港村,551,1,545,5,550,1040,3,1,3,0,1,0,52.88
屏東縣,枋山鄉,善餘村,552,1,488,1,489,963,3,1,3,0,1,0,50.78
屏東縣,三地門鄉,三地村,553,1,55,2,57,105,3,1,3,0,1,0,54.29
屏東縣,三地門鄉,達來村,554,1,2,0,2,12,3,1,3,0,1,0,16.67
屏東縣,三地門鄉,德文村,555,1,4,0,4,14,3,1,3,0,1,0,28.57
屏東縣,三地門鄉,大社村,556,1,4,0,4,15,3,1,3,0,1,0,26.67
屏東縣,三地門鄉,賽嘉村,557,1,15,1,16,46,3,1,3,0,1,0,34.78
屏東縣,三地門鄉,口社村,558,1,23,0,23,39,3,1,3,0,1,0,58.97
屏東縣,三地門鄉,馬兒村,559,1,5,0,5,12,3,1,3,0,1,0,41.67
屏東縣,三地門鄉,安坡村,560,1,18,0,18,30,3,1,3,0,1,0,60
屏東縣,三地門鄉,青山村,561,1,32,2,34,68,3,1,3,0,1,0,50
屏東縣,三地門鄉,青葉村,562,1,18,1,19,42,3,1,3,0,1,0,45.24
屏東縣,霧臺鄉,霧臺村,563,1,3,0,3,5,3,1,3,0,1,0,60
屏東縣,霧臺鄉,霧臺村,564,1,4,0,4,11,3,1,3,0,1,0,36.36
屏東縣,霧臺鄉,霧臺村,565,1,5,1,6,11,3,1,3,0,1,0,54.55
屏東縣,霧臺鄉,吉露村,566,1,2,0,2,3,3,1,3,0,1,0,66.67
屏東縣,霧臺鄉,阿禮村,567,1,2,0,2,4,3,1,3,0,1,0,50
屏東縣,霧臺鄉,大武村,568,1,3,0,3,17,3,1,3,0,1,0,17.65
屏東縣,霧臺鄉,佳暮村,569,1,2,0,2,4,3,1,3,0,1,0,50
屏東縣,霧臺鄉,好茶村,570,1,2,0,2,5,3,1,3,0,1,0,40
屏東縣,瑪家鄉,瑪家村,571,1,8,0,8,15,3,1,3,0,1,0,53.33
屏東縣,瑪家鄉,北葉村,572,1,41,1,42,68,3,1,3,0,1,0,61.76
屏東縣,瑪家鄉,涼山村,573,1,30,0,30,56,3,1,3,0,1,0,53.57
屏東縣,瑪家鄉,佳義村,574,1,25,0,25,49,3,1,3,0,1,0,51.02
屏東縣,瑪家鄉,排灣村,575,1,6,0,6,15,3,1,3,0,1,0,40
屏東縣,瑪家鄉,三和村,576,1,16,1,17,31,3,1,3,0,1,0,54.84
屏東縣,瑪家鄉,三和村,577,1,20,0,20,40,3,1,3,0,1,0,50
屏東縣,瑪家鄉,三和村,578,1,18,0,18,38,3,1,3,0,1,0,47.37
屏東縣,泰武鄉,佳平村,579,1,16,0,16,34,3,1,3,0,1,0,47.06
屏東縣,泰武鄉,佳平村,580,1,9,0,9,12,3,1,3,0,1,0,75
屏東縣,泰武鄉,武潭村,581,1,17,0,17,38,3,1,3,0,1,0,44.74
屏東縣,泰武鄉,平和村,582,1,9,0,9,23,3,1,3,0,1,0,39.13
屏東縣,泰武鄉,佳興村,583,1,7,0,7,10,3,1,3,0,1,0,70
屏東縣,泰武鄉,泰武村,584,1,1,0,1,9,3,1,3,0,1,0,11.11
屏東縣,泰武鄉,萬安村,585,1,8,0,8,27,3,1,3,0,1,0,29.63
屏東縣,來義鄉,來義村,586,1,7,0,7,20,3,1,3,0,1,0,35
屏東縣,來義鄉,義林村,587,1,10,0,10,16,3,1,3,0,1,0,62.5
屏東縣,來義鄉,義林村,588,1,3,0,3,5,3,1,3,0,1,0,60
屏東縣,來義鄉,丹林村,589,1,16,0,16,35,3,1,3,0,1,0,45.71
屏東縣,來義鄉,丹林村,590,1,5,0,5,12,3,1,3,0,1,0,41.67
屏東縣,來義鄉,古樓村,591,1,21,1,22,58,3,1,3,0,1,0,37.93
屏東縣,來義鄉,文樂村,592,1,16,0,16,33,3,1,3,0,1,0,48.48
屏東縣,來義鄉,望嘉村,593,1,30,0,30,43,3,1,3,0,1,0,69.77
屏東縣,來義鄉,南和村,594,1,22,1,23,44,3,1,3,0,1,0,52.27
屏東縣,春日鄉,春日村,595,1,14,0,14,49,3,1,3,0,1,0,28.57
屏東縣,春日鄉,古華村,596,1,16,0,16,43,3,1,3,0,1,0,37.21
屏東縣,春日鄉,士文村,597,1,5,0,5,12,3,1,3,0,1,0,41.67
屏東縣,春日鄉,歸崇村,598,1,61,1,62,110,3,1,3,0,1,0,56.36
屏東縣,春日鄉,七佳村,599,1,49,0,49,92,3,1,3,0,1,0,53.26
屏東縣,春日鄉,力里村,600,1,6,0,6,14,3,1,3,0,1,0,42.86
屏東縣,獅子鄉,楓林村,601,1,28,0,28,57,3,1,3,0,1,0,49.12
屏東縣,獅子鄉,丹路村,602,1,29,0,29,70,3,1,3,0,1,0,41.43
屏東縣,獅子鄉,草埔村,603,1,13,0,13,35,3,1,3,0,1,0,37.14
屏東縣,獅子鄉,內文村,604,1,11,0,11,25,3,1,3,0,1,0,44
屏東縣,獅子鄉,竹坑村,605,1,7,0,7,25,3,1,3,0,1,0,28
屏東縣,獅子鄉,獅子村,606,1,8,0,8,23,3,1,3,0,1,0,34.78
屏東縣,獅子鄉,內獅村,607,1,16,0,16,34,3,1,3,0,1,0,47.06
屏東縣,獅子鄉,南世村,608,1,7,0,7,20,3,1,3,0,1,0,35
屏東縣,牡丹鄉,石門村,609,1,57,0,57,102,3,1,3,0,1,0,55.88
屏東縣,牡丹鄉,石門村,610,1,25,0,25,41,3,1,3,0,1,0,60.98
屏東縣,牡丹鄉,牡丹村,611,1,8,0,8,22,3,1,3,0,1,0,36.36
屏東縣,牡丹鄉,東源村,612,1,11,0,11,19,3,1,3,0,1,0,57.89
屏東縣,牡丹鄉,旭海村,613,1,47,0,47,97,3,1,3,0,1,0,48.45
屏東縣,牡丹鄉,高士村,614,1,21,1,22,31,3,1,3,0,1,0,70.97
屏東縣,牡丹鄉,四林村,615,1,11,0,11,23,3,1,3,0,1,0,47.83
臺東縣,台東市,文化里,1,1,502,4,506,983,3,1,3,0,1,0,51.48
臺東縣,台東市,民族里,2,1,813,8,821,1429,3,1,3,0,1,0,57.45
臺東縣,台東市,自強里,3,1,850,4,854,1566,3,1,3,0,1,0,54.53
臺東縣,台東市,自強里,4,1,1031,1,1032,1875,3,1,3,0,1,0,55.04
臺東縣,台東市,民生里,5,1,831,5,836,1570,3,1,3,0,1,0,53.25
臺東縣,台東市,民生里,6,1,645,5,650,1263,3,1,3,0,1,0,51.46
臺東縣,台東市,寶桑里,7,1,361,3,364,739,3,1,3,0,1,0,49.26
臺東縣,台東市,民權里,8,1,571,2,573,1062,3,1,3,0,1,0,53.95
臺東縣,台東市,四維里,9,1,209,1,210,434,3,1,3,0,1,0,48.39
臺東縣,台東市,中華里,10,1,815,2,817,1588,3,1,3,0,1,0,51.45
臺東縣,台東市,仁愛里,11,1,429,2,431,719,3,1,3,0,1,0,59.94
臺東縣,台東市,強國里,12,1,320,4,324,569,3,1,3,0,1,0,56.94
臺東縣,台東市,大同里,13,1,367,7,374,743,3,1,3,0,1,0,50.34
臺東縣,台東市,成功里,14,1,427,3,430,821,3,1,3,0,1,0,52.38
臺東縣,台東市,建國里,15,1,653,2,655,1328,3,1,3,0,1,0,49.32
臺東縣,台東市,中正里,16,1,495,1,496,894,3,1,3,0,1,0,55.48
臺東縣,台東市,中山里,17,1,524,1,525,918,3,1,3,0,1,0,57.19
臺東縣,台東市,興國里,18,1,394,1,395,733,3,1,3,0,1,0,53.89
臺東縣,台東市,鐵花里,19,1,228,1,229,431,3,1,3,0,1,0,53.13
臺東縣,台東市,東海里,20,1,646,3,649,1191,3,1,3,0,1,0,54.49
臺東縣,台東市,東海里,21,1,946,2,948,1696,3,1,3,0,1,0,55.90
臺東縣,台東市,復國里,22,1,348,4,352,681,3,1,3,0,1,0,51.69
臺東縣,台東市,復興里,23,1,229,3,232,440,3,1,3,0,1,0,52.73
臺東縣,台東市,新興里,24,1,591,1,592,1118,3,1,3,0,1,0,52.95
臺東縣,台東市,新生里,25,1,619,5,624,1217,3,1,3,0,1,0,51.27
臺東縣,台東市,新生里,26,1,921,4,925,1770,3,1,3,0,1,0,52.26
臺東縣,台東市,新生里,27,1,884,5,889,1737,3,1,3,0,1,0,51.18
臺東縣,台東市,中心里,28,1,496,0,496,930,3,1,3,0,1,0,53.33
臺東縣,台東市,中心里,29,1,739,3,742,1282,3,1,3,0,1,0,57.88
臺東縣,台東市,馬蘭里,30,1,728,3,731,1315,3,1,3,0,1,0,55.59
臺東縣,台東市,馬蘭里,31,1,681,3,684,1271,3,1,3,0,1,0,53.82
臺東縣,台東市,光明里,32,1,837,3,840,1616,3,1,3,0,1,0,51.98
臺東縣,台東市,豐年里,33,1,307,0,307,604,3,1,3,0,1,0,50.83
臺東縣,台東市,豐年里,34,1,573,2,575,1103,3,1,3,0,1,0,52.13
臺東縣,台東市,豐樂里,35,1,504,1,505,946,3,1,3,0,1,0,53.38
臺東縣,台東市,永樂里,36,1,622,2,624,1181,3,1,3,0,1,0,52.84
臺東縣,台東市,康樂里,37,1,603,2,605,1114,3,1,3,0,1,0,54.31
臺東縣,台東市,豐榮里,38,1,771,3,774,1504,3,1,3,0,1,0,51.46
臺東縣,台東市,豐榮里,39,1,703,4,707,1443,3,1,3,0,1,0,49.00
臺東縣,台東市,豐榮里,40,1,715,4,719,1436,3,1,3,0,1,0,50.07
臺東縣,台東市,豐榮里,41,1,697,5,702,1412,3,1,3,0,1,0,49.72
臺東縣,台東市,豐谷里,42,1,520,2,522,1028,3,1,3,0,1,0,50.78
臺東縣,台東市,豐谷里,43,1,427,4,431,903,3,1,3,0,1,0,47.73
臺東縣,台東市,豐谷里,44,1,572,4,576,1194,3,1,3,0,1,0,48.24
臺東縣,台東市,豐里里,45,1,828,8,836,1609,3,1,3,0,1,0,51.96
臺東縣,台東市,豐原里,46,1,499,6,505,956,3,1,3,0,1,0,52.82
臺東縣,台東市,富岡里,47,1,596,5,601,1143,3,1,3,0,1,0,52.58
臺東縣,台東市,富豐里,48,1,221,5,226,480,3,1,3,0,1,0,47.08
臺東縣,台東市,南榮里,49,1,536,7,543,910,3,1,3,0,1,0,59.67
臺東縣,台東市,南榮里,50,1,272,0,272,532,3,1,3,0,1,0,51.13
臺東縣,台東市,岩灣里,51,1,507,4,511,1083,3,1,3,0,1,0,47.18
臺東縣,台東市,卑南里,52,1,640,1,641,1075,3,1,3,0,1,0,59.63
臺東縣,台東市,卑南里,53,1,546,2,548,950,3,1,3,0,1,0,57.68
臺東縣,台東市,南王里,54,1,448,0,448,848,3,1,3,0,1,0,52.83
臺東縣,台東市,南王里,55,1,341,1,342,622,3,1,3,0,1,0,54.98
臺東縣,台東市,豐田里,56,1,492,3,495,824,3,1,3,0,1,0,60.07
臺東縣,台東市,豐田里,57,1,465,2,467,872,3,1,3,0,1,0,53.56
臺東縣,台東市,新園里,58,1,467,2,469,943,3,1,3,0,1,0,49.73
臺東縣,台東市,建和里,59,1,393,1,394,785,3,1,3,0,1,0,50.19
臺東縣,台東市,建興里,60,1,498,0,498,862,3,1,3,0,1,0,57.77
臺東縣,台東市,建業里,61,1,435,0,435,804,3,1,3,0,1,0,54.10
臺東縣,台東市,知本里,62,1,431,4,435,872,3,1,3,0,1,0,49.89
臺東縣,台東市,建農里,63,1,497,7,504,1117,3,1,3,0,1,0,45.12
臺東縣,成功鎮,信義里,64,1,73,0,73,184,3,1,3,0,1,0,39.67
臺東縣,成功鎮,信義里,65,1,61,1,62,153,3,1,3,0,1,0,40.52
臺東縣,成功鎮,信義里,66,1,35,0,35,89,3,1,3,0,1,0,39.33
臺東縣,成功鎮,和平里,67,1,61,0,61,138,3,1,3,0,1,0,44.20
臺東縣,成功鎮,忠仁里,68,1,36,0,36,97,3,1,3,0,1,0,37.11
臺東縣,成功鎮,忠仁里,69,1,524,1,525,1028,3,1,3,0,1,0,51.07
臺東縣,成功鎮,忠智里,70,1,704,4,708,1341,3,1,3,0,1,0,52.80
臺東縣,成功鎮,忠智里,71,1,579,0,579,1047,3,1,3,0,1,0,55.30
臺東縣,成功鎮,三民里,72,1,175,1,176,389,3,1,3,0,1,0,45.24
臺東縣,成功鎮,三民里,73,1,361,2,363,717,3,1,3,0,1,0,50.63
臺東縣,成功鎮,三仙里,74,1,97,0,97,195,3,1,3,0,1,0,49.74
臺東縣,成功鎮,三仙里,75,1,139,0,139,366,3,1,3,0,1,0,37.98
臺東縣,成功鎮,忠孝里,76,1,97,0,97,227,3,1,3,0,1,0,42.73
臺東縣,成功鎮,忠孝里,77,1,102,1,103,251,3,1,3,0,1,0,41.04
臺東縣,成功鎮,博愛里,78,1,26,0,26,51,3,1,3,0,1,0,50.98
臺東縣,成功鎮,博愛里,79,1,17,0,17,40,3,1,3,0,1,0,42.50
臺東縣,關山鎮,里壟里,80,1,489,5,494,865,3,1,3,0,1,0,57.11
臺東縣,關山鎮,里壟里,81,1,345,2,347,699,3,1,3,0,1,0,49.64
臺東縣,關山鎮,中福里,82,1,508,8,516,850,3,1,3,0,1,0,60.71
臺東縣,關山鎮,新福里,83,1,353,3,356,647,3,1,3,0,1,0,55.02
臺東縣,關山鎮,豐泉里,84,1,524,2,526,953,3,1,3,0,1,0,55.19
臺東縣,關山鎮,月眉里,85,1,346,2,348,654,3,1,3,0,1,0,53.21
臺東縣,關山鎮,德高里,86,1,245,2,247,484,3,1,3,0,1,0,51.03
臺東縣,關山鎮,德高里,87,1,399,5,404,716,3,1,3,0,1,0,56.42
臺東縣,關山鎮,電光里,88,1,106,0,106,214,3,1,3,0,1,0,49.53
臺東縣,卑南鄉,賓朗村,89,1,489,3,492,849,3,1,3,0,1,0,57.95
臺東縣,卑南鄉,賓朗村,90,1,422,2,424,852,3,1,3,0,1,0,49.77
臺東縣,卑南鄉,美農村,91,1,126,1,127,244,3,1,3,0,1,0,52.05
臺東縣,卑南鄉,美農村,92,1,237,0,237,426,3,1,3,0,1,0,55.63
臺東縣,卑南鄉,美農村,93,1,142,0,142,304,3,1,3,0,1,0,46.71
臺東縣,卑南鄉,初鹿村,94,1,241,2,243,551,3,1,3,0,1,0,44.10
臺東縣,卑南鄉,初鹿村,95,1,224,1,225,443,3,1,3,0,1,0,50.79
臺東縣,卑南鄉,明峰村,96,1,337,2,339,729,3,1,3,0,1,0,46.50
臺東縣,卑南鄉,明峰村,97,1,145,1,146,311,3,1,3,0,1,0,46.95
臺東縣,卑南鄉,嘉豐村,98,1,84,1,85,194,3,1,3,0,1,0,43.81
臺東縣,卑南鄉,嘉豐村,99,1,16,0,16,33,3,1,3,0,1,0,48.48
臺東縣,卑南鄉,太平村,100,1,674,2,676,1300,3,1,3,0,1,0,52.00
臺東縣,卑南鄉,太平村,101,1,362,6,368,667,3,1,3,0,1,0,55.17
臺東縣,卑南鄉,太平村,102,1,357,1,358,669,3,1,3,0,1,0,53.51
臺東縣,卑南鄉,泰安村,103,1,311,5,316,649,3,1,3,0,1,0,48.69
臺東縣,卑南鄉,利嘉村,104,1,204,1,205,410,3,1,3,0,1,0,50.00
臺東縣,卑南鄉,東興村,105,1,103,1,104,218,3,1,3,0,1,0,47.71
臺東縣,卑南鄉,溫泉村,106,1,472,6,478,862,3,1,3,0,1,0,55.45
臺東縣,卑南鄉,溫泉村,107,1,84,1,85,185,3,1,3,0,1,0,45.95
臺東縣,卑南鄉,富山村,108,1,219,2,221,428,3,1,3,0,1,0,51.64
臺東縣,卑南鄉,富源村,109,1,216,1,217,351,3,1,3,0,1,0,61.82
臺東縣,卑南鄉,利吉村,110,1,126,1,127,254,3,1,3,0,1,0,50.00
臺東縣,鹿野鄉,鹿野村,111,1,82,0,82,200,3,1,3,0,1,0,41.00
臺東縣,鹿野鄉,鹿野村,112,1,278,1,279,525,3,1,3,0,1,0,53.14
臺東縣,鹿野鄉,龍田村,113,1,545,3,548,1056,3,1,3,0,1,0,51.89
臺東縣,鹿野鄉,永安村,114,1,338,3,341,798,3,1,3,0,1,0,42.73
臺東縣,鹿野鄉,永安村,115,1,113,0,113,235,3,1,3,0,1,0,48.09
臺東縣,鹿野鄉,瑞隆村,116,1,368,3,371,754,3,1,3,0,1,0,49.20
臺東縣,鹿野鄉,瑞源村,117,1,312,1,313,593,3,1,3,0,1,0,52.78
臺東縣,鹿野鄉,瑞和村,118,1,174,0,174,341,3,1,3,0,1,0,51.03
臺東縣,鹿野鄉,瑞豐村,119,1,217,0,217,442,3,1,3,0,1,0,49.10
臺東縣,鹿野鄉,瑞豐村,120,1,277,5,282,529,3,1,3,0,1,0,53.31
臺東縣,池上鄉,福原村,121,1,471,3,474,929,3,1,3,0,1,0,51.02
臺東縣,池上鄉,福原村,122,1,487,0,487,910,3,1,3,0,1,0,53.52
臺東縣,池上鄉,福文村,123,1,280,1,281,576,3,1,3,0,1,0,48.78
臺東縣,池上鄉,福文村,124,1,268,2,270,615,3,1,3,0,1,0,43.90
臺東縣,池上鄉,慶豐村,125,1,292,0,292,633,3,1,3,0,1,0,46.13
臺東縣,池上鄉,大坡村,126,1,35,1,36,104,3,1,3,0,1,0,34.62
臺東縣,池上鄉,大埔村,127,1,228,0,228,400,3,1,3,0,1,0,57.00
臺東縣,池上鄉,新興村,128,1,368,1,369,741,3,1,3,0,1,0,49.80
臺東縣,池上鄉,錦園村,129,1,192,1,193,392,3,1,3,0,1,0,49.23
臺東縣,池上鄉,萬安村,130,1,174,4,178,353,3,1,3,0,1,0,50.42
臺東縣,池上鄉,富興村,131,1,149,3,152,330,3,1,3,0,1,0,46.06
臺東縣,池上鄉,振興村,132,1,57,0,57,142,3,1,3,0,1,0,40.14
臺東縣,東河鄉,都蘭村,133,1,125,1,126,274,3,1,3,0,1,0,45.99
臺東縣,東河鄉,都蘭村,134,1,222,4,226,414,3,1,3,0,1,0,54.59
臺東縣,東河鄉,都蘭村,135,1,240,1,241,520,3,1,3,0,1,0,46.35
臺東縣,東河鄉,興昌村,136,1,298,1,299,566,3,1,3,0,1,0,52.83
臺東縣,東河鄉,隆昌村,137,1,93,1,94,201,3,1,3,0,1,0,46.77
臺東縣,東河鄉,東河村,138,1,127,0,127,323,3,1,3,0,1,0,39.32
臺東縣,東河鄉,泰源村,139,1,312,2,314,618,3,1,3,0,1,0,50.81
臺東縣,東河鄉,北源村,140,1,147,1,148,385,3,1,3,0,1,0,38.44
臺東縣,東河鄉,北源村,141,1,91,0,91,202,3,1,3,0,1,0,45.05
臺東縣,東河鄉,北源村,142,1,157,1,158,280,3,1,3,0,1,0,56.43
臺東縣,東河鄉,尚德村,143,1,77,1,78,180,3,1,3,0,1,0,43.33
臺東縣,長濱鄉,寧埔村,144,1,38,0,38,89,3,1,3,0,1,0,42.70
臺東縣,長濱鄉,寧埔村,145,1,95,0,95,248,3,1,3,0,1,0,38.31
臺東縣,長濱鄉,竹湖村,146,1,146,0,146,360,3,1,3,0,1,0,40.56
臺東縣,長濱鄉,長濱村,147,1,491,5,496,1080,3,1,3,0,1,0,45.93
臺東縣,長濱鄉,長濱村,148,1,77,1,78,200,3,1,3,0,1,0,39.00
臺東縣,長濱鄉,忠勇村,149,1,200,1,201,503,3,1,3,0,1,0,39.96
臺東縣,長濱鄉,三間村,150,1,74,0,74,183,3,1,3,0,1,0,40.44
臺東縣,長濱鄉,三間村,151,1,41,0,41,80,3,1,3,0,1,0,51.25
臺東縣,長濱鄉,樟原村,152,1,62,0,62,128,3,1,3,0,1,0,48.44
臺東縣,長濱鄉,樟原村,153,1,119,2,121,255,3,1,3,0,1,0,47.45
臺東縣,太麻里鄉,美和村,154,1,460,1,461,904,3,1,3,0,1,0,51.00
臺東縣,太麻里鄉,三和村,155,1,322,0,322,620,3,1,3,0,1,0,51.94
臺東縣,太麻里鄉,華源村,156,1,371,2,373,681,3,1,3,0,1,0,54.77
臺東縣,太麻里鄉,北里村,157,1,196,0,196,385,3,1,3,0,1,0,50.91
臺東縣,太麻里鄉,大王村,158,1,265,1,266,479,3,1,3,0,1,0,55.53
臺東縣,太麻里鄉,大王村,159,1,311,1,312,676,3,1,3,0,1,0,46.15
臺東縣,太麻里鄉,泰和村,160,1,434,2,436,765,3,1,3,0,1,0,56.99
臺東縣,太麻里鄉,泰和村,161,1,240,0,240,459,3,1,3,0,1,0,52.29
臺東縣,太麻里鄉,香蘭村,162,1,175,3,178,367,3,1,3,0,1,0,48.50
臺東縣,太麻里鄉,香蘭村,163,1,54,1,55,95,3,1,3,0,1,0,57.89
臺東縣,太麻里鄉,金崙村,164,1,75,2,77,157,3,1,3,0,1,0,49.04
臺東縣,太麻里鄉,金崙村,165,1,97,1,98,208,3,1,3,0,1,0,47.12
臺東縣,太麻里鄉,金崙村,166,1,24,0,24,52,3,1,3,0,1,0,46.15
臺東縣,太麻里鄉,多良村,167,1,7,0,7,14,3,1,3,0,1,0,50.00
臺東縣,太麻里鄉,多良村,168,1,89,0,89,198,3,1,3,0,1,0,44.95
臺東縣,大武鄉,南興村,169,1,134,1,135,359,3,1,3,0,1,0,37.60
臺東縣,大武鄉,尚武村,170,1,533,4,537,1449,3,1,3,0,1,0,37.06
臺東縣,大武鄉,大武村,171,1,443,6,449,1056,3,1,3,0,1,0,42.52
臺東縣,大武鄉,大鳥村,172,1,26,0,26,93,3,1,3,0,1,0,27.96
臺東縣,大武鄉,大竹村,173,1,13,0,13,47,3,1,3,0,1,0,27.66
臺東縣,大武鄉,大竹村,174,1,19,0,19,50,3,1,3,0,1,0,38.00
臺東縣,綠島鄉,南寮村,175,1,358,0,358,806,3,1,3,0,1,0,44.42
臺東縣,綠島鄉,中寮村,176,1,323,1,324,873,3,1,3,0,1,0,37.11
臺東縣,綠島鄉,公館村,177,1,180,3,183,453,3,1,3,0,1,0,40.40
臺東縣,綠島鄉,公館村,178,1,67,0,67,133,3,1,3,0,1,0,50.38
臺東縣,海端鄉,加拿村,179,1,12,1,13,24,3,1,3,0,1,0,54.17
臺東縣,海端鄉,崁頂村,180,1,26,0,26,51,3,1,3,0,1,0,50.98
臺東縣,海端鄉,海端村,181,1,56,0,56,110,3,1,3,0,1,0,50.91
臺東縣,海端鄉,廣原村,182,1,40,0,40,72,3,1,3,0,1,0,55.56
臺東縣,海端鄉,霧鹿村,183,1,11,1,12,20,3,1,3,0,1,0,60.00
臺東縣,海端鄉,利稻村,184,1,8,1,9,29,3,1,3,0,1,0,31.03
臺東縣,延平鄉,桃源村,185,1,49,1,50,95,3,1,3,0,1,0,52.63
臺東縣,延平鄉,紅葉村,186,1,10,0,10,23,3,1,3,0,1,0,43.48
臺東縣,延平鄉,永康村,187,1,10,0,10,20,3,1,3,0,1,0,50.00
臺東縣,延平鄉,武陵村,188,1,17,0,17,36,3,1,3,0,1,0,47.22
臺東縣,延平鄉,鸞山村,189,1,13,0,13,28,3,1,3,0,1,0,46.43
臺東縣,延平鄉,鸞山村,190,1,37,0,37,76,3,1,3,0,1,0,48.68
臺東縣,金峰鄉,嘉蘭村,191,1,28,0,28,62,3,1,3,0,1,0,45.16
臺東縣,金峰鄉,正興村,192,1,13,0,13,30,3,1,3,0,1,0,43.33
臺東縣,金峰鄉,新興村,193,1,15,1,16,24,3,1,3,0,1,0,66.67
臺東縣,金峰鄉,賓茂村,194,1,5,0,5,8,3,1,3,0,1,0,62.50
臺東縣,金峰鄉,歷坵村,195,1,7,0,7,16,3,1,3,0,1,0,43.75
臺東縣,達仁鄉,安朔村,196,1,43,0,43,100,3,1,3,0,1,0,43.00
臺東縣,達仁鄉,安朔村,197,1,17,1,18,40,3,1,3,0,1,0,45.00
臺東縣,達仁鄉,南田村,198,1,31,0,31,65,3,1,3,0,1,0,47.69
臺東縣,達仁鄉,森永村,199,1,23,0,23,59,3,1,3,0,1,0,38.98
臺東縣,達仁鄉,新化村,200,1,6,0,6,16,3,1,3,0,1,0,37.50
臺東縣,達仁鄉,台板村,201,1,8,0,8,34,3,1,3,0,1,0,23.53
臺東縣,達仁鄉,土板村,202,1,10,0,10,23,3,1,3,0,1,0,43.48
臺東縣,蘭嶼鄉,椰油村,203,1,32,0,32,105,3,1,3,0,1,0,30.48
臺東縣,蘭嶼鄉,紅頭村,204,1,46,0,46,116,3,1,3,0,1,0,39.66
臺東縣,蘭嶼鄉,東清村,205,1,9,0,9,38,3,1,3,0,1,0,23.68
臺東縣,蘭嶼鄉,朗島村,206,1,4,0,4,25,3,1,3,0,1,0,16.00
花蓮縣,花蓮市,民德里,1,1,687,3,690,1307,3,1,3,0,1,0,52.79
花蓮縣,花蓮市,民勤里,2,1,465,3,468,850,3,1,3,0,1,0,55.06
花蓮縣,花蓮市,民勤里,3,1,379,11,390,746,3,1,3,0,1,0,52.28
花蓮縣,花蓮市,民勤里,4,1,616,5,621,1194,3,1,3,0,1,0,52.01
花蓮縣,花蓮市,民意里,5,1,190,4,194,424,3,1,3,0,1,0,45.75
花蓮縣,花蓮市,民意里,6,1,577,7,584,1233,3,1,3,0,1,0,47.36
花蓮縣,花蓮市,民意里,7,1,397,6,403,723,3,1,3,0,1,0,55.74
花蓮縣,花蓮市,民心里,8,1,337,1,338,782,3,1,3,0,1,0,43.22
花蓮縣,花蓮市,民享里,9,1,350,3,353,795,3,1,3,0,1,0,44.40
花蓮縣,花蓮市,民享里,10,1,457,2,459,987,3,1,3,0,1,0,46.50
花蓮縣,花蓮市,民孝里,11,1,467,6,473,980,3,1,3,0,1,0,48.27
花蓮縣,花蓮市,民孝里,12,1,695,6,701,1264,3,1,3,0,1,0,55.46
花蓮縣,花蓮市,民運里,13,1,489,5,494,972,3,1,3,0,1,0,50.82
花蓮縣,花蓮市,民運里,14,1,446,4,450,815,3,1,3,0,1,0,55.21
花蓮縣,花蓮市,民政里,15,1,600,4,604,1256,3,1,3,0,1,0,48.09
花蓮縣,花蓮市,民政里,16,1,702,2,704,1427,3,1,3,0,1,0,49.33
花蓮縣,花蓮市,民立里,17,1,638,7,645,1201,3,1,3,0,1,0,53.71
花蓮縣,花蓮市,民樂里,18,1,233,2,235,491,3,1,3,0,1,0,47.86
花蓮縣,花蓮市,民有里,19,1,356,2,358,647,3,1,3,0,1,0,55.33
花蓮縣,花蓮市,民主里,20,1,331,4,335,571,3,1,3,0,1,0,58.67
花蓮縣,花蓮市,民治里,21,1,215,0,215,345,3,1,3,0,1,0,62.32
花蓮縣,花蓮市,民族里,22,1,312,0,312,552,3,1,3,0,1,0,56.52
花蓮縣,花蓮市,民生里,23,1,710,13,723,1342,3,1,3,0,1,0,53.87
花蓮縣,花蓮市,民權里,24,1,237,3,240,449,3,1,3,0,1,0,53.45
花蓮縣,花蓮市,主商里,25,1,374,1,375,675,3,1,3,0,1,0,55.56
花蓮縣,花蓮市,主勤里,26,1,520,8,528,976,3,1,3,0,1,0,54.10
花蓮縣,花蓮市,主工里,27,1,323,3,326,607,3,1,3,0,1,0,53.71
花蓮縣,花蓮市,主信里,28,1,395,0,395,720,3,1,3,0,1,0,54.86
花蓮縣,花蓮市,主睦里、主義里,29,1,530,4,534,1055,3,1,3,0,1,0,50.62
花蓮縣,花蓮市,主計里,30,1,408,3,411,836,3,1,3,0,1,0,49.16
花蓮縣,花蓮市,主和里,31,1,457,3,460,862,3,1,3,0,1,0,53.36
花蓮縣,花蓮市,主和里,32,1,484,6,490,985,3,1,3,0,1,0,49.75
花蓮縣,花蓮市,主和里,33,1,524,7,531,996,3,1,3,0,1,0,53.31
花蓮縣,花蓮市,主學里,34,1,389,3,392,809,3,1,3,0,1,0,48.45
花蓮縣,花蓮市,主學里,35,1,439,3,442,892,3,1,3,0,1,0,49.55
花蓮縣,花蓮市,主農里,36,1,633,4,637,1257,3,1,3,0,1,0,50.68
花蓮縣,花蓮市,主農里,37,1,760,3,763,1478,3,1,3,0,1,0,51.62
花蓮縣,花蓮市,主安里,38,1,440,3,443,890,3,1,3,0,1,0,49.78
花蓮縣,花蓮市,主安里,39,1,687,6,693,1409,3,1,3,0,1,0,49.18
花蓮縣,花蓮市,主權里,40,1,457,6,463,1029,3,1,3,0,1,0,45
花蓮縣,花蓮市,主權里,41,1,419,2,421,947,3,1,3,0,1,0,44.46
花蓮縣,花蓮市,主權里,42,1,508,4,512,1050,3,1,3,0,1,0,48.76
花蓮縣,花蓮市,主權里,43,1,540,2,542,991,3,1,3,0,1,0,54.69
花蓮縣,花蓮市,主力里,44,1,597,3,600,1225,3,1,3,0,1,0,48.98
花蓮縣,花蓮市,主力里,45,1,622,2,624,1226,3,1,3,0,1,0,50.90
花蓮縣,花蓮市,國風里,46,1,838,5,843,1573,3,1,3,0,1,0,53.59
花蓮縣,花蓮市,國風里,47,1,678,7,685,1508,3,1,3,0,1,0,45.42
花蓮縣,花蓮市,國威里,48,1,383,3,386,718,3,1,3,0,1,0,53.76
花蓮縣,花蓮市,國威里,49,1,387,6,393,974,3,1,3,0,1,0,40.35
花蓮縣,花蓮市,國治里,50,1,477,4,481,1002,3,1,3,0,1,0,48.00
花蓮縣,花蓮市,國安里,51,1,263,3,266,495,3,1,3,0,1,0,53.74
花蓮縣,花蓮市,國光里,52,1,667,6,673,1225,3,1,3,0,1,0,54.94
花蓮縣,花蓮市,國防里,53,1,415,7,422,799,3,1,3,0,1,0,52.82
花蓮縣,花蓮市,國華里,54,1,563,6,569,1159,3,1,3,0,1,0,49.09
花蓮縣,花蓮市,國華里,55,1,423,0,423,847,3,1,3,0,1,0,49.94
花蓮縣,花蓮市,國魂里,56,1,552,1,553,1092,3,1,3,0,1,0,50.64
花蓮縣,花蓮市,國魂里,57,1,336,4,340,668,3,1,3,0,1,0,50.90
花蓮縣,花蓮市,國聯里,58,1,526,1,527,1105,3,1,3,0,1,0,47.69
花蓮縣,花蓮市,國聯里,59,1,466,2,468,1016,3,1,3,0,1,0,46.06
花蓮縣,花蓮市,國盛里,60,1,501,3,504,1236,3,1,3,0,1,0,40.78
花蓮縣,花蓮市,國盛里,61,1,552,2,554,1254,3,1,3,0,1,0,44.18
花蓮縣,花蓮市,國強里,62,1,606,5,611,1202,3,1,3,0,1,0,50.83
花蓮縣,花蓮市,國富里,63,1,667,8,675,1405,3,1,3,0,1,0,48.04
花蓮縣,花蓮市,國富里,64,1,745,3,748,1546,3,1,3,0,1,0,48.38
花蓮縣,花蓮市,國富里,65,1,658,5,663,1393,3,1,3,0,1,0,47.60
花蓮縣,花蓮市,國裕里,66,1,487,2,489,1029,3,1,3,0,1,0,47.52
花蓮縣,花蓮市,國裕里,67,1,606,7,613,1223,3,1,3,0,1,0,50.12
花蓮縣,花蓮市,國裕里,68,1,493,4,497,1033,3,1,3,0,1,0,48.11
花蓮縣,花蓮市,國慶里,69,1,383,2,385,807,3,1,3,0,1,0,47.71
花蓮縣,花蓮市,國興里,70,1,641,2,643,1574,3,1,3,0,1,0,40.85
花蓮縣,花蓮市,國興里,71,1,642,8,650,1309,3,1,3,0,1,0,49.66
花蓮縣,花蓮市,國福里,72,1,352,3,355,913,3,1,3,0,1,0,38.88
花蓮縣,新城鄉,新城村,73,1,187,2,189,344,3,1,3,0,1,0,54.94
花蓮縣,新城鄉,新城村,74,1,460,5,465,920,3,1,3,0,1,0,50.54
花蓮縣,新城鄉,順安村,75,1,309,1,310,586,3,1,3,0,1,0,52.90
花蓮縣,新城鄉,順安村,76,1,146,3,149,236,3,1,3,0,1,0,63.14
花蓮縣,新城鄉,康樂村,77,1,157,1,158,285,3,1,3,0,1,0,55.44
花蓮縣,新城鄉,康樂村,78,1,489,4,493,948,3,1,3,0,1,0,52.00
花蓮縣,新城鄉,康樂村,79,1,300,1,301,673,3,1,3,0,1,0,44.73
花蓮縣,新城鄉,大漢村,80,1,154,3,157,353,3,1,3,0,1,0,44.48
花蓮縣,新城鄉,大漢村,81,1,395,2,397,834,3,1,3,0,1,0,47.60
花蓮縣,新城鄉,大漢村,82,1,212,3,215,422,3,1,3,0,1,0,50.95
花蓮縣,新城鄉,北埔村,83,1,288,3,291,653,3,1,3,0,1,0,44.56
花蓮縣,新城鄉,北埔村,84,1,385,3,388,820,3,1,3,0,1,0,47.32
花蓮縣,新城鄉,北埔村,85,1,480,6,486,968,3,1,3,0,1,0,50.21
花蓮縣,新城鄉,佳林村,86,1,274,4,278,614,3,1,3,0,1,0,45.28
花蓮縣,新城鄉,嘉里村,87,1,498,3,501,1071,3,1,3,0,1,0,46.78
花蓮縣,新城鄉,嘉里村,88,1,504,4,508,938,3,1,3,0,1,0,54.16
花蓮縣,新城鄉,嘉里村,89,1,357,4,361,748,3,1,3,0,1,0,48.26
花蓮縣,新城鄉,嘉新村,90,1,334,1,335,571,3,1,3,0,1,0,58.67
花蓮縣,新城鄉,嘉新村,91,1,165,4,169,394,3,1,3,0,1,0,42.89
花蓮縣,秀林鄉,和平村,92,1,111,0,111,236,3,1,3,0,1,0,47.03
花蓮縣,秀林鄉,和平村,93,1,32,0,32,90,3,1,3,0,1,0,35.56
花蓮縣,秀林鄉,崇德村,94,1,189,1,190,346,3,1,3,0,1,0,54.91
花蓮縣,秀林鄉,富世村,95,1,86,0,86,216,3,1,3,0,1,0,39.81
花蓮縣,秀林鄉,富世村,96,1,51,2,53,155,3,1,3,0,1,0,34.19
花蓮縣,秀林鄉,秀林村,97,1,54,0,54,120,3,1,3,0,1,0,45
花蓮縣,秀林鄉,景美村,98,1,29,0,29,88,3,1,3,0,1,0,32.95
花蓮縣,秀林鄉,景美村,99,1,25,0,25,65,3,1,3,0,1,0,38.46
花蓮縣,秀林鄉,佳民村,100,1,65,1,66,144,3,1,3,0,1,0,45.83
花蓮縣,秀林鄉,水源村,101,1,49,1,50,104,3,1,3,0,1,0,48.08
花蓮縣,秀林鄉,銅門村,102,1,37,0,37,73,3,1,3,0,1,0,50.68
花蓮縣,秀林鄉,文蘭村,103,1,29,2,31,66,3,1,3,0,1,0,46.97
花蓮縣,秀林鄉,文蘭村,104,1,9,0,9,17,3,1,3,0,1,0,52.94
花蓮縣,吉安鄉,永安村,105,1,717,6,723,1552,3,1,3,0,1,0,46.59
花蓮縣,吉安鄉,永安村,106,1,755,3,758,1648,3,1,3,0,1,0,46
花蓮縣,吉安鄉,太昌村,107,1,701,2,703,1483,3,1,3,0,1,0,47.4
花蓮縣,吉安鄉,太昌村,108,1,438,4,442,973,3,1,3,0,1,0,45.43
花蓮縣,吉安鄉,慶豐村,109,1,765,12,777,1667,3,1,3,0,1,0,46.61
花蓮縣,吉安鄉,慶豐村,110,1,831,8,839,1609,3,1,3,0,1,0,52.14
花蓮縣,吉安鄉,慶豐村,111,1,671,6,677,1349,3,1,3,0,1,0,50.19
花蓮縣,吉安鄉,吉安村,112,1,682,4,686,1386,3,1,3,0,1,0,49.49
花蓮縣,吉安鄉,吉安村,113,1,455,5,460,1118,3,1,3,0,1,0,41.14
花蓮縣,吉安鄉,吉安村,114,1,536,4,540,1105,3,1,3,0,1,0,48.87
花蓮縣,吉安鄉,福興村,115,1,400,1,401,837,3,1,3,0,1,0,47.91
花蓮縣,吉安鄉,福興村,116,1,569,1,570,1160,3,1,3,0,1,0,49.14
花蓮縣,吉安鄉,南華村,117,1,580,6,586,1096,3,1,3,0,1,0,53.47
花蓮縣,吉安鄉,干城村,118,1,373,5,378,810,3,1,3,0,1,0,46.67
花蓮縣,吉安鄉,永興村,119,1,739,7,746,1495,3,1,3,0,1,0,49.90
花蓮縣,吉安鄉,永興村,120,1,273,3,276,587,3,1,3,0,1,0,47.02
花蓮縣,吉安鄉,稻香村,121,1,597,5,602,1215,3,1,3,0,1,0,49.55
花蓮縣,吉安鄉,稻香村,122,1,696,7,703,1297,3,1,3,0,1,0,54.20
花蓮縣,吉安鄉,南昌村,123,1,412,2,414,853,3,1,3,0,1,0,48.53
花蓮縣,吉安鄉,南昌村,124,1,571,1,572,1313,3,1,3,0,1,0,43.56
花蓮縣,吉安鄉,宜昌村,125,1,655,3,658,1402,3,1,3,0,1,0,46.93
花蓮縣,吉安鄉,宜昌村,126,1,620,10,630,1305,3,1,3,0,1,0,48.28
花蓮縣,吉安鄉,北昌村,127,1,755,3,758,1525,3,1,3,0,1,0,49.70
花蓮縣,吉安鄉,北昌村,128,1,764,6,770,1464,3,1,3,0,1,0,52.60
花蓮縣,吉安鄉,北昌村,129,1,748,6,754,1464,3,1,3,0,1,0,51.50
花蓮縣,吉安鄉,北昌村,130,1,694,5,699,1430,3,1,3,0,1,0,48.88
花蓮縣,吉安鄉,勝安村,131,1,794,8,802,1633,3,1,3,0,1,0,49.11
花蓮縣,吉安鄉,勝安村,132,1,940,11,951,1967,3,1,3,0,1,0,48.35
花蓮縣,吉安鄉,仁里村,133,1,523,5,528,1047,3,1,3,0,1,0,50.43
花蓮縣,吉安鄉,仁里村,134,1,586,4,590,1247,3,1,3,0,1,0,47.31
花蓮縣,吉安鄉,仁里村,135,1,532,6,538,1163,3,1,3,0,1,0,46.26
花蓮縣,吉安鄉,仁里村,136,1,567,1,568,1128,3,1,3,0,1,0,50.35
花蓮縣,吉安鄉,東昌村,137,1,520,1,521,1074,3,1,3,0,1,0,48.51
花蓮縣,吉安鄉,東昌村,138,1,585,5,590,1336,3,1,3,0,1,0,44.16
花蓮縣,吉安鄉,東昌村,139,1,339,2,341,780,3,1,3,0,1,0,43.72
花蓮縣,吉安鄉,仁安村,140,1,644,5,649,1420,3,1,3,0,1,0,45.70
花蓮縣,吉安鄉,仁和村,141,1,574,7,581,1298,3,1,3,0,1,0,44.76
花蓮縣,吉安鄉,仁和村,142,1,380,8,388,865,3,1,3,0,1,0,44.86
花蓮縣,吉安鄉,仁和村,143,1,446,1,447,955,3,1,3,0,1,0,46.81
花蓮縣,吉安鄉,光華村,144,1,471,2,473,923,3,1,3,0,1,0,51.25
花蓮縣,壽豐鄉,溪口村,145,1,422,2,424,780,3,1,3,0,1,0,54.36
花蓮縣,壽豐鄉,樹湖村,146,1,161,1,162,285,3,1,3,0,1,0,56.84
花蓮縣,壽豐鄉,豐山村,147,1,901,6,907,1787,3,1,3,0,1,0,50.76
花蓮縣,壽豐鄉,豐裡村,148,1,551,3,554,1170,3,1,3,0,1,0,47.35
花蓮縣,壽豐鄉,豐坪村,149,1,331,1,332,629,3,1,3,0,1,0,52.78
花蓮縣,壽豐鄉,壽豐村,150,1,557,6,563,1059,3,1,3,0,1,0,53.16
花蓮縣,壽豐鄉,共和村,151,1,279,2,281,506,3,1,3,0,1,0,55.53
花蓮縣,壽豐鄉,光榮村,152,1,68,1,69,145,3,1,3,0,1,0,47.59
花蓮縣,壽豐鄉,池南村,153,1,275,3,278,538,3,1,3,0,1,0,51.67
花蓮縣,壽豐鄉,平和村,154,1,378,2,380,730,3,1,3,0,1,0,52.05
花蓮縣,壽豐鄉,平和村,155,1,160,1,161,335,3,1,3,0,1,0,48.06
花蓮縣,壽豐鄉,志學村,156,1,435,5,440,984,3,1,3,0,1,0,44.72
花蓮縣,壽豐鄉,志學村,157,1,434,4,438,889,3,1,3,0,1,0,49.27
花蓮縣,壽豐鄉,池南村,158,1,177,1,178,347,3,1,3,0,1,0,51.30
花蓮縣,壽豐鄉,米棧村,159,1,48,0,48,94,3,1,3,0,1,0,51.06
花蓮縣,壽豐鄉,米棧村,160,1,27,0,27,49,3,1,3,0,1,0,55.10
花蓮縣,壽豐鄉,月眉村,161,1,104,0,104,235,3,1,3,0,1,0,44.26
花蓮縣,壽豐鄉,鹽寮村,162,1,157,1,158,351,3,1,3,0,1,0,45.01
花蓮縣,壽豐鄉,水璉村,163,1,158,1,159,355,3,1,3,0,1,0,44.79
花蓮縣,壽豐鄉,水璉村,164,1,23,1,24,48,3,1,3,0,1,0,50.00
花蓮縣,鳳林鎮,鳳仁里,165,1,638,5,643,1153,3,1,3,0,1,0,55.77
花蓮縣,鳳林鎮,鳳義里,166,1,355,3,358,612,3,1,3,0,1,0,58.50
花蓮縣,鳳林鎮,鳳禮里,167,1,407,2,409,675,3,1,3,0,1,0,60.59
花蓮縣,鳳林鎮,鳳智里,168,1,615,3,618,1086,3,1,3,0,1,0,56.91
花蓮縣,鳳林鎮,鳳信里,169,1,218,0,218,395,3,1,3,0,1,0,55.19
花蓮縣,鳳林鎮,鳳信里,170,1,242,0,242,444,3,1,3,0,1,0,54.50
花蓮縣,鳳林鎮,山興里,171,1,73,1,74,154,3,1,3,0,1,0,48.05
花蓮縣,鳳林鎮,山興里,172,1,33,0,33,61,3,1,3,0,1,0,54.1
花蓮縣,鳳林鎮,大榮里,173,1,313,3,316,630,3,1,3,0,1,0,50.16
花蓮縣,鳳林鎮,大榮里,174,1,280,2,282,576,3,1,3,0,1,0,48.96
花蓮縣,鳳林鎮,北林里,175,1,327,5,332,622,3,1,3,0,1,0,53.38
花蓮縣,鳳林鎮,南平里,176,1,312,2,314,633,3,1,3,0,1,0,49.61
花蓮縣,鳳林鎮,林榮里,177,1,426,7,433,817,3,1,3,0,1,0,53
花蓮縣,鳳林鎮,長橋里,178,1,492,5,497,969,3,1,3,0,1,0,51.29
花蓮縣,鳳林鎮,森榮里,179,1,64,0,64,109,3,1,3,0,1,0,58.72
花蓮縣,光復鄉,大華村,180,1,552,4,556,1032,3,1,3,0,1,0,53.88
花蓮縣,光復鄉,大安村,181,1,488,2,490,828,3,1,3,0,1,0,59.18
花蓮縣,光復鄉,大平村,182,1,119,1,120,283,3,1,3,0,1,0,42.40
花蓮縣,光復鄉,大馬村,183,1,180,0,180,368,3,1,3,0,1,0,48.91
花蓮縣,光復鄉,大同村,184,1,383,5,388,697,3,1,3,0,1,0,55.67
花蓮縣,光復鄉,東富村,185,1,39,0,39,80,3,1,3,0,1,0,48.75
花蓮縣,光復鄉,東富村,186,1,42,0,42,114,3,1,3,0,1,0,36.84
花蓮縣,光復鄉,西富村,187,1,58,0,58,120,3,1,3,0,1,0,48.33
花蓮縣,光復鄉,西富村,188,1,103,1,104,208,3,1,3,0,1,0,50.00
花蓮縣,光復鄉,南富村,189,1,40,0,40,104,3,1,3,0,1,0,38.46
花蓮縣,光復鄉,北富村,190,1,74,2,76,174,3,1,3,0,1,0,43.68
花蓮縣,光復鄉,大進村,191,1,253,3,256,423,3,1,3,0,1,0,60.52
花蓮縣,光復鄉,大全村,192,1,243,4,247,488,3,1,3,0,1,0,50.61
花蓮縣,光復鄉,大全村,193,1,72,0,72,112,3,1,3,0,1,0,64.29
花蓮縣,光復鄉,大興村,194,1,139,4,143,317,3,1,3,0,1,0,45.11
花蓮縣,光復鄉,大富村,195,1,162,2,164,367,3,1,3,0,1,0,44.69
花蓮縣,光復鄉,大豐村,196,1,245,4,249,523,3,1,3,0,1,0,47.61
花蓮縣,豐濱鄉,靜浦村,197,1,31,0,31,97,3,1,3,0,1,0,31.96
花蓮縣,豐濱鄉,港口村,198,1,69,0,69,138,3,1,3,0,1,0,50.00
花蓮縣,豐濱鄉,豐濱村,199,1,27,1,28,44,3,1,3,0,1,0,63.64
花蓮縣,豐濱鄉,豐濱村,200,1,214,5,219,489,3,1,3,0,1,0,44.79
花蓮縣,豐濱鄉,豐濱村,201,1,24,0,24,53,3,1,3,0,1,0,45.28
花蓮縣,豐濱鄉,新社村,202,1,23,0,23,74,3,1,3,0,1,0,31.08
花蓮縣,豐濱鄉,磯崎村,203,1,35,0,35,75,3,1,3,0,1,0,46.67
花蓮縣,萬榮鄉,西林村,204,1,15,1,16,44,3,1,3,0,1,0,36.36
花蓮縣,萬榮鄉,見晴村,205,1,13,1,14,34,3,1,3,0,1,0,41.18
花蓮縣,萬榮鄉,萬榮村,206,1,24,0,24,47,3,1,3,0,1,0,51.06
花蓮縣,萬榮鄉,明利村,207,1,33,0,33,58,3,1,3,0,1,0,56.90
花蓮縣,萬榮鄉,馬遠村,208,1,4,0,4,10,3,1,3,0,1,0,40.00
花蓮縣,萬榮鄉,馬遠村,209,1,6,0,6,24,3,1,3,0,1,0,25.00
花蓮縣,萬榮鄉,紅葉村,210,1,37,0,37,86,3,1,3,0,1,0,43.02
花蓮縣,瑞穗鄉,瑞穗村,211,1,438,1,439,821,3,1,3,0,1,0,53.47
花蓮縣,瑞穗鄉,瑞穗村,212,1,449,2,451,946,3,1,3,0,1,0,47.67
花蓮縣,瑞穗鄉,瑞美村,213,1,391,4,395,785,3,1,3,0,1,0,50.32
花蓮縣,瑞穗鄉,瑞美村,214,1,375,2,377,748,3,1,3,0,1,0,50.40
花蓮縣,瑞穗鄉,瑞良村,215,1,215,1,216,387,3,1,3,0,1,0,55.81
花蓮縣,瑞穗鄉,瑞祥村,216,1,381,1,382,813,3,1,3,0,1,0,46.99
花蓮縣,瑞穗鄉,瑞北村,217,1,166,0,166,369,3,1,3,0,1,0,44.99
花蓮縣,瑞穗鄉,舞鶴村,218,1,210,3,213,468,3,1,3,0,1,0,45.51
花蓮縣,瑞穗鄉,鶴岡村,219,1,120,1,121,276,3,1,3,0,1,0,43.84
花蓮縣,瑞穗鄉,奇美村,220,1,25,0,25,51,3,1,3,0,1,0,49.02
花蓮縣,瑞穗鄉,富源村,221,1,327,2,329,605,3,1,3,0,1,0,54.38
花蓮縣,瑞穗鄉,富民村,222,1,104,3,107,275,3,1,3,0,1,0,38.91
花蓮縣,瑞穗鄉,富興村,223,1,222,2,224,444,3,1,3,0,1,0,50.45
花蓮縣,玉里鎮,中城里,224,1,611,9,620,1296,3,1,3,0,1,0,47.84
花蓮縣,玉里鎮,中城里,225,1,679,6,685,1415,3,1,3,0,1,0,48.41
花蓮縣,玉里鎮,中城里,226,1,832,6,838,1558,3,1,3,0,1,0,53.79
花蓮縣,玉里鎮,國武里,227,1,677,5,682,1322,3,1,3,0,1,0,51.59
花蓮縣,玉里鎮,啟模里,228,1,389,3,392,821,3,1,3,0,1,0,47.75
花蓮縣,玉里鎮,啟模里,229,1,401,4,405,822,3,1,3,0,1,0,49.27
花蓮縣,玉里鎮,泰昌里,230,1,541,5,546,1021,3,1,3,0,1,0,53.48
花蓮縣,玉里鎮,泰昌里,231,1,207,19,226,836,3,1,3,0,1,0,27.03
花蓮縣,玉里鎮,泰昌里,232,1,72,13,85,535,3,1,3,0,1,0,15.89
花蓮縣,玉里鎮,永昌里,233,1,476,3,479,1001,3,1,3,0,1,0,47.85
花蓮縣,玉里鎮,源城里,234,1,522,7,529,1080,3,1,3,0,1,0,48.98
花蓮縣,玉里鎮,長良里,235,1,200,6,206,536,3,1,3,0,1,0,38.43
花蓮縣,玉里鎮,樂合里,236,1,146,1,147,358,3,1,3,0,1,0,41.06
花蓮縣,玉里鎮,東豐里,237,1,160,0,160,331,3,1,3,0,1,0,48.34
花蓮縣,玉里鎮,觀音里,238,1,272,3,275,655,3,1,3,0,1,0,41.98
花蓮縣,玉里鎮,觀音里,239,1,133,1,134,275,3,1,3,0,1,0,48.73
花蓮縣,玉里鎮,松浦里,240,1,199,3,202,476,3,1,3,0,1,0,42.44
花蓮縣,玉里鎮,春日里,241,1,173,5,178,455,3,1,3,0,1,0,39.12
花蓮縣,玉里鎮,德武里,242,1,30,0,30,76,3,1,3,0,1,0,39.47
花蓮縣,玉里鎮,三民里,243,1,482,2,484,939,3,1,3,0,1,0,51.54
花蓮縣,玉里鎮,大禹里,244,1,452,4,456,972,3,1,3,0,1,0,46.91
花蓮縣,富里鄉,吳江村,245,1,202,2,204,420,3,1,3,0,1,0,48.57
花蓮縣,富里鄉,東里村,246,1,445,3,448,1120,3,1,3,0,1,0,40.00
花蓮縣,富里鄉,萬寧村,247,1,214,2,216,585,3,1,3,0,1,0,36.92
花蓮縣,富里鄉,新興村,248,1,223,4,227,547,3,1,3,0,1,0,41.50
花蓮縣,富里鄉,竹田村,249,1,483,5,488,1031,3,1,3,0,1,0,47.33
花蓮縣,富里鄉,羅山村,250,1,189,3,192,446,3,1,3,0,1,0,43.05
花蓮縣,富里鄉,石牌村,251,1,407,2,409,837,3,1,3,0,1,0,48.86
花蓮縣,富里鄉,明里村,252,1,182,2,184,389,3,1,3,0,1,0,47.30
花蓮縣,富里鄉,富里村,253,1,696,5,701,1494,3,1,3,0,1,0,46.92
花蓮縣,富里鄉,永豐村,254,1,200,0,200,507,3,1,3,0,1,0,39.45
花蓮縣,富里鄉,豐南村,255,1,143,1,144,312,3,1,3,0,1,0,46.15
花蓮縣,富里鄉,富南村,256,1,218,3,221,517,3,1,3,0,1,0,42.75
花蓮縣,富里鄉,學田村,257,1,291,1,292,536,3,1,3,0,1,0,54.48
花蓮縣,卓溪鄉,崙山村,258,1,9,0,9,19,3,1,3,0,1,0,47.37
花蓮縣,卓溪鄉,立山村,259,1,7,0,7,19,3,1,3,0,1,0,36.84
花蓮縣,卓溪鄉,立山村,260,1,6,0,6,18,3,1,3,0,1,0,33.33
花蓮縣,卓溪鄉,太平村,261,1,6,0,6,7,3,1,3,0,1,0,85.71
花蓮縣,卓溪鄉,太平村,262,1,10,0,10,18,3,1,3,0,1,0,55.56
花蓮縣,卓溪鄉,卓溪村,263,1,40,0,40,79,3,1,3,0,1,0,50.63
花蓮縣,卓溪鄉,卓清村,264,1,27,0,27,58,3,1,3,0,1,0,46.55
花蓮縣,卓溪鄉,卓清村,265,1,12,0,12,29,3,1,3,0,1,0,41.38
花蓮縣,卓溪鄉,古風村,266,1,13,0,13,34,3,1,3,0,1,0,38.24
花蓮縣,卓溪鄉,古風村,267,1,13,0,13,19,3,1,3,0,1,0,68.42
花蓮縣,卓溪鄉,古風村,268,1,10,0,10,16,3,1,3,0,1,0,62.50
澎湖縣,馬公市,新復里,1,1,187,1,188,300,3,1,3,0,1,0,62.67
澎湖縣,馬公市,復興里,2,1,187,0,187,319,3,1,3,0,1,0,58.62
澎湖縣,馬公市,長安里,3,1,314,4,318,526,3,1,3,0,1,0,60.46
澎湖縣,馬公市,中央里,4,1,283,4,287,491,3,1,3,0,1,0,58.45
澎湖縣,馬公市,啟明里,5,1,509,7,516,867,3,1,3,0,1,0,59.52
澎湖縣,馬公市,重慶里,6,1,585,5,590,978,3,1,3,0,1,0,60.33
澎湖縣,馬公市,中興里,7,1,423,5,428,705,3,1,3,0,1,0,60.71
澎湖縣,馬公市,光復里,8,1,509,1,510,924,3,1,3,0,1,0,55.19
澎湖縣,馬公市,光復里,9,1,538,2,540,902,3,1,3,0,1,0,59.87
澎湖縣,馬公市,光明里,10,1,342,2,344,554,3,1,3,0,1,0,62.09
澎湖縣,馬公市,光明里,11,1,329,3,332,605,3,1,3,0,1,0,54.88
澎湖縣,馬公市,光榮里,12,1,743,3,746,1224,3,1,3,0,1,0,60.95
澎湖縣,馬公市,光榮里,13,1,676,4,680,1174,3,1,3,0,1,0,57.92
澎湖縣,馬公市,朝陽里,14,1,607,3,610,1131,3,1,3,0,1,0,53.93
澎湖縣,馬公市,朝陽里,15,1,652,4,656,1197,3,1,3,0,1,0,54.80
澎湖縣,馬公市,朝陽里,16,1,647,5,652,1131,3,1,3,0,1,0,57.65
澎湖縣,馬公市,朝陽里,17,1,679,11,690,1202,3,1,3,0,1,0,57.40
澎湖縣,馬公市,陽明里,18,1,615,7,622,1131,3,1,3,0,1,0,55.00
澎湖縣,馬公市,陽明里,19,1,649,5,654,1141,3,1,3,0,1,0,57.32
澎湖縣,馬公市,重光里,20,1,686,3,689,1159,3,1,3,0,1,0,59.45
澎湖縣,馬公市,西衛里,21,1,777,6,783,1366,3,1,3,0,1,0,57.32
澎湖縣,馬公市,西衛里,22,1,832,3,835,1480,3,1,3,0,1,0,56.42
澎湖縣,馬公市,西文里,23,1,635,4,639,1066,3,1,3,0,1,0,59.94
澎湖縣,馬公市,西文里,24,1,559,5,564,967,3,1,3,0,1,0,58.32
澎湖縣,馬公市,東文里,25,1,690,2,692,1160,3,1,3,0,1,0,59.66
澎湖縣,馬公市,東文里,26,1,511,3,514,924,3,1,3,0,1,0,55.63
澎湖縣,馬公市,案山里,27,1,763,5,768,1231,3,1,3,0,1,0,62.39
澎湖縣,馬公市,光華里,28,1,403,7,410,686,3,1,3,0,1,0,59.77
澎湖縣,馬公市,前寮里,29,1,355,3,358,567,3,1,3,0,1,0,63.14
澎湖縣,馬公市,石泉里,30,1,873,10,883,1512,3,1,3,0,1,0,58.40
澎湖縣,馬公市,菜園里,31,1,221,4,225,323,3,1,3,0,1,0,69.66
澎湖縣,馬公市,東衛里,32,1,791,5,796,1374,3,1,3,0,1,0,57.93
澎湖縣,馬公市,安宅里,33,1,268,2,270,436,3,1,3,0,1,0,61.93
澎湖縣,馬公市,興仁里,34,1,365,0,365,604,3,1,3,0,1,0,60.43
澎湖縣,馬公市,烏崁里,35,1,493,4,497,814,3,1,3,0,1,0,61.06
澎湖縣,馬公市,鐵線里,36,1,258,1,259,387,3,1,3,0,1,0,66.93
澎湖縣,馬公市,鎖港里,37,1,569,3,572,1061,3,1,3,0,1,0,53.91
澎湖縣,馬公市,鎖港里,38,1,502,4,506,973,3,1,3,0,1,0,52.00
澎湖縣,馬公市,山水里,39,1,820,6,826,1406,3,1,3,0,1,0,58.75
澎湖縣,馬公市,五德里,40,1,104,2,106,178,3,1,3,0,1,0,59.55
澎湖縣,馬公市,井垵里,41,1,207,2,209,336,3,1,3,0,1,0,62.20
澎湖縣,馬公市,時裡里,42,1,628,4,632,1064,3,1,3,0,1,0,59.40
澎湖縣,馬公市,風櫃里,43,1,664,6,670,1231,3,1,3,0,1,0,54.43
澎湖縣,馬公市,虎井里,44,1,207,2,209,602,3,1,3,0,1,0,34.72
澎湖縣,馬公市,桶盤里,45,1,55,0,55,201,3,1,3,0,1,0,27.36
澎湖縣,湖西鄉,湖西村,46,1,532,8,540,845,3,1,3,0,1,0,63.91
澎湖縣,湖西鄉,湖東村,47,1,187,1,188,306,3,1,3,0,1,0,61.44
澎湖縣,湖西鄉,青螺村,48,1,106,0,106,203,3,1,3,0,1,0,52.22
澎湖縣,湖西鄉,白坑村,49,1,148,1,149,243,3,1,3,0,1,0,61.32
澎湖縣,湖西鄉,南寮村,50,1,359,4,363,607,3,1,3,0,1,0,59.80
澎湖縣,湖西鄉,北寮村,51,1,169,3,172,279,3,1,3,0,1,0,61.65
澎湖縣,湖西鄉,紅羅村,52,1,328,4,332,556,3,1,3,0,1,0,59.71
澎湖縣,湖西鄉,西溪村,53,1,263,0,263,459,3,1,3,0,1,0,57.30
澎湖縣,湖西鄉,成功村,54,1,268,1,269,421,3,1,3,0,1,0,63.90
澎湖縣,湖西鄉,東石村,55,1,64,0,64,108,3,1,3,0,1,0,59.26
澎湖縣,湖西鄉,沙港村,56,1,436,7,443,722,3,1,3,0,1,0,61.36
澎湖縣,湖西鄉,中西村,57,1,90,0,90,165,3,1,3,0,1,0,54.55
澎湖縣,湖西鄉,鼎灣村,58,1,179,1,180,296,3,1,3,0,1,0,60.81
澎湖縣,湖西鄉,潭邊村,59,1,143,1,144,228,3,1,3,0,1,0,63.16
澎湖縣,湖西鄉,許家村,60,1,101,0,101,166,3,1,3,0,1,0,60.84
澎湖縣,湖西鄉,城北村,61,1,130,0,130,189,3,1,3,0,1,0,68.78
澎湖縣,湖西鄉,太武村,62,1,61,0,61,109,3,1,3,0,1,0,55.96
澎湖縣,湖西鄉,隘門村,63,1,402,2,404,628,3,1,3,0,1,0,64.33
澎湖縣,湖西鄉,林投村,64,1,470,4,474,876,3,1,3,0,1,0,54.11
澎湖縣,湖西鄉,尖山村,65,1,303,1,304,532,3,1,3,0,1,0,57.14
澎湖縣,湖西鄉,龍門村,66,1,465,6,471,783,3,1,3,0,1,0,60.15
澎湖縣,湖西鄉,龍門村,67,1,437,2,439,752,3,1,3,0,1,0,58.38
澎湖縣,湖西鄉,果葉村,68,1,387,1,388,641,3,1,3,0,1,0,60.53
澎湖縣,白沙鄉,中屯村,69,1,279,2,281,441,3,1,3,0,1,0,63.72
澎湖縣,白沙鄉,講美村,70,1,306,2,308,537,3,1,3,0,1,0,57.36
澎湖縣,白沙鄉,城前村,71,1,53,1,54,89,3,1,3,0,1,0,60.67
澎湖縣,白沙鄉,鎮海村,72,1,75,0,75,117,3,1,3,0,1,0,64.10
澎湖縣,白沙鄉,港子村,73,1,123,2,125,239,3,1,3,0,1,0,52.30
澎湖縣,白沙鄉,岐頭村,74,1,112,0,112,207,3,1,3,0,1,0,54.11
澎湖縣,白沙鄉,小赤村,75,1,98,0,98,145,3,1,3,0,1,0,67.59
澎湖縣,白沙鄉,赤崁村,76,1,751,8,759,1306,3,1,3,0,1,0,58.12
澎湖縣,白沙鄉,瓦硐村,77,1,154,2,156,282,3,1,3,0,1,0,55.32
澎湖縣,白沙鄉,後寮村,78,1,373,4,377,644,3,1,3,0,1,0,58.54
澎湖縣,白沙鄉,通梁村,79,1,382,1,383,673,3,1,3,0,1,0,56.91
澎湖縣,白沙鄉,吉貝村,80,1,510,4,514,1212,3,1,3,0,1,0,42.41
澎湖縣,白沙鄉,鳥嶼村,81,1,276,41,317,972,3,1,3,0,1,0,32.61
澎湖縣,白沙鄉,員貝村,82,1,70,0,70,209,3,1,3,0,1,0,33.49
澎湖縣,白沙鄉,大倉村,83,1,80,3,83,175,3,1,3,0,1,0,47.43
澎湖縣,西嶼鄉,橫礁村,84,1,130,0,130,253,3,1,3,0,1,0,51.38
澎湖縣,西嶼鄉,合界村,85,1,194,2,196,387,3,1,3,0,1,0,50.65
澎湖縣,西嶼鄉,竹灣村,86,1,405,4,409,748,3,1,3,0,1,0,54.68
澎湖縣,西嶼鄉,小門村,87,1,135,0,135,262,3,1,3,0,1,0,51.53
澎湖縣,西嶼鄉,大池村,88,1,298,6,304,597,3,1,3,0,1,0,50.92
澎湖縣,西嶼鄉,二崁村,89,1,58,2,60,120,3,1,3,0,1,0,50.00
澎湖縣,西嶼鄉,池東村,90,1,265,1,266,495,3,1,3,0,1,0,53.74
澎湖縣,西嶼鄉,池西村,91,1,97,0,97,188,3,1,3,0,1,0,51.60
澎湖縣,西嶼鄉,赤馬村,92,1,273,1,274,583,3,1,3,0,1,0,47.00
澎湖縣,西嶼鄉,內垵村,93,1,627,4,631,1178,3,1,3,0,1,0,53.57
澎湖縣,西嶼鄉,外垵村,94,1,396,1,397,799,3,1,3,0,1,0,49.69
澎湖縣,西嶼鄉,外垵村,95,1,499,4,503,984,3,1,3,0,1,0,51.12
澎湖縣,望安鄉,東安村,96,1,186,0,186,410,3,1,3,0,1,0,45.37
澎湖縣,望安鄉,西安村,97,1,133,1,134,311,3,1,3,0,1,0,43.09
澎湖縣,望安鄉,中社村,98,1,75,0,75,217,3,1,3,0,1,0,34.56
澎湖縣,望安鄉,水垵村,99,1,133,0,133,280,3,1,3,0,1,0,47.50
澎湖縣,望安鄉,將軍村,100,1,206,3,209,567,3,1,3,0,1,0,36.86
澎湖縣,望安鄉,將軍村,101,1,207,2,209,599,3,1,3,0,1,0,34.89
澎湖縣,望安鄉,東吉村,102,1,29,1,30,266,3,1,3,0,1,0,11.28
澎湖縣,望安鄉,東坪村,103,1,39,0,39,331,3,1,3,0,1,0,11.78
澎湖縣,望安鄉,西坪村,104,1,16,0,16,171,3,1,3,0,1,0,9.36
澎湖縣,望安鄉,花嶼村,105,1,97,3,100,217,3,1,3,0,1,0,46.08
澎湖縣,七美鄉,東湖村,106,1,84,0,84,221,3,1,3,0,1,0,38.01
澎湖縣,七美鄉,西湖村,107,1,148,0,148,409,3,1,3,0,1,0,36.19
澎湖縣,七美鄉,中和村,108,1,172,3,175,442,3,1,3,0,1,0,39.59
澎湖縣,七美鄉,平和村,109,1,104,2,106,254,3,1,3,0,1,0,41.73
澎湖縣,七美鄉,海豐村,110,1,99,2,101,247,3,1,3,0,1,0,40.89
澎湖縣,七美鄉,南港村,111,1,348,1,349,831,3,1,3,0,1,0,42.00
基隆市,中正區,長潭里,1,1,383,3,386,566,3,1,3,0,1,0,68.20
基隆市,中正區,砂子里,2,1,692,1,693,1236,3,1,3,0,1,0,56.07
基隆市,中正區,砂子里,3,1,307,5,312,629,3,1,3,0,1,0,49.60
基隆市,中正區,砂子里,4,1,465,24,489,1023,3,1,3,0,1,0,47.80
基隆市,中正區,八斗里,5,1,894,10,904,1545,3,1,3,0,1,0,58.51
基隆市,中正區,碧砂里,6,1,645,6,651,1281,3,1,3,0,1,0,50.82
基隆市,中正區,新富里,7,1,782,5,787,1694,3,1,3,0,1,0,46.46
基隆市,中正區,新富里,8,1,621,9,630,1213,3,1,3,0,1,0,51.94
基隆市,中正區,新富里,9,1,194,3,197,485,3,1,3,0,1,0,40.62
基隆市,中正區,新豐里,10,1,292,5,297,737,3,1,3,0,1,0,40.30
基隆市,中正區,新豐里,11,1,491,5,496,1108,3,1,3,0,1,0,44.77
基隆市,中正區,新豐里,12,1,730,3,733,1545,3,1,3,0,1,0,47.44
基隆市,中正區,平寮里,13,1,798,2,800,1480,3,1,3,0,1,0,54.05
基隆市,中正區,社寮里,14,1,1011,7,1018,1904,3,1,3,0,1,0,53.47
基隆市,中正區,和憲里,15,1,464,2,466,898,3,1,3,0,1,0,51.89
基隆市,中正區,海濱里,16,1,499,4,503,988,3,1,3,0,1,0,50.91
基隆市,中正區,正濱里,17,1,628,11,639,1216,3,1,3,0,1,0,52.55
基隆市,中正區,中正里,18,1,538,4,542,1154,3,1,3,0,1,0,46.97
基隆市,中正區,中正里,19,1,524,7,531,906,3,1,3,0,1,0,58.61
基隆市,中正區,中濱里,20,1,794,5,799,1350,3,1,3,0,1,0,59.19
基隆市,中正區,建國里,21,1,657,6,663,1196,3,1,3,0,1,0,55.43
基隆市,中正區,建國里,22,1,548,4,552,924,3,1,3,0,1,0,59.74
基隆市,中正區,砂灣里,23,1,618,6,624,1155,3,1,3,0,1,0,54.03
基隆市,中正區,砂灣里,24,1,494,9,503,938,3,1,3,0,1,0,53.62
基隆市,中正區,真砂里,25,1,839,9,848,1476,3,1,3,0,1,0,57.45
基隆市,中正區,正砂里,26,1,833,3,836,1434,3,1,3,0,1,0,58.30
基隆市,中正區,正砂里,27,1,546,4,550,945,3,1,3,0,1,0,58.20
基隆市,中正區,中砂里,28,1,794,5,799,1298,3,1,3,0,1,0,61.56
基隆市,中正區,入船里,29,1,698,5,703,1260,3,1,3,0,1,0,55.79
基隆市,中正區,正船里,30,1,764,3,767,1438,3,1,3,0,1,0,53.34
基隆市,中正區,中船里,31,1,706,5,711,1311,3,1,3,0,1,0,54.23
基隆市,中正區,港通里,32,1,693,5,698,1228,3,1,3,0,1,0,56.84
基隆市,中正區,義重里,33,1,664,4,668,1169,3,1,3,0,1,0,57.14
基隆市,中正區,正義里,34,1,796,3,799,1442,3,1,3,0,1,0,55.41
基隆市,中正區,信義里,35,1,562,6,568,1007,3,1,3,0,1,0,56.41
基隆市,中正區,德義里,36,1,451,4,455,793,3,1,3,0,1,0,57.38
基隆市,信義區,仁壽里,37,1,701,4,705,1174,3,1,3,0,1,0,60.05
基隆市,信義區,仁義里,38,1,765,6,771,1231,3,1,3,0,1,0,62.63
基隆市,信義區,義昭里,39,1,557,1,558,974,3,1,3,0,1,0,57.29
基隆市,信義區,義幸里,40,1,717,4,721,1188,3,1,3,0,1,0,60.69
基隆市,信義區,義幸里,41,1,670,9,679,1171,3,1,3,0,1,0,57.98
基隆市,信義區,義民里,42,1,484,5,489,812,3,1,3,0,1,0,60.22
基隆市,信義區,義和里,43,1,745,7,752,1245,3,1,3,0,1,0,60.40
基隆市,信義區,智慧里,44,1,414,4,418,684,3,1,3,0,1,0,61.11
基隆市,信義區,智誠里,45,1,371,4,375,696,3,1,3,0,1,0,53.88
基隆市,信義區,智誠里,46,1,536,6,542,1014,3,1,3,0,1,0,53.45
基隆市,信義區,禮儀里,47,1,838,4,842,1448,3,1,3,0,1,0,58.15
基隆市,信義區,禮東里,48,1,888,11,899,1539,3,1,3,0,1,0,58.41
基隆市,信義區,信綠里,49,1,694,9,703,1204,3,1,3,0,1,0,58.39
基隆市,信義區,信綠里,50,1,559,5,564,1151,3,1,3,0,1,0,49.00
基隆市,信義區,東信里,51,1,520,5,525,941,3,1,3,0,1,0,55.79
基隆市,信義區,東信里,52,1,1219,7,1226,2448,3,1,3,0,1,0,50.08
基隆市,信義區,東光里,53,1,952,7,959,1836,3,1,3,0,1,0,52.23
基隆市,信義區,東明里,54,1,775,7,782,1533,3,1,3,0,1,0,51.01
基隆市,信義區,東明里,55,1,971,3,974,1811,3,1,3,0,1,0,53.78
基隆市,信義區,東安里,56,1,725,7,732,1321,3,1,3,0,1,0,55.41
基隆市,信義區,東安里,57,1,766,5,771,1346,3,1,3,0,1,0,57.28
基隆市,信義區,孝賢里,58,1,946,5,951,1949,3,1,3,0,1,0,48.79
基隆市,信義區,孝賢里,59,1,1147,6,1153,2030,3,1,3,0,1,0,56.80
基隆市,信義區,孝德里,60,1,848,6,854,1619,3,1,3,0,1,0,52.75
基隆市,信義區,孝德里,61,1,566,1,567,1161,3,1,3,0,1,0,48.84
基隆市,信義區,孝德里,62,1,544,3,547,1119,3,1,3,0,1,0,48.88
基隆市,信義區,孝深里,63,1,615,8,623,1291,3,1,3,0,1,0,48.26
基隆市,信義區,孝深里,64,1,536,2,538,1192,3,1,3,0,1,0,45.13
基隆市,信義區,孝岡里,65,1,455,8,463,908,3,1,3,0,1,0,50.99
基隆市,仁愛區,林泉里,66,1,934,12,946,1726,3,1,3,0,1,0,54.81
基隆市,仁愛區,花崗里,67,1,544,8,552,947,3,1,3,0,1,0,58.29
基隆市,仁愛區,虹橋里,68,1,869,8,877,1526,3,1,3,0,1,0,57.47
基隆市,仁愛區,水錦里,69,1,974,9,983,1756,3,1,3,0,1,0,55.98
基隆市,仁愛區,智仁里,70,1,676,6,682,1150,3,1,3,0,1,0,59.3
基隆市,仁愛區,智仁里,71,1,600,6,606,1082,3,1,3,0,1,0,56.01
基隆市,仁愛區,和明里,72,1,580,4,584,1069,3,1,3,0,1,0,54.63
基隆市,仁愛區,忠勇里,73,1,554,3,557,1009,3,1,3,0,1,0,55.2
基隆市,仁愛區,玉田里,74,1,602,1,603,1078,3,1,3,0,1,0,55.94
基隆市,仁愛區,仁德里,75,1,574,3,577,1006,3,1,3,0,1,0,57.36
基隆市,仁愛區,博愛里,76,1,655,4,659,1212,3,1,3,0,1,0,54.37
基隆市,仁愛區,博愛里,77,1,319,2,321,510,3,1,3,0,1,0,62.94
基隆市,仁愛區,福仁里,78,1,447,5,452,857,3,1,3,0,1,0,52.74
基隆市,仁愛區,誠仁里,79,1,565,7,572,1033,3,1,3,0,1,0,55.37
基隆市,仁愛區,吉仁里,80,1,771,4,775,1438,3,1,3,0,1,0,53.89
基隆市,仁愛區,吉仁里,81,1,671,4,675,1384,3,1,3,0,1,0,48.77
基隆市,仁愛區,育仁里,82,1,486,3,489,884,3,1,3,0,1,0,55.32
基隆市,仁愛區,英仁里,83,1,382,4,386,714,3,1,3,0,1,0,54.06
基隆市,仁愛區,英仁里,84,1,378,2,380,653,3,1,3,0,1,0,58.19
基隆市,仁愛區,龍門里,85,1,461,7,468,858,3,1,3,0,1,0,54.55
基隆市,仁愛區,德厚里,86,1,748,1,749,1363,3,1,3,0,1,0,54.95
基隆市,仁愛區,曲水里,87,1,515,3,518,956,3,1,3,0,1,0,54.18
基隆市,仁愛區,崇文里,88,1,498,4,502,942,3,1,3,0,1,0,53.29
基隆市,仁愛區,文安里,89,1,554,3,557,1032,3,1,3,0,1,0,53.97
基隆市,仁愛區,兆連里,90,1,431,2,433,771,3,1,3,0,1,0,56.16
基隆市,仁愛區,獅球里,91,1,622,8,630,1145,3,1,3,0,1,0,55.02
基隆市,仁愛區,書院里,92,1,676,7,683,1158,3,1,3,0,1,0,58.98
基隆市,仁愛區,朝棟里,93,1,815,5,820,1283,3,1,3,0,1,0,63.91
基隆市,仁愛區,朝棟里,94,1,825,12,837,1579,3,1,3,0,1,0,53.01
基隆市,仁愛區,光華里,95,1,620,2,622,1158,3,1,3,0,1,0,53.71
基隆市,仁愛區,光華里,96,1,660,5,665,1122,3,1,3,0,1,0,59.27
基隆市,仁愛區,明德里,97,1,455,2,457,737,3,1,3,0,1,0,62.01
基隆市,仁愛區,同風里,98,1,405,4,409,652,3,1,3,0,1,0,62.73
基隆市,仁愛區,文昌里,99,1,511,2,513,848,3,1,3,0,1,0,60.50
基隆市,仁愛區,新店里,100,1,409,5,414,690,3,1,3,0,1,0,60.00
基隆市,中山區,新建里,101,1,467,5,472,774,3,1,3,0,1,0,60.98
基隆市,中山區,安民里,102,1,653,8,661,1113,3,1,3,0,1,0,59.39
基隆市,中山區,安平里,103,1,573,10,583,982,3,1,3,0,1,0,59.37
基隆市,中山區,中山里,104,1,600,7,607,1086,3,1,3,0,1,0,55.89
基隆市,中山區,民治里,105,1,525,6,531,957,3,1,3,0,1,0,55.49
基隆市,中山區,中興里,106,1,726,12,738,1284,3,1,3,0,1,0,57.48
基隆市,中山區,仁正里,107,1,461,6,467,828,3,1,3,0,1,0,56.4
基隆市,中山區,健民里,108,1,798,7,805,1410,3,1,3,0,1,0,57.09
基隆市,中山區,通化里,109,1,636,9,645,1187,3,1,3,0,1,0,54.34
基隆市,中山區,居仁里,110,1,354,2,356,707,3,1,3,0,1,0,50.35
基隆市,中山區,居仁里,111,1,383,3,386,760,3,1,3,0,1,0,50.79
基隆市,中山區,通明里,112,1,494,6,500,926,3,1,3,0,1,0,54.00
基隆市,中山區,通明里,113,1,559,5,564,1045,3,1,3,0,1,0,53.97
基隆市,中山區,和平里,114,1,345,3,348,654,3,1,3,0,1,0,53.21
基隆市,中山區,仙洞里,115,1,380,3,383,727,3,1,3,0,1,0,52.68
基隆市,中山區,太白里,116,1,515,3,518,943,3,1,3,0,1,0,54.93
基隆市,中山區,協和里,117,1,476,10,486,887,3,1,3,0,1,0,54.79
基隆市,中山區,協和里,118,1,400,2,402,762,3,1,3,0,1,0,52.76
基隆市,中山區,文化里,119,1,559,5,564,1128,3,1,3,0,1,0,50.00
基隆市,中山區,德安里,120,1,905,3,908,1671,3,1,3,0,1,0,54.34
基隆市,中山區,德安里,121,1,771,4,775,1467,3,1,3,0,1,0,52.83
基隆市,中山區,德和里,122,1,836,10,846,1454,3,1,3,0,1,0,58.18
基隆市,中山區,德和里,123,1,931,7,938,1581,3,1,3,0,1,0,59.33
基隆市,中山區,德和里,124,1,1052,10,1062,1777,3,1,3,0,1,0,59.76
基隆市,中山區,中和里,125,1,770,6,776,1479,3,1,3,0,1,0,52.47
基隆市,中山區,中和里,126,1,399,2,401,837,3,1,3,0,1,0,47.91
基隆市,中山區,中和里,127,1,1028,7,1035,2359,3,1,3,0,1,0,43.87
基隆市,中山區,和慶里,128,1,739,8,747,1898,3,1,3,0,1,0,39.36
基隆市,中山區,和慶里,129,1,759,3,762,1629,3,1,3,0,1,0,46.78
基隆市,中山區,和慶里,130,1,712,7,719,1450,3,1,3,0,1,0,49.59
基隆市,中山區,西康里,131,1,859,16,875,1632,3,1,3,0,1,0,53.62
基隆市,中山區,西定里,132,1,538,3,541,993,3,1,3,0,1,0,54.48
基隆市,中山區,西華里,133,1,582,5,587,993,3,1,3,0,1,0,59.11
基隆市,中山區,西榮里,134,1,477,2,479,853,3,1,3,0,1,0,56.15
基隆市,安樂區,新西里,135,1,754,10,764,1453,3,1,3,0,1,0,52.58
基隆市,安樂區,西川里,136,1,713,8,721,1332,3,1,3,0,1,0,54.13
基隆市,安樂區,定國里,137,1,658,3,661,1233,3,1,3,0,1,0,53.61
基隆市,安樂區,定邦里,138,1,749,10,759,1302,3,1,3,0,1,0,58.29
基隆市,安樂區,慈仁里,139,1,547,5,552,1025,3,1,3,0,1,0,53.85
基隆市,安樂區,干城里,140,1,828,7,835,1493,3,1,3,0,1,0,55.93
基隆市,安樂區,干城里,141,1,437,2,439,781,3,1,3,0,1,0,56.21
基隆市,安樂區,永康里,142,1,751,2,753,1501,3,1,3,0,1,0,50.17
基隆市,安樂區,永康里,143,1,251,2,253,462,3,1,3,0,1,0,54.76
基隆市,安樂區,安和里,144,1,499,2,501,902,3,1,3,0,1,0,55.54
基隆市,安樂區,樂一里,145,1,355,2,357,637,3,1,3,0,1,0,56.04
基隆市,安樂區,嘉仁里,146,1,1043,10,1053,1941,3,1,3,0,1,0,54.25
基隆市,安樂區,嘉仁里,147,1,741,7,748,1368,3,1,3,0,1,0,54.68
基隆市,安樂區,三民里,148,1,816,4,820,1522,3,1,3,0,1,0,53.88
基隆市,安樂區,三民里,149,1,772,4,776,1472,3,1,3,0,1,0,52.72
基隆市,安樂區,三民里,150,1,1102,10,1112,2312,3,1,3,0,1,0,48.10
基隆市,安樂區,四維里,151,1,959,6,965,1645,3,1,3,0,1,0,58.66
基隆市,安樂區,四維里,152,1,800,2,802,1554,3,1,3,0,1,0,51.61
基隆市,安樂區,四維里,153,1,587,6,593,1036,3,1,3,0,1,0,57.24
基隆市,安樂區,五福里,154,1,1052,9,1061,1913,3,1,3,0,1,0,55.46
基隆市,安樂區,五福里,155,1,766,6,772,1516,3,1,3,0,1,0,50.92
基隆市,安樂區,六合里,156,1,912,7,919,1727,3,1,3,0,1,0,53.21
基隆市,安樂區,六合里,157,1,1029,5,1034,1830,3,1,3,0,1,0,56.50
基隆市,安樂區,七賢里,158,1,807,9,816,1466,3,1,3,0,1,0,55.66
基隆市,安樂區,七賢里,159,1,746,3,749,1388,3,1,3,0,1,0,53.96
基隆市,安樂區,長樂里,160,1,1039,7,1046,1900,3,1,3,0,1,0,55.05
基隆市,安樂區,長樂里,161,1,392,2,394,748,3,1,3,0,1,0,52.67
基隆市,安樂區,鶯歌里,162,1,736,6,742,1527,3,1,3,0,1,0,48.59
基隆市,安樂區,鶯歌里,163,1,674,8,682,1312,3,1,3,0,1,0,51.98
基隆市,安樂區,鶯安里,164,1,1258,4,1262,2504,3,1,3,0,1,0,50.40
基隆市,安樂區,興寮里,165,1,984,9,993,2224,3,1,3,0,1,0,44.65
基隆市,安樂區,興寮里,166,1,561,1,562,1276,3,1,3,0,1,0,44.04
基隆市,安樂區,外寮里,167,1,857,9,866,1690,3,1,3,0,1,0,51.24
基隆市,安樂區,外寮里,168,1,757,9,766,1611,3,1,3,0,1,0,47.55
基隆市,安樂區,新崙里,169,1,998,6,1004,2069,3,1,3,0,1,0,48.53
基隆市,安樂區,新崙里,170,1,506,2,508,1036,3,1,3,0,1,0,49.03
基隆市,安樂區,武崙里,171,1,518,1,519,1209,3,1,3,0,1,0,42.93
基隆市,安樂區,武崙里,172,1,1139,7,1146,2283,3,1,3,0,1,0,50.2
基隆市,安樂區,中崙里,173,1,653,4,657,1319,3,1,3,0,1,0,49.81
基隆市,安樂區,內寮里,174,1,887,4,891,1823,3,1,3,0,1,0,48.88
基隆市,安樂區,內寮里,175,1,755,4,759,1699,3,1,3,0,1,0,44.67
基隆市,暖暖區,八西里,176,1,735,6,741,1377,3,1,3,0,1,0,53.81
基隆市,暖暖區,八中里,177,1,334,1,335,613,3,1,3,0,1,0,54.65
基隆市,暖暖區,八堵里,178,1,398,3,401,693,3,1,3,0,1,0,57.86
基隆市,暖暖區,八南里,179,1,297,6,303,613,3,1,3,0,1,0,49.43
基隆市,暖暖區,過港里,180,1,840,8,848,1741,3,1,3,0,1,0,48.71
基隆市,暖暖區,過港里,181,1,840,10,850,1569,3,1,3,0,1,0,54.17
基隆市,暖暖區,暖暖里,182,1,716,7,723,1296,3,1,3,0,1,0,55.79
基隆市,暖暖區,暖暖里,183,1,474,5,479,933,3,1,3,0,1,0,51.34
基隆市,暖暖區,暖同里,184,1,525,2,527,948,3,1,3,0,1,0,55.59
基隆市,暖暖區,暖同里,185,1,649,4,653,1327,3,1,3,0,1,0,49.21
基隆市,暖暖區,暖東里,186,1,231,3,234,393,3,1,3,0,1,0,59.54
基隆市,暖暖區,暖西里,187,1,1057,7,1064,2108,3,1,3,0,1,0,50.47
基隆市,暖暖區,暖西里,188,1,800,8,808,1547,3,1,3,0,1,0,52.23
基隆市,暖暖區,碇內里,189,1,624,9,633,1087,3,1,3,0,1,0,58.23
基隆市,暖暖區,碇內里,190,1,551,3,554,1150,3,1,3,0,1,0,48.17
基隆市,暖暖區,碇和里,191,1,476,6,482,716,3,1,3,0,1,0,67.32
基隆市,暖暖區,碇和里,192,1,737,4,741,1537,3,1,3,0,1,0,48.21
基隆市,暖暖區,碇祥里,193,1,902,4,906,1879,3,1,3,0,1,0,48.22
基隆市,暖暖區,碇祥里,194,1,658,3,661,1508,3,1,3,0,1,0,43.83
基隆市,暖暖區,碇安里,195,1,1276,11,1287,2479,3,1,3,0,1,0,51.92
基隆市,暖暖區,碇安里,196,1,936,7,943,1897,3,1,3,0,1,0,49.71
基隆市,七堵區,長興里,197,1,786,5,791,1435,3,1,3,0,1,0,55.12
基隆市,七堵區,長興里,198,1,687,2,689,1401,3,1,3,0,1,0,49.18
基隆市,七堵區,長興里,199,1,439,8,447,811,3,1,3,0,1,0,55.12
基隆市,七堵區,正光里,200,1,584,11,595,1117,3,1,3,0,1,0,53.27
基隆市,七堵區,正光里,201,1,652,8,660,1113,3,1,3,0,1,0,59.30
基隆市,七堵區,正明里,202,1,671,3,674,1167,3,1,3,0,1,0,57.75
基隆市,七堵區,正明里,203,1,427,8,435,790,3,1,3,0,1,0,55.06
基隆市,七堵區,富民里,204,1,949,4,953,1748,3,1,3,0,1,0,54.52
基隆市,七堵區,富民里,205,1,1092,12,1104,1878,3,1,3,0,1,0,58.79
基隆市,七堵區,永平里,206,1,550,8,558,950,3,1,3,0,1,0,58.74
基隆市,七堵區,永平里,207,1,599,5,604,1060,3,1,3,0,1,0,56.98
基隆市,七堵區,永安里,208,1,611,2,613,1148,3,1,3,0,1,0,53.40
基隆市,七堵區,永安里,209,1,443,3,446,854,3,1,3,0,1,0,52.22
基隆市,七堵區,八德里,210,1,144,1,145,297,3,1,3,0,1,0,48.82
基隆市,七堵區,八德里,211,1,643,4,647,1241,3,1,3,0,1,0,52.14
基隆市,七堵區,自強里,212,1,467,11,478,926,3,1,3,0,1,0,51.62
基隆市,七堵區,泰安里,213,1,388,3,391,784,3,1,3,0,1,0,49.87
基隆市,七堵區,泰安里,214,1,704,6,710,1488,3,1,3,0,1,0,47.72
基隆市,七堵區,泰安里,215,1,467,5,472,938,3,1,3,0,1,0,50.32
基隆市,七堵區,六堵里,216,1,698,9,707,1415,3,1,3,0,1,0,49.96
基隆市,七堵區,堵南里,217,1,693,5,698,1483,3,1,3,0,1,0,47.07
基隆市,七堵區,堵南里,218,1,786,7,793,1776,3,1,3,0,1,0,44.65
基隆市,七堵區,堵北里,219,1,660,7,667,1383,3,1,3,0,1,0,48.23
基隆市,七堵區,堵北里,220,1,858,6,864,1663,3,1,3,0,1,0,51.95
基隆市,七堵區,百福里,221,1,616,4,620,1305,3,1,3,0,1,0,47.51
基隆市,七堵區,百福里,222,1,754,4,758,1614,3,1,3,0,1,0,46.96
基隆市,七堵區,百福里,223,1,705,2,707,1566,3,1,3,0,1,0,45.15
基隆市,七堵區,實踐里,224,1,554,7,561,1189,3,1,3,0,1,0,47.18
基隆市,七堵區,實踐里,225,1,436,0,436,934,3,1,3,0,1,0,46.68
基隆市,七堵區,實踐里,226,1,554,4,558,1228,3,1,3,0,1,0,45.44
基隆市,七堵區,瑪南里,227,1,243,1,244,451,3,1,3,0,1,0,54.10
基隆市,七堵區,瑪東里,228,1,182,0,182,300,3,1,3,0,1,0,60.67
基隆市,七堵區,瑪西里,229,1,201,4,205,350,3,1,3,0,1,0,58.57
基隆市,七堵區,友一里,230,1,739,3,742,1409,3,1,3,0,1,0,52.66
基隆市,七堵區,友二里,231,1,256,1,257,438,3,1,3,0,1,0,58.68
新竹市,東區,育賢里,1,1,512,5,517,1232,3,1,3,0,1,0,41.96
新竹市,東區,親仁里,2,1,499,0,499,931,3,1,3,0,1,0,53.60
新竹市,東區,親仁里,3,1,439,3,442,804,3,1,3,0,1,0,54.98
新竹市,東區,東門里,4,1,411,3,414,708,3,1,3,0,1,0,58.47
新竹市,東區,成功里,5,1,411,2,413,757,3,1,3,0,1,0,54.56
新竹市,東區,榮光里,6,1,228,2,230,442,3,1,3,0,1,0,52.04
新竹市,東區,中正里,7,1,282,2,284,481,3,1,3,0,1,0,59.04
新竹市,東區,錦華里,8,1,542,2,544,987,3,1,3,0,1,0,55.12
新竹市,東區,錦華里,9,1,450,4,454,748,3,1,3,0,1,0,60.70
新竹市,東區,文華里,10,1,658,4,662,1168,3,1,3,0,1,0,56.68
新竹市,東區,文華里,11,1,576,4,580,957,3,1,3,0,1,0,60.61
新竹市,東區,文華里,12,1,755,3,758,1405,3,1,3,0,1,0,53.95
新竹市,東區,復中里,13,1,700,7,707,1273,3,1,3,0,1,0,55.54
新竹市,東區,復中里,14,1,688,9,697,1266,3,1,3,0,1,0,55.06
新竹市,東區,復中里,15,1,686,8,694,1298,3,1,3,0,1,0,53.47
新竹市,東區,復興里,16,1,622,3,625,1145,3,1,3,0,1,0,54.59
新竹市,東區,復興里,17,1,668,1,669,1240,3,1,3,0,1,0,53.95
新竹市,東區,復興里,18,1,667,2,669,1239,3,1,3,0,1,0,54.00
新竹市,東區,三民里,19,1,731,5,736,1290,3,1,3,0,1,0,57.05
新竹市,東區,三民里,20,1,802,3,805,1392,3,1,3,0,1,0,57.83
新竹市,東區,三民里,21,1,676,3,679,1226,3,1,3,0,1,0,55.38
新竹市,東區,東園里,22,1,535,4,539,984,3,1,3,0,1,0,54.78
新竹市,東區,東園里,23,1,912,10,922,1613,3,1,3,0,1,0,57.16
新竹市,東區,公園里,24,1,490,3,493,938,3,1,3,0,1,0,52.56
新竹市,東區,公園里,25,1,771,5,776,1306,3,1,3,0,1,0,59.42
新竹市,東區,建華里,26,1,660,2,662,1184,3,1,3,0,1,0,55.91
新竹市,東區,建華里,27,1,523,2,525,944,3,1,3,0,1,0,55.61
新竹市,東區,東山里,28,1,496,7,503,899,3,1,3,0,1,0,55.95
新竹市,東區,東山里,29,1,611,5,616,994,3,1,3,0,1,0,61.97
新竹市,東區,東山里,30,1,554,5,559,987,3,1,3,0,1,0,56.64
新竹市,東區,綠水里,31,1,688,5,693,1206,3,1,3,0,1,0,57.46
新竹市,東區,綠水里,32,1,903,3,906,1659,3,1,3,0,1,0,54.61
新竹市,東區,綠水里,33,1,824,5,829,1421,3,1,3,0,1,0,58.34
新竹市,東區,東勢里,34,1,571,4,575,1059,3,1,3,0,1,0,54.3
新竹市,東區,光復里,35,1,502,0,502,871,3,1,3,0,1,0,57.63
新竹市,東區,光復里,36,1,511,2,513,975,3,1,3,0,1,0,52.62
新竹市,東區,前溪里,37,1,781,8,789,1520,3,1,3,0,1,0,51.91
新竹市,東區,前溪里,38,1,501,7,508,952,3,1,3,0,1,0,53.36
新竹市,東區,水源里,39,1,786,22,808,1488,3,1,3,0,1,0,54.30
新竹市,東區,水源里,40,1,893,2,895,1570,3,1,3,0,1,0,57.01
新竹市,東區,千甲里,41,1,503,10,513,855,3,1,3,0,1,0,60
新竹市,東區,千甲里,42,1,536,4,540,904,3,1,3,0,1,0,59.73
新竹市,東區,豐功里,43,1,777,4,781,1332,3,1,3,0,1,0,58.63
新竹市,東區,豐功里,44,1,663,5,668,1181,3,1,3,0,1,0,56.56
新竹市,東區,武功里,45,1,893,4,897,1411,3,1,3,0,1,0,63.57
新竹市,東區,武功里,46,1,782,0,782,1192,3,1,3,0,1,0,65.60
新竹市,東區,武功里,47,1,570,2,572,903,3,1,3,0,1,0,63.34
新竹市,東區,軍功里,48,1,647,5,652,1075,3,1,3,0,1,0,60.65
新竹市,東區,軍功里,49,1,653,5,658,1132,3,1,3,0,1,0,58.13
新竹市,東區,軍功里,50,1,633,2,635,1062,3,1,3,0,1,0,59.79
新竹市,東區,立功里,51,1,499,5,504,852,3,1,3,0,1,0,59.15
新竹市,東區,建功里,52,1,365,7,372,658,3,1,3,0,1,0,56.53
新竹市,東區,建功里,53,1,551,1,552,850,3,1,3,0,1,0,64.94
新竹市,東區,建功里,54,1,466,3,469,676,3,1,3,0,1,0,69.38
新竹市,東區,光明里,55,1,702,2,704,1188,3,1,3,0,1,0,59.26
新竹市,東區,光明里,56,1,335,2,337,525,3,1,3,0,1,0,64.19
新竹市,東區,光明里,57,1,791,5,796,1497,3,1,3,0,1,0,53.17
新竹市,東區,龍山里,58,1,546,5,551,992,3,1,3,0,1,0,55.54
新竹市,東區,龍山里,59,1,339,1,340,712,3,1,3,0,1,0,47.75
新竹市,東區,龍山里,60,1,627,4,631,1064,3,1,3,0,1,0,59.30
新竹市,東區,科園里,61,1,665,5,670,1183,3,1,3,0,1,0,56.64
新竹市,東區,科園里,62,1,711,3,714,1222,3,1,3,0,1,0,58.43
新竹市,東區,科園里,63,1,852,5,857,1347,3,1,3,0,1,0,63.62
新竹市,東區,科園里,64,1,785,3,788,1357,3,1,3,0,1,0,58.07
新竹市,東區,埔頂里,65,1,678,10,688,1203,3,1,3,0,1,0,57.19
新竹市,東區,埔頂里,66,1,593,1,594,1061,3,1,3,0,1,0,55.98
新竹市,東區,新莊里,67,1,763,7,770,1415,3,1,3,0,1,0,54.42
新竹市,東區,新莊里,68,1,728,8,736,1391,3,1,3,0,1,0,52.91
新竹市,東區,新莊里,69,1,659,4,663,1140,3,1,3,0,1,0,58.16
新竹市,東區,關東里,70,1,588,2,590,1075,3,1,3,0,1,0,54.88
新竹市,東區,關東里,71,1,614,7,621,1171,3,1,3,0,1,0,53.03
新竹市,東區,關東里,72,1,759,7,766,1377,3,1,3,0,1,0,55.63
新竹市,東區,金山里,73,1,744,2,746,1508,3,1,3,0,1,0,49.47
新竹市,東區,金山里,74,1,866,7,873,1489,3,1,3,0,1,0,58.63
新竹市,東區,金山里,75,1,696,2,698,1348,3,1,3,0,1,0,51.78
新竹市,東區,仙水里,76,1,940,4,944,1693,3,1,3,0,1,0,55.76
新竹市,東區,仙水里,77,1,919,4,923,1656,3,1,3,0,1,0,55.74
新竹市,東區,仙宮里,78,1,537,0,537,874,3,1,3,0,1,0,61.44
新竹市,東區,關帝里,79,1,318,1,319,591,3,1,3,0,1,0,53.98
新竹市,東區,南門里,80,1,391,3,394,688,3,1,3,0,1,0,57.27
新竹市,東區,南市里,81,1,510,3,513,887,3,1,3,0,1,0,57.84
新竹市,東區,福德里,82,1,711,8,719,1300,3,1,3,0,1,0,55.31
新竹市,東區,振興里,83,1,644,5,649,1226,3,1,3,0,1,0,52.94
新竹市,東區,振興里,84,1,579,2,581,1055,3,1,3,0,1,0,55.07
新竹市,東區,振興里,85,1,582,7,589,1109,3,1,3,0,1,0,53.11
新竹市,東區,振興里,86,1,510,0,510,1101,3,1,3,0,1,0,46.32
新竹市,東區,新興里,87,1,555,5,560,971,3,1,3,0,1,0,57.67
新竹市,東區,新興里,88,1,615,7,622,1106,3,1,3,0,1,0,56.24
新竹市,東區,新興里,89,1,548,2,550,1006,3,1,3,0,1,0,54.67
新竹市,東區,寺前里,90,1,459,1,460,858,3,1,3,0,1,0,53.61
新竹市,東區,竹蓮里,91,1,476,3,479,813,3,1,3,0,1,0,58.92
新竹市,東區,下竹里,92,1,389,5,394,712,3,1,3,0,1,0,55.34
新竹市,東區,頂竹里,93,1,499,3,502,957,3,1,3,0,1,0,52.46
新竹市,東區,頂竹里,94,1,561,3,564,979,3,1,3,0,1,0,57.61
新竹市,東區,頂竹里,95,1,568,1,569,1040,3,1,3,0,1,0,54.71
新竹市,東區,南大里,96,1,346,1,347,652,3,1,3,0,1,0,53.22
新竹市,東區,南大里,97,1,467,4,471,844,3,1,3,0,1,0,55.81
新竹市,東區,新光里,98,1,440,5,445,816,3,1,3,0,1,0,54.53
新竹市,東區,新光里,99,1,663,5,668,1263,3,1,3,0,1,0,52.89
新竹市,東區,新光里,100,1,619,1,620,1170,3,1,3,0,1,0,52.99
新竹市,東區,光鎮里,101,1,696,6,702,1475,3,1,3,0,1,0,47.59
新竹市,東區,光鎮里,102,1,861,5,866,1543,3,1,3,0,1,0,56.12
新竹市,東區,高峰里,103,1,745,7,752,1321,3,1,3,0,1,0,56.93
新竹市,東區,高峰里,104,1,588,5,593,1211,3,1,3,0,1,0,48.97
新竹市,東區,高峰里,105,1,665,2,667,1270,3,1,3,0,1,0,52.52
新竹市,東區,高峰里,106,1,599,6,605,1199,3,1,3,0,1,0,50.46
新竹市,東區,湖濱里,107,1,897,6,903,1735,3,1,3,0,1,0,52.05
新竹市,東區,湖濱里,108,1,621,10,631,1191,3,1,3,0,1,0,52.98
新竹市,東區,柴橋里,109,1,603,2,605,1185,3,1,3,0,1,0,51.05
新竹市,東區,柴橋里,110,1,635,3,638,1165,3,1,3,0,1,0,54.76
新竹市,東區,柴橋里,111,1,623,2,625,1122,3,1,3,0,1,0,55.70
新竹市,東區,明湖里,112,1,475,2,477,1057,3,1,3,0,1,0,45.13
新竹市,東區,明湖里,113,1,571,2,573,1067,3,1,3,0,1,0,53.70
新竹市,東區,明湖里,114,1,424,2,426,1101,3,1,3,0,1,0,38.69
新竹市,北區,西門里,115,1,273,5,278,521,3,1,3,0,1,0,53.36
新竹市,北區,潛園里,116,1,469,5,474,793,3,1,3,0,1,0,59.77
新竹市,北區,中央里,117,1,335,3,338,528,3,1,3,0,1,0,64.02
新竹市,北區,石坊里,118,1,293,2,295,538,3,1,3,0,1,0,54.83
新竹市,北區,仁德里,119,1,413,5,418,743,3,1,3,0,1,0,56.26
新竹市,北區,崇禮里,120,1,699,6,705,1168,3,1,3,0,1,0,60.36
新竹市,北區,興南里,121,1,685,4,689,1236,3,1,3,0,1,0,55.74
新竹市,北區,育英里,122,1,601,2,603,1123,3,1,3,0,1,0,53.70
新竹市,北區,育英里,123,1,569,3,572,1034,3,1,3,0,1,0,55.32
新竹市,北區,育英里,124,1,636,4,640,1246,3,1,3,0,1,0,51.36
新竹市,北區,台溪里,125,1,640,6,646,1291,3,1,3,0,1,0,50.04
新竹市,北區,曲溪里,126,1,420,3,423,797,3,1,3,0,1,0,53.07
新竹市,北區,曲溪里,127,1,471,4,475,907,3,1,3,0,1,0,52.37
新竹市,北區,曲溪里,128,1,510,7,517,1037,3,1,3,0,1,0,49.86
新竹市,北區,曲溪里,129,1,358,8,366,556,3,1,3,0,1,0,65.83
新竹市,北區,曲溪里,130,1,778,2,780,1401,3,1,3,0,1,0,55.67
新竹市,北區,西雅里,131,1,711,5,716,1317,3,1,3,0,1,0,54.37
新竹市,北區,西雅里,132,1,684,5,689,1194,3,1,3,0,1,0,57.71
新竹市,北區,客雅里,133,1,387,2,389,809,3,1,3,0,1,0,48.08
新竹市,北區,客雅里,134,1,575,4,579,928,3,1,3,0,1,0,62.39
新竹市,北區,客雅里,135,1,537,10,547,1003,3,1,3,0,1,0,54.54
新竹市,北區,南勢里,136,1,529,3,532,960,3,1,3,0,1,0,55.42
新竹市,北區,南勢里,137,1,750,3,753,1396,3,1,3,0,1,0,53.94
新竹市,北區,南勢里,138,1,600,19,619,1066,3,1,3,0,1,0,58.07
新竹市,北區,大鵬里,139,1,532,6,538,826,3,1,3,0,1,0,65.13
新竹市,北區,大鵬里,140,1,435,5,440,645,3,1,3,0,1,0,68.22
新竹市,北區,大同里,141,1,390,6,396,712,3,1,3,0,1,0,55.62
新竹市,北區,中山里,142,1,391,2,393,656,3,1,3,0,1,0,59.91
新竹市,北區,中興里,143,1,334,3,337,582,3,1,3,0,1,0,57.90
新竹市,北區,新民里,144,1,710,12,722,1275,3,1,3,0,1,0,56.63
新竹市,北區,長和里,145,1,644,3,647,1157,3,1,3,0,1,0,55.92
新竹市,北區,北門里,146,1,521,3,524,906,3,1,3,0,1,0,57.84
新竹市,北區,民富里,147,1,659,8,667,1231,3,1,3,0,1,0,54.18
新竹市,北區,民富里,148,1,705,3,708,1423,3,1,3,0,1,0,49.75
新竹市,北區,民富里,149,1,622,8,630,1361,3,1,3,0,1,0,46.29
新竹市,北區,磐石里,150,1,671,3,674,1332,3,1,3,0,1,0,50.60
新竹市,北區,磐石里,151,1,795,4,799,1559,3,1,3,0,1,0,51.25
新竹市,北區,磐石里,152,1,658,4,662,1217,3,1,3,0,1,0,54.40
新竹市,北區,新雅里,153,1,600,4,604,1254,3,1,3,0,1,0,48.17
新竹市,北區,新雅里,154,1,682,5,687,1247,3,1,3,0,1,0,55.09
新竹市,北區,新雅里,155,1,604,4,608,1140,3,1,3,0,1,0,53.33
新竹市,北區,文雅里,156,1,604,4,608,1114,3,1,3,0,1,0,54.58
新竹市,北區,文雅里,157,1,544,9,553,1021,3,1,3,0,1,0,54.16
新竹市,北區,文雅里,158,1,596,3,599,1028,3,1,3,0,1,0,58.27
新竹市,北區,水田里,159,1,669,3,672,1227,3,1,3,0,1,0,54.77
新竹市,北區,水田里,160,1,843,3,846,1446,3,1,3,0,1,0,58.51
新竹市,北區,光田里,161,1,507,3,510,907,3,1,3,0,1,0,56.23
新竹市,北區,光田里,162,1,632,3,635,1107,3,1,3,0,1,0,57.36
新竹市,北區,光華里,163,1,625,3,628,1549,3,1,3,0,1,0,40.54
新竹市,北區,光華里,164,1,782,4,786,1540,3,1,3,0,1,0,51.04
新竹市,北區,金華里,165,1,672,3,675,1266,3,1,3,0,1,0,53.32
新竹市,北區,金華里,166,1,620,4,624,1245,3,1,3,0,1,0,50.12
新竹市,北區,金華里,167,1,606,5,611,1207,3,1,3,0,1,0,50.62
新竹市,北區,湳雅里,168,1,564,3,567,1133,3,1,3,0,1,0,50.04
新竹市,北區,湳雅里,169,1,759,6,765,1425,3,1,3,0,1,0,53.68
新竹市,北區,金雅里,170,1,780,6,786,1356,3,1,3,0,1,0,57.96
新竹市,北區,湳中里,171,1,837,13,850,1567,3,1,3,0,1,0,54.24
新竹市,北區,湳中里,172,1,780,2,782,1536,3,1,3,0,1,0,50.91
新竹市,北區,湳中里,173,1,726,5,731,1456,3,1,3,0,1,0,50.21
新竹市,北區,舊社里,174,1,627,2,629,1221,3,1,3,0,1,0,51.52
新竹市,北區,舊社里,175,1,581,0,581,1187,3,1,3,0,1,0,48.95
新竹市,北區,舊社里,176,1,671,3,674,1289,3,1,3,0,1,0,52.29
新竹市,北區,舊社里,177,1,542,6,548,1041,3,1,3,0,1,0,52.64
新竹市,北區,金竹里,178,1,745,3,748,1492,3,1,3,0,1,0,50.13
新竹市,北區,金竹里,179,1,773,4,777,1463,3,1,3,0,1,0,53.11
新竹市,北區,金竹里,180,1,654,6,660,1325,3,1,3,0,1,0,49.81
新竹市,北區,武陵里,181,1,635,2,637,1021,3,1,3,0,1,0,62.39
新竹市,北區,武陵里,182,1,619,2,621,944,3,1,3,0,1,0,65.78
新竹市,北區,福林里,183,1,727,3,730,1259,3,1,3,0,1,0,57.98
新竹市,北區,福林里,184,1,962,8,970,1654,3,1,3,0,1,0,58.65
新竹市,北區,境福里,185,1,710,2,712,1316,3,1,3,0,1,0,54.1
新竹市,北區,境福里,186,1,615,5,620,1128,3,1,3,0,1,0,54.96
新竹市,北區,境福里,187,1,699,8,707,1312,3,1,3,0,1,0,53.89
新竹市,北區,士林里,188,1,753,7,760,1256,3,1,3,0,1,0,60.51
新竹市,北區,士林里,189,1,483,1,484,724,3,1,3,0,1,0,66.85
新竹市,北區,士林里,190,1,526,3,529,850,3,1,3,0,1,0,62.24
新竹市,北區,古賢里,191,1,429,5,434,875,3,1,3,0,1,0,49.60
新竹市,北區,南寮里,192,1,562,3,565,1066,3,1,3,0,1,0,53.00
新竹市,北區,南寮里,193,1,544,3,547,1112,3,1,3,0,1,0,49.19
新竹市,北區,南寮里,194,1,837,6,843,1641,3,1,3,0,1,0,51.37
新竹市,北區,康樂里,195,1,515,3,518,944,3,1,3,0,1,0,54.87
新竹市,北區,康樂里,196,1,437,4,441,821,3,1,3,0,1,0,53.71
新竹市,北區,中寮里,197,1,809,6,815,1542,3,1,3,0,1,0,52.85
新竹市,北區,海濱里,198,1,459,4,463,800,3,1,3,0,1,0,57.88
新竹市,北區,海濱里,199,1,462,2,464,1038,3,1,3,0,1,0,44.70
新竹市,北區,港北里,200,1,676,3,679,1191,3,1,3,0,1,0,57.01
新竹市,北區,舊港里,201,1,322,4,326,554,3,1,3,0,1,0,58.84
新竹市,香山區,頂埔里,202,1,653,2,655,1264,3,1,3,0,1,0,51.82
新竹市,香山區,頂埔里,203,1,625,5,630,1378,3,1,3,0,1,0,45.72
新竹市,香山區,頂福里,204,1,670,3,673,1307,3,1,3,0,1,0,51.49
新竹市,香山區,頂福里,205,1,747,7,754,1478,3,1,3,0,1,0,51.01
新竹市,香山區,中埔里,206,1,675,6,681,1275,3,1,3,0,1,0,53.41
新竹市,香山區,中埔里,207,1,585,1,586,1142,3,1,3,0,1,0,51.31
新竹市,香山區,牛埔里,208,1,640,2,642,1143,3,1,3,0,1,0,56.17
新竹市,香山區,牛埔里,209,1,597,6,603,1331,3,1,3,0,1,0,45.30
新竹市,香山區,埔前里,210,1,704,6,710,1343,3,1,3,0,1,0,52.87
新竹市,香山區,埔前里,211,1,681,3,684,1163,3,1,3,0,1,0,58.81
新竹市,香山區,樹下里,212,1,526,9,535,1026,3,1,3,0,1,0,52.14
新竹市,香山區,樹下里,213,1,440,5,445,851,3,1,3,0,1,0,52.29
新竹市,香山區,浸水里,214,1,874,6,880,1603,3,1,3,0,1,0,54.90
新竹市,香山區,虎林里,215,1,568,5,573,998,3,1,3,0,1,0,57.41
新竹市,香山區,虎林里,216,1,580,3,583,993,3,1,3,0,1,0,58.71
新竹市,香山區,虎山里,217,1,668,16,684,1324,3,1,3,0,1,0,51.66
新竹市,香山區,虎山里,218,1,676,8,684,1464,3,1,3,0,1,0,46.72
新竹市,香山區,虎山里,219,1,465,4,469,882,3,1,3,0,1,0,53.17
新竹市,香山區,虎山里,220,1,571,4,575,1096,3,1,3,0,1,0,52.46
新竹市,香山區,港南里,221,1,536,4,540,1000,3,1,3,0,1,0,54.00
新竹市,香山區,港南里,222,1,473,4,477,903,3,1,3,0,1,0,52.82
新竹市,香山區,東香里,223,1,338,0,338,668,3,1,3,0,1,0,50.60
新竹市,香山區,東香里,224,1,940,5,945,1754,3,1,3,0,1,0,53.88
新竹市,香山區,香村里,225,1,517,8,525,1010,3,1,3,0,1,0,51.98
新竹市,香山區,香村里,226,1,519,1,520,1049,3,1,3,0,1,0,49.57
新竹市,香山區,香山里,227,1,748,5,753,1447,3,1,3,0,1,0,52.04
新竹市,香山區,香山里,228,1,615,4,619,1352,3,1,3,0,1,0,45.78
新竹市,香山區,大庄里,229,1,567,3,570,1005,3,1,3,0,1,0,56.72
新竹市,香山區,大庄里,230,1,536,2,538,1048,3,1,3,0,1,0,51.34
新竹市,香山區,美山里,231,1,512,5,517,980,3,1,3,0,1,0,52.76
新竹市,香山區,朝山里,232,1,419,0,419,785,3,1,3,0,1,0,53.38
新竹市,香山區,朝山里,233,1,480,4,484,923,3,1,3,0,1,0,52.44
新竹市,香山區,海山里,234,1,548,7,555,1007,3,1,3,0,1,0,55.11
新竹市,香山區,海山里,235,1,407,2,409,880,3,1,3,0,1,0,46.48
新竹市,香山區,鹽水里,236,1,645,8,653,1178,3,1,3,0,1,0,55.43
新竹市,香山區,內湖里,237,1,587,2,589,1193,3,1,3,0,1,0,49.37
新竹市,香山區,內湖里,238,1,525,8,533,1091,3,1,3,0,1,0,48.85
新竹市,香山區,內湖里,239,1,572,6,578,1217,3,1,3,0,1,0,47.49
新竹市,香山區,南港里,240,1,438,4,442,801,3,1,3,0,1,0,55.18
新竹市,香山區,中隘里,241,1,693,7,700,1332,3,1,3,0,1,0,52.55
新竹市,香山區,南隘里,242,1,339,4,343,641,3,1,3,0,1,0,53.51
新竹市,香山區,大湖里,243,1,366,5,371,722,3,1,3,0,1,0,51.39
新竹市,香山區,茄苳里,244,1,424,5,429,800,3,1,3,0,1,0,53.63
臺中市,中區,綠川里,1,1,541,5,546,936,3,1,3,0,1,0,58.33
臺中市,中區,綠川里,2,1,575,6,581,992,3,1,3,0,1,0,58.57
臺中市,中區,繼光里,3,1,976,4,980,1705,3,1,3,0,1,0,57.48
臺中市,中區,公園里,4,1,922,3,925,1696,3,1,3,0,1,0,54.54
臺中市,中區,光復里,5,1,731,7,738,1294,3,1,3,0,1,0,57.03
臺中市,中區,光復里,6,1,634,3,637,1142,3,1,3,0,1,0,55.78
臺中市,中區,大墩里,7,1,770,6,776,1396,3,1,3,0,1,0,55.59
臺中市,中區,大墩里,8,1,553,6,559,1021,3,1,3,0,1,0,54.75
臺中市,中區,柳川里,9,1,1047,7,1054,1860,3,1,3,0,1,0,56.67
臺中市,中區,大誠里,10,1,488,5,493,832,3,1,3,0,1,0,59.25
臺中市,中區,大誠里,11,1,715,7,722,1206,3,1,3,0,1,0,59.87
臺中市,中區,中華里,12,1,1047,8,1055,1828,3,1,3,0,1,0,57.71
臺中市,東區,新庄里,13,1,560,7,567,1124,3,1,3,0,1,0,50.44
臺中市,東區,新庄里,14,1,651,6,657,1164,3,1,3,0,1,0,56.44
臺中市,東區,新庄里,15,1,681,10,691,1116,3,1,3,0,1,0,61.92
臺中市,東區,振興里,16,1,667,3,670,1082,3,1,3,0,1,0,61.92
臺中市,東區,振興里,17,1,680,7,687,1140,3,1,3,0,1,0,60.26
臺中市,東區,振興里,18,1,671,5,676,1095,3,1,3,0,1,0,61.74
臺中市,東區,東橋里,19,1,645,1,646,1144,3,1,3,0,1,0,56.47
臺中市,東區,東橋里,20,1,624,7,631,1093,3,1,3,0,1,0,57.73
臺中市,東區,東橋里,21,1,650,3,653,1102,3,1,3,0,1,0,59.26
臺中市,東區,東興里,22,1,647,6,653,1170,3,1,3,0,1,0,55.81
臺中市,東區,東興里,23,1,517,3,520,823,3,1,3,0,1,0,63.18
臺中市,東區,東興里,24,1,554,1,555,922,3,1,3,0,1,0,60.20
臺中市,東區,泉源里,25,1,499,2,501,848,3,1,3,0,1,0,59.08
臺中市,東區,泉源里,26,1,587,8,595,981,3,1,3,0,1,0,60.65
臺中市,東區,干城里,27,1,836,4,840,1346,3,1,3,0,1,0,62.41
臺中市,東區,干城里,28,1,615,3,618,1071,3,1,3,0,1,0,57.70
臺中市,東區,旱溪里,29,1,839,3,842,1464,3,1,3,0,1,0,57.51
臺中市,東區,旱溪里,30,1,543,1,544,901,3,1,3,0,1,0,60.38
臺中市,東區,樂成里,31,1,564,8,572,952,3,1,3,0,1,0,60.08
臺中市,東區,樂成里,32,1,504,2,506,920,3,1,3,0,1,0,55.00
臺中市,東區,東門里,33,1,698,4,702,1142,3,1,3,0,1,0,61.47
臺中市,東區,東門里,34,1,714,5,719,1260,3,1,3,0,1,0,57.06
臺中市,東區,東門里,35,1,775,2,777,1213,3,1,3,0,1,0,64.06
臺中市,東區,東門里,36,1,716,2,718,1207,3,1,3,0,1,0,59.49
臺中市,東區,十甲里,37,1,719,14,733,1388,3,1,3,0,1,0,52.81
臺中市,東區,十甲里,38,1,852,7,859,1394,3,1,3,0,1,0,61.62
臺中市,東區,東英里,39,1,728,7,735,1319,3,1,3,0,1,0,55.72
臺中市,東區,東英里,40,1,694,7,701,1223,3,1,3,0,1,0,57.32
臺中市,東區,東英里,41,1,789,6,795,1461,3,1,3,0,1,0,54.41
臺中市,東區,東南里,42,1,869,8,877,1407,3,1,3,0,1,0,62.33
臺中市,東區,東南里,43,1,445,4,449,722,3,1,3,0,1,0,62.19
臺中市,東區,東南里,44,1,635,5,640,1180,3,1,3,0,1,0,54.24
臺中市,東區,東勢里,45,1,851,6,857,1508,3,1,3,0,1,0,56.83
臺中市,東區,東勢里,46,1,785,2,787,1326,3,1,3,0,1,0,59.35
臺中市,東區,合作里,47,1,731,4,735,1247,3,1,3,0,1,0,58.94
臺中市,東區,合作里,48,1,796,4,800,1330,3,1,3,0,1,0,60.15
臺中市,東區,富仁里,49,1,864,8,872,1263,3,1,3,0,1,0,69.04
臺中市,東區,富仁里,50,1,560,4,564,1003,3,1,3,0,1,0,56.23
臺中市,東區,富仁里,51,1,574,2,576,982,3,1,3,0,1,0,58.66
臺中市,東區,富臺里,52,1,1006,4,1010,1653,3,1,3,0,1,0,61.10
臺中市,東區,東信里,53,1,656,7,663,1079,3,1,3,0,1,0,61.45
臺中市,東區,東信里,54,1,661,9,670,1127,3,1,3,0,1,0,59.45
臺中市,東區,東信里,55,1,795,6,801,1303,3,1,3,0,1,0,61.47
臺中市,東區,東信里,56,1,628,3,631,1019,3,1,3,0,1,0,61.92
臺中市,東區,東信里,57,1,490,2,492,870,3,1,3,0,1,0,56.55
臺中市,西區,三民里,58,1,1044,6,1050,2171,3,1,3,0,1,0,48.36
臺中市,西區,平和里,59,1,960,7,967,1776,3,1,3,0,1,0,54.45
臺中市,西區,利民里,60,1,1092,8,1100,1966,3,1,3,0,1,0,55.95
臺中市,西區,公民里,61,1,751,5,756,1332,3,1,3,0,1,0,56.76
臺中市,西區,公民里,62,1,723,6,729,1271,3,1,3,0,1,0,57.36
臺中市,西區,公民里,63,1,893,10,903,1581,3,1,3,0,1,0,57.12
臺中市,西區,廣民里,64,1,1029,12,1041,1756,3,1,3,0,1,0,59.28
臺中市,西區,東昇里,65,1,694,3,697,1152,3,1,3,0,1,0,60.50
臺中市,西區,東昇里,66,1,643,1,644,1122,3,1,3,0,1,0,57.40
臺中市,西區,民生里,67,1,678,3,681,1157,3,1,3,0,1,0,58.86
臺中市,西區,民生里,68,1,557,3,560,929,3,1,3,0,1,0,60.28
臺中市,西區,昇平里,69,1,792,8,800,1362,3,1,3,0,1,0,58.74
臺中市,西區,昇平里,70,1,1000,4,1004,1829,3,1,3,0,1,0,54.89
臺中市,西區,昇平里,71,1,880,7,887,1712,3,1,3,0,1,0,51.81
臺中市,西區,藍興里,72,1,1099,4,1103,1824,3,1,3,0,1,0,60.47
臺中市,西區,藍興里,73,1,750,6,756,1295,3,1,3,0,1,0,58.38
臺中市,西區,公館里,74,1,879,10,889,1488,3,1,3,0,1,0,59.74
臺中市,西區,公館里,75,1,986,8,994,1514,3,1,3,0,1,0,65.65
臺中市,西區,公館里,76,1,932,7,939,1701,3,1,3,0,1,0,55.20
臺中市,西區,和龍里,77,1,575,8,583,969,3,1,3,0,1,0,60.17
臺中市,西區,和龍里,78,1,657,7,664,1196,3,1,3,0,1,0,55.52
臺中市,西區,民龍里,79,1,829,8,837,1460,3,1,3,0,1,0,57.33
臺中市,西區,民龍里,80,1,547,1,548,993,3,1,3,0,1,0,55.19
臺中市,西區,安龍里,81,1,785,4,789,1366,3,1,3,0,1,0,57.76
臺中市,西區,安龍里,82,1,617,5,622,1150,3,1,3,0,1,0,54.09
臺中市,西區,吉龍里,83,1,743,13,756,1382,3,1,3,0,1,0,54.70
臺中市,西區,吉龍里,84,1,866,5,871,1509,3,1,3,0,1,0,57.72
臺中市,西區,吉龍里,85,1,758,6,764,1354,3,1,3,0,1,0,56.43
臺中市,西區,吉龍里,86,1,686,4,690,1149,3,1,3,0,1,0,60.05
臺中市,西區,後龍里,87,1,850,8,858,1502,3,1,3,0,1,0,57.12
臺中市,西區,後龍里,88,1,875,2,877,1544,3,1,3,0,1,0,56.80
臺中市,西區,中興里,89,1,911,5,916,1506,3,1,3,0,1,0,60.82
臺中市,西區,中興里,90,1,1021,15,1036,1696,3,1,3,0,1,0,61.08
臺中市,西區,忠明里,91,1,862,9,871,1566,3,1,3,0,1,0,55.62
臺中市,西區,忠明里,92,1,785,5,790,1415,3,1,3,0,1,0,55.83
臺中市,西區,忠明里,93,1,888,6,894,1604,3,1,3,0,1,0,55.74
臺中市,西區,公正里,94,1,903,4,907,1683,3,1,3,0,1,0,53.89
臺中市,西區,公正里,95,1,918,4,922,1708,3,1,3,0,1,0,53.98
臺中市,西區,公正里,96,1,746,5,751,1290,3,1,3,0,1,0,58.22
臺中市,西區,公平里,97,1,1050,5,1055,1836,3,1,3,0,1,0,57.46
臺中市,西區,公平里,98,1,937,4,941,1848,3,1,3,0,1,0,50.92
臺中市,西區,公德里,99,1,852,6,858,1513,3,1,3,0,1,0,56.71
臺中市,西區,公德里,100,1,924,9,933,1780,3,1,3,0,1,0,52.42
臺中市,西區,公益里,101,1,814,2,816,1327,3,1,3,0,1,0,61.49
臺中市,西區,公益里,102,1,862,8,870,1418,3,1,3,0,1,0,61.35
臺中市,西區,土庫里,103,1,803,3,806,1404,3,1,3,0,1,0,57.41
臺中市,西區,土庫里,104,1,944,7,951,1601,3,1,3,0,1,0,59.40
臺中市,西區,土庫里,105,1,848,16,864,1519,3,1,3,0,1,0,56.88
臺中市,西區,忠誠里,106,1,1039,6,1045,1905,3,1,3,0,1,0,54.86
臺中市,西區,忠誠里,107,1,917,4,921,1639,3,1,3,0,1,0,56.19
臺中市,西區,忠誠里,108,1,928,7,935,1566,3,1,3,0,1,0,59.71
臺中市,西區,大忠里,109,1,603,4,607,1039,3,1,3,0,1,0,58.42
臺中市,西區,大忠里,110,1,1091,4,1095,1792,3,1,3,0,1,0,61.10
臺中市,西區,吉龍里,111,1,916,4,920,1579,3,1,3,0,1,0,58.26
臺中市,西區,吉龍里,112,1,723,4,727,1197,3,1,3,0,1,0,60.74
臺中市,南區,長春里,113,1,597,4,601,1078,3,1,3,0,1,0,55.75
臺中市,南區,長春里,114,1,652,3,655,1149,3,1,3,0,1,0,57.01
臺中市,南區,長榮里,115,1,814,7,821,1336,3,1,3,0,1,0,61.45
臺中市,南區,長榮里,116,1,736,5,741,1164,3,1,3,0,1,0,63.66
臺中市,南區,城隍里,117,1,990,6,996,1664,3,1,3,0,1,0,59.86
臺中市,南區,城隍里,118,1,1030,10,1040,1685,3,1,3,0,1,0,61.72
臺中市,南區,國光里,119,1,1090,11,1101,1915,3,1,3,0,1,0,57.49
臺中市,南區,國光里,120,1,1060,8,1068,1648,3,1,3,0,1,0,64.81
臺中市,南區,南門里,121,1,907,5,912,1572,3,1,3,0,1,0,58.02
臺中市,南區,南門里,122,1,925,5,930,1644,3,1,3,0,1,0,56.57
臺中市,南區,德義里,123,1,754,2,756,1266,3,1,3,0,1,0,59.72
臺中市,南區,德義里,124,1,699,3,702,1223,3,1,3,0,1,0,57.40
臺中市,南區,積善里,125,1,632,4,636,1138,3,1,3,0,1,0,55.89
臺中市,南區,積善里,126,1,868,6,874,1502,3,1,3,0,1,0,58.19
臺中市,南區,江川里,127,1,764,3,767,1289,3,1,3,0,1,0,59.50
臺中市,南區,江川里,128,1,509,3,512,935,3,1,3,0,1,0,54.76
臺中市,南區,新榮里,129,1,787,7,794,1632,3,1,3,0,1,0,48.65
臺中市,南區,新榮里,130,1,740,0,740,1654,3,1,3,0,1,0,44.74
臺中市,南區,福興里,131,1,1036,5,1041,1742,3,1,3,0,1,0,59.76
臺中市,南區,福興里,132,1,960,7,967,1667,3,1,3,0,1,0,58.01
臺中市,南區,福平里,133,1,716,4,720,1441,3,1,3,0,1,0,49.97
臺中市,南區,福平里,134,1,809,10,819,1470,3,1,3,0,1,0,55.71
臺中市,南區,福平里,135,1,809,8,817,1498,3,1,3,0,1,0,54.54
臺中市,南區,福順里,136,1,605,8,613,1050,3,1,3,0,1,0,58.38
臺中市,南區,福順里,137,1,612,13,625,1108,3,1,3,0,1,0,56.41
臺中市,南區,福順里,138,1,567,5,572,1063,3,1,3,0,1,0,53.81
臺中市,南區,和平里,139,1,614,7,621,1151,3,1,3,0,1,0,53.95
臺中市,南區,和平里,140,1,559,4,563,1179,3,1,3,0,1,0,47.75
臺中市,南區,平和里,141,1,830,4,834,1522,3,1,3,0,1,0,54.80
臺中市,南區,平和里,142,1,912,10,922,1463,3,1,3,0,1,0,63.02
臺中市,南區,南和里,143,1,685,7,692,1361,3,1,3,0,1,0,50.84
臺中市,南區,南和里,144,1,715,9,724,1218,3,1,3,0,1,0,59.44
臺中市,南區,南和里,145,1,672,6,678,1328,3,1,3,0,1,0,51.05
臺中市,南區,永興里,146,1,837,11,848,1420,3,1,3,0,1,0,59.72
臺中市,南區,永興里,147,1,770,5,775,1505,3,1,3,0,1,0,51.50
臺中市,南區,永興里,148,1,748,3,751,1465,3,1,3,0,1,0,51.26
臺中市,南區,永和里,149,1,883,11,894,1567,3,1,3,0,1,0,57.05
臺中市,南區,永和里,150,1,803,4,807,1483,3,1,3,0,1,0,54.42
臺中市,南區,樹義里,151,1,936,12,948,1675,3,1,3,0,1,0,56.60
臺中市,南區,樹義里,152,1,722,6,728,1626,3,1,3,0,1,0,44.77
臺中市,南區,樹義里,153,1,882,4,886,1754,3,1,3,0,1,0,50.51
臺中市,南區,樹義里,154,1,887,10,897,1739,3,1,3,0,1,0,51.58
臺中市,南區,工學里,155,1,726,4,730,1341,3,1,3,0,1,0,54.44
臺中市,南區,工學里,156,1,654,1,655,1244,3,1,3,0,1,0,52.65
臺中市,南區,工學里,157,1,644,2,646,1202,3,1,3,0,1,0,53.74
臺中市,南區,樹德里,158,1,788,9,797,1586,3,1,3,0,1,0,50.25
臺中市,南區,樹德里,159,1,956,6,962,1883,3,1,3,0,1,0,51.09
臺中市,南區,樹德里,160,1,771,0,771,1514,3,1,3,0,1,0,50.92
臺中市,南區,西川里,161,1,876,5,881,1566,3,1,3,0,1,0,56.26
臺中市,南區,西川里,162,1,847,4,851,1455,3,1,3,0,1,0,58.49
臺中市,南區,崇倫里,163,1,1016,8,1024,1752,3,1,3,0,1,0,58.45
臺中市,南區,崇倫里,164,1,1024,5,1029,1571,3,1,3,0,1,0,65.50
臺中市,北區,中正里,165,1,955,4,959,1609,3,1,3,0,1,0,59.60
臺中市,北區,六合里,166,1,953,4,957,1675,3,1,3,0,1,0,57.13
臺中市,北區,光大里,167,1,487,2,489,866,3,1,3,0,1,0,56.47
臺中市,北區,光大里,168,1,526,7,533,1006,3,1,3,0,1,0,52.98
臺中市,北區,文莊里,169,1,1093,5,1098,1571,3,1,3,0,1,0,69.89
臺中市,北區,文莊里,170,1,935,7,942,1657,3,1,3,0,1,0,56.85
臺中市,北區,大湖里,171,1,569,4,573,1110,3,1,3,0,1,0,51.62
臺中市,北區,大湖里,172,1,675,5,680,1108,3,1,3,0,1,0,61.37
臺中市,北區,五常里,173,1,688,6,694,1279,3,1,3,0,1,0,54.26
臺中市,北區,錦平里,174,1,547,1,548,926,3,1,3,0,1,0,59.18
臺中市,北區,錦平里,175,1,448,12,460,903,3,1,3,0,1,0,50.94
臺中市,北區,新北里,176,1,715,4,719,1245,3,1,3,0,1,0,57.75
臺中市,北區,新北里,177,1,505,1,506,918,3,1,3,0,1,0,55.12
臺中市,北區,新興里,178,1,694,6,700,1177,3,1,3,0,1,0,59.47
臺中市,北區,新興里,179,1,416,3,419,808,3,1,3,0,1,0,51.86
臺中市,北區,樂英里,180,1,686,6,692,1067,3,1,3,0,1,0,64.85
臺中市,北區,樂英里,181,1,733,5,738,1127,3,1,3,0,1,0,65.48
臺中市,北區,樂英里,182,1,545,6,551,992,3,1,3,0,1,0,55.54
臺中市,北區,錦村里,183,1,1046,5,1051,1811,3,1,3,0,1,0,58.03
臺中市,北區,錦村里,184,1,707,5,712,1143,3,1,3,0,1,0,62.29
臺中市,北區,建成里,185,1,810,6,816,1447,3,1,3,0,1,0,56.39
臺中市,北區,建成里,186,1,684,5,689,1337,3,1,3,0,1,0,51.53
臺中市,北區,建成里,187,1,633,4,637,1243,3,1,3,0,1,0,51.25
臺中市,北區,建德里,188,1,1032,9,1041,1784,3,1,3,0,1,0,58.35
臺中市,北區,建德里,189,1,940,4,944,1514,3,1,3,0,1,0,62.35
臺中市,北區,錦洲里,190,1,730,7,737,1281,3,1,3,0,1,0,57.53
臺中市,北區,錦洲里,191,1,789,5,794,1336,3,1,3,0,1,0,59.43
臺中市,北區,錦祥里,192,1,780,4,784,1562,3,1,3,0,1,0,50.19
臺中市,北區,錦祥里,193,1,716,5,721,1285,3,1,3,0,1,0,56.11
臺中市,北區,金華里,194,1,860,7,867,1531,3,1,3,0,1,0,56.63
臺中市,北區,金龍里,195,1,802,6,808,1351,3,1,3,0,1,0,59.81
臺中市,北區,金龍里,196,1,745,2,747,1408,3,1,3,0,1,0,53.05
臺中市,北區,金龍里,197,1,784,4,788,1437,3,1,3,0,1,0,54.84
臺中市,北區,邱厝里,198,1,898,6,904,1688,3,1,3,0,1,0,53.55
臺中市,北區,建興里,199,1,574,4,578,1060,3,1,3,0,1,0,54.53
臺中市,北區,建興里,200,1,555,1,556,1037,3,1,3,0,1,0,53.62
臺中市,北區,建興里,201,1,606,3,609,1041,3,1,3,0,1,0,58.50
臺中市,北區,建興里,202,1,536,5,541,1017,3,1,3,0,1,0,53.20
臺中市,北區,建興里,203,1,551,1,552,1003,3,1,3,0,1,0,55.03
臺中市,北區,頂厝里,204,1,911,4,915,1685,3,1,3,0,1,0,54.30
臺中市,北區,頂厝里,205,1,851,8,859,1637,3,1,3,0,1,0,52.47
臺中市,北區,崇德里,206,1,911,5,916,1589,3,1,3,0,1,0,57.65
臺中市,北區,崇德里,207,1,668,2,670,1159,3,1,3,0,1,0,57.81
臺中市,北區,賴厝里,208,1,809,3,812,2189,3,1,3,0,1,0,37.09
臺中市,北區,賴厝里,209,1,803,3,806,1586,3,1,3,0,1,0,50.82
臺中市,北區,賴福里,210,1,536,2,538,932,3,1,3,0,1,0,57.73
臺中市,北區,賴福里,211,1,857,8,865,1503,3,1,3,0,1,0,57.55
臺中市,北區,賴興里,212,1,823,6,829,1633,3,1,3,0,1,0,50.77
臺中市,北區,賴興里,213,1,779,5,784,1434,3,1,3,0,1,0,54.67
臺中市,北區,賴旺里,214,1,587,4,591,1149,3,1,3,0,1,0,51.44
臺中市,北區,賴旺里,215,1,593,3,596,1229,3,1,3,0,1,0,48.49
臺中市,北區,賴旺里,216,1,637,1,638,1228,3,1,3,0,1,0,51.95
臺中市,北區,賴明里,217,1,456,6,462,1088,3,1,3,0,1,0,42.46
臺中市,北區,賴明里,218,1,626,4,630,1087,3,1,3,0,1,0,57.96
臺中市,北區,賴明里,219,1,575,2,577,1056,3,1,3,0,1,0,54.64
臺中市,北區,梅川里,220,1,538,1,539,1053,3,1,3,0,1,0,51.19
臺中市,北區,梅川里,221,1,651,4,655,1224,3,1,3,0,1,0,53.51
臺中市,北區,賴村里,222,1,760,7,767,1421,3,1,3,0,1,0,53.98
臺中市,北區,賴村里,223,1,733,4,737,1279,3,1,3,0,1,0,57.62
臺中市,北區,賴村里,224,1,718,6,724,1232,3,1,3,0,1,0,58.77
臺中市,北區,育德里,225,1,850,5,855,1493,3,1,3,0,1,0,57.27
臺中市,北區,育德里,226,1,783,5,788,1471,3,1,3,0,1,0,53.57
臺中市,北區,淡溝里,227,1,771,1,772,1315,3,1,3,0,1,0,58.71
臺中市,北區,淡溝里,228,1,812,8,820,1335,3,1,3,0,1,0,61.42
臺中市,北區,淡溝里,229,1,639,6,645,1135,3,1,3,0,1,0,56.83
臺中市,北區,健行里,230,1,901,2,903,1457,3,1,3,0,1,0,61.98
臺中市,北區,健行里,231,1,750,8,758,1292,3,1,3,0,1,0,58.67
臺中市,北區,健行里,232,1,793,6,799,1461,3,1,3,0,1,0,54.69
臺中市,北區,健行里,233,1,689,4,693,1347,3,1,3,0,1,0,51.45
臺中市,北區,明德里,234,1,846,3,849,1491,3,1,3,0,1,0,56.94
臺中市,北區,明德里,235,1,628,6,634,1136,3,1,3,0,1,0,55.81
臺中市,北區,明德里,236,1,976,2,978,1661,3,1,3,0,1,0,58.88
臺中市,北區,明新里,237,1,703,2,705,1349,3,1,3,0,1,0,52.26
臺中市,北區,明新里,238,1,646,1,647,1227,3,1,3,0,1,0,52.73
臺中市,北區,長青里,239,1,881,5,886,1670,3,1,3,0,1,0,53.05
臺中市,北區,長青里,240,1,927,9,936,1620,3,1,3,0,1,0,57.78
臺中市,北區,長青里,241,1,877,4,881,1607,3,1,3,0,1,0,54.82
臺中市,北區,立人里,242,1,817,3,820,1495,3,1,3,0,1,0,54.85
臺中市,北區,立人里,243,1,665,4,669,1335,3,1,3,0,1,0,50.11
臺中市,北區,中達里,244,1,666,4,670,1188,3,1,3,0,1,0,56.40
臺中市,北區,中達里,245,1,726,4,730,1265,3,1,3,0,1,0,57.71
臺中市,西屯區,西安里,246,1,801,5,806,1330,3,1,3,0,1,0,60.60
臺中市,西屯區,西安里,247,1,683,7,690,1240,3,1,3,0,1,0,55.65
臺中市,西屯區,西安里,248,1,701,5,706,1197,3,1,3,0,1,0,58.98
臺中市,西屯區,至善里,249,1,778,3,781,1497,3,1,3,0,1,0,52.17
臺中市,西屯區,至善里,250,1,764,2,766,1434,3,1,3,0,1,0,53.42
臺中市,西屯區,西平里,251,1,936,5,941,1682,3,1,3,0,1,0,55.95
臺中市,西屯區,西平里,252,1,835,6,841,1509,3,1,3,0,1,0,55.73
臺中市,西屯區,西平里,253,1,1011,7,1018,1530,3,1,3,0,1,0,66.54
臺中市,西屯區,西墩里,254,1,673,2,675,1059,3,1,3,0,1,0,63.74
臺中市,西屯區,西墩里,255,1,783,5,788,1339,3,1,3,0,1,0,58.85
臺中市,西屯區,西墩里,256,1,651,7,658,1229,3,1,3,0,1,0,53.54
臺中市,西屯區,潮洋里,257,1,724,8,732,1208,3,1,3,0,1,0,60.60
臺中市,西屯區,潮洋里,258,1,654,6,660,1162,3,1,3,0,1,0,56.80
臺中市,西屯區,龍潭里,259,1,591,1,592,937,3,1,3,0,1,0,63.18
臺中市,西屯區,惠來里,260,1,1002,9,1011,1704,3,1,3,0,1,0,59.33
臺中市,西屯區,惠來里,261,1,1021,9,1030,1869,3,1,3,0,1,0,55.11
臺中市,西屯區,惠來里,262,1,931,6,937,1674,3,1,3,0,1,0,55.97
臺中市,西屯區,上石里,263,1,873,6,879,1660,3,1,3,0,1,0,52.95
臺中市,西屯區,上石里,264,1,730,3,733,1594,3,1,3,0,1,0,45.98
臺中市,西屯區,上安里,265,1,659,3,662,1397,3,1,3,0,1,0,47.39
臺中市,西屯區,上安里,266,1,756,4,760,1340,3,1,3,0,1,0,56.72
臺中市,西屯區,上德里,267,1,1113,12,1125,1862,3,1,3,0,1,0,60.42
臺中市,西屯區,上德里,268,1,929,11,940,1728,3,1,3,0,1,0,54.40
臺中市,西屯區,逢甲里,269,1,699,10,709,1426,3,1,3,0,1,0,49.72
臺中市,西屯區,逢甲里,270,1,695,4,699,1266,3,1,3,0,1,0,55.21
臺中市,西屯區,逢甲里,271,1,685,1,686,1168,3,1,3,0,1,0,58.73
臺中市,西屯區,逢福里,272,1,714,4,718,1213,3,1,3,0,1,0,59.19
臺中市,西屯區,逢福里,273,1,864,9,873,1614,3,1,3,0,1,0,54.09
臺中市,西屯區,逢福里,274,1,811,8,819,1382,3,1,3,0,1,0,59.26
臺中市,西屯區,何厝里,275,1,560,0,560,1178,3,1,3,0,1,0,47.54
臺中市,西屯區,何厝里,276,1,765,6,771,1406,3,1,3,0,1,0,54.84
臺中市,西屯區,何明里,277,1,889,8,897,1611,3,1,3,0,1,0,55.68
臺中市,西屯區,何明里,278,1,811,1,812,1551,3,1,3,0,1,0,52.35
臺中市,西屯區,何南里,279,1,928,6,934,1663,3,1,3,0,1,0,56.16
臺中市,西屯區,何南里,280,1,920,9,929,1697,3,1,3,0,1,0,54.74
臺中市,西屯區,何成里,281,1,733,3,736,1387,3,1,3,0,1,0,53.06
臺中市,西屯區,何成里,282,1,736,8,744,1508,3,1,3,0,1,0,49.34
臺中市,西屯區,何成里,283,1,701,3,704,1304,3,1,3,0,1,0,53.99
臺中市,西屯區,何成里,284,1,638,3,641,1202,3,1,3,0,1,0,53.33
臺中市,西屯區,何安里,285,1,741,3,744,1765,3,1,3,0,1,0,42.15
臺中市,西屯區,何安里,286,1,701,2,703,1296,3,1,3,0,1,0,54.24
臺中市,西屯區,何安里,287,1,710,8,718,1282,3,1,3,0,1,0,56.01
臺中市,西屯區,何仁里,288,1,903,3,906,1696,3,1,3,0,1,0,53.42
臺中市,西屯區,何仁里,289,1,833,8,841,1566,3,1,3,0,1,0,53.70
臺中市,西屯區,何仁里,290,1,881,5,886,1696,3,1,3,0,1,0,52.24
臺中市,西屯區,何德里,291,1,804,5,809,1547,3,1,3,0,1,0,52.29
臺中市,西屯區,何德里,292,1,794,1,795,1394,3,1,3,0,1,0,57.03
臺中市,西屯區,何福里,293,1,621,3,624,1167,3,1,3,0,1,0,53.47
臺中市,西屯區,何福里,294,1,697,2,699,1237,3,1,3,0,1,0,56.51
臺中市,西屯區,何福里,295,1,642,8,650,1164,3,1,3,0,1,0,55.84
臺中市,西屯區,何源里,296,1,839,6,845,1520,3,1,3,0,1,0,55.59
臺中市,西屯區,何源里,297,1,971,7,978,1679,3,1,3,0,1,0,58.25
臺中市,西屯區,何源里,298,1,910,4,914,1772,3,1,3,0,1,0,51.58
臺中市,西屯區,大河里,299,1,936,11,947,1679,3,1,3,0,1,0,56.40
臺中市,西屯區,大河里,300,1,967,5,972,1633,3,1,3,0,1,0,59.52
臺中市,西屯區,大石里,301,1,605,7,612,940,3,1,3,0,1,0,65.11
臺中市,西屯區,大福里,302,1,887,1,888,1494,3,1,3,0,1,0,59.44
臺中市,西屯區,大福里,303,1,742,6,748,1378,3,1,3,0,1,0,54.28
臺中市,西屯區,大鵬里,304,1,793,4,797,1291,3,1,3,0,1,0,61.74
臺中市,西屯區,大鵬里,305,1,767,6,773,1314,3,1,3,0,1,0,58.83
臺中市,西屯區,大鵬里,306,1,726,4,730,1377,3,1,3,0,1,0,53.01
臺中市,西屯區,港尾里,307,1,603,5,608,1110,3,1,3,0,1,0,54.77
臺中市,西屯區,港尾里,308,1,740,2,742,1331,3,1,3,0,1,0,55.75
臺中市,西屯區,港尾里,309,1,820,7,827,1528,3,1,3,0,1,0,54.12
臺中市,西屯區,港尾里,310,1,535,2,537,741,3,1,3,0,1,0,72.47
臺中市,西屯區,廣福里,311,1,670,5,675,1053,3,1,3,0,1,0,64.10
臺中市,西屯區,廣福里,312,1,649,8,657,1079,3,1,3,0,1,0,60.89
臺中市,西屯區,林厝里,313,1,665,11,676,1106,3,1,3,0,1,0,61.12
臺中市,西屯區,林厝里,314,1,875,8,883,1500,3,1,3,0,1,0,58.87
臺中市,西屯區,永安里,315,1,818,3,821,1341,3,1,3,0,1,0,61.22
臺中市,西屯區,永安里,316,1,920,3,923,1526,3,1,3,0,1,0,60.48
臺中市,西屯區,永安里,317,1,774,4,778,1426,3,1,3,0,1,0,54.56
臺中市,西屯區,永安里,318,1,739,8,747,1229,3,1,3,0,1,0,60.78
臺中市,西屯區,福安里,319,1,532,1,533,1032,3,1,3,0,1,0,51.65
臺中市,西屯區,福安里,320,1,519,1,520,951,3,1,3,0,1,0,54.68
臺中市,西屯區,福雅里,321,1,1012,6,1018,1799,3,1,3,0,1,0,56.59
臺中市,西屯區,福雅里,322,1,874,6,880,1730,3,1,3,0,1,0,50.87
臺中市,西屯區,福林里,323,1,717,9,726,1302,3,1,3,0,1,0,55.76
臺中市,西屯區,福林里,324,1,646,4,650,1229,3,1,3,0,1,0,52.89
臺中市,西屯區,福林里,325,1,755,9,764,1316,3,1,3,0,1,0,58.05
臺中市,西屯區,福瑞里,326,1,534,3,537,1013,3,1,3,0,1,0,53.01
臺中市,西屯區,福瑞里,327,1,558,1,559,1044,3,1,3,0,1,0,53.54
臺中市,西屯區,福聯里,328,1,871,4,875,1740,3,1,3,0,1,0,50.29
臺中市,西屯區,福和里,329,1,998,4,1002,1667,3,1,3,0,1,0,60.11
臺中市,西屯區,福和里,330,1,815,5,820,1433,3,1,3,0,1,0,57.22
臺中市,西屯區,福中里,331,1,610,1,611,1031,3,1,3,0,1,0,59.26
臺中市,西屯區,福中里,332,1,697,4,701,1271,3,1,3,0,1,0,55.15
臺中市,西屯區,福恩里,333,1,779,5,784,1535,3,1,3,0,1,0,51.07
臺中市,西屯區,福恩里,334,1,795,0,795,1534,3,1,3,0,1,0,51.83
臺中市,西屯區,協和里,335,1,652,3,655,1112,3,1,3,0,1,0,58.90
臺中市,西屯區,協和里,336,1,491,6,497,807,3,1,3,0,1,0,61.59
臺中市,西屯區,協和里,337,1,683,2,685,1226,3,1,3,0,1,0,55.87
臺中市,南屯區,南屯里,338,1,706,6,712,1169,3,1,3,0,1,0,60.91
臺中市,南屯區,南屯里,339,1,678,13,691,1235,3,1,3,0,1,0,55.95
臺中市,南屯區,南屯里,340,1,731,5,736,1274,3,1,3,0,1,0,57.77
臺中市,南屯區,南屯里,341,1,704,9,713,1386,3,1,3,0,1,0,51.44
臺中市,南屯區,豐樂里,342,1,951,8,959,1654,3,1,3,0,1,0,57.98
臺中市,南屯區,豐樂里,343,1,920,3,923,1520,3,1,3,0,1,0,60.72
臺中市,南屯區,豐樂里,344,1,892,4,896,1591,3,1,3,0,1,0,56.32
臺中市,南屯區,豐樂里,345,1,741,3,744,1755,3,1,3,0,1,0,42.39
臺中市,南屯區,楓樹里,346,1,758,9,767,1327,3,1,3,0,1,0,57.80
臺中市,南屯區,楓樹里,347,1,889,12,901,1385,3,1,3,0,1,0,65.05
臺中市,南屯區,楓樹里,348,1,843,7,850,1320,3,1,3,0,1,0,64.39
臺中市,南屯區,中和里,349,1,802,8,810,1379,3,1,3,0,1,0,58.74
臺中市,南屯區,中和里,350,1,797,4,801,1360,3,1,3,0,1,0,58.90
臺中市,南屯區,中和里,351,1,701,8,709,1164,3,1,3,0,1,0,60.91
臺中市,南屯區,鎮平里,352,1,363,2,365,585,3,1,3,0,1,0,62.39
臺中市,南屯區,鎮平里,353,1,619,4,623,918,3,1,3,0,1,0,67.86
臺中市,南屯區,永定里,354,1,835,5,840,1574,3,1,3,0,1,0,53.37
臺中市,南屯區,永定里,355,1,886,7,893,1589,3,1,3,0,1,0,56.20
臺中市,南屯區,春社里,356,1,889,7,896,1580,3,1,3,0,1,0,56.71
臺中市,南屯區,春社里,357,1,700,6,706,1250,3,1,3,0,1,0,56.48
臺中市,南屯區,春社里,358,1,577,6,583,929,3,1,3,0,1,0,62.76
臺中市,南屯區,春社里,359,1,419,8,427,777,3,1,3,0,1,0,54.95
臺中市,南屯區,春安里,360,1,783,7,790,1132,3,1,3,0,1,0,69.79
臺中市,南屯區,春安里,361,1,746,2,748,1224,3,1,3,0,1,0,61.11
臺中市,南屯區,文山里,362,1,822,6,828,1595,3,1,3,0,1,0,51.91
臺中市,南屯區,文山里,363,1,749,6,755,1545,3,1,3,0,1,0,48.87
臺中市,南屯區,文山里,364,1,925,6,931,1709,3,1,3,0,1,0,54.48
臺中市,南屯區,寶山里,365,1,868,9,877,1482,3,1,3,0,1,0,59.18
臺中市,南屯區,寶山里,366,1,776,5,781,1563,3,1,3,0,1,0,49.97
臺中市,南屯區,新生里,367,1,736,7,743,1298,3,1,3,0,1,0,57.24
臺中市,南屯區,三義里,368,1,671,3,674,1249,3,1,3,0,1,0,53.96
臺中市,南屯區,三義里,369,1,724,6,730,1496,3,1,3,0,1,0,48.80
臺中市,南屯區,三義里,370,1,734,3,737,1422,3,1,3,0,1,0,51.83
臺中市,南屯區,三和里,371,1,795,10,805,1672,3,1,3,0,1,0,48.15
臺中市,南屯區,三和里,372,1,873,6,879,1641,3,1,3,0,1,0,53.56
臺中市,南屯區,三和里,373,1,629,5,634,1157,3,1,3,0,1,0,54.80
臺中市,南屯區,三厝里,374,1,853,3,856,1493,3,1,3,0,1,0,57.33
臺中市,南屯區,三厝里,375,1,796,5,801,1473,3,1,3,0,1,0,54.38
臺中市,南屯區,三厝里,376,1,737,9,746,1458,3,1,3,0,1,0,51.17
臺中市,南屯區,黎明里,377,1,877,7,884,1375,3,1,3,0,1,0,64.29
臺中市,南屯區,黎明里,378,1,768,5,773,1301,3,1,3,0,1,0,59.42
臺中市,南屯區,黎明里,379,1,744,4,748,1335,3,1,3,0,1,0,56.03
臺中市,南屯區,文心里,380,1,740,6,746,1348,3,1,3,0,1,0,55.34
臺中市,南屯區,文心里,381,1,714,5,719,1378,3,1,3,0,1,0,52.18
臺中市,南屯區,田心里,382,1,929,6,935,1562,3,1,3,0,1,0,59.86
臺中市,南屯區,田心里,383,1,694,9,703,1193,3,1,3,0,1,0,58.93
臺中市,南屯區,田心里,384,1,732,9,741,1352,3,1,3,0,1,0,54.81
臺中市,南屯區,向心里,385,1,794,7,801,1422,3,1,3,0,1,0,56.33
臺中市,南屯區,向心里,386,1,698,2,700,1262,3,1,3,0,1,0,55.47
臺中市,南屯區,同心里,387,1,700,8,708,1409,3,1,3,0,1,0,50.25
臺中市,南屯區,同心里,388,1,703,7,710,1277,3,1,3,0,1,0,55.60
臺中市,南屯區,同心里,389,1,672,4,676,1177,3,1,3,0,1,0,57.43
臺中市,南屯區,大興里,390,1,932,8,940,1671,3,1,3,0,1,0,56.25
臺中市,南屯區,大興里,391,1,900,5,905,1564,3,1,3,0,1,0,57.86
臺中市,南屯區,大同里,392,1,619,5,624,1183,3,1,3,0,1,0,52.75
臺中市,南屯區,大同里,393,1,675,4,679,1189,3,1,3,0,1,0,57.11
臺中市,南屯區,大同里,394,1,757,6,763,1286,3,1,3,0,1,0,59.33
臺中市,南屯區,大誠里,395,1,575,5,580,1044,3,1,3,0,1,0,55.56
臺中市,南屯區,大誠里,396,1,681,4,685,1269,3,1,3,0,1,0,53.98
臺中市,南屯區,大業里,397,1,670,5,675,1174,3,1,3,0,1,0,57.50
臺中市,南屯區,大業里,398,1,655,6,661,1191,3,1,3,0,1,0,55.50
臺中市,南屯區,大業里,399,1,638,2,640,1225,3,1,3,0,1,0,52.24
臺中市,南屯區,大業里,400,1,551,4,555,1160,3,1,3,0,1,0,47.84
臺中市,南屯區,溝墘里,401,1,916,3,919,1653,3,1,3,0,1,0,55.60
臺中市,南屯區,溝墘里,402,1,1026,5,1031,1812,3,1,3,0,1,0,56.90
臺中市,南屯區,惠中里,403,1,750,1,751,1356,3,1,3,0,1,0,55.38
臺中市,南屯區,惠中里,404,1,711,4,715,1431,3,1,3,0,1,0,49.97
臺中市,南屯區,惠中里,405,1,775,5,780,1522,3,1,3,0,1,0,51.25
臺中市,北屯區,北屯里,406,1,843,3,846,1546,3,1,3,0,1,0,54.72
臺中市,北屯區,北屯里,407,1,809,5,814,1463,3,1,3,0,1,0,55.64
臺中市,北屯區,北京里,408,1,911,5,916,1564,3,1,3,0,1,0,58.57
臺中市,北屯區,北京里,409,1,922,8,930,1617,3,1,3,0,1,0,57.51
臺中市,北屯區,北興里,410,1,877,6,883,1522,3,1,3,0,1,0,58.02
臺中市,北屯區,北興里,411,1,915,12,927,1544,3,1,3,0,1,0,60.04
臺中市,北屯區,三光里,412,1,721,3,724,1382,3,1,3,0,1,0,52.39
臺中市,北屯區,三光里,413,1,722,5,727,1322,3,1,3,0,1,0,54.99
臺中市,北屯區,三光里,414,1,799,13,812,1459,3,1,3,0,1,0,55.65
臺中市,北屯區,三光里,415,1,790,4,794,1383,3,1,3,0,1,0,57.41
臺中市,北屯區,三和里,416,1,1064,4,1068,1874,3,1,3,0,1,0,56.99
臺中市,北屯區,三和里,417,1,708,6,714,1346,3,1,3,0,1,0,53.05
臺中市,北屯區,三和里,418,1,786,4,790,1480,3,1,3,0,1,0,53.38
臺中市,北屯區,水景里,419,1,864,2,866,1492,3,1,3,0,1,0,58.04
臺中市,北屯區,水景里,420,1,715,7,722,1186,3,1,3,0,1,0,60.88
臺中市,北屯區,水景里,421,1,726,4,730,1237,3,1,3,0,1,0,59.01
臺中市,北屯區,水景里,422,1,683,2,685,1097,3,1,3,0,1,0,62.44
臺中市,北屯區,水景里,423,1,622,4,626,1129,3,1,3,0,1,0,55.45
臺中市,北屯區,軍功里,424,1,968,11,979,1542,3,1,3,0,1,0,63.49
臺中市,北屯區,軍功里,425,1,734,9,743,1199,3,1,3,0,1,0,61.97
臺中市,北屯區,軍功里,426,1,729,5,734,1211,3,1,3,0,1,0,60.61
臺中市,北屯區,軍功里,427,1,583,6,589,1112,3,1,3,0,1,0,52.97
臺中市,北屯區,軍功里,428,1,717,10,727,1340,3,1,3,0,1,0,54.25
臺中市,北屯區,平昌里,429,1,1064,8,1072,1918,3,1,3,0,1,0,55.89
臺中市,北屯區,平昌里,430,1,889,6,895,1695,3,1,3,0,1,0,52.80
臺中市,北屯區,水湳里,431,1,937,4,941,1559,3,1,3,0,1,0,60.36
臺中市,北屯區,水湳里,432,1,668,5,673,1156,3,1,3,0,1,0,58.22
臺中市,北屯區,水湳里,433,1,883,8,891,1613,3,1,3,0,1,0,55.24
臺中市,北屯區,水湳里,434,1,910,2,912,1583,3,1,3,0,1,0,57.61
臺中市,北屯區,陳平里,435,1,946,4,950,1649,3,1,3,0,1,0,57.61
臺中市,北屯區,陳平里,436,1,857,8,865,1626,3,1,3,0,1,0,53.20
臺中市,北屯區,忠平里,437,1,885,3,888,1544,3,1,3,0,1,0,57.51
臺中市,北屯區,忠平里,438,1,877,3,880,1592,3,1,3,0,1,0,55.28
臺中市,北屯區,新平里,439,1,787,3,790,1247,3,1,3,0,1,0,63.35
臺中市,北屯區,新平里,440,1,898,6,904,1595,3,1,3,0,1,0,56.68
臺中市,北屯區,新平里,441,1,798,5,803,1492,3,1,3,0,1,0,53.82
臺中市,北屯區,大德里,442,1,962,9,971,1656,3,1,3,0,1,0,58.64
臺中市,北屯區,大德里,443,1,735,1,736,1237,3,1,3,0,1,0,59.50
臺中市,北屯區,大德里,444,1,751,11,762,1312,3,1,3,0,1,0,58.08
臺中市,北屯區,仁愛里,445,1,784,15,799,1424,3,1,3,0,1,0,56.11
臺中市,北屯區,仁和里,446,1,964,8,972,1562,3,1,3,0,1,0,62.23
臺中市,北屯區,仁和里,447,1,810,6,816,2043,3,1,3,0,1,0,39.94
臺中市,北屯區,仁和里,448,1,841,2,843,1445,3,1,3,0,1,0,58.34
臺中市,北屯區,仁美里,449,1,488,2,490,794,3,1,3,0,1,0,61.71
臺中市,北屯區,仁美里,450,1,898,6,904,1536,3,1,3,0,1,0,58.85
臺中市,北屯區,仁美里,451,1,954,10,964,1524,3,1,3,0,1,0,63.25
臺中市,北屯區,仁美里,452,1,903,4,907,1380,3,1,3,0,1,0,65.72
臺中市,北屯區,同榮里,453,1,637,6,643,1151,3,1,3,0,1,0,55.86
臺中市,北屯區,同榮里,454,1,674,4,678,1056,3,1,3,0,1,0,64.20
臺中市,北屯區,同榮里,455,1,788,3,791,1349,3,1,3,0,1,0,58.64
臺中市,北屯區,同榮里,456,1,622,2,624,1125,3,1,3,0,1,0,55.47
臺中市,北屯區,同榮里,457,1,439,4,443,696,3,1,3,0,1,0,63.65
臺中市,北屯區,后庄里,458,1,871,7,878,1560,3,1,3,0,1,0,56.28
臺中市,北屯區,后庄里,459,1,1118,6,1124,1778,3,1,3,0,1,0,63.22
臺中市,北屯區,后庄里,460,1,1031,11,1042,1743,3,1,3,0,1,0,59.78
臺中市,北屯區,后庄里,461,1,728,2,730,1382,3,1,3,0,1,0,52.82
臺中市,北屯區,四民里,462,1,923,8,931,1468,3,1,3,0,1,0,63.42
臺中市,北屯區,四民里,463,1,342,1,343,485,3,1,3,0,1,0,70.72
臺中市,北屯區,松竹里,464,1,682,2,684,1213,3,1,3,0,1,0,56.39
臺中市,北屯區,松竹里,465,1,621,4,625,1155,3,1,3,0,1,0,54.11
臺中市,北屯區,松竹里,466,1,847,5,852,1542,3,1,3,0,1,0,55.25
臺中市,北屯區,松竹里,467,1,538,3,541,1217,3,1,3,0,1,0,44.45
臺中市,北屯區,和平里,468,1,988,7,995,1600,3,1,3,0,1,0,62.19
臺中市,北屯區,和平里,469,1,1035,3,1038,1743,3,1,3,0,1,0,59.55
臺中市,北屯區,和平里,470,1,871,11,882,1501,3,1,3,0,1,0,58.76
臺中市,北屯區,部子里,471,1,430,5,435,694,3,1,3,0,1,0,62.68
臺中市,北屯區,部子里,472,1,550,3,553,937,3,1,3,0,1,0,59.02
臺中市,北屯區,東山里,473,1,1042,5,1047,1600,3,1,3,0,1,0,65.44
臺中市,北屯區,大坑里,474,1,1040,10,1050,1728,3,1,3,0,1,0,60.76
臺中市,北屯區,民政里,475,1,504,1,505,895,3,1,3,0,1,0,56.42
臺中市,北屯區,民德里,476,1,493,2,495,811,3,1,3,0,1,0,61.04
臺中市,北屯區,平安里,477,1,841,9,850,1310,3,1,3,0,1,0,64.89
臺中市,北屯區,平安里,478,1,754,13,767,1372,3,1,3,0,1,0,55.90
臺中市,北屯區,平安里,479,1,888,4,892,1625,3,1,3,0,1,0,54.89
臺中市,北屯區,平和里,480,1,557,6,563,1108,3,1,3,0,1,0,50.81
臺中市,北屯區,平和里,481,1,685,3,688,1258,3,1,3,0,1,0,54.69
臺中市,北屯區,平和里,482,1,534,3,537,1101,3,1,3,0,1,0,48.77
臺中市,北屯區,平心里,483,1,828,6,834,1671,3,1,3,0,1,0,49.91
臺中市,北屯區,平心里,484,1,816,6,822,1572,3,1,3,0,1,0,52.29
臺中市,北屯區,平陽里,485,1,828,6,834,1597,3,1,3,0,1,0,52.22
臺中市,北屯區,平陽里,486,1,1013,6,1019,1898,3,1,3,0,1,0,53.69
臺中市,北屯區,平德里,487,1,738,1,739,1355,3,1,3,0,1,0,54.54
臺中市,北屯區,平德里,488,1,781,4,785,1561,3,1,3,0,1,0,50.29
臺中市,北屯區,平德里,489,1,899,6,905,1606,3,1,3,0,1,0,56.35
臺中市,北屯區,平福里,490,1,752,10,762,1268,3,1,3,0,1,0,60.09
臺中市,北屯區,平福里,491,1,630,6,636,1226,3,1,3,0,1,0,51.88
臺中市,北屯區,平順里,492,1,765,7,772,1279,3,1,3,0,1,0,60.36
臺中市,北屯區,平順里,493,1,522,6,528,1016,3,1,3,0,1,0,51.97
臺中市,北屯區,東光里,494,1,559,6,565,994,3,1,3,0,1,0,56.84
臺中市,北屯區,東光里,495,1,802,9,811,1550,3,1,3,0,1,0,52.32
臺中市,北屯區,東光里,496,1,649,6,655,1172,3,1,3,0,1,0,55.89
臺中市,北屯區,舊社里,497,1,1089,8,1097,1787,3,1,3,0,1,0,61.39
臺中市,北屯區,舊社里,498,1,680,2,682,1256,3,1,3,0,1,0,54.30
臺中市,北屯區,舊社里,499,1,691,5,696,1260,3,1,3,0,1,0,55.24
臺中市,北屯區,舊社里,500,1,577,2,579,1145,3,1,3,0,1,0,50.57
臺中市,北屯區,平興里,501,1,676,6,682,1187,3,1,3,0,1,0,57.46
臺中市,北屯區,平興里,502,1,562,3,565,1176,3,1,3,0,1,0,48.04
臺中市,北屯區,平興里,503,1,942,6,948,1854,3,1,3,0,1,0,51.13
臺中市,北屯區,平田里,504,1,892,5,897,1628,3,1,3,0,1,0,55.10
臺中市,北屯區,平田里,505,1,756,10,766,1370,3,1,3,0,1,0,55.91
臺中市,北屯區,平田里,506,1,741,4,745,1382,3,1,3,0,1,0,53.91
臺中市,北屯區,松安里,507,1,643,3,646,1153,3,1,3,0,1,0,56.03
臺中市,北屯區,松安里,508,1,718,7,725,1287,3,1,3,0,1,0,56.33
臺中市,北屯區,松安里,509,1,728,6,734,1329,3,1,3,0,1,0,55.23
臺中市,北屯區,松和里,510,1,652,4,656,1179,3,1,3,0,1,0,55.64
臺中市,北屯區,松和里,511,1,731,3,734,1342,3,1,3,0,1,0,54.69
臺中市,北屯區,松和里,512,1,556,4,560,1043,3,1,3,0,1,0,53.69
臺中市,北屯區,松和里,513,1,734,6,740,1517,3,1,3,0,1,0,48.78
臺中市,北屯區,松茂里,514,1,825,3,828,1414,3,1,3,0,1,0,58.56
臺中市,北屯區,松茂里,515,1,685,4,689,1301,3,1,3,0,1,0,52.96
臺中市,北屯區,松茂里,516,1,692,5,697,1209,3,1,3,0,1,0,57.65
臺中市,北屯區,松勇里,517,1,585,5,590,997,3,1,3,0,1,0,59.18
臺中市,北屯區,松勇里,518,1,485,2,487,875,3,1,3,0,1,0,55.66
臺中市,北屯區,松勇里,519,1,1003,9,1012,1768,3,1,3,0,1,0,57.24
臺中市,北屯區,松強里,520,1,567,3,570,1130,3,1,3,0,1,0,50.44
臺中市,北屯區,松強里,521,1,731,5,736,1358,3,1,3,0,1,0,54.20
臺中市,北屯區,松強里,522,1,535,0,535,1152,3,1,3,0,1,0,46.44
嘉義市,東區,短竹里,1,1,779,6,785,1378,3,1,3,0,1,0,56.97
嘉義市,東區,短竹里,2,1,701,3,704,1324,3,1,3,0,1,0,53.17
嘉義市,東區,短竹里,3,1,794,4,798,1490,3,1,3,0,1,0,53.56
嘉義市,東區,東川里,4,1,470,5,475,809,3,1,3,0,1,0,58.71
嘉義市,東區,東川里,5,1,522,8,530,877,3,1,3,0,1,0,60.43
嘉義市,東區,鹿寮里,6,1,353,0,353,632,3,1,3,0,1,0,55.85
嘉義市,東區,盧厝里,7,1,650,4,654,1189,3,1,3,0,1,0,55.00
嘉義市,東區,盧厝里,8,1,661,3,664,1334,3,1,3,0,1,0,49.78
嘉義市,東區,盧厝里,9,1,542,0,542,990,3,1,3,0,1,0,54.75
嘉義市,東區,東平里,10,1,495,5,500,871,3,1,3,0,1,0,57.41
嘉義市,東區,太平里,11,1,733,3,736,1487,3,1,3,0,1,0,49.50
嘉義市,東區,太平里,12,1,516,1,517,902,3,1,3,0,1,0,57.32
嘉義市,東區,太平里,13,1,365,0,365,629,3,1,3,0,1,0,58.03
嘉義市,東區,太平里,14,1,476,3,479,869,3,1,3,0,1,0,55.12
嘉義市,東區,王田里,15,1,676,2,678,1233,3,1,3,0,1,0,54.99
嘉義市,東區,王田里,16,1,566,1,567,1099,3,1,3,0,1,0,51.59
嘉義市,東區,長竹里,17,1,568,3,571,1003,3,1,3,0,1,0,56.93
嘉義市,東區,長竹里,18,1,885,7,892,1603,3,1,3,0,1,0,55.65
嘉義市,東區,後庄里,19,1,717,1,718,1332,3,1,3,0,1,0,53.90
嘉義市,東區,後庄里,20,1,584,7,591,1079,3,1,3,0,1,0,54.77
嘉義市,東區,後庄里,21,1,614,4,618,1112,3,1,3,0,1,0,55.58
嘉義市,東區,新店里,22,1,726,6,732,1343,3,1,3,0,1,0,54.50
嘉義市,東區,新店里,23,1,524,0,524,933,3,1,3,0,1,0,56.16
嘉義市,東區,新店里,24,1,488,2,490,967,3,1,3,0,1,0,50.67
嘉義市,東區,圳頭里,25,1,678,2,680,1210,3,1,3,0,1,0,56.20
嘉義市,東區,圳頭里,26,1,610,6,616,984,3,1,3,0,1,0,62.60
嘉義市,東區,圳頭里,27,1,895,2,897,1672,3,1,3,0,1,0,53.65
嘉義市,東區,東噴里,28,1,624,4,628,1114,3,1,3,0,1,0,56.37
嘉義市,東區,希康里,29,1,174,0,174,297,3,1,3,0,1,0,58.59
嘉義市,東區,東山里,30,1,275,1,276,452,3,1,3,0,1,0,61.06
嘉義市,東區,東安里,31,1,318,1,319,535,3,1,3,0,1,0,59.63
嘉義市,東區,大街里,32,1,305,3,308,518,3,1,3,0,1,0,59.46
嘉義市,東區,祐民里,33,1,357,3,360,668,3,1,3,0,1,0,53.89
嘉義市,東區,東仁里,34,1,307,1,308,494,3,1,3,0,1,0,62.35
嘉義市,東區,內安里,35,1,245,0,245,427,3,1,3,0,1,0,57.38
嘉義市,東區,雲霄里,36,1,375,3,378,634,3,1,3,0,1,0,59.62
嘉義市,東區,雲霄里,37,1,345,2,347,638,3,1,3,0,1,0,54.39
嘉義市,東區,建國里,38,1,357,1,358,626,3,1,3,0,1,0,57.19
嘉義市,東區,府路里,39,1,561,6,567,1011,3,1,3,0,1,0,56.08
嘉義市,東區,鎮南里,40,1,191,1,192,377,3,1,3,0,1,0,50.93
嘉義市,東區,神農里,41,1,519,3,522,985,3,1,3,0,1,0,52.99
嘉義市,東區,崇文里,42,1,383,1,384,632,3,1,3,0,1,0,60.76
嘉義市,東區,龍山里,43,1,392,1,393,715,3,1,3,0,1,0,54.97
嘉義市,東區,安平里,44,1,416,5,421,706,3,1,3,0,1,0,59.63
嘉義市,東區,文昌里,45,1,382,1,383,648,3,1,3,0,1,0,59.10
嘉義市,東區,志航里,46,1,702,8,710,1156,3,1,3,0,1,0,61.42
嘉義市,東區,蘭井里,47,1,337,0,337,612,3,1,3,0,1,0,55.07
嘉義市,東區,光復里,48,1,576,6,582,1063,3,1,3,0,1,0,54.75
嘉義市,東區,初陽里,49,1,689,2,691,1276,3,1,3,0,1,0,54.15
嘉義市,東區,震安里,50,1,443,2,445,770,3,1,3,0,1,0,57.79
嘉義市,東區,新開里,51,1,394,2,396,639,3,1,3,0,1,0,61.97
嘉義市,東區,新開里,52,1,385,1,386,721,3,1,3,0,1,0,53.54
嘉義市,東區,宣信里,53,1,450,2,452,899,3,1,3,0,1,0,50.28
嘉義市,東區,宣信里,54,1,442,1,443,890,3,1,3,0,1,0,49.78
嘉義市,東區,興南里,55,1,732,4,736,1277,3,1,3,0,1,0,57.64
嘉義市,東區,豐年里,56,1,400,1,401,724,3,1,3,0,1,0,55.39
嘉義市,東區,豐年里,57,1,428,2,430,814,3,1,3,0,1,0,52.83
嘉義市,東區,芳草里,58,1,673,3,676,1291,3,1,3,0,1,0,52.36
嘉義市,東區,芳草里,59,1,455,0,455,899,3,1,3,0,1,0,50.61
嘉義市,東區,芳草里,60,1,617,3,620,1323,3,1,3,0,1,0,46.86
嘉義市,東區,芳安里,61,1,779,4,783,1387,3,1,3,0,1,0,56.45
嘉義市,東區,芳安里,62,1,392,3,395,657,3,1,3,0,1,0,60.12
嘉義市,東區,頂寮里,63,1,537,3,540,1014,3,1,3,0,1,0,53.25
嘉義市,東區,頂寮里,64,1,538,1,539,991,3,1,3,0,1,0,54.39
嘉義市,東區,安寮里,65,1,464,1,465,870,3,1,3,0,1,0,53.45
嘉義市,東區,安寮里,66,1,497,2,499,1062,3,1,3,0,1,0,46.99
嘉義市,東區,安寮里,67,1,604,3,607,1217,3,1,3,0,1,0,49.88
嘉義市,東區,安寮里,68,1,788,4,792,1558,3,1,3,0,1,0,50.83
嘉義市,東區,興村里,69,1,721,1,722,1390,3,1,3,0,1,0,51.94
嘉義市,東區,興村里,70,1,844,6,850,1790,3,1,3,0,1,0,47.49
嘉義市,東區,興安里,71,1,530,5,535,1120,3,1,3,0,1,0,47.77
嘉義市,東區,興安里,72,1,538,4,542,1074,3,1,3,0,1,0,50.47
嘉義市,東區,興仁里,73,1,446,1,447,839,3,1,3,0,1,0,53.28
嘉義市,東區,興仁里,74,1,623,4,627,1209,3,1,3,0,1,0,51.86
嘉義市,東區,興仁里,75,1,580,2,582,1154,3,1,3,0,1,0,50.43
嘉義市,東區,北城里,76,1,466,5,471,848,3,1,3,0,1,0,55.54
嘉義市,東區,仁武里,77,1,382,2,384,639,3,1,3,0,1,0,60.09
嘉義市,東區,泰安里,78,1,595,2,597,1040,3,1,3,0,1,0,57.40
嘉義市,東區,檜村里,79,1,432,3,435,797,3,1,3,0,1,0,54.58
嘉義市,東區,檜村里,80,1,341,1,342,658,3,1,3,0,1,0,51.98
嘉義市,東區,社口里,81,1,515,4,519,853,3,1,3,0,1,0,60.84
嘉義市,東區,仁和里,82,1,282,3,285,477,3,1,3,0,1,0,59.75
嘉義市,東區,中庄里,83,1,750,5,755,1473,3,1,3,0,1,0,51.26
嘉義市,東區,中庄里,84,1,682,6,688,1262,3,1,3,0,1,0,54.52
嘉義市,東區,仁義里,85,1,637,1,638,1172,3,1,3,0,1,0,54.44
嘉義市,東區,仁義里,86,1,477,3,480,981,3,1,3,0,1,0,48.93
嘉義市,東區,後湖里,87,1,861,5,866,1654,3,1,3,0,1,0,52.36
嘉義市,東區,後湖里,88,1,775,2,777,1425,3,1,3,0,1,0,54.53
嘉義市,東區,荖藤里,89,1,501,1,502,900,3,1,3,0,1,0,55.78
嘉義市,東區,荖藤里,90,1,350,2,352,701,3,1,3,0,1,0,50.21
嘉義市,東區,荖藤里,91,1,519,1,520,1133,3,1,3,0,1,0,45.90
嘉義市,東區,頂庄里,92,1,615,6,621,1247,3,1,3,0,1,0,49.80
嘉義市,東區,頂庄里,93,1,700,4,704,1413,3,1,3,0,1,0,49.82
嘉義市,東區,頂庄里,94,1,492,2,494,970,3,1,3,0,1,0,50.93
嘉義市,東區,頂庄里,95,1,641,8,649,1210,3,1,3,0,1,0,53.64
嘉義市,西區,書院里,96,1,556,4,560,1015,3,1,3,0,1,0,55.17
嘉義市,西區,驛站里,97,1,355,0,355,596,3,1,3,0,1,0,59.56
嘉義市,西區,民安里,98,1,251,1,252,477,3,1,3,0,1,0,52.83
嘉義市,西區,菜園里,99,1,378,2,380,631,3,1,3,0,1,0,60.22
嘉義市,西區,集英里,100,1,285,1,286,531,3,1,3,0,1,0,53.86
嘉義市,西區,福松里,101,1,489,2,491,773,3,1,3,0,1,0,63.52
嘉義市,西區,義昌里,102,1,330,3,333,581,3,1,3,0,1,0,57.31
嘉義市,西區,自治里,103,1,641,4,645,1126,3,1,3,0,1,0,57.28
嘉義市,西區,大業里,104,1,508,7,515,828,3,1,3,0,1,0,62.20
嘉義市,西區,中庸里,105,1,450,2,452,810,3,1,3,0,1,0,55.80
嘉義市,西區,學圃里,106,1,313,2,315,530,3,1,3,0,1,0,59.43
嘉義市,西區,北杏里,107,1,432,3,435,800,3,1,3,0,1,0,54.37
嘉義市,西區,社內里,108,1,317,3,320,528,3,1,3,0,1,0,60.61
嘉義市,西區,民生里,109,1,341,0,341,543,3,1,3,0,1,0,62.80
嘉義市,西區,慶昇里,110,1,206,2,208,405,3,1,3,0,1,0,51.36
嘉義市,西區,通運里,111,1,195,0,195,367,3,1,3,0,1,0,53.13
嘉義市,西區,榮檜里,112,1,348,3,351,631,3,1,3,0,1,0,55.63
嘉義市,西區,功科里,113,1,447,5,452,712,3,1,3,0,1,0,63.48
嘉義市,西區,康莊里,114,1,370,3,373,608,3,1,3,0,1,0,61.35
嘉義市,西區,福全里,115,1,535,6,541,993,3,1,3,0,1,0,54.48
嘉義市,西區,福全里,116,1,607,2,609,1138,3,1,3,0,1,0,53.51
嘉義市,西區,福全里,117,1,566,9,575,1218,3,1,3,0,1,0,47.21
嘉義市,西區,福全里,118,1,672,10,682,1279,3,1,3,0,1,0,53.32
嘉義市,西區,福全里,119,1,719,7,726,1431,3,1,3,0,1,0,50.73
嘉義市,西區,力行里,120,1,521,4,525,911,3,1,3,0,1,0,57.63
嘉義市,西區,劉厝里,121,1,675,8,683,1299,3,1,3,0,1,0,52.58
嘉義市,西區,劉厝里,122,1,786,7,793,1633,3,1,3,0,1,0,48.56
嘉義市,西區,劉厝里,123,1,395,0,395,744,3,1,3,0,1,0,53.09
嘉義市,西區,港坪里,124,1,574,2,576,1021,3,1,3,0,1,0,56.42
嘉義市,西區,港坪里,125,1,554,5,559,1041,3,1,3,0,1,0,53.70
嘉義市,西區,頭港里,126,1,679,2,681,1282,3,1,3,0,1,0,53.12
嘉義市,西區,西平里,127,1,743,2,745,1310,3,1,3,0,1,0,56.87
嘉義市,西區,大溪里,128,1,466,6,472,929,3,1,3,0,1,0,50.81
嘉義市,西區,大溪里,129,1,469,2,471,890,3,1,3,0,1,0,52.92
嘉義市,西區,磚窯里,130,1,723,4,727,1287,3,1,3,0,1,0,56.49
嘉義市,西區,磚窯里,131,1,516,6,522,963,3,1,3,0,1,0,54.21
嘉義市,西區,磚窯里,132,1,538,3,541,990,3,1,3,0,1,0,54.65
嘉義市,西區,新西里,133,1,478,1,479,910,3,1,3,0,1,0,52.64
嘉義市,西區,新西里,134,1,570,1,571,1134,3,1,3,0,1,0,50.35
嘉義市,西區,華明里,135,1,440,2,442,772,3,1,3,0,1,0,57.25
嘉義市,西區,導民里,136,1,288,5,293,590,3,1,3,0,1,0,49.66
嘉義市,西區,導民里,137,1,377,0,377,650,3,1,3,0,1,0,58
嘉義市,西區,培元里,138,1,562,4,566,991,3,1,3,0,1,0,57.11
嘉義市,西區,垂楊里,139,1,423,4,427,888,3,1,3,0,1,0,48.09
嘉義市,西區,垂楊里,140,1,542,2,544,1065,3,1,3,0,1,0,51.08
嘉義市,西區,車店里,141,1,767,3,770,1549,3,1,3,0,1,0,49.71
嘉義市,西區,車店里,142,1,701,8,709,1321,3,1,3,0,1,0,53.67
嘉義市,西區,車店里,143,1,879,4,883,1608,3,1,3,0,1,0,54.91
嘉義市,西區,福民里,144,1,810,4,814,1406,3,1,3,0,1,0,57.89
嘉義市,西區,福民里,145,1,721,4,725,1432,3,1,3,0,1,0,50.63
嘉義市,西區,福民里,146,1,729,5,734,1531,3,1,3,0,1,0,47.94
嘉義市,西區,湖內里,147,1,711,8,719,1291,3,1,3,0,1,0,55.69
嘉義市,西區,湖內里,148,1,704,3,707,1265,3,1,3,0,1,0,55.89
嘉義市,西區,湖內里,149,1,412,6,418,898,3,1,3,0,1,0,46.55
嘉義市,西區,湖內里,150,1,699,4,703,1372,3,1,3,0,1,0,51.24
嘉義市,西區,湖內里,151,1,514,2,516,967,3,1,3,0,1,0,53.36
嘉義市,西區,湖內里,152,1,658,2,660,1249,3,1,3,0,1,0,52.84
嘉義市,西區,美源里,153,1,550,4,554,1024,3,1,3,0,1,0,54.10
嘉義市,西區,美源里,154,1,769,6,775,1422,3,1,3,0,1,0,54.50
嘉義市,西區,美源里,155,1,461,7,468,929,3,1,3,0,1,0,50.38
嘉義市,西區,光路里,156,1,680,4,684,1317,3,1,3,0,1,0,51.94
嘉義市,西區,光路里,157,1,827,4,831,1610,3,1,3,0,1,0,51.61
嘉義市,西區,光路里,158,1,717,8,725,1419,3,1,3,0,1,0,51.09
嘉義市,西區,育英里,159,1,608,1,609,1102,3,1,3,0,1,0,55.26
嘉義市,西區,育英里,160,1,605,7,612,1140,3,1,3,0,1,0,53.68
嘉義市,西區,自強里,161,1,686,4,690,1212,3,1,3,0,1,0,56.93
嘉義市,西區,長安里,162,1,675,3,678,1262,3,1,3,0,1,0,53.72
嘉義市,西區,北榮里,163,1,500,2,502,936,3,1,3,0,1,0,53.63
嘉義市,西區,北榮里,164,1,570,3,573,1027,3,1,3,0,1,0,55.79
嘉義市,西區,重興里,165,1,577,4,581,1142,3,1,3,0,1,0,50.88
嘉義市,西區,重興里,166,1,478,2,480,900,3,1,3,0,1,0,53.33
嘉義市,西區,慶昌里,167,1,290,2,292,491,3,1,3,0,1,0,59.47
嘉義市,西區,小湖里,168,1,346,3,349,647,3,1,3,0,1,0,53.94
嘉義市,西區,竹文里,169,1,406,2,408,746,3,1,3,0,1,0,54.69
嘉義市,西區,竹文里,170,1,383,4,387,682,3,1,3,0,1,0,56.74
嘉義市,西區,香湖里,171,1,692,3,695,1355,3,1,3,0,1,0,51.29
嘉義市,西區,湖邊里,172,1,484,2,486,925,3,1,3,0,1,0,52.54
嘉義市,西區,湖邊里,173,1,461,2,463,926,3,1,3,0,1,0,50.00
嘉義市,西區,竹圍里,174,1,540,4,544,1029,3,1,3,0,1,0,52.87
嘉義市,西區,竹圍里,175,1,552,0,552,1120,3,1,3,0,1,0,49.29
嘉義市,西區,竹圍里,176,1,465,8,473,865,3,1,3,0,1,0,54.68
嘉義市,西區,竹圍里,177,1,520,3,523,975,3,1,3,0,1,0,53.64
嘉義市,西區,保安里,178,1,706,8,714,1358,3,1,3,0,1,0,52.58
嘉義市,西區,保安里,179,1,808,4,812,1431,3,1,3,0,1,0,56.74
嘉義市,西區,保安里,180,1,809,2,811,1630,3,1,3,0,1,0,49.75
嘉義市,西區,保安里,181,1,783,5,788,1590,3,1,3,0,1,0,49.56
嘉義市,西區,保安里,182,1,668,7,675,1442,3,1,3,0,1,0,46.81
嘉義市,西區,保安里,183,1,761,3,764,1560,3,1,3,0,1,0,48.97
嘉義市,西區,新厝里,184,1,593,5,598,1126,3,1,3,0,1,0,53.11
嘉義市,西區,新厝里,185,1,584,7,591,1151,3,1,3,0,1,0,51.35
嘉義市,西區,新厝里,186,1,596,1,597,1137,3,1,3,0,1,0,52.51
嘉義市,西區,北湖里,187,1,626,4,630,1188,3,1,3,0,1,0,53.03
嘉義市,西區,北湖里,188,1,636,7,643,1162,3,1,3,0,1,0,55.34
嘉義市,西區,下埤里,189,1,641,6,647,1215,3,1,3,0,1,0,53.25
嘉義市,西區,竹村里,190,1,488,2,490,909,3,1,3,0,1,0,53.91
臺南市,東區,崇信里,1,1,948,3,951,1752,3,1,3,0,1,0,54.28
臺南市,東區,崇信里,2,1,923,3,926,2104,3,1,3,0,1,0,44.01
臺南市,東區,崇學里,3,1,711,5,716,1248,3,1,3,0,1,0,57.37
臺南市,東區,崇學里,4,1,751,4,755,1360,3,1,3,0,1,0,55.51
臺南市,東區,崇德里,5,1,885,4,889,1470,3,1,3,0,1,0,60.48
臺南市,東區,崇德里,6,1,689,5,694,1236,3,1,3,0,1,0,56.15
臺南市,東區,崇德里,7,1,745,5,750,1319,3,1,3,0,1,0,56.86
臺南市,東區,崇善里,8,1,817,6,823,1524,3,1,3,0,1,0,54.00
臺南市,東區,崇善里,9,1,1030,5,1035,1961,3,1,3,0,1,0,52.78
臺南市,東區,崇成里,10,1,594,2,596,1123,3,1,3,0,1,0,53.07
臺南市,東區,崇成里,11,1,695,5,700,1221,3,1,3,0,1,0,57.33
臺南市,東區,崇文里,12,1,684,2,686,1264,3,1,3,0,1,0,54.27
臺南市,東區,崇文里,13,1,786,2,788,1411,3,1,3,0,1,0,55.85
臺南市,東區,崇文里,14,1,1046,9,1055,1835,3,1,3,0,1,0,57.49
臺南市,東區,東智里,15,1,1193,10,1203,2068,3,1,3,0,1,0,58.17
臺南市,東區,大智里,16,1,973,3,976,1665,3,1,3,0,1,0,58.62
臺南市,東區,大智里,17,1,887,6,893,1486,3,1,3,0,1,0,60.09
臺南市,東區,大智里,18,1,870,5,875,1595,3,1,3,0,1,0,54.86
臺南市,東區,德高里,19,1,806,6,812,1355,3,1,3,0,1,0,59.93
臺南市,東區,德高里,20,1,654,8,662,1198,3,1,3,0,1,0,55.26
臺南市,東區,仁和里,21,1,859,1,860,1644,3,1,3,0,1,0,52.31
臺南市,東區,仁和里,22,1,1106,6,1112,2205,3,1,3,0,1,0,50.43
臺南市,東區,和平里,23,1,737,5,742,1341,3,1,3,0,1,0,55.33
臺南市,東區,和平里,24,1,826,3,829,1474,3,1,3,0,1,0,56.24
臺南市,東區,虎尾里,25,1,807,5,812,1416,3,1,3,0,1,0,57.34
臺南市,東區,虎尾里,26,1,806,10,816,1366,3,1,3,0,1,0,59.74
臺南市,東區,虎尾里,27,1,843,4,847,1705,3,1,3,0,1,0,49.68
臺南市,東區,裕聖里,28,1,1043,4,1047,1995,3,1,3,0,1,0,52.48
臺南市,東區,復興里,29,1,886,3,889,1632,3,1,3,0,1,0,54.47
臺南市,東區,復興里,30,1,833,4,837,1501,3,1,3,0,1,0,55.76
臺南市,東區,自強里,31,1,689,1,690,1397,3,1,3,0,1,0,49.39
臺南市,東區,自強里,32,1,759,7,766,1354,3,1,3,0,1,0,56.57
臺南市,東區,自強里,33,1,817,5,822,1469,3,1,3,0,1,0,55.96
臺南市,東區,東聖里,34,1,651,1,652,1180,3,1,3,0,1,0,55.25
臺南市,東區,東聖里,35,1,528,5,533,950,3,1,3,0,1,0,56.11
臺南市,東區,關聖里,36,1,1059,8,1067,1832,3,1,3,0,1,0,58.24
臺南市,東區,關聖里,37,1,796,4,800,1501,3,1,3,0,1,0,53.30
臺南市,東區,關聖里,38,1,895,5,900,1561,3,1,3,0,1,0,57.66
臺南市,東區,關聖里,39,1,932,5,937,1695,3,1,3,0,1,0,55.28
臺南市,東區,後甲里,40,1,680,4,684,1215,3,1,3,0,1,0,56.30
臺南市,東區,後甲里,41,1,851,2,853,1404,3,1,3,0,1,0,60.75
臺南市,東區,復國里,42,1,623,5,628,929,3,1,3,0,1,0,67.60
臺南市,東區,復國里,43,1,615,6,621,949,3,1,3,0,1,0,65.44
臺南市,東區,中興里,44,1,529,7,536,747,3,1,3,0,1,0,71.75
臺南市,東區,中興里,45,1,548,5,553,837,3,1,3,0,1,0,66.07
臺南市,東區,東光里,46,1,668,3,671,1184,3,1,3,0,1,0,56.67
臺南市,東區,東光里,47,1,1095,5,1100,1850,3,1,3,0,1,0,59.46
臺南市,東區,東光里,48,1,673,5,678,1203,3,1,3,0,1,0,56.36
臺南市,東區,東明里,49,1,914,4,918,1606,3,1,3,0,1,0,57.16
臺南市,東區,東明里,50,1,915,5,920,1672,3,1,3,0,1,0,55.02
臺南市,東區,莊敬里,51,1,852,1,853,1471,3,1,3,0,1,0,57.99
臺南市,東區,莊敬里,52,1,1090,6,1096,1800,3,1,3,0,1,0,60.89
臺南市,東區,小東里,53,1,783,5,788,1433,3,1,3,0,1,0,54.99
臺南市,東區,小東里,54,1,849,3,852,1464,3,1,3,0,1,0,58.20
臺南市,東區,小東里,55,1,743,3,746,1273,3,1,3,0,1,0,58.60
臺南市,東區,大學里,56,1,872,2,874,1427,3,1,3,0,1,0,61.25
臺南市,東區,成大里,57,1,553,3,556,1005,3,1,3,0,1,0,55.32
臺南市,東區,成大里,58,1,672,3,675,1129,3,1,3,0,1,0,59.79
臺南市,東區,東門里,59,1,663,3,666,1137,3,1,3,0,1,0,58.58
臺南市,東區,東門里,60,1,581,4,585,962,3,1,3,0,1,0,60.81
臺南市,東區,圍下里,61,1,660,4,664,1102,3,1,3,0,1,0,60.25
臺南市,東區,圍下里,62,1,678,3,681,1114,3,1,3,0,1,0,61.13
臺南市,東區,中西里,63,1,876,7,883,1502,3,1,3,0,1,0,58.79
臺南市,東區,中西里,64,1,940,6,946,1585,3,1,3,0,1,0,59.68
臺南市,東區,東安里,65,1,825,10,835,1565,3,1,3,0,1,0,53.35
臺南市,東區,新東里,66,1,774,3,777,1281,3,1,3,0,1,0,60.66
臺南市,東區,新東里,67,1,691,5,696,1186,3,1,3,0,1,0,58.68
臺南市,東區,崇誨里,68,1,882,3,885,1441,3,1,3,0,1,0,61.42
臺南市,東區,崇誨里,69,1,703,4,707,1247,3,1,3,0,1,0,56.70
臺南市,東區,衛國里,70,1,876,7,883,1590,3,1,3,0,1,0,55.53
臺南市,東區,裕農里,71,1,883,4,887,1547,3,1,3,0,1,0,57.34
臺南市,東區,裕農里,72,1,773,3,776,1340,3,1,3,0,1,0,57.91
臺南市,東區,富強里,73,1,1175,7,1182,2085,3,1,3,0,1,0,56.69
臺南市,東區,富強里,74,1,1025,5,1030,1769,3,1,3,0,1,0,58.22
臺南市,東區,富裕里,75,1,1147,8,1155,2082,3,1,3,0,1,0,55.48
臺南市,東區,忠孝里,76,1,916,2,918,1760,3,1,3,0,1,0,52.16
臺南市,東區,忠孝里,77,1,996,2,998,1843,3,1,3,0,1,0,54.15
臺南市,東區,忠孝里,78,1,345,5,350,543,3,1,3,0,1,0,64.46
臺南市,東區,崇明里,79,1,898,5,903,1529,3,1,3,0,1,0,59.06
臺南市,東區,崇明里,80,1,893,3,896,1555,3,1,3,0,1,0,57.62
臺南市,東區,大福里,81,1,1278,8,1286,2149,3,1,3,0,1,0,59.84
臺南市,東區,大德里,82,1,933,5,938,1611,3,1,3,0,1,0,58.22
臺南市,東區,路東里,83,1,698,3,701,1246,3,1,3,0,1,0,56.26
臺南市,東區,大同里,84,1,1063,5,1068,1904,3,1,3,0,1,0,56.09
臺南市,東區,大同里,85,1,598,5,603,1034,3,1,3,0,1,0,58.32
臺南市,東區,泉南里,86,1,1248,2,1250,2105,3,1,3,0,1,0,59.38
臺南市,東區,泉南里,87,1,1249,4,1253,2134,3,1,3,0,1,0,58.72
臺南市,東區,龍山里,88,1,737,8,745,1335,3,1,3,0,1,0,55.81
臺南市,東區,龍山里,89,1,808,5,813,1480,3,1,3,0,1,0,54.93
臺南市,東區,德光里,90,1,955,6,961,1707,3,1,3,0,1,0,56.30
臺南市,東區,德光里,91,1,988,7,995,1712,3,1,3,0,1,0,58.12
臺南市,南區,大恩里,92,1,906,2,908,1536,3,1,3,0,1,0,59.11
臺南市,南區,大恩里,93,1,968,8,976,1631,3,1,3,0,1,0,59.84
臺南市,南區,大林里,94,1,555,4,559,964,3,1,3,0,1,0,57.99
臺南市,南區,大林里,95,1,536,5,541,906,3,1,3,0,1,0,59.71
臺南市,南區,大忠里,96,1,857,7,864,1406,3,1,3,0,1,0,61.45
臺南市,南區,大忠里,97,1,631,10,641,1108,3,1,3,0,1,0,57.85
臺南市,南區,大忠里,98,1,1032,4,1036,1765,3,1,3,0,1,0,58.70
臺南市,南區,新生里,99,1,1173,16,1189,1772,3,1,3,0,1,0,67.10
臺南市,南區,竹溪里,100,1,857,11,868,1451,3,1,3,0,1,0,59.82
臺南市,南區,明德里,101,1,435,3,438,745,3,1,3,0,1,0,58.79
臺南市,南區,興中里,102,1,576,2,578,941,3,1,3,0,1,0,61.42
臺南市,南區,荔宅里,103,1,632,5,637,1051,3,1,3,0,1,0,60.61
臺南市,南區,大成里,104,1,555,2,557,920,3,1,3,0,1,0,60.54
臺南市,南區,田寮里,105,1,429,2,431,743,3,1,3,0,1,0,58.01
臺南市,南區,田寮里,106,1,610,3,613,1083,3,1,3,0,1,0,56.60
臺南市,南區,田寮里,107,1,915,6,921,1530,3,1,3,0,1,0,60.20
臺南市,南區,新興里,108,1,669,4,673,1160,3,1,3,0,1,0,58.02
臺南市,南區,新興里,109,1,821,5,826,1465,3,1,3,0,1,0,56.38
臺南市,南區,再興里,110,1,670,8,678,1063,3,1,3,0,1,0,63.78
臺南市,南區,再興里,111,1,642,3,645,1098,3,1,3,0,1,0,58.74
臺南市,南區,廣州里,112,1,787,3,790,1246,3,1,3,0,1,0,63.40
臺南市,南區,廣州里,113,1,790,6,796,1266,3,1,3,0,1,0,62.88
臺南市,南區,新昌里,114,1,685,3,688,1156,3,1,3,0,1,0,59.52
臺南市,南區,新昌里,115,1,667,2,669,1196,3,1,3,0,1,0,55.94
臺南市,南區,文華里,116,1,952,5,957,1571,3,1,3,0,1,0,60.92
臺南市,南區,文華里,117,1,932,6,938,1539,3,1,3,0,1,0,60.95
臺南市,南區,文南里,118,1,791,6,797,1312,3,1,3,0,1,0,60.75
臺南市,南區,文南里,119,1,846,4,850,1398,3,1,3,0,1,0,60.80
臺南市,南區,文南里,120,1,659,2,661,1356,3,1,3,0,1,0,48.75
臺南市,南區,金華里,121,1,867,6,873,1476,3,1,3,0,1,0,59.15
臺南市,南區,金華里,122,1,857,9,866,1659,3,1,3,0,1,0,52.20
臺南市,南區,金華里,123,1,936,5,941,1597,3,1,3,0,1,0,58.92
臺南市,南區,國宅里,124,1,940,5,945,1554,3,1,3,0,1,0,60.81
臺南市,南區,國宅里,125,1,819,3,822,1405,3,1,3,0,1,0,58.51
臺南市,南區,日新里,126,1,582,0,582,960,3,1,3,0,1,0,60.62
臺南市,南區,日新里,127,1,611,4,615,1095,3,1,3,0,1,0,56.16
臺南市,南區,光明里,128,1,927,7,934,1593,3,1,3,0,1,0,58.63
臺南市,南區,光明里,129,1,715,2,717,1325,3,1,3,0,1,0,54.11
臺南市,南區,光明里,130,1,660,3,663,1190,3,1,3,0,1,0,55.71
臺南市,南區,白雪里,131,1,586,3,589,939,3,1,3,0,1,0,62.73
臺南市,南區,白雪里,132,1,553,3,556,939,3,1,3,0,1,0,59.21
臺南市,南區,明亮里,133,1,614,2,616,1174,3,1,3,0,1,0,52.47
臺南市,南區,明亮里,134,1,653,8,661,1213,3,1,3,0,1,0,54.49
臺南市,南區,明亮里,135,1,659,5,664,1123,3,1,3,0,1,0,59.13
臺南市,南區,府南里,136,1,788,6,794,1493,3,1,3,0,1,0,53.18
臺南市,南區,府南里,137,1,707,3,710,1223,3,1,3,0,1,0,58.05
臺南市,南區,府南里,138,1,777,3,780,1398,3,1,3,0,1,0,55.79
臺南市,南區,明興里,139,1,917,6,923,1520,3,1,3,0,1,0,60.72
臺南市,南區,明興里,140,1,892,12,904,1657,3,1,3,0,1,0,54.56
臺南市,南區,郡南里,141,1,843,3,846,1427,3,1,3,0,1,0,59.29
臺南市,南區,郡南里,142,1,914,3,917,1665,3,1,3,0,1,0,55.08
臺南市,南區,建南里,143,1,795,2,797,1339,3,1,3,0,1,0,59.52
臺南市,南區,建南里,144,1,839,9,848,1476,3,1,3,0,1,0,57.45
臺南市,南區,建南里,145,1,728,4,732,1227,3,1,3,0,1,0,59.66
臺南市,南區,南都里,146,1,520,1,521,946,3,1,3,0,1,0,55.07
臺南市,南區,南都里,147,1,593,3,596,1437,3,1,3,0,1,0,41.48
臺南市,南區,南華里,148,1,616,5,621,1148,3,1,3,0,1,0,54.09
臺南市,南區,南華里,149,1,701,3,704,1294,3,1,3,0,1,0,54.40
臺南市,南區,開南里,150,1,666,1,667,1283,3,1,3,0,1,0,51.99
臺南市,南區,開南里,151,1,644,4,648,1251,3,1,3,0,1,0,51.80
臺南市,南區,開南里,152,1,778,8,786,1523,3,1,3,0,1,0,51.61
臺南市,南區,彰南里,153,1,484,4,488,904,3,1,3,0,1,0,53.98
臺南市,南區,彰南里,154,1,526,3,529,921,3,1,3,0,1,0,57.44
臺南市,南區,鯤鯓里,155,1,653,4,657,1006,3,1,3,0,1,0,65.31
臺南市,南區,鯤鯓里,156,1,540,3,543,853,3,1,3,0,1,0,63.66
臺南市,南區,喜北里,157,1,641,3,644,1107,3,1,3,0,1,0,58.18
臺南市,南區,喜北里,158,1,694,1,695,1071,3,1,3,0,1,0,64.89
臺南市,南區,喜南里,159,1,880,5,885,1452,3,1,3,0,1,0,60.95
臺南市,南區,喜東里,160,1,949,7,956,1516,3,1,3,0,1,0,63.06
臺南市,南區,省躬里,161,1,795,4,799,1384,3,1,3,0,1,0,57.73
臺南市,南區,省躬里,162,1,718,2,720,1254,3,1,3,0,1,0,57.42
臺南市,南區,永寧里,163,1,577,1,578,876,3,1,3,0,1,0,65.98
臺南市,南區,永寧里,164,1,672,3,675,1078,3,1,3,0,1,0,62.62
臺南市,南區,松安里,165,1,1063,5,1068,1784,3,1,3,0,1,0,59.87
臺南市,南區,佛壇里,166,1,1061,7,1068,1836,3,1,3,0,1,0,58.17
臺南市,南區,同安里,167,1,712,4,716,1151,3,1,3,0,1,0,62.21
臺南市,南區,同安里,168,1,483,5,488,882,3,1,3,0,1,0,55.33
臺南市,南區,興農里,169,1,599,8,607,954,3,1,3,0,1,0,63.63
臺南市,南區,興農里,170,1,523,2,525,873,3,1,3,0,1,0,60.14
臺南市,中西區,小西里,171,1,596,1,597,968,3,1,3,0,1,0,61.67
臺南市,中西區,大南里,172,1,747,5,752,1234,3,1,3,0,1,0,60.94
臺南市,中西區,銀同里,173,1,737,1,738,1223,3,1,3,0,1,0,60.34
臺南市,中西區,五妃里,174,1,891,5,896,1576,3,1,3,0,1,0,56.85
臺南市,中西區,郡王里,175,1,824,2,826,1439,3,1,3,0,1,0,57.40
臺南市,中西區,仙草里,176,1,627,0,627,1209,3,1,3,0,1,0,51.86
臺南市,中西區,仙草里,177,1,682,0,682,1153,3,1,3,0,1,0,59.15
臺南市,中西區,法華里,178,1,777,1,778,1284,3,1,3,0,1,0,60.59
臺南市,中西區,法華里,179,1,670,4,674,1214,3,1,3,0,1,0,55.52
臺南市,中西區,福安里,180,1,815,4,819,1309,3,1,3,0,1,0,62.57
臺南市,中西區,進學里,181,1,790,5,795,1322,3,1,3,0,1,0,60.14
臺南市,中西區,建國里,182,1,778,1,779,1345,3,1,3,0,1,0,57.92
臺南市,中西區,青年里,183,1,832,2,834,1345,3,1,3,0,1,0,62.01
臺南市,中西區,永福里,184,1,837,6,843,1410,3,1,3,0,1,0,59.79
臺南市,中西區,永華里,185,1,808,14,822,1423,3,1,3,0,1,0,57.77
臺南市,中西區,天后里,186,1,978,6,984,1607,3,1,3,0,1,0,61.23
臺南市,中西區,三民里,187,1,902,8,910,1486,3,1,3,0,1,0,61.24
臺南市,中西區,赤嵌里,188,1,866,6,872,1514,3,1,3,0,1,0,57.60
臺南市,中西區,公正里,189,1,803,7,810,1429,3,1,3,0,1,0,56.68
臺南市,中西區,萬昌里,190,1,670,5,675,998,3,1,3,0,1,0,67.64
臺南市,中西區,萬昌里,191,1,629,1,630,1028,3,1,3,0,1,0,61.28
臺南市,中西區,開山里,192,1,662,4,666,1118,3,1,3,0,1,0,59.57
臺南市,中西區,開山里,193,1,548,2,550,986,3,1,3,0,1,0,55.78
臺南市,中西區,西賢里,194,1,1333,3,1336,2293,3,1,3,0,1,0,58.26
臺南市,中西區,西賢里,195,1,736,5,741,1266,3,1,3,0,1,0,58.53
臺南市,中西區,西湖里,196,1,798,3,801,1343,3,1,3,0,1,0,59.64
臺南市,中西區,西湖里,197,1,1109,8,1117,1914,3,1,3,0,1,0,58.36
臺南市,中西區,光賢里,198,1,942,2,944,1509,3,1,3,0,1,0,62.56
臺南市,中西區,光賢里,199,1,747,7,754,1246,3,1,3,0,1,0,60.51
臺南市,中西區,文賢里,200,1,776,3,779,1286,3,1,3,0,1,0,60.58
臺南市,中西區,協和里,201,1,556,3,559,1104,3,1,3,0,1,0,50.63
臺南市,中西區,協和里,202,1,578,4,582,962,3,1,3,0,1,0,60.50
臺南市,中西區,三合里,203,1,1128,8,1136,1870,3,1,3,0,1,0,60.75
臺南市,中西區,普濟里,204,1,729,3,732,1164,3,1,3,0,1,0,62.89
臺南市,中西區,水仙里,205,1,802,3,805,1336,3,1,3,0,1,0,60.25
臺南市,中西區,民權里,206,1,970,10,980,1576,3,1,3,0,1,0,62.18
臺南市,中西區,藥王里,207,1,757,6,763,1324,3,1,3,0,1,0,57.63
臺南市,中西區,藥王里,208,1,838,6,844,1608,3,1,3,0,1,0,52.49
臺南市,中西區,協進里,209,1,611,2,613,1064,3,1,3,0,1,0,57.61
臺南市,中西區,中正里,210,1,785,9,794,1309,3,1,3,0,1,0,60.66
臺南市,中西區,安海里,211,1,661,0,661,1272,3,1,3,0,1,0,51.97
臺南市,中西區,大涼里,212,1,505,6,511,934,3,1,3,0,1,0,54.71
臺南市,中西區,大涼里,213,1,853,8,861,1471,3,1,3,0,1,0,58.53
臺南市,中西區,民主里,214,1,572,6,578,965,3,1,3,0,1,0,59.90
臺南市,中西區,保安里,215,1,773,4,777,1309,3,1,3,0,1,0,59.36
臺南市,中西區,郡西里,216,1,743,7,750,1222,3,1,3,0,1,0,61.37
臺南市,中西區,民生里,217,1,1037,10,1047,1777,3,1,3,0,1,0,58.92
臺南市,中西區,元安里,218,1,746,2,748,1287,3,1,3,0,1,0,58.12
臺南市,北區,開元里,219,1,618,8,626,1057,3,1,3,0,1,0,59.22
臺南市,北區,開元里,220,1,733,4,737,1236,3,1,3,0,1,0,59.63
臺南市,北區,元寶里,221,1,309,3,312,721,3,1,3,0,1,0,43.27
臺南市,北區,元寶里,222,1,540,2,542,1054,3,1,3,0,1,0,51.42
臺南市,北區,國興里,223,1,841,10,851,1419,3,1,3,0,1,0,59.97
臺南市,北區,華興里,224,1,577,1,578,1019,3,1,3,0,1,0,56.72
臺南市,北區,華興里,225,1,606,6,612,1034,3,1,3,0,1,0,59.19
臺南市,北區,力行里,226,1,671,2,673,1149,3,1,3,0,1,0,58.57
臺南市,北區,力行里,227,1,678,2,680,1084,3,1,3,0,1,0,62.73
臺南市,北區,重興里,228,1,853,7,860,1489,3,1,3,0,1,0,57.76
臺南市,北區,重興里,229,1,823,3,826,1286,3,1,3,0,1,0,64.23
臺南市,北區,東興里,230,1,549,0,549,980,3,1,3,0,1,0,56.02
臺南市,北區,東興里,231,1,603,1,604,998,3,1,3,0,1,0,60.52
臺南市,北區,新勝里,232,1,521,3,524,907,3,1,3,0,1,0,57.77
臺南市,北區,新勝里,233,1,483,2,485,884,3,1,3,0,1,0,54.86
臺南市,北區,長榮里,234,1,746,7,753,1120,3,1,3,0,1,0,67.23
臺南市,北區,振興里,235,1,565,1,566,955,3,1,3,0,1,0,59.27
臺南市,北區,振興里,236,1,543,7,550,893,3,1,3,0,1,0,61.59
臺南市,北區,仁愛里,237,1,508,5,513,885,3,1,3,0,1,0,57.97
臺南市,北區,仁愛里,238,1,493,2,495,859,3,1,3,0,1,0,57.63
臺南市,北區,勝安里,239,1,697,7,704,1202,3,1,3,0,1,0,58.57
臺南市,北區,中樓里,240,1,543,10,553,899,3,1,3,0,1,0,61.51
臺南市,北區,中樓里,241,1,683,6,689,1122,3,1,3,0,1,0,61.41
臺南市,北區,永祥里,242,1,889,5,894,1515,3,1,3,0,1,0,59.01
臺南市,北區,永祥里,243,1,799,4,803,1353,3,1,3,0,1,0,59.35
臺南市,北區,小康里,244,1,584,2,586,992,3,1,3,0,1,0,59.07
臺南市,北區,小康里,245,1,613,9,622,1026,3,1,3,0,1,0,60.62
臺南市,北區,實踐里,246,1,894,5,899,1430,3,1,3,0,1,0,62.87
臺南市,北區,光武里,247,1,502,1,503,770,3,1,3,0,1,0,65.32
臺南市,北區,大道里,248,1,558,7,565,830,3,1,3,0,1,0,68.07
臺南市,北區,大山里,249,1,730,10,740,1206,3,1,3,0,1,0,61.36
臺南市,北區,大仁里,250,1,534,5,539,904,3,1,3,0,1,0,59.62
臺南市,北區,興北里,251,1,888,6,894,1508,3,1,3,0,1,0,59.28
臺南市,北區,公園里,252,1,455,3,458,794,3,1,3,0,1,0,57.68
臺南市,北區,公園里,253,1,632,2,634,1099,3,1,3,0,1,0,57.69
臺南市,北區,正風里,254,1,856,5,861,1470,3,1,3,0,1,0,58.57
臺南市,北區,延平里,255,1,482,1,483,842,3,1,3,0,1,0,57.36
臺南市,北區,延平里,256,1,474,1,475,903,3,1,3,0,1,0,52.60
臺南市,北區,興南里,257,1,699,7,706,1293,3,1,3,0,1,0,54.60
臺南市,北區,玉皇里,258,1,979,2,981,1649,3,1,3,0,1,0,59.49
臺南市,北區,正覺里,259,1,657,4,661,1077,3,1,3,0,1,0,61.37
臺南市,北區,正覺里,260,1,669,2,671,1096,3,1,3,0,1,0,61.22
臺南市,北區,正覺里,261,1,587,3,590,1013,3,1,3,0,1,0,58.24
臺南市,北區,六甲里,262,1,592,2,594,1087,3,1,3,0,1,0,54.65
臺南市,北區,六甲里,263,1,609,3,612,1165,3,1,3,0,1,0,52.53
臺南市,北區,國姓里,264,1,892,4,896,1532,3,1,3,0,1,0,58.49
臺南市,北區,長德里,265,1,832,4,836,1506,3,1,3,0,1,0,55.51
臺南市,北區,三德里,266,1,771,4,775,1337,3,1,3,0,1,0,57.97
臺南市,北區,五福里,267,1,690,2,692,1599,3,1,3,0,1,0,43.28
臺南市,北區,成功里,268,1,749,8,757,1326,3,1,3,0,1,0,57.09
臺南市,北區,成功里,269,1,466,3,469,927,3,1,3,0,1,0,50.59
臺南市,北區,成功里,270,1,690,3,693,1242,3,1,3,0,1,0,55.80
臺南市,北區,成德里,271,1,622,0,622,1125,3,1,3,0,1,0,55.29
臺南市,北區,成德里,272,1,776,3,779,1422,3,1,3,0,1,0,54.78
臺南市,北區,成德里,273,1,554,2,556,1058,3,1,3,0,1,0,52.55
臺南市,北區,成德里,274,1,1042,6,1048,2029,3,1,3,0,1,0,51.65
臺南市,北區,和順里,275,1,651,6,657,1196,3,1,3,0,1,0,54.93
臺南市,北區,和順里,276,1,666,4,670,1215,3,1,3,0,1,0,55.14
臺南市,北區,和順里,277,1,764,8,772,1319,3,1,3,0,1,0,58.53
臺南市,北區,和順里,278,1,763,4,767,1561,3,1,3,0,1,0,49.14
臺南市,北區,安民里,279,1,835,4,839,1351,3,1,3,0,1,0,62.10
臺南市,北區,文元里,280,1,741,5,746,1405,3,1,3,0,1,0,53.10
臺南市,北區,文元里,281,1,697,5,702,1356,3,1,3,0,1,0,51.77
臺南市,北區,文元里,282,1,762,1,763,1345,3,1,3,0,1,0,56.73
臺南市,北區,文成里,283,1,785,7,792,1413,3,1,3,0,1,0,56.05
臺南市,北區,文成里,284,1,787,6,793,1357,3,1,3,0,1,0,58.44
臺南市,北區,裕民里,285,1,862,7,869,1383,3,1,3,0,1,0,62.83
臺南市,北區,大和里,286,1,925,10,935,1564,3,1,3,0,1,0,59.78
臺南市,北區,大和里,287,1,851,5,856,1492,3,1,3,0,1,0,57.37
臺南市,北區,大港里,288,1,720,9,729,1272,3,1,3,0,1,0,57.31
臺南市,北區,大港里,289,1,863,8,871,1485,3,1,3,0,1,0,58.65
臺南市,北區,大港里,290,1,999,5,1004,1787,3,1,3,0,1,0,56.18
臺南市,北區,大豐里,291,1,935,5,940,1706,3,1,3,0,1,0,55.10
臺南市,北區,大豐里,292,1,731,5,736,1336,3,1,3,0,1,0,55.09
臺南市,北區,大豐里,293,1,581,1,582,974,3,1,3,0,1,0,59.75
臺南市,北區,賢北里,294,1,705,5,710,1207,3,1,3,0,1,0,58.82
臺南市,北區,賢北里,295,1,737,3,740,1253,3,1,3,0,1,0,59.06
臺南市,安南區,東和里,296,1,360,3,363,584,3,1,3,0,1,0,62.16
臺南市,安南區,塭南里,297,1,1174,9,1183,2062,3,1,3,0,1,0,57.37
臺南市,安南區,塭南里,298,1,878,5,883,1588,3,1,3,0,1,0,55.60
臺南市,安南區,州南里,299,1,976,3,979,1642,3,1,3,0,1,0,59.62
臺南市,安南區,州南里,300,1,771,3,774,1388,3,1,3,0,1,0,55.76
臺南市,安南區,州南里,301,1,685,5,690,1237,3,1,3,0,1,0,55.78
臺南市,安南區,安順里,302,1,837,11,848,1350,3,1,3,0,1,0,62.81
臺南市,安南區,安順里,303,1,876,4,880,1413,3,1,3,0,1,0,62.28
臺南市,安南區,州北里,304,1,1018,6,1024,1599,3,1,3,0,1,0,64.04
臺南市,安南區,州北里,305,1,975,4,979,1746,3,1,3,0,1,0,56.07
臺南市,安南區,新順里,306,1,1060,7,1067,1744,3,1,3,0,1,0,61.18
臺南市,安南區,新順里,307,1,1074,5,1079,1895,3,1,3,0,1,0,56.94
臺南市,安南區,頂安里,308,1,789,5,794,1194,3,1,3,0,1,0,66.50
臺南市,安南區,頂安里,309,1,862,8,870,1599,3,1,3,0,1,0,54.41
臺南市,安南區,安慶里,310,1,699,4,703,1115,3,1,3,0,1,0,63.05
臺南市,安南區,安慶里,311,1,965,6,971,1624,3,1,3,0,1,0,59.79
臺南市,安南區,安慶里,312,1,856,8,864,1445,3,1,3,0,1,0,59.79
臺南市,安南區,溪北里,313,1,762,4,766,1234,3,1,3,0,1,0,62.07
臺南市,安南區,溪北里,314,1,792,5,797,1298,3,1,3,0,1,0,61.40
臺南市,安南區,安和里,315,1,1155,5,1160,1947,3,1,3,0,1,0,59.58
臺南市,安南區,安西里,316,1,1380,8,1388,2171,3,1,3,0,1,0,63.93
臺南市,安南區,溪頂里,317,1,1344,9,1353,2223,3,1,3,0,1,0,60.86
臺南市,安南區,溪頂里,318,1,922,9,931,1621,3,1,3,0,1,0,57.43
臺南市,安南區,安東里,319,1,804,7,811,1313,3,1,3,0,1,0,61.77
臺南市,安南區,安東里,320,1,758,1,759,1218,3,1,3,0,1,0,62.32
臺南市,安南區,鳳凰里,321,1,1040,7,1047,1953,3,1,3,0,1,0,53.61
臺南市,安南區,鳳凰里,322,1,904,7,911,1769,3,1,3,0,1,0,51.50
臺南市,安南區,梅花里,323,1,848,5,853,1524,3,1,3,0,1,0,55.97
臺南市,安南區,梅花里,324,1,872,4,876,1637,3,1,3,0,1,0,53.51
臺南市,安南區,理想里,325,1,1029,8,1037,1754,3,1,3,0,1,0,59.12
臺南市,安南區,理想里,326,1,997,3,1000,1794,3,1,3,0,1,0,55.74
臺南市,安南區,大安里,327,1,856,10,866,1537,3,1,3,0,1,0,56.34
臺南市,安南區,大安里,328,1,861,6,867,1496,3,1,3,0,1,0,57.95
臺南市,安南區,原佃里,329,1,1008,7,1015,1503,3,1,3,0,1,0,67.53
臺南市,安南區,長安里,330,1,884,1,885,1561,3,1,3,0,1,0,56.69
臺南市,安南區,長安里,331,1,1004,7,1011,1750,3,1,3,0,1,0,57.77
臺南市,安南區,公親里,332,1,690,4,694,1042,3,1,3,0,1,0,66.60
臺南市,安南區,布袋里,333,1,749,2,751,1301,3,1,3,0,1,0,57.72
臺南市,安南區,總頭里,334,1,1105,7,1112,1701,3,1,3,0,1,0,65.37
臺南市,安南區,南興里,335,1,800,3,803,1333,3,1,3,0,1,0,60.24
臺南市,安南區,學東里,336,1,1051,7,1058,1810,3,1,3,0,1,0,58.45
臺南市,安南區,公塭里,337,1,638,0,638,825,3,1,3,0,1,0,77.33
臺南市,安南區,佃東里,338,1,633,4,637,1062,3,1,3,0,1,0,59.98
臺南市,安南區,佃東里,339,1,684,1,685,1171,3,1,3,0,1,0,58.50
臺南市,安南區,佃西里,340,1,930,4,934,1480,3,1,3,0,1,0,63.11
臺南市,安南區,淵西里,341,1,593,3,596,1036,3,1,3,0,1,0,57.53
臺南市,安南區,淵西里,342,1,828,6,834,1407,3,1,3,0,1,0,59.28
臺南市,安南區,海西里,343,1,715,2,717,1179,3,1,3,0,1,0,60.81
臺南市,安南區,海西里,344,1,650,6,656,1142,3,1,3,0,1,0,57.44
臺南市,安南區,海東里,345,1,1053,9,1062,1895,3,1,3,0,1,0,56.04
臺南市,安南區,海東里,346,1,942,5,947,1718,3,1,3,0,1,0,55.12
臺南市,安南區,溪心里,347,1,751,6,757,1338,3,1,3,0,1,0,56.58
臺南市,安南區,溪心里,348,1,675,5,680,1182,3,1,3,0,1,0,57.53
臺南市,安南區,溪心里,349,1,684,4,688,1579,3,1,3,0,1,0,43.57
臺南市,安南區,淵東里,350,1,763,7,770,1368,3,1,3,0,1,0,56.29
臺南市,安南區,淵東里,351,1,976,7,983,1657,3,1,3,0,1,0,59.32
臺南市,安南區,淵中里,352,1,838,8,846,1491,3,1,3,0,1,0,56.74
臺南市,安南區,淵中里,353,1,682,5,687,1211,3,1,3,0,1,0,56.73
臺南市,安南區,溪墘里,354,1,868,1,869,1396,3,1,3,0,1,0,62.25
臺南市,安南區,溪墘里,355,1,855,3,858,1448,3,1,3,0,1,0,59.25
臺南市,安南區,海佃里,356,1,1143,9,1152,1958,3,1,3,0,1,0,58.84
臺南市,安南區,海佃里,357,1,1207,7,1214,1972,3,1,3,0,1,0,61.56
臺南市,安南區,國安里,358,1,1029,3,1032,1677,3,1,3,0,1,0,61.54
臺南市,安南區,溪東里,359,1,516,3,519,849,3,1,3,0,1,0,61.13
臺南市,安南區,溪東里,360,1,1137,9,1146,1926,3,1,3,0,1,0,59.50
臺南市,安南區,安富里,361,1,1148,10,1158,2045,3,1,3,0,1,0,56.63
臺南市,安南區,安富里,362,1,1232,9,1241,2126,3,1,3,0,1,0,58.37
臺南市,安南區,幸福里,363,1,881,9,890,1489,3,1,3,0,1,0,59.77
臺南市,安南區,幸福里,364,1,1237,8,1245,1962,3,1,3,0,1,0,63.46
臺南市,安南區,海南里,365,1,637,5,642,1017,3,1,3,0,1,0,63.13
臺南市,安南區,海南里,366,1,643,3,646,958,3,1,3,0,1,0,67.43
臺南市,安南區,城東里,367,1,862,2,864,1378,3,1,3,0,1,0,62.70
臺南市,安南區,城南里,368,1,1100,7,1107,1632,3,1,3,0,1,0,67.83
臺南市,安南區,城南里,369,1,523,2,525,772,3,1,3,0,1,0,68.01
臺南市,安南區,青草里,370,1,822,3,825,1283,3,1,3,0,1,0,64.30
臺南市,安南區,城西里,371,1,706,8,714,1023,3,1,3,0,1,0,69.79
臺南市,安南區,城北里,372,1,850,4,854,1217,3,1,3,0,1,0,70.17
臺南市,安南區,城中里,373,1,700,1,701,886,3,1,3,0,1,0,79.12
臺南市,安南區,砂崙里,374,1,335,2,337,497,3,1,3,0,1,0,67.81
臺南市,安南區,砂崙里,375,1,385,2,387,562,3,1,3,0,1,0,68.86
臺南市,安南區,顯宮里,376,1,715,1,716,1089,3,1,3,0,1,0,65.75
臺南市,安南區,鹿耳里,377,1,399,0,399,642,3,1,3,0,1,0,62.15
臺南市,安南區,四草里,378,1,984,2,986,1433,3,1,3,0,1,0,68.81
臺南市,安南區,鹽田里,379,1,402,0,402,551,3,1,3,0,1,0,72.96
臺南市,安平區,平安里,380,1,808,2,810,1460,3,1,3,0,1,0,55.48
臺南市,安平區,平安里,381,1,913,9,922,1495,3,1,3,0,1,0,61.67
臺南市,安平區,石門里,382,1,1182,8,1190,2276,3,1,3,0,1,0,52.28
臺南市,安平區,港仔里,383,1,879,6,885,1435,3,1,3,0,1,0,61.67
臺南市,安平區,海頭里,384,1,900,3,903,1493,3,1,3,0,1,0,60.48
臺南市,安平區,西門里,385,1,1206,7,1213,1943,3,1,3,0,1,0,62.43
臺南市,安平區,金城里,386,1,877,7,884,1502,3,1,3,0,1,0,58.85
臺南市,安平區,漁光里,387,1,360,1,361,518,3,1,3,0,1,0,69.69
臺南市,安平區,億載里,388,1,795,1,796,1477,3,1,3,0,1,0,53.89
臺南市,安平區,平通里,389,1,908,4,912,2030,3,1,3,0,1,0,44.93
臺南市,安平區,平通里,390,1,948,4,952,1916,3,1,3,0,1,0,49.69
臺南市,安平區,育平里,391,1,738,3,741,1497,3,1,3,0,1,0,49.50
臺南市,安平區,育平里,392,1,809,2,811,1729,3,1,3,0,1,0,46.91
臺南市,安平區,育平里,393,1,799,7,806,1726,3,1,3,0,1,0,46.70
臺南市,安平區,華平里,394,1,960,7,967,1833,3,1,3,0,1,0,52.76
臺南市,安平區,華平里,395,1,934,7,941,1850,3,1,3,0,1,0,50.86
臺南市,安平區,怡平里,396,1,607,2,609,1316,3,1,3,0,1,0,46.28
臺南市,安平區,怡平里,397,1,710,3,713,1355,3,1,3,0,1,0,52.62
臺南市,安平區,國平里,398,1,1015,2,1017,1819,3,1,3,0,1,0,55.91
臺南市,安平區,國平里,399,1,754,7,761,1734,3,1,3,0,1,0,43.89
臺南市,安平區,建平里,400,1,807,5,812,1528,3,1,3,0,1,0,53.14
臺南市,安平區,建平里,401,1,854,4,858,1610,3,1,3,0,1,0,53.29
臺南市,安平區,文平里,402,1,875,3,878,1570,3,1,3,0,1,0,55.92
臺南市,安平區,文平里,403,1,889,1,890,1648,3,1,3,0,1,0,54.00
金門縣,金城鎮,東門里,1,1,509,11,520,1051,3,1,3,0,1,0,49.48
金門縣,金城鎮,東門里,2,1,529,3,532,1157,3,1,3,0,1,0,45.98
金門縣,金城鎮,南門里,3,1,505,8,513,1096,3,1,3,0,1,0,46.81
金門縣,金城鎮,南門里,4,1,643,5,648,1434,3,1,3,0,1,0,45.19
金門縣,金城鎮,西門里,5,1,546,7,553,1172,3,1,3,0,1,0,47.18
金門縣,金城鎮,西門里,6,1,585,7,592,1292,3,1,3,0,1,0,45.82
金門縣,金城鎮,西門里,7,1,845,9,854,1731,3,1,3,0,1,0,49.34
金門縣,金城鎮,北門里,8,1,814,11,825,1778,3,1,3,0,1,0,46.40
金門縣,金城鎮,賢庵里,9,1,658,10,668,1480,3,1,3,0,1,0,45.14
金門縣,金城鎮,金水里,10,1,418,4,422,795,3,1,3,0,1,0,53.08
金門縣,金城鎮,古城里,11,1,729,9,738,1467,3,1,3,0,1,0,50.31
金門縣,金城鎮,珠沙里,12,1,440,4,444,943,3,1,3,0,1,0,47.08
金門縣,金寧鄉,古寧村,13,1,655,13,668,1328,3,1,3,0,1,0,50.30
金門縣,金寧鄉,安美村,14,1,871,17,888,1670,3,1,3,0,1,0,53.17
金門縣,金寧鄉,湖埔村,15,1,791,13,804,1683,3,1,3,0,1,0,47.77
金門縣,金寧鄉,榜林村,16,1,778,10,788,1718,3,1,3,0,1,0,45.87
金門縣,金寧鄉,盤山村,17,1,654,8,662,1398,3,1,3,0,1,0,47.35
金門縣,金寧鄉,后盤村,18,1,295,4,299,564,3,1,3,0,1,0,53.01
金門縣,金湖鎮,新市里,19,1,507,6,513,972,3,1,3,0,1,0,52.78
金門縣,金湖鎮,新市里,20,1,579,7,586,1151,3,1,3,0,1,0,50.91
金門縣,金湖鎮,山外里,21,1,794,11,805,1572,3,1,3,0,1,0,51.21
金門縣,金湖鎮,溪湖里,22,1,328,5,333,664,3,1,3,0,1,0,50.15
金門縣,金湖鎮,蓮庵里,23,1,345,4,349,652,3,1,3,0,1,0,53.53
金門縣,金湖鎮,料羅里,24,1,368,1,369,718,3,1,3,0,1,0,51.39
金門縣,金湖鎮,新湖里,25,1,460,12,472,954,3,1,3,0,1,0,49.48
金門縣,金湖鎮,新湖里,26,1,579,5,584,1144,3,1,3,0,1,0,51.05
金門縣,金湖鎮,正義里,27,1,509,13,522,950,3,1,3,0,1,0,54.95
金門縣,金湖鎮,瓊林里,28,1,651,8,659,1369,3,1,3,0,1,0,48.14
金門縣,金沙鎮,汶沙里,29,1,461,3,464,1027,3,1,3,0,1,0,45.18
金門縣,金沙鎮,汶沙里,30,1,581,5,586,1215,3,1,3,0,1,0,48.23
金門縣,金沙鎮,何斗里,31,1,430,6,436,870,3,1,3,0,1,0,50.11
金門縣,金沙鎮,浦山里,32,1,448,8,456,965,3,1,3,0,1,0,47.25
金門縣,金沙鎮,西園里,33,1,317,1,318,646,3,1,3,0,1,0,49.23
金門縣,金沙鎮,官嶼里,34,1,389,2,391,840,3,1,3,0,1,0,46.55
金門縣,金沙鎮,三山里,35,1,399,2,401,834,3,1,3,0,1,0,48.08
金門縣,金沙鎮,大洋里,36,1,296,3,299,499,3,1,3,0,1,0,59.92
金門縣,金沙鎮,光前里,37,1,440,4,444,916,3,1,3,0,1,0,48.47
金門縣,烈嶼鄉,林湖村,38,1,709,5,714,1350,3,1,3,0,1,0,52.89
金門縣,烈嶼鄉,黃埔村,39,1,277,1,278,580,3,1,3,0,1,0,47.93
金門縣,烈嶼鄉,西口村,40,1,396,2,398,838,3,1,3,0,1,0,47.49
金門縣,烈嶼鄉,上林村,41,1,280,1,281,579,3,1,3,0,1,0,48.53
金門縣,烈嶼鄉,上岐村,42,1,592,2,594,1125,3,1,3,0,1,0,52.8
金門縣,烏坵鄉,大坵村,43,1,27,0,27,103,3,1,3,0,1,0,26.21
金門縣,烏坵鄉,小坵村,44,1,19,0,19,159,3,1,3,0,1,0,11.95
連江縣,南竿鄉,介壽村,1,1,970,9,979,1347,3,1,3,0,1,0,72.68
連江縣,南竿鄉,福沃村、復興村,2,1,811,5,816,1210,3,1,3,0,1,0,67.44
連江縣,南竿鄉,仁愛村、馬祖村、津沙村、珠螺村、清水村、四維村,3,1,909,13,922,1521,3,1,3,0,1,0,60.62
連江縣,北竿鄉,后沃村、橋仔村、塘岐村,4,1,603,10,613,933,3,1,3,0,1,0,65.70
連江縣,北竿鄉,白沙村、板里村、芹壁村,5,1,271,6,277,438,3,1,3,0,1,0,63.24
連江縣,莒光鄉,青帆村、田沃村、西坵村,6,1,279,0,279,489,3,1,3,0,1,0,57.06
連江縣,莒光鄉,大坪村、福正村,7,1,211,0,211,376,3,1,3,0,1,0,56.12
連江縣,東引鄉,中柳村、樂華村,8,1,397,4,401,643,3,1,3,0,1,0,62.36
