CountyCityName,TownshipName,VillageName,PollStationNo,DistrictName,BallotsAccepted,BallotsRejected,BallotsCast,Voters,CandidateCounts,ElectedCounts,CandidateMaleCounts,CandidateFemaleCounts,ElectedMaleCounts,ElectedFemaleCounts,BallotsRate
全國,,,0,0,8153974,197832,8351806,10892906,166,75,135,31,59,16,76.67
臺北縣,,,0,0,1526644,42015,1568659,2065188,22,12,19,3,11,1,75.96
宜蘭縣,,,0,0,232350,4129,236479,303029,4,2,4,0,2,0,78.04
桃園縣,,,0,0,702557,17863,720420,919861,14,6,12,2,5,1,78.32
新竹縣,,,0,0,196264,5947,202211,251871,5,2,5,0,2,0,80.28
苗栗縣,,,0,0,285034,6257,291291,365563,10,3,10,0,3,0,79.68
臺中縣,,,0,0,669475,21357,690832,853492,10,6,7,3,5,1,80.94
彰化縣,,,0,0,650195,14701,664896,821077,11,6,8,3,4,2,80.98
南投縣,,,0,0,265140,6278,271418,350917,5,3,5,0,3,0,77.35
雲林縣,,,0,0,357284,7178,364462,513972,7,4,4,3,1,3,70.91
嘉義縣,,,0,0,291825,6855,298680,388786,6,3,6,0,3,0,76.82
臺南縣,,,0,0,534060,10426,544486,720348,10,5,8,2,4,1,75.59
高雄縣,,,0,0,598932,10943,609875,770950,12,5,9,3,4,1,79.11
屏東縣,,,0,0,424904,6468,431372,580043,9,4,6,3,3,1,74.37
臺東縣,,,0,0,76954,1841,78795,122280,4,1,4,0,1,0,64.44
花蓮縣,,,0,0,116202,4878,121080,188597,2,1,2,0,1,0,64.20
澎湖縣,,,0,0,38760,1551,40311,64170,2,1,0,2,0,1,62.82
基隆市,,,0,0,177659,4491,182150,243567,10,2,9,1,1,1,74.78
新竹市,,,0,0,153407,5292,158699,220070,2,1,1,1,0,1,72.11
臺中市,,,0,0,387439,7079,394518,523077,10,4,6,4,2,2,75.42
嘉義市,,,0,0,121670,3618,125288,169913,4,1,4,0,1,0,73.74
臺南市,,,0,0,347219,8665,355884,456135,7,3,6,1,3,0,78.02
臺北縣,板橋市,,0,0,250402,7349,257751,335302,4,1,4,0,1,0,76.87
臺北縣,三重市,,0,0,182877,4687,187564,243252,2,1,2,0,1,0,77.11
臺北縣,中和市,,0,0,191358,5067,196425,257025,4,1,3,1,1,0,76.42
臺北縣,永和市,,0,0,117891,2985,120876,159106,3,1,3,0,1,0,75.97
臺北縣,新莊市,,0,0,140711,4144,144855,190677,4,1,4,0,1,0,75.97
臺北縣,新店市,,0,0,123050,2674,125724,171918,3,1,3,0,1,0,73.13
臺北縣,樹林市,,0,0,56757,1480,58237,76301,4,1,4,0,1,0,76.33
臺北縣,鶯歌鎮,,0,0,31202,1002,32204,41944,2,1,2,0,1,0,76.78
臺北縣,三峽鎮,,0,0,30657,768,31425,42422,4,1,2,2,1,0,74.08
臺北縣,淡水鎮,,0,0,45457,1557,47014,61169,2,1,0,2,0,1,76.86
臺北縣,汐止市,,0,0,52284,1874,54158,73194,3,1,2,1,1,0,73.99
臺北縣,瑞芳鎮,,0,0,25670,809,26479,36502,3,1,3,0,1,0,72.54
臺北縣,土城市,,0,0,74855,1979,76834,101622,3,1,3,0,1,0,75.61
臺北縣,蘆洲市,,0,0,57966,1601,59567,77034,5,1,4,1,0,1,77.33
臺北縣,五股鄉,,0,0,24980,719,25699,33412,2,1,1,1,1,0,76.92
臺北縣,泰山鄉,,0,0,26468,653,27121,34587,2,1,1,1,1,0,78.41
臺北縣,林口鄉,,0,0,17691,582,18273,23939,2,1,1,1,1,0,76.33
臺北縣,深坑鄉,,0,0,7754,249,8003,10313,2,1,1,1,1,0,77.60
臺北縣,石碇鄉,,0,0,4357,79,4436,6004,2,1,1,1,1,0,73.88
臺北縣,坪林鄉,,0,0,3179,75,3254,4697,2,1,1,1,1,0,69.28
臺北縣,三芝鄉,,0,0,9285,355,9640,12344,2,1,1,1,1,0,78.09
臺北縣,石門鄉,,0,0,5140,116,5256,6946,2,1,1,1,1,0,75.67
臺北縣,八里鄉,,0,0,9710,319,10029,13102,2,1,1,1,1,0,76.55
臺北縣,平溪鄉,,0,0,3737,79,3816,5370,2,1,1,1,1,0,71.06
臺北縣,雙溪鄉,,0,0,6265,92,6357,8589,2,1,1,1,1,0,74.01
臺北縣,貢寮鄉,,0,0,7205,150,7355,10351,2,1,1,1,1,0,71.06
臺北縣,金山鄉,,0,0,9359,217,9576,13113,2,1,1,1,1,0,73.03
臺北縣,萬里鄉,,0,0,9317,335,9652,13521,2,1,1,1,1,0,71.39
臺北縣,烏來鄉,,0,0,1060,19,1079,1432,2,1,1,1,1,0,75.35
宜蘭縣,宜蘭市,,0,0,45511,858,46369,58650,2,1,1,1,1,0,79.06
宜蘭縣,羅東鎮,,0,0,33588,657,34245,42576,2,1,1,1,1,0,80.43
宜蘭縣,蘇澳鎮,,0,0,24766,454,25220,33866,2,1,1,1,1,0,74.47
宜蘭縣,頭城鎮,,0,0,17069,219,17288,23103,2,1,1,1,1,0,74.83
宜蘭縣,礁溪鄉,,0,0,19840,309,20149,25766,2,1,1,1,1,0,78.20
宜蘭縣,壯圍鄉,,0,0,13086,205,13291,17382,2,1,1,1,1,0,76.46
宜蘭縣,員山鄉,,0,0,16979,281,17260,22540,2,1,1,1,1,0,76.57
宜蘭縣,冬山鄉,,0,0,27263,545,27808,34598,2,1,1,1,1,0,80.37
宜蘭縣,五結鄉,,0,0,20578,346,20924,25887,2,1,1,1,1,0,80.83
宜蘭縣,三星鄉,,0,0,12411,226,12637,16743,2,1,1,1,1,0,75.48
宜蘭縣,大同鄉,,0,0,667,10,677,957,2,1,1,1,1,0,70.74
宜蘭縣,南澳鄉,,0,0,592,19,611,961,2,1,1,1,1,0,63.58
桃園縣,桃園市,,0,0,118723,3125,121848,158551,2,1,1,1,1,0,76.85
桃園縣,中壢市,,0,0,143652,3233,146885,187020,2,1,1,1,1,0,78.54
桃園縣,大溪鎮,,0,0,38909,989,39898,50345,2,1,1,1,1,0,79.25
桃園縣,楊梅鎮,,0,0,51404,1277,52681,66217,2,1,1,1,1,0,79.56
桃園縣,蘆竹鄉,,0,0,31291,781,32072,40090,2,1,1,1,1,0,80.00
桃園縣,大園鄉,,0,0,32606,671,33277,41202,2,1,1,1,1,0,80.77
桃園縣,龜山鄉,,0,0,44711,1615,46326,63303,2,1,1,1,1,0,73.18
桃園縣,八德市,,0,0,69596,2306,71902,92262,2,1,1,1,1,0,77.93
桃園縣,龍潭鄉,,0,0,42651,1012,43663,54972,2,1,1,1,1,0,79.43
桃園縣,平鎮市,,0,0,76578,1914,78492,99204,2,1,1,1,1,0,79.12
桃園縣,新屋鄉,,0,0,25908,415,26323,32462,2,1,1,1,1,0,81.09
桃園縣,觀音鄉,,0,0,24681,479,25160,31571,2,1,1,1,1,0,79.69
桃園縣,復興鄉,,0,0,1847,46,1893,2662,2,1,1,1,1,0,71.11
新竹縣,竹北市,,0,0,35193,1187,36380,45929,2,1,1,1,1,0,79.21
新竹縣,竹東鎮,,0,0,40121,1352,41473,51540,2,1,1,1,1,0,80.47
新竹縣,新埔鎮,,0,0,18516,632,19148,24179,2,1,1,1,1,0,79.19
新竹縣,關西鎮,,0,0,17897,401,18298,22409,2,1,1,1,1,0,81.65
新竹縣,湖口鄉,,0,0,29176,975,30151,37278,2,1,1,1,1,0,80.88
新竹縣,新豐鄉,,0,0,19427,494,19921,24987,2,1,1,1,1,0,79.73
新竹縣,芎林鄉,,0,0,9867,254,10121,12476,2,1,1,1,1,0,81.12
新竹縣,橫山鄉,,0,0,8801,223,9024,11054,2,1,1,1,1,0,81.64
新竹縣,北埔鄉,,0,0,6025,145,6170,7617,2,1,1,1,1,0,81.00
新竹縣,寶山鄉,,0,0,6211,175,6386,7877,2,1,1,1,1,0,81.07
新竹縣,峨眉鄉,,0,0,4004,67,4071,5078,2,1,1,1,1,0,80.17
新竹縣,尖石鄉,,0,0,774,34,808,1066,2,1,1,1,1,0,75.80
新竹縣,五峰鄉,,0,0,252,8,260,381,2,1,1,1,1,0,68.24
苗栗縣,苗栗市,,0,0,45533,1275,46808,58970,2,1,1,1,1,0,79.38
苗栗縣,苑裡鎮,,0,0,24896,620,25516,32171,2,1,1,1,1,0,79.31
苗栗縣,通霄鎮,,0,0,22575,376,22951,28633,2,1,1,1,1,0,80.16
苗栗縣,竹南鎮,,0,0,33457,602,34059,40968,2,1,1,1,1,0,83.14
苗栗縣,頭份鎮,,0,0,40571,918,41489,52515,2,1,1,1,1,0,79.00
苗栗縣,後龍鎮,,0,0,21798,618,22416,29866,2,1,1,1,1,0,75.06
苗栗縣,卓蘭鎮,,0,0,11213,213,11426,13799,2,1,1,1,1,0,82.80
苗栗縣,大湖鄉,,0,0,10050,208,10258,13128,2,1,1,1,1,0,78.14
苗栗縣,公館鄉,,0,0,18410,275,18685,22895,2,1,1,1,1,0,81.61
苗栗縣,銅鑼鄉,,0,0,11238,217,11455,14373,2,1,1,1,1,0,79.70
苗栗縣,南庄鄉,,0,0,6415,113,6528,8522,2,1,1,1,1,0,76.60
苗栗縣,頭屋鄉,,0,0,6883,188,7071,8736,2,1,1,1,1,0,80.94
苗栗縣,三義鄉,,0,0,9332,225,9557,11826,2,1,1,1,1,0,80.81
苗栗縣,西湖鄉,,0,0,5241,99,5340,7035,2,1,1,1,1,0,75.91
苗栗縣,造橋鄉,,0,0,8078,142,8220,9939,2,1,1,1,1,0,82.70
苗栗縣,三灣鄉,,0,0,4834,69,4903,6013,2,1,1,1,1,0,81.54
苗栗縣,獅潭鄉,,0,0,3355,73,3428,4597,2,1,1,1,1,0,74.57
苗栗縣,泰安鄉,,0,0,1155,26,1181,1577,2,1,1,1,1,0,74.89
臺中縣,豐原市,,0,0,76528,2706,79234,98316,2,1,1,1,1,0,80.59
臺中縣,東勢鎮,,0,0,31689,732,32421,40736,2,1,1,1,1,0,79.59
臺中縣,大甲鎮,,0,0,38074,957,39031,46960,2,1,1,1,1,0,83.12
臺中縣,清水鎮,,0,0,42332,1090,43422,53269,2,1,1,1,1,0,81.51
臺中縣,沙鹿鎮,,0,0,34043,1027,35070,42182,2,1,1,1,1,0,83.14
臺中縣,梧棲鎮,,0,0,22099,587,22686,27872,2,1,1,1,1,0,81.39
臺中縣,后里鄉,,0,0,28857,917,29774,35425,2,1,1,1,1,0,84.05
臺中縣,神岡鄉,,0,0,28967,822,29789,35931,2,1,1,1,1,0,82.91
臺中縣,潭子鄉,,0,0,34105,1280,35385,44182,2,1,1,1,1,0,80.09
臺中縣,大雅鄉,,0,0,30313,1134,31447,38587,2,1,1,1,1,0,81.50
臺中縣,新社鄉,,0,0,15242,380,15622,18944,2,1,1,1,1,0,82.46
臺中縣,石岡鄉,,0,0,8603,239,8842,10756,2,1,1,1,1,0,82.21
臺中縣,外埔鄉,,0,0,15239,338,15577,18370,2,1,1,1,1,0,84.80
臺中縣,大安鄉,,0,0,11402,211,11613,13939,2,1,1,1,1,0,83.31
臺中縣,烏日鄉,,0,0,29788,885,30673,37397,2,1,1,1,1,0,82.02
臺中縣,大肚鄉,,0,0,24944,824,25768,31246,2,1,1,1,1,0,82.47
臺中縣,龍井鄉,,0,0,26750,823,27573,33781,2,1,1,1,1,0,81.62
臺中縣,霧峰鄉,,0,0,33181,1010,34191,41674,2,1,1,1,1,0,82.04
臺中縣,太平市,,0,0,64794,2630,67424,86646,2,1,1,1,1,0,77.82
臺中縣,大里市,,0,0,68465,2672,71137,91602,2,1,1,1,1,0,77.66
臺中縣,和平鄉,,0,0,4060,93,4153,5677,2,1,1,1,1,0,73.15
彰化縣,彰化市,,0,0,109582,2845,112427,137088,2,1,1,1,1,0,82.01
彰化縣,鹿港鎮,,0,0,41100,844,41944,50708,2,1,1,1,1,0,82.72
彰化縣,和美鎮,,0,0,40987,947,41934,49895,2,1,1,1,1,0,84.04
彰化縣,線西鄉,,0,0,8575,166,8741,10269,2,1,1,1,1,0,85.12
彰化縣,伸港鄉,,0,0,15829,284,16113,19578,2,1,1,1,1,0,82.30
彰化縣,福興鄉,,0,0,23499,518,24017,29331,2,1,1,1,1,0,81.88
彰化縣,秀水鄉,,0,0,18336,409,18745,22129,2,1,1,1,1,0,84.71
彰化縣,花壇鄉,,0,0,22543,456,22999,27671,2,1,1,1,1,0,83.12
彰化縣,芬園鄉,,0,0,14405,309,14714,17804,2,1,1,1,1,0,82.64
彰化縣,員林鎮,,0,0,60409,1490,61899,76488,2,1,1,1,1,0,80.93
彰化縣,溪湖鎮,,0,0,27304,485,27789,33310,2,1,1,1,1,0,83.43
彰化縣,田中鎮,,0,0,23843,723,24566,31177,2,1,1,1,1,0,78.80
彰化縣,大村鄉,,0,0,18042,353,18395,22041,2,1,1,1,1,0,83.46
彰化縣,埔鹽鄉,,0,0,19224,371,19595,23278,2,1,1,1,1,0,84.18
彰化縣,埔心鄉,,0,0,17955,348,18303,22145,2,1,1,1,1,0,82.65
彰化縣,永靖鄉,,0,0,20531,462,20993,25744,2,1,1,1,1,0,81.55
彰化縣,社頭鄉,,0,0,22588,552,23140,28181,2,1,1,1,1,0,82.11
彰化縣,二水鄉,,0,0,10854,200,11054,13637,2,1,1,1,1,0,81.06
彰化縣,北斗鎮,,0,0,16575,351,16926,20930,2,1,1,1,1,0,80.87
彰化縣,二林鎮,,0,0,29062,594,29656,37949,2,1,1,1,1,0,78.15
彰化縣,田尾鄉,,0,0,15057,341,15398,19082,2,1,1,1,1,0,80.69
彰化縣,埤頭鄉,,0,0,16882,415,17297,22191,2,1,1,1,1,0,77.95
彰化縣,芳苑鄉,,0,0,19553,425,19978,28482,2,1,1,1,1,0,70.14
彰化縣,大城鄉,,0,0,10697,241,10938,16090,2,1,1,1,1,0,67.98
彰化縣,竹塘鄉,,0,0,9342,162,9504,12715,2,1,1,1,1,0,74.75
彰化縣,溪州鄉,,0,0,17421,410,17831,23164,2,1,1,1,1,0,76.98
南投縣,南投市,,0,0,50897,1524,52421,65384,2,1,1,1,1,0,80.17
南投縣,埔里鎮,,0,0,42679,902,43581,57447,2,1,1,1,1,0,75.86
南投縣,草屯鎮,,0,0,47259,1426,48685,60633,2,1,1,1,1,0,80.29
南投縣,竹山鎮,,0,0,31677,560,32237,42194,2,1,1,1,1,0,76.40
南投縣,集集鎮,,0,0,6780,115,6895,9047,2,1,1,1,1,0,76.21
南投縣,名間鄉,,0,0,22828,454,23282,29125,2,1,1,1,1,0,79.94
南投縣,鹿谷鄉,,0,0,11624,230,11854,15476,2,1,1,1,1,0,76.60
南投縣,中寮鄉,,0,0,10765,215,10980,14123,2,1,1,1,1,0,77.75
南投縣,魚池鄉,,0,0,9097,158,9255,13088,2,1,1,1,1,0,70.71
南投縣,國姓鄉,,0,0,12945,294,13239,18262,2,1,1,1,1,0,72.49
南投縣,水里鄉,,0,0,12471,267,12738,17234,2,1,1,1,1,0,73.91
南投縣,信義鄉,,0,0,4315,80,4395,6205,2,1,1,1,1,0,70.83
南投縣,仁愛鄉,,0,0,1803,53,1856,2699,2,1,1,1,1,0,68.77
雲林縣,斗六市,,0,0,46739,1293,48032,61141,2,1,1,1,1,0,78.56
雲林縣,斗南鎮,,0,0,24401,438,24839,31505,2,1,1,1,1,0,78.84
雲林縣,虎尾鎮,,0,0,32197,684,32881,44269,2,1,1,1,1,0,74.28
雲林縣,西螺鎮,,0,0,24886,471,25357,34205,2,1,1,1,1,0,74.13
雲林縣,土庫鎮,,0,0,15485,257,15742,22378,2,1,1,1,1,0,70.35
雲林縣,北港鎮,,0,0,23063,583,23646,33273,2,1,1,1,1,0,71.07
雲林縣,古坑鄉,,0,0,19102,371,19473,25865,2,1,1,1,1,0,75.29
雲林縣,大埤鄉,,0,0,12150,197,12347,16826,2,1,1,1,1,0,73.38
雲林縣,莿桐鄉,,0,0,15696,351,16047,21163,2,1,1,1,1,0,75.83
雲林縣,林內鄉,,0,0,10774,279,11053,14381,2,1,1,1,1,0,76.86
雲林縣,二崙鄉,,0,0,16466,226,16692,23728,2,1,1,1,1,0,70.35
雲林縣,崙背鄉,,0,0,13854,233,14087,20585,2,1,1,1,1,0,68.43
雲林縣,麥寮鄉,,0,0,13164,219,13383,21184,2,1,1,1,1,0,63.18
雲林縣,東勢鄉,,0,0,8784,159,8943,14045,2,1,1,1,1,0,63.67
雲林縣,褒忠鄉,,0,0,7433,149,7582,10781,2,1,1,1,1,0,70.33
雲林縣,臺西鄉,,0,0,13302,223,13525,21454,2,1,1,1,1,0,63.04
雲林縣,元長鄉,,0,0,15188,253,15441,24121,2,1,1,1,1,0,64.01
雲林縣,四湖鄉,,0,0,13310,244,13554,23752,2,1,1,1,1,0,57.06
雲林縣,口湖鄉,,0,0,15179,253,15432,24155,2,1,1,1,1,0,63.89
雲林縣,水林鄉,,0,0,16111,295,16406,25161,2,1,1,1,1,0,65.20
嘉義縣,太保市,,0,0,15208,418,15626,19625,2,1,1,1,1,0,79.62
嘉義縣,朴子市,,0,0,22602,508,23110,30488,2,1,1,1,1,0,75.80
嘉義縣,布袋鎮,,0,0,18051,429,18480,25036,2,1,1,1,1,0,73.81
嘉義縣,大林鎮,,0,0,19411,467,19878,25926,2,1,1,1,1,0,76.67
嘉義縣,民雄鄉,,0,0,33024,837,33861,42367,2,1,1,1,1,0,79.92
嘉義縣,溪口鄉,,0,0,9972,233,10205,13628,2,1,1,1,1,0,74.88
嘉義縣,新港鄉,,0,0,18704,461,19165,25448,2,1,1,1,1,0,75.31
嘉義縣,六腳鄉,,0,0,16480,396,16876,23267,2,1,1,1,1,0,72.53
嘉義縣,東石鄉,,0,0,16515,388,16903,23420,2,1,1,1,1,0,72.17
嘉義縣,義竹鄉,,0,0,14156,264,14420,18446,2,1,1,1,1,0,78.17
嘉義縣,鹿草鄉,,0,0,10828,304,11132,14450,2,1,1,1,1,0,77.04
嘉義縣,水上鄉,,0,0,28371,731,29102,35964,2,1,1,1,1,0,80.92
嘉義縣,中埔鄉,,0,0,23421,541,23962,31336,2,1,1,1,1,0,76.47
嘉義縣,竹崎鄉,,0,0,22259,427,22686,28908,2,1,1,1,1,0,78.48
嘉義縣,梅山鄉,,0,0,13159,281,13440,17248,2,1,1,1,1,0,77.92
嘉義縣,番路鄉,,0,0,6482,112,6594,8373,2,1,1,1,1,0,78.75
嘉義縣,大埔鄉,,0,0,1966,33,1999,2902,2,1,1,1,1,0,68.88
嘉義縣,阿里山鄉,,0,0,1216,25,1241,1954,2,1,1,1,1,0,63.51
臺南縣,新營市,,0,0,35755,727,36482,48844,2,1,1,1,1,0,74.69
臺南縣,鹽水鎮,,0,0,14675,323,14998,20727,2,1,1,1,1,0,72.36
臺南縣,白河鎮,,0,0,19619,388,20007,27374,2,1,1,1,1,0,73.09
臺南縣,柳營鄉,,0,0,12813,223,13036,17426,2,1,1,1,1,0,74.81
臺南縣,後壁鄉,,0,0,15987,307,16294,21665,2,1,1,1,1,0,75.21
臺南縣,東山鄉,,0,0,12910,197,13107,19755,2,1,1,1,1,0,66.35
臺南縣,麻豆鎮,,0,0,25037,420,25457,32530,2,1,1,1,1,0,78.26
臺南縣,下營鄉,,0,0,14771,217,14988,20123,2,1,1,1,1,0,74.48
臺南縣,六甲鄉,,0,0,12628,245,12873,17390,2,1,1,1,1,0,74.03
臺南縣,官田鄉,,0,0,13357,240,13597,17297,2,1,1,1,1,0,78.61
臺南縣,大內鄉,,0,0,7103,115,7218,9686,2,1,1,1,1,0,74.52
臺南縣,佳里鎮,,0,0,27496,422,27918,36249,2,1,1,1,1,0,77.02
臺南縣,學甲鎮,,0,0,15752,209,15961,21297,2,1,1,1,1,0,74.94
臺南縣,西港鄉,,0,0,12851,196,13047,16659,2,1,1,1,1,0,78.32
臺南縣,七股鄉,,0,0,14526,228,14754,19788,2,1,1,1,1,0,74.56
臺南縣,將軍鄉,,0,0,12647,158,12805,17649,2,1,1,1,1,0,72.55
臺南縣,北門鄉,,0,0,7175,95,7270,10507,2,1,1,1,1,0,69.19
臺南縣,新化鎮,,0,0,21499,463,21962,28428,2,1,1,1,1,0,77.25
臺南縣,善化鎮,,0,0,21507,415,21922,28204,2,1,1,1,1,0,77.73
臺南縣,新市鄉,,0,0,14878,264,15142,19283,2,1,1,1,1,0,78.53
臺南縣,安定鄉,,0,0,14910,305,15215,19575,2,1,1,1,1,0,77.73
臺南縣,山上鄉,,0,0,4387,68,4455,5819,2,1,1,1,1,0,76.56
臺南縣,玉井鄉,,0,0,9151,129,9280,12653,2,1,1,1,1,0,73.34
臺南縣,楠西鄉,,0,0,6433,79,6512,9198,2,1,1,1,1,0,70.80
臺南縣,南化鄉,,0,0,5254,80,5334,7331,2,1,1,1,1,0,72.76
臺南縣,左鎮鄉,,0,0,3754,59,3813,5088,2,1,1,1,1,0,74.94
臺南縣,仁德鄉,,0,0,30402,799,31201,40514,2,1,1,1,1,0,77.01
臺南縣,歸仁鄉,,0,0,27816,573,28389,36262,2,1,1,1,1,0,78.29
臺南縣,關廟鄉,,0,0,19818,352,20170,26240,2,1,1,1,1,0,76.87
臺南縣,龍崎鄉,,0,0,2977,34,3011,3990,2,1,1,1,1,0,75.46
臺南縣,永康市,,0,0,76172,2096,78268,102797,2,1,1,1,1,0,76.14
高雄縣,鳳山市,,0,0,145566,3012,148578,192358,2,1,1,1,1,0,77.24
高雄縣,林園鄉,,0,0,32485,648,33133,42671,2,1,1,1,1,0,77.65
高雄縣,大寮鄉,,0,0,54458,957,55415,70286,2,1,1,1,1,0,78.84
高雄縣,大樹鄉,,0,0,24860,369,25229,31181,2,1,1,1,1,0,80.91
高雄縣,大社鄉,,0,0,15026,312,15338,19504,2,1,1,1,1,0,78.64
高雄縣,仁武鄉,,0,0,20319,474,20793,26473,2,1,1,1,1,0,78.54
高雄縣,鳥松鄉,,0,0,16493,323,16816,21201,2,1,1,1,1,0,79.32
高雄縣,岡山鎮,,0,0,46536,786,47322,58110,2,1,1,1,1,0,81.44
高雄縣,橋頭鄉,,0,0,20677,353,21030,24997,2,1,1,1,1,0,84.13
高雄縣,燕巢鄉,,0,0,18003,331,18334,22642,2,1,1,1,1,0,80.97
高雄縣,田寮鄉,,0,0,5865,89,5954,7820,2,1,1,1,1,0,76.14
高雄縣,阿蓮鄉,,0,0,15565,265,15830,19589,2,1,1,1,1,0,80.81
高雄縣,路竹鄉,,0,0,27514,507,28021,34019,2,1,1,1,1,0,82.37
高雄縣,湖內鄉,,0,0,14049,279,14328,17553,2,1,1,1,1,0,81.63
高雄縣,茄萣鄉,,0,0,17497,340,17837,22012,2,1,1,1,1,0,81.03
高雄縣,永安鄉,,0,0,6785,78,6863,8446,2,1,1,1,1,0,81.26
高雄縣,彌陀鄉,,0,0,11869,201,12070,14319,2,1,1,1,1,0,84.29
高雄縣,梓官鄉,,0,0,20177,387,20564,25107,2,1,1,1,1,0,81.91
高雄縣,旗山鎮,,0,0,25580,394,25974,32933,2,1,1,1,1,0,78.87
高雄縣,美濃鎮,,0,0,27393,360,27753,35728,2,1,1,1,1,0,77.68
高雄縣,六龜鄉,,0,0,9089,180,9269,13209,2,1,1,1,1,0,70.17
高雄縣,甲仙鄉,,0,0,4759,57,4816,6389,2,1,1,1,1,0,75.38
高雄縣,杉林鄉,,0,0,7260,110,7370,10358,2,1,1,1,1,0,71.15
高雄縣,內門鄉,,0,0,10666,121,10787,13363,2,1,1,1,1,0,80.72
高雄縣,茂林鄉,,0,0,65,0,65,92,2,1,1,1,1,0,70.65
高雄縣,桃源鄉,,0,0,226,3,229,369,2,1,1,1,1,0,62.06
高雄縣,三民鄉,,0,0,150,7,157,221,2,1,1,1,1,0,71.04
屏東縣,屏東市,,0,0,104709,1256,105965,139504,2,1,1,1,1,0,75.96
屏東縣,潮州鎮,,0,0,26333,368,26701,36576,2,1,1,1,1,0,73.00
屏東縣,東港鎮,,0,0,21888,377,22265,30635,2,1,1,1,1,0,72.68
屏東縣,恆春鎮,,0,0,13471,237,13708,21854,2,1,1,1,1,0,62.73
屏東縣,萬丹鄉,,0,0,27235,413,27648,34255,2,1,1,1,1,0,80.71
屏東縣,長治鄉,,0,0,14932,222,15154,19720,2,1,1,1,1,0,76.85
屏東縣,麟洛鄉,,0,0,6432,77,6509,7965,2,1,1,1,1,0,81.72
屏東縣,九如鄉,,0,0,11619,174,11793,14761,2,1,1,1,1,0,79.89
屏東縣,里港鄉,,0,0,14159,207,14366,18400,2,1,1,1,1,0,78.08
屏東縣,鹽埔鄉,,0,0,15206,296,15502,19084,2,1,1,1,1,0,81.23
屏東縣,高樹鄉,,0,0,15769,347,16116,22542,2,1,1,1,1,0,71.49
屏東縣,萬巒鄉,,0,0,12670,186,12856,17338,2,1,1,1,1,0,74.15
屏東縣,內埔鄉,,0,0,31520,482,32002,42865,2,1,1,1,1,0,74.66
屏東縣,竹田鄉,,0,0,10776,159,10935,14096,2,1,1,1,1,0,77.58
屏東縣,新埤鄉,,0,0,6273,98,6371,9057,2,1,1,1,1,0,70.34
屏東縣,枋寮鄉,,0,0,14885,223,15108,21181,2,1,1,1,1,0,71.33
屏東縣,新園鄉,,0,0,20010,311,20321,27254,2,1,1,1,1,0,74.56
屏東縣,崁頂鄉,,0,0,7197,131,7328,9509,2,1,1,1,1,0,77.06
屏東縣,林邊鄉,,0,0,12071,157,12228,16136,2,1,1,1,1,0,75.78
屏東縣,南州鄉,,0,0,7054,102,7156,9665,2,1,1,1,1,0,74.04
屏東縣,佳冬鄉,,0,0,12903,264,13167,17401,2,1,1,1,1,0,75.67
屏東縣,琉球鄉,,0,0,4551,81,4632,8609,2,1,1,1,1,0,53.80
屏東縣,車城鄉,,0,0,5285,106,5391,8586,2,1,1,1,1,0,62.79
屏東縣,滿州鄉,,0,0,3200,54,3254,5507,2,1,1,1,1,0,59.09
屏東縣,枋山鄉,,0,0,3210,58,3268,5044,2,1,1,1,1,0,64.79
屏東縣,三地門鄉,,0,0,228,10,238,356,2,1,1,1,1,0,66.85
屏東縣,霧臺鄉,,0,0,28,0,28,54,2,1,1,1,1,0,51.85
屏東縣,瑪家鄉,,0,0,226,11,237,374,2,1,1,1,1,0,63.37
屏東縣,泰武鄉,,0,0,109,11,120,170,2,1,1,1,1,0,70.59
屏東縣,來義鄉,,0,0,269,22,291,415,2,1,1,1,1,0,70.12
屏東縣,春日鄉,,0,0,267,9,276,408,2,1,1,1,1,0,67.65
屏東縣,獅子鄉,,0,0,165,7,172,286,2,1,1,1,1,0,60.14
屏東縣,牡丹鄉,,0,0,254,12,266,436,2,1,1,1,1,0,61.01
臺東縣,臺東市,,0,0,42114,1006,43120,62700,2,1,1,1,1,0,68.77
臺東縣,成功鎮,,0,0,4029,81,4110,6442,2,1,1,1,1,0,63.80
臺東縣,關山鎮,,0,0,3896,101,3997,6461,2,1,1,1,1,0,61.86
臺東縣,卑南鄉,,0,0,7597,225,7822,11858,2,1,1,1,1,0,65.96
臺東縣,鹿野鄉,,0,0,3442,92,3534,5962,2,1,1,1,1,0,59.28
臺東縣,池上鄉,,0,0,4093,102,4195,6891,2,1,1,1,1,0,60.88
臺東縣,東河鄉,,0,0,2529,49,2578,5661,2,1,1,1,1,0,45.54
臺東縣,長濱鄉,,0,0,1937,38,1975,3839,2,1,1,1,1,0,51.45
臺東縣,太麻里鄉,,0,0,3975,69,4044,6678,2,1,1,1,1,0,60.56
臺東縣,大武鄉,,0,0,1500,37,1537,2593,2,1,1,1,1,0,59.27
臺東縣,綠島鄉,,0,0,1066,19,1085,1814,2,1,1,1,1,0,59.81
臺東縣,海端鄉,,0,0,201,11,212,351,2,1,1,1,1,0,60.40
臺東縣,延平鄉,,0,0,177,2,179,300,2,1,1,1,1,0,59.67
臺東縣,金峰鄉,,0,0,133,3,136,236,2,1,1,1,1,0,57.63
臺東縣,達仁鄉,,0,0,197,2,199,357,2,1,1,1,1,0,55.74
臺東縣,蘭嶼鄉,,0,0,68,4,72,137,2,1,1,1,1,0,52.55
花蓮縣,花蓮市,,0,0,43460,2202,45662,67313,2,1,1,1,1,0,67.84
花蓮縣,鳳林鎮,,0,0,6420,145,6565,10090,2,1,1,1,1,0,65.06
花蓮縣,玉里鎮,,0,0,10347,548,10895,19068,2,1,1,1,1,0,57.14
花蓮縣,新城鄉,,0,0,7552,295,7847,11619,2,1,1,1,1,0,67.54
花蓮縣,吉安鄉,,0,0,24876,973,25849,39175,2,1,1,1,1,0,65.98
花蓮縣,壽豐鄉,,0,0,7004,191,7195,11653,2,1,1,1,1,0,61.74
花蓮縣,光復鄉,,0,0,4174,146,4320,7259,2,1,1,1,1,0,59.51
花蓮縣,豐濱鄉,,0,0,766,18,784,1396,2,1,1,1,1,0,56.16
花蓮縣,瑞穗鄉,,0,0,4482,121,4603,7784,2,1,1,1,1,0,59.13
花蓮縣,富里鄉,,0,0,5509,175,5684,10418,2,1,1,1,1,0,54.56
花蓮縣,秀林鄉,,0,0,1214,48,1262,2047,2,1,1,1,1,0,61.65
花蓮縣,萬榮鄉,,0,0,184,6,190,359,2,1,1,1,1,0,52.92
花蓮縣,卓溪鄉,,0,0,214,10,224,416,2,1,1,1,1,0,53.85
澎湖縣,馬公市,,0,0,22781,1100,23881,35324,2,1,1,1,1,0,67.61
澎湖縣,湖西鄉,,0,0,6178,232,6410,10152,2,1,1,1,1,0,63.14
澎湖縣,白沙鄉,,0,0,3933,60,3993,6897,2,1,1,1,1,0,57.89
澎湖縣,西嶼鄉,,0,0,3623,89,3712,6620,2,1,1,1,1,0,56.07
澎湖縣,望安鄉,,0,0,1159,39,1198,2859,2,1,1,1,1,0,41.90
澎湖縣,七美鄉,,0,0,1086,31,1117,2318,2,1,1,1,1,0,48.19
基隆市,中正區,,0,0,28368,808,29176,39888,2,1,1,1,1,0,73.14
基隆市,七堵區,,0,0,26095,607,26702,35529,2,1,1,1,1,0,75.16
基隆市,暖暖區,,0,0,14279,361,14640,19730,2,1,1,1,1,0,74.20
基隆市,仁愛區,,0,0,29918,784,30702,41083,2,1,1,1,1,0,74.73
基隆市,中山區,,0,0,25318,604,25922,34305,2,1,1,1,1,0,75.56
基隆市,安樂區,,0,0,31234,742,31976,42576,2,1,1,1,1,0,75.10
基隆市,信義區,,0,0,22447,585,23032,30456,2,1,1,1,1,0,75.62
新竹市,東區,,0,0,73204,2818,76022,104723,2,1,1,1,1,0,72.59
新竹市,北區,,0,0,56549,1811,58360,80881,2,1,1,1,1,0,72.16
新竹市,香山區,,0,0,23654,663,24317,34466,2,1,1,1,1,0,70.55
臺中市,中區,,0,0,12948,235,13183,17881,2,1,1,1,1,0,73.73
臺中市,東區,,0,0,34928,635,35563,46778,2,1,1,1,1,0,76.03
臺中市,南區,,0,0,35648,647,36295,47978,2,1,1,1,1,0,75.65
臺中市,西區,,0,0,51561,959,52520,70420,2,1,1,1,1,0,74.58
臺中市,北區,,0,0,67917,1248,69165,94120,2,1,1,1,1,0,73.49
臺中市,西屯區,,0,0,61391,1082,62473,81597,2,1,1,1,1,0,76.56
臺中市,南屯區,,0,0,37288,621,37909,50776,2,1,1,1,1,0,74.66
臺中市,北屯區,,0,0,85758,1652,87410,113527,2,1,1,1,1,0,76.99
嘉義市,東區,,0,0,60927,1867,62794,85000,2,1,1,1,1,0,73.88
嘉義市,西區,,0,0,60743,1751,62494,84913,2,1,1,1,1,0,73.60
臺南市,東區,,0,0,78985,2271,81256,105088,2,1,1,1,1,0,77.32
臺南市,南區,,0,0,70359,1695,72054,93377,2,1,1,1,1,0,77.16
臺南市,西區,,0,0,26492,615,27107,33576,2,1,1,1,1,0,80.73
臺南市,北區,,0,0,62263,1506,63769,81799,2,1,1,1,1,0,77.96
臺南市,中區,,0,0,26241,726,26967,34554,2,1,1,1,1,0,78.04
臺南市,安南區,,0,0,68820,1511,70331,89288,2,1,1,1,1,0,78.77
臺南市,安平區,,0,0,14059,341,14400,18453,2,1,1,1,1,0,78.04
