CountyCityName,TownshipName,VillageName,PollStationNo,DistrictName,BallotsAccepted,BallotsRejected,BallotsCast,Voters,CandidateCounts,ElectedCounts,CandidateMaleCounts,CandidateFemaleCounts,ElectedMaleCounts,ElectedFemaleCounts,BallotsRate
全國,,,0,0,9899442,150004,10049446,14712126,382,168,319,63,134,34,68.31
臺北市,,,0,2,1478366,27578,1505944,1861849,48,20,35,13,13,7,80.88
臺北市,,,0,2,756142,13705,769847,939731,18,10,13,5,7,3,81.92
臺北市,,,0,2,722224,13873,736097,922118,30,10,22,8,6,4,79.83
高雄市,,,0,2,789435,15119,804554,999907,25,11,22,3,9,2,80.46
高雄市,,,0,2,439114,8169,447283,555547,11,6,10,1,5,1,80.51
高雄市,,,0,2,350321,6950,357271,444360,14,5,12,2,4,1,80.40
臺北縣,,,0,3,1391092,19982,1411074,2305255,67,27,60,7,24,3,61.21
臺北縣,,,0,3,413786,6655,420441,673753,23,8,22,1,8,0,62.40
臺北縣,,,0,3,507620,7429,515049,828853,25,10,21,4,8,2,62.14
臺北縣,,,0,3,469686,5898,475584,802649,19,9,17,2,8,1,59.25
宜蘭縣,,,0,0,184540,1812,186352,313548,6,4,6,0,4,0,59.43
桃園縣,,,0,0,670981,9769,680750,1058166,26,12,21,5,9,3,64.33
新竹縣,,,0,0,166751,2344,169095,275783,7,3,6,1,3,0,61.31
苗栗縣,,,0,0,265628,3655,269283,378177,11,4,10,1,4,0,71.21
臺中縣,,,0,0,664314,12708,677022,949844,22,11,18,4,10,1,71.28
彰化縣,,,0,0,662464,10717,673181,873339,20,10,18,2,8,2,77.08
南投縣,,,0,0,241112,2513,243625,362368,11,4,10,1,4,0,67.23
雲林縣,,,0,0,356118,5341,361459,529788,12,6,8,4,4,2,68.23
嘉義縣,,,0,0,272739,4363,277102,401807,10,4,9,1,3,1,68.96
臺南縣,,,0,0,497969,5649,503618,769171,16,9,13,3,6,3,65.48
高雄縣,,,0,0,585269,7621,592890,841020,15,9,12,3,8,1,70.50
屏東縣,,,0,0,408652,4170,412822,602121,16,7,13,3,6,1,68.56
臺東縣,,,0,0,75180,775,75955,122617,4,1,4,0,1,0,61.94
花蓮縣,,,0,0,106566,1428,107994,192838,6,2,6,0,2,0,56.00
澎湖縣,,,0,0,35590,491,36081,64104,3,1,3,0,1,0,56.29
基隆市,,,0,0,138173,1621,139794,262783,5,3,4,1,2,1,53.20
新竹市,,,0,0,120844,2998,123842,238183,7,3,5,2,2,1,51.99
臺中市,,,0,0,365418,4213,369631,601470,20,7,16,4,4,3,61.45
嘉義市,,,0,0,104286,1156,105442,178417,6,2,4,2,1,1,59.10
臺南市,,,0,0,295188,3328,298516,490521,13,6,10,3,4,2,60.86
金門縣,,,0,0,20324,341,20665,34316,5,1,5,0,1,0,60.22
連江縣,,,0,0,2443,312,2755,4734,1,1,1,0,1,0,58.20
宜蘭縣,,,0,0,184540,1812,186352,313548,6,4,6,0,4,0,59.43
桃園縣,,,0,0,670981,9769,680750,1058166,26,12,21,5,9,3,64.33
新竹縣,,,0,0,166751,2344,169095,275783,7,3,6,1,3,0,61.31
苗栗縣,,,0,0,265628,3655,269283,378177,11,4,10,1,4,0,71.21
臺中縣,,,0,0,664314,12708,677022,949844,22,11,18,4,10,1,71.28
彰化縣,,,0,0,662464,10717,673181,873339,20,10,18,2,8,2,77.08
南投縣,,,0,0,241112,2513,243625,362368,11,4,10,1,4,0,67.23
雲林縣,,,0,0,356118,5341,361459,529788,12,6,8,4,4,2,68.23
嘉義縣,,,0,0,272739,4363,277102,401807,10,4,9,1,3,1,68.96
臺南縣,,,0,0,497969,5649,503618,769171,16,9,13,3,6,3,65.48
高雄縣,,,0,0,585269,7621,592890,841020,15,9,12,3,8,1,70.50
屏東縣,,,0,0,408652,4170,412822,602121,16,7,13,3,6,1,68.56
臺東縣,,,0,0,75180,775,75955,122617,4,1,4,0,1,0,61.94
花蓮縣,,,0,0,106566,1428,107994,192838,6,2,6,0,2,0,56.00
澎湖縣,,,0,0,35590,491,36081,64104,3,1,3,0,1,0,56.29
基隆市,,,0,0,138173,1621,139794,262783,5,3,4,1,2,1,53.20
新竹市,,,0,0,120844,2998,123842,238183,7,3,5,2,2,1,51.99
臺中市,,,0,0,365418,4213,369631,601470,20,7,16,4,4,3,61.45
嘉義市,,,0,0,104286,1156,105442,178417,6,2,4,2,1,1,59.10
臺南市,,,0,0,295188,3328,298516,490521,13,6,10,3,4,2,60.86
金門縣,,,0,0,20324,341,20665,34316,5,1,5,0,1,0,60.22
連江縣,,,0,0,2443,312,2755,4734,1,1,1,0,1,0,58.20
臺北市,北投區,,0,1,139765,2600,142365,171136,0,0,0,0,0,0,83.19
臺北市,士林區,,0,1,168391,3106,171497,208473,0,0,0,0,0,0,82.26
臺北市,內湖區,,0,1,131366,2230,133596,160832,0,0,0,0,0,0,83.07
臺北市,南港區,,0,1,62892,1240,64132,76841,0,0,0,0,0,0,83.46
臺北市,松山區,,0,1,115017,1800,116817,147426,0,0,0,0,0,0,79.24
臺北市,信義區,,0,1,138711,2729,141440,175023,0,0,0,0,0,0,80.81
臺北市,中山區,,0,2,120733,2565,123298,156459,0,0,0,0,0,0,78.81
臺北市,大同區,,0,2,76433,1740,78173,96237,0,0,0,0,0,0,81.23
臺北市,中正區,,0,2,90983,1703,92686,117635,0,0,0,0,0,0,78.79
臺北市,萬華區,,0,2,121683,2530,124213,152220,0,0,0,0,0,0,81.60
臺北市,大安區,,0,2,175897,2854,178751,230280,0,0,0,0,0,0,77.62
臺北市,文山區,,0,2,136495,2481,138976,169287,0,0,0,0,0,0,82.09
高雄市,鹽埕區,,0,1,18731,326,19057,23859,0,0,0,0,0,0,79.87
高雄市,鼓山區,,0,1,61931,1139,63070,78425,0,0,0,0,0,0,80.42
高雄市,左營區,,0,1,78067,1419,79486,99608,0,0,0,0,0,0,79.80
高雄市,楠梓區,,0,1,78646,1455,80101,97244,0,0,0,0,0,0,82.37
高雄市,三民區,,0,1,183864,3353,187217,233736,0,0,0,0,0,0,80.10
高雄市,旗津區,,0,1,17875,477,18352,22675,0,0,0,0,0,0,80.93
高雄市,新興區,,0,2,34907,542,35449,45343,0,0,0,0,0,0,78.18
高雄市,前金區,,0,2,19718,341,20059,25668,0,0,0,0,0,0,78.15
高雄市,苓雅區,,0,2,111151,2075,113226,141953,0,0,0,0,0,0,79.76
高雄市,前鎮區,,0,2,109132,2485,111617,137921,0,0,0,0,0,0,80.93
高雄市,小港區,,0,2,75413,1507,76920,93475,0,0,0,0,0,0,82.29
臺北縣,板橋市,,0,1,211574,3269,214843,346189,0,0,0,0,0,0,62.06
臺北縣,土城市,,0,1,82588,1486,84074,137290,0,0,0,0,0,0,61.24
臺北縣,樹林鎮,,0,1,55831,925,56756,91079,0,0,0,0,0,0,62.32
臺北縣,鶯歌鎮,,0,1,31572,472,32044,48289,0,0,0,0,0,0,66.36
臺北縣,三峽鎮,,0,1,32221,503,32724,50906,0,0,0,0,0,0,64.28
臺北縣,三重市,,0,2,159766,2449,162215,254699,0,0,0,0,0,0,63.69
臺北縣,蘆洲市,,0,2,61315,945,62260,96347,0,0,0,0,0,0,64.62
臺北縣,新莊市,,0,2,129188,1711,130899,223767,0,0,0,0,0,0,58.50
臺北縣,五股鄉,,0,2,26084,369,26453,42110,0,0,0,0,0,0,62.82
臺北縣,泰山鄉,,0,2,23692,310,24002,39122,0,0,0,0,0,0,61.35
臺北縣,林口鄉,,0,2,19321,277,19598,31152,0,0,0,0,0,0,62.91
臺北縣,淡水鎮,,0,2,45174,719,45893,73579,0,0,0,0,0,0,62.37
臺北縣,八里鄉,,0,2,11497,225,11722,17509,0,0,0,0,0,0,66.95
臺北縣,三芝鄉,,0,2,9307,126,9433,15077,0,0,0,0,0,0,62.57
臺北縣,石門鄉,,0,2,4998,80,5078,7494,0,0,0,0,0,0,67.76
臺北縣,金山鄉,,0,2,8945,94,9039,14378,0,0,0,0,0,0,62.87
臺北縣,萬里鄉,,0,2,8333,124,8457,13619,0,0,0,0,0,0,62.10
臺北縣,中和市,,0,3,158565,2250,160815,270385,0,0,0,0,0,0,59.48
臺北縣,永和市,,0,3,93771,1108,94879,159939,0,0,0,0,0,0,59.32
臺北縣,新店市,,0,3,109687,1248,110935,185986,0,0,0,0,0,0,59.65
臺北縣,深坑鄉,,0,3,7734,114,7848,13549,0,0,0,0,0,0,57.92
臺北縣,石碇鄉,,0,3,3867,50,3917,5931,0,0,0,0,0,0,66.04
臺北縣,坪林鄉,,0,3,2910,39,2949,4885,0,0,0,0,0,0,60.37
臺北縣,烏來鄉,,0,3,971,8,979,1610,0,0,0,0,0,0,60.81
臺北縣,汐止鎮,,0,3,56467,597,57064,101333,0,0,0,0,0,0,56.31
臺北縣,瑞芳鎮,,0,3,20644,325,20969,34942,0,0,0,0,0,0,60.01
臺北縣,平溪鄉,,0,3,3237,34,3271,5123,0,0,0,0,0,0,63.85
臺北縣,雙溪鄉,,0,3,5556,49,5605,8387,0,0,0,0,0,0,66.83
臺北縣,貢寮鄉,,0,3,6277,76,6353,10579,0,0,0,0,0,0,60.05
宜蘭縣,宜蘭市,,0,1,37252,383,37635,61433,0,0,0,0,0,0,61.26
宜蘭縣,羅東鎮,,0,1,26169,223,26392,45214,0,0,0,0,0,0,58.37
宜蘭縣,蘇澳鎮,,0,1,18792,190,18982,33514,0,0,0,0,0,0,56.64
宜蘭縣,頭城鎮,,0,1,13914,145,14059,23215,0,0,0,0,0,0,60.56
宜蘭縣,礁溪鄉,,0,1,16347,175,16522,26540,0,0,0,0,0,0,62.25
宜蘭縣,壯圍鄉,,0,1,11138,92,11230,18326,0,0,0,0,0,0,61.28
宜蘭縣,員山鄉,,0,1,13374,179,13553,23792,0,0,0,0,0,0,56.96
宜蘭縣,冬山鄉,,0,1,20868,178,21046,36128,0,0,0,0,0,0,58.25
宜蘭縣,五結鄉,,0,1,16333,133,16466,27150,0,0,0,0,0,0,60.65
宜蘭縣,三星鄉,,0,1,9499,108,9607,16385,0,0,0,0,0,0,58.63
宜蘭縣,大同鄉,,0,1,490,2,492,1038,0,0,0,0,0,0,47.40
宜蘭縣,南澳鄉,,0,1,364,4,368,813,0,0,0,0,0,0,45.26
桃園縣,桃園市,,0,1,115981,1521,117502,194104,0,0,0,0,0,0,60.54
桃園縣,龜山鄉,,0,1,40193,646,40839,71934,0,0,0,0,0,0,56.77
桃園縣,八德市,,0,1,65963,1144,67107,101819,0,0,0,0,0,0,65.91
桃園縣,蘆竹鄉,,0,1,34305,547,34852,53442,0,0,0,0,0,0,65.21
桃園縣,大園鄉,,0,1,33960,458,34418,47535,0,0,0,0,0,0,72.41
桃園縣,大溪鎮,,0,1,35921,547,36468,53171,0,0,0,0,0,0,68.59
桃園縣,復興鄉,,0,1,1680,23,1703,2858,0,0,0,0,0,0,59.59
桃園縣,中壢市,,0,1,129964,1778,131742,205982,0,0,0,0,0,0,63.96
桃園縣,平鎮市,,0,1,73884,1121,75005,115812,0,0,0,0,0,0,64.76
桃園縣,楊梅鎮,,0,1,50144,716,50860,78938,0,0,0,0,0,0,64.43
桃園縣,龍潭鄉,,0,1,40616,622,41238,63871,0,0,0,0,0,0,64.56
桃園縣,新屋鄉,,0,1,24521,294,24815,33814,0,0,0,0,0,0,73.39
桃園縣,觀音鄉,,0,1,23849,352,24201,34886,0,0,0,0,0,0,69.37
新竹縣,竹北市,,0,1,29593,407,30000,54682,0,0,0,0,0,0,54.86
新竹縣,竹東鎮,,0,1,33787,459,34246,55638,0,0,0,0,0,0,61.55
新竹縣,新埔鎮,,0,1,16069,226,16295,25257,0,0,0,0,0,0,64.52
新竹縣,關西鎮,,0,1,14705,197,14902,22664,0,0,0,0,0,0,65.75
新竹縣,湖口鄉,,0,1,25511,436,25947,41717,0,0,0,0,0,0,62.20
新竹縣,新豐鄉,,0,1,15970,260,16230,28280,0,0,0,0,0,0,57.39
新竹縣,芎林鄉,,0,1,9163,105,9268,13492,0,0,0,0,0,0,68.69
新竹縣,橫山鄉,,0,1,7389,86,7475,10966,0,0,0,0,0,0,68.17
新竹縣,北埔鄉,,0,1,4868,61,4929,7548,0,0,0,0,0,0,65.30
新竹縣,寶山鄉,,0,1,5598,56,5654,9184,0,0,0,0,0,0,61.56
新竹縣,峨眉鄉,,0,1,3325,30,3355,4921,0,0,0,0,0,0,68.18
新竹縣,尖石鄉,,0,1,588,20,608,1070,0,0,0,0,0,0,56.82
新竹縣,五峰鄉,,0,1,185,1,186,364,0,0,0,0,0,0,51.10
苗栗縣,苗栗市,,0,1,40230,716,40946,60986,0,0,0,0,0,0,67.14
苗栗縣,苑裡鎮,,0,1,22747,266,23013,33471,0,0,0,0,0,0,68.76
苗栗縣,通霄鎮,,0,1,20979,263,21242,29119,0,0,0,0,0,0,72.95
苗栗縣,竹南鎮,,0,1,31501,460,31961,44580,0,0,0,0,0,0,71.69
苗栗縣,頭份鎮,,0,1,37397,509,37906,56790,0,0,0,0,0,0,66.75
苗栗縣,後龍鎮,,0,1,22354,230,22584,30354,0,0,0,0,0,0,74.40
苗栗縣,卓蘭鎮,,0,1,10679,184,10863,13959,0,0,0,0,0,0,77.82
苗栗縣,大湖鄉,,0,1,9502,110,9612,12867,0,0,0,0,0,0,74.70
苗栗縣,公館鄉,,0,1,17081,221,17302,23489,0,0,0,0,0,0,73.66
苗栗縣,銅鑼鄉,,0,1,10711,163,10874,14658,0,0,0,0,0,0,74.18
苗栗縣,南庄鄉,,0,1,5279,77,5356,8066,0,0,0,0,0,0,66.40
苗栗縣,頭屋鄉,,0,1,6876,63,6939,9032,0,0,0,0,0,0,76.83
苗栗縣,三義鄉,,0,1,9213,130,9343,12198,0,0,0,0,0,0,76.59
苗栗縣,西湖鄉,,0,1,4750,57,4807,6720,0,0,0,0,0,0,71.53
苗栗縣,造橋鄉,,0,1,7775,98,7873,10056,0,0,0,0,0,0,78.29
苗栗縣,三灣鄉,,0,1,4265,54,4319,5915,0,0,0,0,0,0,73.02
苗栗縣,獅潭鄉,,0,1,3232,37,3269,4409,0,0,0,0,0,0,74.14
苗栗縣,泰安鄉,,0,1,1057,17,1074,1508,0,0,0,0,0,0,71.22
臺中縣,豐原市,,0,1,70517,1292,71809,104519,0,0,0,0,0,0,68.70
臺中縣,東勢鎮,,0,1,30320,596,30916,41491,0,0,0,0,0,0,74.51
臺中縣,大甲鎮,,0,1,36465,700,37165,49861,0,0,0,0,0,0,74.54
臺中縣,清水鎮,,0,1,40941,712,41653,56213,0,0,0,0,0,0,74.10
臺中縣,沙鹿鎮,,0,1,34064,578,34642,46093,0,0,0,0,0,0,75.16
臺中縣,梧棲鎮,,0,1,22729,409,23138,31275,0,0,0,0,0,0,73.98
臺中縣,后里鄉,,0,1,28279,609,28888,37126,0,0,0,0,0,0,77.81
臺中縣,神岡鄉,,0,1,28633,568,29201,39854,0,0,0,0,0,0,73.27
臺中縣,潭子鄉,,0,1,35590,621,36211,54524,0,0,0,0,0,0,66.41
臺中縣,大雅鄉,,0,1,33382,751,34133,47626,0,0,0,0,0,0,71.67
臺中縣,新社鄉,,0,1,14888,265,15153,19387,0,0,0,0,0,0,78.16
臺中縣,石岡鄉,,0,1,8406,160,8566,11165,0,0,0,0,0,0,76.72
臺中縣,外埔鄉,,0,1,15918,286,16204,20240,0,0,0,0,0,0,80.06
臺中縣,大安鄉,,0,1,11432,167,11599,14758,0,0,0,0,0,0,78.59
臺中縣,烏日鄉,,0,1,29350,561,29911,41784,0,0,0,0,0,0,71.58
臺中縣,大肚鄉,,0,1,25396,522,25918,34409,0,0,0,0,0,0,75.32
臺中縣,龍井鄉,,0,1,28903,521,29424,40036,0,0,0,0,0,0,73.49
臺中縣,霧峰鄉,,0,1,32141,627,32768,45165,0,0,0,0,0,0,72.55
臺中縣,太平市,,0,1,66259,1421,67680,103235,0,0,0,0,0,0,65.56
臺中縣,大里市,,0,1,66960,1288,68248,105154,0,0,0,0,0,0,64.90
臺中縣,和平鄉,,0,1,3741,54,3795,5929,0,0,0,0,0,0,64.01
彰化縣,彰化市,,0,1,110815,1884,112699,147723,0,0,0,0,0,0,76.29
彰化縣,花壇鄉,,0,1,23314,357,23671,30048,0,0,0,0,0,0,78.78
彰化縣,芬園鄉,,0,1,14493,234,14727,18697,0,0,0,0,0,0,78.77
彰化縣,鹿港鎮,,0,1,42400,665,43065,53953,0,0,0,0,0,0,79.82
彰化縣,福興鄉,,0,1,24839,326,25165,31451,0,0,0,0,0,0,80.01
彰化縣,秀水鄉,,0,1,19611,317,19928,24168,0,0,0,0,0,0,82.46
彰化縣,和美鎮,,0,1,43330,756,44086,54651,0,0,0,0,0,0,80.67
彰化縣,線西鄉,,0,1,8854,140,8994,11042,0,0,0,0,0,0,81.45
彰化縣,伸港鄉,,0,1,17011,221,17232,21387,0,0,0,0,0,0,80.57
彰化縣,員林鎮,,0,1,59127,1000,60127,82289,0,0,0,0,0,0,73.07
彰化縣,大村鄉,,0,1,18196,268,18464,23641,0,0,0,0,0,0,78.10
彰化縣,永靖鄉,,0,1,20382,403,20785,27015,0,0,0,0,0,0,76.94
彰化縣,溪湖鎮,,0,1,27764,371,28135,35714,0,0,0,0,0,0,78.78
彰化縣,埔鹽鄉,,0,1,19937,258,20195,24543,0,0,0,0,0,0,82.28
彰化縣,埔心鄉,,0,1,17953,303,18256,23434,0,0,0,0,0,0,77.90
彰化縣,田中鎮,,0,1,23173,470,23643,32724,0,0,0,0,0,0,72.25
彰化縣,社頭鄉,,0,1,22838,390,23228,30177,0,0,0,0,0,0,76.97
彰化縣,二水鄉,,0,1,10568,144,10712,13615,0,0,0,0,0,0,78.68
彰化縣,北斗鎮,,0,1,17043,272,17315,22576,0,0,0,0,0,0,76.70
彰化縣,溪州鄉,,0,1,17175,311,17486,23720,0,0,0,0,0,0,73.72
彰化縣,田尾鄉,,0,1,15513,264,15777,20159,0,0,0,0,0,0,78.26
彰化縣,埤頭鄉,,0,1,16986,351,17337,22795,0,0,0,0,0,0,76.06
彰化縣,二林鎮,,0,1,29727,454,30181,39194,0,0,0,0,0,0,77.00
彰化縣,芳苑鄉,,0,1,20634,301,20935,29269,0,0,0,0,0,0,71.53
彰化縣,大城鄉,,0,1,11213,151,11364,16530,0,0,0,0,0,0,68.75
彰化縣,竹塘鄉,,0,1,9568,106,9674,12824,0,0,0,0,0,0,75.44
南投縣,南投市,,0,1,46969,446,47415,69131,0,0,0,0,0,0,68.59
南投縣,埔里鎮,,0,1,38202,405,38607,60006,0,0,0,0,0,0,64.34
南投縣,草屯鎮,,0,1,43726,505,44231,64901,0,0,0,0,0,0,68.15
南投縣,竹山鎮,,0,1,29579,323,29902,43360,0,0,0,0,0,0,68.96
南投縣,集集鎮,,0,1,6154,49,6203,9022,0,0,0,0,0,0,68.75
南投縣,名間鄉,,0,1,21056,252,21308,30166,0,0,0,0,0,0,70.64
南投縣,鹿谷鄉,,0,1,10399,84,10483,15398,0,0,0,0,0,0,68.08
南投縣,中寮鄉,,0,1,9565,75,9640,13818,0,0,0,0,0,0,69.76
南投縣,魚池鄉,,0,1,7822,62,7884,13124,0,0,0,0,0,0,60.07
南投縣,國姓鄉,,0,1,11292,149,11441,17980,0,0,0,0,0,0,63.63
南投縣,水里鄉,,0,1,10980,102,11082,16754,0,0,0,0,0,0,66.15
南投縣,信義鄉,,0,1,3875,39,3914,6010,0,0,0,0,0,0,65.12
南投縣,仁愛鄉,,0,1,1493,22,1515,2698,0,0,0,0,0,0,56.15
雲林縣,斗六市,,0,1,46078,847,46925,65864,0,0,0,0,0,0,71.25
雲林縣,斗南鎮,,0,1,24158,326,24484,33045,0,0,0,0,0,0,74.09
雲林縣,虎尾鎮,,0,1,31503,620,32123,45969,0,0,0,0,0,0,69.88
雲林縣,西螺鎮,,0,1,23494,315,23809,35207,0,0,0,0,0,0,67.63
雲林縣,土庫鎮,,0,1,15454,202,15656,22999,0,0,0,0,0,0,68.07
雲林縣,北港鎮,,0,1,22481,446,22927,33266,0,0,0,0,0,0,68.92
雲林縣,古坑鄉,,0,1,19190,282,19472,26157,0,0,0,0,0,0,74.44
雲林縣,大埤鄉,,0,1,11969,162,12131,17049,0,0,0,0,0,0,71.15
雲林縣,莿桐鄉,,0,1,15899,227,16126,22327,0,0,0,0,0,0,72.23
雲林縣,林內鄉,,0,1,10551,214,10765,14754,0,0,0,0,0,0,72.96
雲林縣,二崙鄉,,0,1,15731,197,15928,24068,0,0,0,0,0,0,66.18
雲林縣,崙背鄉,,0,1,14019,200,14219,21235,0,0,0,0,0,0,66.96
雲林縣,麥寮鄉,,0,1,14453,172,14625,22670,0,0,0,0,0,0,64.51
雲林縣,東勢鄉,,0,1,8878,123,9001,14589,0,0,0,0,0,0,61.70
雲林縣,褒忠鄉,,0,1,7865,91,7956,11145,0,0,0,0,0,0,71.39
雲林縣,台西鄉,,0,1,14138,140,14278,21669,0,0,0,0,0,0,65.89
雲林縣,元長鄉,,0,1,15603,163,15766,24607,0,0,0,0,0,0,64.07
雲林縣,四湖鄉,,0,1,13146,195,13341,23509,0,0,0,0,0,0,56.75
雲林縣,口湖鄉,,0,1,15233,169,15402,24343,0,0,0,0,0,0,63.27
雲林縣,水林鄉,,0,1,16275,250,16525,25316,0,0,0,0,0,0,65.27
嘉義縣,太保市,,0,1,15602,257,15859,21191,0,0,0,0,0,0,74.84
嘉義縣,朴子市,,0,1,20652,297,20949,30999,0,0,0,0,0,0,67.58
嘉義縣,布袋鎮,,0,1,16792,286,17078,25066,0,0,0,0,0,0,68.13
嘉義縣,大林鎮,,0,1,17832,273,18105,26238,0,0,0,0,0,0,69.00
嘉義縣,民雄鄉,,0,1,33086,498,33584,46978,0,0,0,0,0,0,71.49
嘉義縣,溪口鄉,,0,1,8761,135,8896,13672,0,0,0,0,0,0,65.07
嘉義縣,新港鄉,,0,1,16923,267,17190,25877,0,0,0,0,0,0,66.43
嘉義縣,六腳鄉,,0,1,14860,220,15080,23116,0,0,0,0,0,0,65.24
嘉義縣,東石鄉,,0,1,15524,216,15740,23418,0,0,0,0,0,0,67.21
嘉義縣,義竹鄉,,0,1,13186,147,13333,18363,0,0,0,0,0,0,72.61
嘉義縣,鹿草鄉,,0,1,9887,188,10075,14251,0,0,0,0,0,0,70.70
嘉義縣,水上鄉,,0,1,27507,575,28082,39149,0,0,0,0,0,0,71.73
嘉義縣,中埔鄉,,0,1,21666,412,22078,33202,0,0,0,0,0,0,66.50
嘉義縣,竹崎鄉,,0,1,20031,295,20326,29378,0,0,0,0,0,0,69.19
嘉義縣,梅山鄉,,0,1,12020,196,12216,17208,0,0,0,0,0,0,70.99
嘉義縣,番路鄉,,0,1,5761,68,5829,8910,0,0,0,0,0,0,65.42
嘉義縣,大埔鄉,,0,1,1580,18,1598,2871,0,0,0,0,0,0,55.66
嘉義縣,阿里山鄉,,0,1,1069,15,1084,1920,0,0,0,0,0,0,56.46
臺南縣,新營市,,0,1,30603,401,31004,51409,0,0,0,0,0,0,60.31
臺南縣,鹽水鎮,,0,1,13667,183,13850,21261,0,0,0,0,0,0,65.14
臺南縣,白河鎮,,0,1,16373,201,16574,26825,0,0,0,0,0,0,61.79
臺南縣,柳營鄉,,0,1,12056,167,12223,17870,0,0,0,0,0,0,68.40
臺南縣,後壁鄉,,0,1,14239,167,14406,21859,0,0,0,0,0,0,65.90
臺南縣,東山鄉,,0,1,11810,125,11935,19426,0,0,0,0,0,0,61.44
臺南縣,麻豆鎮,,0,1,23756,254,24010,33754,0,0,0,0,0,0,71.13
臺南縣,下營鄉,,0,1,14183,138,14321,20392,0,0,0,0,0,0,70.23
臺南縣,六甲鄉,,0,1,11530,129,11659,17574,0,0,0,0,0,0,66.34
臺南縣,官田鄉,,0,1,12313,134,12447,17645,0,0,0,0,0,0,70.54
臺南縣,大內鄉,,0,1,6152,77,6229,9638,0,0,0,0,0,0,64.63
臺南縣,佳里鎮,,0,1,26027,238,26265,38797,0,0,0,0,0,0,67.70
臺南縣,學甲鎮,,0,1,14784,105,14889,21588,0,0,0,0,0,0,68.97
臺南縣,西港鄉,,0,1,12684,150,12834,17920,0,0,0,0,0,0,71.62
臺南縣,七股鄉,,0,1,14306,121,14427,19913,0,0,0,0,0,0,72.45
臺南縣,將軍鄉,,0,1,12105,73,12178,18143,0,0,0,0,0,0,67.12
臺南縣,北門鄉,,0,1,7047,59,7106,10392,0,0,0,0,0,0,68.38
臺南縣,新化鎮,,0,1,20875,325,21200,31110,0,0,0,0,0,0,68.15
臺南縣,善化鎮,,0,1,19131,236,19367,29518,0,0,0,0,0,0,65.61
臺南縣,新市鄉,,0,1,14307,182,14489,22140,0,0,0,0,0,0,65.44
臺南縣,安定鄉,,0,1,14461,160,14621,20879,0,0,0,0,0,0,70.03
臺南縣,山上鄉,,0,1,4048,54,4102,6003,0,0,0,0,0,0,68.33
臺南縣,玉井鄉,,0,1,8818,82,8900,12614,0,0,0,0,0,0,70.56
臺南縣,楠西鄉,,0,1,6462,68,6530,9286,0,0,0,0,0,0,70.32
臺南縣,南化鄉,,0,1,5377,47,5424,7550,0,0,0,0,0,0,71.84
臺南縣,左鎮鄉,,0,1,3695,42,3737,5037,0,0,0,0,0,0,74.19
臺南縣,仁德鄉,,0,1,28743,413,29156,45156,0,0,0,0,0,0,64.57
臺南縣,歸仁鄉,,0,1,27032,277,27309,40807,0,0,0,0,0,0,66.92
臺南縣,關廟鄉,,0,1,18553,173,18726,27512,0,0,0,0,0,0,68.06
臺南縣,龍崎鄉,,0,1,2711,13,2724,3803,0,0,0,0,0,0,71.63
臺南縣,永康市,,0,1,70121,855,70976,123350,0,0,0,0,0,0,57.54
高雄縣,鳳山市,,0,1,138203,1790,139993,214192,0,0,0,0,0,0,65.36
高雄縣,林園鄉,,0,1,33821,375,34196,47627,0,0,0,0,0,0,71.80
高雄縣,大寮鄉,,0,1,54581,675,55256,78602,0,0,0,0,0,0,70.30
高雄縣,大樹鄉,,0,1,23730,239,23969,33037,0,0,0,0,0,0,72.55
高雄縣,大社鄉,,0,1,15616,234,15850,22614,0,0,0,0,0,0,70.09
高雄縣,仁武鄉,,0,1,22280,364,22644,32692,0,0,0,0,0,0,69.26
高雄縣,鳥松鄉,,0,1,17929,206,18135,25870,0,0,0,0,0,0,70.10
高雄縣,岡山鎮,,0,1,43804,561,44365,62489,0,0,0,0,0,0,71.00
高雄縣,橋頭鄉,,0,1,19422,230,19652,26821,0,0,0,0,0,0,73.27
高雄縣,燕巢鄉,,0,1,17407,241,17648,23339,0,0,0,0,0,0,75.62
高雄縣,田寮鄉,,0,1,5777,75,5852,8033,0,0,0,0,0,0,72.85
高雄縣,阿蓮鄉,,0,1,14955,269,15224,21028,0,0,0,0,0,0,72.40
高雄縣,路竹鄉,,0,1,27294,393,27687,36421,0,0,0,0,0,0,76.02
高雄縣,湖內鄉,,0,1,14194,223,14417,19985,0,0,0,0,0,0,72.14
高雄縣,茄萣鄉,,0,1,16539,192,16731,23357,0,0,0,0,0,0,71.63
高雄縣,永安鄉,,0,1,7655,70,7725,10384,0,0,0,0,0,0,74.39
高雄縣,彌陀鄉,,0,1,11974,163,12137,15185,0,0,0,0,0,0,79.93
高雄縣,梓官鄉,,0,1,19986,318,20304,27208,0,0,0,0,0,0,74.63
高雄縣,旗山鎮,,0,1,23441,301,23742,32652,0,0,0,0,0,0,72.71
高雄縣,美濃鎮,,0,1,25596,281,25877,35077,0,0,0,0,0,0,73.77
高雄縣,六龜鄉,,0,1,8479,146,8625,13081,0,0,0,0,0,0,65.94
高雄縣,甲仙鄉,,0,1,4684,60,4744,6597,0,0,0,0,0,0,71.91
高雄縣,杉林鄉,,0,1,7058,95,7153,10356,0,0,0,0,0,0,69.07
高雄縣,內門鄉,,0,1,10422,117,10539,13567,0,0,0,0,0,0,77.68
高雄縣,茂林鄉,,0,1,63,0,63,108,0,0,0,0,0,0,58.33
高雄縣,桃源鄉,,0,1,226,2,228,399,0,0,0,0,0,0,57.14
高雄縣,三民鄉,,0,1,133,1,134,299,0,0,0,0,0,0,44.82
屏東縣,屏東市,,0,1,95375,891,96266,145278,0,0,0,0,0,0,66.26
屏東縣,潮州鎮,,0,1,25893,257,26150,38900,0,0,0,0,0,0,67.22
屏東縣,東港鎮,,0,1,23485,204,23689,33119,0,0,0,0,0,0,71.53
屏東縣,恆春鎮,,0,1,12943,221,13164,22098,0,0,0,0,0,0,59.57
屏東縣,萬丹鄉,,0,1,27858,243,28101,36676,0,0,0,0,0,0,76.62
屏東縣,長治鄉,,0,1,14808,140,14948,21256,0,0,0,0,0,0,70.32
屏東縣,麟洛鄉,,0,1,6207,39,6246,8513,0,0,0,0,0,0,73.37
屏東縣,九如鄉,,0,1,11758,103,11861,16005,0,0,0,0,0,0,74.11
屏東縣,里港鄉,,0,1,13728,136,13864,19106,0,0,0,0,0,0,72.56
屏東縣,鹽埔鄉,,0,1,14279,165,14444,19914,0,0,0,0,0,0,72.53
屏東縣,高樹鄉,,0,1,14659,175,14834,22660,0,0,0,0,0,0,65.46
屏東縣,萬巒鄉,,0,1,12079,140,12219,17526,0,0,0,0,0,0,69.72
屏東縣,內埔鄉,,0,1,28757,331,29088,43904,0,0,0,0,0,0,66.25
屏東縣,竹田鄉,,0,1,10412,98,10510,14244,0,0,0,0,0,0,73.79
屏東縣,新埤鄉,,0,1,5914,45,5959,8918,0,0,0,0,0,0,66.82
屏東縣,枋寮鄉,,0,1,13829,140,13969,21398,0,0,0,0,0,0,65.28
屏東縣,新園鄉,,0,1,20773,187,20960,28415,0,0,0,0,0,0,73.76
屏東縣,崁頂鄉,,0,1,7174,78,7252,10235,0,0,0,0,0,0,70.85
屏東縣,林邊鄉,,0,1,11805,142,11947,16537,0,0,0,0,0,0,72.24
屏東縣,南州鄉,,0,1,7057,75,7132,9777,0,0,0,0,0,0,72.95
屏東縣,佳冬鄉,,0,1,12096,137,12233,17361,0,0,0,0,0,0,70.46
屏東縣,琉球鄉,,0,1,5252,39,5291,8833,0,0,0,0,0,0,59.90
屏東縣,車城鄉,,0,1,4993,80,5073,8309,0,0,0,0,0,0,61.05
屏東縣,滿州鄉,,0,1,2960,37,2997,5527,0,0,0,0,0,0,54.22
屏東縣,枋山鄉,,0,1,3155,44,3199,5032,0,0,0,0,0,0,63.57
屏東縣,三地門鄉,,0,1,205,5,210,409,0,0,0,0,0,0,51.34
屏東縣,霧台鄉,,0,1,33,0,33,79,0,0,0,0,0,0,41.77
屏東縣,瑪家鄉,,0,1,216,4,220,376,0,0,0,0,0,0,58.51
屏東縣,泰武鄉,,0,1,93,0,93,172,0,0,0,0,0,0,54.07
屏東縣,來義鄉,,0,1,237,11,248,429,0,0,0,0,0,0,57.81
屏東縣,春日鄉,,0,1,258,0,258,408,0,0,0,0,0,0,63.24
屏東縣,獅子鄉,,0,1,152,0,152,303,0,0,0,0,0,0,50.17
屏東縣,牡丹鄉,,0,1,209,3,212,404,0,0,0,0,0,0,52.48
臺東縣,台東市,,0,1,40974,460,41434,65196,0,0,0,0,0,0,63.55
臺東縣,成功鎮,,0,1,4038,18,4056,6437,0,0,0,0,0,0,63.01
臺東縣,關山鎮,,0,1,3815,37,3852,6388,0,0,0,0,0,0,60.30
臺東縣,卑南鄉,,0,1,7302,82,7384,11525,0,0,0,0,0,0,64.07
臺東縣,鹿野鄉,,0,1,3429,27,3456,5766,0,0,0,0,0,0,59.94
臺東縣,池上鄉,,0,1,4084,41,4125,6726,0,0,0,0,0,0,61.33
臺東縣,東河鄉,,0,1,2395,25,2420,4433,0,0,0,0,0,0,54.59
臺東縣,長濱鄉,,0,1,1808,15,1823,3570,0,0,0,0,0,0,51.06
臺東縣,太麻里鄉,,0,1,4045,30,4075,6547,0,0,0,0,0,0,62.24
臺東縣,大武鄉,,0,1,1491,15,1506,2675,0,0,0,0,0,0,56.30
臺東縣,綠島鄉,,0,1,1099,11,1110,1912,0,0,0,0,0,0,58.05
臺東縣,海端鄉,,0,1,178,7,185,341,0,0,0,0,0,0,54.25
臺東縣,延平鄉,,0,1,166,2,168,305,0,0,0,0,0,0,55.08
臺東縣,金峰鄉,,0,1,106,1,107,206,0,0,0,0,0,0,51.94
臺東縣,達仁鄉,,0,1,176,3,179,424,0,0,0,0,0,0,42.22
臺東縣,蘭嶼鄉,,0,1,74,1,75,166,0,0,0,0,0,0,45.18
花蓮縣,花蓮市,,0,1,39470,427,39897,69287,0,0,0,0,0,0,57.58
花蓮縣,新城鄉,,0,1,6690,116,6806,12130,0,0,0,0,0,0,56.11
花蓮縣,秀林鄉,,0,1,909,12,921,1961,0,0,0,0,0,0,46.97
花蓮縣,吉安鄉,,0,1,24452,306,24758,43775,0,0,0,0,0,0,56.56
花蓮縣,壽豐鄉,,0,1,6303,90,6393,11477,0,0,0,0,0,0,55.70
花蓮縣,鳳林鎮,,0,1,5585,75,5660,9679,0,0,0,0,0,0,58.48
花蓮縣,光復鄉,,0,1,3789,45,3834,6857,0,0,0,0,0,0,55.91
花蓮縣,豐濱鄉,,0,1,613,6,619,1284,0,0,0,0,0,0,48.21
花蓮縣,萬榮鄉,,0,1,156,1,157,380,0,0,0,0,0,0,41.32
花蓮縣,瑞穗鄉,,0,1,4076,43,4119,7594,0,0,0,0,0,0,54.24
花蓮縣,玉里鎮,,0,1,9542,249,9791,18567,0,0,0,0,0,0,52.73
花蓮縣,富里鄉,,0,1,4801,50,4851,9461,0,0,0,0,0,0,51.27
花蓮縣,卓溪鄉,,0,1,180,8,188,386,0,0,0,0,0,0,48.70
澎湖縣,馬公市,,0,1,21055,271,21326,35874,0,0,0,0,0,0,59.45
澎湖縣,湖西鄉,,0,1,5758,84,5842,9607,0,0,0,0,0,0,60.81
澎湖縣,白沙鄉,,0,1,3586,47,3633,6847,0,0,0,0,0,0,53.06
澎湖縣,西嶼鄉,,0,1,3171,55,3226,6431,0,0,0,0,0,0,50.16
澎湖縣,望安鄉,,0,1,1024,14,1038,3158,0,0,0,0,0,0,32.87
澎湖縣,七美鄉,,0,1,996,20,1016,2187,0,0,0,0,0,0,46.46
基隆市,中正區,,0,1,21027,240,21267,39892,0,0,0,0,0,0,53.31
基隆市,信義區,,0,1,18865,195,19060,33778,0,0,0,0,0,0,56.43
基隆市,仁愛區,,0,1,20844,242,21086,38787,0,0,0,0,0,0,54.36
基隆市,中山區,,0,1,20325,279,20604,36706,0,0,0,0,0,0,56.13
基隆市,安樂區,,0,1,26380,300,26680,52170,0,0,0,0,0,0,51.14
基隆市,暖暖區,,0,1,12070,141,12211,24458,0,0,0,0,0,0,49.93
基隆市,七堵區,,0,1,18662,224,18886,36992,0,0,0,0,0,0,51.05
新竹市,東區,,0,1,57824,1343,59167,112807,0,0,0,0,0,0,52.45
新竹市,北區,,0,1,43322,1114,44436,85203,0,0,0,0,0,0,52.15
新竹市,香山區,,0,1,19698,541,20239,40173,0,0,0,0,0,0,50.38
臺中市,中區,,0,1,10026,103,10129,16563,0,0,0,0,0,0,61.15
臺中市,東區,,0,1,30302,380,30682,47767,0,0,0,0,0,0,64.23
臺中市,南區,,0,1,35784,409,36193,60167,0,0,0,0,0,0,60.15
臺中市,西區,,0,1,43597,521,44118,73173,0,0,0,0,0,0,60.29
臺中市,北區,,0,1,58184,667,58851,98116,0,0,0,0,0,0,59.98
臺中市,西屯區,,0,1,61230,625,61855,102724,0,0,0,0,0,0,60.21
臺中市,南屯區,,0,1,43387,494,43881,69616,0,0,0,0,0,0,63.03
臺中市,北屯區,,0,1,82908,1014,83922,133344,0,0,0,0,0,0,62.94
嘉義市,東區,,0,1,51284,573,51857,87650,0,0,0,0,0,0,59.16
嘉義市,西區,,0,1,53002,583,53585,90767,0,0,0,0,0,0,59.04
臺南市,東區,,0,1,68605,748,69353,116264,0,0,0,0,0,0,59.65
臺南市,南區,,0,1,56434,554,56988,94768,0,0,0,0,0,0,60.13
臺南市,西區,,0,1,20725,219,20944,32791,0,0,0,0,0,0,63.87
臺南市,北區,,0,1,49669,608,50277,83622,0,0,0,0,0,0,60.12
臺南市,中區,,0,1,19697,202,19899,32600,0,0,0,0,0,0,61.04
臺南市,安南區,,0,1,64036,868,64904,102486,0,0,0,0,0,0,63.33
臺南市,安平區,,0,1,16022,129,16151,27990,0,0,0,0,0,0,57.70
金門縣,金城鎮,,0,1,6514,109,6623,10999,0,0,0,0,0,0,60.21
金門縣,金寧鄉,,0,1,3616,60,3676,6137,0,0,0,0,0,0,59.90
金門縣,金湖鎮,,0,1,4727,81,4808,7470,0,0,0,0,0,0,64.36
金門縣,金沙鎮,,0,1,3488,55,3543,5987,0,0,0,0,0,0,59.18
金門縣,烈嶼鄉,,0,1,1941,36,1977,3447,0,0,0,0,0,0,57.35
金門縣,烏坵鄉,,0,1,38,0,38,276,0,0,0,0,0,0,13.77
連江縣,南竿鄉,,0,1,1488,150,1638,2638,0,0,0,0,0,0,62.09
連江縣,北竿鄉,,0,1,399,104,503,929,0,0,0,0,0,0,54.14
連江縣,莒光鄉,,0,1,253,28,281,652,0,0,0,0,0,0,43.10
連江縣,東引鄉,,0,1,303,30,333,515,0,0,0,0,0,0,64.66
臺北市,北投區,建民里,0,1,3032,55,3087,3720,0,0,0,0,0,0,82.98
臺北市,北投區,文林里,0,1,2699,45,2744,3270,0,0,0,0,0,0,83.91
臺北市,北投區,石牌里,0,1,3441,52,3493,4192,0,0,0,0,0,0,83.33
臺北市,北投區,福興里,0,1,4085,80,4165,4893,0,0,0,0,0,0,85.12
臺北市,北投區,榮光里,0,1,4382,67,4449,5291,0,0,0,0,0,0,84.09
臺北市,北投區,榮華里,0,1,4336,73,4409,5385,0,0,0,0,0,0,81.88
臺北市,北投區,裕民里,0,1,4141,82,4223,5054,0,0,0,0,0,0,83.56
臺北市,北投區,振華里,0,1,4966,79,5045,6022,0,0,0,0,0,0,83.78
臺北市,北投區,永和里,0,1,4479,77,4556,5631,0,0,0,0,0,0,80.91
臺北市,北投區,永欣里,0,1,3744,60,3804,4743,0,0,0,0,0,0,80.20
臺北市,北投區,永明里,0,1,2740,49,2789,3330,0,0,0,0,0,0,83.75
臺北市,北投區,東華里,0,1,3043,56,3099,3647,0,0,0,0,0,0,84.97
臺北市,北投區,吉利里,0,1,3763,73,3836,4584,0,0,0,0,0,0,83.68
臺北市,北投區,吉慶里,0,1,3178,44,3222,3823,0,0,0,0,0,0,84.28
臺北市,北投區,尊賢里,0,1,3006,51,3057,3657,0,0,0,0,0,0,83.59
臺北市,北投區,立賢里,0,1,3190,60,3250,3878,0,0,0,0,0,0,83.81
臺北市,北投區,立農里,0,1,5127,82,5209,6106,0,0,0,0,0,0,85.31
臺北市,北投區,八仙里,0,1,2768,62,2830,3398,0,0,0,0,0,0,83.28
臺北市,北投區,洲美里,0,1,1083,25,1108,1271,0,0,0,0,0,0,87.18
臺北市,北投區,奇岩里,0,1,5635,100,5735,6883,0,0,0,0,0,0,83.32
臺北市,北投區,清江里,0,1,4928,117,5045,5987,0,0,0,0,0,0,84.27
臺北市,北投區,中央里,0,1,4670,79,4749,5670,0,0,0,0,0,0,83.76
臺北市,北投區,長安里,0,1,3454,67,3521,4266,0,0,0,0,0,0,82.54
臺北市,北投區,大同里,0,1,3527,59,3586,4254,0,0,0,0,0,0,84.30
臺北市,北投區,溫泉里,0,1,3885,69,3954,4782,0,0,0,0,0,0,82.69
臺北市,北投區,林泉里,0,1,2058,41,2099,2681,0,0,0,0,0,0,78.29
臺北市,北投區,中心里,0,1,3280,46,3326,4202,0,0,0,0,0,0,79.15
臺北市,北投區,中庸里,0,1,2778,42,2820,3293,0,0,0,0,0,0,85.64
臺北市,北投區,開明里,0,1,4038,79,4117,5075,0,0,0,0,0,0,81.12
臺北市,北投區,中和里,0,1,3534,68,3602,4381,0,0,0,0,0,0,82.22
臺北市,北投區,智仁里,0,1,3810,56,3866,4725,0,0,0,0,0,0,81.82
臺北市,北投區,秀山里,0,1,2313,53,2366,2937,0,0,0,0,0,0,80.56
臺北市,北投區,文化里,0,1,2611,36,2647,3163,0,0,0,0,0,0,83.69
臺北市,北投區,豐年里,0,1,2700,37,2737,3224,0,0,0,0,0,0,84.89
臺北市,北投區,稻香里,0,1,2849,49,2898,3584,0,0,0,0,0,0,80.86
臺北市,北投區,桃源里,0,1,3259,50,3309,3953,0,0,0,0,0,0,83.71
臺北市,北投區,一德里,0,1,3802,95,3897,4605,0,0,0,0,0,0,84.63
臺北市,北投區,關渡里,0,1,6027,211,6238,7363,0,0,0,0,0,0,84.72
臺北市,北投區,泉源里,0,1,1535,36,1571,1870,0,0,0,0,0,0,84.01
臺北市,北投區,湖山里,0,1,1869,38,1907,2343,0,0,0,0,0,0,81.39
臺北市,士林區,永福里,0,1,3004,64,3068,3665,0,0,0,0,0,0,83.71
臺北市,士林區,公館里,0,1,1914,41,1955,2327,0,0,0,0,0,0,84.01
臺北市,士林區,新安里,0,1,2717,40,2757,3412,0,0,0,0,0,0,80.80
臺北市,士林區,陽明里,0,1,2626,31,2657,3255,0,0,0,0,0,0,81.63
臺北市,士林區,菁山里,0,1,4937,71,5008,6154,0,0,0,0,0,0,81.38
臺北市,士林區,平等里,0,1,4332,71,4403,5334,0,0,0,0,0,0,82.55
臺北市,士林區,溪山里,0,1,4641,77,4718,5706,0,0,0,0,0,0,82.68
臺北市,士林區,翠山里,0,1,5034,110,5144,6205,0,0,0,0,0,0,82.90
臺北市,士林區,三玉里,0,1,3473,65,3538,4154,0,0,0,0,0,0,85.17
臺北市,士林區,天福里,0,1,2670,47,2717,3195,0,0,0,0,0,0,85.04
臺北市,士林區,天祿里,0,1,4588,95,4683,5576,0,0,0,0,0,0,83.98
臺北市,士林區,天壽里,0,1,3177,71,3248,3942,0,0,0,0,0,0,82.39
臺北市,士林區,天和里,0,1,4332,100,4432,5462,0,0,0,0,0,0,81.14
臺北市,士林區,天山里,0,1,3136,67,3203,3999,0,0,0,0,0,0,80.10
臺北市,士林區,天玉里,0,1,3535,76,3611,4366,0,0,0,0,0,0,82.71
臺北市,士林區,天母里,0,1,3806,93,3899,4624,0,0,0,0,0,0,84.32
臺北市,士林區,岩山里,0,1,2441,59,2500,2971,0,0,0,0,0,0,84.15
臺北市,士林區,名山里,0,1,4690,89,4779,5651,0,0,0,0,0,0,84.57
臺北市,士林區,聖山里,0,1,5219,118,5337,6287,0,0,0,0,0,0,84.89
臺北市,士林區,芝山里,0,1,4096,108,4204,4924,0,0,0,0,0,0,85.38
臺北市,士林區,東山里,0,1,4262,96,4358,5128,0,0,0,0,0,0,84.98
臺北市,士林區,德行里,0,1,3210,95,3305,3795,0,0,0,0,0,0,87.09
臺北市,士林區,德華里,0,1,4640,94,4734,5667,0,0,0,0,0,0,83.54
臺北市,士林區,忠誠里,0,1,3516,99,3615,4216,0,0,0,0,0,0,85.74
臺北市,士林區,蘭雅里,0,1,2695,51,2746,3488,0,0,0,0,0,0,78.73
臺北市,士林區,蘭興里,0,1,3976,61,4037,4939,0,0,0,0,0,0,81.74
臺北市,士林區,仁勇里,0,1,2625,48,2673,3256,0,0,0,0,0,0,82.09
臺北市,士林區,義信里,0,1,3500,47,3547,4345,0,0,0,0,0,0,81.63
臺北市,士林區,福林里,0,1,3144,39,3183,3863,0,0,0,0,0,0,82.40
臺北市,士林區,福德里,0,1,3632,53,3685,4402,0,0,0,0,0,0,83.71
臺北市,士林區,福志里,0,1,4144,68,4212,5183,0,0,0,0,0,0,81.27
臺北市,士林區,舊佳里,0,1,3139,54,3193,3840,0,0,0,0,0,0,83.15
臺北市,士林區,福佳里,0,1,3456,50,3506,4243,0,0,0,0,0,0,82.63
臺北市,士林區,後港里,0,1,5267,95,5362,6511,0,0,0,0,0,0,82.35
臺北市,士林區,福中里,0,1,3684,45,3729,4587,0,0,0,0,0,0,81.29
臺北市,士林區,前港里,0,1,3990,62,4052,4924,0,0,0,0,0,0,82.29
臺北市,士林區,百齡里,0,1,3148,38,3186,3917,0,0,0,0,0,0,81.34
臺北市,士林區,承德里,0,1,2744,37,2781,3559,0,0,0,0,0,0,78.14
臺北市,士林區,福華里,0,1,4469,71,4540,5628,0,0,0,0,0,0,80.67
臺北市,士林區,明勝里,0,1,4111,48,4159,5269,0,0,0,0,0,0,78.93
臺北市,士林區,福順里,0,1,4940,46,4986,6270,0,0,0,0,0,0,79.52
臺北市,士林區,富光里,0,1,3867,59,3926,4980,0,0,0,0,0,0,78.84
臺北市,士林區,葫蘆里,0,1,850,21,871,1084,0,0,0,0,0,0,80.35
臺北市,士林區,葫東里,0,1,913,15,928,1127,0,0,0,0,0,0,82.34
臺北市,士林區,社子里,0,1,1318,26,1344,1707,0,0,0,0,0,0,78.73
臺北市,士林區,社新里,0,1,1984,32,2016,2664,0,0,0,0,0,0,75.68
臺北市,士林區,社園里,0,1,1058,29,1087,1307,0,0,0,0,0,0,83.17
臺北市,士林區,永倫里,0,1,980,12,992,1166,0,0,0,0,0,0,85.08
臺北市,士林區,福安里,0,1,962,28,990,1176,0,0,0,0,0,0,84.18
臺北市,士林區,富洲里,0,1,3799,94,3893,5023,0,0,0,0,0,0,77.50
臺北市,內湖區,西湖里,0,1,4996,89,5085,6049,0,0,0,0,0,0,84.06
臺北市,內湖區,西康里,0,1,4691,99,4790,5719,0,0,0,0,0,0,83.76
臺北市,內湖區,西安里,0,1,3766,67,3833,4587,0,0,0,0,0,0,83.56
臺北市,內湖區,港墘里,0,1,3258,58,3316,3941,0,0,0,0,0,0,84.14
臺北市,內湖區,港都里,0,1,6545,105,6650,7931,0,0,0,0,0,0,83.85
臺北市,內湖區,港富里,0,1,5608,74,5682,6816,0,0,0,0,0,0,83.36
臺北市,內湖區,港華里,0,1,4768,73,4841,5780,0,0,0,0,0,0,83.75
臺北市,內湖區,內湖里,0,1,3154,56,3210,3900,0,0,0,0,0,0,82.31
臺北市,內湖區,湖濱里,0,1,4350,50,4400,5408,0,0,0,0,0,0,81.36
臺北市,內湖區,紫星里,0,1,4986,80,5066,6074,0,0,0,0,0,0,83.40
臺北市,內湖區,大湖里,0,1,6407,104,6511,8075,0,0,0,0,0,0,80.63
臺北市,內湖區,金龍里,0,1,3497,56,3553,4265,0,0,0,0,0,0,83.31
臺北市,內湖區,金瑞里,0,1,3844,68,3912,4711,0,0,0,0,0,0,83.04
臺北市,內湖區,碧山里,0,1,4101,45,4146,5062,0,0,0,0,0,0,81.90
臺北市,內湖區,紫雲里,0,1,3077,78,3155,3787,0,0,0,0,0,0,83.31
臺北市,內湖區,清白里,0,1,3197,61,3258,3979,0,0,0,0,0,0,81.88
臺北市,內湖區,葫洲里,0,1,12692,202,12894,15679,0,0,0,0,0,0,82.24
臺北市,內湖區,紫陽里,0,1,4078,54,4132,4956,0,0,0,0,0,0,83.37
臺北市,內湖區,瑞陽里,0,1,5052,84,5136,6043,0,0,0,0,0,0,84.99
臺北市,內湖區,瑞光里,0,1,2948,49,2997,3539,0,0,0,0,0,0,84.68
臺北市,內湖區,五分里,0,1,4862,96,4958,5954,0,0,0,0,0,0,83.27
臺北市,內湖區,東湖里,0,1,8115,133,8248,9912,0,0,0,0,0,0,83.21
臺北市,內湖區,樂康里,0,1,4239,73,4312,5160,0,0,0,0,0,0,83.57
臺北市,內湖區,內溝里,0,1,4870,98,4968,6032,0,0,0,0,0,0,82.36
臺北市,內湖區,週美里,0,1,2963,55,3018,3562,0,0,0,0,0,0,84.73
臺北市,內湖區,行善里,0,1,2895,66,2961,3572,0,0,0,0,0,0,82.89
臺北市,內湖區,石潭里,0,1,1639,42,1681,2073,0,0,0,0,0,0,81.09
臺北市,內湖區,湖興里,0,1,4032,64,4096,4902,0,0,0,0,0,0,83.56
臺北市,內湖區,湖元里,0,1,2736,51,2787,3364,0,0,0,0,0,0,82.85
臺北市,南港區,百福里,0,1,3022,65,3087,3681,0,0,0,0,0,0,83.86
臺北市,南港區,鴻福里,0,1,3285,71,3356,3995,0,0,0,0,0,0,84.01
臺北市,南港區,成福里,0,1,5090,81,5171,6272,0,0,0,0,0,0,82.45
臺北市,南港區,萬福里,0,1,2792,45,2837,3370,0,0,0,0,0,0,84.18
臺北市,南港區,聯成里,0,1,3405,63,3468,4078,0,0,0,0,0,0,85.04
臺北市,南港區,新光里,0,1,2759,46,2805,3392,0,0,0,0,0,0,82.69
臺北市,南港區,合成里,0,1,3995,83,4078,4818,0,0,0,0,0,0,84.64
臺北市,南港區,玉成里,0,1,3058,48,3106,3695,0,0,0,0,0,0,84.06
臺北市,南港區,西新里,0,1,2859,58,2917,3494,0,0,0,0,0,0,83.49
臺北市,南港區,東新里,0,1,4210,82,4292,5109,0,0,0,0,0,0,84.01
臺北市,南港區,東明里,0,1,2754,53,2807,3471,0,0,0,0,0,0,80.87
臺北市,南港區,南港里,0,1,3536,78,3614,4377,0,0,0,0,0,0,82.57
臺北市,南港區,三重里,0,1,2243,57,2300,2705,0,0,0,0,0,0,85.03
臺北市,南港區,中南里,0,1,2715,61,2776,3236,0,0,0,0,0,0,85.78
臺北市,南港區,新富里,0,1,2713,57,2770,3341,0,0,0,0,0,0,82.91
臺北市,南港區,中研里,0,1,5678,113,5791,6984,0,0,0,0,0,0,82.92
臺北市,南港區,舊莊里,0,1,4973,101,5074,6154,0,0,0,0,0,0,82.45
臺北市,南港區,九如里,0,1,3805,78,3883,4669,0,0,0,0,0,0,83.17
臺北市,松山區,莊敬里,0,1,3829,58,3887,4748,0,0,0,0,0,0,81.87
臺北市,松山區,東榮里,0,1,5318,56,5374,6887,0,0,0,0,0,0,78.03
臺北市,松山區,三民里,0,1,4273,66,4339,5480,0,0,0,0,0,0,79.18
臺北市,松山區,新益里,0,1,3009,49,3058,3779,0,0,0,0,0,0,80.92
臺北市,松山區,富錦里,0,1,3345,30,3375,4274,0,0,0,0,0,0,78.97
臺北市,松山區,新東里,0,1,3041,55,3096,3874,0,0,0,0,0,0,79.92
臺北市,松山區,富泰里,0,1,2743,34,2777,3662,0,0,0,0,0,0,75.83
臺北市,松山區,介壽里,0,1,2826,47,2873,3763,0,0,0,0,0,0,76.35
臺北市,松山區,精忠里,0,1,2805,41,2846,3739,0,0,0,0,0,0,76.12
臺北市,松山區,東光里,0,1,4627,91,4718,6107,0,0,0,0,0,0,77.26
臺北市,松山區,龍田里,0,1,3451,41,3492,4534,0,0,0,0,0,0,77.02
臺北市,松山區,東昌里,0,1,2858,45,2903,3695,0,0,0,0,0,0,78.57
臺北市,松山區,東勢里,0,1,2033,24,2057,2623,0,0,0,0,0,0,78.42
臺北市,松山區,中華里,0,1,3032,43,3075,3788,0,0,0,0,0,0,81.18
臺北市,松山區,民有里,0,1,5257,68,5325,6918,0,0,0,0,0,0,76.97
臺北市,松山區,民福里,0,1,4201,85,4286,5318,0,0,0,0,0,0,80.59
臺北市,松山區,松基里,0,1,2283,48,2331,3000,0,0,0,0,0,0,77.70
臺北市,松山區,慈祐里,0,1,3848,45,3893,4784,0,0,0,0,0,0,81.38
臺北市,松山區,安平里,0,1,5732,118,5850,7069,0,0,0,0,0,0,82.76
臺北市,松山區,鵬程里,0,1,3232,48,3280,3981,0,0,0,0,0,0,82.39
臺北市,松山區,自強里,0,1,4545,64,4609,5794,0,0,0,0,0,0,79.55
臺北市,松山區,吉祥里,0,1,4775,84,4859,6143,0,0,0,0,0,0,79.10
臺北市,松山區,新聚里,0,1,4420,73,4493,5670,0,0,0,0,0,0,79.24
臺北市,松山區,復盛里,0,1,4043,68,4111,5067,0,0,0,0,0,0,81.13
臺北市,松山區,中正里,0,1,4591,76,4667,6060,0,0,0,0,0,0,77.01
臺北市,松山區,中崙里,0,1,2494,50,2544,3130,0,0,0,0,0,0,81.28
臺北市,松山區,美仁里,0,1,2146,26,2172,2669,0,0,0,0,0,0,81.38
臺北市,松山區,吉仁里,0,1,2390,26,2416,3011,0,0,0,0,0,0,80.24
臺北市,松山區,敦化里,0,1,4360,63,4423,5476,0,0,0,0,0,0,80.77
臺北市,松山區,復源里,0,1,1984,26,2010,2523,0,0,0,0,0,0,79.67
臺北市,松山區,復建里,0,1,2231,35,2266,2888,0,0,0,0,0,0,78.46
臺北市,松山區,復勢里,0,1,3721,78,3799,4799,0,0,0,0,0,0,79.16
臺北市,松山區,福成里,0,1,1574,39,1613,2173,0,0,0,0,0,0,74.23
臺北市,信義區,西村里,0,1,3088,36,3124,3910,0,0,0,0,0,0,79.90
臺北市,信義區,正和里,0,1,3010,61,3071,3963,0,0,0,0,0,0,77.49
臺北市,信義區,興隆里,0,1,1847,40,1887,2515,0,0,0,0,0,0,75.03
臺北市,信義區,中興里,0,1,1645,31,1676,2269,0,0,0,0,0,0,73.87
臺北市,信義區,新仁里,0,1,2609,49,2658,3487,0,0,0,0,0,0,76.23
臺北市,信義區,興雅里,0,1,3853,64,3917,4952,0,0,0,0,0,0,79.10
臺北市,信義區,敦厚里,0,1,2901,56,2957,3746,0,0,0,0,0,0,78.94
臺北市,信義區,廣居里,0,1,3820,56,3876,4873,0,0,0,0,0,0,79.54
臺北市,信義區,安康里,0,1,4633,58,4691,5939,0,0,0,0,0,0,78.99
臺北市,信義區,六藝里,0,1,2268,54,2322,2822,0,0,0,0,0,0,82.28
臺北市,信義區,雅祥里,0,1,2993,40,3033,3702,0,0,0,0,0,0,81.93
臺北市,信義區,五常里,0,1,2403,54,2457,2986,0,0,0,0,0,0,82.28
臺北市,信義區,五全里,0,1,3363,76,3439,4143,0,0,0,0,0,0,83.01
臺北市,信義區,永吉里,0,1,3051,75,3126,3775,0,0,0,0,0,0,82.81
臺北市,信義區,長春里,0,1,2958,70,3028,3708,0,0,0,0,0,0,81.66
臺北市,信義區,四育里,0,1,3697,70,3767,4500,0,0,0,0,0,0,83.71
臺北市,信義區,四維里,0,1,3680,51,3731,4602,0,0,0,0,0,0,81.07
臺北市,信義區,永春里,0,1,3641,55,3696,4475,0,0,0,0,0,0,82.59
臺北市,信義區,富台里,0,1,2493,46,2539,3158,0,0,0,0,0,0,80.40
臺北市,信義區,國業里,0,1,4281,78,4359,5371,0,0,0,0,0,0,81.16
臺北市,信義區,松隆里,0,1,1858,45,1903,2368,0,0,0,0,0,0,80.36
臺北市,信義區,松友里,0,1,4028,93,4121,5004,0,0,0,0,0,0,82.35
臺北市,信義區,松光里,0,1,3657,41,3698,4554,0,0,0,0,0,0,81.20
臺北市,信義區,中坡里,0,1,3060,56,3116,3751,0,0,0,0,0,0,83.07
臺北市,信義區,中行里,0,1,5112,105,5217,6252,0,0,0,0,0,0,83.45
臺北市,信義區,大道里,0,1,4201,92,4293,5244,0,0,0,0,0,0,81.86
臺北市,信義區,大仁里,0,1,3827,153,3980,4929,0,0,0,0,0,0,80.75
臺北市,信義區,景新里,0,1,3131,49,3180,3983,0,0,0,0,0,0,79.84
臺北市,信義區,惠安里,0,1,4460,98,4558,5505,0,0,0,0,0,0,82.80
臺北市,信義區,三張里,0,1,5776,94,5870,7322,0,0,0,0,0,0,80.17
臺北市,信義區,三犁里,0,1,3066,66,3132,3955,0,0,0,0,0,0,79.19
臺北市,信義區,六合里,0,1,4038,70,4108,5193,0,0,0,0,0,0,79.11
臺北市,信義區,泰和里,0,1,5212,115,5327,6619,0,0,0,0,0,0,80.48
臺北市,信義區,景聯里,0,1,3140,65,3205,3960,0,0,0,0,0,0,80.93
臺北市,信義區,景勤里,0,1,3116,59,3175,3909,0,0,0,0,0,0,81.22
臺北市,信義區,雙和里,0,1,4388,74,4462,5478,0,0,0,0,0,0,81.45
臺北市,信義區,嘉興里,0,1,2145,45,2190,2668,0,0,0,0,0,0,82.08
臺北市,信義區,黎順里,0,1,2790,48,2838,3566,0,0,0,0,0,0,79.58
臺北市,信義區,黎平里,0,1,4482,103,4585,5590,0,0,0,0,0,0,82.02
臺北市,信義區,黎忠里,0,1,3076,79,3155,3804,0,0,0,0,0,0,82.94
臺北市,信義區,黎安里,0,1,1914,59,1973,2473,0,0,0,0,0,0,79.78
臺北市,中山區,正守里,0,2,1936,37,1973,2513,0,0,0,0,0,0,78.51
臺北市,中山區,正義里,0,2,2552,84,2636,3526,0,0,0,0,0,0,74.76
臺北市,中山區,正得里,0,2,1841,34,1875,2565,0,0,0,0,0,0,73.10
臺北市,中山區,民安里,0,2,3065,62,3127,4110,0,0,0,0,0,0,76.08
臺北市,中山區,康樂里,0,2,1254,47,1301,1890,0,0,0,0,0,0,68.84
臺北市,中山區,中山里,0,2,2888,73,2961,3942,0,0,0,0,0,0,75.11
臺北市,中山區,聚盛里,0,2,2003,42,2045,2786,0,0,0,0,0,0,73.40
臺北市,中山區,集英里,0,2,3521,92,3613,4555,0,0,0,0,0,0,79.32
臺北市,中山區,聚葉里,0,2,2222,60,2282,3003,0,0,0,0,0,0,75.99
臺北市,中山區,恆安里,0,2,1749,50,1799,2477,0,0,0,0,0,0,72.63
臺北市,中山區,晴光里,0,2,2299,41,2340,3259,0,0,0,0,0,0,71.80
臺北市,中山區,圓山里,0,2,2747,84,2831,3726,0,0,0,0,0,0,75.98
臺北市,中山區,新庄里,0,2,3044,58,3102,3905,0,0,0,0,0,0,79.44
臺北市,中山區,劍潭里,0,2,1852,32,1884,2357,0,0,0,0,0,0,79.93
臺北市,中山區,大直里,0,2,6242,87,6329,7761,0,0,0,0,0,0,81.55
臺北市,中山區,成功里,0,2,3383,74,3457,4133,0,0,0,0,0,0,83.64
臺北市,中山區,永安里,0,2,4314,58,4372,5261,0,0,0,0,0,0,83.10
臺北市,中山區,大佳里,0,2,726,24,750,909,0,0,0,0,0,0,82.51
臺北市,中山區,新喜里,0,2,3187,64,3251,3955,0,0,0,0,0,0,82.20
臺北市,中山區,新福里,0,2,3151,95,3246,4110,0,0,0,0,0,0,78.98
臺北市,中山區,松江里,0,2,3943,69,4012,5056,0,0,0,0,0,0,79.35
臺北市,中山區,新生里,0,2,3017,73,3090,3911,0,0,0,0,0,0,79.01
臺北市,中山區,中庄里,0,2,3495,93,3588,4574,0,0,0,0,0,0,78.44
臺北市,中山區,行政里,0,2,3233,81,3314,4162,0,0,0,0,0,0,79.63
臺北市,中山區,行仁里,0,2,5242,114,5356,6474,0,0,0,0,0,0,82.73
臺北市,中山區,行孝里,0,2,2420,61,2481,3045,0,0,0,0,0,0,81.48
臺北市,中山區,下埤里,0,2,4455,95,4550,5573,0,0,0,0,0,0,81.64
臺北市,中山區,江寧里,0,2,4059,71,4130,5168,0,0,0,0,0,0,79.91
臺北市,中山區,江山里,0,2,4698,81,4779,5846,0,0,0,0,0,0,81.75
臺北市,中山區,中吉里,0,2,3176,60,3236,4207,0,0,0,0,0,0,76.92
臺北市,中山區,中原里,0,2,2864,68,2932,3813,0,0,0,0,0,0,76.89
臺北市,中山區,興亞里,0,2,3084,59,3143,4172,0,0,0,0,0,0,75.34
臺北市,中山區,中央里,0,2,2207,43,2250,2875,0,0,0,0,0,0,78.26
臺北市,中山區,朱馥里,0,2,3891,83,3974,5010,0,0,0,0,0,0,79.32
臺北市,中山區,龍洲里,0,2,3455,58,3513,4304,0,0,0,0,0,0,81.62
臺北市,中山區,朱園里,0,2,2663,50,2713,3418,0,0,0,0,0,0,79.37
臺北市,中山區,埤頭里,0,2,2669,46,2715,3431,0,0,0,0,0,0,79.13
臺北市,中山區,朱崙里,0,2,2054,38,2092,2635,0,0,0,0,0,0,79.39
臺北市,中山區,力行里,0,2,3848,64,3912,5032,0,0,0,0,0,0,77.74
臺北市,中山區,復華里,0,2,2284,60,2344,3010,0,0,0,0,0,0,77.87
臺北市,大同區,玉泉里,0,2,2462,49,2511,3262,0,0,0,0,0,0,76.98
臺北市,大同區,建明里,0,2,2373,50,2423,3096,0,0,0,0,0,0,78.26
臺北市,大同區,建功里,0,2,2563,56,2619,3243,0,0,0,0,0,0,80.76
臺北市,大同區,建泰里,0,2,2194,55,2249,2886,0,0,0,0,0,0,77.93
臺北市,大同區,永樂里,0,2,3240,50,3290,4139,0,0,0,0,0,0,79.49
臺北市,大同區,朝陽里,0,2,2340,46,2386,2975,0,0,0,0,0,0,80.20
臺北市,大同區,星明里,0,2,2844,75,2919,3584,0,0,0,0,0,0,81.45
臺北市,大同區,光能里,0,2,3439,91,3530,4262,0,0,0,0,0,0,82.82
臺北市,大同區,大有里,0,2,3281,63,3344,4055,0,0,0,0,0,0,82.47
臺北市,大同區,延平里,0,2,2407,60,2467,3141,0,0,0,0,0,0,78.54
臺北市,大同區,雙連里,0,2,5759,132,5891,7233,0,0,0,0,0,0,81.45
臺北市,大同區,南芳里,0,2,2573,49,2622,3269,0,0,0,0,0,0,80.21
臺北市,大同區,民權里,0,2,4149,107,4256,5351,0,0,0,0,0,0,79.54
臺北市,大同區,景星里,0,2,1945,53,1998,2451,0,0,0,0,0,0,81.52
臺北市,大同區,隆和里,0,2,2156,45,2201,2680,0,0,0,0,0,0,82.13
臺北市,大同區,蓬萊里,0,2,3051,72,3123,3877,0,0,0,0,0,0,80.55
臺北市,大同區,國順里,0,2,2873,74,2947,3532,0,0,0,0,0,0,83.44
臺北市,大同區,國慶里,0,2,1571,36,1607,1946,0,0,0,0,0,0,82.58
臺北市,大同區,揚雅里,0,2,2006,57,2063,2545,0,0,0,0,0,0,81.06
臺北市,大同區,斯文里,0,2,3553,84,3637,4454,0,0,0,0,0,0,81.66
臺北市,大同區,鄰江里,0,2,4204,97,4301,5146,0,0,0,0,0,0,83.58
臺北市,大同區,至聖里,0,2,5169,107,5276,6431,0,0,0,0,0,0,82.04
臺北市,大同區,文昌里,0,2,857,16,873,1026,0,0,0,0,0,0,85.09
臺北市,大同區,老師里,0,2,2909,67,2976,3673,0,0,0,0,0,0,81.02
臺北市,大同區,重慶里,0,2,2634,57,2691,3197,0,0,0,0,0,0,84.17
臺北市,大同區,保安里,0,2,3881,92,3973,4783,0,0,0,0,0,0,83.07
臺北市,中正區,水源里,0,2,2222,46,2268,2832,0,0,0,0,0,0,80.08
臺北市,中正區,富水里,0,2,1608,44,1652,2249,0,0,0,0,0,0,73.45
臺北市,中正區,文盛里,0,2,1692,30,1722,2189,0,0,0,0,0,0,78.67
臺北市,中正區,林興里,0,2,2976,61,3037,3822,0,0,0,0,0,0,79.46
臺北市,中正區,河堤里,0,2,2936,49,2985,3922,0,0,0,0,0,0,76.11
臺北市,中正區,頂東里,0,2,3562,56,3618,4547,0,0,0,0,0,0,79.57
臺北市,中正區,網溪里,0,2,3483,57,3540,4518,0,0,0,0,0,0,78.35
臺北市,中正區,板溪里,0,2,2176,46,2222,2823,0,0,0,0,0,0,78.71
臺北市,中正區,螢圃里,0,2,3382,59,3441,4232,0,0,0,0,0,0,81.31
臺北市,中正區,螢雪里,0,2,2881,54,2935,3637,0,0,0,0,0,0,80.70
臺北市,中正區,永功里,0,2,3499,92,3591,4392,0,0,0,0,0,0,81.76
臺北市,中正區,永昌里,0,2,2996,54,3050,3725,0,0,0,0,0,0,81.88
臺北市,中正區,龍興里,0,2,4307,89,4396,5439,0,0,0,0,0,0,80.82
臺北市,中正區,忠勤里,0,2,4659,143,4802,6021,0,0,0,0,0,0,79.75
臺北市,中正區,廈安里,0,2,2335,40,2375,2922,0,0,0,0,0,0,81.28
臺北市,中正區,愛國里,0,2,2062,31,2093,2660,0,0,0,0,0,0,78.68
臺北市,中正區,南門里,0,2,2365,39,2404,3049,0,0,0,0,0,0,78.85
臺北市,中正區,龍光里,0,2,2500,33,2533,3213,0,0,0,0,0,0,78.84
臺北市,中正區,南福里,0,2,4680,74,4754,5991,0,0,0,0,0,0,79.35
臺北市,中正區,龍福里,0,2,3610,64,3674,4582,0,0,0,0,0,0,80.18
臺北市,中正區,新營里,0,2,5013,70,5083,6172,0,0,0,0,0,0,82.36
臺北市,中正區,建國里,0,2,872,14,886,1293,0,0,0,0,0,0,68.52
臺北市,中正區,光復里,0,2,2112,47,2159,2942,0,0,0,0,0,0,73.39
臺北市,中正區,黎明里,0,2,1483,35,1518,2145,0,0,0,0,0,0,70.77
臺北市,中正區,梅花里,0,2,2272,54,2326,2956,0,0,0,0,0,0,78.69
臺北市,中正區,幸福里,0,2,2609,59,2668,3463,0,0,0,0,0,0,77.04
臺北市,中正區,幸市里,0,2,2618,38,2656,3549,0,0,0,0,0,0,74.84
臺北市,中正區,東門里,0,2,2345,51,2396,3088,0,0,0,0,0,0,77.59
臺北市,中正區,文北里,0,2,3003,50,3053,4027,0,0,0,0,0,0,75.81
臺北市,中正區,文祥里,0,2,4161,52,4213,5192,0,0,0,0,0,0,81.14
臺北市,中正區,三愛里,0,2,4564,72,4636,6043,0,0,0,0,0,0,76.72
臺北市,萬華區,福星里,0,2,2976,57,3033,3938,0,0,0,0,0,0,77.02
臺北市,萬華區,萬壽里,0,2,1839,37,1876,2629,0,0,0,0,0,0,71.36
臺北市,萬華區,西門里,0,2,2098,53,2151,2865,0,0,0,0,0,0,75.08
臺北市,萬華區,新起里,0,2,4403,129,4532,5658,0,0,0,0,0,0,80.10
臺北市,萬華區,菜園里,0,2,3653,71,3724,4612,0,0,0,0,0,0,80.75
臺北市,萬華區,青山里,0,2,3317,83,3400,4206,0,0,0,0,0,0,80.84
臺北市,萬華區,富民里,0,2,3315,56,3371,4164,0,0,0,0,0,0,80.96
臺北市,萬華區,福音里,0,2,2548,43,2591,3121,0,0,0,0,0,0,83.02
臺北市,萬華區,仁德里,0,2,2971,52,3023,3637,0,0,0,0,0,0,83.12
臺北市,萬華區,富福里,0,2,3186,48,3234,3876,0,0,0,0,0,0,83.44
臺北市,萬華區,糖廍里,0,2,5462,87,5549,6676,0,0,0,0,0,0,83.12
臺北市,萬華區,綠堤里,0,2,3289,78,3367,4111,0,0,0,0,0,0,81.90
臺北市,萬華區,華江里,0,2,2644,58,2702,3440,0,0,0,0,0,0,78.55
臺北市,萬華區,柳鄉里,0,2,5778,121,5899,7244,0,0,0,0,0,0,81.43
臺北市,萬華區,壽德里,0,2,2852,56,2908,3579,0,0,0,0,0,0,81.25
臺北市,萬華區,興德里,0,2,4833,113,4946,5985,0,0,0,0,0,0,82.64
臺北市,萬華區,華中里,0,2,3800,82,3882,4842,0,0,0,0,0,0,80.17
臺北市,萬華區,日祥里,0,2,5612,121,5733,7010,0,0,0,0,0,0,81.78
臺北市,萬華區,忠貞里,0,2,3664,100,3764,4623,0,0,0,0,0,0,81.42
臺北市,萬華區,凌霄里,0,2,2597,37,2634,3113,0,0,0,0,0,0,84.61
臺北市,萬華區,騰雲里,0,2,4374,87,4461,5523,0,0,0,0,0,0,80.77
臺北市,萬華區,忠德里,0,2,2929,62,2991,3636,0,0,0,0,0,0,82.26
臺北市,萬華區,孝德里,0,2,2176,43,2219,2682,0,0,0,0,0,0,82.74
臺北市,萬華區,和德里,0,2,4550,112,4662,5797,0,0,0,0,0,0,80.42
臺北市,萬華區,錦德里,0,2,3541,77,3618,4304,0,0,0,0,0,0,84.06
臺北市,萬華區,全德里,0,2,2552,48,2600,3206,0,0,0,0,0,0,81.10
臺北市,萬華區,保德里,0,2,2065,43,2108,2532,0,0,0,0,0,0,83.25
臺北市,萬華區,銘德里,0,2,3225,67,3292,3903,0,0,0,0,0,0,84.35
臺北市,萬華區,榮德里,0,2,2808,72,2880,3377,0,0,0,0,0,0,85.28
臺北市,萬華區,和平里,0,2,3346,47,3393,4043,0,0,0,0,0,0,83.92
臺北市,萬華區,日善里,0,2,3117,57,3174,3871,0,0,0,0,0,0,81.99
臺北市,萬華區,新安里,0,2,4293,87,4380,5220,0,0,0,0,0,0,83.91
臺北市,萬華區,頂碩里,0,2,3395,83,3478,4231,0,0,0,0,0,0,82.20
臺北市,萬華區,雙園里,0,2,3542,67,3609,4377,0,0,0,0,0,0,82.45
臺北市,萬華區,新忠里,0,2,2894,65,2959,3626,0,0,0,0,0,0,81.61
臺北市,萬華區,新和里,0,2,2039,31,2070,2563,0,0,0,0,0,0,80.76
臺北市,大安區,德安里,0,2,3226,58,3284,4451,0,0,0,0,0,0,73.78
臺北市,大安區,仁慈里,0,2,2735,34,2769,3711,0,0,0,0,0,0,74.62
臺北市,大安區,和安里,0,2,3938,64,4002,5118,0,0,0,0,0,0,78.19
臺北市,大安區,民炤里,0,2,4600,71,4671,6243,0,0,0,0,0,0,74.82
臺北市,大安區,仁愛里,0,2,3101,50,3151,4492,0,0,0,0,0,0,70.15
臺北市,大安區,義村里,0,2,4295,49,4344,5603,0,0,0,0,0,0,77.53
臺北市,大安區,民輝里,0,2,3515,63,3578,4724,0,0,0,0,0,0,75.74
臺北市,大安區,昌隆里,0,2,2419,34,2453,3243,0,0,0,0,0,0,75.64
臺北市,大安區,誠安里,0,2,2676,35,2711,3565,0,0,0,0,0,0,76.04
臺北市,大安區,光武里,0,2,4368,80,4448,6116,0,0,0,0,0,0,72.73
臺北市,大安區,龍坡里,0,2,3248,50,3298,4224,0,0,0,0,0,0,78.08
臺北市,大安區,龍泉里,0,2,2587,50,2637,3460,0,0,0,0,0,0,76.21
臺北市,大安區,古風里,0,2,2511,39,2550,3232,0,0,0,0,0,0,78.90
臺北市,大安區,古莊里,0,2,3840,75,3915,4953,0,0,0,0,0,0,79.04
臺北市,大安區,龍安里,0,2,2938,52,2990,3891,0,0,0,0,0,0,76.84
臺北市,大安區,錦安里,0,2,2859,36,2895,3729,0,0,0,0,0,0,77.63
臺北市,大安區,福住里,0,2,3029,42,3071,3891,0,0,0,0,0,0,78.93
臺北市,大安區,永康里,0,2,2004,23,2027,2559,0,0,0,0,0,0,79.21
臺北市,大安區,光明里,0,2,2216,27,2243,2817,0,0,0,0,0,0,79.62
臺北市,大安區,錦泰里,0,2,3214,44,3258,4025,0,0,0,0,0,0,80.94
臺北市,大安區,錦華里,0,2,3246,47,3293,4139,0,0,0,0,0,0,79.56
臺北市,大安區,龍圖里,0,2,4003,57,4060,5177,0,0,0,0,0,0,78.42
臺北市,大安區,新龍里,0,2,3871,49,3920,4934,0,0,0,0,0,0,79.45
臺北市,大安區,龍陣里,0,2,2292,28,2320,3017,0,0,0,0,0,0,76.90
臺北市,大安區,龍雲里,0,2,3146,47,3193,4037,0,0,0,0,0,0,79.09
臺北市,大安區,龍生里,0,2,3724,53,3777,4756,0,0,0,0,0,0,79.42
臺北市,大安區,住安里,0,2,3452,66,3518,4499,0,0,0,0,0,0,78.20
臺北市,大安區,義安里,0,2,3279,52,3331,4352,0,0,0,0,0,0,76.54
臺北市,大安區,通化里,0,2,3971,80,4051,4978,0,0,0,0,0,0,81.38
臺北市,大安區,通安里,0,2,3516,65,3581,4481,0,0,0,0,0,0,79.92
臺北市,大安區,臨江里,0,2,2801,87,2888,3560,0,0,0,0,0,0,81.12
臺北市,大安區,法治里,0,2,2664,47,2711,3411,0,0,0,0,0,0,79.48
臺北市,大安區,全安里,0,2,2616,31,2647,3423,0,0,0,0,0,0,77.33
臺北市,大安區,群賢里,0,2,3747,49,3796,4935,0,0,0,0,0,0,76.92
臺北市,大安區,群英里,0,2,4647,47,4694,5829,0,0,0,0,0,0,80.53
臺北市,大安區,虎嘯里,0,2,1950,27,1977,2595,0,0,0,0,0,0,76.18
臺北市,大安區,臥龍里,0,2,1929,32,1961,2487,0,0,0,0,0,0,78.85
臺北市,大安區,龍淵里,0,2,5277,58,5335,6788,0,0,0,0,0,0,78.59
臺北市,大安區,龍門里,0,2,2866,52,2918,3844,0,0,0,0,0,0,75.91
臺北市,大安區,農場里,0,2,1493,31,1524,2016,0,0,0,0,0,0,75.60
臺北市,大安區,大學里,0,2,4830,69,4899,6391,0,0,0,0,0,0,76.65
臺北市,大安區,芳和里,0,2,3858,68,3926,4829,0,0,0,0,0,0,81.30
臺北市,大安區,青峰里,0,2,1310,40,1350,1829,0,0,0,0,0,0,73.81
臺北市,大安區,黎元里,0,2,3547,85,3632,4431,0,0,0,0,0,0,81.97
臺北市,大安區,黎孝里,0,2,4772,73,4845,5950,0,0,0,0,0,0,81.43
臺北市,大安區,黎和里,0,2,2666,48,2714,3309,0,0,0,0,0,0,82.02
臺北市,大安區,建安里,0,2,2861,44,2905,3990,0,0,0,0,0,0,72.81
臺北市,大安區,建倫里,0,2,3378,54,3432,4666,0,0,0,0,0,0,73.55
臺北市,大安區,敦安里,0,2,3602,73,3675,4792,0,0,0,0,0,0,76.69
臺北市,大安區,正聲里,0,2,2810,54,2864,3778,0,0,0,0,0,0,75.81
臺北市,大安區,敦煌里,0,2,3534,53,3587,4599,0,0,0,0,0,0,78.00
臺北市,大安區,華聲里,0,2,2544,43,2587,3358,0,0,0,0,0,0,77.04
臺北市,大安區,車層里,0,2,3806,91,3897,5112,0,0,0,0,0,0,76.23
臺北市,大安區,光信里,0,2,4570,78,4648,5941,0,0,0,0,0,0,78.24
臺北市,文山區,景行里,0,2,3162,41,3203,3885,0,0,0,0,0,0,82.45
臺北市,文山區,景東里,0,2,3828,69,3897,4767,0,0,0,0,0,0,81.75
臺北市,文山區,景美里,0,2,2732,46,2778,3362,0,0,0,0,0,0,82.63
臺北市,文山區,景慶里,0,2,3857,64,3921,4783,0,0,0,0,0,0,81.98
臺北市,文山區,景仁里,0,2,2982,53,3035,3649,0,0,0,0,0,0,83.17
臺北市,文山區,景華里,0,2,3466,43,3509,4302,0,0,0,0,0,0,81.57
臺北市,文山區,萬有里,0,2,2920,39,2959,3527,0,0,0,0,0,0,83.90
臺北市,文山區,萬祥里,0,2,2891,60,2951,3528,0,0,0,0,0,0,83.65
臺北市,文山區,萬隆里,0,2,3516,41,3557,4331,0,0,0,0,0,0,82.13
臺北市,文山區,萬年里,0,2,3139,66,3205,4035,0,0,0,0,0,0,79.43
臺北市,文山區,萬和里,0,2,2359,51,2410,2867,0,0,0,0,0,0,84.06
臺北市,文山區,萬盛里,0,2,2966,48,3014,3758,0,0,0,0,0,0,80.20
臺北市,文山區,興豐里,0,2,4643,79,4722,5742,0,0,0,0,0,0,82.24
臺北市,文山區,興光里,0,2,2980,57,3037,3706,0,0,0,0,0,0,81.95
臺北市,文山區,興家里,0,2,3470,49,3519,4240,0,0,0,0,0,0,83.00
臺北市,文山區,興得里,0,2,3666,55,3721,4598,0,0,0,0,0,0,80.93
臺北市,文山區,興業里,0,2,3424,49,3473,4219,0,0,0,0,0,0,82.32
臺北市,文山區,興安里,0,2,3469,48,3517,4278,0,0,0,0,0,0,82.21
臺北市,文山區,興福里,0,2,3528,71,3599,4296,0,0,0,0,0,0,83.78
臺北市,文山區,興旺里,0,2,3580,69,3649,4462,0,0,0,0,0,0,81.78
臺北市,文山區,興泰里,0,2,2340,45,2385,2867,0,0,0,0,0,0,83.19
臺北市,文山區,興昌里,0,2,3291,53,3344,4076,0,0,0,0,0,0,82.04
臺北市,文山區,試院里,0,2,3823,64,3887,4747,0,0,0,0,0,0,81.88
臺北市,文山區,華興里,0,2,4160,82,4242,5237,0,0,0,0,0,0,81.00
臺北市,文山區,明義里,0,2,2628,109,2737,3588,0,0,0,0,0,0,76.28
臺北市,文山區,明興里,0,2,4171,87,4258,5189,0,0,0,0,0,0,82.06
臺北市,文山區,木柵里,0,2,4734,97,4831,5758,0,0,0,0,0,0,83.90
臺北市,文山區,木新里,0,2,5196,111,5307,6482,0,0,0,0,0,0,81.87
臺北市,文山區,順興里,0,2,6104,110,6214,7540,0,0,0,0,0,0,82.41
臺北市,文山區,樟林里,0,2,5264,83,5347,6457,0,0,0,0,0,0,82.81
臺北市,文山區,樟新里,0,2,6534,118,6652,8036,0,0,0,0,0,0,82.78
臺北市,文山區,樟腳里,0,2,5749,102,5851,7049,0,0,0,0,0,0,83.00
臺北市,文山區,萬芳里,0,2,6617,114,6731,8183,0,0,0,0,0,0,82.26
臺北市,文山區,博嘉里,0,2,2290,50,2340,2946,0,0,0,0,0,0,79.43
臺北市,文山區,萬興里,0,2,4872,100,4972,6150,0,0,0,0,0,0,80.85
臺北市,文山區,指南里,0,2,1626,46,1672,2026,0,0,0,0,0,0,82.53
臺北市,文山區,老泉里,0,2,518,12,530,621,0,0,0,0,0,0,85.35
高雄市,鹽埕區,藍橋里,0,1,803,20,823,1021,0,0,0,0,0,0,80.61
高雄市,鹽埕區,慈愛里,0,1,523,8,531,647,0,0,0,0,0,0,82.07
高雄市,鹽埕區,博愛里,0,1,804,19,823,957,0,0,0,0,0,0,86.00
高雄市,鹽埕區,壽星里,0,1,1049,16,1065,1334,0,0,0,0,0,0,79.84
高雄市,鹽埕區,中山里,0,1,1059,6,1065,1316,0,0,0,0,0,0,80.93
高雄市,鹽埕區,教仁里,0,1,1737,32,1769,2182,0,0,0,0,0,0,81.07
高雄市,鹽埕區,新樂里,0,1,665,9,674,839,0,0,0,0,0,0,80.33
高雄市,鹽埕區,中原里,0,1,583,11,594,732,0,0,0,0,0,0,81.15
高雄市,鹽埕區,光明里,0,1,890,19,909,1128,0,0,0,0,0,0,80.59
高雄市,鹽埕區,育仁里,0,1,697,9,706,896,0,0,0,0,0,0,78.79
高雄市,鹽埕區,河濱里,0,1,1447,20,1467,1889,0,0,0,0,0,0,77.66
高雄市,鹽埕區,沙地里,0,1,838,15,853,1110,0,0,0,0,0,0,76.85
高雄市,鹽埕區,南端里,0,1,882,19,901,1166,0,0,0,0,0,0,77.27
高雄市,鹽埕區,港都里,0,1,903,21,924,1162,0,0,0,0,0,0,79.52
高雄市,鹽埕區,江西里,0,1,975,11,986,1248,0,0,0,0,0,0,79.01
高雄市,鹽埕區,新豐里,0,1,570,13,583,678,0,0,0,0,0,0,85.99
高雄市,鹽埕區,府北里,0,1,1267,28,1295,1692,0,0,0,0,0,0,76.54
高雄市,鹽埕區,陸橋里,0,1,1069,12,1081,1338,0,0,0,0,0,0,80.79
高雄市,鹽埕區,瀨南里,0,1,581,11,592,730,0,0,0,0,0,0,81.10
高雄市,鹽埕區,新化里,0,1,649,17,666,853,0,0,0,0,0,0,78.08
高雄市,鹽埕區,江南里,0,1,740,10,750,941,0,0,0,0,0,0,79.70
高雄市,鼓山區,鼓峰里,0,1,1573,30,1603,2022,0,0,0,0,0,0,79.28
高雄市,鼓山區,雄峰里,0,1,1590,31,1621,2026,0,0,0,0,0,0,80.01
高雄市,鼓山區,前峰里,0,1,3335,36,3371,4052,0,0,0,0,0,0,83.19
高雄市,鼓山區,光榮里,0,1,3279,50,3329,4023,0,0,0,0,0,0,82.75
高雄市,鼓山區,民族里,0,1,1133,25,1158,1417,0,0,0,0,0,0,81.72
高雄市,鼓山區,內惟里,0,1,1037,22,1059,1285,0,0,0,0,0,0,82.41
高雄市,鼓山區,建國里,0,1,1634,35,1669,2040,0,0,0,0,0,0,81.81
高雄市,鼓山區,忠正里,0,1,3712,81,3793,4730,0,0,0,0,0,0,80.19
高雄市,鼓山區,自強里,0,1,670,11,681,857,0,0,0,0,0,0,79.46
高雄市,鼓山區,龍井里,0,1,1264,19,1283,1584,0,0,0,0,0,0,81.00
高雄市,鼓山區,正德里,0,1,1405,30,1435,1751,0,0,0,0,0,0,81.95
高雄市,鼓山區,平和里,0,1,2374,38,2412,2911,0,0,0,0,0,0,82.86
高雄市,鼓山區,民強里,0,1,1711,34,1745,2036,0,0,0,0,0,0,85.71
高雄市,鼓山區,厚生里,0,1,1612,27,1639,1990,0,0,0,0,0,0,82.36
高雄市,鼓山區,龍子里,0,1,3589,75,3664,4742,0,0,0,0,0,0,77.27
高雄市,鼓山區,龍水里,0,1,942,22,964,1268,0,0,0,0,0,0,76.03
高雄市,鼓山區,明誠里,0,1,5841,87,5928,7594,0,0,0,0,0,0,78.06
高雄市,鼓山區,華豐里,0,1,2753,37,2790,3453,0,0,0,0,0,0,80.80
高雄市,鼓山區,裕興里,0,1,1729,29,1758,2201,0,0,0,0,0,0,79.87
高雄市,鼓山區,裕豐里,0,1,1776,23,1799,2248,0,0,0,0,0,0,80.03
高雄市,鼓山區,鼓岩里,0,1,1322,32,1354,1678,0,0,0,0,0,0,80.69
高雄市,鼓山區,樹德里,0,1,891,15,906,1083,0,0,0,0,0,0,83.66
高雄市,鼓山區,寶樹里,0,1,735,17,752,935,0,0,0,0,0,0,80.43
高雄市,鼓山區,興宗里,0,1,1316,21,1337,1617,0,0,0,0,0,0,82.68
高雄市,鼓山區,光化里,0,1,1242,25,1267,1607,0,0,0,0,0,0,78.84
高雄市,鼓山區,山下里,0,1,1411,31,1442,1782,0,0,0,0,0,0,80.92
高雄市,鼓山區,河邊里,0,1,1204,22,1226,1523,0,0,0,0,0,0,80.50
高雄市,鼓山區,綠川里,0,1,1389,32,1421,1744,0,0,0,0,0,0,81.48
高雄市,鼓山區,登山里,0,1,640,6,646,815,0,0,0,0,0,0,79.26
高雄市,鼓山區,峰南里,0,1,908,18,926,1146,0,0,0,0,0,0,80.80
高雄市,鼓山區,麗興里,0,1,936,17,953,1211,0,0,0,0,0,0,78.70
高雄市,鼓山區,新民里,0,1,974,21,995,1237,0,0,0,0,0,0,80.44
高雄市,鼓山區,延平里,0,1,810,15,825,1077,0,0,0,0,0,0,76.60
高雄市,鼓山區,維生里,0,1,1213,27,1240,1579,0,0,0,0,0,0,78.53
高雄市,鼓山區,惠安里,0,1,1112,26,1138,1436,0,0,0,0,0,0,79.25
高雄市,鼓山區,壽山里,0,1,1233,47,1280,1670,0,0,0,0,0,0,76.65
高雄市,鼓山區,哨船頭里,0,1,1013,16,1029,1282,0,0,0,0,0,0,80.27
高雄市,鼓山區,桃源里,0,1,623,9,632,773,0,0,0,0,0,0,81.76
高雄市,左營區,進學里,0,1,1313,33,1346,1707,0,0,0,0,0,0,78.85
高雄市,左營區,尾西里,0,1,1043,24,1067,1283,0,0,0,0,0,0,83.16
高雄市,左營區,頂北里,0,1,552,6,558,661,0,0,0,0,0,0,84.42
高雄市,左營區,中北里,0,1,585,9,594,700,0,0,0,0,0,0,84.86
高雄市,左營區,中南里,0,1,543,10,553,652,0,0,0,0,0,0,84.82
高雄市,左營區,廟東里,0,1,843,14,857,984,0,0,0,0,0,0,87.09
高雄市,左營區,廟北里,0,1,912,28,940,1083,0,0,0,0,0,0,86.80
高雄市,左營區,尾南里,0,1,883,15,898,1034,0,0,0,0,0,0,86.85
高雄市,左營區,尾北里,0,1,1996,36,2032,2463,0,0,0,0,0,0,82.50
高雄市,左營區,海光里,0,1,1340,27,1367,1670,0,0,0,0,0,0,81.86
高雄市,左營區,屏山里,0,1,1349,30,1379,1727,0,0,0,0,0,0,79.85
高雄市,左營區,祥和里,0,1,614,15,629,745,0,0,0,0,0,0,84.43
高雄市,左營區,永清里,0,1,1722,47,1769,2206,0,0,0,0,0,0,80.19
高雄市,左營區,復興里,0,1,1037,19,1056,1320,0,0,0,0,0,0,80.00
高雄市,左營區,莒光里,0,1,1348,16,1364,1685,0,0,0,0,0,0,80.95
高雄市,左營區,光輝里,0,1,2035,37,2072,2530,0,0,0,0,0,0,81.90
高雄市,左營區,合群里,0,1,1032,11,1043,1350,0,0,0,0,0,0,77.26
高雄市,左營區,自治里,0,1,1484,27,1511,1896,0,0,0,0,0,0,79.69
高雄市,左營區,明建里,0,1,1142,24,1166,1497,0,0,0,0,0,0,77.89
高雄市,左營區,自立里,0,1,766,11,777,973,0,0,0,0,0,0,79.86
高雄市,左營區,頂西里,0,1,1136,8,1144,1340,0,0,0,0,0,0,85.37
高雄市,左營區,聖后里,0,1,799,20,819,1014,0,0,0,0,0,0,80.77
高雄市,左營區,聖西里,0,1,383,6,389,464,0,0,0,0,0,0,83.84
高雄市,左營區,聖南里,0,1,481,3,484,558,0,0,0,0,0,0,86.74
高雄市,左營區,城南里,0,1,509,6,515,648,0,0,0,0,0,0,79.48
高雄市,左營區,路東里,0,1,667,14,681,810,0,0,0,0,0,0,84.07
高雄市,左營區,部北里,0,1,468,5,473,555,0,0,0,0,0,0,85.23
高雄市,左營區,部南里,0,1,636,13,649,774,0,0,0,0,0,0,83.85
高雄市,左營區,埤西里,0,1,1005,15,1020,1221,0,0,0,0,0,0,83.54
高雄市,左營區,埤北里,0,1,1162,25,1187,1546,0,0,0,0,0,0,76.78
高雄市,左營區,埤東里,0,1,1156,25,1181,1458,0,0,0,0,0,0,81.00
高雄市,左營區,海勝里,0,1,1107,20,1127,1365,0,0,0,0,0,0,82.56
高雄市,左營區,自勉里,0,1,1429,36,1465,1777,0,0,0,0,0,0,82.44
高雄市,左營區,崇實里,0,1,915,10,925,1166,0,0,0,0,0,0,79.33
高雄市,左營區,自助里,0,1,1958,22,1980,2523,0,0,0,0,0,0,78.48
高雄市,左營區,果貿里,0,1,1677,20,1697,2092,0,0,0,0,0,0,81.12
高雄市,左營區,果惠里,0,1,1225,17,1242,1601,0,0,0,0,0,0,77.58
高雄市,左營區,果峰里,0,1,1436,32,1468,1849,0,0,0,0,0,0,79.39
高雄市,左營區,新下里,0,1,5099,71,5170,6371,0,0,0,0,0,0,81.15
高雄市,左營區,新上里,0,1,10147,179,10326,13484,0,0,0,0,0,0,76.58
高雄市,左營區,新中里,0,1,3320,70,3390,4110,0,0,0,0,0,0,82.48
高雄市,左營區,新光里,0,1,4494,63,4557,5716,0,0,0,0,0,0,79.72
高雄市,左營區,菜公里,0,1,6850,162,7012,8924,0,0,0,0,0,0,78.57
高雄市,左營區,福山里,0,1,7469,138,7607,10076,0,0,0,0,0,0,75.50
高雄市,楠梓區,清豐里,0,1,5416,119,5535,6865,0,0,0,0,0,0,80.63
高雄市,楠梓區,東寧里,0,1,1740,31,1771,2157,0,0,0,0,0,0,82.10
高雄市,楠梓區,五常里,0,1,2848,67,2915,3652,0,0,0,0,0,0,79.82
高雄市,楠梓區,享平里,0,1,1918,26,1944,2330,0,0,0,0,0,0,83.43
高雄市,楠梓區,中陽里,0,1,2013,41,2054,2524,0,0,0,0,0,0,81.38
高雄市,楠梓區,惠楠里,0,1,1734,38,1772,2201,0,0,0,0,0,0,80.51
高雄市,楠梓區,惠民里,0,1,2300,42,2342,2858,0,0,0,0,0,0,81.95
高雄市,楠梓區,惠豐里,0,1,1763,33,1796,2179,0,0,0,0,0,0,82.42
高雄市,楠梓區,錦屏里,0,1,2682,46,2728,3191,0,0,0,0,0,0,85.49
高雄市,楠梓區,玉屏里,0,1,1834,38,1872,2132,0,0,0,0,0,0,87.80
高雄市,楠梓區,金田里,0,1,2444,50,2494,2937,0,0,0,0,0,0,84.92
高雄市,楠梓區,稔田里,0,1,1283,27,1310,1557,0,0,0,0,0,0,84.14
高雄市,楠梓區,瑞屏里,0,1,2364,49,2413,2882,0,0,0,0,0,0,83.73
高雄市,楠梓區,翠屏里,0,1,7504,141,7645,9748,0,0,0,0,0,0,78.43
高雄市,楠梓區,宏南里,0,1,1315,19,1334,1651,0,0,0,0,0,0,80.80
高雄市,楠梓區,宏毅里,0,1,2444,34,2478,2983,0,0,0,0,0,0,83.07
高雄市,楠梓區,宏榮里,0,1,1216,15,1231,1464,0,0,0,0,0,0,84.08
高雄市,楠梓區,廣昌里,0,1,2328,52,2380,2850,0,0,0,0,0,0,83.51
高雄市,楠梓區,久昌里,0,1,1632,37,1669,2051,0,0,0,0,0,0,81.37
高雄市,楠梓區,大昌里,0,1,1687,33,1720,2078,0,0,0,0,0,0,82.77
高雄市,楠梓區,福昌里,0,1,1442,16,1458,1751,0,0,0,0,0,0,83.27
高雄市,楠梓區,盛昌里,0,1,2190,42,2232,2674,0,0,0,0,0,0,83.47
高雄市,楠梓區,泰昌里,0,1,1208,27,1235,1456,0,0,0,0,0,0,84.82
高雄市,楠梓區,興昌里,0,1,1879,32,1911,2324,0,0,0,0,0,0,82.23
高雄市,楠梓區,建昌里,0,1,1816,20,1836,2216,0,0,0,0,0,0,82.85
高雄市,楠梓區,宏昌里,0,1,1482,20,1502,1794,0,0,0,0,0,0,83.72
高雄市,楠梓區,和昌里,0,1,1692,24,1716,2047,0,0,0,0,0,0,83.83
高雄市,楠梓區,慶昌里,0,1,2290,45,2335,2781,0,0,0,0,0,0,83.96
高雄市,楠梓區,隆昌里,0,1,2603,46,2649,3150,0,0,0,0,0,0,84.10
高雄市,楠梓區,秀昌里,0,1,1451,35,1486,1793,0,0,0,0,0,0,82.88
高雄市,楠梓區,裕昌里,0,1,1594,30,1624,1947,0,0,0,0,0,0,83.41
高雄市,楠梓區,國昌里,0,1,1895,40,1935,2375,0,0,0,0,0,0,81.47
高雄市,楠梓區,加昌里,0,1,3777,55,3832,4702,0,0,0,0,0,0,81.50
高雄市,楠梓區,仁昌里,0,1,2129,47,2176,2724,0,0,0,0,0,0,79.88
高雄市,楠梓區,藍田里,0,1,796,12,808,910,0,0,0,0,0,0,88.79
高雄市,楠梓區,中興里,0,1,698,3,701,830,0,0,0,0,0,0,84.46
高雄市,楠梓區,中和里,0,1,1239,23,1262,1480,0,0,0,0,0,0,85.27
高雄市,三民區,鼎金里,0,1,2182,51,2233,2772,0,0,0,0,0,0,80.56
高雄市,三民區,鼎盛里,0,1,2539,40,2579,3144,0,0,0,0,0,0,82.03
高雄市,三民區,鼎強里,0,1,3667,66,3733,4582,0,0,0,0,0,0,81.47
高雄市,三民區,鼎力里,0,1,2366,49,2415,3037,0,0,0,0,0,0,79.52
高雄市,三民區,鼎西里,0,1,2858,55,2913,3602,0,0,0,0,0,0,80.87
高雄市,三民區,鼎中里,0,1,2477,42,2519,2969,0,0,0,0,0,0,84.84
高雄市,三民區,鼎泰里,0,1,8429,122,8551,11100,0,0,0,0,0,0,77.04
高雄市,三民區,本館里,0,1,4955,98,5053,6187,0,0,0,0,0,0,81.67
高雄市,三民區,本和里,0,1,3654,67,3721,4493,0,0,0,0,0,0,82.82
高雄市,三民區,本文里,0,1,1568,29,1597,1933,0,0,0,0,0,0,82.62
高雄市,三民區,本武里,0,1,1195,24,1219,1492,0,0,0,0,0,0,81.70
高雄市,三民區,本元里,0,1,3115,44,3159,3943,0,0,0,0,0,0,80.12
高雄市,三民區,本安里,0,1,2542,49,2591,3133,0,0,0,0,0,0,82.70
高雄市,三民區,本上里,0,1,2725,51,2776,3465,0,0,0,0,0,0,80.12
高雄市,三民區,本揚里,0,1,4301,62,4363,5451,0,0,0,0,0,0,80.04
高雄市,三民區,寶獅里,0,1,2463,36,2499,3141,0,0,0,0,0,0,79.56
高雄市,三民區,寶德里,0,1,2958,49,3007,3792,0,0,0,0,0,0,79.30
高雄市,三民區,寶泰里,0,1,1942,25,1967,2458,0,0,0,0,0,0,80.02
高雄市,三民區,寶興里,0,1,3894,75,3969,4894,0,0,0,0,0,0,81.10
高雄市,三民區,寶中里,0,1,2029,31,2060,2479,0,0,0,0,0,0,83.10
高雄市,三民區,寶華里,0,1,1851,29,1880,2361,0,0,0,0,0,0,79.63
高雄市,三民區,寶國里,0,1,3769,55,3824,4743,0,0,0,0,0,0,80.62
高雄市,三民區,寶民里,0,1,1699,31,1730,2136,0,0,0,0,0,0,80.99
高雄市,三民區,寶慶里,0,1,1728,39,1767,2184,0,0,0,0,0,0,80.91
高雄市,三民區,寶業里,0,1,2622,44,2666,3394,0,0,0,0,0,0,78.55
高雄市,三民區,寶盛里,0,1,2740,49,2789,3529,0,0,0,0,0,0,79.03
高雄市,三民區,寶安里,0,1,3441,58,3499,4395,0,0,0,0,0,0,79.61
高雄市,三民區,寶龍里,0,1,2742,61,2803,3417,0,0,0,0,0,0,82.03
高雄市,三民區,寶珠里,0,1,3357,83,3440,4306,0,0,0,0,0,0,79.89
高雄市,三民區,寶玉里,0,1,4133,66,4199,5234,0,0,0,0,0,0,80.23
高雄市,三民區,灣子里,0,1,2130,37,2167,2787,0,0,0,0,0,0,77.75
高雄市,三民區,灣愛里,0,1,1839,39,1878,2424,0,0,0,0,0,0,77.48
高雄市,三民區,灣中里,0,1,3078,66,3144,3975,0,0,0,0,0,0,79.09
高雄市,三民區,灣華里,0,1,1854,41,1895,2322,0,0,0,0,0,0,81.61
高雄市,三民區,灣勝里,0,1,1547,27,1574,1942,0,0,0,0,0,0,81.05
高雄市,三民區,灣利里,0,1,2736,49,2785,3330,0,0,0,0,0,0,83.63
高雄市,三民區,灣復里,0,1,2089,30,2119,2750,0,0,0,0,0,0,77.05
高雄市,三民區,正興里,0,1,5160,83,5243,6743,0,0,0,0,0,0,77.75
高雄市,三民區,正順里,0,1,2368,39,2407,3028,0,0,0,0,0,0,79.49
高雄市,三民區,灣興里,0,1,1164,17,1181,1465,0,0,0,0,0,0,80.61
高雄市,三民區,灣成里,0,1,1239,15,1254,1550,0,0,0,0,0,0,80.90
高雄市,三民區,安康里,0,1,2341,47,2388,3066,0,0,0,0,0,0,77.89
高雄市,三民區,安寧里,0,1,1741,39,1780,2207,0,0,0,0,0,0,80.65
高雄市,三民區,安吉里,0,1,2690,36,2726,3565,0,0,0,0,0,0,76.47
高雄市,三民區,安發里,0,1,2949,63,3012,3752,0,0,0,0,0,0,80.28
高雄市,三民區,安東里,0,1,2501,39,2540,3160,0,0,0,0,0,0,80.38
高雄市,三民區,安和里,0,1,2067,44,2111,2612,0,0,0,0,0,0,80.82
高雄市,三民區,達德里,0,1,1240,24,1264,1542,0,0,0,0,0,0,81.97
高雄市,三民區,達明里,0,1,1336,26,1362,1687,0,0,0,0,0,0,80.74
高雄市,三民區,達仁里,0,1,1165,12,1177,1479,0,0,0,0,0,0,79.58
高雄市,三民區,達勇里,0,1,917,15,932,1109,0,0,0,0,0,0,84.04
高雄市,三民區,同德里,0,1,2161,37,2198,2793,0,0,0,0,0,0,78.70
高雄市,三民區,德智里,0,1,1797,36,1833,2311,0,0,0,0,0,0,79.32
高雄市,三民區,德仁里,0,1,1461,32,1493,1879,0,0,0,0,0,0,79.46
高雄市,三民區,安生里,0,1,1378,26,1404,1774,0,0,0,0,0,0,79.14
高雄市,三民區,德東里,0,1,707,18,725,908,0,0,0,0,0,0,79.85
高雄市,三民區,德行里,0,1,949,14,963,1188,0,0,0,0,0,0,81.06
高雄市,三民區,精華里,0,1,1362,17,1379,1730,0,0,0,0,0,0,79.71
高雄市,三民區,民享里,0,1,1663,32,1695,2051,0,0,0,0,0,0,82.64
高雄市,三民區,安宜里,0,1,2550,52,2602,3162,0,0,0,0,0,0,82.29
高雄市,三民區,安泰里,0,1,3105,56,3161,3942,0,0,0,0,0,0,80.19
高雄市,三民區,安邦里,0,1,2704,44,2748,3441,0,0,0,0,0,0,79.86
高雄市,三民區,十全里,0,1,1134,24,1158,1426,0,0,0,0,0,0,81.21
高雄市,三民區,十美里,0,1,1397,31,1428,1751,0,0,0,0,0,0,81.55
高雄市,三民區,德北里,0,1,1745,37,1782,2228,0,0,0,0,0,0,79.98
高雄市,三民區,立誠里,0,1,803,13,816,1011,0,0,0,0,0,0,80.71
高雄市,三民區,立業里,0,1,927,23,950,1129,0,0,0,0,0,0,84.15
高雄市,三民區,港東里,0,1,1005,16,1021,1310,0,0,0,0,0,0,77.94
高雄市,三民區,港新里,0,1,1088,19,1107,1481,0,0,0,0,0,0,74.75
高雄市,三民區,港西里,0,1,640,13,653,886,0,0,0,0,0,0,73.70
高雄市,三民區,港北里,0,1,445,8,453,547,0,0,0,0,0,0,82.82
高雄市,三民區,博愛里,0,1,862,20,882,1167,0,0,0,0,0,0,75.58
高雄市,三民區,博惠里,0,1,2989,54,3043,3886,0,0,0,0,0,0,78.31
高雄市,三民區,長明里,0,1,944,20,964,1230,0,0,0,0,0,0,78.37
高雄市,三民區,建東里,0,1,598,11,609,864,0,0,0,0,0,0,70.49
高雄市,三民區,興德里,0,1,992,12,1004,1299,0,0,0,0,0,0,77.29
高雄市,三民區,鳳南里,0,1,964,21,985,1207,0,0,0,0,0,0,81.61
高雄市,三民區,鳳北里,0,1,1693,30,1723,2117,0,0,0,0,0,0,81.39
高雄市,三民區,德西里,0,1,1031,29,1060,1282,0,0,0,0,0,0,82.68
高雄市,三民區,九如里,0,1,342,8,350,451,0,0,0,0,0,0,77.61
高雄市,三民區,豐裕里,0,1,2217,46,2263,2755,0,0,0,0,0,0,82.14
高雄市,三民區,川東里,0,1,1494,36,1530,1926,0,0,0,0,0,0,79.44
高雄市,三民區,裕民里,0,1,713,21,734,863,0,0,0,0,0,0,85.05
高雄市,三民區,力行里,0,1,998,15,1013,1185,0,0,0,0,0,0,85.49
高雄市,三民區,千歲里,0,1,926,26,952,1171,0,0,0,0,0,0,81.30
高雄市,三民區,立德里,0,1,1017,23,1040,1328,0,0,0,0,0,0,78.31
高雄市,三民區,千北里,0,1,1099,24,1123,1419,0,0,0,0,0,0,79.14
高雄市,三民區,千秋里,0,1,1872,41,1913,2377,0,0,0,0,0,0,80.48
高雄市,旗津區,旗下里,0,1,1092,28,1120,1357,0,0,0,0,0,0,82.54
高雄市,旗津區,永安里,0,1,844,26,870,1128,0,0,0,0,0,0,77.13
高雄市,旗津區,振興里,0,1,1348,25,1373,1779,0,0,0,0,0,0,77.18
高雄市,旗津區,慈愛里,0,1,1570,73,1643,2040,0,0,0,0,0,0,80.54
高雄市,旗津區,復興里,0,1,2019,47,2066,2537,0,0,0,0,0,0,81.43
高雄市,旗津區,中華里,0,1,1022,19,1041,1260,0,0,0,0,0,0,82.62
高雄市,旗津區,實踐里,0,1,969,29,998,1328,0,0,0,0,0,0,75.15
高雄市,旗津區,北汕里,0,1,1830,50,1880,2359,0,0,0,0,0,0,79.69
高雄市,旗津區,南汕里,0,1,1344,30,1374,1692,0,0,0,0,0,0,81.21
高雄市,旗津區,上竹里,0,1,1927,56,1983,2421,0,0,0,0,0,0,81.91
高雄市,旗津區,中洲里,0,1,1352,34,1386,1651,0,0,0,0,0,0,83.95
高雄市,旗津區,安順里,0,1,926,16,942,1183,0,0,0,0,0,0,79.63
高雄市,旗津區,中興里,0,1,1632,44,1676,1940,0,0,0,0,0,0,86.39
高雄市,新興區,浩然里,0,2,1578,33,1611,2087,0,0,0,0,0,0,77.19
高雄市,新興區,振成里,0,2,907,13,920,1224,0,0,0,0,0,0,75.16
高雄市,新興區,德生里,0,2,1569,17,1586,2092,0,0,0,0,0,0,75.81
高雄市,新興區,振華里,0,2,989,16,1005,1301,0,0,0,0,0,0,77.25
高雄市,新興區,正氣里,0,2,1222,26,1248,1583,0,0,0,0,0,0,78.84
高雄市,新興區,德政里,0,2,589,12,601,772,0,0,0,0,0,0,77.85
高雄市,新興區,仁聲里,0,2,583,6,589,766,0,0,0,0,0,0,76.89
高雄市,新興區,德望里,0,2,1361,27,1388,1855,0,0,0,0,0,0,74.82
高雄市,新興區,華聲里,0,2,784,12,796,1036,0,0,0,0,0,0,76.83
高雄市,新興區,蕉園里,0,2,605,9,614,756,0,0,0,0,0,0,81.22
高雄市,新興區,永寧里,0,2,1126,16,1142,1458,0,0,0,0,0,0,78.33
高雄市,新興區,玉衡里,0,2,838,13,851,1049,0,0,0,0,0,0,81.12
高雄市,新興區,順昌里,0,2,1683,32,1715,2185,0,0,0,0,0,0,78.49
高雄市,新興區,文昌里,0,2,1643,18,1661,2148,0,0,0,0,0,0,77.33
高雄市,新興區,光耀里,0,2,1945,20,1965,2507,0,0,0,0,0,0,78.38
高雄市,新興區,興昌里,0,2,701,8,709,883,0,0,0,0,0,0,80.29
高雄市,新興區,南港里,0,2,732,5,737,914,0,0,0,0,0,0,80.63
高雄市,新興區,開平里,0,2,2044,30,2074,2561,0,0,0,0,0,0,80.98
高雄市,新興區,成功里,0,2,920,14,934,1210,0,0,0,0,0,0,77.19
高雄市,新興區,新江里,0,2,895,11,906,1214,0,0,0,0,0,0,74.63
高雄市,新興區,黎明里,0,2,682,16,698,910,0,0,0,0,0,0,76.70
高雄市,新興區,愛平里,0,2,747,15,762,951,0,0,0,0,0,0,80.13
高雄市,新興區,南港里,0,2,1803,23,1826,2303,0,0,0,0,0,0,79.29
高雄市,新興區,中東里,0,2,1726,24,1750,2412,0,0,0,0,0,0,72.55
高雄市,新興區,明莊里,0,2,690,20,710,893,0,0,0,0,0,0,79.51
高雄市,新興區,大明里,0,2,937,12,949,1197,0,0,0,0,0,0,79.28
高雄市,新興區,秋山里,0,2,933,16,949,1187,0,0,0,0,0,0,79.95
高雄市,新興區,長驛里,0,2,655,8,663,840,0,0,0,0,0,0,78.93
高雄市,新興區,建興里,0,2,689,16,705,873,0,0,0,0,0,0,80.76
高雄市,新興區,建華里,0,2,777,9,786,1015,0,0,0,0,0,0,77.44
高雄市,新興區,漢民里,0,2,762,16,778,935,0,0,0,0,0,0,83.21
高雄市,新興區,榮治里,0,2,662,14,676,819,0,0,0,0,0,0,82.54
高雄市,新興區,東坡里,0,2,1130,15,1145,1407,0,0,0,0,0,0,81.38
高雄市,前金區,三川里,0,2,657,17,674,854,0,0,0,0,0,0,78.92
高雄市,前金區,草江里,0,2,926,15,941,1204,0,0,0,0,0,0,78.16
高雄市,前金區,長城里,0,2,1170,15,1185,1492,0,0,0,0,0,0,79.42
高雄市,前金區,北金里,0,2,666,14,680,858,0,0,0,0,0,0,79.25
高雄市,前金區,東金里,0,2,688,18,706,949,0,0,0,0,0,0,74.39
高雄市,前金區,新生里,0,2,2341,45,2386,3098,0,0,0,0,0,0,77.02
高雄市,前金區,後金里,0,2,822,15,837,1047,0,0,0,0,0,0,79.94
高雄市,前金區,長興里,0,2,832,8,840,1120,0,0,0,0,0,0,75.00
高雄市,前金區,青山里,0,2,988,19,1007,1313,0,0,0,0,0,0,76.69
高雄市,前金區,民生里,0,2,558,12,570,742,0,0,0,0,0,0,76.82
高雄市,前金區,復元里,0,2,753,10,763,1014,0,0,0,0,0,0,75.25
高雄市,前金區,林投里,0,2,1014,26,1040,1292,0,0,0,0,0,0,80.50
高雄市,前金區,國民里,0,2,941,10,951,1189,0,0,0,0,0,0,79.98
高雄市,前金區,社東里,0,2,1434,21,1455,1789,0,0,0,0,0,0,81.33
高雄市,前金區,社西里,0,2,824,26,850,1060,0,0,0,0,0,0,80.19
高雄市,前金區,博孝里,0,2,781,8,789,1018,0,0,0,0,0,0,77.50
高雄市,前金區,長生里,0,2,1207,18,1225,1633,0,0,0,0,0,0,75.02
高雄市,前金區,榮復里,0,2,1069,16,1085,1363,0,0,0,0,0,0,79.60
高雄市,前金區,文西里,0,2,884,11,895,1158,0,0,0,0,0,0,77.29
高雄市,前金區,文東里,0,2,1163,17,1180,1475,0,0,0,0,0,0,80.00
高雄市,苓雅區,博仁里,0,2,598,11,609,754,0,0,0,0,0,0,80.77
高雄市,苓雅區,苓洲里,0,2,1029,18,1047,1353,0,0,0,0,0,0,77.38
高雄市,苓雅區,苓昇里,0,2,1123,37,1160,1439,0,0,0,0,0,0,80.61
高雄市,苓雅區,苓中里,0,2,1237,26,1263,1556,0,0,0,0,0,0,81.17
高雄市,苓雅區,苓雅里,0,2,1048,20,1068,1372,0,0,0,0,0,0,77.84
高雄市,苓雅區,苓東里,0,2,1162,28,1190,1504,0,0,0,0,0,0,79.12
高雄市,苓雅區,城北里,0,2,1190,24,1214,1533,0,0,0,0,0,0,79.19
高雄市,苓雅區,城西里,0,2,566,10,576,692,0,0,0,0,0,0,83.24
高雄市,苓雅區,城東里,0,2,1376,19,1395,1750,0,0,0,0,0,0,79.71
高雄市,苓雅區,意誠里,0,2,1364,31,1395,1856,0,0,0,0,0,0,75.16
高雄市,苓雅區,鼓中里,0,2,1074,14,1088,1294,0,0,0,0,0,0,84.08
高雄市,苓雅區,田西里,0,2,1189,17,1206,1481,0,0,0,0,0,0,81.43
高雄市,苓雅區,人和里,0,2,1415,25,1440,1827,0,0,0,0,0,0,78.82
高雄市,苓雅區,仁政里,0,2,1262,34,1296,1688,0,0,0,0,0,0,76.78
高雄市,苓雅區,廣澤里,0,2,1527,33,1560,1933,0,0,0,0,0,0,80.70
高雄市,苓雅區,美田里,0,2,968,17,985,1238,0,0,0,0,0,0,79.56
高雄市,苓雅區,華堂里,0,2,2274,40,2314,3048,0,0,0,0,0,0,75.92
高雄市,苓雅區,日中里,0,2,1883,37,1920,2428,0,0,0,0,0,0,79.08
高雄市,苓雅區,普照里,0,2,1984,29,2013,2560,0,0,0,0,0,0,78.63
高雄市,苓雅區,和煦里,0,2,1697,28,1725,2162,0,0,0,0,0,0,79.79
高雄市,苓雅區,晴朗里,0,2,733,14,747,926,0,0,0,0,0,0,80.67
高雄市,苓雅區,普天里,0,2,2097,36,2133,2726,0,0,0,0,0,0,78.25
高雄市,苓雅區,林富里,0,2,1219,17,1236,1534,0,0,0,0,0,0,80.57
高雄市,苓雅區,林圍里,0,2,1511,29,1540,1981,0,0,0,0,0,0,77.74
高雄市,苓雅區,林安里,0,2,1194,17,1211,1522,0,0,0,0,0,0,79.57
高雄市,苓雅區,光華里,0,2,618,13,631,782,0,0,0,0,0,0,80.69
高雄市,苓雅區,林興里,0,2,1172,26,1198,1484,0,0,0,0,0,0,80.73
高雄市,苓雅區,林華里,0,2,2374,51,2425,3010,0,0,0,0,0,0,80.56
高雄市,苓雅區,林西里,0,2,1482,43,1525,1930,0,0,0,0,0,0,79.02
高雄市,苓雅區,林中里,0,2,2518,53,2571,3177,0,0,0,0,0,0,80.93
高雄市,苓雅區,林泉里,0,2,1320,10,1330,1676,0,0,0,0,0,0,79.36
高雄市,苓雅區,林南里,0,2,2040,28,2068,2724,0,0,0,0,0,0,75.92
高雄市,苓雅區,中正里,0,2,1788,23,1811,2377,0,0,0,0,0,0,76.19
高雄市,苓雅區,尚義里,0,2,1028,23,1051,1399,0,0,0,0,0,0,75.13
高雄市,苓雅區,同慶里,0,2,1174,22,1196,1528,0,0,0,0,0,0,78.27
高雄市,苓雅區,凱旋里,0,2,1523,23,1546,1948,0,0,0,0,0,0,79.36
高雄市,苓雅區,安祥里,0,2,1697,39,1736,2275,0,0,0,0,0,0,76.31
高雄市,苓雅區,奏捷里,0,2,1236,21,1257,1550,0,0,0,0,0,0,81.10
高雄市,苓雅區,福壽里,0,2,1306,18,1324,1624,0,0,0,0,0,0,81.53
高雄市,苓雅區,福南里,0,2,1852,41,1893,2269,0,0,0,0,0,0,83.43
高雄市,苓雅區,五權里,0,2,1455,23,1478,1887,0,0,0,0,0,0,78.33
高雄市,苓雅區,民主里,0,2,2641,43,2684,3514,0,0,0,0,0,0,76.38
高雄市,苓雅區,林德里,0,2,1414,27,1441,1820,0,0,0,0,0,0,79.18
高雄市,苓雅區,林貴里,0,2,1080,19,1099,1335,0,0,0,0,0,0,82.32
高雄市,苓雅區,林榮里,0,2,2945,62,3007,3773,0,0,0,0,0,0,79.70
高雄市,苓雅區,英明里,0,2,1560,29,1589,1980,0,0,0,0,0,0,80.25
高雄市,苓雅區,林靖里,0,2,1316,21,1337,1625,0,0,0,0,0,0,82.28
高雄市,苓雅區,朝陽里,0,2,1191,22,1213,1537,0,0,0,0,0,0,78.92
高雄市,苓雅區,福隆里,0,2,2183,26,2209,2715,0,0,0,0,0,0,81.36
高雄市,苓雅區,福祥里,0,2,1088,11,1099,1367,0,0,0,0,0,0,80.40
高雄市,苓雅區,福海里,0,2,806,26,832,1049,0,0,0,0,0,0,79.31
高雄市,苓雅區,福康里,0,2,1637,20,1657,2039,0,0,0,0,0,0,81.27
高雄市,苓雅區,福人里,0,2,1896,45,1941,2352,0,0,0,0,0,0,82.53
高雄市,苓雅區,福地里,0,2,2321,48,2369,2881,0,0,0,0,0,0,82.23
高雄市,苓雅區,福居里,0,2,2326,38,2364,2849,0,0,0,0,0,0,82.98
高雄市,苓雅區,福東里,0,2,1764,39,1803,2288,0,0,0,0,0,0,78.80
高雄市,苓雅區,福西里,0,2,1869,28,1897,2354,0,0,0,0,0,0,80.59
高雄市,苓雅區,永康里,0,2,1776,33,1809,2239,0,0,0,0,0,0,80.79
高雄市,苓雅區,正文里,0,2,1287,24,1311,1604,0,0,0,0,0,0,81.73
高雄市,苓雅區,正言里,0,2,1761,29,1790,2270,0,0,0,0,0,0,78.85
高雄市,苓雅區,正大里,0,2,3042,50,3092,3942,0,0,0,0,0,0,78.44
高雄市,苓雅區,五福里,0,2,2899,64,2963,3778,0,0,0,0,0,0,78.43
高雄市,苓雅區,正心里,0,2,2570,54,2624,3295,0,0,0,0,0,0,79.64
高雄市,苓雅區,正道里,0,2,2773,48,2821,3517,0,0,0,0,0,0,80.21
高雄市,苓雅區,正義里,0,2,1688,29,1717,2080,0,0,0,0,0,0,82.55
高雄市,苓雅區,正仁里,0,2,1791,44,1835,2278,0,0,0,0,0,0,80.55
高雄市,苓雅區,文昌里,0,2,3041,56,3097,3659,0,0,0,0,0,0,84.64
高雄市,苓雅區,建軍里,0,2,1562,34,1596,1935,0,0,0,0,0,0,82.48
高雄市,苓雅區,衛武里,0,2,1621,38,1659,2081,0,0,0,0,0,0,79.72
高雄市,前鎮區,草衙里,0,2,5833,140,5973,7378,0,0,0,0,0,0,80.96
高雄市,前鎮區,明孝里,0,2,1947,46,1993,2498,0,0,0,0,0,0,79.78
高雄市,前鎮區,明正里,0,2,2571,51,2622,3220,0,0,0,0,0,0,81.43
高雄市,前鎮區,明義里,0,2,1476,30,1506,1774,0,0,0,0,0,0,84.89
高雄市,前鎮區,仁愛里,0,2,1228,40,1268,1551,0,0,0,0,0,0,81.75
高雄市,前鎮區,德昌里,0,2,1507,40,1547,1976,0,0,0,0,0,0,78.29
高雄市,前鎮區,平等里,0,2,1294,43,1337,1707,0,0,0,0,0,0,78.32
高雄市,前鎮區,平昌里,0,2,668,10,678,825,0,0,0,0,0,0,82.18
高雄市,前鎮區,明禮里,0,2,1452,32,1484,1804,0,0,0,0,0,0,82.26
高雄市,前鎮區,信義里,0,2,1348,25,1373,1664,0,0,0,0,0,0,82.51
高雄市,前鎮區,信德里,0,2,2045,56,2101,2618,0,0,0,0,0,0,80.25
高雄市,前鎮區,明道里,0,2,1075,18,1093,1339,0,0,0,0,0,0,81.63
高雄市,前鎮區,興化里,0,2,574,13,587,730,0,0,0,0,0,0,80.41
高雄市,前鎮區,興仁里,0,2,806,23,829,1008,0,0,0,0,0,0,82.24
高雄市,前鎮區,前鎮里,0,2,1356,24,1380,1601,0,0,0,0,0,0,86.20
高雄市,前鎮區,鎮東里,0,2,1619,36,1655,1942,0,0,0,0,0,0,85.22
高雄市,前鎮區,鎮榮里,0,2,1972,67,2039,2499,0,0,0,0,0,0,81.59
高雄市,前鎮區,鎮昌里,0,2,1586,35,1621,1957,0,0,0,0,0,0,82.83
高雄市,前鎮區,鎮海里,0,2,2753,84,2837,3507,0,0,0,0,0,0,80.90
高雄市,前鎮區,鎮陽里,0,2,997,20,1017,1172,0,0,0,0,0,0,86.77
高雄市,前鎮區,興邦里,0,2,943,26,969,1195,0,0,0,0,0,0,81.09
高雄市,前鎮區,鎮中里,0,2,757,24,781,930,0,0,0,0,0,0,83.98
高雄市,前鎮區,鎮北里,0,2,905,15,920,1117,0,0,0,0,0,0,82.36
高雄市,前鎮區,忠純里,0,2,2129,48,2177,2636,0,0,0,0,0,0,82.59
高雄市,前鎮區,忠誠里,0,2,1629,45,1674,2019,0,0,0,0,0,0,82.91
高雄市,前鎮區,西山里,0,2,2287,47,2334,2930,0,0,0,0,0,0,79.66
高雄市,前鎮區,民權里,0,2,2252,37,2289,2773,0,0,0,0,0,0,82.55
高雄市,前鎮區,建隆里,0,2,751,19,770,972,0,0,0,0,0,0,79.22
高雄市,前鎮區,振興里,0,2,1334,36,1370,1630,0,0,0,0,0,0,84.05
高雄市,前鎮區,良和里,0,2,1770,26,1796,2329,0,0,0,0,0,0,77.11
高雄市,前鎮區,西甲里,0,2,1632,37,1669,2031,0,0,0,0,0,0,82.18
高雄市,前鎮區,盛興里,0,2,1610,32,1642,2264,0,0,0,0,0,0,72.53
高雄市,前鎮區,盛豐里,0,2,2174,43,2217,2922,0,0,0,0,0,0,75.87
高雄市,前鎮區,興中里,0,2,2280,59,2339,3104,0,0,0,0,0,0,75.35
高雄市,前鎮區,興東里,0,2,2807,70,2877,3563,0,0,0,0,0,0,80.75
高雄市,前鎮區,忠孝里,0,2,1920,35,1955,2439,0,0,0,0,0,0,80.16
高雄市,前鎮區,復國里,0,2,2202,38,2240,2750,0,0,0,0,0,0,81.45
高雄市,前鎮區,竹內里,0,2,1962,49,2011,2549,0,0,0,0,0,0,78.89
高雄市,前鎮區,竹東里,0,2,1473,38,1511,1978,0,0,0,0,0,0,76.39
高雄市,前鎮區,竹南里,0,2,1795,95,1890,2374,0,0,0,0,0,0,79.61
高雄市,前鎮區,竹北里,0,2,1457,29,1486,1911,0,0,0,0,0,0,77.76
高雄市,前鎮區,竹西里,0,2,2426,35,2461,2995,0,0,0,0,0,0,82.17
高雄市,前鎮區,竹中里,0,2,2072,40,2112,2652,0,0,0,0,0,0,79.64
高雄市,前鎮區,瑞竹里,0,2,1054,26,1080,1333,0,0,0,0,0,0,81.02
高雄市,前鎮區,瑞南里,0,2,3539,70,3609,4347,0,0,0,0,0,0,83.02
高雄市,前鎮區,瑞豐里,0,2,1786,43,1829,2210,0,0,0,0,0,0,82.76
高雄市,前鎮區,瑞祥里,0,2,3393,58,3451,4189,0,0,0,0,0,0,82.38
高雄市,前鎮區,瑞東里,0,2,1902,30,1932,2408,0,0,0,0,0,0,80.23
高雄市,前鎮區,瑞和里,0,2,1552,49,1601,1966,0,0,0,0,0,0,81.43
高雄市,前鎮區,瑞平里,0,2,2414,53,2467,2957,0,0,0,0,0,0,83.43
高雄市,前鎮區,瑞隆里,0,2,2274,53,2327,2940,0,0,0,0,0,0,79.15
高雄市,前鎮區,瑞北里,0,2,2232,40,2272,2722,0,0,0,0,0,0,83.47
高雄市,前鎮區,瑞西里,0,2,2272,43,2315,2697,0,0,0,0,0,0,85.84
高雄市,前鎮區,瑞崗里,0,2,2058,45,2103,2605,0,0,0,0,0,0,80.73
高雄市,前鎮區,瑞興里,0,2,2051,36,2087,2577,0,0,0,0,0,0,80.99
高雄市,前鎮區,瑞誠里,0,2,1711,39,1750,2148,0,0,0,0,0,0,81.47
高雄市,前鎮區,瑞文里,0,2,1720,36,1756,2158,0,0,0,0,0,0,81.37
高雄市,前鎮區,瑞華里,0,2,2644,53,2697,3388,0,0,0,0,0,0,79.60
高雄市,前鎮區,瑞昌里,0,2,1856,55,1911,2443,0,0,0,0,0,0,78.22
高雄市,小港區,小港里,0,2,1402,39,1441,1742,0,0,0,0,0,0,82.72
高雄市,小港區,港口里,0,2,2133,29,2162,2709,0,0,0,0,0,0,79.81
高雄市,小港區,港正里,0,2,1507,23,1530,1865,0,0,0,0,0,0,82.04
高雄市,小港區,港墘里,0,2,1094,25,1119,1321,0,0,0,0,0,0,84.71
高雄市,小港區,港明里,0,2,2085,52,2137,2523,0,0,0,0,0,0,84.70
高雄市,小港區,港后里,0,2,1337,23,1360,1613,0,0,0,0,0,0,84.31
高雄市,小港區,港南里,0,2,1031,15,1046,1295,0,0,0,0,0,0,80.77
高雄市,小港區,港興里,0,2,1398,21,1419,1685,0,0,0,0,0,0,84.21
高雄市,小港區,鳳宮里,0,2,1222,24,1246,1542,0,0,0,0,0,0,80.80
高雄市,小港區,店鎮里,0,2,3049,50,3099,3770,0,0,0,0,0,0,82.20
高雄市,小港區,大苓里,0,2,1549,20,1569,1904,0,0,0,0,0,0,82.41
高雄市,小港區,二苓里,0,2,2074,36,2110,2562,0,0,0,0,0,0,82.36
高雄市,小港區,三苓里,0,2,1803,32,1835,2185,0,0,0,0,0,0,83.98
高雄市,小港區,正苓里,0,2,2299,45,2344,2939,0,0,0,0,0,0,79.76
高雄市,小港區,順苓里,0,2,2226,41,2267,2816,0,0,0,0,0,0,80.50
高雄市,小港區,六苓里,0,2,888,19,907,1093,0,0,0,0,0,0,82.98
高雄市,小港區,宏亮里,0,2,1496,32,1528,1856,0,0,0,0,0,0,82.33
高雄市,小港區,山東里,0,2,1754,42,1796,2257,0,0,0,0,0,0,79.57
高雄市,小港區,青島里,0,2,1378,35,1413,1700,0,0,0,0,0,0,83.12
高雄市,小港區,濟南里,0,2,1878,43,1921,2352,0,0,0,0,0,0,81.68
高雄市,小港區,泰山里,0,2,1421,26,1447,1712,0,0,0,0,0,0,84.52
高雄市,小港區,山明里,0,2,2558,57,2615,3173,0,0,0,0,0,0,82.41
高雄市,小港區,高松里,0,2,2427,45,2472,2922,0,0,0,0,0,0,84.60
高雄市,小港區,松金里,0,2,1241,35,1276,1610,0,0,0,0,0,0,79.25
高雄市,小港區,松山里,0,2,1050,17,1067,1272,0,0,0,0,0,0,83.88
高雄市,小港區,大坪里,0,2,800,13,813,950,0,0,0,0,0,0,85.58
高雄市,小港區,坪頂里,0,2,818,13,831,958,0,0,0,0,0,0,86.74
高雄市,小港區,孔宅里,0,2,2332,63,2395,2989,0,0,0,0,0,0,80.13
高雄市,小港區,廈莊里,0,2,1240,23,1263,1489,0,0,0,0,0,0,84.82
高雄市,小港區,合作里,0,2,1543,31,1574,1901,0,0,0,0,0,0,82.80
高雄市,小港區,桂林里,0,2,3731,94,3825,4748,0,0,0,0,0,0,80.56
高雄市,小港區,中厝里,0,2,1890,30,1920,2295,0,0,0,0,0,0,83.66
高雄市,小港區,鳳鳴里,0,2,1754,28,1782,2048,0,0,0,0,0,0,87.01
高雄市,小港區,龍鳳里,0,2,1643,27,1670,1938,0,0,0,0,0,0,86.17
高雄市,小港區,鳳森里,0,2,1229,15,1244,1470,0,0,0,0,0,0,84.63
高雄市,小港區,鳳林里,0,2,1672,29,1701,2098,0,0,0,0,0,0,81.08
高雄市,小港區,鳳興里,0,2,1231,19,1250,1473,0,0,0,0,0,0,84.86
高雄市,小港區,鳳源里,0,2,1866,33,1899,2281,0,0,0,0,0,0,83.25
高雄市,小港區,海澄里,0,2,3471,84,3555,4304,0,0,0,0,0,0,82.60
高雄市,小港區,海昌里,0,2,1786,34,1820,2255,0,0,0,0,0,0,80.71
高雄市,小港區,海豐里,0,2,1927,36,1963,2396,0,0,0,0,0,0,81.93
高雄市,小港區,海原里,0,2,2091,52,2143,2729,0,0,0,0,0,0,78.53
高雄市,小港區,海城里,0,2,2089,57,2146,2735,0,0,0,0,0,0,78.46
臺北縣,板橋市,留侯里,0,1,681,9,690,1166,0,0,0,0,0,0,59.18
臺北縣,板橋市,流芳里,0,1,763,12,775,1234,0,0,0,0,0,0,62.80
臺北縣,板橋市,赤松里,0,1,417,12,429,642,0,0,0,0,0,0,66.82
臺北縣,板橋市,黃石里,0,1,701,8,709,1066,0,0,0,0,0,0,66.51
臺北縣,板橋市,挹秀里,0,1,931,13,944,1499,0,0,0,0,0,0,62.98
臺北縣,板橋市,湳興里,0,1,2356,45,2401,3743,0,0,0,0,0,0,64.15
臺北縣,板橋市,新興里,0,1,1554,24,1578,2398,0,0,0,0,0,0,65.80
臺北縣,板橋市,社後里,0,1,2748,42,2790,4493,0,0,0,0,0,0,62.10
臺北縣,板橋市,香社里,0,1,2064,29,2093,3204,0,0,0,0,0,0,65.32
臺北縣,板橋市,香雅里,0,1,1271,9,1280,2025,0,0,0,0,0,0,63.21
臺北縣,板橋市,中正里,0,1,1982,26,2008,3441,0,0,0,0,0,0,58.36
臺北縣,板橋市,自強里,0,1,2585,35,2620,4282,0,0,0,0,0,0,61.19
臺北縣,板橋市,自立里,0,1,1564,23,1587,2323,0,0,0,0,0,0,68.32
臺北縣,板橋市,光華里,0,1,1286,13,1299,2096,0,0,0,0,0,0,61.98
臺北縣,板橋市,光榮里,0,1,1372,18,1390,2131,0,0,0,0,0,0,65.23
臺北縣,板橋市,國光里,0,1,2085,17,2102,3092,0,0,0,0,0,0,67.98
臺北縣,板橋市,港尾里,0,1,946,7,953,1674,0,0,0,0,0,0,56.93
臺北縣,板橋市,新生里,0,1,1907,25,1932,3344,0,0,0,0,0,0,57.78
臺北縣,板橋市,金華里,0,1,1708,26,1734,3101,0,0,0,0,0,0,55.92
臺北縣,板橋市,港德里,0,1,2127,37,2164,4037,0,0,0,0,0,0,53.60
臺北縣,板橋市,民權里,0,1,1583,15,1598,2441,0,0,0,0,0,0,65.46
臺北縣,板橋市,民安里,0,1,1119,16,1135,1695,0,0,0,0,0,0,66.96
臺北縣,板橋市,建國里,0,1,1985,27,2012,3092,0,0,0,0,0,0,65.07
臺北縣,板橋市,漢生里,0,1,2167,21,2188,3529,0,0,0,0,0,0,62.00
臺北縣,板橋市,新民里,0,1,1895,23,1918,3037,0,0,0,0,0,0,63.15
臺北縣,板橋市,公館里,0,1,2132,35,2167,3358,0,0,0,0,0,0,64.53
臺北縣,板橋市,幸福里,0,1,1964,24,1988,3214,0,0,0,0,0,0,61.85
臺北縣,板橋市,文德里,0,1,997,20,1017,1833,0,0,0,0,0,0,55.48
臺北縣,板橋市,忠誠里,0,1,1372,16,1388,2061,0,0,0,0,0,0,67.35
臺北縣,板橋市,陽明里,0,1,1389,20,1409,2263,0,0,0,0,0,0,62.26
臺北縣,板橋市,百壽里,0,1,1322,17,1339,1958,0,0,0,0,0,0,68.39
臺北縣,板橋市,介壽里,0,1,1527,24,1551,2402,0,0,0,0,0,0,64.57
臺北縣,板橋市,新埔里,0,1,1330,20,1350,2018,0,0,0,0,0,0,66.90
臺北縣,板橋市,華江里,0,1,1835,33,1868,3019,0,0,0,0,0,0,61.87
臺北縣,板橋市,江翠里,0,1,2241,35,2276,3611,0,0,0,0,0,0,63.03
臺北縣,板橋市,純翠里,0,1,2052,34,2086,3523,0,0,0,0,0,0,59.21
臺北縣,板橋市,溪頭里,0,1,2433,34,2467,4131,0,0,0,0,0,0,59.72
臺北縣,板橋市,聯翠里,0,1,1196,12,1208,1967,0,0,0,0,0,0,61.41
臺北縣,板橋市,文化里,0,1,1490,18,1508,2396,0,0,0,0,0,0,62.94
臺北縣,板橋市,宏翠里,0,1,1500,30,1530,2236,0,0,0,0,0,0,68.43
臺北縣,板橋市,仁翠里,0,1,1639,39,1678,2545,0,0,0,0,0,0,65.93
臺北縣,板橋市,新翠里,0,1,2671,39,2710,4504,0,0,0,0,0,0,60.17
臺北縣,板橋市,朝陽里,0,1,1565,16,1581,2597,0,0,0,0,0,0,60.88
臺北縣,板橋市,吉翠里,0,1,1732,34,1766,2775,0,0,0,0,0,0,63.64
臺北縣,板橋市,德翠里,0,1,1897,32,1929,3056,0,0,0,0,0,0,63.12
臺北縣,板橋市,新海里,0,1,1586,23,1609,2624,0,0,0,0,0,0,61.32
臺北縣,板橋市,滿翠里,0,1,1601,24,1625,2592,0,0,0,0,0,0,62.69
臺北縣,板橋市,明翠里,0,1,2426,32,2458,3981,0,0,0,0,0,0,61.74
臺北縣,板橋市,松翠里,0,1,1603,17,1620,2757,0,0,0,0,0,0,58.76
臺北縣,板橋市,柏翠里,0,1,1451,16,1467,2422,0,0,0,0,0,0,60.57
臺北縣,板橋市,龍翠里,0,1,1764,16,1780,2962,0,0,0,0,0,0,60.09
臺北縣,板橋市,松柏里,0,1,1264,19,1283,1929,0,0,0,0,0,0,66.51
臺北縣,板橋市,華翠里,0,1,1521,25,1546,2596,0,0,0,0,0,0,59.55
臺北縣,板橋市,莒光里,0,1,1390,20,1410,2335,0,0,0,0,0,0,60.39
臺北縣,板橋市,忠翠里,0,1,2373,42,2415,3959,0,0,0,0,0,0,61.00
臺北縣,板橋市,嵐翠里,0,1,1217,22,1239,2124,0,0,0,0,0,0,58.33
臺北縣,板橋市,文聖里,0,1,1332,27,1359,2081,0,0,0,0,0,0,65.31
臺北縣,板橋市,文翠里,0,1,1887,24,1911,3103,0,0,0,0,0,0,61.59
臺北縣,板橋市,青翠里,0,1,1322,19,1341,2476,0,0,0,0,0,0,54.16
臺北縣,板橋市,懷翠里,0,1,2170,30,2200,3879,0,0,0,0,0,0,56.72
臺北縣,板橋市,福翠里,0,1,1034,19,1053,1636,0,0,0,0,0,0,64.36
臺北縣,板橋市,港嘴里,0,1,2359,30,2389,4106,0,0,0,0,0,0,58.18
臺北縣,板橋市,振興里,0,1,2095,34,2129,3256,0,0,0,0,0,0,65.39
臺北縣,板橋市,振義里,0,1,1851,31,1882,2935,0,0,0,0,0,0,64.12
臺北縣,板橋市,光復里,0,1,1436,24,1460,2394,0,0,0,0,0,0,60.99
臺北縣,板橋市,埔墘里,0,1,2320,36,2356,3828,0,0,0,0,0,0,61.55
臺北縣,板橋市,富貴里,0,1,944,7,951,1732,0,0,0,0,0,0,54.91
臺北縣,板橋市,長壽里,0,1,1483,31,1514,2166,0,0,0,0,0,0,69.90
臺北縣,板橋市,福壽里,0,1,1202,29,1231,2031,0,0,0,0,0,0,60.61
臺北縣,板橋市,居仁里,0,1,1445,32,1477,2316,0,0,0,0,0,0,63.77
臺北縣,板橋市,海山里,0,1,2693,39,2732,4429,0,0,0,0,0,0,61.68
臺北縣,板橋市,九如里,0,1,1370,18,1388,2310,0,0,0,0,0,0,60.09
臺北縣,板橋市,正泰里,0,1,1410,27,1437,2213,0,0,0,0,0,0,64.93
臺北縣,板橋市,玉光里,0,1,2079,45,2124,3447,0,0,0,0,0,0,61.62
臺北縣,板橋市,光仁里,0,1,1506,29,1535,2299,0,0,0,0,0,0,66.77
臺北縣,板橋市,埤墘里,0,1,1655,13,1668,2678,0,0,0,0,0,0,62.29
臺北縣,板橋市,莊敬里,0,1,1134,16,1150,1714,0,0,0,0,0,0,67.09
臺北縣,板橋市,永安里,0,1,1314,21,1335,2200,0,0,0,0,0,0,60.68
臺北縣,板橋市,雙玉里,0,1,1494,34,1528,2428,0,0,0,0,0,0,62.93
臺北縣,板橋市,廣新里,0,1,1720,28,1748,2813,0,0,0,0,0,0,62.14
臺北縣,板橋市,深丘里,0,1,2393,20,2413,4027,0,0,0,0,0,0,59.92
臺北縣,板橋市,香丘里,0,1,1582,18,1600,2570,0,0,0,0,0,0,62.26
臺北縣,板橋市,西安里,0,1,1218,19,1237,1897,0,0,0,0,0,0,65.21
臺北縣,板橋市,東丘里,0,1,1983,45,2028,3246,0,0,0,0,0,0,62.48
臺北縣,板橋市,民生里,0,1,871,13,884,1446,0,0,0,0,0,0,61.13
臺北縣,板橋市,長安里,0,1,1489,24,1513,2500,0,0,0,0,0,0,60.52
臺北縣,板橋市,東安里,0,1,1181,18,1199,1920,0,0,0,0,0,0,62.45
臺北縣,板橋市,福丘里,0,1,951,12,963,1521,0,0,0,0,0,0,63.31
臺北縣,板橋市,福祿里,0,1,1440,23,1463,2437,0,0,0,0,0,0,60.03
臺北縣,板橋市,民族里,0,1,1850,22,1872,3000,0,0,0,0,0,0,62.40
臺北縣,板橋市,國泰里,0,1,1249,26,1275,2091,0,0,0,0,0,0,60.98
臺北縣,板橋市,後埔里,0,1,1568,17,1585,2565,0,0,0,0,0,0,61.79
臺北縣,板橋市,福德里,0,1,2352,30,2382,3643,0,0,0,0,0,0,65.39
臺北縣,板橋市,景星里,0,1,1563,22,1585,2458,0,0,0,0,0,0,64.48
臺北縣,板橋市,福星里,0,1,1312,24,1336,2093,0,0,0,0,0,0,63.83
臺北縣,板橋市,鄉雲里,0,1,1503,24,1527,2376,0,0,0,0,0,0,64.27
臺北縣,板橋市,廣德里,0,1,2549,41,2590,4208,0,0,0,0,0,0,61.55
臺北縣,板橋市,大豐里,0,1,2175,19,2194,3501,0,0,0,0,0,0,62.67
臺北縣,板橋市,重慶里,0,1,3143,60,3203,5414,0,0,0,0,0,0,59.16
臺北縣,板橋市,仁愛里,0,1,1694,20,1714,2676,0,0,0,0,0,0,64.05
臺北縣,板橋市,和平里,0,1,527,8,535,848,0,0,0,0,0,0,63.09
臺北縣,板橋市,廣福里,0,1,1261,21,1282,2169,0,0,0,0,0,0,59.11
臺北縣,板橋市,五權里,0,1,2052,21,2073,3488,0,0,0,0,0,0,59.43
臺北縣,板橋市,華興里,0,1,1636,28,1664,2741,0,0,0,0,0,0,60.71
臺北縣,板橋市,華貴里,0,1,1432,36,1468,2163,0,0,0,0,0,0,67.87
臺北縣,板橋市,華福里,0,1,1056,11,1067,1611,0,0,0,0,0,0,66.23
臺北縣,板橋市,華德里,0,1,2449,52,2501,4019,0,0,0,0,0,0,62.23
臺北縣,板橋市,華東里,0,1,2206,35,2241,3578,0,0,0,0,0,0,62.63
臺北縣,板橋市,信義里,0,1,1887,46,1933,3063,0,0,0,0,0,0,63.11
臺北縣,板橋市,浮洲里,0,1,1891,31,1922,3444,0,0,0,0,0,0,55.81
臺北縣,板橋市,華中里,0,1,2199,41,2240,3728,0,0,0,0,0,0,60.09
臺北縣,板橋市,僑中里,0,1,1632,28,1660,2595,0,0,0,0,0,0,63.97
臺北縣,板橋市,大觀里,0,1,1479,19,1498,2401,0,0,0,0,0,0,62.39
臺北縣,板橋市,歡園里,0,1,726,11,737,1005,0,0,0,0,0,0,73.33
臺北縣,板橋市,中山里,0,1,2310,39,2349,3917,0,0,0,0,0,0,59.97
臺北縣,板橋市,復興里,0,1,1738,32,1770,2589,0,0,0,0,0,0,68.37
臺北縣,板橋市,大安里,0,1,1975,35,2010,3261,0,0,0,0,0,0,61.64
臺北縣,板橋市,福安里,0,1,1264,17,1281,2150,0,0,0,0,0,0,59.58
臺北縣,板橋市,聚安里,0,1,2302,49,2351,3723,0,0,0,0,0,0,63.15
臺北縣,板橋市,龍安里,0,1,1408,25,1433,2324,0,0,0,0,0,0,61.66
臺北縣,板橋市,崑崙里,0,1,2857,51,2908,4883,0,0,0,0,0,0,59.55
臺北縣,板橋市,成和里,0,1,1503,25,1528,2542,0,0,0,0,0,0,60.11
臺北縣,板橋市,溪洲里,0,1,2208,39,2247,3649,0,0,0,0,0,0,61.58
臺北縣,板橋市,溪福里,0,1,2744,58,2802,4709,0,0,0,0,0,0,59.50
臺北縣,板橋市,溪北里,0,1,1570,28,1598,2430,0,0,0,0,0,0,65.76
臺北縣,板橋市,堂春里,0,1,1664,23,1687,2567,0,0,0,0,0,0,65.72
臺北縣,土城市,祖田里,0,1,719,18,737,1123,0,0,0,0,0,0,65.63
臺北縣,土城市,頂新里,0,1,742,12,754,1099,0,0,0,0,0,0,68.61
臺北縣,土城市,頂福里,0,1,1978,46,2024,3063,0,0,0,0,0,0,66.08
臺北縣,土城市,頂埔里,0,1,1390,37,1427,2356,0,0,0,0,0,0,60.57
臺北縣,土城市,沛陂里,0,1,1440,36,1476,2303,0,0,0,0,0,0,64.09
臺北縣,土城市,永寧里,0,1,2810,51,2861,4695,0,0,0,0,0,0,60.94
臺北縣,土城市,大安里,0,1,1651,32,1683,3006,0,0,0,0,0,0,55.99
臺北縣,土城市,員仁里,0,1,2107,48,2155,3712,0,0,0,0,0,0,58.05
臺北縣,土城市,埤塘里,0,1,1259,29,1288,2033,0,0,0,0,0,0,63.35
臺北縣,土城市,土城里,0,1,1006,17,1023,1528,0,0,0,0,0,0,66.95
臺北縣,土城市,長風里,0,1,566,6,572,853,0,0,0,0,0,0,67.06
臺北縣,土城市,員信里,0,1,1662,31,1693,2826,0,0,0,0,0,0,59.91
臺北縣,土城市,員林里,0,1,2239,42,2281,3777,0,0,0,0,0,0,60.39
臺北縣,土城市,員福里,0,1,2251,37,2288,3783,0,0,0,0,0,0,60.48
臺北縣,土城市,日和里,0,1,2233,33,2266,3671,0,0,0,0,0,0,61.73
臺北縣,土城市,日新里,0,1,2184,42,2226,3412,0,0,0,0,0,0,65.24
臺北縣,土城市,裕生里,0,1,2047,39,2086,3421,0,0,0,0,0,0,60.98
臺北縣,土城市,貨饒里,0,1,1779,29,1808,2850,0,0,0,0,0,0,63.44
臺北縣,土城市,瑞興里,0,1,1613,25,1638,2441,0,0,0,0,0,0,67.10
臺北縣,土城市,復興里,0,1,1925,26,1951,3029,0,0,0,0,0,0,64.41
臺北縣,土城市,廣福里,0,1,2130,25,2155,3492,0,0,0,0,0,0,61.71
臺北縣,土城市,學成里,0,1,1450,22,1472,2220,0,0,0,0,0,0,66.31
臺北縣,土城市,埤林里,0,1,4407,63,4470,7190,0,0,0,0,0,0,62.17
臺北縣,土城市,樂利里,0,1,2358,40,2398,3733,0,0,0,0,0,0,64.24
臺北縣,土城市,學府里,0,1,1356,28,1384,2156,0,0,0,0,0,0,64.19
臺北縣,土城市,柑林里,0,1,4510,79,4589,8769,0,0,0,0,0,0,52.33
臺北縣,土城市,青雲里,0,1,1221,17,1238,1972,0,0,0,0,0,0,62.78
臺北縣,土城市,清和里,0,1,2493,32,2525,4235,0,0,0,0,0,0,59.62
臺北縣,土城市,清化里,0,1,711,19,730,1178,0,0,0,0,0,0,61.97
臺北縣,土城市,清溪里,0,1,2773,54,2827,4444,0,0,0,0,0,0,63.61
臺北縣,土城市,清水里,0,1,4214,73,4287,6898,0,0,0,0,0,0,62.15
臺北縣,土城市,永豐里,0,1,1331,37,1368,2130,0,0,0,0,0,0,64.23
臺北縣,土城市,永富里,0,1,2073,44,2117,3498,0,0,0,0,0,0,60.52
臺北縣,土城市,廷寮里,0,1,3230,45,3275,5973,0,0,0,0,0,0,54.83
臺北縣,土城市,峰廷里,0,1,2768,39,2807,4704,0,0,0,0,0,0,59.67
臺北縣,土城市,延吉里,0,1,1748,35,1783,2869,0,0,0,0,0,0,62.15
臺北縣,土城市,延壽里,0,1,3510,60,3570,5650,0,0,0,0,0,0,63.19
臺北縣,土城市,平和里,0,1,2807,51,2858,4535,0,0,0,0,0,0,63.02
臺北縣,土城市,安和里,0,1,1988,41,2029,3374,0,0,0,0,0,0,60.14
臺北縣,土城市,延和里,0,1,1909,46,1955,3289,0,0,0,0,0,0,59.44
臺北縣,樹林鎮,保安里,0,1,2422,39,2461,3925,0,0,0,0,0,0,62.70
臺北縣,樹林鎮,圳福里,0,1,1672,30,1702,2725,0,0,0,0,0,0,62.46
臺北縣,樹林鎮,圳安里,0,1,865,9,874,1478,0,0,0,0,0,0,59.13
臺北縣,樹林鎮,圳民里,0,1,944,17,961,1657,0,0,0,0,0,0,58.00
臺北縣,樹林鎮,圳生里,0,1,621,6,627,1035,0,0,0,0,0,0,60.58
臺北縣,樹林鎮,三龍里,0,1,831,12,843,1398,0,0,0,0,0,0,60.30
臺北縣,樹林鎮,三多里,0,1,1470,33,1503,2552,0,0,0,0,0,0,58.89
臺北縣,樹林鎮,三福里,0,1,1804,38,1842,2931,0,0,0,0,0,0,62.85
臺北縣,樹林鎮,三興里,0,1,1868,35,1903,3424,0,0,0,0,0,0,55.58
臺北縣,樹林鎮,羌寮里,0,1,1415,21,1436,2454,0,0,0,0,0,0,58.52
臺北縣,樹林鎮,光興里,0,1,1247,17,1264,2322,0,0,0,0,0,0,54.44
臺北縣,樹林鎮,金寮里,0,1,1429,29,1458,2464,0,0,0,0,0,0,59.17
臺北縣,樹林鎮,潭底里,0,1,1848,21,1869,2984,0,0,0,0,0,0,62.63
臺北縣,樹林鎮,文林里,0,1,1540,29,1569,2819,0,0,0,0,0,0,55.66
臺北縣,樹林鎮,樹東里,0,1,648,8,656,961,0,0,0,0,0,0,68.26
臺北縣,樹林鎮,樹北里,0,1,614,3,617,929,0,0,0,0,0,0,66.42
臺北縣,樹林鎮,樹福里,0,1,1160,20,1180,1836,0,0,0,0,0,0,64.27
臺北縣,樹林鎮,樹德里,0,1,1629,23,1652,2585,0,0,0,0,0,0,63.91
臺北縣,樹林鎮,樹西里,0,1,2318,31,2349,3527,0,0,0,0,0,0,66.60
臺北縣,樹林鎮,育英里,0,1,1305,28,1333,2008,0,0,0,0,0,0,66.38
臺北縣,樹林鎮,樹南里,0,1,1699,21,1720,2704,0,0,0,0,0,0,63.61
臺北縣,樹林鎮,樹人里,0,1,1445,24,1469,2330,0,0,0,0,0,0,63.05
臺北縣,樹林鎮,樹興里,0,1,1574,18,1592,2492,0,0,0,0,0,0,63.88
臺北縣,樹林鎮,坡內里,0,1,710,8,718,1065,0,0,0,0,0,0,67.42
臺北縣,樹林鎮,大同里,0,1,1045,17,1062,1789,0,0,0,0,0,0,59.36
臺北縣,樹林鎮,中華里,0,1,1062,21,1083,1721,0,0,0,0,0,0,62.93
臺北縣,樹林鎮,太順里,0,1,911,18,929,1534,0,0,0,0,0,0,60.56
臺北縣,樹林鎮,和平里,0,1,1843,23,1866,2822,0,0,0,0,0,0,66.12
臺北縣,樹林鎮,彭興里,0,1,2000,30,2030,3442,0,0,0,0,0,0,58.98
臺北縣,樹林鎮,彭厝里,0,1,1595,24,1619,2587,0,0,0,0,0,0,62.58
臺北縣,樹林鎮,彭福里,0,1,1642,34,1676,2638,0,0,0,0,0,0,63.53
臺北縣,樹林鎮,東昇里,0,1,1749,27,1776,2733,0,0,0,0,0,0,64.98
臺北縣,樹林鎮,東陽里,0,1,2140,32,2172,3767,0,0,0,0,0,0,57.66
臺北縣,樹林鎮,東山里,0,1,1491,31,1522,2286,0,0,0,0,0,0,66.58
臺北縣,樹林鎮,山佳里,0,1,1473,31,1504,2284,0,0,0,0,0,0,65.85
臺北縣,樹林鎮,中山里,0,1,1640,36,1676,2439,0,0,0,0,0,0,68.72
臺北縣,樹林鎮,樂山里,0,1,750,23,773,1146,0,0,0,0,0,0,67.45
臺北縣,樹林鎮,東園里,0,1,745,11,756,1113,0,0,0,0,0,0,67.92
臺北縣,樹林鎮,北園里,0,1,824,15,839,1270,0,0,0,0,0,0,66.06
臺北縣,樹林鎮,柑園里,0,1,761,7,768,1141,0,0,0,0,0,0,67.31
臺北縣,樹林鎮,南園里,0,1,420,7,427,643,0,0,0,0,0,0,66.41
臺北縣,樹林鎮,西園里,0,1,662,18,680,1119,0,0,0,0,0,0,60.77
臺北縣,鶯歌鎮,建德里,0,1,325,8,333,466,0,0,0,0,0,0,71.46
臺北縣,鶯歌鎮,東鶯里,0,1,614,7,621,873,0,0,0,0,0,0,71.13
臺北縣,鶯歌鎮,北鶯里,0,1,860,10,870,1209,0,0,0,0,0,0,71.96
臺北縣,鶯歌鎮,西鶯里,0,1,1207,11,1218,1689,0,0,0,0,0,0,72.11
臺北縣,鶯歌鎮,中鶯里,0,1,616,6,622,799,0,0,0,0,0,0,77.85
臺北縣,鶯歌鎮,南鶯里,0,1,2396,26,2422,3434,0,0,0,0,0,0,70.53
臺北縣,鶯歌鎮,建國里,0,1,2163,35,2198,3514,0,0,0,0,0,0,62.55
臺北縣,鶯歌鎮,南靖里,0,1,1677,18,1695,2438,0,0,0,0,0,0,69.52
臺北縣,鶯歌鎮,尖山里,0,1,2303,36,2339,3461,0,0,0,0,0,0,67.58
臺北縣,鶯歌鎮,二橋里,0,1,2600,45,2645,3700,0,0,0,0,0,0,71.49
臺北縣,鶯歌鎮,二甲里,0,1,529,14,543,738,0,0,0,0,0,0,73.58
臺北縣,鶯歌鎮,同慶里,0,1,728,7,735,1048,0,0,0,0,0,0,70.13
臺北縣,鶯歌鎮,永昌里,0,1,3253,48,3301,5138,0,0,0,0,0,0,64.25
臺北縣,鶯歌鎮,永吉里,0,1,2097,33,2130,3074,0,0,0,0,0,0,69.29
臺北縣,鶯歌鎮,鳳鳴里,0,1,1752,38,1790,2832,0,0,0,0,0,0,63.21
臺北縣,鶯歌鎮,鳳祥里,0,1,1804,33,1837,3108,0,0,0,0,0,0,59.11
臺北縣,鶯歌鎮,鳳福里,0,1,1885,24,1909,3033,0,0,0,0,0,0,62.94
臺北縣,鶯歌鎮,大湖里,0,1,2205,38,2243,3655,0,0,0,0,0,0,61.37
臺北縣,鶯歌鎮,中湖里,0,1,2405,32,2437,3849,0,0,0,0,0,0,63.32
臺北縣,鶯歌鎮,東湖里,0,1,153,3,156,231,0,0,0,0,0,0,67.53
臺北縣,三峽鎮,三峽里,0,1,239,1,240,356,0,0,0,0,0,0,67.42
臺北縣,三峽鎮,秀川里,0,1,308,4,312,442,0,0,0,0,0,0,70.59
臺北縣,三峽鎮,八張里,0,1,1455,33,1488,2131,0,0,0,0,0,0,69.83
臺北縣,三峽鎮,中埔里,0,1,739,9,748,1199,0,0,0,0,0,0,62.39
臺北縣,三峽鎮,弘道里,0,1,559,4,563,823,0,0,0,0,0,0,68.41
臺北縣,三峽鎮,永館里,0,1,2399,33,2432,3769,0,0,0,0,0,0,64.53
臺北縣,三峽鎮,中正里,0,1,1824,34,1858,2974,0,0,0,0,0,0,62.47
臺北縣,三峽鎮,礁溪里,0,1,1463,19,1482,2440,0,0,0,0,0,0,60.74
臺北縣,三峽鎮,介壽里,0,1,1770,30,1800,2914,0,0,0,0,0,0,61.77
臺北縣,三峽鎮,安溪里,0,1,2561,38,2599,4217,0,0,0,0,0,0,61.63
臺北縣,三峽鎮,龍埔里,0,1,2470,47,2517,4106,0,0,0,0,0,0,61.30
臺北縣,三峽鎮,鳶山里,0,1,2971,53,3024,4956,0,0,0,0,0,0,61.02
臺北縣,三峽鎮,大埔里,0,1,1911,29,1940,2989,0,0,0,0,0,0,64.90
臺北縣,三峽鎮,二鬮里,0,1,1104,15,1119,2058,0,0,0,0,0,0,54.37
臺北縣,三峽鎮,嘉添里,0,1,1855,27,1882,2687,0,0,0,0,0,0,70.04
臺北縣,三峽鎮,添福里,0,1,612,11,623,908,0,0,0,0,0,0,68.61
臺北縣,三峽鎮,五寮里,0,1,611,9,620,925,0,0,0,0,0,0,67.03
臺北縣,三峽鎮,金圳里,0,1,282,6,288,466,0,0,0,0,0,0,61.80
臺北縣,三峽鎮,插角里,0,1,573,7,580,856,0,0,0,0,0,0,67.76
臺北縣,三峽鎮,有木里,0,1,506,6,512,824,0,0,0,0,0,0,62.14
臺北縣,三峽鎮,溪南里,0,1,838,12,850,1126,0,0,0,0,0,0,75.49
臺北縣,三峽鎮,溪北里,0,1,1265,13,1278,1773,0,0,0,0,0,0,72.08
臺北縣,三峽鎮,溪東里,0,1,1433,30,1463,2178,0,0,0,0,0,0,67.17
臺北縣,三峽鎮,成福里,0,1,621,3,624,830,0,0,0,0,0,0,75.18
臺北縣,三峽鎮,安坑里,0,1,822,15,837,1327,0,0,0,0,0,0,63.07
臺北縣,三峽鎮,竹崙里,0,1,1030,15,1045,1632,0,0,0,0,0,0,64.03
臺北縣,三重市,大有里,0,2,2028,27,2055,3114,0,0,0,0,0,0,65.99
臺北縣,三重市,博愛里,0,2,2004,28,2032,3147,0,0,0,0,0,0,64.57
臺北縣,三重市,二重里,0,2,1059,22,1081,1749,0,0,0,0,0,0,61.81
臺北縣,三重市,頂崁里,0,2,940,20,960,1598,0,0,0,0,0,0,60.08
臺北縣,三重市,谷王里,0,2,744,7,751,1121,0,0,0,0,0,0,66.99
臺北縣,三重市,五谷里,0,2,1151,14,1165,1817,0,0,0,0,0,0,64.12
臺北縣,三重市,中興里,0,2,1892,29,1921,2839,0,0,0,0,0,0,67.66
臺北縣,三重市,德厚里,0,2,281,5,286,391,0,0,0,0,0,0,73.15
臺北縣,三重市,成功里,0,2,1397,14,1411,2490,0,0,0,0,0,0,56.67
臺北縣,三重市,福祉里,0,2,1705,26,1731,2640,0,0,0,0,0,0,65.57
臺北縣,三重市,福德里,0,2,1600,17,1617,2783,0,0,0,0,0,0,58.10
臺北縣,三重市,福民里,0,2,1561,18,1579,2392,0,0,0,0,0,0,66.01
臺北縣,三重市,過田里,0,2,2162,28,2190,3491,0,0,0,0,0,0,62.73
臺北縣,三重市,錦田里,0,2,1149,19,1168,1782,0,0,0,0,0,0,65.54
臺北縣,三重市,重明里,0,2,1363,23,1386,2082,0,0,0,0,0,0,66.57
臺北縣,三重市,光田里,0,2,1938,31,1969,3226,0,0,0,0,0,0,61.04
臺北縣,三重市,光陽里,0,2,2695,39,2734,4225,0,0,0,0,0,0,64.71
臺北縣,三重市,田心里,0,2,2063,28,2091,3388,0,0,0,0,0,0,61.72
臺北縣,三重市,福田里,0,2,1450,21,1471,2281,0,0,0,0,0,0,64.49
臺北縣,三重市,田中里,0,2,2691,29,2720,4181,0,0,0,0,0,0,65.06
臺北縣,三重市,田安里,0,2,2405,34,2439,4071,0,0,0,0,0,0,59.91
臺北縣,三重市,三民里,0,2,1315,16,1331,2010,0,0,0,0,0,0,66.22
臺北縣,三重市,光明里,0,2,2330,37,2367,4143,0,0,0,0,0,0,57.13
臺北縣,三重市,光正里,0,2,646,9,655,1188,0,0,0,0,0,0,55.13
臺北縣,三重市,同安里,0,2,871,17,888,1468,0,0,0,0,0,0,60.49
臺北縣,三重市,同慶里,0,2,884,26,910,1473,0,0,0,0,0,0,61.78
臺北縣,三重市,菜寮里,0,2,1005,10,1015,1695,0,0,0,0,0,0,59.88
臺北縣,三重市,永春里,0,2,795,8,803,1249,0,0,0,0,0,0,64.29
臺北縣,三重市,中正里,0,2,731,11,742,1134,0,0,0,0,0,0,65.43
臺北縣,三重市,吉利里,0,2,716,11,727,1292,0,0,0,0,0,0,56.27
臺北縣,三重市,大同里,0,2,893,9,902,1475,0,0,0,0,0,0,61.15
臺北縣,三重市,中民里,0,2,719,12,731,1180,0,0,0,0,0,0,61.95
臺北縣,三重市,平和里,0,2,944,14,958,1548,0,0,0,0,0,0,61.89
臺北縣,三重市,大安里,0,2,881,19,900,1422,0,0,0,0,0,0,63.29
臺北縣,三重市,仁德里,0,2,1158,21,1179,1889,0,0,0,0,0,0,62.41
臺北縣,三重市,忠孝里,0,2,903,12,915,1601,0,0,0,0,0,0,57.15
臺北縣,三重市,仁義里,0,2,705,6,711,1070,0,0,0,0,0,0,66.45
臺北縣,三重市,光榮里,0,2,611,6,617,1001,0,0,0,0,0,0,61.64
臺北縣,三重市,光輝里,0,2,1071,5,1076,1584,0,0,0,0,0,0,67.93
臺北縣,三重市,福星里,0,2,539,3,542,818,0,0,0,0,0,0,66.26
臺北縣,三重市,福利里,0,2,754,8,762,1378,0,0,0,0,0,0,55.30
臺北縣,三重市,清和里,0,2,1023,6,1029,1774,0,0,0,0,0,0,58.00
臺北縣,三重市,永興里,0,2,580,6,586,968,0,0,0,0,0,0,60.54
臺北縣,三重市,中山里,0,2,1154,11,1165,2014,0,0,0,0,0,0,57.85
臺北縣,三重市,大園里,0,2,1275,25,1300,2065,0,0,0,0,0,0,62.95
臺北縣,三重市,國隆里,0,2,1249,20,1269,2004,0,0,0,0,0,0,63.32
臺北縣,三重市,重陽里,0,2,1539,15,1554,2568,0,0,0,0,0,0,60.51
臺北縣,三重市,民生里,0,2,2104,36,2140,3428,0,0,0,0,0,0,62.43
臺北縣,三重市,重新里,0,2,848,13,861,1363,0,0,0,0,0,0,63.17
臺北縣,三重市,正德里,0,2,652,11,663,1040,0,0,0,0,0,0,63.75
臺北縣,三重市,正義里,0,2,915,9,924,1450,0,0,0,0,0,0,63.72
臺北縣,三重市,正安里,0,2,926,16,942,1555,0,0,0,0,0,0,60.58
臺北縣,三重市,自強里,0,2,979,12,991,1492,0,0,0,0,0,0,66.42
臺北縣,三重市,文化里,0,2,1276,14,1290,2180,0,0,0,0,0,0,59.17
臺北縣,三重市,中央里,0,2,954,17,971,1463,0,0,0,0,0,0,66.37
臺北縣,三重市,雙園里,0,2,566,3,569,944,0,0,0,0,0,0,60.28
臺北縣,三重市,錦通里,0,2,938,13,951,1510,0,0,0,0,0,0,62.98
臺北縣,三重市,錦安里,0,2,1141,10,1151,1713,0,0,0,0,0,0,67.19
臺北縣,三重市,長安里,0,2,1076,12,1088,1844,0,0,0,0,0,0,59.00
臺北縣,三重市,光華里,0,2,870,11,881,1482,0,0,0,0,0,0,59.45
臺北縣,三重市,長生里,0,2,406,10,416,724,0,0,0,0,0,0,57.46
臺北縣,三重市,開元里,0,2,842,9,851,1331,0,0,0,0,0,0,63.94
臺北縣,三重市,大德里,0,2,398,7,405,619,0,0,0,0,0,0,65.43
臺北縣,三重市,長元里,0,2,1221,23,1244,1983,0,0,0,0,0,0,62.73
臺北縣,三重市,長江里,0,2,1056,20,1076,1563,0,0,0,0,0,0,68.84
臺北縣,三重市,長泰里,0,2,1167,22,1189,1956,0,0,0,0,0,0,60.79
臺北縣,三重市,長福里,0,2,864,11,875,1404,0,0,0,0,0,0,62.32
臺北縣,三重市,介壽里,0,2,722,14,736,1097,0,0,0,0,0,0,67.09
臺北縣,三重市,萬壽里,0,2,959,16,975,1525,0,0,0,0,0,0,63.93
臺北縣,三重市,錦江里,0,2,1392,30,1422,2055,0,0,0,0,0,0,69.20
臺北縣,三重市,龍濱里,0,2,1552,35,1587,2327,0,0,0,0,0,0,68.20
臺北縣,三重市,龍門里,0,2,868,14,882,1495,0,0,0,0,0,0,59.00
臺北縣,三重市,秀江里,0,2,687,15,702,1118,0,0,0,0,0,0,62.79
臺北縣,三重市,奕壽里,0,2,860,9,869,1367,0,0,0,0,0,0,63.57
臺北縣,三重市,三安里,0,2,1369,22,1391,2200,0,0,0,0,0,0,63.23
臺北縣,三重市,福安里,0,2,1235,15,1250,2172,0,0,0,0,0,0,57.55
臺北縣,三重市,信安里,0,2,790,16,806,1350,0,0,0,0,0,0,59.70
臺北縣,三重市,安慶里,0,2,1068,13,1081,1808,0,0,0,0,0,0,59.79
臺北縣,三重市,幸福里,0,2,2055,34,2089,3521,0,0,0,0,0,0,59.33
臺北縣,三重市,六合里,0,2,2012,25,2037,2994,0,0,0,0,0,0,68.04
臺北縣,三重市,六福里,0,2,2266,23,2289,3804,0,0,0,0,0,0,60.17
臺北縣,三重市,順德里,0,2,1159,18,1177,1890,0,0,0,0,0,0,62.28
臺北縣,三重市,承德里,0,2,1027,18,1045,1639,0,0,0,0,0,0,63.76
臺北縣,三重市,瑞德里,0,2,1321,20,1341,2088,0,0,0,0,0,0,64.22
臺北縣,三重市,崇德里,0,2,2015,38,2053,3375,0,0,0,0,0,0,60.83
臺北縣,三重市,厚德里,0,2,1461,19,1480,2114,0,0,0,0,0,0,70.01
臺北縣,三重市,維德里,0,2,1378,21,1399,2209,0,0,0,0,0,0,63.33
臺北縣,三重市,尚德里,0,2,1595,15,1610,2528,0,0,0,0,0,0,63.69
臺北縣,三重市,培德里,0,2,1565,26,1591,2532,0,0,0,0,0,0,62.84
臺北縣,三重市,立德里,0,2,1539,22,1561,2559,0,0,0,0,0,0,61.00
臺北縣,三重市,永德里,0,2,2409,47,2456,3854,0,0,0,0,0,0,63.73
臺北縣,三重市,永煇里,0,2,1168,26,1194,1985,0,0,0,0,0,0,60.15
臺北縣,三重市,永發里,0,2,1955,23,1978,3130,0,0,0,0,0,0,63.19
臺北縣,三重市,永盛里,0,2,1823,35,1858,2682,0,0,0,0,0,0,69.28
臺北縣,三重市,永吉里,0,2,1331,22,1353,2135,0,0,0,0,0,0,63.37
臺北縣,三重市,永安里,0,2,1508,27,1535,2465,0,0,0,0,0,0,62.27
臺北縣,三重市,永豐里,0,2,2147,33,2180,3202,0,0,0,0,0,0,68.08
臺北縣,三重市,永福里,0,2,2291,22,2313,3630,0,0,0,0,0,0,63.72
臺北縣,三重市,永清里,0,2,2391,33,2424,3935,0,0,0,0,0,0,61.60
臺北縣,三重市,永順里,0,2,2100,54,2154,3196,0,0,0,0,0,0,67.40
臺北縣,三重市,溪美里,0,2,2745,42,2787,4453,0,0,0,0,0,0,62.59
臺北縣,三重市,福隆里,0,2,1647,24,1671,2612,0,0,0,0,0,0,63.97
臺北縣,三重市,五常里,0,2,1814,40,1854,2717,0,0,0,0,0,0,68.24
臺北縣,三重市,五福里,0,2,1410,27,1437,2165,0,0,0,0,0,0,66.37
臺北縣,三重市,仁忠里,0,2,1631,37,1668,2472,0,0,0,0,0,0,67.48
臺北縣,三重市,慈福里,0,2,1288,25,1313,1937,0,0,0,0,0,0,67.79
臺北縣,三重市,慈生里,0,2,1331,23,1354,1967,0,0,0,0,0,0,68.84
臺北縣,三重市,慈惠里,0,2,1291,20,1311,1865,0,0,0,0,0,0,70.29
臺北縣,三重市,慈愛里,0,2,2039,48,2087,2939,0,0,0,0,0,0,71.01
臺北縣,三重市,慈化里,0,2,1358,31,1389,1939,0,0,0,0,0,0,71.63
臺北縣,三重市,慈祐里,0,2,2069,32,2101,3187,0,0,0,0,0,0,65.92
臺北縣,三重市,富華里,0,2,1462,24,1486,2086,0,0,0,0,0,0,71.24
臺北縣,三重市,富貴里,0,2,1566,37,1603,2370,0,0,0,0,0,0,67.64
臺北縣,三重市,富福里,0,2,1104,21,1125,1665,0,0,0,0,0,0,67.57
臺北縣,三重市,五華里,0,2,1780,24,1804,2536,0,0,0,0,0,0,71.14
臺北縣,三重市,碧華里,0,2,1111,17,1128,1744,0,0,0,0,0,0,64.68
臺北縣,三重市,福樂里,0,2,1837,29,1866,2728,0,0,0,0,0,0,68.40
臺北縣,三重市,仁華里,0,2,1964,27,1991,2833,0,0,0,0,0,0,70.28
臺北縣,三重市,五順里,0,2,1533,20,1553,2640,0,0,0,0,0,0,58.83
臺北縣,蘆洲市,光華里,0,2,2206,36,2242,3387,0,0,0,0,0,0,66.19
臺北縣,蘆洲市,光明里,0,2,1740,22,1762,2793,0,0,0,0,0,0,63.09
臺北縣,蘆洲市,中路里,0,2,1574,17,1591,2365,0,0,0,0,0,0,67.27
臺北縣,蘆洲市,中華里,0,2,1430,25,1455,2156,0,0,0,0,0,0,67.49
臺北縣,蘆洲市,九芎里,0,2,1587,21,1608,2733,0,0,0,0,0,0,58.84
臺北縣,蘆洲市,永安里,0,2,1516,22,1538,2363,0,0,0,0,0,0,65.09
臺北縣,蘆洲市,延平里,0,2,1196,15,1211,1959,0,0,0,0,0,0,61.82
臺北縣,蘆洲市,長安里,0,2,1570,24,1594,2554,0,0,0,0,0,0,62.41
臺北縣,蘆洲市,忠義里,0,2,1061,12,1073,1560,0,0,0,0,0,0,68.78
臺北縣,蘆洲市,中原里,0,2,1560,12,1572,2516,0,0,0,0,0,0,62.48
臺北縣,蘆洲市,永康里,0,2,1609,17,1626,2611,0,0,0,0,0,0,62.27
臺北縣,蘆洲市,永德里,0,2,1340,22,1362,2317,0,0,0,0,0,0,58.78
臺北縣,蘆洲市,成功里,0,2,2020,31,2051,3501,0,0,0,0,0,0,58.58
臺北縣,蘆洲市,永樂里,0,2,1884,30,1914,3434,0,0,0,0,0,0,55.74
臺北縣,蘆洲市,南港里,0,2,1948,29,1977,3276,0,0,0,0,0,0,60.35
臺北縣,蘆洲市,正義里,0,2,422,8,430,619,0,0,0,0,0,0,69.47
臺北縣,蘆洲市,樓厝里,0,2,1957,28,1985,2994,0,0,0,0,0,0,66.30
臺北縣,蘆洲市,信義里,0,2,1916,22,1938,2716,0,0,0,0,0,0,71.35
臺北縣,蘆洲市,玉清里,0,2,1619,22,1641,2580,0,0,0,0,0,0,63.60
臺北縣,蘆洲市,復興里,0,2,1344,28,1372,2071,0,0,0,0,0,0,66.25
臺北縣,蘆洲市,福安里,0,2,1274,19,1293,1887,0,0,0,0,0,0,68.52
臺北縣,蘆洲市,鷺江里,0,2,1740,33,1773,2685,0,0,0,0,0,0,66.03
臺北縣,蘆洲市,恆德里,0,2,2342,36,2378,3881,0,0,0,0,0,0,61.27
臺北縣,蘆洲市,溪墘里,0,2,1550,22,1572,2242,0,0,0,0,0,0,70.12
臺北縣,蘆洲市,樹德里,0,2,1552,19,1571,2324,0,0,0,0,0,0,67.60
臺北縣,蘆洲市,民和里,0,2,1412,32,1444,2008,0,0,0,0,0,0,71.91
臺北縣,蘆洲市,得仁里,0,2,1268,21,1289,1893,0,0,0,0,0,0,68.09
臺北縣,蘆洲市,得勝里,0,2,1885,25,1910,2720,0,0,0,0,0,0,70.22
臺北縣,蘆洲市,仁復里,0,2,997,21,1018,1454,0,0,0,0,0,0,70.01
臺北縣,蘆洲市,仁德里,0,2,2262,45,2307,3418,0,0,0,0,0,0,67.50
臺北縣,蘆洲市,仁義里,0,2,1264,18,1282,1943,0,0,0,0,0,0,65.98
臺北縣,蘆洲市,保和里,0,2,1243,22,1265,1820,0,0,0,0,0,0,69.51
臺北縣,蘆洲市,水湳里,0,2,2556,38,2594,4190,0,0,0,0,0,0,61.91
臺北縣,蘆洲市,水河里,0,2,2584,52,2636,4149,0,0,0,0,0,0,63.53
臺北縣,蘆洲市,仁愛里,0,2,1826,33,1859,3001,0,0,0,0,0,0,61.95
臺北縣,蘆洲市,忠孝里,0,2,996,19,1015,1505,0,0,0,0,0,0,67.44
臺北縣,蘆洲市,保佑里,0,2,1613,17,1630,2562,0,0,0,0,0,0,63.62
臺北縣,蘆洲市,保新里,0,2,1452,30,1482,2160,0,0,0,0,0,0,68.61
臺北縣,新莊市,全安里,0,2,2029,29,2058,3240,0,0,0,0,0,0,63.52
臺北縣,新莊市,海山里,0,2,2409,34,2443,4037,0,0,0,0,0,0,60.52
臺北縣,新莊市,國泰里,0,2,872,10,882,1424,0,0,0,0,0,0,61.94
臺北縣,新莊市,豐年里,0,2,1473,24,1497,2667,0,0,0,0,0,0,56.13
臺北縣,新莊市,文聖里,0,2,1882,22,1904,2976,0,0,0,0,0,0,63.98
臺北縣,新莊市,文衡里,0,2,967,9,976,1487,0,0,0,0,0,0,65.64
臺北縣,新莊市,中全里,0,2,1449,15,1464,2571,0,0,0,0,0,0,56.94
臺北縣,新莊市,中和里,0,2,2141,33,2174,3571,0,0,0,0,0,0,60.88
臺北縣,新莊市,立基里,0,2,2188,19,2207,3905,0,0,0,0,0,0,56.52
臺北縣,新莊市,立廷里,0,2,1015,6,1021,1798,0,0,0,0,0,0,56.79
臺北縣,新莊市,立志里,0,2,1644,20,1664,2881,0,0,0,0,0,0,57.76
臺北縣,新莊市,中泰里,0,2,2289,32,2321,3776,0,0,0,0,0,0,61.47
臺北縣,新莊市,中宏里,0,2,1369,25,1394,2279,0,0,0,0,0,0,61.17
臺北縣,新莊市,忠孝里,0,2,2063,23,2086,3518,0,0,0,0,0,0,59.30
臺北縣,新莊市,立言里,0,2,2185,25,2210,3617,0,0,0,0,0,0,61.10
臺北縣,新莊市,全泰里,0,2,2129,21,2150,3496,0,0,0,0,0,0,61.50
臺北縣,新莊市,興漢里,0,2,1854,26,1880,2901,0,0,0,0,0,0,64.81
臺北縣,新莊市,榮和里,0,2,1637,26,1663,2673,0,0,0,0,0,0,62.21
臺北縣,新莊市,文德里,0,2,748,10,758,1146,0,0,0,0,0,0,66.14
臺北縣,新莊市,文明里,0,2,994,10,1004,1554,0,0,0,0,0,0,64.61
臺北縣,新莊市,福基里,0,2,1232,18,1250,1913,0,0,0,0,0,0,65.34
臺北縣,新莊市,福興里,0,2,1243,15,1258,2197,0,0,0,0,0,0,57.26
臺北縣,新莊市,化成里,0,2,1273,16,1289,2054,0,0,0,0,0,0,62.76
臺北縣,新莊市,思賢里,0,2,1582,26,1608,2595,0,0,0,0,0,0,61.97
臺北縣,新莊市,仁愛里,0,2,1321,19,1340,2313,0,0,0,0,0,0,57.93
臺北縣,新莊市,仁義里,0,2,1418,17,1435,2478,0,0,0,0,0,0,57.91
臺北縣,新莊市,思源里,0,2,2157,25,2182,3736,0,0,0,0,0,0,58.40
臺北縣,新莊市,自強里,0,2,1395,22,1417,2372,0,0,0,0,0,0,59.74
臺北縣,新莊市,自立里,0,2,2204,37,2241,3660,0,0,0,0,0,0,61.23
臺北縣,新莊市,自信里,0,2,1065,18,1083,1746,0,0,0,0,0,0,62.03
臺北縣,新莊市,中信里,0,2,2478,32,2510,4112,0,0,0,0,0,0,61.04
臺北縣,新莊市,中平里,0,2,1631,22,1653,3102,0,0,0,0,0,0,53.29
臺北縣,新莊市,中港里,0,2,2232,30,2262,3972,0,0,0,0,0,0,56.95
臺北縣,新莊市,立德里,0,2,1166,8,1174,1977,0,0,0,0,0,0,59.38
臺北縣,新莊市,立功里,0,2,1620,18,1638,2987,0,0,0,0,0,0,54.84
臺北縣,新莊市,立泰里,0,2,1761,24,1785,2915,0,0,0,0,0,0,61.23
臺北縣,新莊市,頭前里,0,2,1881,28,1909,3044,0,0,0,0,0,0,62.71
臺北縣,新莊市,和平里,0,2,1754,19,1773,3055,0,0,0,0,0,0,58.04
臺北縣,新莊市,昌平里,0,2,1212,18,1230,2272,0,0,0,0,0,0,54.14
臺北縣,新莊市,信義里,0,2,1962,32,1994,3441,0,0,0,0,0,0,57.95
臺北縣,新莊市,昌信里,0,2,835,11,846,1481,0,0,0,0,0,0,57.12
臺北縣,新莊市,昌隆里,0,2,1171,7,1178,1937,0,0,0,0,0,0,60.82
臺北縣,新莊市,昌明里,0,2,1533,28,1561,2358,0,0,0,0,0,0,66.20
臺北縣,新莊市,幸福里,0,2,1808,25,1833,3353,0,0,0,0,0,0,54.67
臺北縣,新莊市,中原里,0,2,2050,27,2077,3577,0,0,0,0,0,0,58.07
臺北縣,新莊市,中誠里,0,2,1039,18,1057,1675,0,0,0,0,0,0,63.10
臺北縣,新莊市,中隆里,0,2,1315,18,1333,2200,0,0,0,0,0,0,60.59
臺北縣,新莊市,中美里,0,2,2409,25,2434,4030,0,0,0,0,0,0,60.40
臺北縣,新莊市,中華里,0,2,803,11,814,1242,0,0,0,0,0,0,65.54
臺北縣,新莊市,恆安里,0,2,2156,26,2182,3559,0,0,0,0,0,0,61.31
臺北縣,新莊市,立人里,0,2,984,11,995,1537,0,0,0,0,0,0,64.74
臺北縣,新莊市,瓊林里,0,2,2480,38,2518,4307,0,0,0,0,0,0,58.46
臺北縣,新莊市,營盤里,0,2,1210,11,1221,1937,0,0,0,0,0,0,63.04
臺北縣,新莊市,福營里,0,2,1229,19,1248,1969,0,0,0,0,0,0,63.38
臺北縣,新莊市,泰豐里,0,2,1064,13,1077,1846,0,0,0,0,0,0,58.34
臺北縣,新莊市,丹鳳里,0,2,1739,17,1756,3180,0,0,0,0,0,0,55.22
臺北縣,新莊市,合鳳里,0,2,1897,18,1915,3138,0,0,0,0,0,0,61.03
臺北縣,新莊市,雙鳳里,0,2,1944,25,1969,3241,0,0,0,0,0,0,60.75
臺北縣,新莊市,祥鳳里,0,2,927,9,936,1453,0,0,0,0,0,0,64.42
臺北縣,新莊市,富國里,0,2,1095,15,1110,1823,0,0,0,0,0,0,60.89
臺北縣,新莊市,富民里,0,2,1279,21,1300,2367,0,0,0,0,0,0,54.92
臺北縣,新莊市,龍鳳里,0,2,1828,21,1849,3261,0,0,0,0,0,0,56.70
臺北縣,新莊市,龍安里,0,2,899,6,905,1672,0,0,0,0,0,0,54.13
臺北縣,新莊市,裕民里,0,2,2240,32,2272,4034,0,0,0,0,0,0,56.32
臺北縣,新莊市,建福里,0,2,1013,24,1037,1800,0,0,0,0,0,0,57.61
臺北縣,新莊市,民本里,0,2,1303,14,1317,2226,0,0,0,0,0,0,59.16
臺北縣,新莊市,民全里,0,2,1203,21,1224,2096,0,0,0,0,0,0,58.40
臺北縣,新莊市,八德里,0,2,1117,13,1130,2118,0,0,0,0,0,0,53.35
臺北縣,新莊市,民安里,0,2,1656,23,1679,2881,0,0,0,0,0,0,58.28
臺北縣,新莊市,建安里,0,2,1725,27,1752,3454,0,0,0,0,0,0,50.72
臺北縣,新莊市,民有里,0,2,1191,16,1207,2139,0,0,0,0,0,0,56.43
臺北縣,新莊市,四維里,0,2,1679,38,1717,3281,0,0,0,0,0,0,52.33
臺北縣,新莊市,南港里,0,2,1724,24,1748,3321,0,0,0,0,0,0,52.63
臺北縣,新莊市,後德里,0,2,1097,9,1106,1946,0,0,0,0,0,0,56.83
臺北縣,新莊市,萬安里,0,2,1288,14,1302,2339,0,0,0,0,0,0,55.66
臺北縣,新莊市,光華里,0,2,1816,31,1847,3707,0,0,0,0,0,0,49.82
臺北縣,新莊市,光明里,0,2,1238,23,1261,2391,0,0,0,0,0,0,52.74
臺北縣,新莊市,成德里,0,2,1382,18,1400,2630,0,0,0,0,0,0,53.23
臺北縣,新莊市,龍福里,0,2,560,4,564,1026,0,0,0,0,0,0,54.97
臺北縣,新莊市,西盛里,0,2,1951,36,1987,3752,0,0,0,0,0,0,52.96
臺北縣,新莊市,光正里,0,2,1101,7,1108,2041,0,0,0,0,0,0,54.29
臺北縣,新莊市,光榮里,0,2,1126,13,1139,2052,0,0,0,0,0,0,55.51
臺北縣,新莊市,光和里,0,2,838,12,850,1593,0,0,0,0,0,0,53.36
臺北縣,新莊市,後港里,0,2,2322,29,2351,4339,0,0,0,0,0,0,54.18
臺北縣,五股鄉,興珍村,0,2,2133,22,2155,3363,0,0,0,0,0,0,64.08
臺北縣,五股鄉,更寮村,0,2,674,5,679,1073,0,0,0,0,0,0,63.28
臺北縣,五股鄉,集福村,0,2,1162,26,1188,1836,0,0,0,0,0,0,64.71
臺北縣,五股鄉,集賢村,0,2,1317,15,1332,2195,0,0,0,0,0,0,60.68
臺北縣,五股鄉,觀音村,0,2,781,11,792,1214,0,0,0,0,0,0,65.24
臺北縣,五股鄉,成德村,0,2,1265,28,1293,2081,0,0,0,0,0,0,62.13
臺北縣,五股鄉,成州村,0,2,2100,29,2129,3381,0,0,0,0,0,0,62.97
臺北縣,五股鄉,成功村,0,2,1321,28,1349,2295,0,0,0,0,0,0,58.78
臺北縣,五股鄉,成泰村,0,2,1277,28,1305,2038,0,0,0,0,0,0,64.03
臺北縣,五股鄉,五福村,0,2,1439,17,1456,2356,0,0,0,0,0,0,61.80
臺北縣,五股鄉,六福村,0,2,1182,10,1192,1983,0,0,0,0,0,0,60.11
臺北縣,五股鄉,五龍村,0,2,729,11,740,1099,0,0,0,0,0,0,67.33
臺北縣,五股鄉,五股村,0,2,1594,14,1608,2632,0,0,0,0,0,0,61.09
臺北縣,五股鄉,民義村,0,2,1252,13,1265,1918,0,0,0,0,0,0,65.95
臺北縣,五股鄉,德音村,0,2,1631,14,1645,2644,0,0,0,0,0,0,62.22
臺北縣,五股鄉,水碓村,0,2,2559,47,2606,4085,0,0,0,0,0,0,63.79
臺北縣,五股鄉,德泰村,0,2,1880,31,1911,3162,0,0,0,0,0,0,60.44
臺北縣,五股鄉,陸一村,0,2,1347,14,1361,2037,0,0,0,0,0,0,66.81
臺北縣,五股鄉,貿商村,0,2,441,6,447,718,0,0,0,0,0,0,62.26
臺北縣,泰山鄉,大科村,0,2,615,6,621,853,0,0,0,0,0,0,72.80
臺北縣,泰山鄉,黎明村,0,2,1240,25,1265,2068,0,0,0,0,0,0,61.17
臺北縣,泰山鄉,山腳村,0,2,2424,26,2450,4238,0,0,0,0,0,0,57.81
臺北縣,泰山鄉,福泰村,0,2,2347,30,2377,3799,0,0,0,0,0,0,62.57
臺北縣,泰山鄉,楓樹村,0,2,1479,18,1497,2421,0,0,0,0,0,0,61.83
臺北縣,泰山鄉,同榮村,0,2,1617,17,1634,2560,0,0,0,0,0,0,63.83
臺北縣,泰山鄉,同興村,0,2,1180,16,1196,1855,0,0,0,0,0,0,64.47
臺北縣,泰山鄉,義學村,0,2,1693,21,1714,2783,0,0,0,0,0,0,61.59
臺北縣,泰山鄉,義仁村,0,2,1943,18,1961,3413,0,0,0,0,0,0,57.46
臺北縣,泰山鄉,明志村,0,2,1540,29,1569,2583,0,0,0,0,0,0,60.74
臺北縣,泰山鄉,泰友村,0,2,1016,10,1026,1632,0,0,0,0,0,0,62.87
臺北縣,泰山鄉,新明村,0,2,1371,21,1392,2308,0,0,0,0,0,0,60.31
臺北縣,泰山鄉,貴子村,0,2,1604,22,1626,2614,0,0,0,0,0,0,62.20
臺北縣,泰山鄉,貴賢村,0,2,1544,24,1568,2505,0,0,0,0,0,0,62.59
臺北縣,泰山鄉,貴和村,0,2,2079,27,2106,3490,0,0,0,0,0,0,60.34
臺北縣,林口鄉,東林村,0,2,1990,22,2012,3132,0,0,0,0,0,0,64.24
臺北縣,林口鄉,林口村,0,2,1908,27,1935,3188,0,0,0,0,0,0,60.70
臺北縣,林口鄉,西林村,0,2,1844,28,1872,2951,0,0,0,0,0,0,63.44
臺北縣,林口鄉,菁湖村,0,2,1776,18,1794,2828,0,0,0,0,0,0,63.44
臺北縣,林口鄉,中湖村,0,2,1582,19,1601,2344,0,0,0,0,0,0,68.30
臺北縣,林口鄉,湖北村,0,2,793,10,803,998,0,0,0,0,0,0,80.46
臺北縣,林口鄉,湖南村,0,2,994,11,1005,1453,0,0,0,0,0,0,69.17
臺北縣,林口鄉,南勢村,0,2,2750,56,2806,5189,0,0,0,0,0,0,54.08
臺北縣,林口鄉,東勢村,0,2,3104,48,3152,5434,0,0,0,0,0,0,58.01
臺北縣,林口鄉,頂福村,0,2,595,5,600,900,0,0,0,0,0,0,66.67
臺北縣,林口鄉,下福村,0,2,626,11,637,882,0,0,0,0,0,0,72.22
臺北縣,林口鄉,嘉寶村,0,2,488,9,497,618,0,0,0,0,0,0,80.42
臺北縣,林口鄉,瑞平村,0,2,338,7,345,447,0,0,0,0,0,0,77.18
臺北縣,林口鄉,太平村,0,2,533,6,539,788,0,0,0,0,0,0,68.40
臺北縣,淡水鎮,中和里,0,2,434,8,442,573,0,0,0,0,0,0,77.14
臺北縣,淡水鎮,屯山里,0,2,752,11,763,957,0,0,0,0,0,0,79.73
臺北縣,淡水鎮,賢孝里,0,2,924,13,937,1237,0,0,0,0,0,0,75.75
臺北縣,淡水鎮,興仁里,0,2,961,12,973,1280,0,0,0,0,0,0,76.02
臺北縣,淡水鎮,蕃薯里,0,2,430,1,431,748,0,0,0,0,0,0,57.62
臺北縣,淡水鎮,義山里,0,2,1349,28,1377,2139,0,0,0,0,0,0,64.38
臺北縣,淡水鎮,忠山里,0,2,631,8,639,785,0,0,0,0,0,0,81.40
臺北縣,淡水鎮,水源里,0,2,1064,11,1075,1659,0,0,0,0,0,0,64.80
臺北縣,淡水鎮,忠寮里,0,2,652,10,662,909,0,0,0,0,0,0,72.83
臺北縣,淡水鎮,樹興里,0,2,468,11,479,706,0,0,0,0,0,0,67.85
臺北縣,淡水鎮,坪頂里,0,2,558,7,565,907,0,0,0,0,0,0,62.29
臺北縣,淡水鎮,福德里,0,2,2190,26,2216,4132,0,0,0,0,0,0,53.63
臺北縣,淡水鎮,竹圍里,0,2,2335,46,2381,4156,0,0,0,0,0,0,57.29
臺北縣,淡水鎮,民生里,0,2,2188,41,2229,3771,0,0,0,0,0,0,59.11
臺北縣,淡水鎮,八勢里,0,2,545,8,553,876,0,0,0,0,0,0,63.13
臺北縣,淡水鎮,竿蓁里,0,2,1107,8,1115,2105,0,0,0,0,0,0,52.97
臺北縣,淡水鎮,崁頂里,0,2,787,11,798,1136,0,0,0,0,0,0,70.25
臺北縣,淡水鎮,埤島里,0,2,809,19,828,1067,0,0,0,0,0,0,77.60
臺北縣,淡水鎮,新興里,0,2,5462,65,5527,9477,0,0,0,0,0,0,58.32
臺北縣,淡水鎮,水碓里,0,2,4119,77,4196,7033,0,0,0,0,0,0,59.66
臺北縣,淡水鎮,北投里,0,2,925,18,943,1548,0,0,0,0,0,0,60.92
臺北縣,淡水鎮,鄧公里,0,2,4771,75,4846,7978,0,0,0,0,0,0,60.74
臺北縣,淡水鎮,中興里,0,2,2279,48,2327,3573,0,0,0,0,0,0,65.13
臺北縣,淡水鎮,長庚里,0,2,1028,19,1047,1543,0,0,0,0,0,0,67.85
臺北縣,淡水鎮,清文里,0,2,678,12,690,988,0,0,0,0,0,0,69.84
臺北縣,淡水鎮,草東里,0,2,561,8,569,804,0,0,0,0,0,0,70.77
臺北縣,淡水鎮,協元里,0,2,883,17,900,1385,0,0,0,0,0,0,64.98
臺北縣,淡水鎮,永吉里,0,2,496,13,509,731,0,0,0,0,0,0,69.63
臺北縣,淡水鎮,民安里,0,2,479,4,483,748,0,0,0,0,0,0,64.57
臺北縣,淡水鎮,新生里,0,2,327,10,337,498,0,0,0,0,0,0,67.67
臺北縣,淡水鎮,文化里,0,2,679,9,688,1061,0,0,0,0,0,0,64.84
臺北縣,淡水鎮,油車里,0,2,1970,27,1997,3214,0,0,0,0,0,0,62.13
臺北縣,淡水鎮,沙崙里,0,2,2333,38,2371,3855,0,0,0,0,0,0,61.50
臺北縣,八里鄉,龍源村,0,2,2183,50,2233,3461,0,0,0,0,0,0,64.52
臺北縣,八里鄉,米倉村,0,2,1171,23,1194,1823,0,0,0,0,0,0,65.50
臺北縣,八里鄉,大崁村,0,2,828,14,842,1149,0,0,0,0,0,0,73.28
臺北縣,八里鄉,埤頭村,0,2,1217,15,1232,1970,0,0,0,0,0,0,62.54
臺北縣,八里鄉,頂罟村,0,2,602,21,623,865,0,0,0,0,0,0,72.02
臺北縣,八里鄉,舊城村,0,2,1891,35,1926,3267,0,0,0,0,0,0,58.95
臺北縣,八里鄉,訊塘村,0,2,1370,28,1398,2077,0,0,0,0,0,0,67.31
臺北縣,八里鄉,荖阡村,0,2,682,15,697,916,0,0,0,0,0,0,76.09
臺北縣,八里鄉,下罟村,0,2,788,14,802,951,0,0,0,0,0,0,84.33
臺北縣,八里鄉,長坑村,0,2,765,10,775,1030,0,0,0,0,0,0,75.24
臺北縣,三芝鄉,八賢村,0,2,219,1,220,335,0,0,0,0,0,0,65.67
臺北縣,三芝鄉,埔頭村,0,2,1954,27,1981,3208,0,0,0,0,0,0,61.75
臺北縣,三芝鄉,古庄村,0,2,568,8,576,808,0,0,0,0,0,0,71.29
臺北縣,三芝鄉,新庄村,0,2,490,5,495,794,0,0,0,0,0,0,62.34
臺北縣,三芝鄉,埔坪村,0,2,2514,32,2546,4121,0,0,0,0,0,0,61.78
臺北縣,三芝鄉,茂長村,0,2,228,2,230,413,0,0,0,0,0,0,55.69
臺北縣,三芝鄉,橫山村,0,2,369,5,374,536,0,0,0,0,0,0,69.78
臺北縣,三芝鄉,錫板村,0,2,469,6,475,779,0,0,0,0,0,0,60.98
臺北縣,三芝鄉,後厝村,0,2,729,20,749,1248,0,0,0,0,0,0,60.02
臺北縣,三芝鄉,福德村,0,2,359,5,364,577,0,0,0,0,0,0,63.08
臺北縣,三芝鄉,圓山村,0,2,302,5,307,500,0,0,0,0,0,0,61.40
臺北縣,三芝鄉,店子村,0,2,423,7,430,641,0,0,0,0,0,0,67.08
臺北縣,三芝鄉,興華村,0,2,683,3,686,1117,0,0,0,0,0,0,61.41
臺北縣,石門鄉,德茂村,0,2,515,3,518,752,0,0,0,0,0,0,68.88
臺北縣,石門鄉,富基村,0,2,648,6,654,1002,0,0,0,0,0,0,65.27
臺北縣,石門鄉,老梅村,0,2,991,34,1025,1534,0,0,0,0,0,0,66.82
臺北縣,石門鄉,山溪村,0,2,431,5,436,638,0,0,0,0,0,0,68.34
臺北縣,石門鄉,石門村,0,2,727,7,734,1046,0,0,0,0,0,0,70.17
臺北縣,石門鄉,尖鹿村,0,2,735,10,745,1091,0,0,0,0,0,0,68.29
臺北縣,石門鄉,乾華村,0,2,151,2,153,268,0,0,0,0,0,0,57.09
臺北縣,石門鄉,茂林村,0,2,351,6,357,511,0,0,0,0,0,0,69.86
臺北縣,石門鄉,草里村,0,2,449,7,456,652,0,0,0,0,0,0,69.94
臺北縣,金山鄉,和平村,0,2,269,4,273,437,0,0,0,0,0,0,62.47
臺北縣,金山鄉,大同村,0,2,424,5,429,645,0,0,0,0,0,0,66.51
臺北縣,金山鄉,豐漁村,0,2,293,2,295,445,0,0,0,0,0,0,66.29
臺北縣,金山鄉,磺港村,0,2,859,9,868,1409,0,0,0,0,0,0,61.60
臺北縣,金山鄉,美田村,0,2,3630,33,3663,5829,0,0,0,0,0,0,62.84
臺北縣,金山鄉,五湖村,0,2,874,12,886,1377,0,0,0,0,0,0,64.34
臺北縣,金山鄉,重和村,0,2,469,3,472,823,0,0,0,0,0,0,57.35
臺北縣,金山鄉,兩湖村,0,2,242,3,245,368,0,0,0,0,0,0,66.58
臺北縣,金山鄉,六股村,0,2,336,2,338,515,0,0,0,0,0,0,65.63
臺北縣,金山鄉,三界村,0,2,343,4,347,545,0,0,0,0,0,0,63.67
臺北縣,金山鄉,清泉村,0,2,469,9,478,765,0,0,0,0,0,0,62.48
臺北縣,金山鄉,西湖村,0,2,147,0,147,239,0,0,0,0,0,0,61.51
臺北縣,金山鄉,萬壽村,0,2,273,7,280,429,0,0,0,0,0,0,65.27
臺北縣,金山鄉,永興村,0,2,317,1,318,552,0,0,0,0,0,0,57.61
臺北縣,萬里鄉,萬里村,0,2,1869,23,1892,2908,0,0,0,0,0,0,65.06
臺北縣,萬里鄉,北基村,0,2,1081,21,1102,1911,0,0,0,0,0,0,57.67
臺北縣,萬里鄉,龜吼村,0,2,974,11,985,1537,0,0,0,0,0,0,64.09
臺北縣,萬里鄉,野柳村,0,2,1261,17,1278,2130,0,0,0,0,0,0,60.00
臺北縣,萬里鄉,大鵬村,0,2,1307,20,1327,2051,0,0,0,0,0,0,64.70
臺北縣,萬里鄉,磺潭村,0,2,309,4,313,455,0,0,0,0,0,0,68.79
臺北縣,萬里鄉,雙興村,0,2,446,5,451,758,0,0,0,0,0,0,59.50
臺北縣,萬里鄉,溪底村,0,2,314,3,317,538,0,0,0,0,0,0,58.92
臺北縣,萬里鄉,崁腳村,0,2,308,3,311,564,0,0,0,0,0,0,55.14
臺北縣,萬里鄉,中幅村,0,2,464,17,481,767,0,0,0,0,0,0,62.71
臺北縣,中和市,中原里,0,3,1361,18,1379,2545,0,0,0,0,0,0,54.18
臺北縣,中和市,連和里,0,3,779,6,785,1282,0,0,0,0,0,0,61.23
臺北縣,中和市,連城里,0,3,2567,32,2599,4355,0,0,0,0,0,0,59.68
臺北縣,中和市,力行里,0,3,1784,25,1809,3063,0,0,0,0,0,0,59.06
臺北縣,中和市,正行里,0,3,1039,12,1051,1883,0,0,0,0,0,0,55.82
臺北縣,中和市,德行里,0,3,1855,30,1885,3151,0,0,0,0,0,0,59.82
臺北縣,中和市,枋寮里,0,3,1631,18,1649,2696,0,0,0,0,0,0,61.16
臺北縣,中和市,漳和里,0,3,1628,24,1652,2618,0,0,0,0,0,0,63.10
臺北縣,中和市,廟美里,0,3,2127,25,2152,3582,0,0,0,0,0,0,60.08
臺北縣,中和市,福真里,0,3,1872,37,1909,3333,0,0,0,0,0,0,57.28
臺北縣,中和市,福善里,0,3,1818,18,1836,2912,0,0,0,0,0,0,63.05
臺北縣,中和市,福美里,0,3,2329,26,2355,3753,0,0,0,0,0,0,62.75
臺北縣,中和市,福祥里,0,3,1927,32,1959,3255,0,0,0,0,0,0,60.18
臺北縣,中和市,瓦窯里,0,3,2076,21,2097,3700,0,0,0,0,0,0,56.68
臺北縣,中和市,福和里,0,3,1744,18,1762,2995,0,0,0,0,0,0,58.83
臺北縣,中和市,佳和里,0,3,2220,35,2255,3814,0,0,0,0,0,0,59.12
臺北縣,中和市,新南里,0,3,2342,34,2376,4140,0,0,0,0,0,0,57.39
臺北縣,中和市,南山里,0,3,1788,21,1809,3048,0,0,0,0,0,0,59.35
臺北縣,中和市,平河里,0,3,1960,31,1991,3598,0,0,0,0,0,0,55.34
臺北縣,中和市,信和里,0,3,1846,44,1890,3255,0,0,0,0,0,0,58.06
臺北縣,中和市,仁和里,0,3,1985,39,2024,3294,0,0,0,0,0,0,61.45
臺北縣,中和市,中正里,0,3,1818,19,1837,2969,0,0,0,0,0,0,61.87
臺北縣,中和市,中山里,0,3,1083,15,1098,1783,0,0,0,0,0,0,61.58
臺北縣,中和市,建和里,0,3,2025,32,2057,3303,0,0,0,0,0,0,62.28
臺北縣,中和市,碧河里,0,3,1240,24,1264,2268,0,0,0,0,0,0,55.73
臺北縣,中和市,宜安里,0,3,1023,13,1036,1625,0,0,0,0,0,0,63.75
臺北縣,中和市,安樂里,0,3,1576,22,1598,2557,0,0,0,0,0,0,62.50
臺北縣,中和市,安和里,0,3,1413,20,1433,2316,0,0,0,0,0,0,61.87
臺北縣,中和市,安順里,0,3,1933,22,1955,3227,0,0,0,0,0,0,60.58
臺北縣,中和市,安平里,0,3,2422,26,2448,3783,0,0,0,0,0,0,64.71
臺北縣,中和市,中安里,0,3,1910,21,1931,3005,0,0,0,0,0,0,64.26
臺北縣,中和市,泰安里,0,3,1939,30,1969,3169,0,0,0,0,0,0,62.13
臺北縣,中和市,秀山里,0,3,1965,36,2001,3351,0,0,0,0,0,0,59.71
臺北縣,中和市,秀成里,0,3,1605,24,1629,2748,0,0,0,0,0,0,59.28
臺北縣,中和市,秀義里,0,3,1316,29,1345,2214,0,0,0,0,0,0,60.75
臺北縣,中和市,秀福里,0,3,2352,24,2376,3762,0,0,0,0,0,0,63.16
臺北縣,中和市,秀景里,0,3,2659,36,2695,4513,0,0,0,0,0,0,59.72
臺北縣,中和市,秀明里,0,3,1742,19,1761,2840,0,0,0,0,0,0,62.01
臺北縣,中和市,秀峰里,0,3,1558,14,1572,2672,0,0,0,0,0,0,58.83
臺北縣,中和市,秀士里,0,3,1271,30,1301,2077,0,0,0,0,0,0,62.64
臺北縣,中和市,秀水里,0,3,1995,30,2025,3360,0,0,0,0,0,0,60.27
臺北縣,中和市,秀仁里,0,3,1388,23,1411,2305,0,0,0,0,0,0,61.21
臺北縣,中和市,正南里,0,3,1774,36,1810,3155,0,0,0,0,0,0,57.37
臺北縣,中和市,頂南里,0,3,1474,22,1496,2433,0,0,0,0,0,0,61.49
臺北縣,中和市,華新里,0,3,2110,30,2140,4009,0,0,0,0,0,0,53.38
臺北縣,中和市,東南里,0,3,2561,39,2600,4123,0,0,0,0,0,0,63.06
臺北縣,中和市,華南里,0,3,1649,25,1674,2896,0,0,0,0,0,0,57.80
臺北縣,中和市,忠孝里,0,3,2206,38,2244,4016,0,0,0,0,0,0,55.88
臺北縣,中和市,崇南里,0,3,1714,27,1741,2773,0,0,0,0,0,0,62.78
臺北縣,中和市,興南里,0,3,1735,31,1766,2925,0,0,0,0,0,0,60.38
臺北縣,中和市,景南里,0,3,1648,22,1670,2758,0,0,0,0,0,0,60.55
臺北縣,中和市,景本里,0,3,1123,16,1139,1866,0,0,0,0,0,0,61.04
臺北縣,中和市,橫路里,0,3,200,3,203,305,0,0,0,0,0,0,66.56
臺北縣,中和市,內南里,0,3,2422,35,2457,4045,0,0,0,0,0,0,60.74
臺北縣,中和市,壽南里,0,3,1354,22,1376,2250,0,0,0,0,0,0,61.16
臺北縣,中和市,福南里,0,3,1812,46,1858,3146,0,0,0,0,0,0,59.06
臺北縣,中和市,外南里,0,3,1789,23,1812,3067,0,0,0,0,0,0,59.08
臺北縣,中和市,中興里,0,3,1965,33,1998,3388,0,0,0,0,0,0,58.97
臺北縣,中和市,吉興里,0,3,1068,17,1085,1892,0,0,0,0,0,0,57.35
臺北縣,中和市,復興里,0,3,2653,29,2682,4412,0,0,0,0,0,0,60.79
臺北縣,中和市,和興里,0,3,1625,26,1651,2736,0,0,0,0,0,0,60.34
臺北縣,中和市,景平里,0,3,1984,22,2006,3490,0,0,0,0,0,0,57.48
臺北縣,中和市,景新里,0,3,1791,15,1806,2906,0,0,0,0,0,0,62.15
臺北縣,中和市,景福里,0,3,2294,36,2330,4092,0,0,0,0,0,0,56.94
臺北縣,中和市,景安里,0,3,2441,33,2474,3913,0,0,0,0,0,0,63.23
臺北縣,中和市,景文里,0,3,1455,23,1478,2406,0,0,0,0,0,0,61.43
臺北縣,中和市,錦和里,0,3,1284,15,1299,2159,0,0,0,0,0,0,60.17
臺北縣,中和市,錦中里,0,3,1551,17,1568,2643,0,0,0,0,0,0,59.33
臺北縣,中和市,錦昌里,0,3,842,8,850,1407,0,0,0,0,0,0,60.41
臺北縣,中和市,錦盛里,0,3,1512,22,1534,2634,0,0,0,0,0,0,58.24
臺北縣,中和市,灰窯里,0,3,300,1,301,483,0,0,0,0,0,0,62.32
臺北縣,中和市,積穗里,0,3,2240,23,2263,3835,0,0,0,0,0,0,59.01
臺北縣,中和市,民享里,0,3,1368,16,1384,2026,0,0,0,0,0,0,68.31
臺北縣,中和市,民有里,0,3,1536,22,1558,2552,0,0,0,0,0,0,61.05
臺北縣,中和市,員山里,0,3,1805,24,1829,3209,0,0,0,0,0,0,57.00
臺北縣,中和市,員富里,0,3,919,24,943,1821,0,0,0,0,0,0,51.78
臺北縣,中和市,嘉穗里,0,3,1257,17,1274,2149,0,0,0,0,0,0,59.28
臺北縣,中和市,嘉慶里,0,3,1449,18,1467,2871,0,0,0,0,0,0,51.10
臺北縣,中和市,文元里,0,3,2339,30,2369,4266,0,0,0,0,0,0,55.53
臺北縣,中和市,嘉新里,0,3,1548,27,1575,2838,0,0,0,0,0,0,55.50
臺北縣,中和市,民安里,0,3,2018,28,2046,3540,0,0,0,0,0,0,57.80
臺北縣,中和市,安穗里,0,3,1571,20,1591,2814,0,0,0,0,0,0,56.54
臺北縣,中和市,瑞穗里,0,3,1092,10,1102,1797,0,0,0,0,0,0,61.32
臺北縣,中和市,冠穗里,0,3,1622,13,1635,2712,0,0,0,0,0,0,60.29
臺北縣,中和市,明穗里,0,3,1728,25,1753,3033,0,0,0,0,0,0,57.80
臺北縣,中和市,清穗里,0,3,1414,40,1454,2488,0,0,0,0,0,0,58.44
臺北縣,中和市,自強里,0,3,1923,30,1953,3468,0,0,0,0,0,0,56.31
臺北縣,中和市,德穗里,0,3,2207,33,2240,3747,0,0,0,0,0,0,59.78
臺北縣,中和市,民生里,0,3,1644,23,1667,2797,0,0,0,0,0,0,59.60
臺北縣,中和市,國光里,0,3,1621,10,1631,2879,0,0,0,0,0,0,56.65
臺北縣,中和市,國華里,0,3,1255,19,1274,2369,0,0,0,0,0,0,53.78
臺北縣,中和市,壽德里,0,3,1007,11,1018,1638,0,0,0,0,0,0,62.15
臺北縣,中和市,明德里,0,3,1755,20,1775,3089,0,0,0,0,0,0,57.46
臺北縣,永和市,光復里,0,3,912,19,931,1546,0,0,0,0,0,0,60.22
臺北縣,永和市,網溪里,0,3,554,11,565,1045,0,0,0,0,0,0,54.07
臺北縣,永和市,復興里,0,3,1117,14,1131,2010,0,0,0,0,0,0,56.27
臺北縣,永和市,竹林里,0,3,1860,28,1888,3373,0,0,0,0,0,0,55.97
臺北縣,永和市,桂林里,0,3,1704,20,1724,3012,0,0,0,0,0,0,57.24
臺北縣,永和市,上林里,0,3,1862,17,1879,3227,0,0,0,0,0,0,58.23
臺北縣,永和市,福林里,0,3,1826,12,1838,3164,0,0,0,0,0,0,58.09
臺北縣,永和市,勵行里,0,3,689,12,701,1226,0,0,0,0,0,0,57.18
臺北縣,永和市,中興里,0,3,1477,12,1489,2693,0,0,0,0,0,0,55.29
臺北縣,永和市,永興里,0,3,1697,20,1717,3129,0,0,0,0,0,0,54.87
臺北縣,永和市,正興里,0,3,1138,13,1151,2048,0,0,0,0,0,0,56.20
臺北縣,永和市,豫溪里,0,3,1658,12,1670,2918,0,0,0,0,0,0,57.23
臺北縣,永和市,光明里,0,3,1560,12,1572,2600,0,0,0,0,0,0,60.46
臺北縣,永和市,福和里,0,3,2035,22,2057,3670,0,0,0,0,0,0,56.05
臺北縣,永和市,得和里,0,3,2125,15,2140,3490,0,0,0,0,0,0,61.32
臺北縣,永和市,永貞里,0,3,1748,22,1770,3037,0,0,0,0,0,0,58.28
臺北縣,永和市,永福里,0,3,1487,16,1503,2456,0,0,0,0,0,0,61.20
臺北縣,永和市,河濱里,0,3,1476,18,1494,2475,0,0,0,0,0,0,60.36
臺北縣,永和市,秀和里,0,3,1981,21,2002,3354,0,0,0,0,0,0,59.69
臺北縣,永和市,永元里,0,3,2226,19,2245,3801,0,0,0,0,0,0,59.06
臺北縣,永和市,民權里,0,3,2151,24,2175,3556,0,0,0,0,0,0,61.16
臺北縣,永和市,民族里,0,3,2177,15,2192,3491,0,0,0,0,0,0,62.79
臺北縣,永和市,秀朗里,0,3,1853,24,1877,3207,0,0,0,0,0,0,58.53
臺北縣,永和市,秀成里,0,3,1389,18,1407,2251,0,0,0,0,0,0,62.51
臺北縣,永和市,秀林里,0,3,1718,9,1727,2771,0,0,0,0,0,0,62.32
臺北縣,永和市,秀得里,0,3,1143,10,1153,1959,0,0,0,0,0,0,58.86
臺北縣,永和市,秀元里,0,3,1552,19,1571,2627,0,0,0,0,0,0,59.80
臺北縣,永和市,民生里,0,3,2006,24,2030,3402,0,0,0,0,0,0,59.67
臺北縣,永和市,民本里,0,3,1389,17,1406,2294,0,0,0,0,0,0,61.29
臺北縣,永和市,民富里,0,3,1349,18,1367,2284,0,0,0,0,0,0,59.85
臺北縣,永和市,民樂里,0,3,1904,28,1932,3202,0,0,0,0,0,0,60.34
臺北縣,永和市,民治里,0,3,1443,13,1456,2549,0,0,0,0,0,0,57.12
臺北縣,永和市,智光里,0,3,1848,19,1867,3060,0,0,0,0,0,0,61.01
臺北縣,永和市,潭安里,0,3,1953,22,1975,3464,0,0,0,0,0,0,57.02
臺北縣,永和市,潭墘里,0,3,1929,17,1946,3337,0,0,0,0,0,0,58.32
臺北縣,永和市,店街里,0,3,1703,21,1724,3056,0,0,0,0,0,0,56.41
臺北縣,永和市,大新里,0,3,1080,18,1098,1826,0,0,0,0,0,0,60.13
臺北縣,永和市,永安里,0,3,1771,19,1790,3074,0,0,0,0,0,0,58.23
臺北縣,永和市,永樂里,0,3,1098,7,1105,1934,0,0,0,0,0,0,57.14
臺北縣,永和市,水源里,0,3,1979,26,2005,3258,0,0,0,0,0,0,61.54
臺北縣,永和市,協和里,0,3,1535,17,1552,2613,0,0,0,0,0,0,59.40
臺北縣,永和市,雙和里,0,3,1775,23,1798,2956,0,0,0,0,0,0,60.83
臺北縣,永和市,安和里,0,3,1756,27,1783,2892,0,0,0,0,0,0,61.65
臺北縣,永和市,前溪里,0,3,983,12,995,1675,0,0,0,0,0,0,59.40
臺北縣,永和市,和平里,0,3,1872,24,1896,3260,0,0,0,0,0,0,58.16
臺北縣,永和市,保平里,0,3,2011,23,2034,3187,0,0,0,0,0,0,63.82
臺北縣,永和市,中溪里,0,3,2083,22,2105,3514,0,0,0,0,0,0,59.90
臺北縣,永和市,保安里,0,3,2209,26,2235,3856,0,0,0,0,0,0,57.96
臺北縣,永和市,保順里,0,3,1479,16,1495,2634,0,0,0,0,0,0,56.76
臺北縣,永和市,下溪里,0,3,1684,28,1712,2885,0,0,0,0,0,0,59.34
臺北縣,永和市,大同里,0,3,701,15,716,1000,0,0,0,0,0,0,71.60
臺北縣,永和市,新生里,0,3,520,19,539,825,0,0,0,0,0,0,65.33
臺北縣,永和市,永成里,0,3,612,15,627,1006,0,0,0,0,0,0,62.33
臺北縣,永和市,忠義里,0,3,472,13,485,732,0,0,0,0,0,0,66.26
臺北縣,永和市,文化里,0,3,1526,33,1559,2491,0,0,0,0,0,0,62.59
臺北縣,永和市,仁愛里,0,3,1154,16,1170,2060,0,0,0,0,0,0,56.80
臺北縣,永和市,信義里,0,3,1156,14,1170,1974,0,0,0,0,0,0,59.27
臺北縣,永和市,後溪里,0,3,896,13,909,1522,0,0,0,0,0,0,59.72
臺北縣,永和市,上溪里,0,3,1107,8,1115,1903,0,0,0,0,0,0,58.59
臺北縣,永和市,頂溪里,0,3,1198,19,1217,2025,0,0,0,0,0,0,60.10
臺北縣,永和市,河堤里,0,3,1102,10,1112,1845,0,0,0,0,0,0,60.27
臺北縣,永和市,新部里,0,3,1373,12,1385,2208,0,0,0,0,0,0,62.73
臺北縣,新店市,新店里,0,3,917,9,926,1440,0,0,0,0,0,0,64.31
臺北縣,新店市,張南里,0,3,697,13,710,1146,0,0,0,0,0,0,61.95
臺北縣,新店市,國校里,0,3,1150,12,1162,2012,0,0,0,0,0,0,57.75
臺北縣,新店市,文中里,0,3,763,16,779,1334,0,0,0,0,0,0,58.40
臺北縣,新店市,廣明里,0,3,510,6,516,792,0,0,0,0,0,0,65.15
臺北縣,新店市,文明里,0,3,1377,18,1395,2073,0,0,0,0,0,0,67.29
臺北縣,新店市,中興里,0,3,2131,22,2153,3714,0,0,0,0,0,0,57.97
臺北縣,新店市,新生里,0,3,2341,28,2369,3785,0,0,0,0,0,0,62.59
臺北縣,新店市,新德里,0,3,1444,19,1463,2391,0,0,0,0,0,0,61.19
臺北縣,新店市,張北里,0,3,3030,32,3062,5186,0,0,0,0,0,0,59.04
臺北縣,新店市,五峰里,0,3,3064,34,3098,5367,0,0,0,0,0,0,57.72
臺北縣,新店市,長春里,0,3,974,6,980,1619,0,0,0,0,0,0,60.53
臺北縣,新店市,新安里,0,3,1747,19,1766,3039,0,0,0,0,0,0,58.11
臺北縣,新店市,忠誠里,0,3,1296,23,1319,2182,0,0,0,0,0,0,60.45
臺北縣,新店市,中正里,0,3,3161,37,3198,5265,0,0,0,0,0,0,60.74
臺北縣,新店市,中華里,0,3,1997,19,2016,3390,0,0,0,0,0,0,59.47
臺北縣,新店市,仁愛里,0,3,1362,13,1375,2253,0,0,0,0,0,0,61.03
臺北縣,新店市,建國里,0,3,1586,12,1598,2697,0,0,0,0,0,0,59.25
臺北縣,新店市,百忍里,0,3,2137,26,2163,3575,0,0,0,0,0,0,60.50
臺北縣,新店市,百和里,0,3,1447,20,1467,2516,0,0,0,0,0,0,58.31
臺北縣,新店市,福德里,0,3,1988,24,2012,3296,0,0,0,0,0,0,61.04
臺北縣,新店市,百福里,0,3,1515,13,1528,2469,0,0,0,0,0,0,61.89
臺北縣,新店市,福民里,0,3,1784,19,1803,3006,0,0,0,0,0,0,59.98
臺北縣,新店市,中山里,0,3,693,13,706,1198,0,0,0,0,0,0,58.93
臺北縣,新店市,和平里,0,3,570,11,581,869,0,0,0,0,0,0,66.86
臺北縣,新店市,中央里,0,3,1430,10,1440,2418,0,0,0,0,0,0,59.55
臺北縣,新店市,國豐里,0,3,1853,25,1878,3100,0,0,0,0,0,0,60.58
臺北縣,新店市,明德里,0,3,1979,14,1993,3357,0,0,0,0,0,0,59.37
臺北縣,新店市,大豐里,0,3,1816,14,1830,2942,0,0,0,0,0,0,62.20
臺北縣,新店市,大同里,0,3,1904,15,1919,3077,0,0,0,0,0,0,62.37
臺北縣,新店市,江陵里,0,3,2023,24,2047,3482,0,0,0,0,0,0,58.79
臺北縣,新店市,復興里,0,3,1315,24,1339,2391,0,0,0,0,0,0,56.00
臺北縣,新店市,寶興里,0,3,2061,20,2081,3462,0,0,0,0,0,0,60.11
臺北縣,新店市,寶福里,0,3,2160,32,2192,3668,0,0,0,0,0,0,59.76
臺北縣,新店市,寶安里,0,3,2607,17,2624,4435,0,0,0,0,0,0,59.17
臺北縣,新店市,信義里,0,3,2448,25,2473,4242,0,0,0,0,0,0,58.30
臺北縣,新店市,忠孝里,0,3,1501,23,1524,2513,0,0,0,0,0,0,60.64
臺北縣,新店市,大鵬里,0,3,202,6,208,339,0,0,0,0,0,0,61.36
臺北縣,新店市,太平里,0,3,1364,22,1386,2134,0,0,0,0,0,0,64.95
臺北縣,新店市,美城里,0,3,1236,15,1251,2038,0,0,0,0,0,0,61.38
臺北縣,新店市,頂城里,0,3,822,13,835,1405,0,0,0,0,0,0,59.43
臺北縣,新店市,下城里,0,3,1025,13,1038,1697,0,0,0,0,0,0,61.17
臺北縣,新店市,柴埕里,0,3,2656,28,2684,4700,0,0,0,0,0,0,57.11
臺北縣,新店市,安和里,0,3,2169,32,2201,3729,0,0,0,0,0,0,59.02
臺北縣,新店市,永安里,0,3,2123,19,2142,3651,0,0,0,0,0,0,58.67
臺北縣,新店市,新和里,0,3,1678,13,1691,2963,0,0,0,0,0,0,57.07
臺北縣,新店市,永平里,0,3,1738,26,1764,3006,0,0,0,0,0,0,58.68
臺北縣,新店市,公崙里,0,3,3037,41,3078,5307,0,0,0,0,0,0,58.00
臺北縣,新店市,安昌里,0,3,1399,6,1405,2385,0,0,0,0,0,0,58.91
臺北縣,新店市,德安里,0,3,3070,38,3108,5144,0,0,0,0,0,0,60.42
臺北縣,新店市,明城里,0,3,1319,4,1323,2168,0,0,0,0,0,0,61.02
臺北縣,新店市,小城里,0,3,1642,19,1661,2692,0,0,0,0,0,0,61.70
臺北縣,新店市,雙城里,0,3,2696,18,2714,4521,0,0,0,0,0,0,60.03
臺北縣,新店市,香坡里,0,3,1654,17,1671,3267,0,0,0,0,0,0,51.15
臺北縣,新店市,日興里,0,3,2298,24,2322,4016,0,0,0,0,0,0,57.82
臺北縣,新店市,玫瑰里,0,3,2345,25,2370,3803,0,0,0,0,0,0,62.32
臺北縣,新店市,吉祥里,0,3,1791,15,1806,3167,0,0,0,0,0,0,57.03
臺北縣,新店市,塗潭里,0,3,733,5,738,1313,0,0,0,0,0,0,56.21
臺北縣,新店市,青潭里,0,3,1587,17,1604,2795,0,0,0,0,0,0,57.39
臺北縣,新店市,美潭里,0,3,2087,28,2115,3430,0,0,0,0,0,0,61.66
臺北縣,新店市,員潭里,0,3,1496,29,1525,2454,0,0,0,0,0,0,62.14
臺北縣,新店市,雙坑里,0,3,417,4,421,828,0,0,0,0,0,0,50.85
臺北縣,新店市,粗坑里,0,3,1135,14,1149,2090,0,0,0,0,0,0,54.98
臺北縣,新店市,屈尺里,0,3,1332,23,1355,2147,0,0,0,0,0,0,63.11
臺北縣,新店市,龜山里,0,3,807,13,820,1353,0,0,0,0,0,0,60.61
臺北縣,新店市,廣興里,0,3,624,12,636,1046,0,0,0,0,0,0,60.80
臺北縣,新店市,直潭里,0,3,427,2,429,697,0,0,0,0,0,0,61.55
臺北縣,深坑鄉,萬順村,0,3,866,14,880,1651,0,0,0,0,0,0,53.30
臺北縣,深坑鄉,萬福村,0,3,997,19,1016,1735,0,0,0,0,0,0,58.56
臺北縣,深坑鄉,土庫村,0,3,1027,15,1042,1693,0,0,0,0,0,0,61.55
臺北縣,深坑鄉,賴仲村,0,3,636,10,646,1180,0,0,0,0,0,0,54.75
臺北縣,深坑鄉,深坑村,0,3,1282,19,1301,2214,0,0,0,0,0,0,58.76
臺北縣,深坑鄉,埔新村,0,3,1819,18,1837,3254,0,0,0,0,0,0,56.45
臺北縣,深坑鄉,昇高村,0,3,803,15,818,1376,0,0,0,0,0,0,59.45
臺北縣,深坑鄉,阿柔村,0,3,304,4,308,446,0,0,0,0,0,0,69.06
臺北縣,石碇鄉,石碇村,0,3,293,1,294,389,0,0,0,0,0,0,75.58
臺北縣,石碇鄉,潭邊村,0,3,381,4,385,656,0,0,0,0,0,0,58.69
臺北縣,石碇鄉,烏塗村,0,3,371,10,381,614,0,0,0,0,0,0,62.05
臺北縣,石碇鄉,彭山村,0,3,173,2,175,259,0,0,0,0,0,0,67.57
臺北縣,石碇鄉,豐田村,0,3,267,1,268,432,0,0,0,0,0,0,62.04
臺北縣,石碇鄉,隆盛村,0,3,448,8,456,730,0,0,0,0,0,0,62.47
臺北縣,石碇鄉,豐林村,0,3,178,1,179,246,0,0,0,0,0,0,72.76
臺北縣,石碇鄉,中民村,0,3,569,8,577,776,0,0,0,0,0,0,74.36
臺北縣,石碇鄉,永定村,0,3,380,7,387,571,0,0,0,0,0,0,67.78
臺北縣,石碇鄉,光明村,0,3,144,2,146,225,0,0,0,0,0,0,64.89
臺北縣,石碇鄉,永安村,0,3,250,1,251,429,0,0,0,0,0,0,58.51
臺北縣,石碇鄉,格頭村,0,3,413,5,418,604,0,0,0,0,0,0,69.21
臺北縣,坪林鄉,坪林村,0,3,655,7,662,979,0,0,0,0,0,0,67.62
臺北縣,坪林鄉,水德村,0,3,331,5,336,534,0,0,0,0,0,0,62.92
臺北縣,坪林鄉,大林村,0,3,491,4,495,935,0,0,0,0,0,0,52.94
臺北縣,坪林鄉,石曹村,0,3,238,2,240,374,0,0,0,0,0,0,64.17
臺北縣,坪林鄉,上德村,0,3,428,7,435,693,0,0,0,0,0,0,62.77
臺北縣,坪林鄉,漁光村,0,3,347,7,354,674,0,0,0,0,0,0,52.52
臺北縣,坪林鄉,粗窟村,0,3,420,7,427,696,0,0,0,0,0,0,61.35
臺北縣,烏來鄉,忠治村,0,3,253,0,253,407,0,0,0,0,0,0,62.16
臺北縣,烏來鄉,烏來村,0,3,539,6,545,898,0,0,0,0,0,0,60.69
臺北縣,烏來鄉,孝義村,0,3,63,0,63,93,0,0,0,0,0,0,67.74
臺北縣,烏來鄉,信賢村,0,3,89,2,91,152,0,0,0,0,0,0,59.87
臺北縣,烏來鄉,福山村,0,3,27,0,27,60,0,0,0,0,0,0,45.00
臺北縣,汐止鎮,仁德里,0,3,912,7,919,1448,0,0,0,0,0,0,63.47
臺北縣,汐止鎮,義民里,0,3,708,7,715,1237,0,0,0,0,0,0,57.80
臺北縣,汐止鎮,禮門里,0,3,562,5,567,985,0,0,0,0,0,0,57.56
臺北縣,汐止鎮,智慧里,0,3,1392,10,1402,2676,0,0,0,0,0,0,52.39
臺北縣,汐止鎮,大同里,0,3,933,12,945,1649,0,0,0,0,0,0,57.31
臺北縣,汐止鎮,信望里,0,3,297,2,299,527,0,0,0,0,0,0,56.74
臺北縣,汐止鎮,新昌里,0,3,2272,32,2304,3946,0,0,0,0,0,0,58.39
臺北縣,汐止鎮,福安里,0,3,804,15,819,1396,0,0,0,0,0,0,58.67
臺北縣,汐止鎮,秀峰里,0,3,1633,21,1654,2783,0,0,0,0,0,0,59.43
臺北縣,汐止鎮,秀山里,0,3,1233,9,1242,2136,0,0,0,0,0,0,58.15
臺北縣,汐止鎮,復興里,0,3,1682,12,1694,3046,0,0,0,0,0,0,55.61
臺北縣,汐止鎮,自強里,0,3,1718,28,1746,2876,0,0,0,0,0,0,60.71
臺北縣,汐止鎮,文化里,0,3,1421,22,1443,2478,0,0,0,0,0,0,58.23
臺北縣,汐止鎮,白雲里,0,3,1196,13,1209,2033,0,0,0,0,0,0,59.47
臺北縣,汐止鎮,茄苳里,0,3,1502,23,1525,2675,0,0,0,0,0,0,57.01
臺北縣,汐止鎮,崇德里,0,3,1375,17,1392,2504,0,0,0,0,0,0,55.59
臺北縣,汐止鎮,橋東里,0,3,2411,26,2437,4540,0,0,0,0,0,0,53.68
臺北縣,汐止鎮,長安里,0,3,813,7,820,1447,0,0,0,0,0,0,56.67
臺北縣,汐止鎮,保安里,0,3,789,5,794,1250,0,0,0,0,0,0,63.52
臺北縣,汐止鎮,東山里,0,3,267,3,270,454,0,0,0,0,0,0,59.47
臺北縣,汐止鎮,保長里,0,3,1572,18,1590,2614,0,0,0,0,0,0,60.83
臺北縣,汐止鎮,鄉長里,0,3,1059,17,1076,1656,0,0,0,0,0,0,64.98
臺北縣,汐止鎮,江北里,0,3,2080,21,2101,3550,0,0,0,0,0,0,59.18
臺北縣,汐止鎮,拱北里,0,3,1808,20,1828,3652,0,0,0,0,0,0,50.05
臺北縣,汐止鎮,烘內里,0,3,639,6,645,1161,0,0,0,0,0,0,55.56
臺北縣,汐止鎮,八連里,0,3,499,7,506,808,0,0,0,0,0,0,62.62
臺北縣,汐止鎮,長青里,0,3,552,5,557,917,0,0,0,0,0,0,60.74
臺北縣,汐止鎮,北峰里,0,3,1599,11,1610,2832,0,0,0,0,0,0,56.85
臺北縣,汐止鎮,金龍里,0,3,1328,9,1337,2652,0,0,0,0,0,0,50.41
臺北縣,汐止鎮,樟樹里,0,3,892,8,900,1521,0,0,0,0,0,0,59.17
臺北縣,汐止鎮,忠孝里,0,3,1956,21,1977,3609,0,0,0,0,0,0,54.78
臺北縣,汐止鎮,厚德里,0,3,1255,17,1272,2334,0,0,0,0,0,0,54.50
臺北縣,汐止鎮,山光里,0,3,425,3,428,905,0,0,0,0,0,0,47.29
臺北縣,汐止鎮,中興里,0,3,2050,16,2066,4009,0,0,0,0,0,0,51.53
臺北縣,汐止鎮,福德里,0,3,941,10,951,1975,0,0,0,0,0,0,48.15
臺北縣,汐止鎮,興福里,0,3,884,5,889,1901,0,0,0,0,0,0,46.76
臺北縣,汐止鎮,康福里,0,3,549,9,558,1106,0,0,0,0,0,0,50.45
臺北縣,汐止鎮,湖光里,0,3,1026,9,1035,2108,0,0,0,0,0,0,49.10
臺北縣,汐止鎮,湖興里,0,3,1525,8,1533,2839,0,0,0,0,0,0,54.00
臺北縣,汐止鎮,北山里,0,3,1980,18,1998,3625,0,0,0,0,0,0,55.12
臺北縣,汐止鎮,忠山里,0,3,1267,10,1277,2259,0,0,0,0,0,0,56.53
臺北縣,汐止鎮,環河里,0,3,592,4,596,929,0,0,0,0,0,0,64.16
臺北縣,汐止鎮,橫科里,0,3,2372,31,2403,3948,0,0,0,0,0,0,60.87
臺北縣,汐止鎮,福山里,0,3,1386,10,1396,2367,0,0,0,0,0,0,58.98
臺北縣,汐止鎮,宜興里,0,3,1343,16,1359,2210,0,0,0,0,0,0,61.49
臺北縣,汐止鎮,東勢里,0,3,968,12,980,1760,0,0,0,0,0,0,55.68
臺北縣,瑞芳鎮,龍潭里,0,3,499,3,502,810,0,0,0,0,0,0,61.98
臺北縣,瑞芳鎮,龍興里,0,3,1001,5,1006,1619,0,0,0,0,0,0,62.14
臺北縣,瑞芳鎮,龍鎮里,0,3,842,17,859,1389,0,0,0,0,0,0,61.84
臺北縣,瑞芳鎮,龍安里,0,3,363,9,372,607,0,0,0,0,0,0,61.29
臺北縣,瑞芳鎮,龍川里,0,3,957,9,966,1584,0,0,0,0,0,0,60.98
臺北縣,瑞芳鎮,龍山里,0,3,756,21,777,1327,0,0,0,0,0,0,58.55
臺北縣,瑞芳鎮,爪峰里,0,3,2159,20,2179,3734,0,0,0,0,0,0,58.36
臺北縣,瑞芳鎮,新峰里,0,3,1236,16,1252,2012,0,0,0,0,0,0,62.23
臺北縣,瑞芳鎮,東和里,0,3,1205,22,1227,2023,0,0,0,0,0,0,60.65
臺北縣,瑞芳鎮,柑坪里,0,3,786,13,799,1207,0,0,0,0,0,0,66.20
臺北縣,瑞芳鎮,弓橋里,0,3,171,1,172,329,0,0,0,0,0,0,52.28
臺北縣,瑞芳鎮,侯硐里,0,3,375,5,380,555,0,0,0,0,0,0,68.47
臺北縣,瑞芳鎮,光復里,0,3,225,2,227,397,0,0,0,0,0,0,57.18
臺北縣,瑞芳鎮,碩仁里,0,3,123,0,123,181,0,0,0,0,0,0,67.96
臺北縣,瑞芳鎮,吉慶里,0,3,958,23,981,1709,0,0,0,0,0,0,57.40
臺北縣,瑞芳鎮,吉安里,0,3,1591,45,1636,2925,0,0,0,0,0,0,55.93
臺北縣,瑞芳鎮,上天里,0,3,749,13,762,1308,0,0,0,0,0,0,58.26
臺北縣,瑞芳鎮,傑魚里,0,3,1031,18,1049,1896,0,0,0,0,0,0,55.33
臺北縣,瑞芳鎮,基山里,0,3,379,4,383,611,0,0,0,0,0,0,62.68
臺北縣,瑞芳鎮,永慶里,0,3,364,3,367,638,0,0,0,0,0,0,57.52
臺北縣,瑞芳鎮,崇文里,0,3,252,6,258,488,0,0,0,0,0,0,52.87
臺北縣,瑞芳鎮,福住里,0,3,152,2,154,296,0,0,0,0,0,0,52.03
臺北縣,瑞芳鎮,頌德里,0,3,249,4,253,468,0,0,0,0,0,0,54.06
臺北縣,瑞芳鎮,瓜山里,0,3,213,1,214,316,0,0,0,0,0,0,67.72
臺北縣,瑞芳鎮,銅山里,0,3,195,2,197,311,0,0,0,0,0,0,63.34
臺北縣,瑞芳鎮,新山里,0,3,287,4,291,455,0,0,0,0,0,0,63.96
臺北縣,瑞芳鎮,石山里,0,3,262,4,266,474,0,0,0,0,0,0,56.12
臺北縣,瑞芳鎮,濂洞里,0,3,454,8,462,672,0,0,0,0,0,0,68.75
臺北縣,瑞芳鎮,濂新里,0,3,193,3,196,357,0,0,0,0,0,0,54.90
臺北縣,瑞芳鎮,南雅里,0,3,135,0,135,207,0,0,0,0,0,0,65.22
臺北縣,瑞芳鎮,鼻頭里,0,3,338,4,342,531,0,0,0,0,0,0,64.41
臺北縣,瑞芳鎮,海濱里,0,3,566,11,577,897,0,0,0,0,0,0,64.33
臺北縣,瑞芳鎮,瑞濱里,0,3,1015,18,1033,1611,0,0,0,0,0,0,64.12
臺北縣,瑞芳鎮,深澳里,0,3,563,9,572,998,0,0,0,0,0,0,57.31
臺北縣,平溪鄉,薯榔村,0,3,283,4,287,459,0,0,0,0,0,0,62.53
臺北縣,平溪鄉,菁桐村,0,3,238,3,241,321,0,0,0,0,0,0,75.08
臺北縣,平溪鄉,白石村,0,3,237,5,242,314,0,0,0,0,0,0,77.07
臺北縣,平溪鄉,石底村,0,3,342,4,346,541,0,0,0,0,0,0,63.96
臺北縣,平溪鄉,平溪村,0,3,189,2,191,286,0,0,0,0,0,0,66.78
臺北縣,平溪鄉,嶺腳村,0,3,457,3,460,697,0,0,0,0,0,0,66.00
臺北縣,平溪鄉,東勢村,0,3,231,0,231,378,0,0,0,0,0,0,61.11
臺北縣,平溪鄉,十分村,0,3,647,3,650,1102,0,0,0,0,0,0,58.98
臺北縣,平溪鄉,望古村,0,3,100,1,101,156,0,0,0,0,0,0,64.74
臺北縣,平溪鄉,南山村,0,3,276,3,279,527,0,0,0,0,0,0,52.94
臺北縣,平溪鄉,新寮村,0,3,108,5,113,164,0,0,0,0,0,0,68.90
臺北縣,平溪鄉,平湖村,0,3,129,1,130,178,0,0,0,0,0,0,73.03
臺北縣,雙溪鄉,雙溪村,0,3,396,2,398,600,0,0,0,0,0,0,66.33
臺北縣,雙溪鄉,新基村,0,3,681,5,686,964,0,0,0,0,0,0,71.16
臺北縣,雙溪鄉,三港村,0,3,273,1,274,451,0,0,0,0,0,0,60.75
臺北縣,雙溪鄉,牡丹村,0,3,1248,15,1263,1882,0,0,0,0,0,0,67.11
臺北縣,雙溪鄉,三貂村,0,3,207,0,207,312,0,0,0,0,0,0,66.35
臺北縣,雙溪鄉,平林村,0,3,606,9,615,974,0,0,0,0,0,0,63.14
臺北縣,雙溪鄉,上林村,0,3,468,6,474,712,0,0,0,0,0,0,66.57
臺北縣,雙溪鄉,外柑村,0,3,322,3,325,513,0,0,0,0,0,0,63.35
臺北縣,雙溪鄉,長源村,0,3,276,2,278,403,0,0,0,0,0,0,68.98
臺北縣,雙溪鄉,共和村,0,3,351,3,354,512,0,0,0,0,0,0,69.14
臺北縣,雙溪鄉,魚行村,0,3,465,3,468,651,0,0,0,0,0,0,71.89
臺北縣,雙溪鄉,泰平村,0,3,263,0,263,413,0,0,0,0,0,0,63.68
臺北縣,貢寮鄉,貢寮村,0,3,585,8,593,943,0,0,0,0,0,0,62.88
臺北縣,貢寮鄉,龍崗村,0,3,249,2,251,434,0,0,0,0,0,0,57.83
臺北縣,貢寮鄉,吉林村,0,3,266,7,273,422,0,0,0,0,0,0,64.69
臺北縣,貢寮鄉,雙玉村,0,3,487,8,495,799,0,0,0,0,0,0,61.95
臺北縣,貢寮鄉,福隆村,0,3,897,8,905,1514,0,0,0,0,0,0,59.78
臺北縣,貢寮鄉,福連村,0,3,454,1,455,766,0,0,0,0,0,0,59.40
臺北縣,貢寮鄉,龍門村,0,3,387,1,388,632,0,0,0,0,0,0,61.39
臺北縣,貢寮鄉,仁里村,0,3,932,19,951,1524,0,0,0,0,0,0,62.40
臺北縣,貢寮鄉,真理村,0,3,1025,8,1033,1838,0,0,0,0,0,0,56.20
臺北縣,貢寮鄉,美豐村,0,3,506,8,514,817,0,0,0,0,0,0,62.91
臺北縣,貢寮鄉,和美村,0,3,489,6,495,890,0,0,0,0,0,0,55.62
宜蘭縣,宜蘭市,南門里,0,1,437,4,441,726,0,0,0,0,0,0,60.74
宜蘭縣,宜蘭市,負郭里,0,1,1292,15,1307,2070,0,0,0,0,0,0,63.14
宜蘭縣,宜蘭市,民族里,0,1,1384,16,1400,2209,0,0,0,0,0,0,63.38
宜蘭縣,宜蘭市,建軍里,0,1,1336,21,1357,2291,0,0,0,0,0,0,59.23
宜蘭縣,宜蘭市,復興里,0,1,1703,19,1722,2721,0,0,0,0,0,0,63.29
宜蘭縣,宜蘭市,思源里,0,1,1923,19,1942,3393,0,0,0,0,0,0,57.24
宜蘭縣,宜蘭市,文化里,0,1,1464,13,1477,2398,0,0,0,0,0,0,61.59
宜蘭縣,宜蘭市,神農里,0,1,452,3,455,743,0,0,0,0,0,0,61.24
宜蘭縣,宜蘭市,民生里,0,1,314,7,321,472,0,0,0,0,0,0,68.01
宜蘭縣,宜蘭市,昇平里,0,1,491,5,496,729,0,0,0,0,0,0,68.04
宜蘭縣,宜蘭市,大東里,0,1,321,5,326,569,0,0,0,0,0,0,57.29
宜蘭縣,宜蘭市,新興里,0,1,362,5,367,613,0,0,0,0,0,0,59.87
宜蘭縣,宜蘭市,和睦里,0,1,1186,11,1197,2003,0,0,0,0,0,0,59.76
宜蘭縣,宜蘭市,民權里,0,1,843,10,853,1360,0,0,0,0,0,0,62.72
宜蘭縣,宜蘭市,進士里,0,1,2548,25,2573,4083,0,0,0,0,0,0,63.02
宜蘭縣,宜蘭市,南橋里,0,1,334,2,336,597,0,0,0,0,0,0,56.28
宜蘭縣,宜蘭市,建業里,0,1,715,4,719,1127,0,0,0,0,0,0,63.80
宜蘭縣,宜蘭市,南津里,0,1,444,5,449,757,0,0,0,0,0,0,59.31
宜蘭縣,宜蘭市,凱旋里,0,1,664,8,672,1140,0,0,0,0,0,0,58.95
宜蘭縣,宜蘭市,黎明里,0,1,677,5,682,1140,0,0,0,0,0,0,59.82
宜蘭縣,宜蘭市,東村里,0,1,1892,19,1911,3107,0,0,0,0,0,0,61.51
宜蘭縣,宜蘭市,延平里,0,1,1986,25,2011,3332,0,0,0,0,0,0,60.35
宜蘭縣,宜蘭市,七張里,0,1,686,6,692,1137,0,0,0,0,0,0,60.86
宜蘭縣,宜蘭市,慈安里,0,1,2132,18,2150,3868,0,0,0,0,0,0,55.58
宜蘭縣,宜蘭市,新民里,0,1,418,5,423,654,0,0,0,0,0,0,64.68
宜蘭縣,宜蘭市,東門里,0,1,361,3,364,582,0,0,0,0,0,0,62.54
宜蘭縣,宜蘭市,中正里,0,1,414,4,418,645,0,0,0,0,0,0,64.81
宜蘭縣,宜蘭市,小東里,0,1,768,8,776,1264,0,0,0,0,0,0,61.39
宜蘭縣,宜蘭市,菜園里,0,1,787,10,797,1336,0,0,0,0,0,0,59.66
宜蘭縣,宜蘭市,孝廉里,0,1,681,9,690,1070,0,0,0,0,0,0,64.49
宜蘭縣,宜蘭市,新生里,0,1,1276,9,1285,2071,0,0,0,0,0,0,62.05
宜蘭縣,宜蘭市,茭白里,0,1,927,6,933,1671,0,0,0,0,0,0,55.83
宜蘭縣,宜蘭市,北津里,0,1,825,10,835,1308,0,0,0,0,0,0,63.84
宜蘭縣,宜蘭市,梅洲里,0,1,1491,14,1505,2351,0,0,0,0,0,0,64.02
宜蘭縣,宜蘭市,北門里,0,1,573,6,579,896,0,0,0,0,0,0,64.62
宜蘭縣,宜蘭市,慶和里,0,1,513,5,518,816,0,0,0,0,0,0,63.48
宜蘭縣,宜蘭市,鄂王里,0,1,498,2,500,812,0,0,0,0,0,0,61.58
宜蘭縣,宜蘭市,西門里,0,1,817,6,823,1241,0,0,0,0,0,0,66.32
宜蘭縣,宜蘭市,中山里,0,1,540,8,548,848,0,0,0,0,0,0,64.62
宜蘭縣,宜蘭市,大道里,0,1,777,8,785,1283,0,0,0,0,0,0,61.18
宜蘭縣,羅東鎮,開羅里,0,1,304,2,306,493,0,0,0,0,0,0,62.07
宜蘭縣,羅東鎮,開元里,0,1,366,0,366,539,0,0,0,0,0,0,67.90
宜蘭縣,羅東鎮,東明里,0,1,302,1,303,530,0,0,0,0,0,0,57.17
宜蘭縣,羅東鎮,大新里,0,1,633,4,637,1171,0,0,0,0,0,0,54.40
宜蘭縣,羅東鎮,東安里,0,1,1037,15,1052,1858,0,0,0,0,0,0,56.62
宜蘭縣,羅東鎮,新群里,0,1,1124,10,1134,1880,0,0,0,0,0,0,60.32
宜蘭縣,羅東鎮,羅莊里,0,1,839,4,843,1605,0,0,0,0,0,0,52.52
宜蘭縣,羅東鎮,南昌里,0,1,1114,11,1125,2031,0,0,0,0,0,0,55.39
宜蘭縣,羅東鎮,南豪里,0,1,852,8,860,1355,0,0,0,0,0,0,63.47
宜蘭縣,羅東鎮,成功里,0,1,709,6,715,1202,0,0,0,0,0,0,59.48
宜蘭縣,羅東鎮,仁德里,0,1,520,1,521,838,0,0,0,0,0,0,62.17
宜蘭縣,羅東鎮,居仁里,0,1,405,5,410,685,0,0,0,0,0,0,59.85
宜蘭縣,羅東鎮,義和里,0,1,536,5,541,892,0,0,0,0,0,0,60.65
宜蘭縣,羅東鎮,羅東里,0,1,418,2,420,674,0,0,0,0,0,0,62.31
宜蘭縣,羅東鎮,浮崙里,0,1,445,3,448,741,0,0,0,0,0,0,60.46
宜蘭縣,羅東鎮,漢民里,0,1,1962,19,1981,3453,0,0,0,0,0,0,57.37
宜蘭縣,羅東鎮,西安里,0,1,2479,27,2506,4362,0,0,0,0,0,0,57.45
宜蘭縣,羅東鎮,北成里,0,1,2659,17,2676,4523,0,0,0,0,0,0,59.16
宜蘭縣,羅東鎮,賢文里,0,1,1844,15,1859,3269,0,0,0,0,0,0,56.87
宜蘭縣,羅東鎮,公正里,0,1,1000,8,1008,1725,0,0,0,0,0,0,58.43
宜蘭縣,羅東鎮,集祥里,0,1,557,4,561,972,0,0,0,0,0,0,57.72
宜蘭縣,羅東鎮,信義里,0,1,1526,17,1543,2688,0,0,0,0,0,0,57.40
宜蘭縣,羅東鎮,樹林里,0,1,1771,11,1782,3055,0,0,0,0,0,0,58.33
宜蘭縣,羅東鎮,竹林里,0,1,1464,15,1479,2490,0,0,0,0,0,0,59.40
宜蘭縣,羅東鎮,仁愛里,0,1,1303,13,1316,2183,0,0,0,0,0,0,60.28
宜蘭縣,蘇澳鎮,龍德里,0,1,1594,11,1605,2894,0,0,0,0,0,0,55.46
宜蘭縣,蘇澳鎮,頂寮里,0,1,448,3,451,718,0,0,0,0,0,0,62.81
宜蘭縣,蘇澳鎮,永榮里,0,1,1632,11,1643,2778,0,0,0,0,0,0,59.14
宜蘭縣,蘇澳鎮,存仁里,0,1,701,4,705,1068,0,0,0,0,0,0,66.01
宜蘭縣,蘇澳鎮,港邊里,0,1,730,8,738,1278,0,0,0,0,0,0,57.75
宜蘭縣,蘇澳鎮,岳明里,0,1,135,5,140,342,0,0,0,0,0,0,40.94
宜蘭縣,蘇澳鎮,隘丁里,0,1,1128,15,1143,1995,0,0,0,0,0,0,57.29
宜蘭縣,蘇澳鎮,新城里,0,1,631,6,637,1070,0,0,0,0,0,0,59.53
宜蘭縣,蘇澳鎮,聖湖里,0,1,2517,17,2534,4620,0,0,0,0,0,0,54.85
宜蘭縣,蘇澳鎮,蘇西里,0,1,1249,8,1257,2225,0,0,0,0,0,0,56.49
宜蘭縣,蘇澳鎮,蘇北里,0,1,713,9,722,1237,0,0,0,0,0,0,58.37
宜蘭縣,蘇澳鎮,蘇南里,0,1,347,4,351,601,0,0,0,0,0,0,58.40
宜蘭縣,蘇澳鎮,蘇東里,0,1,311,4,315,576,0,0,0,0,0,0,54.69
宜蘭縣,蘇澳鎮,長安里,0,1,347,3,350,621,0,0,0,0,0,0,56.36
宜蘭縣,蘇澳鎮,永光里,0,1,376,5,381,584,0,0,0,0,0,0,65.24
宜蘭縣,蘇澳鎮,永春里,0,1,360,5,365,668,0,0,0,0,0,0,54.64
宜蘭縣,蘇澳鎮,永樂里,0,1,342,2,344,545,0,0,0,0,0,0,63.12
宜蘭縣,蘇澳鎮,南安里,0,1,651,8,659,1141,0,0,0,0,0,0,57.76
宜蘭縣,蘇澳鎮,南正里,0,1,629,4,633,1115,0,0,0,0,0,0,56.77
宜蘭縣,蘇澳鎮,南成里,0,1,701,6,707,1260,0,0,0,0,0,0,56.11
宜蘭縣,蘇澳鎮,南興里,0,1,867,7,874,1707,0,0,0,0,0,0,51.20
宜蘭縣,蘇澳鎮,南寧里,0,1,650,7,657,1176,0,0,0,0,0,0,55.87
宜蘭縣,蘇澳鎮,南建里,0,1,674,8,682,1324,0,0,0,0,0,0,51.51
宜蘭縣,蘇澳鎮,東澳里,0,1,192,3,195,350,0,0,0,0,0,0,55.71
宜蘭縣,蘇澳鎮,南強里,0,1,435,13,448,836,0,0,0,0,0,0,53.59
宜蘭縣,蘇澳鎮,朝陽里,0,1,432,14,446,785,0,0,0,0,0,0,56.82
宜蘭縣,頭城鎮,石城里,0,1,208,2,210,393,0,0,0,0,0,0,53.44
宜蘭縣,頭城鎮,大里里,0,1,294,1,295,694,0,0,0,0,0,0,42.51
宜蘭縣,頭城鎮,大溪里,0,1,658,9,667,1495,0,0,0,0,0,0,44.62
宜蘭縣,頭城鎮,合興里,0,1,207,6,213,392,0,0,0,0,0,0,54.34
宜蘭縣,頭城鎮,更新里,0,1,740,12,752,1350,0,0,0,0,0,0,55.70
宜蘭縣,頭城鎮,外澳里,0,1,476,3,479,829,0,0,0,0,0,0,57.78
宜蘭縣,頭城鎮,港口里,0,1,378,11,389,628,0,0,0,0,0,0,61.94
宜蘭縣,頭城鎮,武營里,0,1,863,12,875,1345,0,0,0,0,0,0,65.06
宜蘭縣,頭城鎮,大坑里,0,1,699,7,706,1091,0,0,0,0,0,0,64.71
宜蘭縣,頭城鎮,城東里,0,1,518,2,520,741,0,0,0,0,0,0,70.18
宜蘭縣,頭城鎮,城北里,0,1,358,4,362,590,0,0,0,0,0,0,61.36
宜蘭縣,頭城鎮,城西里,0,1,460,3,463,664,0,0,0,0,0,0,69.73
宜蘭縣,頭城鎮,城南里,0,1,408,2,410,596,0,0,0,0,0,0,68.79
宜蘭縣,頭城鎮,竹安里,0,1,1104,9,1113,1905,0,0,0,0,0,0,58.43
宜蘭縣,頭城鎮,新建里,0,1,1086,8,1094,1754,0,0,0,0,0,0,62.37
宜蘭縣,頭城鎮,拔雅里,0,1,788,5,793,1291,0,0,0,0,0,0,61.43
宜蘭縣,頭城鎮,福成里,0,1,591,6,597,974,0,0,0,0,0,0,61.29
宜蘭縣,頭城鎮,金面里,0,1,977,6,983,1569,0,0,0,0,0,0,62.65
宜蘭縣,頭城鎮,金盈里,0,1,390,3,393,694,0,0,0,0,0,0,56.63
宜蘭縣,頭城鎮,頂埔里,0,1,863,10,873,1303,0,0,0,0,0,0,67.00
宜蘭縣,頭城鎮,下埔里,0,1,585,2,587,915,0,0,0,0,0,0,64.15
宜蘭縣,頭城鎮,中崙里,0,1,615,12,627,949,0,0,0,0,0,0,66.07
宜蘭縣,頭城鎮,二城里,0,1,648,10,658,1053,0,0,0,0,0,0,62.49
宜蘭縣,礁溪鄉,白雲村,0,1,815,6,821,1412,0,0,0,0,0,0,58.14
宜蘭縣,礁溪鄉,玉石村,0,1,1017,15,1032,1607,0,0,0,0,0,0,64.22
宜蘭縣,礁溪鄉,德陽村,0,1,2007,23,2030,3369,0,0,0,0,0,0,60.26
宜蘭縣,礁溪鄉,大忠村,0,1,1258,12,1270,1951,0,0,0,0,0,0,65.09
宜蘭縣,礁溪鄉,大義村,0,1,444,3,447,664,0,0,0,0,0,0,67.32
宜蘭縣,礁溪鄉,六結村,0,1,869,9,878,1341,0,0,0,0,0,0,65.47
宜蘭縣,礁溪鄉,二龍村,0,1,705,5,710,1114,0,0,0,0,0,0,63.73
宜蘭縣,礁溪鄉,時潮村,0,1,826,8,834,1331,0,0,0,0,0,0,62.66
宜蘭縣,礁溪鄉,玉田村,0,1,1091,12,1103,1792,0,0,0,0,0,0,61.55
宜蘭縣,礁溪鄉,三民村,0,1,1379,12,1391,2237,0,0,0,0,0,0,62.18
宜蘭縣,礁溪鄉,林美村,0,1,632,11,643,1048,0,0,0,0,0,0,61.35
宜蘭縣,礁溪鄉,白鵝村,0,1,409,5,414,655,0,0,0,0,0,0,63.21
宜蘭縣,礁溪鄉,玉光村,0,1,532,9,541,893,0,0,0,0,0,0,60.58
宜蘭縣,礁溪鄉,光武村,0,1,640,7,647,1068,0,0,0,0,0,0,60.58
宜蘭縣,礁溪鄉,吳沙村,0,1,1398,9,1407,2133,0,0,0,0,0,0,65.96
宜蘭縣,礁溪鄉,龍潭村,0,1,1549,18,1567,2630,0,0,0,0,0,0,59.58
宜蘭縣,礁溪鄉,匏崙村,0,1,545,7,552,889,0,0,0,0,0,0,62.09
宜蘭縣,礁溪鄉,二結村,0,1,231,4,235,406,0,0,0,0,0,0,57.88
宜蘭縣,壯圍鄉,吉祥村,0,1,1543,13,1556,2585,0,0,0,0,0,0,60.19
宜蘭縣,壯圍鄉,美福村,0,1,942,10,952,1573,0,0,0,0,0,0,60.52
宜蘭縣,壯圍鄉,新南村,0,1,560,4,564,852,0,0,0,0,0,0,66.20
宜蘭縣,壯圍鄉,東港村,0,1,527,3,530,948,0,0,0,0,0,0,55.91
宜蘭縣,壯圍鄉,復興村,0,1,889,9,898,1535,0,0,0,0,0,0,58.50
宜蘭縣,壯圍鄉,過嶺村,0,1,891,9,900,1481,0,0,0,0,0,0,60.77
宜蘭縣,壯圍鄉,永鎮村,0,1,472,5,477,811,0,0,0,0,0,0,58.82
宜蘭縣,壯圍鄉,忠孝村,0,1,1194,9,1203,1895,0,0,0,0,0,0,63.48
宜蘭縣,壯圍鄉,古亭村,0,1,754,6,760,1211,0,0,0,0,0,0,62.76
宜蘭縣,壯圍鄉,功勞村,0,1,605,4,609,986,0,0,0,0,0,0,61.76
宜蘭縣,壯圍鄉,美城村,0,1,1202,11,1213,1872,0,0,0,0,0,0,64.80
宜蘭縣,壯圍鄉,新社村,0,1,620,2,622,1045,0,0,0,0,0,0,59.52
宜蘭縣,壯圍鄉,大福村,0,1,939,7,946,1532,0,0,0,0,0,0,61.75
宜蘭縣,員山鄉,員山村,0,1,2267,19,2286,4030,0,0,0,0,0,0,56.72
宜蘭縣,員山鄉,尚德村,0,1,1003,10,1013,1832,0,0,0,0,0,0,55.29
宜蘭縣,員山鄉,惠好村,0,1,712,15,727,1157,0,0,0,0,0,0,62.83
宜蘭縣,員山鄉,七賢村,0,1,530,5,535,914,0,0,0,0,0,0,58.53
宜蘭縣,員山鄉,深溝村,0,1,743,12,755,1357,0,0,0,0,0,0,55.64
宜蘭縣,員山鄉,蓁巷村,0,1,527,11,538,1084,0,0,0,0,0,0,49.63
宜蘭縣,員山鄉,內城村,0,1,874,15,889,1496,0,0,0,0,0,0,59.43
宜蘭縣,員山鄉,中華村,0,1,369,7,376,760,0,0,0,0,0,0,49.47
宜蘭縣,員山鄉,永和村,0,1,854,10,864,1560,0,0,0,0,0,0,55.38
宜蘭縣,員山鄉,頭分村,0,1,604,12,616,1046,0,0,0,0,0,0,58.89
宜蘭縣,員山鄉,枕山村,0,1,1243,14,1257,2066,0,0,0,0,0,0,60.84
宜蘭縣,員山鄉,同樂村,0,1,1349,23,1372,2296,0,0,0,0,0,0,59.76
宜蘭縣,員山鄉,湖東村,0,1,446,7,453,878,0,0,0,0,0,0,51.59
宜蘭縣,員山鄉,逸仙村,0,1,463,6,469,837,0,0,0,0,0,0,56.03
宜蘭縣,員山鄉,湖北村,0,1,554,7,561,954,0,0,0,0,0,0,58.81
宜蘭縣,員山鄉,湖西村,0,1,836,6,842,1525,0,0,0,0,0,0,55.21
宜蘭縣,冬山鄉,武淵村,0,1,670,2,672,1088,0,0,0,0,0,0,61.76
宜蘭縣,冬山鄉,珍珠村,0,1,693,8,701,1165,0,0,0,0,0,0,60.17
宜蘭縣,冬山鄉,補城村,0,1,544,5,549,946,0,0,0,0,0,0,58.03
宜蘭縣,冬山鄉,三奇村,0,1,465,6,471,804,0,0,0,0,0,0,58.58
宜蘭縣,冬山鄉,大興村,0,1,614,4,618,924,0,0,0,0,0,0,66.88
宜蘭縣,冬山鄉,東城村,0,1,678,3,681,1162,0,0,0,0,0,0,58.61
宜蘭縣,冬山鄉,香和村,0,1,1106,6,1112,1830,0,0,0,0,0,0,60.77
宜蘭縣,冬山鄉,南興村,0,1,1046,10,1056,1730,0,0,0,0,0,0,61.04
宜蘭縣,冬山鄉,冬山村,0,1,541,2,543,843,0,0,0,0,0,0,64.41
宜蘭縣,冬山鄉,安平村,0,1,423,4,427,712,0,0,0,0,0,0,59.97
宜蘭縣,冬山鄉,太和村,0,1,802,2,804,1290,0,0,0,0,0,0,62.33
宜蘭縣,冬山鄉,八寶村,0,1,497,1,498,813,0,0,0,0,0,0,61.25
宜蘭縣,冬山鄉,丸山村,0,1,758,6,764,1242,0,0,0,0,0,0,61.51
宜蘭縣,冬山鄉,中山村,0,1,250,1,251,424,0,0,0,0,0,0,59.20
宜蘭縣,冬山鄉,順安村,0,1,2134,15,2149,4072,0,0,0,0,0,0,52.78
宜蘭縣,冬山鄉,永美村,0,1,1059,7,1066,1913,0,0,0,0,0,0,55.72
宜蘭縣,冬山鄉,群英村,0,1,2541,27,2568,4408,0,0,0,0,0,0,58.26
宜蘭縣,冬山鄉,清溝村,0,1,1475,17,1492,2536,0,0,0,0,0,0,58.83
宜蘭縣,冬山鄉,鹿埔村,0,1,1178,17,1195,2130,0,0,0,0,0,0,56.10
宜蘭縣,冬山鄉,得安村,0,1,541,12,553,1033,0,0,0,0,0,0,53.53
宜蘭縣,冬山鄉,廣興村,0,1,1199,8,1207,2163,0,0,0,0,0,0,55.80
宜蘭縣,冬山鄉,廣安村,0,1,670,8,678,1169,0,0,0,0,0,0,58.00
宜蘭縣,冬山鄉,柯林村,0,1,541,4,545,936,0,0,0,0,0,0,58.23
宜蘭縣,冬山鄉,大進村,0,1,443,3,446,795,0,0,0,0,0,0,56.10
宜蘭縣,五結鄉,三興村,0,1,982,7,989,1573,0,0,0,0,0,0,62.87
宜蘭縣,五結鄉,二結村,0,1,859,8,867,1380,0,0,0,0,0,0,62.83
宜蘭縣,五結鄉,鎮安村,0,1,1172,13,1185,1914,0,0,0,0,0,0,61.91
宜蘭縣,五結鄉,上四村,0,1,859,10,869,1425,0,0,0,0,0,0,60.98
宜蘭縣,五結鄉,中興村,0,1,602,5,607,973,0,0,0,0,0,0,62.38
宜蘭縣,五結鄉,四結村,0,1,1232,8,1240,2071,0,0,0,0,0,0,59.87
宜蘭縣,五結鄉,福興村,0,1,926,5,931,1472,0,0,0,0,0,0,63.25
宜蘭縣,五結鄉,五結村,0,1,1482,5,1487,2461,0,0,0,0,0,0,60.42
宜蘭縣,五結鄉,大吉村,0,1,1646,10,1656,2655,0,0,0,0,0,0,62.37
宜蘭縣,五結鄉,協和村,0,1,1276,14,1290,2133,0,0,0,0,0,0,60.48
宜蘭縣,五結鄉,孝威村,0,1,792,7,799,1267,0,0,0,0,0,0,63.06
宜蘭縣,五結鄉,錦眾村,0,1,881,10,891,1452,0,0,0,0,0,0,61.36
宜蘭縣,五結鄉,利澤村,0,1,1182,6,1188,1995,0,0,0,0,0,0,59.55
宜蘭縣,五結鄉,成興村,0,1,1243,15,1258,2305,0,0,0,0,0,0,54.58
宜蘭縣,五結鄉,季新村,0,1,1199,10,1209,2074,0,0,0,0,0,0,58.29
宜蘭縣,三星鄉,員山村,0,1,126,1,127,230,0,0,0,0,0,0,55.22
宜蘭縣,三星鄉,天山村,0,1,363,2,365,645,0,0,0,0,0,0,56.59
宜蘭縣,三星鄉,天福村,0,1,411,9,420,821,0,0,0,0,0,0,51.16
宜蘭縣,三星鄉,雙賢村,0,1,371,4,375,663,0,0,0,0,0,0,56.56
宜蘭縣,三星鄉,人和村,0,1,248,6,254,467,0,0,0,0,0,0,54.39
宜蘭縣,三星鄉,義德村,0,1,670,3,673,1108,0,0,0,0,0,0,60.74
宜蘭縣,三星鄉,集慶村,0,1,647,10,657,1109,0,0,0,0,0,0,59.24
宜蘭縣,三星鄉,月眉村,0,1,497,7,504,840,0,0,0,0,0,0,60.00
宜蘭縣,三星鄉,拱照村,0,1,549,6,555,1060,0,0,0,0,0,0,52.36
宜蘭縣,三星鄉,大隱村,0,1,1660,23,1683,2902,0,0,0,0,0,0,57.99
宜蘭縣,三星鄉,行健村,0,1,369,4,373,657,0,0,0,0,0,0,56.77
宜蘭縣,三星鄉,萬德村,0,1,284,8,292,535,0,0,0,0,0,0,54.58
宜蘭縣,三星鄉,貴林村,0,1,247,4,251,488,0,0,0,0,0,0,51.43
宜蘭縣,三星鄉,萬富村,0,1,378,2,380,647,0,0,0,0,0,0,58.73
宜蘭縣,三星鄉,大義村,0,1,663,5,668,1048,0,0,0,0,0,0,63.74
宜蘭縣,三星鄉,尚武村,0,1,477,2,479,794,0,0,0,0,0,0,60.33
宜蘭縣,三星鄉,大洲村,0,1,857,7,864,1247,0,0,0,0,0,0,69.29
宜蘭縣,三星鄉,尾塹村,0,1,682,5,687,1124,0,0,0,0,0,0,61.12
宜蘭縣,大同鄉,寒溪村,0,1,40,0,40,113,0,0,0,0,0,0,35.40
宜蘭縣,大同鄉,崙埤村,0,1,47,0,47,101,0,0,0,0,0,0,46.53
宜蘭縣,大同鄉,松羅村,0,1,122,0,122,241,0,0,0,0,0,0,50.62
宜蘭縣,大同鄉,復興村,0,1,128,1,129,238,0,0,0,0,0,0,54.20
宜蘭縣,大同鄉,英士村,0,1,38,0,38,84,0,0,0,0,0,0,45.24
宜蘭縣,大同鄉,樂水村,0,1,21,0,21,61,0,0,0,0,0,0,34.43
宜蘭縣,大同鄉,太平村,0,1,31,1,32,54,0,0,0,0,0,0,59.26
宜蘭縣,大同鄉,茂安村,0,1,10,0,10,16,0,0,0,0,0,0,62.50
宜蘭縣,大同鄉,四季村,0,1,11,0,11,54,0,0,0,0,0,0,20.37
宜蘭縣,大同鄉,南山村,0,1,42,0,42,76,0,0,0,0,0,0,55.26
宜蘭縣,南澳鄉,東岳村,0,1,41,0,41,83,0,0,0,0,0,0,49.40
宜蘭縣,南澳鄉,南澳村,0,1,137,1,138,251,0,0,0,0,0,0,54.98
宜蘭縣,南澳鄉,碧候村,0,1,40,0,40,92,0,0,0,0,0,0,43.48
宜蘭縣,南澳鄉,金岳村,0,1,27,0,27,66,0,0,0,0,0,0,40.91
宜蘭縣,南澳鄉,武塔村,0,1,52,0,52,128,0,0,0,0,0,0,40.63
宜蘭縣,南澳鄉,金洋村,0,1,11,2,13,31,0,0,0,0,0,0,41.94
宜蘭縣,南澳鄉,澳花村,0,1,56,1,57,162,0,0,0,0,0,0,35.19
桃園縣,桃園市,大林里,0,1,2721,30,2751,4435,0,0,0,0,0,0,62.03
桃園縣,桃園市,雲林里,0,1,1866,27,1893,3136,0,0,0,0,0,0,60.36
桃園縣,桃園市,大豐里,0,1,2150,29,2179,3570,0,0,0,0,0,0,61.04
桃園縣,桃園市,福林里,0,1,2683,34,2717,4144,0,0,0,0,0,0,65.56
桃園縣,桃園市,福安里,0,1,1891,26,1917,3013,0,0,0,0,0,0,63.62
桃園縣,桃園市,豐林里,0,1,2905,39,2944,4657,0,0,0,0,0,0,63.22
桃園縣,桃園市,建國里,0,1,2345,36,2381,3924,0,0,0,0,0,0,60.68
桃園縣,桃園市,東門里,0,1,1378,18,1396,2269,0,0,0,0,0,0,61.52
桃園縣,桃園市,東山里,0,1,1140,7,1147,1847,0,0,0,0,0,0,62.10
桃園縣,桃園市,萬壽里,0,1,594,8,602,917,0,0,0,0,0,0,65.65
桃園縣,桃園市,武陵里,0,1,841,9,850,1472,0,0,0,0,0,0,57.74
桃園縣,桃園市,民生里,0,1,899,9,908,1369,0,0,0,0,0,0,66.33
桃園縣,桃園市,文化里,0,1,495,1,496,843,0,0,0,0,0,0,58.84
桃園縣,桃園市,文明里,0,1,913,5,918,1470,0,0,0,0,0,0,62.45
桃園縣,桃園市,文昌里,0,1,668,15,683,1022,0,0,0,0,0,0,66.83
桃園縣,桃園市,南門里,0,1,2652,33,2685,4390,0,0,0,0,0,0,61.16
桃園縣,桃園市,南華里,0,1,944,7,951,1400,0,0,0,0,0,0,67.93
桃園縣,桃園市,西門里,0,1,892,19,911,1426,0,0,0,0,0,0,63.88
桃園縣,桃園市,西湖里,0,1,731,10,741,1182,0,0,0,0,0,0,62.69
桃園縣,桃園市,長美里,0,1,634,7,641,947,0,0,0,0,0,0,67.69
桃園縣,桃園市,永興里,0,1,1198,10,1208,1810,0,0,0,0,0,0,66.74
桃園縣,桃園市,中興里,0,1,2744,24,2768,4306,0,0,0,0,0,0,64.28
桃園縣,桃園市,光興里,0,1,2640,25,2665,4170,0,0,0,0,0,0,63.91
桃園縣,桃園市,中路里,0,1,1552,20,1572,2665,0,0,0,0,0,0,58.99
桃園縣,桃園市,中信里,0,1,1851,20,1871,3179,0,0,0,0,0,0,58.85
桃園縣,桃園市,中山里,0,1,1955,30,1985,3432,0,0,0,0,0,0,57.84
桃園縣,桃園市,中平里,0,1,1660,16,1676,2941,0,0,0,0,0,0,56.99
桃園縣,桃園市,中原里,0,1,869,6,875,1431,0,0,0,0,0,0,61.15
桃園縣,桃園市,中泰里,0,1,1542,23,1565,2787,0,0,0,0,0,0,56.15
桃園縣,桃園市,中德里,0,1,2409,39,2448,3773,0,0,0,0,0,0,64.88
桃園縣,桃園市,中正里,0,1,2241,33,2274,3679,0,0,0,0,0,0,61.81
桃園縣,桃園市,文中里,0,1,1554,26,1580,2524,0,0,0,0,0,0,62.60
桃園縣,桃園市,中成里,0,1,1684,21,1705,2638,0,0,0,0,0,0,64.63
桃園縣,桃園市,玉山里,0,1,2407,44,2451,4036,0,0,0,0,0,0,60.73
桃園縣,桃園市,泰山里,0,1,1780,33,1813,2797,0,0,0,0,0,0,64.82
桃園縣,桃園市,龍岡里,0,1,1830,26,1856,2830,0,0,0,0,0,0,65.58
桃園縣,桃園市,龍安里,0,1,907,6,913,1521,0,0,0,0,0,0,60.03
桃園縣,桃園市,龍鳳里,0,1,1392,9,1401,2359,0,0,0,0,0,0,59.39
桃園縣,桃園市,龍祥里,0,1,2163,30,2193,3603,0,0,0,0,0,0,60.87
桃園縣,桃園市,龍山里,0,1,2079,26,2105,3232,0,0,0,0,0,0,65.13
桃園縣,桃園市,東埔里,0,1,2247,37,2284,3779,0,0,0,0,0,0,60.44
桃園縣,桃園市,信光里,0,1,2056,34,2090,3606,0,0,0,0,0,0,57.96
桃園縣,桃園市,永安里,0,1,2389,21,2410,3724,0,0,0,0,0,0,64.72
桃園縣,桃園市,中寧里,0,1,2335,24,2359,4244,0,0,0,0,0,0,55.58
桃園縣,桃園市,中埔里,0,1,1261,20,1281,1820,0,0,0,0,0,0,70.38
桃園縣,桃園市,南埔里,0,1,1384,13,1397,2370,0,0,0,0,0,0,58.95
桃園縣,桃園市,寶慶里,0,1,1630,14,1644,3172,0,0,0,0,0,0,51.83
桃園縣,桃園市,北埔里,0,1,1730,23,1753,3524,0,0,0,0,0,0,49.74
桃園縣,桃園市,西埔里,0,1,1398,27,1425,1984,0,0,0,0,0,0,71.82
桃園縣,桃園市,慈文里,0,1,2257,38,2295,3850,0,0,0,0,0,0,59.61
桃園縣,桃園市,新埔里,0,1,2230,32,2262,3624,0,0,0,0,0,0,62.42
桃園縣,桃園市,同安里,0,1,1712,18,1730,3012,0,0,0,0,0,0,57.44
桃園縣,桃園市,莊敬里,0,1,1380,8,1388,2793,0,0,0,0,0,0,49.70
桃園縣,桃園市,自強里,0,1,1770,16,1786,3178,0,0,0,0,0,0,56.20
桃園縣,桃園市,長安里,0,1,1474,18,1492,2460,0,0,0,0,0,0,60.65
桃園縣,桃園市,長德里,0,1,1714,26,1740,2884,0,0,0,0,0,0,60.33
桃園縣,桃園市,中和里,0,1,949,6,955,1452,0,0,0,0,0,0,65.77
桃園縣,桃園市,北門里,0,1,1053,18,1071,1632,0,0,0,0,0,0,65.63
桃園縣,桃園市,朝陽里,0,1,950,12,962,1593,0,0,0,0,0,0,60.39
桃園縣,桃園市,青溪里,0,1,2482,29,2511,4214,0,0,0,0,0,0,59.59
桃園縣,桃園市,成功里,0,1,1831,19,1850,3093,0,0,0,0,0,0,59.81
桃園縣,桃園市,三民里,0,1,1905,18,1923,3214,0,0,0,0,0,0,59.83
桃園縣,桃園市,忠義里,0,1,2571,57,2628,4533,0,0,0,0,0,0,57.97
桃園縣,桃園市,大興里,0,1,2283,35,2318,4054,0,0,0,0,0,0,57.18
桃園縣,桃園市,會稽里,0,1,1623,30,1653,3248,0,0,0,0,0,0,50.89
桃園縣,桃園市,大有里,0,1,713,11,724,1614,0,0,0,0,0,0,44.86
桃園縣,桃園市,寶山里,0,1,1345,19,1364,2385,0,0,0,0,0,0,57.19
桃園縣,桃園市,春日里,0,1,1609,34,1643,2965,0,0,0,0,0,0,55.41
桃園縣,桃園市,汴洲里,0,1,1901,28,1929,2937,0,0,0,0,0,0,65.68
桃園縣,龜山鄉,龜山村,0,1,2606,54,2660,4366,0,0,0,0,0,0,60.93
桃園縣,龜山鄉,新路村,0,1,3064,46,3110,4903,0,0,0,0,0,0,63.43
桃園縣,龜山鄉,大同村,0,1,2242,38,2280,3794,0,0,0,0,0,0,60.09
桃園縣,龜山鄉,中興村,0,1,2590,46,2636,4523,0,0,0,0,0,0,58.28
桃園縣,龜山鄉,陸光村,0,1,1546,24,1570,2212,0,0,0,0,0,0,70.98
桃園縣,龜山鄉,精忠村,0,1,1310,11,1321,1909,0,0,0,0,0,0,69.20
桃園縣,龜山鄉,福源村,0,1,904,23,927,1600,0,0,0,0,0,0,57.94
桃園縣,龜山鄉,兔坑村,0,1,866,15,881,1722,0,0,0,0,0,0,51.16
桃園縣,龜山鄉,迴龍村,0,1,1676,30,1706,3437,0,0,0,0,0,0,49.64
桃園縣,龜山鄉,龍華村,0,1,1158,20,1178,1985,0,0,0,0,0,0,59.35
桃園縣,龜山鄉,龍壽村,0,1,854,19,873,1486,0,0,0,0,0,0,58.75
桃園縣,龜山鄉,嶺頂村,0,1,1307,27,1334,2770,0,0,0,0,0,0,48.16
桃園縣,龜山鄉,新嶺村,0,1,1297,21,1318,2535,0,0,0,0,0,0,51.99
桃園縣,龜山鄉,舊路村,0,1,1143,30,1173,1786,0,0,0,0,0,0,65.68
桃園縣,龜山鄉,山德村,0,1,2696,41,2737,4590,0,0,0,0,0,0,59.63
桃園縣,龜山鄉,山頂村,0,1,1911,25,1936,4102,0,0,0,0,0,0,47.20
桃園縣,龜山鄉,山福村,0,1,1520,17,1537,2640,0,0,0,0,0,0,58.22
桃園縣,龜山鄉,幸福村,0,1,1977,28,2005,3781,0,0,0,0,0,0,53.03
桃園縣,龜山鄉,大崗村,0,1,2653,37,2690,5218,0,0,0,0,0,0,51.55
桃園縣,龜山鄉,公西村,0,1,897,19,916,1538,0,0,0,0,0,0,59.56
桃園縣,龜山鄉,文化村,0,1,881,11,892,1735,0,0,0,0,0,0,51.41
桃園縣,龜山鄉,樂善村,0,1,1647,13,1660,3692,0,0,0,0,0,0,44.96
桃園縣,龜山鄉,大坑村,0,1,721,9,730,1167,0,0,0,0,0,0,62.55
桃園縣,龜山鄉,南上村,0,1,762,12,774,1160,0,0,0,0,0,0,66.72
桃園縣,龜山鄉,南美村,0,1,647,5,652,1062,0,0,0,0,0,0,61.39
桃園縣,龜山鄉,楓樹村,0,1,1318,25,1343,2221,0,0,0,0,0,0,60.47
桃園縣,八德市,興仁里,0,1,1810,35,1845,2887,0,0,0,0,0,0,63.91
桃園縣,八德市,福興里,0,1,1823,28,1851,2517,0,0,0,0,0,0,73.54
桃園縣,八德市,瑞豐里,0,1,2010,33,2043,2942,0,0,0,0,0,0,69.44
桃園縣,八德市,瑞泰里,0,1,1669,32,1701,2668,0,0,0,0,0,0,63.76
桃園縣,八德市,瑞發里,0,1,1986,37,2023,2993,0,0,0,0,0,0,67.59
桃園縣,八德市,瑞德里,0,1,2072,41,2113,2940,0,0,0,0,0,0,71.87
桃園縣,八德市,瑞祥里,0,1,1844,24,1868,2738,0,0,0,0,0,0,68.22
桃園縣,八德市,廣興里,0,1,2787,52,2839,4156,0,0,0,0,0,0,68.31
桃園縣,八德市,廣隆里,0,1,1865,28,1893,2690,0,0,0,0,0,0,70.37
桃園縣,八德市,竹園里,0,1,1525,37,1562,2335,0,0,0,0,0,0,66.90
桃園縣,八德市,霄裡里,0,1,2472,58,2530,3662,0,0,0,0,0,0,69.09
桃園縣,八德市,茄明里,0,1,1352,33,1385,2256,0,0,0,0,0,0,61.39
桃園縣,八德市,茄苳里,0,1,2345,46,2391,3639,0,0,0,0,0,0,65.70
桃園縣,八德市,高明里,0,1,1713,41,1754,2709,0,0,0,0,0,0,64.75
桃園縣,八德市,高城里,0,1,1204,28,1232,1833,0,0,0,0,0,0,67.21
桃園縣,八德市,白鷺里,0,1,1332,16,1348,1924,0,0,0,0,0,0,70.06
桃園縣,八德市,大湳里,0,1,1461,31,1492,2325,0,0,0,0,0,0,64.17
桃園縣,八德市,大發里,0,1,946,17,963,1337,0,0,0,0,0,0,72.03
桃園縣,八德市,大仁里,0,1,1850,28,1878,2783,0,0,0,0,0,0,67.48
桃園縣,八德市,大明里,0,1,1108,15,1123,1859,0,0,0,0,0,0,60.41
桃園縣,八德市,大安里,0,1,972,15,987,1538,0,0,0,0,0,0,64.17
桃園縣,八德市,大竹里,0,1,801,10,811,1245,0,0,0,0,0,0,65.14
桃園縣,八德市,大興里,0,1,2258,34,2292,3576,0,0,0,0,0,0,64.09
桃園縣,八德市,大華里,0,1,2274,38,2312,3587,0,0,0,0,0,0,64.45
桃園縣,八德市,大信里,0,1,3457,80,3537,5700,0,0,0,0,0,0,62.05
桃園縣,八德市,大和里,0,1,1130,16,1146,1815,0,0,0,0,0,0,63.14
桃園縣,八德市,大昌里,0,1,1611,24,1635,2427,0,0,0,0,0,0,67.37
桃園縣,八德市,大同里,0,1,1066,14,1080,1592,0,0,0,0,0,0,67.84
桃園縣,八德市,大慶里,0,1,831,19,850,1314,0,0,0,0,0,0,64.69
桃園縣,八德市,大成里,0,1,2212,35,2247,3294,0,0,0,0,0,0,68.21
桃園縣,八德市,大義里,0,1,1684,17,1701,2667,0,0,0,0,0,0,63.78
桃園縣,八德市,大忠里,0,1,1130,24,1154,1789,0,0,0,0,0,0,64.51
桃園縣,八德市,大智里,0,1,2713,36,2749,4061,0,0,0,0,0,0,67.69
桃園縣,八德市,大正里,0,1,1588,25,1613,2480,0,0,0,0,0,0,65.04
桃園縣,八德市,大福里,0,1,1724,13,1737,2873,0,0,0,0,0,0,60.46
桃園縣,八德市,大強里,0,1,1448,24,1472,2177,0,0,0,0,0,0,67.62
桃園縣,八德市,大勇里,0,1,1114,18,1132,1750,0,0,0,0,0,0,64.69
桃園縣,八德市,大榮里,0,1,867,8,875,1428,0,0,0,0,0,0,61.27
桃園縣,八德市,大千里,0,1,1909,34,1943,3313,0,0,0,0,0,0,58.65
桃園縣,蘆竹鄉,新興村,0,1,1792,27,1819,2748,0,0,0,0,0,0,66.19
桃園縣,蘆竹鄉,中福村,0,1,1624,19,1643,2432,0,0,0,0,0,0,67.56
桃園縣,蘆竹鄉,新莊村,0,1,1654,28,1682,2536,0,0,0,0,0,0,66.32
桃園縣,蘆竹鄉,上竹村,0,1,1127,18,1145,1706,0,0,0,0,0,0,67.12
桃園縣,蘆竹鄉,宏竹村,0,1,1297,17,1314,1812,0,0,0,0,0,0,72.52
桃園縣,蘆竹鄉,大竹村,0,1,1293,25,1318,2049,0,0,0,0,0,0,64.32
桃園縣,蘆竹鄉,富竹村,0,1,637,6,643,833,0,0,0,0,0,0,77.19
桃園縣,蘆竹鄉,大華村,0,1,1231,18,1249,1746,0,0,0,0,0,0,71.53
桃園縣,蘆竹鄉,蘆竹村,0,1,1971,31,2002,2775,0,0,0,0,0,0,72.14
桃園縣,蘆竹鄉,南崁村,0,1,1330,17,1347,2068,0,0,0,0,0,0,65.14
桃園縣,蘆竹鄉,南興村,0,1,2261,44,2305,4161,0,0,0,0,0,0,55.40
桃園縣,蘆竹鄉,南榮村,0,1,1191,20,1211,1978,0,0,0,0,0,0,61.22
桃園縣,蘆竹鄉,錦中村,0,1,1043,12,1055,1648,0,0,0,0,0,0,64.02
桃園縣,蘆竹鄉,錦興村,0,1,1503,33,1536,2304,0,0,0,0,0,0,66.67
桃園縣,蘆竹鄉,長興村,0,1,864,13,877,1341,0,0,0,0,0,0,65.40
桃園縣,蘆竹鄉,五福村,0,1,1096,15,1111,1813,0,0,0,0,0,0,61.28
桃園縣,蘆竹鄉,羊稠村,0,1,1266,15,1281,2419,0,0,0,0,0,0,52.96
桃園縣,蘆竹鄉,營盤村,0,1,1192,12,1204,2067,0,0,0,0,0,0,58.25
桃園縣,蘆竹鄉,瓦窯村,0,1,668,18,686,1253,0,0,0,0,0,0,54.75
桃園縣,蘆竹鄉,內厝村,0,1,1175,17,1192,1690,0,0,0,0,0,0,70.53
桃園縣,蘆竹鄉,山鼻村,0,1,911,15,926,1319,0,0,0,0,0,0,70.20
桃園縣,蘆竹鄉,坑子村,0,1,997,13,1010,1524,0,0,0,0,0,0,66.27
桃園縣,蘆竹鄉,外社村,0,1,819,16,835,1204,0,0,0,0,0,0,69.35
桃園縣,蘆竹鄉,山腳村,0,1,1979,29,2008,2881,0,0,0,0,0,0,69.70
桃園縣,蘆竹鄉,坑口村,0,1,1401,29,1430,1990,0,0,0,0,0,0,71.86
桃園縣,蘆竹鄉,海湖村,0,1,1983,40,2023,3145,0,0,0,0,0,0,64.32
桃園縣,大園鄉,大園村,0,1,3558,53,3611,4804,0,0,0,0,0,0,75.17
桃園縣,大園鄉,田心村,0,1,2569,20,2589,3711,0,0,0,0,0,0,69.77
桃園縣,大園鄉,溪海村,0,1,1876,32,1908,2767,0,0,0,0,0,0,68.96
桃園縣,大園鄉,和平村,0,1,970,15,985,1374,0,0,0,0,0,0,71.69
桃園縣,大園鄉,橫峰村,0,1,3314,46,3360,4605,0,0,0,0,0,0,72.96
桃園縣,大園鄉,五權村,0,1,2461,32,2493,3256,0,0,0,0,0,0,76.57
桃園縣,大園鄉,埔心村,0,1,2895,41,2936,3907,0,0,0,0,0,0,75.15
桃園縣,大園鄉,大海村,0,1,950,21,971,1195,0,0,0,0,0,0,81.26
桃園縣,大園鄉,建華村,0,1,723,5,728,964,0,0,0,0,0,0,75.52
桃園縣,大園鄉,三石村,0,1,1731,29,1760,2311,0,0,0,0,0,0,76.16
桃園縣,大園鄉,果林村,0,1,2630,36,2666,3807,0,0,0,0,0,0,70.03
桃園縣,大園鄉,竹圍村,0,1,1498,15,1513,2077,0,0,0,0,0,0,72.85
桃園縣,大園鄉,海口村,0,1,870,12,882,1282,0,0,0,0,0,0,68.80
桃園縣,大園鄉,沙崙村,0,1,1778,30,1808,2565,0,0,0,0,0,0,70.49
桃園縣,大園鄉,后厝村,0,1,1056,12,1068,1400,0,0,0,0,0,0,76.29
桃園縣,大園鄉,圳頭村,0,1,1292,20,1312,1849,0,0,0,0,0,0,70.96
桃園縣,大園鄉,內海村,0,1,1171,12,1183,1640,0,0,0,0,0,0,72.13
桃園縣,大園鄉,北港村,0,1,1075,8,1083,1575,0,0,0,0,0,0,68.76
桃園縣,大園鄉,南港村,0,1,1543,19,1562,2446,0,0,0,0,0,0,63.86
桃園縣,大溪鎮,興和里,0,1,1168,15,1183,1667,0,0,0,0,0,0,70.97
桃園縣,大溪鎮,福仁里,0,1,774,10,784,1118,0,0,0,0,0,0,70.13
桃園縣,大溪鎮,田心里,0,1,2085,34,2119,3228,0,0,0,0,0,0,65.64
桃園縣,大溪鎮,一心里,0,1,1849,24,1873,2815,0,0,0,0,0,0,66.54
桃園縣,大溪鎮,一德里,0,1,2274,25,2299,3552,0,0,0,0,0,0,64.72
桃園縣,大溪鎮,月眉里,0,1,712,7,719,1010,0,0,0,0,0,0,71.19
桃園縣,大溪鎮,永福里,0,1,622,9,631,888,0,0,0,0,0,0,71.06
桃園縣,大溪鎮,康安里,0,1,698,15,713,958,0,0,0,0,0,0,74.43
桃園縣,大溪鎮,義和里,0,1,1127,14,1141,1574,0,0,0,0,0,0,72.49
桃園縣,大溪鎮,美華里,0,1,1618,28,1646,2467,0,0,0,0,0,0,66.72
桃園縣,大溪鎮,福安里,0,1,1349,16,1365,2056,0,0,0,0,0,0,66.39
桃園縣,大溪鎮,復興里,0,1,610,7,617,931,0,0,0,0,0,0,66.27
桃園縣,大溪鎮,新峰里,0,1,644,10,654,974,0,0,0,0,0,0,67.15
桃園縣,大溪鎮,中新里,0,1,1050,20,1070,1530,0,0,0,0,0,0,69.93
桃園縣,大溪鎮,瑞興里,0,1,1415,21,1436,1980,0,0,0,0,0,0,72.53
桃園縣,大溪鎮,仁善里,0,1,1560,28,1588,2266,0,0,0,0,0,0,70.08
桃園縣,大溪鎮,僑愛里,0,1,698,8,706,1086,0,0,0,0,0,0,65.01
桃園縣,大溪鎮,仁義里,0,1,1839,39,1878,2669,0,0,0,0,0,0,70.36
桃園縣,大溪鎮,仁和里,0,1,1135,19,1154,1761,0,0,0,0,0,0,65.53
桃園縣,大溪鎮,仁愛里,0,1,1099,15,1114,1590,0,0,0,0,0,0,70.06
桃園縣,大溪鎮,仁武里,0,1,1803,26,1829,2614,0,0,0,0,0,0,69.97
桃園縣,大溪鎮,仁文里,0,1,1854,28,1882,2783,0,0,0,0,0,0,67.62
桃園縣,大溪鎮,南興里,0,1,2467,46,2513,3482,0,0,0,0,0,0,72.17
桃園縣,大溪鎮,員林里,0,1,801,10,811,1118,0,0,0,0,0,0,72.54
桃園縣,大溪鎮,光明里,0,1,1065,23,1088,1606,0,0,0,0,0,0,67.75
桃園縣,大溪鎮,瑞源里,0,1,1791,26,1817,2741,0,0,0,0,0,0,66.29
桃園縣,大溪鎮,三元里,0,1,1814,24,1838,2707,0,0,0,0,0,0,67.90
桃園縣,復興鄉,三民村,0,1,780,12,792,1202,0,0,0,0,0,0,65.89
桃園縣,復興鄉,澤仁村,0,1,423,4,427,652,0,0,0,0,0,0,65.49
桃園縣,復興鄉,霞雲村,0,1,28,1,29,48,0,0,0,0,0,0,60.42
桃園縣,復興鄉,義盛村,0,1,26,0,26,42,0,0,0,0,0,0,61.90
桃園縣,復興鄉,羅浮村,0,1,177,1,178,303,0,0,0,0,0,0,58.75
桃園縣,復興鄉,奎輝村,0,1,21,1,22,62,0,0,0,0,0,0,35.48
桃園縣,復興鄉,長興村,0,1,68,3,71,108,0,0,0,0,0,0,65.74
桃園縣,復興鄉,高義村,0,1,31,0,31,57,0,0,0,0,0,0,54.39
桃園縣,復興鄉,三光村,0,1,17,0,17,53,0,0,0,0,0,0,32.08
桃園縣,復興鄉,華陵村,0,1,109,1,110,331,0,0,0,0,0,0,33.23
桃園縣,中壢市,後寮里,0,1,1396,29,1425,2411,0,0,0,0,0,0,59.10
桃園縣,中壢市,明德里,0,1,1765,25,1790,2833,0,0,0,0,0,0,63.18
桃園縣,中壢市,至善里,0,1,1700,23,1723,3116,0,0,0,0,0,0,55.30
桃園縣,中壢市,龍興里,0,1,2066,24,2090,3225,0,0,0,0,0,0,64.81
桃園縣,中壢市,龍德里,0,1,1715,26,1741,2693,0,0,0,0,0,0,64.65
桃園縣,中壢市,龍岡里,0,1,2341,39,2380,3533,0,0,0,0,0,0,67.36
桃園縣,中壢市,龍東里,0,1,2651,40,2691,4044,0,0,0,0,0,0,66.54
桃園縣,中壢市,龍昌里,0,1,2527,45,2572,3911,0,0,0,0,0,0,65.76
桃園縣,中壢市,龍平里,0,1,1899,30,1929,2914,0,0,0,0,0,0,66.20
桃園縣,中壢市,龍安里,0,1,1662,36,1698,2489,0,0,0,0,0,0,68.22
桃園縣,中壢市,仁美里,0,1,1914,20,1934,3066,0,0,0,0,0,0,63.08
桃園縣,中壢市,仁福里,0,1,1857,21,1878,2984,0,0,0,0,0,0,62.94
桃園縣,中壢市,仁愛里,0,1,2195,42,2237,3556,0,0,0,0,0,0,62.91
桃園縣,中壢市,仁德里,0,1,2452,33,2485,3871,0,0,0,0,0,0,64.20
桃園縣,中壢市,仁祥里,0,1,1535,33,1568,2478,0,0,0,0,0,0,63.28
桃園縣,中壢市,華勛里,0,1,1826,34,1860,2772,0,0,0,0,0,0,67.10
桃園縣,中壢市,中堅里,0,1,2487,48,2535,3713,0,0,0,0,0,0,68.27
桃園縣,中壢市,普仁里,0,1,1742,26,1768,2896,0,0,0,0,0,0,61.05
桃園縣,中壢市,普忠里,0,1,1211,13,1224,2234,0,0,0,0,0,0,54.79
桃園縣,中壢市,普強里,0,1,1667,9,1676,2557,0,0,0,0,0,0,65.55
桃園縣,中壢市,信義里,0,1,1586,13,1599,2325,0,0,0,0,0,0,68.77
桃園縣,中壢市,正義里,0,1,1810,12,1822,2987,0,0,0,0,0,0,61.00
桃園縣,中壢市,普慶里,0,1,1350,16,1366,2037,0,0,0,0,0,0,67.06
桃園縣,中壢市,普義里,0,1,1066,16,1082,1659,0,0,0,0,0,0,65.22
桃園縣,中壢市,德義里,0,1,1406,24,1430,2178,0,0,0,0,0,0,65.66
桃園縣,中壢市,仁義里,0,1,1327,15,1342,2186,0,0,0,0,0,0,61.39
桃園縣,中壢市,忠義里,0,1,950,20,970,1473,0,0,0,0,0,0,65.85
桃園縣,中壢市,興仁里,0,1,2333,32,2365,3674,0,0,0,0,0,0,64.37
桃園縣,中壢市,中正里,0,1,1850,27,1877,2953,0,0,0,0,0,0,63.56
桃園縣,中壢市,中山里,0,1,1722,21,1743,3252,0,0,0,0,0,0,53.60
桃園縣,中壢市,篤行里,0,1,1006,26,1032,1517,0,0,0,0,0,0,68.03
桃園縣,中壢市,自立里,0,1,1325,11,1336,2330,0,0,0,0,0,0,57.34
桃園縣,中壢市,自強里,0,1,2208,25,2233,3482,0,0,0,0,0,0,64.13
桃園縣,中壢市,內壢里,0,1,1571,32,1603,2481,0,0,0,0,0,0,64.61
桃園縣,中壢市,成功里,0,1,1446,23,1469,2309,0,0,0,0,0,0,63.62
桃園縣,中壢市,福德里,0,1,1574,23,1597,2459,0,0,0,0,0,0,64.95
桃園縣,中壢市,中原里,0,1,2341,26,2367,3584,0,0,0,0,0,0,66.04
桃園縣,中壢市,忠孝里,0,1,1160,23,1183,1843,0,0,0,0,0,0,64.19
桃園縣,中壢市,復興里,0,1,2059,26,2085,3365,0,0,0,0,0,0,61.96
桃園縣,中壢市,復華里,0,1,2061,26,2087,3162,0,0,0,0,0,0,66.00
桃園縣,中壢市,文化里,0,1,2282,33,2315,3682,0,0,0,0,0,0,62.87
桃園縣,中壢市,和平里,0,1,1179,21,1200,1802,0,0,0,0,0,0,66.59
桃園縣,中壢市,內定里,0,1,1559,29,1588,2461,0,0,0,0,0,0,64.53
桃園縣,中壢市,石頭里,0,1,1110,13,1123,2038,0,0,0,0,0,0,55.10
桃園縣,中壢市,中央里,0,1,2169,22,2191,3392,0,0,0,0,0,0,64.59
桃園縣,中壢市,新興里,0,1,2849,41,2890,4703,0,0,0,0,0,0,61.45
桃園縣,中壢市,振興里,0,1,2243,32,2275,3525,0,0,0,0,0,0,64.54
桃園縣,中壢市,東興里,0,1,3114,33,3147,4932,0,0,0,0,0,0,63.81
桃園縣,中壢市,水尾里,0,1,2351,26,2377,3700,0,0,0,0,0,0,64.24
桃園縣,中壢市,忠福里,0,1,2960,40,3000,4677,0,0,0,0,0,0,64.14
桃園縣,中壢市,幸福里,0,1,1917,22,1939,3440,0,0,0,0,0,0,56.37
桃園縣,中壢市,永福里,0,1,2110,28,2138,3586,0,0,0,0,0,0,59.62
桃園縣,中壢市,青埔里,0,1,1032,8,1040,1487,0,0,0,0,0,0,69.94
桃園縣,中壢市,新街里,0,1,1077,6,1083,1808,0,0,0,0,0,0,59.90
桃園縣,中壢市,興南里,0,1,1047,7,1054,1622,0,0,0,0,0,0,64.98
桃園縣,中壢市,興國里,0,1,2794,35,2829,4416,0,0,0,0,0,0,64.06
桃園縣,中壢市,興和里,0,1,1564,22,1586,2311,0,0,0,0,0,0,68.63
桃園縣,中壢市,永興里,0,1,699,4,703,1015,0,0,0,0,0,0,69.26
桃園縣,中壢市,中壢里,0,1,590,5,595,927,0,0,0,0,0,0,64.19
桃園縣,中壢市,中榮里,0,1,656,5,661,1066,0,0,0,0,0,0,62.01
桃園縣,中壢市,中建里,0,1,722,5,727,1109,0,0,0,0,0,0,65.55
桃園縣,中壢市,舊明里,0,1,1460,16,1476,2131,0,0,0,0,0,0,69.26
桃園縣,中壢市,新明里,0,1,2246,25,2271,3484,0,0,0,0,0,0,65.18
桃園縣,中壢市,光明里,0,1,2477,25,2502,4176,0,0,0,0,0,0,59.91
桃園縣,中壢市,永光里,0,1,1742,23,1765,2867,0,0,0,0,0,0,61.56
桃園縣,中壢市,三民里,0,1,1623,27,1650,2432,0,0,0,0,0,0,67.85
桃園縣,中壢市,五權里,0,1,2212,32,2244,3571,0,0,0,0,0,0,62.84
桃園縣,中壢市,五福里,0,1,1932,32,1964,3115,0,0,0,0,0,0,63.05
桃園縣,中壢市,芝芭里,0,1,1366,12,1378,1992,0,0,0,0,0,0,69.18
桃園縣,中壢市,洽溪里,0,1,884,15,899,1384,0,0,0,0,0,0,64.96
桃園縣,中壢市,內厝里,0,1,1986,22,2008,3127,0,0,0,0,0,0,64.21
桃園縣,中壢市,月眉里,0,1,1877,26,1903,2706,0,0,0,0,0,0,70.33
桃園縣,中壢市,山東里,0,1,1840,31,1871,2584,0,0,0,0,0,0,72.41
桃園縣,中壢市,過嶺里,0,1,1536,22,1558,2162,0,0,0,0,0,0,72.06
桃園縣,平鎮市,新勢里,0,1,2046,28,2074,3124,0,0,0,0,0,0,66.39
桃園縣,平鎮市,新榮里,0,1,2037,33,2070,3318,0,0,0,0,0,0,62.39
桃園縣,平鎮市,新富里,0,1,2189,25,2214,3789,0,0,0,0,0,0,58.43
桃園縣,平鎮市,北華里,0,1,1208,24,1232,1828,0,0,0,0,0,0,67.40
桃園縣,平鎮市,北安里,0,1,1043,10,1053,1599,0,0,0,0,0,0,65.85
桃園縣,平鎮市,北勢里,0,1,1385,17,1402,2190,0,0,0,0,0,0,64.02
桃園縣,平鎮市,新貴里,0,1,1469,20,1489,2277,0,0,0,0,0,0,65.39
桃園縣,平鎮市,金陵里,0,1,1055,13,1068,1500,0,0,0,0,0,0,71.20
桃園縣,平鎮市,北興里,0,1,2126,30,2156,3287,0,0,0,0,0,0,65.59
桃園縣,平鎮市,北貴里,0,1,1698,23,1721,2634,0,0,0,0,0,0,65.34
桃園縣,平鎮市,北富里,0,1,1661,15,1676,2623,0,0,0,0,0,0,63.90
桃園縣,平鎮市,龍恩里,0,1,1551,33,1584,2422,0,0,0,0,0,0,65.40
桃園縣,平鎮市,東社里,0,1,1935,28,1963,2874,0,0,0,0,0,0,68.30
桃園縣,平鎮市,龍興里,0,1,1386,30,1416,2184,0,0,0,0,0,0,64.84
桃園縣,平鎮市,忠貞里,0,1,894,14,908,1305,0,0,0,0,0,0,69.58
桃園縣,平鎮市,中正里,0,1,812,12,824,1296,0,0,0,0,0,0,63.58
桃園縣,平鎮市,貿易里,0,1,1615,31,1646,2340,0,0,0,0,0,0,70.34
桃園縣,平鎮市,建安里,0,1,1917,35,1952,2965,0,0,0,0,0,0,65.83
桃園縣,平鎮市,華安里,0,1,1726,35,1761,2701,0,0,0,0,0,0,65.20
桃園縣,平鎮市,東安里,0,1,1324,28,1352,2051,0,0,0,0,0,0,65.92
桃園縣,平鎮市,新安里,0,1,1508,33,1541,2422,0,0,0,0,0,0,63.63
桃園縣,平鎮市,東勢里,0,1,2141,25,2166,3333,0,0,0,0,0,0,64.99
桃園縣,平鎮市,莊敬里,0,1,2495,47,2542,3810,0,0,0,0,0,0,66.72
桃園縣,平鎮市,湧豐里,0,1,881,13,894,1301,0,0,0,0,0,0,68.72
桃園縣,平鎮市,湧光里,0,1,2794,42,2836,4164,0,0,0,0,0,0,68.11
桃園縣,平鎮市,湧安里,0,1,1607,29,1636,2470,0,0,0,0,0,0,66.23
桃園縣,平鎮市,廣興里,0,1,2125,26,2151,3457,0,0,0,0,0,0,62.22
桃園縣,平鎮市,廣達里,0,1,1833,19,1852,2921,0,0,0,0,0,0,63.40
桃園縣,平鎮市,復旦里,0,1,3001,42,3043,4916,0,0,0,0,0,0,61.90
桃園縣,平鎮市,義興里,0,1,2785,32,2817,4309,0,0,0,0,0,0,65.37
桃園縣,平鎮市,義民里,0,1,1806,21,1827,2976,0,0,0,0,0,0,61.39
桃園縣,平鎮市,宋屋里,0,1,2238,37,2275,3854,0,0,0,0,0,0,59.03
桃園縣,平鎮市,廣仁里,0,1,1835,26,1861,3188,0,0,0,0,0,0,58.38
桃園縣,平鎮市,雙連里,0,1,2119,24,2143,3209,0,0,0,0,0,0,66.78
桃園縣,平鎮市,高雙里,0,1,1512,15,1527,2374,0,0,0,0,0,0,64.32
桃園縣,平鎮市,平鎮里,0,1,1950,49,1999,2931,0,0,0,0,0,0,68.20
桃園縣,平鎮市,鎮興里,0,1,1354,21,1375,2041,0,0,0,0,0,0,67.37
桃園縣,平鎮市,金星里,0,1,4166,78,4244,6694,0,0,0,0,0,0,63.40
桃園縣,平鎮市,南勢里,0,1,1921,26,1947,3033,0,0,0,0,0,0,64.19
桃園縣,平鎮市,福林里,0,1,1312,12,1324,1913,0,0,0,0,0,0,69.21
桃園縣,平鎮市,山峰里,0,1,1424,20,1444,2189,0,0,0,0,0,0,65.97
桃園縣,楊梅鎮,仁美里,0,1,2395,42,2437,3684,0,0,0,0,0,0,66.15
桃園縣,楊梅鎮,埔心里,0,1,1083,13,1096,1530,0,0,0,0,0,0,71.63
桃園縣,楊梅鎮,光華里,0,1,1727,22,1749,2564,0,0,0,0,0,0,68.21
桃園縣,楊梅鎮,金龍里,0,1,995,10,1005,1417,0,0,0,0,0,0,70.92
桃園縣,楊梅鎮,四維里,0,1,1193,8,1201,1695,0,0,0,0,0,0,70.86
桃園縣,楊梅鎮,永平里,0,1,661,10,671,1109,0,0,0,0,0,0,60.50
桃園縣,楊梅鎮,瑞塘里,0,1,2022,32,2054,3211,0,0,0,0,0,0,63.97
桃園縣,楊梅鎮,瑞坪里,0,1,1180,8,1188,2010,0,0,0,0,0,0,59.10
桃園縣,楊梅鎮,梅溪里,0,1,1297,19,1316,2212,0,0,0,0,0,0,59.49
桃園縣,楊梅鎮,金溪里,0,1,1348,9,1357,2606,0,0,0,0,0,0,52.07
桃園縣,楊梅鎮,楊明里,0,1,1378,22,1400,2371,0,0,0,0,0,0,59.05
桃園縣,楊梅鎮,裕成里,0,1,1035,15,1050,2143,0,0,0,0,0,0,49.00
桃園縣,楊梅鎮,大同里,0,1,1758,16,1774,2640,0,0,0,0,0,0,67.20
桃園縣,楊梅鎮,中山里,0,1,1022,14,1036,1760,0,0,0,0,0,0,58.86
桃園縣,楊梅鎮,楊梅里,0,1,1811,14,1825,2615,0,0,0,0,0,0,69.79
桃園縣,楊梅鎮,楊江里,0,1,771,9,780,1122,0,0,0,0,0,0,69.52
桃園縣,楊梅鎮,梅新里,0,1,926,20,946,1581,0,0,0,0,0,0,59.84
桃園縣,楊梅鎮,紅梅里,0,1,1367,11,1378,2043,0,0,0,0,0,0,67.45
桃園縣,楊梅鎮,永寧里,0,1,2070,34,2104,3164,0,0,0,0,0,0,66.50
桃園縣,楊梅鎮,大平里,0,1,1839,42,1881,2782,0,0,0,0,0,0,67.61
桃園縣,楊梅鎮,秀才里,0,1,1651,26,1677,2487,0,0,0,0,0,0,67.43
桃園縣,楊梅鎮,東流里,0,1,1051,12,1063,1635,0,0,0,0,0,0,65.02
桃園縣,楊梅鎮,豐野里,0,1,1918,33,1951,2772,0,0,0,0,0,0,70.38
桃園縣,楊梅鎮,富岡里,0,1,2692,38,2730,3855,0,0,0,0,0,0,70.82
桃園縣,楊梅鎮,員本里,0,1,1190,11,1201,1729,0,0,0,0,0,0,69.46
桃園縣,楊梅鎮,三湖里,0,1,1410,24,1434,2491,0,0,0,0,0,0,57.57
桃園縣,楊梅鎮,上湖里,0,1,1606,34,1640,2769,0,0,0,0,0,0,59.23
桃園縣,楊梅鎮,上田里,0,1,1379,11,1390,2058,0,0,0,0,0,0,67.54
桃園縣,楊梅鎮,高山里,0,1,2022,43,2065,3202,0,0,0,0,0,0,64.49
桃園縣,楊梅鎮,青山里,0,1,639,7,646,1214,0,0,0,0,0,0,53.21
桃園縣,楊梅鎮,高榮里,0,1,1314,21,1335,2011,0,0,0,0,0,0,66.38
桃園縣,楊梅鎮,雙榮里,0,1,810,15,825,1205,0,0,0,0,0,0,68.46
桃園縣,楊梅鎮,新榮里,0,1,985,22,1007,1675,0,0,0,0,0,0,60.12
桃園縣,楊梅鎮,水美里,0,1,1831,22,1853,2802,0,0,0,0,0,0,66.13
桃園縣,楊梅鎮,瑞原里,0,1,1768,27,1795,2774,0,0,0,0,0,0,64.71
桃園縣,龍潭鄉,黃唐村,0,1,3261,51,3312,5205,0,0,0,0,0,0,63.63
桃園縣,龍潭鄉,中山村,0,1,2298,29,2327,3368,0,0,0,0,0,0,69.09
桃園縣,龍潭鄉,烏林村,0,1,3318,62,3380,5423,0,0,0,0,0,0,62.33
桃園縣,龍潭鄉,干城村,0,1,511,9,520,720,0,0,0,0,0,0,72.22
桃園縣,龍潭鄉,凌雲村,0,1,3133,59,3192,4745,0,0,0,0,0,0,67.27
桃園縣,龍潭鄉,八德村,0,1,2932,49,2981,4821,0,0,0,0,0,0,61.83
桃園縣,龍潭鄉,上林村,0,1,1524,21,1545,2390,0,0,0,0,0,0,64.64
桃園縣,龍潭鄉,龍潭村,0,1,1445,6,1451,2009,0,0,0,0,0,0,72.22
桃園縣,龍潭鄉,中正村,0,1,4011,63,4074,6239,0,0,0,0,0,0,65.30
桃園縣,龍潭鄉,九龍村,0,1,2368,38,2406,4041,0,0,0,0,0,0,59.54
桃園縣,龍潭鄉,中興村,0,1,4454,79,4533,7342,0,0,0,0,0,0,61.74
桃園縣,龍潭鄉,佳安村,0,1,1936,18,1954,2978,0,0,0,0,0,0,65.61
桃園縣,龍潭鄉,三坑村,0,1,863,20,883,1290,0,0,0,0,0,0,68.45
桃園縣,龍潭鄉,大平村,0,1,498,9,507,782,0,0,0,0,0,0,64.83
桃園縣,龍潭鄉,三林村,0,1,4282,48,4330,6648,0,0,0,0,0,0,65.13
桃園縣,龍潭鄉,高平村,0,1,1353,22,1375,2197,0,0,0,0,0,0,62.59
桃園縣,龍潭鄉,高原村,0,1,1359,24,1383,2199,0,0,0,0,0,0,62.89
桃園縣,龍潭鄉,三和村,0,1,563,12,575,802,0,0,0,0,0,0,71.70
桃園縣,龍潭鄉,三水村,0,1,507,3,510,672,0,0,0,0,0,0,75.89
桃園縣,新屋鄉,新屋村,0,1,1686,12,1698,2268,0,0,0,0,0,0,74.87
桃園縣,新屋鄉,新生村,0,1,2072,16,2088,2755,0,0,0,0,0,0,75.79
桃園縣,新屋鄉,後湖村,0,1,861,10,871,1168,0,0,0,0,0,0,74.57
桃園縣,新屋鄉,清華村,0,1,1905,34,1939,2692,0,0,0,0,0,0,72.03
桃園縣,新屋鄉,石磊村,0,1,1213,13,1226,1617,0,0,0,0,0,0,75.82
桃園縣,新屋鄉,東明村,0,1,789,7,796,1052,0,0,0,0,0,0,75.67
桃園縣,新屋鄉,社子村,0,1,1042,15,1057,1345,0,0,0,0,0,0,78.59
桃園縣,新屋鄉,埔頂村,0,1,1385,17,1402,1853,0,0,0,0,0,0,75.66
桃園縣,新屋鄉,九斗村,0,1,1213,15,1228,1686,0,0,0,0,0,0,72.84
桃園縣,新屋鄉,頭洲村,0,1,1862,20,1882,2630,0,0,0,0,0,0,71.56
桃園縣,新屋鄉,大坡村,0,1,950,12,962,1328,0,0,0,0,0,0,72.44
桃園縣,新屋鄉,望間村,0,1,1123,8,1131,1498,0,0,0,0,0,0,75.50
桃園縣,新屋鄉,後庄村,0,1,756,12,768,1144,0,0,0,0,0,0,67.13
桃園縣,新屋鄉,蚵間村,0,1,561,8,569,802,0,0,0,0,0,0,70.95
桃園縣,新屋鄉,深圳村,0,1,462,5,467,672,0,0,0,0,0,0,69.49
桃園縣,新屋鄉,康榔村,0,1,798,14,812,1082,0,0,0,0,0,0,75.05
桃園縣,新屋鄉,笨港村,0,1,791,17,808,1096,0,0,0,0,0,0,73.72
桃園縣,新屋鄉,永安村,0,1,1515,14,1529,2125,0,0,0,0,0,0,71.95
桃園縣,新屋鄉,永興村,0,1,611,7,618,913,0,0,0,0,0,0,67.69
桃園縣,新屋鄉,下埔村,0,1,518,3,521,732,0,0,0,0,0,0,71.17
桃園縣,新屋鄉,石牌村,0,1,571,8,579,820,0,0,0,0,0,0,70.61
桃園縣,新屋鄉,下田村,0,1,1065,12,1077,1482,0,0,0,0,0,0,72.67
桃園縣,新屋鄉,赤欄村,0,1,772,15,787,1054,0,0,0,0,0,0,74.67
桃園縣,觀音鄉,觀音村,0,1,1610,22,1632,2243,0,0,0,0,0,0,72.76
桃園縣,觀音鄉,白玉村,0,1,846,15,861,1133,0,0,0,0,0,0,75.99
桃園縣,觀音鄉,廣興村,0,1,876,13,889,1270,0,0,0,0,0,0,70.00
桃園縣,觀音鄉,大潭村,0,1,774,8,782,1072,0,0,0,0,0,0,72.95
桃園縣,觀音鄉,保生村,0,1,1011,13,1024,1440,0,0,0,0,0,0,71.11
桃園縣,觀音鄉,武威村,0,1,482,4,486,667,0,0,0,0,0,0,72.86
桃園縣,觀音鄉,三和村,0,1,553,2,555,723,0,0,0,0,0,0,76.76
桃園縣,觀音鄉,新興村,0,1,522,5,527,691,0,0,0,0,0,0,76.27
桃園縣,觀音鄉,坑尾村,0,1,788,15,803,1146,0,0,0,0,0,0,70.07
桃園縣,觀音鄉,金湖村,0,1,1113,15,1128,1682,0,0,0,0,0,0,67.06
桃園縣,觀音鄉,藍埔村,0,1,1186,14,1200,1674,0,0,0,0,0,0,71.68
桃園縣,觀音鄉,大同村,0,1,1052,22,1074,1546,0,0,0,0,0,0,69.47
桃園縣,觀音鄉,大堀村,0,1,630,5,635,955,0,0,0,0,0,0,66.49
桃園縣,觀音鄉,崙坪村,0,1,2133,44,2177,3188,0,0,0,0,0,0,68.29
桃園縣,觀音鄉,富源村,0,1,1020,18,1038,1669,0,0,0,0,0,0,62.19
桃園縣,觀音鄉,上大村,0,1,1023,16,1039,1523,0,0,0,0,0,0,68.22
桃園縣,觀音鄉,新坡村,0,1,1651,28,1679,2460,0,0,0,0,0,0,68.25
桃園縣,觀音鄉,廣福村,0,1,1156,16,1172,1664,0,0,0,0,0,0,70.43
桃園縣,觀音鄉,塔腳村,0,1,724,9,733,963,0,0,0,0,0,0,76.12
桃園縣,觀音鄉,保障村,0,1,1122,13,1135,1623,0,0,0,0,0,0,69.93
桃園縣,觀音鄉,草漯村,0,1,1867,32,1899,2839,0,0,0,0,0,0,66.89
桃園縣,觀音鄉,樹林村,0,1,882,11,893,1446,0,0,0,0,0,0,61.76
桃園縣,觀音鄉,富林村,0,1,828,12,840,1269,0,0,0,0,0,0,66.19
新竹縣,竹北市,鹿場里,0,1,643,9,652,979,0,0,0,0,0,0,66.60
新竹縣,竹北市,東平里,0,1,297,5,302,455,0,0,0,0,0,0,66.37
新竹縣,竹北市,中興里,0,1,800,9,809,1423,0,0,0,0,0,0,56.85
新竹縣,竹北市,隘口里,0,1,490,5,495,812,0,0,0,0,0,0,60.96
新竹縣,竹北市,東海里,0,1,1362,17,1379,2244,0,0,0,0,0,0,61.45
新竹縣,竹北市,十興里,0,1,2244,41,2285,3888,0,0,0,0,0,0,58.77
新竹縣,竹北市,斗崙里,0,1,3831,42,3873,7318,0,0,0,0,0,0,52.92
新竹縣,竹北市,竹北里,0,1,1527,10,1537,2719,0,0,0,0,0,0,56.53
新竹縣,竹北市,竹仁里,0,1,2755,33,2788,5255,0,0,0,0,0,0,53.05
新竹縣,竹北市,竹義里,0,1,3052,35,3087,5910,0,0,0,0,0,0,52.23
新竹縣,竹北市,泰和里,0,1,1617,20,1637,2799,0,0,0,0,0,0,58.49
新竹縣,竹北市,新社里,0,1,2067,35,2102,4405,0,0,0,0,0,0,47.72
新竹縣,竹北市,新國里,0,1,1502,20,1522,3013,0,0,0,0,0,0,50.51
新竹縣,竹北市,聯興里,0,1,1452,26,1478,2549,0,0,0,0,0,0,57.98
新竹縣,竹北市,麻園里,0,1,604,7,611,1083,0,0,0,0,0,0,56.42
新竹縣,竹北市,溪州里,0,1,800,11,811,1464,0,0,0,0,0,0,55.40
新竹縣,竹北市,新庄里,0,1,498,6,504,831,0,0,0,0,0,0,60.65
新竹縣,竹北市,白地里,0,1,770,21,791,1447,0,0,0,0,0,0,54.66
新竹縣,竹北市,新港里,0,1,486,11,497,988,0,0,0,0,0,0,50.30
新竹縣,竹北市,大眉里,0,1,615,13,628,1149,0,0,0,0,0,0,54.66
新竹縣,竹北市,大義里,0,1,738,12,750,1249,0,0,0,0,0,0,60.05
新竹縣,竹北市,尚義里,0,1,684,11,695,1255,0,0,0,0,0,0,55.38
新竹縣,竹北市,崇義里,0,1,759,8,767,1447,0,0,0,0,0,0,53.01
新竹縣,竹東鎮,上坪里,0,1,295,5,300,417,0,0,0,0,0,0,71.94
新竹縣,竹東鎮,瑞峰里,0,1,217,5,222,353,0,0,0,0,0,0,62.89
新竹縣,竹東鎮,軟橋里,0,1,269,2,271,383,0,0,0,0,0,0,70.76
新竹縣,竹東鎮,員崠里,0,1,1035,11,1046,1728,0,0,0,0,0,0,60.53
新竹縣,竹東鎮,上館里,0,1,3105,49,3154,5462,0,0,0,0,0,0,57.74
新竹縣,竹東鎮,東寧里,0,1,1683,14,1697,2632,0,0,0,0,0,0,64.48
新竹縣,竹東鎮,中正里,0,1,861,15,876,1373,0,0,0,0,0,0,63.80
新竹縣,竹東鎮,大鄉里,0,1,1756,29,1785,2909,0,0,0,0,0,0,61.36
新竹縣,竹東鎮,中山里,0,1,1201,13,1214,1838,0,0,0,0,0,0,66.05
新竹縣,竹東鎮,南華里,0,1,751,13,764,1202,0,0,0,0,0,0,63.56
新竹縣,竹東鎮,東華里,0,1,525,3,528,789,0,0,0,0,0,0,66.92
新竹縣,竹東鎮,商華里,0,1,1317,19,1336,2084,0,0,0,0,0,0,64.11
新竹縣,竹東鎮,雞林里,0,1,1937,25,1962,3216,0,0,0,0,0,0,61.01
新竹縣,竹東鎮,仁愛里,0,1,1648,15,1663,2518,0,0,0,0,0,0,66.04
新竹縣,竹東鎮,竹東里,0,1,979,16,995,1488,0,0,0,0,0,0,66.87
新竹縣,竹東鎮,忠孝里,0,1,744,11,755,1270,0,0,0,0,0,0,59.45
新竹縣,竹東鎮,榮樂里,0,1,930,6,936,1420,0,0,0,0,0,0,65.92
新竹縣,竹東鎮,榮華里,0,1,3213,40,3253,5038,0,0,0,0,0,0,64.57
新竹縣,竹東鎮,五豐里,0,1,2554,39,2593,4552,0,0,0,0,0,0,56.96
新竹縣,竹東鎮,陸豐里,0,1,317,2,319,464,0,0,0,0,0,0,68.75
新竹縣,竹東鎮,三重里,0,1,2246,36,2282,3995,0,0,0,0,0,0,57.12
新竹縣,竹東鎮,二重里,0,1,3067,43,3110,5235,0,0,0,0,0,0,59.41
新竹縣,竹東鎮,頭重里,0,1,1904,29,1933,3245,0,0,0,0,0,0,59.57
新竹縣,竹東鎮,員山里,0,1,839,12,851,1332,0,0,0,0,0,0,63.89
新竹縣,竹東鎮,柯湖里,0,1,394,7,401,695,0,0,0,0,0,0,57.70
新竹縣,新埔鎮,新埔里,0,1,630,15,645,992,0,0,0,0,0,0,65.02
新竹縣,新埔鎮,新生里,0,1,431,6,437,670,0,0,0,0,0,0,65.22
新竹縣,新埔鎮,新民里,0,1,632,4,636,1010,0,0,0,0,0,0,62.97
新竹縣,新埔鎮,田新里,0,1,1475,21,1496,2292,0,0,0,0,0,0,65.27
新竹縣,新埔鎮,旱坑里,0,1,964,10,974,1621,0,0,0,0,0,0,60.09
新竹縣,新埔鎮,五埔里,0,1,1135,14,1149,1741,0,0,0,0,0,0,66.00
新竹縣,新埔鎮,四座里,0,1,1653,21,1674,2665,0,0,0,0,0,0,62.81
新竹縣,新埔鎮,照門里,0,1,929,12,941,1394,0,0,0,0,0,0,67.50
新竹縣,新埔鎮,清水里,0,1,303,3,306,440,0,0,0,0,0,0,69.55
新竹縣,新埔鎮,鹿鳴里,0,1,439,8,447,692,0,0,0,0,0,0,64.60
新竹縣,新埔鎮,新北里,0,1,422,9,431,613,0,0,0,0,0,0,70.31
新竹縣,新埔鎮,巨埔里,0,1,776,11,787,1084,0,0,0,0,0,0,72.60
新竹縣,新埔鎮,內立里,0,1,709,12,721,1074,0,0,0,0,0,0,67.13
新竹縣,新埔鎮,寶石里,0,1,457,3,460,701,0,0,0,0,0,0,65.62
新竹縣,新埔鎮,文山里,0,1,2057,39,2096,3445,0,0,0,0,0,0,60.84
新竹縣,新埔鎮,上寮里,0,1,929,8,937,1524,0,0,0,0,0,0,61.48
新竹縣,新埔鎮,下寮里,0,1,1040,17,1057,1664,0,0,0,0,0,0,63.52
新竹縣,新埔鎮,南平里,0,1,635,10,645,978,0,0,0,0,0,0,65.95
新竹縣,新埔鎮,北平里,0,1,453,3,456,657,0,0,0,0,0,0,69.41
新竹縣,關西鎮,東興里,0,1,422,4,426,600,0,0,0,0,0,0,71.00
新竹縣,關西鎮,西安里,0,1,1023,21,1044,1564,0,0,0,0,0,0,66.75
新竹縣,關西鎮,南雄里,0,1,490,6,496,745,0,0,0,0,0,0,66.58
新竹縣,關西鎮,北斗里,0,1,2107,24,2131,3364,0,0,0,0,0,0,63.35
新竹縣,關西鎮,北山里,0,1,507,4,511,741,0,0,0,0,0,0,68.96
新竹縣,關西鎮,仁安里,0,1,577,8,585,898,0,0,0,0,0,0,65.14
新竹縣,關西鎮,南山里,0,1,634,9,643,1019,0,0,0,0,0,0,63.10
新竹縣,關西鎮,東安里,0,1,1589,24,1613,2608,0,0,0,0,0,0,61.85
新竹縣,關西鎮,東山里,0,1,456,7,463,719,0,0,0,0,0,0,64.39
新竹縣,關西鎮,東光里,0,1,671,11,682,1104,0,0,0,0,0,0,61.78
新竹縣,關西鎮,南新里,0,1,668,9,677,975,0,0,0,0,0,0,69.44
新竹縣,關西鎮,新富里,0,1,400,12,412,610,0,0,0,0,0,0,67.54
新竹縣,關西鎮,玉山里,0,1,342,7,349,529,0,0,0,0,0,0,65.97
新竹縣,關西鎮,金山里,0,1,404,5,409,639,0,0,0,0,0,0,64.01
新竹縣,關西鎮,錦山里,0,1,527,5,532,918,0,0,0,0,0,0,57.95
新竹縣,關西鎮,大同里,0,1,474,3,477,699,0,0,0,0,0,0,68.24
新竹縣,關西鎮,石光里,0,1,1203,15,1218,1769,0,0,0,0,0,0,68.85
新竹縣,關西鎮,東平里,0,1,612,8,620,947,0,0,0,0,0,0,65.47
新竹縣,關西鎮,上林里,0,1,596,7,603,821,0,0,0,0,0,0,73.45
新竹縣,關西鎮,新力里,0,1,457,4,461,634,0,0,0,0,0,0,72.71
新竹縣,關西鎮,南和里,0,1,546,4,550,761,0,0,0,0,0,0,72.27
新竹縣,湖口鄉,和興村,0,1,2723,46,2769,4453,0,0,0,0,0,0,62.18
新竹縣,湖口鄉,德盛村,0,1,1767,28,1795,2943,0,0,0,0,0,0,60.99
新竹縣,湖口鄉,愛勢村,0,1,2103,42,2145,3493,0,0,0,0,0,0,61.41
新竹縣,湖口鄉,仁勢村,0,1,551,4,555,825,0,0,0,0,0,0,67.27
新竹縣,湖口鄉,孝勢村,0,1,733,10,743,1137,0,0,0,0,0,0,65.35
新竹縣,湖口鄉,中勢村,0,1,2637,38,2675,4099,0,0,0,0,0,0,65.26
新竹縣,湖口鄉,信勢村,0,1,2979,54,3033,4905,0,0,0,0,0,0,61.83
新竹縣,湖口鄉,波羅村,0,1,594,13,607,1000,0,0,0,0,0,0,60.70
新竹縣,湖口鄉,長嶺村,0,1,1421,33,1454,2319,0,0,0,0,0,0,62.70
新竹縣,湖口鄉,長安村,0,1,627,2,629,997,0,0,0,0,0,0,63.09
新竹縣,湖口鄉,湖口村,0,1,1332,12,1344,2142,0,0,0,0,0,0,62.75
新竹縣,湖口鄉,湖鏡村,0,1,1324,23,1347,2033,0,0,0,0,0,0,66.26
新竹縣,湖口鄉,湖南村,0,1,769,14,783,1264,0,0,0,0,0,0,61.95
新竹縣,湖口鄉,中興村,0,1,1953,46,1999,3123,0,0,0,0,0,0,64.01
新竹縣,湖口鄉,鳳凰村,0,1,2613,41,2654,4595,0,0,0,0,0,0,57.76
新竹縣,湖口鄉,鳳山村,0,1,1385,30,1415,2389,0,0,0,0,0,0,59.23
新竹縣,新豐鄉,福興村,0,1,545,9,554,794,0,0,0,0,0,0,69.77
新竹縣,新豐鄉,後湖村,0,1,969,16,985,1578,0,0,0,0,0,0,62.42
新竹縣,新豐鄉,青埔村,0,1,821,12,833,1281,0,0,0,0,0,0,65.03
新竹縣,新豐鄉,埔和村,0,1,1008,8,1016,2025,0,0,0,0,0,0,50.17
新竹縣,新豐鄉,坡頭村,0,1,482,7,489,755,0,0,0,0,0,0,64.77
新竹縣,新豐鄉,新豐村,0,1,1053,26,1079,1957,0,0,0,0,0,0,55.14
新竹縣,新豐鄉,瑞興村,0,1,735,14,749,1269,0,0,0,0,0,0,59.02
新竹縣,新豐鄉,中崙村,0,1,1028,14,1042,1795,0,0,0,0,0,0,58.05
新竹縣,新豐鄉,重興村,0,1,2809,38,2847,5163,0,0,0,0,0,0,55.14
新竹縣,新豐鄉,上坑村,0,1,701,11,712,1176,0,0,0,0,0,0,60.54
新竹縣,新豐鄉,鳳坑村,0,1,563,7,570,903,0,0,0,0,0,0,63.12
新竹縣,新豐鄉,員山村,0,1,3308,58,3366,5811,0,0,0,0,0,0,57.92
新竹縣,新豐鄉,松林村,0,1,1948,40,1988,3773,0,0,0,0,0,0,52.69
新竹縣,芎林鄉,華龍村,0,1,314,2,316,431,0,0,0,0,0,0,73.32
新竹縣,芎林鄉,五龍村,0,1,370,6,376,508,0,0,0,0,0,0,74.02
新竹縣,芎林鄉,秀湖村,0,1,513,3,516,760,0,0,0,0,0,0,67.89
新竹縣,芎林鄉,永興村,0,1,276,2,278,379,0,0,0,0,0,0,73.35
新竹縣,芎林鄉,石潭村,0,1,1460,14,1474,2203,0,0,0,0,0,0,66.91
新竹縣,芎林鄉,新鳳村,0,1,974,14,988,1397,0,0,0,0,0,0,70.72
新竹縣,芎林鄉,中坑村,0,1,383,4,387,533,0,0,0,0,0,0,72.61
新竹縣,芎林鄉,水坑村,0,1,380,5,385,577,0,0,0,0,0,0,66.72
新竹縣,芎林鄉,文林村,0,1,1252,18,1270,1844,0,0,0,0,0,0,68.87
新竹縣,芎林鄉,芎林村,0,1,966,16,982,1397,0,0,0,0,0,0,70.29
新竹縣,芎林鄉,上山村,0,1,1553,12,1565,2445,0,0,0,0,0,0,64.01
新竹縣,芎林鄉,下山村,0,1,722,9,731,1018,0,0,0,0,0,0,71.81
新竹縣,橫山鄉,橫山村,0,1,2044,19,2063,3168,0,0,0,0,0,0,65.12
新竹縣,橫山鄉,田寮村,0,1,560,5,565,812,0,0,0,0,0,0,69.58
新竹縣,橫山鄉,南昌村,0,1,102,1,103,145,0,0,0,0,0,0,71.03
新竹縣,橫山鄉,豐鄉村,0,1,90,2,92,135,0,0,0,0,0,0,68.15
新竹縣,橫山鄉,豐田村,0,1,214,1,215,327,0,0,0,0,0,0,65.75
新竹縣,橫山鄉,內灣村,0,1,705,8,713,1103,0,0,0,0,0,0,64.64
新竹縣,橫山鄉,力行村,0,1,599,6,605,859,0,0,0,0,0,0,70.43
新竹縣,橫山鄉,福興村,0,1,323,4,327,481,0,0,0,0,0,0,67.98
新竹縣,橫山鄉,沙坑村,0,1,771,13,784,1131,0,0,0,0,0,0,69.32
新竹縣,橫山鄉,新興村,0,1,1088,15,1103,1522,0,0,0,0,0,0,72.47
新竹縣,橫山鄉,大肚村,0,1,893,12,905,1283,0,0,0,0,0,0,70.54
新竹縣,北埔鄉,北埔村,0,1,723,2,725,1127,0,0,0,0,0,0,64.33
新竹縣,北埔鄉,南興村,0,1,822,7,829,1275,0,0,0,0,0,0,65.02
新竹縣,北埔鄉,大湖村,0,1,327,5,332,482,0,0,0,0,0,0,68.88
新竹縣,北埔鄉,埔尾村,0,1,1489,20,1509,2298,0,0,0,0,0,0,65.67
新竹縣,北埔鄉,水際村,0,1,467,8,475,762,0,0,0,0,0,0,62.34
新竹縣,北埔鄉,南埔村,0,1,218,5,223,327,0,0,0,0,0,0,68.20
新竹縣,北埔鄉,大林村,0,1,413,8,421,620,0,0,0,0,0,0,67.90
新竹縣,北埔鄉,南坑村,0,1,227,3,230,347,0,0,0,0,0,0,66.28
新竹縣,北埔鄉,外坪村,0,1,182,3,185,310,0,0,0,0,0,0,59.68
新竹縣,寶山鄉,雙溪村,0,1,1759,27,1786,3317,0,0,0,0,0,0,53.84
新竹縣,寶山鄉,大崎村,0,1,487,2,489,902,0,0,0,0,0,0,54.21
新竹縣,寶山鄉,三峰村,0,1,529,4,533,763,0,0,0,0,0,0,69.86
新竹縣,寶山鄉,新城村,0,1,707,5,712,1131,0,0,0,0,0,0,62.95
新竹縣,寶山鄉,寶斗村,0,1,453,5,458,633,0,0,0,0,0,0,72.35
新竹縣,寶山鄉,深井村,0,1,467,3,470,703,0,0,0,0,0,0,66.86
新竹縣,寶山鄉,寶山村,0,1,452,1,453,627,0,0,0,0,0,0,72.25
新竹縣,寶山鄉,油田村,0,1,397,3,400,558,0,0,0,0,0,0,71.68
新竹縣,寶山鄉,山湖村,0,1,347,6,353,550,0,0,0,0,0,0,64.18
新竹縣,峨眉鄉,峨眉村,0,1,632,2,634,892,0,0,0,0,0,0,71.08
新竹縣,峨眉鄉,中盛村,0,1,448,4,452,677,0,0,0,0,0,0,66.77
新竹縣,峨眉鄉,石井村,0,1,439,4,443,631,0,0,0,0,0,0,70.21
新竹縣,峨眉鄉,七星村,0,1,436,5,441,645,0,0,0,0,0,0,68.37
新竹縣,峨眉鄉,富興村,0,1,811,13,824,1197,0,0,0,0,0,0,68.84
新竹縣,峨眉鄉,湖光村,0,1,559,2,561,879,0,0,0,0,0,0,63.82
新竹縣,尖石鄉,嘉樂村,0,1,272,8,280,418,0,0,0,0,0,0,66.99
新竹縣,尖石鄉,義興村,0,1,15,1,16,41,0,0,0,0,0,0,39.02
新竹縣,尖石鄉,嘉樂村,0,1,75,1,76,139,0,0,0,0,0,0,54.68
新竹縣,尖石鄉,新樂村,0,1,90,4,94,183,0,0,0,0,0,0,51.37
新竹縣,尖石鄉,錦屏村,0,1,70,4,74,143,0,0,0,0,0,0,51.75
新竹縣,尖石鄉,梅花村,0,1,19,0,19,46,0,0,0,0,0,0,41.30
新竹縣,尖石鄉,玉峰村,0,1,18,2,20,35,0,0,0,0,0,0,57.14
新竹縣,尖石鄉,秀巒村,0,1,29,0,29,65,0,0,0,0,0,0,44.62
新竹縣,五峰鄉,大隘村,0,1,85,0,85,152,0,0,0,0,0,0,55.92
新竹縣,五峰鄉,花園村,0,1,40,0,40,74,0,0,0,0,0,0,54.05
新竹縣,五峰鄉,竹林村,0,1,7,0,7,11,0,0,0,0,0,0,63.64
新竹縣,五峰鄉,桃山村,0,1,53,1,54,127,0,0,0,0,0,0,42.52
苗栗縣,苗栗市,中苗里,0,1,567,17,584,865,0,0,0,0,0,0,67.51
苗栗縣,苗栗市,青苗里,0,1,680,8,688,1019,0,0,0,0,0,0,67.52
苗栗縣,苗栗市,維祥里,0,1,1839,40,1879,2924,0,0,0,0,0,0,64.26
苗栗縣,苗栗市,維新里,0,1,2364,28,2392,3606,0,0,0,0,0,0,66.33
苗栗縣,苗栗市,玉清里,0,1,1377,14,1391,2123,0,0,0,0,0,0,65.52
苗栗縣,苗栗市,玉華里,0,1,2112,49,2161,3205,0,0,0,0,0,0,67.43
苗栗縣,苗栗市,綠苗里,0,1,605,9,614,924,0,0,0,0,0,0,66.45
苗栗縣,苗栗市,高苗里,0,1,1437,64,1501,2414,0,0,0,0,0,0,62.18
苗栗縣,苗栗市,新苗里,0,1,667,9,676,973,0,0,0,0,0,0,69.48
苗栗縣,苗栗市,玉苗里,0,1,744,13,757,1101,0,0,0,0,0,0,68.76
苗栗縣,苗栗市,大同里,0,1,389,7,396,652,0,0,0,0,0,0,60.74
苗栗縣,苗栗市,恭敬里,0,1,1054,21,1075,1542,0,0,0,0,0,0,69.71
苗栗縣,苗栗市,水源里,0,1,1522,28,1550,2191,0,0,0,0,0,0,70.74
苗栗縣,苗栗市,勝利里,0,1,2273,40,2313,3399,0,0,0,0,0,0,68.05
苗栗縣,苗栗市,清華里,0,1,2021,23,2044,2953,0,0,0,0,0,0,69.22
苗栗縣,苗栗市,上苗里,0,1,1222,20,1242,1774,0,0,0,0,0,0,70.01
苗栗縣,苗栗市,北苗里,0,1,2414,32,2446,3690,0,0,0,0,0,0,66.29
苗栗縣,苗栗市,嘉盛里,0,1,3612,52,3664,5252,0,0,0,0,0,0,69.76
苗栗縣,苗栗市,福星里,0,1,3324,56,3380,5028,0,0,0,0,0,0,67.22
苗栗縣,苗栗市,建功里,0,1,2165,46,2211,3284,0,0,0,0,0,0,67.33
苗栗縣,苗栗市,福麗里,0,1,2500,39,2539,3913,0,0,0,0,0,0,64.89
苗栗縣,苗栗市,文山里,0,1,2761,62,2823,4189,0,0,0,0,0,0,67.39
苗栗縣,苗栗市,新川里,0,1,740,8,748,1067,0,0,0,0,0,0,70.10
苗栗縣,苗栗市,新英里,0,1,1841,31,1872,2898,0,0,0,0,0,0,64.60
苗栗縣,苑裡鎮,苑東里,0,1,1133,8,1141,1667,0,0,0,0,0,0,68.45
苗栗縣,苑裡鎮,苑南里,0,1,1045,14,1059,1578,0,0,0,0,0,0,67.11
苗栗縣,苑裡鎮,苑北里,0,1,596,10,606,890,0,0,0,0,0,0,68.09
苗栗縣,苑裡鎮,西平里,0,1,857,5,862,1302,0,0,0,0,0,0,66.21
苗栗縣,苑裡鎮,苑港里,0,1,774,13,787,1106,0,0,0,0,0,0,71.16
苗栗縣,苑裡鎮,西勢里,0,1,1011,19,1030,1499,0,0,0,0,0,0,68.71
苗栗縣,苑裡鎮,海岸里,0,1,643,4,647,955,0,0,0,0,0,0,67.75
苗栗縣,苑裡鎮,房裡里,0,1,1330,18,1348,1990,0,0,0,0,0,0,67.74
苗栗縣,苑裡鎮,客庄里,0,1,1944,14,1958,2899,0,0,0,0,0,0,67.54
苗栗縣,苑裡鎮,中正里,0,1,1150,12,1162,1725,0,0,0,0,0,0,67.36
苗栗縣,苑裡鎮,苑坑里,0,1,615,4,619,976,0,0,0,0,0,0,63.42
苗栗縣,苑裡鎮,水坡里,0,1,404,3,407,611,0,0,0,0,0,0,66.61
苗栗縣,苑裡鎮,新復里,0,1,746,1,747,1087,0,0,0,0,0,0,68.72
苗栗縣,苑裡鎮,山腳里,0,1,1038,18,1056,1587,0,0,0,0,0,0,66.54
苗栗縣,苑裡鎮,舊社里,0,1,1073,15,1088,1538,0,0,0,0,0,0,70.74
苗栗縣,苑裡鎮,福田里,0,1,860,13,873,1252,0,0,0,0,0,0,69.73
苗栗縣,苑裡鎮,石鎮里,0,1,486,3,489,630,0,0,0,0,0,0,77.62
苗栗縣,苑裡鎮,蕉埔里,0,1,687,12,699,945,0,0,0,0,0,0,73.97
苗栗縣,苑裡鎮,南勢里,0,1,483,7,490,737,0,0,0,0,0,0,66.49
苗栗縣,苑裡鎮,泰田里,0,1,981,10,991,1383,0,0,0,0,0,0,71.66
苗栗縣,苑裡鎮,上館里,0,1,1025,14,1039,1503,0,0,0,0,0,0,69.13
苗栗縣,苑裡鎮,玉田里,0,1,964,11,975,1398,0,0,0,0,0,0,69.74
苗栗縣,苑裡鎮,社苓里,0,1,1289,18,1307,1925,0,0,0,0,0,0,67.90
苗栗縣,苑裡鎮,山柑里,0,1,761,9,770,1091,0,0,0,0,0,0,70.58
苗栗縣,苑裡鎮,田心里,0,1,852,11,863,1197,0,0,0,0,0,0,72.10
苗栗縣,通霄鎮,通東里,0,1,851,9,860,1259,0,0,0,0,0,0,68.31
苗栗縣,通霄鎮,通西里,0,1,1565,11,1576,2159,0,0,0,0,0,0,73.00
苗栗縣,通霄鎮,平元里,0,1,2311,24,2335,3357,0,0,0,0,0,0,69.56
苗栗縣,通霄鎮,五南里,0,1,904,8,912,1234,0,0,0,0,0,0,73.91
苗栗縣,通霄鎮,五北里,0,1,1076,13,1089,1401,0,0,0,0,0,0,77.73
苗栗縣,通霄鎮,梅南里,0,1,1066,13,1079,1433,0,0,0,0,0,0,75.30
苗栗縣,通霄鎮,通南里,0,1,1628,25,1653,2323,0,0,0,0,0,0,71.16
苗栗縣,通霄鎮,坪頂里,0,1,872,37,909,1211,0,0,0,0,0,0,75.06
苗栗縣,通霄鎮,福興里,0,1,466,3,469,663,0,0,0,0,0,0,70.74
苗栗縣,通霄鎮,南和里,0,1,641,12,653,843,0,0,0,0,0,0,77.46
苗栗縣,通霄鎮,城南里,0,1,727,16,743,1046,0,0,0,0,0,0,71.03
苗栗縣,通霄鎮,城北里,0,1,497,8,505,708,0,0,0,0,0,0,71.33
苗栗縣,通霄鎮,圳頭里,0,1,591,6,597,770,0,0,0,0,0,0,77.53
苗栗縣,通霄鎮,內湖里,0,1,1331,8,1339,1708,0,0,0,0,0,0,78.40
苗栗縣,通霄鎮,楓樹里,0,1,426,2,428,578,0,0,0,0,0,0,74.05
苗栗縣,通霄鎮,烏眉里,0,1,713,6,719,947,0,0,0,0,0,0,75.92
苗栗縣,通霄鎮,福龍里,0,1,374,2,376,542,0,0,0,0,0,0,69.37
苗栗縣,通霄鎮,福源里,0,1,465,8,473,727,0,0,0,0,0,0,65.06
苗栗縣,通霄鎮,通灣里,0,1,1491,19,1510,2070,0,0,0,0,0,0,72.95
苗栗縣,通霄鎮,新埔里,0,1,924,11,935,1240,0,0,0,0,0,0,75.40
苗栗縣,通霄鎮,內島里,0,1,572,11,583,768,0,0,0,0,0,0,75.91
苗栗縣,通霄鎮,白東里,0,1,889,8,897,1304,0,0,0,0,0,0,68.79
苗栗縣,通霄鎮,白西里,0,1,599,3,602,828,0,0,0,0,0,0,72.71
苗栗縣,竹南鎮,竹南里,0,1,1156,14,1170,1687,0,0,0,0,0,0,69.35
苗栗縣,竹南鎮,照南里,0,1,1647,32,1679,2300,0,0,0,0,0,0,73.00
苗栗縣,竹南鎮,正南里,0,1,1408,23,1431,2131,0,0,0,0,0,0,67.15
苗栗縣,竹南鎮,新南里,0,1,1772,19,1791,2497,0,0,0,0,0,0,71.73
苗栗縣,竹南鎮,大厝里,0,1,2098,23,2121,3020,0,0,0,0,0,0,70.23
苗栗縣,竹南鎮,營盤里,0,1,1663,22,1685,2273,0,0,0,0,0,0,74.13
苗栗縣,竹南鎮,聖福里,0,1,1432,16,1448,2089,0,0,0,0,0,0,69.32
苗栗縣,竹南鎮,竹興里,0,1,1754,40,1794,2622,0,0,0,0,0,0,68.42
苗栗縣,竹南鎮,龍鳳里,0,1,2725,34,2759,3706,0,0,0,0,0,0,74.45
苗栗縣,竹南鎮,山佳里,0,1,2993,35,3028,4400,0,0,0,0,0,0,68.82
苗栗縣,竹南鎮,中港里,0,1,651,3,654,871,0,0,0,0,0,0,75.09
苗栗縣,竹南鎮,中華里,0,1,1360,16,1376,1981,0,0,0,0,0,0,69.46
苗栗縣,竹南鎮,中英里,0,1,735,10,745,1040,0,0,0,0,0,0,71.63
苗栗縣,竹南鎮,中美里,0,1,998,19,1017,1374,0,0,0,0,0,0,74.02
苗栗縣,竹南鎮,開元里,0,1,381,4,385,486,0,0,0,0,0,0,79.22
苗栗縣,竹南鎮,海口里,0,1,1300,15,1315,1810,0,0,0,0,0,0,72.65
苗栗縣,竹南鎮,港墘里,0,1,991,9,1000,1277,0,0,0,0,0,0,78.31
苗栗縣,竹南鎮,公館里,0,1,701,11,712,1043,0,0,0,0,0,0,68.26
苗栗縣,竹南鎮,大埔里,0,1,1987,56,2043,2832,0,0,0,0,0,0,72.14
苗栗縣,竹南鎮,頂埔里,0,1,1560,21,1581,2090,0,0,0,0,0,0,75.65
苗栗縣,竹南鎮,崎頂里,0,1,1560,27,1587,2156,0,0,0,0,0,0,73.61
苗栗縣,竹南鎮,公義里,0,1,629,11,640,895,0,0,0,0,0,0,71.51
苗栗縣,頭份鎮,流東里,0,1,1343,19,1362,1901,0,0,0,0,0,0,71.65
苗栗縣,頭份鎮,珊湖里,0,1,1265,16,1281,1801,0,0,0,0,0,0,71.13
苗栗縣,頭份鎮,斗煥里,0,1,1890,27,1917,2630,0,0,0,0,0,0,72.89
苗栗縣,頭份鎮,新華里,0,1,2235,43,2278,3339,0,0,0,0,0,0,68.22
苗栗縣,頭份鎮,興隆里,0,1,1672,25,1697,2693,0,0,0,0,0,0,63.02
苗栗縣,頭份鎮,上埔里,0,1,1477,18,1495,2191,0,0,0,0,0,0,68.23
苗栗縣,頭份鎮,土牛里,0,1,499,10,509,787,0,0,0,0,0,0,64.68
苗栗縣,頭份鎮,頭份里,0,1,1446,28,1474,2357,0,0,0,0,0,0,62.54
苗栗縣,頭份鎮,忠孝里,0,1,2572,24,2596,4016,0,0,0,0,0,0,64.64
苗栗縣,頭份鎮,信義里,0,1,521,10,531,727,0,0,0,0,0,0,73.04
苗栗縣,頭份鎮,仁愛里,0,1,984,7,991,1440,0,0,0,0,0,0,68.82
苗栗縣,頭份鎮,上興里,0,1,735,6,741,995,0,0,0,0,0,0,74.47
苗栗縣,頭份鎮,下興里,0,1,1221,16,1237,1924,0,0,0,0,0,0,64.29
苗栗縣,頭份鎮,山下里,0,1,1384,14,1398,2021,0,0,0,0,0,0,69.17
苗栗縣,頭份鎮,後庄里,0,1,2454,34,2488,3754,0,0,0,0,0,0,66.28
苗栗縣,頭份鎮,建國里,0,1,1410,22,1432,2226,0,0,0,0,0,0,64.33
苗栗縣,頭份鎮,成功里,0,1,1391,19,1410,2275,0,0,0,0,0,0,61.98
苗栗縣,頭份鎮,蟠桃里,0,1,1049,17,1066,1696,0,0,0,0,0,0,62.85
苗栗縣,頭份鎮,東庄里,0,1,1327,12,1339,2069,0,0,0,0,0,0,64.72
苗栗縣,頭份鎮,和平里,0,1,724,11,735,1022,0,0,0,0,0,0,71.92
苗栗縣,頭份鎮,民族里,0,1,918,14,932,1449,0,0,0,0,0,0,64.32
苗栗縣,頭份鎮,民權里,0,1,1039,8,1047,1604,0,0,0,0,0,0,65.27
苗栗縣,頭份鎮,民生里,0,1,1056,24,1080,1742,0,0,0,0,0,0,62.00
苗栗縣,頭份鎮,田寮里,0,1,1642,22,1664,2539,0,0,0,0,0,0,65.54
苗栗縣,頭份鎮,蘆竹里,0,1,953,13,966,1292,0,0,0,0,0,0,74.77
苗栗縣,頭份鎮,尖山里,0,1,913,7,920,1270,0,0,0,0,0,0,72.44
苗栗縣,頭份鎮,廣興里,0,1,621,9,630,847,0,0,0,0,0,0,74.38
苗栗縣,頭份鎮,尖下里,0,1,1475,20,1495,2335,0,0,0,0,0,0,64.03
苗栗縣,頭份鎮,濫坑里,0,1,1181,14,1195,1848,0,0,0,0,0,0,64.66
苗栗縣,後龍鎮,南龍里,0,1,1104,12,1116,1468,0,0,0,0,0,0,76.02
苗栗縣,後龍鎮,中龍里,0,1,750,0,750,945,0,0,0,0,0,0,79.37
苗栗縣,後龍鎮,北龍里,0,1,1006,19,1025,1391,0,0,0,0,0,0,73.69
苗栗縣,後龍鎮,大庄里,0,1,2387,24,2411,3098,0,0,0,0,0,0,77.82
苗栗縣,後龍鎮,溪洲里,0,1,1531,16,1547,2068,0,0,0,0,0,0,74.81
苗栗縣,後龍鎮,豐富里,0,1,965,13,978,1250,0,0,0,0,0,0,78.24
苗栗縣,後龍鎮,校椅里,0,1,922,6,928,1184,0,0,0,0,0,0,78.38
苗栗縣,後龍鎮,埔頂里,0,1,1650,14,1664,2061,0,0,0,0,0,0,80.74
苗栗縣,後龍鎮,新民里,0,1,1048,11,1059,1307,0,0,0,0,0,0,81.03
苗栗縣,後龍鎮,復興里,0,1,485,8,493,632,0,0,0,0,0,0,78.01
苗栗縣,後龍鎮,東明里,0,1,1005,7,1012,1401,0,0,0,0,0,0,72.23
苗栗縣,後龍鎮,大山里,0,1,1168,13,1181,1629,0,0,0,0,0,0,72.50
苗栗縣,後龍鎮,灣寶里,0,1,997,8,1005,1380,0,0,0,0,0,0,72.83
苗栗縣,後龍鎮,海寶里,0,1,725,9,734,1008,0,0,0,0,0,0,72.82
苗栗縣,後龍鎮,外埔里,0,1,858,11,869,1258,0,0,0,0,0,0,69.08
苗栗縣,後龍鎮,海埔里,0,1,722,7,729,1062,0,0,0,0,0,0,68.64
苗栗縣,後龍鎮,秀水里,0,1,549,1,550,755,0,0,0,0,0,0,72.85
苗栗縣,後龍鎮,水尾里,0,1,791,6,797,1115,0,0,0,0,0,0,71.48
苗栗縣,後龍鎮,龍津里,0,1,490,10,500,658,0,0,0,0,0,0,75.99
苗栗縣,後龍鎮,龍坑里,0,1,927,14,941,1256,0,0,0,0,0,0,74.92
苗栗縣,後龍鎮,福寧里,0,1,601,3,604,836,0,0,0,0,0,0,72.25
苗栗縣,後龍鎮,中和里,0,1,810,6,816,1274,0,0,0,0,0,0,64.05
苗栗縣,後龍鎮,南港里,0,1,863,12,875,1318,0,0,0,0,0,0,66.39
苗栗縣,卓蘭鎮,老庄里,0,1,1619,24,1643,2106,0,0,0,0,0,0,78.02
苗栗縣,卓蘭鎮,新榮里,0,1,870,12,882,1134,0,0,0,0,0,0,77.78
苗栗縣,卓蘭鎮,中街里,0,1,605,9,614,798,0,0,0,0,0,0,76.94
苗栗縣,卓蘭鎮,新厝里,0,1,1157,14,1171,1546,0,0,0,0,0,0,75.74
苗栗縣,卓蘭鎮,豐田里,0,1,801,23,824,986,0,0,0,0,0,0,83.57
苗栗縣,卓蘭鎮,西坪里,0,1,424,7,431,572,0,0,0,0,0,0,75.35
苗栗縣,卓蘭鎮,苗豐里,0,1,586,3,589,722,0,0,0,0,0,0,81.58
苗栗縣,卓蘭鎮,上新里,0,1,1406,29,1435,1912,0,0,0,0,0,0,75.05
苗栗縣,卓蘭鎮,內灣里,0,1,1569,37,1606,2025,0,0,0,0,0,0,79.31
苗栗縣,卓蘭鎮,坪林里,0,1,1112,19,1131,1440,0,0,0,0,0,0,78.54
苗栗縣,卓蘭鎮,景山里,0,1,530,7,537,718,0,0,0,0,0,0,74.79
苗栗縣,大湖鄉,大湖村,0,1,1234,11,1245,1702,0,0,0,0,0,0,73.15
苗栗縣,大湖鄉,明湖村,0,1,562,4,566,702,0,0,0,0,0,0,80.63
苗栗縣,大湖鄉,靜湖村,0,1,1200,14,1214,1606,0,0,0,0,0,0,75.59
苗栗縣,大湖鄉,富興村,0,1,1019,10,1029,1369,0,0,0,0,0,0,75.16
苗栗縣,大湖鄉,大南村,0,1,474,7,481,705,0,0,0,0,0,0,68.23
苗栗縣,大湖鄉,大寮村,0,1,929,8,937,1256,0,0,0,0,0,0,74.60
苗栗縣,大湖鄉,南湖村,0,1,559,10,569,749,0,0,0,0,0,0,75.97
苗栗縣,大湖鄉,義和村,0,1,1117,19,1136,1529,0,0,0,0,0,0,74.30
苗栗縣,大湖鄉,東興村,0,1,588,2,590,777,0,0,0,0,0,0,75.93
苗栗縣,大湖鄉,武榮村,0,1,425,6,431,562,0,0,0,0,0,0,76.69
苗栗縣,大湖鄉,栗林村,0,1,695,12,707,982,0,0,0,0,0,0,72.00
苗栗縣,大湖鄉,新開村,0,1,700,7,707,928,0,0,0,0,0,0,76.19
苗栗縣,公館鄉,館中村,0,1,1112,17,1129,1517,0,0,0,0,0,0,74.42
苗栗縣,公館鄉,館東村,0,1,1518,24,1542,2139,0,0,0,0,0,0,72.09
苗栗縣,公館鄉,館南村,0,1,1722,24,1746,2484,0,0,0,0,0,0,70.29
苗栗縣,公館鄉,中義村,0,1,1328,15,1343,1873,0,0,0,0,0,0,71.70
苗栗縣,公館鄉,玉泉村,0,1,1088,23,1111,1548,0,0,0,0,0,0,71.77
苗栗縣,公館鄉,大坑村,0,1,655,7,662,934,0,0,0,0,0,0,70.88
苗栗縣,公館鄉,福基村,0,1,795,7,802,1046,0,0,0,0,0,0,76.67
苗栗縣,公館鄉,福德村,0,1,302,3,305,412,0,0,0,0,0,0,74.03
苗栗縣,公館鄉,福星村,0,1,1029,15,1044,1456,0,0,0,0,0,0,71.70
苗栗縣,公館鄉,石墻村,0,1,1029,12,1041,1352,0,0,0,0,0,0,77.00
苗栗縣,公館鄉,開礦村,0,1,263,2,265,332,0,0,0,0,0,0,79.82
苗栗縣,公館鄉,五谷村,0,1,1256,19,1275,1739,0,0,0,0,0,0,73.32
苗栗縣,公館鄉,玉谷村,0,1,751,8,759,1014,0,0,0,0,0,0,74.85
苗栗縣,公館鄉,鶴岡村,0,1,991,12,1003,1343,0,0,0,0,0,0,74.68
苗栗縣,公館鄉,鶴山村,0,1,954,9,963,1292,0,0,0,0,0,0,74.54
苗栗縣,公館鄉,尖山村,0,1,992,9,1001,1330,0,0,0,0,0,0,75.26
苗栗縣,公館鄉,仁安村,0,1,886,10,896,1141,0,0,0,0,0,0,78.53
苗栗縣,公館鄉,南河村,0,1,157,4,161,215,0,0,0,0,0,0,74.88
苗栗縣,公館鄉,北河村,0,1,253,1,254,322,0,0,0,0,0,0,78.88
苗栗縣,銅鑼鄉,福興村,0,1,761,10,771,1034,0,0,0,0,0,0,74.56
苗栗縣,銅鑼鄉,朝陽村,0,1,1198,20,1218,1659,0,0,0,0,0,0,73.42
苗栗縣,銅鑼鄉,竹森村,0,1,744,11,755,1069,0,0,0,0,0,0,70.63
苗栗縣,銅鑼鄉,銅鑼村,0,1,2934,48,2982,3942,0,0,0,0,0,0,75.65
苗栗縣,銅鑼鄉,九湖村,0,1,938,18,956,1292,0,0,0,0,0,0,73.99
苗栗縣,銅鑼鄉,樟樹村,0,1,964,12,976,1264,0,0,0,0,0,0,77.22
苗栗縣,銅鑼鄉,中平村,0,1,1883,30,1913,2606,0,0,0,0,0,0,73.41
苗栗縣,銅鑼鄉,興隆村,0,1,478,3,481,630,0,0,0,0,0,0,76.35
苗栗縣,銅鑼鄉,盛隆村,0,1,378,3,381,551,0,0,0,0,0,0,69.15
苗栗縣,銅鑼鄉,新隆村,0,1,433,8,441,611,0,0,0,0,0,0,72.18
苗栗縣,南庄鄉,東村,0,1,864,13,877,1309,0,0,0,0,0,0,67.00
苗栗縣,南庄鄉,西村,0,1,499,3,502,719,0,0,0,0,0,0,69.82
苗栗縣,南庄鄉,南江村,0,1,736,6,742,1121,0,0,0,0,0,0,66.19
苗栗縣,南庄鄉,田美村,0,1,586,8,594,910,0,0,0,0,0,0,65.27
苗栗縣,南庄鄉,獅山村,0,1,662,15,677,1041,0,0,0,0,0,0,65.03
苗栗縣,南庄鄉,南富村,0,1,721,17,738,1117,0,0,0,0,0,0,66.07
苗栗縣,南庄鄉,員林村,0,1,734,5,739,1091,0,0,0,0,0,0,67.74
苗栗縣,南庄鄉,蓬萊村,0,1,297,6,303,468,0,0,0,0,0,0,64.74
苗栗縣,南庄鄉,東河村,0,1,180,4,184,290,0,0,0,0,0,0,63.45
苗栗縣,頭屋鄉,頭屋村,0,1,1746,15,1761,2310,0,0,0,0,0,0,76.23
苗栗縣,頭屋鄉,獅潭村,0,1,1177,9,1186,1504,0,0,0,0,0,0,78.86
苗栗縣,頭屋鄉,北坑村,0,1,484,4,488,636,0,0,0,0,0,0,76.73
苗栗縣,頭屋鄉,曲洞村,0,1,675,10,685,877,0,0,0,0,0,0,78.11
苗栗縣,頭屋鄉,飛鳳村,0,1,258,1,259,352,0,0,0,0,0,0,73.58
苗栗縣,頭屋鄉,象山村,0,1,1369,15,1384,1834,0,0,0,0,0,0,75.46
苗栗縣,頭屋鄉,明德村,0,1,885,7,892,1147,0,0,0,0,0,0,77.77
苗栗縣,頭屋鄉,鳴鳳村,0,1,282,2,284,372,0,0,0,0,0,0,76.34
苗栗縣,三義鄉,廣盛村,0,1,2834,41,2875,3827,0,0,0,0,0,0,75.12
苗栗縣,三義鄉,勝興村,0,1,1955,20,1975,2663,0,0,0,0,0,0,74.16
苗栗縣,三義鄉,雙湖村,0,1,1241,20,1261,1611,0,0,0,0,0,0,78.27
苗栗縣,三義鄉,雙潭村,0,1,1035,18,1053,1336,0,0,0,0,0,0,78.82
苗栗縣,三義鄉,西湖村,0,1,937,11,948,1227,0,0,0,0,0,0,77.26
苗栗縣,三義鄉,龍騰村,0,1,310,7,317,384,0,0,0,0,0,0,82.55
苗栗縣,三義鄉,鯉魚潭村,0,1,901,13,914,1150,0,0,0,0,0,0,79.48
苗栗縣,西湖鄉,高埔村,0,1,462,6,468,623,0,0,0,0,0,0,75.12
苗栗縣,西湖鄉,下埔村,0,1,410,7,417,571,0,0,0,0,0,0,73.03
苗栗縣,西湖鄉,五湖村,0,1,642,10,652,915,0,0,0,0,0,0,71.26
苗栗縣,西湖鄉,四湖村,0,1,502,5,507,666,0,0,0,0,0,0,76.13
苗栗縣,西湖鄉,三湖村,0,1,691,9,700,998,0,0,0,0,0,0,70.14
苗栗縣,西湖鄉,龍洞村,0,1,402,3,405,538,0,0,0,0,0,0,75.28
苗栗縣,西湖鄉,金獅村,0,1,387,5,392,544,0,0,0,0,0,0,72.06
苗栗縣,西湖鄉,湖東村,0,1,806,9,815,1171,0,0,0,0,0,0,69.60
苗栗縣,西湖鄉,二湖村,0,1,448,3,451,694,0,0,0,0,0,0,64.99
苗栗縣,造橋鄉,造橋村,0,1,1215,17,1232,1608,0,0,0,0,0,0,76.62
苗栗縣,造橋鄉,平興村,0,1,420,3,423,530,0,0,0,0,0,0,79.81
苗栗縣,造橋鄉,豐湖村,0,1,701,7,708,946,0,0,0,0,0,0,74.84
苗栗縣,造橋鄉,大西村,0,1,2164,29,2193,2796,0,0,0,0,0,0,78.43
苗栗縣,造橋鄉,錦水村,0,1,445,3,448,556,0,0,0,0,0,0,80.58
苗栗縣,造橋鄉,大龍村,0,1,442,3,445,538,0,0,0,0,0,0,82.71
苗栗縣,造橋鄉,朝陽村,0,1,1038,19,1057,1356,0,0,0,0,0,0,77.95
苗栗縣,造橋鄉,談文村,0,1,574,10,584,731,0,0,0,0,0,0,79.89
苗栗縣,造橋鄉,龍昇村,0,1,776,7,783,995,0,0,0,0,0,0,78.69
苗栗縣,三灣鄉,三灣村,0,1,1488,18,1506,2078,0,0,0,0,0,0,72.47
苗栗縣,三灣鄉,內灣村,0,1,477,8,485,609,0,0,0,0,0,0,79.64
苗栗縣,三灣鄉,銅鏡村,0,1,588,4,592,862,0,0,0,0,0,0,68.68
苗栗縣,三灣鄉,頂寮村,0,1,189,7,196,247,0,0,0,0,0,0,79.35
苗栗縣,三灣鄉,北埔村,0,1,421,4,425,592,0,0,0,0,0,0,71.79
苗栗縣,三灣鄉,大河村,0,1,466,5,471,672,0,0,0,0,0,0,70.09
苗栗縣,三灣鄉,大坪村,0,1,381,4,385,520,0,0,0,0,0,0,74.04
苗栗縣,三灣鄉,永和村,0,1,255,4,259,335,0,0,0,0,0,0,77.31
苗栗縣,獅潭鄉,百壽村,0,1,208,0,208,293,0,0,0,0,0,0,70.99
苗栗縣,獅潭鄉,永興村,0,1,490,7,497,668,0,0,0,0,0,0,74.40
苗栗縣,獅潭鄉,新店村,0,1,762,6,768,980,0,0,0,0,0,0,78.37
苗栗縣,獅潭鄉,和興村,0,1,451,4,455,638,0,0,0,0,0,0,71.32
苗栗縣,獅潭鄉,豐林村,0,1,471,4,475,676,0,0,0,0,0,0,70.27
苗栗縣,獅潭鄉,新豐村,0,1,284,6,290,376,0,0,0,0,0,0,77.13
苗栗縣,獅潭鄉,竹木村,0,1,566,10,576,778,0,0,0,0,0,0,74.04
苗栗縣,泰安鄉,八卦村,0,1,108,1,109,132,0,0,0,0,0,0,82.58
苗栗縣,泰安鄉,錦水村,0,1,213,3,216,353,0,0,0,0,0,0,61.19
苗栗縣,泰安鄉,清安村,0,1,496,11,507,681,0,0,0,0,0,0,74.45
苗栗縣,泰安鄉,大興村,0,1,69,1,70,102,0,0,0,0,0,0,68.63
苗栗縣,泰安鄉,中興村,0,1,95,1,96,128,0,0,0,0,0,0,75.00
苗栗縣,泰安鄉,梅園村,0,1,18,0,18,27,0,0,0,0,0,0,66.67
苗栗縣,泰安鄉,象鼻村,0,1,39,0,39,53,0,0,0,0,0,0,73.58
苗栗縣,泰安鄉,士林村,0,1,19,0,19,32,0,0,0,0,0,0,59.38
臺中縣,豐原市,豐原里,0,1,1376,28,1404,1941,0,0,0,0,0,0,72.33
臺中縣,豐原市,豐榮里,0,1,665,7,672,959,0,0,0,0,0,0,70.07
臺中縣,豐原市,頂街里,0,1,536,11,547,850,0,0,0,0,0,0,64.35
臺中縣,豐原市,中山里,0,1,677,6,683,924,0,0,0,0,0,0,73.92
臺中縣,豐原市,下街里,0,1,606,11,617,842,0,0,0,0,0,0,73.28
臺中縣,豐原市,中陽里,0,1,2863,46,2909,4258,0,0,0,0,0,0,68.32
臺中縣,豐原市,大湳里,0,1,1380,20,1400,1994,0,0,0,0,0,0,70.21
臺中縣,豐原市,北湳里,0,1,1549,23,1572,2183,0,0,0,0,0,0,72.01
臺中縣,豐原市,東湳里,0,1,2429,56,2485,3419,0,0,0,0,0,0,72.68
臺中縣,豐原市,西湳里,0,1,3446,85,3531,5446,0,0,0,0,0,0,64.84
臺中縣,豐原市,豐西里,0,1,1153,23,1176,1700,0,0,0,0,0,0,69.18
臺中縣,豐原市,圳寮里,0,1,800,14,814,1093,0,0,0,0,0,0,74.47
臺中縣,豐原市,豐圳里,0,1,1767,28,1795,2611,0,0,0,0,0,0,68.75
臺中縣,豐原市,富春里,0,1,704,11,715,881,0,0,0,0,0,0,81.16
臺中縣,豐原市,葫蘆里,0,1,602,5,607,880,0,0,0,0,0,0,68.98
臺中縣,豐原市,西安里,0,1,3003,50,3053,4557,0,0,0,0,0,0,67.00
臺中縣,豐原市,西勢里,0,1,1432,17,1449,2031,0,0,0,0,0,0,71.34
臺中縣,豐原市,中興里,0,1,1810,15,1825,2637,0,0,0,0,0,0,69.21
臺中縣,豐原市,社皮里,0,1,4285,89,4374,6922,0,0,0,0,0,0,63.19
臺中縣,豐原市,三村里,0,1,2752,57,2809,4098,0,0,0,0,0,0,68.55
臺中縣,豐原市,東勢里,0,1,931,21,952,1451,0,0,0,0,0,0,65.61
臺中縣,豐原市,民生里,0,1,731,6,737,1070,0,0,0,0,0,0,68.88
臺中縣,豐原市,田心里,0,1,2750,50,2800,4325,0,0,0,0,0,0,64.74
臺中縣,豐原市,豐田里,0,1,5023,122,5145,7823,0,0,0,0,0,0,65.77
臺中縣,豐原市,鐮村里,0,1,2260,42,2302,3209,0,0,0,0,0,0,71.74
臺中縣,豐原市,陽明里,0,1,1626,22,1648,2360,0,0,0,0,0,0,69.83
臺中縣,豐原市,南陽里,0,1,3716,56,3772,5566,0,0,0,0,0,0,67.77
臺中縣,豐原市,北陽里,0,1,6110,82,6192,9279,0,0,0,0,0,0,66.73
臺中縣,豐原市,東陽里,0,1,1129,22,1151,1556,0,0,0,0,0,0,73.97
臺中縣,豐原市,南村里,0,1,2320,28,2348,3580,0,0,0,0,0,0,65.59
臺中縣,豐原市,南田里,0,1,2268,49,2317,3053,0,0,0,0,0,0,75.89
臺中縣,豐原市,南嵩里,0,1,1993,38,2031,2772,0,0,0,0,0,0,73.27
臺中縣,豐原市,翁明里,0,1,1100,27,1127,1529,0,0,0,0,0,0,73.71
臺中縣,豐原市,翁子里,0,1,1480,22,1502,2201,0,0,0,0,0,0,68.24
臺中縣,豐原市,翁社里,0,1,1294,47,1341,1790,0,0,0,0,0,0,74.92
臺中縣,豐原市,朴子里,0,1,1951,56,2007,2729,0,0,0,0,0,0,73.54
臺中縣,東勢鎮,北興里,0,1,862,27,889,1179,0,0,0,0,0,0,75.40
臺中縣,東勢鎮,中寧里,0,1,661,13,674,879,0,0,0,0,0,0,76.68
臺中縣,東勢鎮,東安里,0,1,1057,31,1088,1502,0,0,0,0,0,0,72.44
臺中縣,東勢鎮,南平里,0,1,1458,35,1493,1926,0,0,0,0,0,0,77.52
臺中縣,東勢鎮,延平里,0,1,1669,36,1705,2350,0,0,0,0,0,0,72.55
臺中縣,東勢鎮,上新里,0,1,763,20,783,1014,0,0,0,0,0,0,77.22
臺中縣,東勢鎮,廣興里,0,1,1108,15,1123,1556,0,0,0,0,0,0,72.17
臺中縣,東勢鎮,泰昌里,0,1,2212,42,2254,3255,0,0,0,0,0,0,69.25
臺中縣,東勢鎮,中嵙里,0,1,1300,16,1316,1842,0,0,0,0,0,0,71.44
臺中縣,東勢鎮,福隆里,0,1,2093,50,2143,2858,0,0,0,0,0,0,74.98
臺中縣,東勢鎮,隆興里,0,1,1021,11,1032,1405,0,0,0,0,0,0,73.45
臺中縣,東勢鎮,新盛里,0,1,3229,55,3284,4295,0,0,0,0,0,0,76.46
臺中縣,東勢鎮,詒福里,0,1,1052,24,1076,1443,0,0,0,0,0,0,74.57
臺中縣,東勢鎮,上城里,0,1,733,10,743,984,0,0,0,0,0,0,75.51
臺中縣,東勢鎮,下城里,0,1,714,14,728,896,0,0,0,0,0,0,81.25
臺中縣,東勢鎮,慶東里,0,1,1489,21,1510,1929,0,0,0,0,0,0,78.28
臺中縣,東勢鎮,慶福里,0,1,997,13,1010,1364,0,0,0,0,0,0,74.05
臺中縣,東勢鎮,東新里,0,1,1265,30,1295,1853,0,0,0,0,0,0,69.89
臺中縣,東勢鎮,粵寧里,0,1,1356,27,1383,1838,0,0,0,0,0,0,75.24
臺中縣,東勢鎮,下新里,0,1,1182,23,1205,1519,0,0,0,0,0,0,79.33
臺中縣,東勢鎮,興隆里,0,1,851,15,866,1224,0,0,0,0,0,0,70.75
臺中縣,東勢鎮,茂興里,0,1,1115,21,1136,1595,0,0,0,0,0,0,71.22
臺中縣,東勢鎮,泰興里,0,1,561,14,575,741,0,0,0,0,0,0,77.60
臺中縣,東勢鎮,埤頭里,0,1,554,8,562,662,0,0,0,0,0,0,84.89
臺中縣,東勢鎮,明正里,0,1,1018,25,1043,1382,0,0,0,0,0,0,75.47
臺中縣,大甲鎮,朝陽里,0,1,869,14,883,1211,0,0,0,0,0,0,72.91
臺中縣,大甲鎮,大甲里,0,1,841,14,855,1165,0,0,0,0,0,0,73.39
臺中縣,大甲鎮,順天里,0,1,1161,25,1186,1640,0,0,0,0,0,0,72.32
臺中縣,大甲鎮,孔門里,0,1,544,11,555,732,0,0,0,0,0,0,75.82
臺中縣,大甲鎮,平安里,0,1,1319,24,1343,1763,0,0,0,0,0,0,76.18
臺中縣,大甲鎮,庄美里,0,1,1330,25,1355,1861,0,0,0,0,0,0,72.81
臺中縣,大甲鎮,新美里,0,1,2147,43,2190,2996,0,0,0,0,0,0,73.10
臺中縣,大甲鎮,岷山里,0,1,1174,18,1192,1572,0,0,0,0,0,0,75.83
臺中縣,大甲鎮,中山里,0,1,2029,52,2081,2963,0,0,0,0,0,0,70.23
臺中縣,大甲鎮,南陽里,0,1,659,17,676,880,0,0,0,0,0,0,76.82
臺中縣,大甲鎮,薰風里,0,1,622,11,633,880,0,0,0,0,0,0,71.93
臺中縣,大甲鎮,義和里,0,1,1703,38,1741,2401,0,0,0,0,0,0,72.51
臺中縣,大甲鎮,武陵里,0,1,819,22,841,991,0,0,0,0,0,0,84.86
臺中縣,大甲鎮,文曲里,0,1,830,15,845,1031,0,0,0,0,0,0,81.96
臺中縣,大甲鎮,武曲里,0,1,1052,14,1066,1390,0,0,0,0,0,0,76.69
臺中縣,大甲鎮,文武里,0,1,2873,44,2917,4073,0,0,0,0,0,0,71.62
臺中縣,大甲鎮,奉化里,0,1,824,22,846,1089,0,0,0,0,0,0,77.69
臺中縣,大甲鎮,德化里,0,1,894,11,905,1433,0,0,0,0,0,0,63.15
臺中縣,大甲鎮,江南里,0,1,728,14,742,942,0,0,0,0,0,0,78.77
臺中縣,大甲鎮,頂店里,0,1,2232,63,2295,2995,0,0,0,0,0,0,76.63
臺中縣,大甲鎮,太白里,0,1,880,23,903,1179,0,0,0,0,0,0,76.59
臺中縣,大甲鎮,孟春里,0,1,2043,46,2089,2798,0,0,0,0,0,0,74.66
臺中縣,大甲鎮,幸福里,0,1,1625,24,1649,2259,0,0,0,0,0,0,73.00
臺中縣,大甲鎮,日南里,0,1,2456,34,2490,3466,0,0,0,0,0,0,71.84
臺中縣,大甲鎮,龍泉里,0,1,1025,21,1046,1320,0,0,0,0,0,0,79.24
臺中縣,大甲鎮,西岐里,0,1,1104,23,1127,1441,0,0,0,0,0,0,78.21
臺中縣,大甲鎮,銅安里,0,1,863,13,876,1135,0,0,0,0,0,0,77.18
臺中縣,大甲鎮,福德里,0,1,840,12,852,1025,0,0,0,0,0,0,83.12
臺中縣,大甲鎮,建興里,0,1,979,7,986,1230,0,0,0,0,0,0,80.16
臺中縣,清水鎮,鰲峰里,0,1,813,24,837,1229,0,0,0,0,0,0,68.10
臺中縣,清水鎮,靈泉里,0,1,790,10,800,1055,0,0,0,0,0,0,75.83
臺中縣,清水鎮,清水里,0,1,1330,29,1359,2025,0,0,0,0,0,0,67.11
臺中縣,清水鎮,文昌里,0,1,539,4,543,741,0,0,0,0,0,0,73.28
臺中縣,清水鎮,南寧里,0,1,1373,16,1389,1965,0,0,0,0,0,0,70.69
臺中縣,清水鎮,西寧里,0,1,1006,19,1025,1364,0,0,0,0,0,0,75.15
臺中縣,清水鎮,北寧里,0,1,520,6,526,701,0,0,0,0,0,0,75.04
臺中縣,清水鎮,中興里,0,1,332,7,339,465,0,0,0,0,0,0,72.90
臺中縣,清水鎮,西社里,0,1,1737,27,1764,2342,0,0,0,0,0,0,75.32
臺中縣,清水鎮,南社里,0,1,2713,36,2749,3762,0,0,0,0,0,0,73.07
臺中縣,清水鎮,裕嘉里,0,1,809,21,830,1092,0,0,0,0,0,0,76.01
臺中縣,清水鎮,臨江里,0,1,1067,22,1089,1370,0,0,0,0,0,0,79.49
臺中縣,清水鎮,秀水里,0,1,2197,43,2240,3066,0,0,0,0,0,0,73.06
臺中縣,清水鎮,武鹿里,0,1,1933,29,1962,2521,0,0,0,0,0,0,77.83
臺中縣,清水鎮,海濱里,0,1,1349,25,1374,1750,0,0,0,0,0,0,78.51
臺中縣,清水鎮,康榔里,0,1,2097,40,2137,3007,0,0,0,0,0,0,71.07
臺中縣,清水鎮,中社里,0,1,1390,22,1412,1934,0,0,0,0,0,0,73.01
臺中縣,清水鎮,高西里,0,1,982,11,993,1274,0,0,0,0,0,0,77.94
臺中縣,清水鎮,高南里,0,1,953,20,973,1243,0,0,0,0,0,0,78.28
臺中縣,清水鎮,高東里,0,1,909,30,939,1253,0,0,0,0,0,0,74.94
臺中縣,清水鎮,高北里,0,1,757,15,772,987,0,0,0,0,0,0,78.22
臺中縣,清水鎮,高美里,0,1,981,14,995,1232,0,0,0,0,0,0,80.76
臺中縣,清水鎮,國姓里,0,1,1314,17,1331,1922,0,0,0,0,0,0,69.25
臺中縣,清水鎮,菁埔里,0,1,1555,23,1578,2079,0,0,0,0,0,0,75.90
臺中縣,清水鎮,頂湳里,0,1,1254,20,1274,1707,0,0,0,0,0,0,74.63
臺中縣,清水鎮,田寮里,0,1,1368,23,1391,2006,0,0,0,0,0,0,69.34
臺中縣,清水鎮,橋頭里,0,1,3503,72,3575,4978,0,0,0,0,0,0,71.82
臺中縣,清水鎮,下湳里,0,1,2067,28,2095,2861,0,0,0,0,0,0,73.23
臺中縣,清水鎮,東山里,0,1,835,23,858,1085,0,0,0,0,0,0,79.08
臺中縣,清水鎮,吳厝里,0,1,865,17,882,1101,0,0,0,0,0,0,80.11
臺中縣,清水鎮,楊厝里,0,1,770,5,775,964,0,0,0,0,0,0,80.39
臺中縣,清水鎮,海風里,0,1,833,14,847,1132,0,0,0,0,0,0,74.82
臺中縣,沙鹿鎮,居仁里,0,1,1032,12,1044,1328,0,0,0,0,0,0,78.61
臺中縣,沙鹿鎮,洛泉里,0,1,1732,20,1752,2236,0,0,0,0,0,0,78.35
臺中縣,沙鹿鎮,沙鹿里,0,1,843,16,859,1152,0,0,0,0,0,0,74.57
臺中縣,沙鹿鎮,美仁里,0,1,451,9,460,578,0,0,0,0,0,0,79.58
臺中縣,沙鹿鎮,興仁里,0,1,1597,26,1623,2189,0,0,0,0,0,0,74.14
臺中縣,沙鹿鎮,興安里,0,1,1764,28,1792,2437,0,0,0,0,0,0,73.53
臺中縣,沙鹿鎮,斗抵里,0,1,2528,45,2573,3325,0,0,0,0,0,0,77.38
臺中縣,沙鹿鎮,鹿峰里,0,1,2661,38,2699,3471,0,0,0,0,0,0,77.76
臺中縣,沙鹿鎮,鹿寮里,0,1,3395,37,3432,4638,0,0,0,0,0,0,74.00
臺中縣,沙鹿鎮,竹林里,0,1,3386,60,3446,4792,0,0,0,0,0,0,71.91
臺中縣,沙鹿鎮,犁分里,0,1,650,14,664,831,0,0,0,0,0,0,79.90
臺中縣,沙鹿鎮,福興里,0,1,1397,20,1417,1961,0,0,0,0,0,0,72.26
臺中縣,沙鹿鎮,北勢里,0,1,2031,41,2072,2798,0,0,0,0,0,0,74.05
臺中縣,沙鹿鎮,晉江里,0,1,889,10,899,1129,0,0,0,0,0,0,79.63
臺中縣,沙鹿鎮,六路里,0,1,1060,24,1084,1528,0,0,0,0,0,0,70.94
臺中縣,沙鹿鎮,南勢里,0,1,1210,16,1226,1580,0,0,0,0,0,0,77.59
臺中縣,沙鹿鎮,埔子里,0,1,2288,57,2345,3259,0,0,0,0,0,0,71.95
臺中縣,沙鹿鎮,公明里,0,1,2452,41,2493,3315,0,0,0,0,0,0,75.20
臺中縣,沙鹿鎮,清泉里,0,1,1217,27,1244,1594,0,0,0,0,0,0,78.04
臺中縣,沙鹿鎮,西勢里,0,1,1481,37,1518,1952,0,0,0,0,0,0,77.77
臺中縣,梧棲鎮,頂寮里,0,1,1533,19,1552,2148,0,0,0,0,0,0,72.25
臺中縣,梧棲鎮,下寮里,0,1,1439,32,1471,1972,0,0,0,0,0,0,74.59
臺中縣,梧棲鎮,中正里,0,1,2127,26,2153,3026,0,0,0,0,0,0,71.15
臺中縣,梧棲鎮,中和里,0,1,391,8,399,540,0,0,0,0,0,0,73.89
臺中縣,梧棲鎮,文化里,0,1,813,16,829,1101,0,0,0,0,0,0,75.30
臺中縣,梧棲鎮,安仁里,0,1,522,5,527,719,0,0,0,0,0,0,73.30
臺中縣,梧棲鎮,草湳里,0,1,3093,64,3157,4356,0,0,0,0,0,0,72.47
臺中縣,梧棲鎮,南簡里,0,1,1469,26,1495,2038,0,0,0,0,0,0,73.36
臺中縣,梧棲鎮,福德里,0,1,1693,32,1725,2349,0,0,0,0,0,0,73.44
臺中縣,梧棲鎮,大庄里,0,1,3133,63,3196,4381,0,0,0,0,0,0,72.95
臺中縣,梧棲鎮,大村里,0,1,2237,40,2277,3081,0,0,0,0,0,0,73.90
臺中縣,梧棲鎮,興農里,0,1,1266,22,1288,1642,0,0,0,0,0,0,78.44
臺中縣,梧棲鎮,永寧里,0,1,1452,31,1483,1926,0,0,0,0,0,0,77.00
臺中縣,梧棲鎮,永安里,0,1,1561,25,1586,1996,0,0,0,0,0,0,79.46
臺中縣,后里鄉,廣福村,0,1,1359,22,1381,1813,0,0,0,0,0,0,76.17
臺中縣,后里鄉,仁里村,0,1,1744,41,1785,2282,0,0,0,0,0,0,78.22
臺中縣,后里鄉,義里村,0,1,3420,83,3503,4820,0,0,0,0,0,0,72.68
臺中縣,后里鄉,后里村,0,1,2424,45,2469,3141,0,0,0,0,0,0,78.61
臺中縣,后里鄉,厚里村,0,1,1292,21,1313,1693,0,0,0,0,0,0,77.55
臺中縣,后里鄉,墩東村,0,1,2688,57,2745,3639,0,0,0,0,0,0,75.43
臺中縣,后里鄉,墩西村,0,1,1424,24,1448,1795,0,0,0,0,0,0,80.67
臺中縣,后里鄉,墩南村,0,1,1756,41,1797,2271,0,0,0,0,0,0,79.13
臺中縣,后里鄉,墩北村,0,1,2020,24,2044,2636,0,0,0,0,0,0,77.54
臺中縣,后里鄉,中和村,0,1,1398,38,1436,1765,0,0,0,0,0,0,81.36
臺中縣,后里鄉,舊社村,0,1,909,27,936,1151,0,0,0,0,0,0,81.32
臺中縣,后里鄉,聯合村,0,1,1124,35,1159,1423,0,0,0,0,0,0,81.45
臺中縣,后里鄉,太平村,0,1,1449,40,1489,1820,0,0,0,0,0,0,81.81
臺中縣,后里鄉,眉山村,0,1,1659,34,1693,2192,0,0,0,0,0,0,77.24
臺中縣,后里鄉,樂業村,0,1,261,6,267,329,0,0,0,0,0,0,81.16
臺中縣,后里鄉,月眉村,0,1,1169,20,1189,1477,0,0,0,0,0,0,80.50
臺中縣,后里鄉,公館村,0,1,1255,32,1287,1682,0,0,0,0,0,0,76.52
臺中縣,后里鄉,泰安村,0,1,928,19,947,1197,0,0,0,0,0,0,79.11
臺中縣,神岡鄉,神岡村,0,1,1509,29,1538,2209,0,0,0,0,0,0,69.62
臺中縣,神岡鄉,庄前村,0,1,1001,22,1023,1374,0,0,0,0,0,0,74.45
臺中縣,神岡鄉,北庄村,0,1,1362,25,1387,1927,0,0,0,0,0,0,71.98
臺中縣,神岡鄉,庄後村,0,1,1341,25,1366,1821,0,0,0,0,0,0,75.01
臺中縣,神岡鄉,圳前村,0,1,1461,34,1495,2050,0,0,0,0,0,0,72.93
臺中縣,神岡鄉,圳堵村,0,1,1520,31,1551,1918,0,0,0,0,0,0,80.87
臺中縣,神岡鄉,新庄村,0,1,2459,35,2494,3298,0,0,0,0,0,0,75.62
臺中縣,神岡鄉,山皮村,0,1,660,10,670,873,0,0,0,0,0,0,76.75
臺中縣,神岡鄉,社口村,0,1,3367,57,3424,4520,0,0,0,0,0,0,75.75
臺中縣,神岡鄉,社南村,0,1,2285,65,2350,3373,0,0,0,0,0,0,69.67
臺中縣,神岡鄉,三角村,0,1,1325,20,1345,1928,0,0,0,0,0,0,69.76
臺中縣,神岡鄉,大社村,0,1,1622,32,1654,2414,0,0,0,0,0,0,68.52
臺中縣,神岡鄉,岸裡村,0,1,1545,26,1571,2179,0,0,0,0,0,0,72.10
臺中縣,神岡鄉,豐洲村,0,1,3822,83,3905,5609,0,0,0,0,0,0,69.62
臺中縣,神岡鄉,神洲村,0,1,1573,28,1601,2097,0,0,0,0,0,0,76.35
臺中縣,神岡鄉,溪洲村,0,1,1781,46,1827,2264,0,0,0,0,0,0,80.70
臺中縣,潭子鄉,潭秀村,0,1,975,18,993,1412,0,0,0,0,0,0,70.33
臺中縣,潭子鄉,潭北村,0,1,1271,18,1289,1969,0,0,0,0,0,0,65.46
臺中縣,潭子鄉,潭陽村,0,1,4700,99,4799,7383,0,0,0,0,0,0,65.00
臺中縣,潭子鄉,福仁村,0,1,3440,66,3506,5719,0,0,0,0,0,0,61.30
臺中縣,潭子鄉,頭家村,0,1,6632,113,6745,10916,0,0,0,0,0,0,61.79
臺中縣,潭子鄉,甘蔗村,0,1,3015,42,3057,4729,0,0,0,0,0,0,64.64
臺中縣,潭子鄉,東寶村,0,1,5169,97,5266,7600,0,0,0,0,0,0,69.29
臺中縣,潭子鄉,大富村,0,1,1013,13,1026,1296,0,0,0,0,0,0,79.17
臺中縣,潭子鄉,大豐村,0,1,1700,25,1725,2461,0,0,0,0,0,0,70.09
臺中縣,潭子鄉,栗林村,0,1,2771,52,2823,3822,0,0,0,0,0,0,73.86
臺中縣,潭子鄉,嘉仁村,0,1,2195,41,2236,3084,0,0,0,0,0,0,72.50
臺中縣,潭子鄉,新田村,0,1,965,11,976,1424,0,0,0,0,0,0,68.54
臺中縣,潭子鄉,聚興村,0,1,1744,26,1770,2709,0,0,0,0,0,0,65.34
臺中縣,大雅鄉,上雅村,0,1,2212,45,2257,3168,0,0,0,0,0,0,71.24
臺中縣,大雅鄉,大雅村,0,1,2435,60,2495,3455,0,0,0,0,0,0,72.21
臺中縣,大雅鄉,文雅村,0,1,2620,50,2670,3865,0,0,0,0,0,0,69.08
臺中縣,大雅鄉,三和村,0,1,1996,47,2043,2854,0,0,0,0,0,0,71.58
臺中縣,大雅鄉,二和村,0,1,1934,29,1963,2761,0,0,0,0,0,0,71.10
臺中縣,大雅鄉,四德村,0,1,1668,30,1698,2490,0,0,0,0,0,0,68.19
臺中縣,大雅鄉,西寶村,0,1,1853,44,1897,2596,0,0,0,0,0,0,73.07
臺中縣,大雅鄉,上楓村,0,1,5490,135,5625,8259,0,0,0,0,0,0,68.11
臺中縣,大雅鄉,員林村,0,1,3490,108,3598,4848,0,0,0,0,0,0,74.22
臺中縣,大雅鄉,六寶村,0,1,3486,84,3570,4866,0,0,0,0,0,0,73.37
臺中縣,大雅鄉,秀山村,0,1,1936,32,1968,2471,0,0,0,0,0,0,79.64
臺中縣,大雅鄉,橫山村,0,1,2095,37,2132,2786,0,0,0,0,0,0,76.53
臺中縣,大雅鄉,忠義村,0,1,2167,50,2217,3207,0,0,0,0,0,0,69.13
臺中縣,新社鄉,新社村,0,1,1905,39,1944,2481,0,0,0,0,0,0,78.36
臺中縣,新社鄉,復盛村,0,1,1255,22,1277,1647,0,0,0,0,0,0,77.53
臺中縣,新社鄉,中正村,0,1,952,11,963,1223,0,0,0,0,0,0,78.74
臺中縣,新社鄉,月湖村,0,1,699,14,713,913,0,0,0,0,0,0,78.09
臺中縣,新社鄉,崑山村,0,1,910,21,931,1220,0,0,0,0,0,0,76.31
臺中縣,新社鄉,大南村,0,1,1513,24,1537,1955,0,0,0,0,0,0,78.62
臺中縣,新社鄉,永源村,0,1,1951,54,2005,2481,0,0,0,0,0,0,80.81
臺中縣,新社鄉,中興村,0,1,628,9,637,818,0,0,0,0,0,0,77.87
臺中縣,新社鄉,協成村,0,1,1928,30,1958,2507,0,0,0,0,0,0,78.10
臺中縣,新社鄉,東興村,0,1,1026,5,1031,1272,0,0,0,0,0,0,81.05
臺中縣,新社鄉,慶西村,0,1,711,8,719,909,0,0,0,0,0,0,79.10
臺中縣,新社鄉,中和村,0,1,452,8,460,618,0,0,0,0,0,0,74.43
臺中縣,新社鄉,福興村,0,1,958,20,978,1343,0,0,0,0,0,0,72.82
臺中縣,石岡鄉,石岡村,0,1,673,10,683,919,0,0,0,0,0,0,74.32
臺中縣,石岡鄉,萬安村,0,1,853,14,867,1099,0,0,0,0,0,0,78.89
臺中縣,石岡鄉,九房村,0,1,727,24,751,957,0,0,0,0,0,0,78.47
臺中縣,石岡鄉,金星村,0,1,770,13,783,1102,0,0,0,0,0,0,71.05
臺中縣,石岡鄉,龍興村,0,1,514,4,518,647,0,0,0,0,0,0,80.06
臺中縣,石岡鄉,萬興村,0,1,970,15,985,1226,0,0,0,0,0,0,80.34
臺中縣,石岡鄉,梅子村,0,1,1239,21,1260,1651,0,0,0,0,0,0,76.32
臺中縣,石岡鄉,土牛村,0,1,717,15,732,952,0,0,0,0,0,0,76.89
臺中縣,石岡鄉,德興村,0,1,975,20,995,1303,0,0,0,0,0,0,76.36
臺中縣,石岡鄉,和盛村,0,1,968,24,992,1309,0,0,0,0,0,0,75.78
臺中縣,外埔鄉,永豐村,0,1,785,10,795,945,0,0,0,0,0,0,84.13
臺中縣,外埔鄉,六分村,0,1,1032,25,1057,1347,0,0,0,0,0,0,78.47
臺中縣,外埔鄉,三崁村,0,1,1255,27,1282,1599,0,0,0,0,0,0,80.18
臺中縣,外埔鄉,大同村,0,1,2608,24,2632,3257,0,0,0,0,0,0,80.81
臺中縣,外埔鄉,水美村,0,1,1827,33,1860,2355,0,0,0,0,0,0,78.98
臺中縣,外埔鄉,大東村,0,1,2998,74,3072,4048,0,0,0,0,0,0,75.89
臺中縣,外埔鄉,馬鳴村,0,1,1004,21,1025,1281,0,0,0,0,0,0,80.02
臺中縣,外埔鄉,中山村,0,1,777,10,787,932,0,0,0,0,0,0,84.44
臺中縣,外埔鄉,鐵山村,0,1,1534,24,1558,1927,0,0,0,0,0,0,80.85
臺中縣,外埔鄉,土城村,0,1,1198,22,1220,1440,0,0,0,0,0,0,84.72
臺中縣,外埔鄉,部子村,0,1,900,16,916,1109,0,0,0,0,0,0,82.60
臺中縣,大安鄉,南埔村,0,1,830,14,844,1040,0,0,0,0,0,0,81.15
臺中縣,大安鄉,南庄村,0,1,894,11,905,1126,0,0,0,0,0,0,80.37
臺中縣,大安鄉,中庄村,0,1,1636,30,1666,2199,0,0,0,0,0,0,75.76
臺中縣,大安鄉,東安村,0,1,967,9,976,1180,0,0,0,0,0,0,82.71
臺中縣,大安鄉,福興村,0,1,817,16,833,1054,0,0,0,0,0,0,79.03
臺中縣,大安鄉,龜殼村,0,1,1237,19,1256,1557,0,0,0,0,0,0,80.67
臺中縣,大安鄉,頂安村,0,1,623,4,627,832,0,0,0,0,0,0,75.36
臺中縣,大安鄉,永安村,0,1,1195,11,1206,1542,0,0,0,0,0,0,78.21
臺中縣,大安鄉,福住村,0,1,729,15,744,961,0,0,0,0,0,0,77.42
臺中縣,大安鄉,海墘村,0,1,1032,14,1046,1332,0,0,0,0,0,0,78.53
臺中縣,大安鄉,西安村,0,1,910,12,922,1249,0,0,0,0,0,0,73.82
臺中縣,大安鄉,松雅村,0,1,562,12,574,686,0,0,0,0,0,0,83.67
臺中縣,烏日鄉,烏日村,0,1,3526,58,3584,4910,0,0,0,0,0,0,72.99
臺中縣,烏日鄉,湖日村,0,1,1500,24,1524,2231,0,0,0,0,0,0,68.31
臺中縣,烏日鄉,三和村,0,1,2545,72,2617,3651,0,0,0,0,0,0,71.68
臺中縣,烏日鄉,榮泉村,0,1,1962,36,1998,2559,0,0,0,0,0,0,78.08
臺中縣,烏日鄉,學田村,0,1,1464,34,1498,1975,0,0,0,0,0,0,75.85
臺中縣,烏日鄉,九德村,0,1,5042,99,5141,8012,0,0,0,0,0,0,64.17
臺中縣,烏日鄉,仁德村,0,1,2801,54,2855,4220,0,0,0,0,0,0,67.65
臺中縣,烏日鄉,前竹村,0,1,1407,29,1436,1939,0,0,0,0,0,0,74.06
臺中縣,烏日鄉,五光村,0,1,1042,17,1059,1368,0,0,0,0,0,0,77.41
臺中縣,烏日鄉,光明村,0,1,1408,16,1424,1935,0,0,0,0,0,0,73.59
臺中縣,烏日鄉,東園村,0,1,1111,6,1117,1450,0,0,0,0,0,0,77.03
臺中縣,烏日鄉,溪埧村,0,1,2306,34,2340,3148,0,0,0,0,0,0,74.33
臺中縣,烏日鄉,螺潭村,0,1,1052,17,1069,1409,0,0,0,0,0,0,75.87
臺中縣,烏日鄉,北里村,0,1,883,22,905,1207,0,0,0,0,0,0,74.98
臺中縣,烏日鄉,南里村,0,1,732,21,753,973,0,0,0,0,0,0,77.39
臺中縣,烏日鄉,溪尾村,0,1,569,22,591,797,0,0,0,0,0,0,74.15
臺中縣,大肚鄉,王田村,0,1,2351,64,2415,3288,0,0,0,0,0,0,73.45
臺中縣,大肚鄉,中和村,0,1,624,9,633,740,0,0,0,0,0,0,85.54
臺中縣,大肚鄉,福山村,0,1,2217,37,2254,2934,0,0,0,0,0,0,76.82
臺中縣,大肚鄉,營埔村,0,1,965,20,985,1191,0,0,0,0,0,0,82.70
臺中縣,大肚鄉,社腳村,0,1,1568,39,1607,2047,0,0,0,0,0,0,78.51
臺中縣,大肚鄉,新興村,0,1,1389,31,1420,1932,0,0,0,0,0,0,73.50
臺中縣,大肚鄉,大東村,0,1,1784,24,1808,2323,0,0,0,0,0,0,77.83
臺中縣,大肚鄉,大肚村,0,1,1290,19,1309,1729,0,0,0,0,0,0,75.71
臺中縣,大肚鄉,永和村,0,1,650,14,664,820,0,0,0,0,0,0,80.98
臺中縣,大肚鄉,磺溪村,0,1,1007,19,1026,1225,0,0,0,0,0,0,83.76
臺中縣,大肚鄉,永順村,0,1,1160,19,1179,1461,0,0,0,0,0,0,80.70
臺中縣,大肚鄉,成功村,0,1,693,5,698,798,0,0,0,0,0,0,87.47
臺中縣,大肚鄉,山陽村,0,1,1021,37,1058,1316,0,0,0,0,0,0,80.40
臺中縣,大肚鄉,頂街村,0,1,2551,47,2598,3497,0,0,0,0,0,0,74.29
臺中縣,大肚鄉,瑞井村,0,1,2324,54,2378,3391,0,0,0,0,0,0,70.13
臺中縣,大肚鄉,蔗部村,0,1,3802,84,3886,5717,0,0,0,0,0,0,67.97
臺中縣,龍井鄉,竹坑村,0,1,1360,20,1380,1766,0,0,0,0,0,0,78.14
臺中縣,龍井鄉,龍東村,0,1,1550,29,1579,2029,0,0,0,0,0,0,77.82
臺中縣,龍井鄉,龍西村,0,1,1088,15,1103,1357,0,0,0,0,0,0,81.28
臺中縣,龍井鄉,田中村,0,1,1665,33,1698,2193,0,0,0,0,0,0,77.43
臺中縣,龍井鄉,福田村,0,1,692,16,708,943,0,0,0,0,0,0,75.08
臺中縣,龍井鄉,麗水村,0,1,1547,16,1563,1822,0,0,0,0,0,0,85.78
臺中縣,龍井鄉,龍津村,0,1,2968,51,3019,3861,0,0,0,0,0,0,78.19
臺中縣,龍井鄉,三德村,0,1,1659,22,1681,2139,0,0,0,0,0,0,78.59
臺中縣,龍井鄉,忠和村,0,1,2507,47,2554,3337,0,0,0,0,0,0,76.54
臺中縣,龍井鄉,山腳村,0,1,2335,41,2376,3149,0,0,0,0,0,0,75.45
臺中縣,龍井鄉,龍泉村,0,1,2607,58,2665,3650,0,0,0,0,0,0,73.01
臺中縣,龍井鄉,龍崗村,0,1,1252,23,1275,1702,0,0,0,0,0,0,74.91
臺中縣,龍井鄉,新庄村,0,1,2519,42,2561,3770,0,0,0,0,0,0,67.93
臺中縣,龍井鄉,南寮村,0,1,896,10,906,1236,0,0,0,0,0,0,73.30
臺中縣,龍井鄉,東海村,0,1,2492,51,2543,4321,0,0,0,0,0,0,58.85
臺中縣,龍井鄉,新東村,0,1,1766,47,1813,2761,0,0,0,0,0,0,65.66
臺中縣,霧峰鄉,桐林村,0,1,824,10,834,1138,0,0,0,0,0,0,73.29
臺中縣,霧峰鄉,吉峰村,0,1,4306,77,4383,6490,0,0,0,0,0,0,67.53
臺中縣,霧峰鄉,甲寅村,0,1,2777,56,2833,4152,0,0,0,0,0,0,68.23
臺中縣,霧峰鄉,本鄉村,0,1,1231,29,1260,1838,0,0,0,0,0,0,68.55
臺中縣,霧峰鄉,中正村,0,1,1183,24,1207,1649,0,0,0,0,0,0,73.20
臺中縣,霧峰鄉,錦榮村,0,1,650,20,670,920,0,0,0,0,0,0,72.83
臺中縣,霧峰鄉,萊園村,0,1,774,21,795,1120,0,0,0,0,0,0,70.98
臺中縣,霧峰鄉,本堂村,0,1,3426,75,3501,5084,0,0,0,0,0,0,68.86
臺中縣,霧峰鄉,北柳村,0,1,1996,28,2024,2731,0,0,0,0,0,0,74.11
臺中縣,霧峰鄉,南柳村,0,1,985,15,1000,1259,0,0,0,0,0,0,79.43
臺中縣,霧峰鄉,四德村,0,1,1440,26,1466,1919,0,0,0,0,0,0,76.39
臺中縣,霧峰鄉,五福村,0,1,1717,34,1751,2205,0,0,0,0,0,0,79.41
臺中縣,霧峰鄉,丁台村,0,1,1329,21,1350,1708,0,0,0,0,0,0,79.04
臺中縣,霧峰鄉,北勢村,0,1,1129,26,1155,1446,0,0,0,0,0,0,79.88
臺中縣,霧峰鄉,南勢村,0,1,795,12,807,1054,0,0,0,0,0,0,76.57
臺中縣,霧峰鄉,萬豐村,0,1,1750,37,1787,2472,0,0,0,0,0,0,72.29
臺中縣,霧峰鄉,舊正村,0,1,1444,22,1466,1961,0,0,0,0,0,0,74.76
臺中縣,霧峰鄉,坑口村,0,1,2104,48,2152,2922,0,0,0,0,0,0,73.65
臺中縣,霧峰鄉,峰谷村,0,1,741,16,757,1061,0,0,0,0,0,0,71.35
臺中縣,霧峰鄉,六股村,0,1,1540,30,1570,2036,0,0,0,0,0,0,77.11
臺中縣,太平市,太平里,0,1,3301,70,3371,4803,0,0,0,0,0,0,70.19
臺中縣,太平市,長億里,0,1,4163,106,4269,6510,0,0,0,0,0,0,65.58
臺中縣,太平市,中平里,0,1,3565,84,3649,5714,0,0,0,0,0,0,63.86
臺中縣,太平市,中興里,0,1,3585,55,3640,5625,0,0,0,0,0,0,64.71
臺中縣,太平市,東平里,0,1,5652,120,5772,8055,0,0,0,0,0,0,71.66
臺中縣,太平市,建國里,0,1,2742,62,2804,4350,0,0,0,0,0,0,64.46
臺中縣,太平市,坪林里,0,1,4881,91,4972,7098,0,0,0,0,0,0,70.05
臺中縣,太平市,光華里,0,1,4227,102,4329,6704,0,0,0,0,0,0,64.57
臺中縣,太平市,中山里,0,1,3800,88,3888,5905,0,0,0,0,0,0,65.84
臺中縣,太平市,宜欣里,0,1,6250,133,6383,10651,0,0,0,0,0,0,59.93
臺中縣,太平市,新坪里,0,1,5241,120,5361,9081,0,0,0,0,0,0,59.04
臺中縣,太平市,新光里,0,1,4298,101,4399,7234,0,0,0,0,0,0,60.81
臺中縣,太平市,新福里,0,1,2298,43,2341,3519,0,0,0,0,0,0,66.52
臺中縣,太平市,頭汴里,0,1,2435,47,2482,3531,0,0,0,0,0,0,70.29
臺中縣,太平市,東汴里,0,1,898,11,909,1238,0,0,0,0,0,0,73.42
臺中縣,太平市,興隆里,0,1,3439,89,3528,5082,0,0,0,0,0,0,69.42
臺中縣,太平市,黃竹里,0,1,685,7,692,895,0,0,0,0,0,0,77.32
臺中縣,太平市,光隆里,0,1,2885,51,2936,4241,0,0,0,0,0,0,69.23
臺中縣,太平市,德隆里,0,1,1914,41,1955,2999,0,0,0,0,0,0,65.19
臺中縣,大里市,大里里,0,1,1840,37,1877,2547,0,0,0,0,0,0,73.69
臺中縣,大里市,新里里,0,1,4354,71,4425,6639,0,0,0,0,0,0,66.65
臺中縣,大里市,樹王里,0,1,1832,37,1869,2539,0,0,0,0,0,0,73.61
臺中縣,大里市,祥興里,0,1,3081,64,3145,5175,0,0,0,0,0,0,60.77
臺中縣,大里市,內新里,0,1,4787,83,4870,8199,0,0,0,0,0,0,59.40
臺中縣,大里市,東昇里,0,1,1635,46,1681,2557,0,0,0,0,0,0,65.74
臺中縣,大里市,大元里,0,1,2053,41,2094,2949,0,0,0,0,0,0,71.01
臺中縣,大里市,西湖里,0,1,1233,18,1251,1713,0,0,0,0,0,0,73.03
臺中縣,大里市,夏田里,0,1,720,12,732,944,0,0,0,0,0,0,77.54
臺中縣,大里市,仁化里,0,1,5106,104,5210,8149,0,0,0,0,0,0,63.93
臺中縣,大里市,健民里,0,1,2611,52,2663,3886,0,0,0,0,0,0,68.53
臺中縣,大里市,塗城里,0,1,3708,73,3781,5718,0,0,0,0,0,0,66.12
臺中縣,大里市,東湖里,0,1,3497,69,3566,5870,0,0,0,0,0,0,60.75
臺中縣,大里市,東興里,0,1,5113,89,5202,7997,0,0,0,0,0,0,65.05
臺中縣,大里市,日新里,0,1,1864,54,1918,2939,0,0,0,0,0,0,65.26
臺中縣,大里市,西榮里,0,1,6319,111,6430,10259,0,0,0,0,0,0,62.68
臺中縣,大里市,金城里,0,1,5231,88,5319,7957,0,0,0,0,0,0,66.85
臺中縣,大里市,立仁里,0,1,3929,83,4012,6546,0,0,0,0,0,0,61.29
臺中縣,大里市,新仁里,0,1,3344,67,3411,5355,0,0,0,0,0,0,63.70
臺中縣,大里市,瑞城里,0,1,4703,89,4792,7216,0,0,0,0,0,0,66.41
臺中縣,和平鄉,南勢村,0,1,955,7,962,1370,0,0,0,0,0,0,70.22
臺中縣,和平鄉,天輪村,0,1,292,3,295,436,0,0,0,0,0,0,67.66
臺中縣,和平鄉,博愛村,0,1,702,9,711,1089,0,0,0,0,0,0,65.29
臺中縣,和平鄉,自由村,0,1,345,9,354,491,0,0,0,0,0,0,72.10
臺中縣,和平鄉,達觀村,0,1,303,5,308,468,0,0,0,0,0,0,65.81
臺中縣,和平鄉,中坑村,0,1,192,3,195,256,0,0,0,0,0,0,76.17
臺中縣,和平鄉,梨山村,0,1,727,15,742,1414,0,0,0,0,0,0,52.48
臺中縣,和平鄉,平等村,0,1,225,3,228,405,0,0,0,0,0,0,56.30
彰化縣,彰化市,桃源里,0,1,2018,43,2061,2780,0,0,0,0,0,0,74.14
彰化縣,彰化市,卦山里,0,1,1566,31,1597,2170,0,0,0,0,0,0,73.59
彰化縣,彰化市,東興里,0,1,1119,17,1136,1490,0,0,0,0,0,0,76.24
彰化縣,彰化市,華北里,0,1,1176,20,1196,1590,0,0,0,0,0,0,75.22
彰化縣,彰化市,華陽里,0,1,1557,25,1582,2101,0,0,0,0,0,0,75.30
彰化縣,彰化市,建寶里,0,1,1774,21,1795,2357,0,0,0,0,0,0,76.16
彰化縣,彰化市,光南里,0,1,1028,20,1048,1318,0,0,0,0,0,0,79.51
彰化縣,彰化市,介壽里,0,1,1387,20,1407,1878,0,0,0,0,0,0,74.92
彰化縣,彰化市,延平里,0,1,3425,52,3477,4831,0,0,0,0,0,0,71.97
彰化縣,彰化市,延和里,0,1,2299,49,2348,3017,0,0,0,0,0,0,77.83
彰化縣,彰化市,南興里,0,1,3095,60,3155,4258,0,0,0,0,0,0,74.10
彰化縣,彰化市,南瑤里,0,1,4304,67,4371,5869,0,0,0,0,0,0,74.48
彰化縣,彰化市,成功里,0,1,1063,14,1077,1419,0,0,0,0,0,0,75.90
彰化縣,彰化市,大同里,0,1,886,10,896,1177,0,0,0,0,0,0,76.13
彰化縣,彰化市,永生里,0,1,1128,18,1146,1467,0,0,0,0,0,0,78.12
彰化縣,彰化市,福安里,0,1,828,16,844,1080,0,0,0,0,0,0,78.15
彰化縣,彰化市,西安里,0,1,1755,24,1779,2413,0,0,0,0,0,0,73.73
彰化縣,彰化市,彰安里,0,1,2187,32,2219,2926,0,0,0,0,0,0,75.84
彰化縣,彰化市,中央里,0,1,700,10,710,927,0,0,0,0,0,0,76.59
彰化縣,彰化市,富貴里,0,1,779,22,801,1044,0,0,0,0,0,0,76.72
彰化縣,彰化市,民權里,0,1,973,16,989,1278,0,0,0,0,0,0,77.39
彰化縣,彰化市,長樂里,0,1,949,16,965,1264,0,0,0,0,0,0,76.34
彰化縣,彰化市,萬壽里,0,1,772,10,782,1015,0,0,0,0,0,0,77.04
彰化縣,彰化市,西興里,0,1,1461,28,1489,2017,0,0,0,0,0,0,73.82
彰化縣,彰化市,平和里,0,1,2333,31,2364,3190,0,0,0,0,0,0,74.11
彰化縣,彰化市,崙平里,0,1,2806,57,2863,3836,0,0,0,0,0,0,74.64
彰化縣,彰化市,向陽里,0,1,1482,19,1501,1967,0,0,0,0,0,0,76.31
彰化縣,彰化市,莿桐里,0,1,1633,21,1654,2141,0,0,0,0,0,0,77.25
彰化縣,彰化市,南美里,0,1,1115,17,1132,1394,0,0,0,0,0,0,81.21
彰化縣,彰化市,南安里,0,1,1278,25,1303,1560,0,0,0,0,0,0,83.53
彰化縣,彰化市,東芳里,0,1,2025,21,2046,2556,0,0,0,0,0,0,80.05
彰化縣,彰化市,磚窯里,0,1,1896,41,1937,2439,0,0,0,0,0,0,79.42
彰化縣,彰化市,西勢里,0,1,1688,32,1720,2232,0,0,0,0,0,0,77.06
彰化縣,彰化市,忠權里,0,1,1673,33,1706,2268,0,0,0,0,0,0,75.22
彰化縣,彰化市,忠孝里,0,1,842,14,856,1161,0,0,0,0,0,0,73.73
彰化縣,彰化市,五權里,0,1,1957,46,2003,2866,0,0,0,0,0,0,69.89
彰化縣,彰化市,新興里,0,1,2664,43,2707,3616,0,0,0,0,0,0,74.86
彰化縣,彰化市,新華里,0,1,1379,33,1412,1824,0,0,0,0,0,0,77.41
彰化縣,彰化市,興北里,0,1,1048,12,1060,1440,0,0,0,0,0,0,73.61
彰化縣,彰化市,信義里,0,1,716,13,729,965,0,0,0,0,0,0,75.54
彰化縣,彰化市,民生里,0,1,1011,19,1030,1379,0,0,0,0,0,0,74.69
彰化縣,彰化市,光復里,0,1,605,8,613,797,0,0,0,0,0,0,76.91
彰化縣,彰化市,永福里,0,1,764,8,772,979,0,0,0,0,0,0,78.86
彰化縣,彰化市,光華里,0,1,688,10,698,920,0,0,0,0,0,0,75.87
彰化縣,彰化市,中正里,0,1,973,6,979,1314,0,0,0,0,0,0,74.51
彰化縣,彰化市,中山里,0,1,623,13,636,827,0,0,0,0,0,0,76.90
彰化縣,彰化市,龍山里,0,1,1581,19,1600,2116,0,0,0,0,0,0,75.61
彰化縣,彰化市,文化里,0,1,1060,14,1074,1427,0,0,0,0,0,0,75.26
彰化縣,彰化市,陽明里,0,1,1317,30,1347,1812,0,0,0,0,0,0,74.34
彰化縣,彰化市,萬安里,0,1,2479,41,2520,3383,0,0,0,0,0,0,74.49
彰化縣,彰化市,下部里,0,1,2464,45,2509,3141,0,0,0,0,0,0,79.88
彰化縣,彰化市,茄苳里,0,1,639,14,653,748,0,0,0,0,0,0,87.30
彰化縣,彰化市,茄南里,0,1,1528,25,1553,1911,0,0,0,0,0,0,81.27
彰化縣,彰化市,寶部里,0,1,825,15,840,1006,0,0,0,0,0,0,83.50
彰化縣,彰化市,古夷里,0,1,1535,25,1560,1968,0,0,0,0,0,0,79.27
彰化縣,彰化市,阿夷里,0,1,3014,64,3078,3969,0,0,0,0,0,0,77.55
彰化縣,彰化市,和調里,0,1,1509,28,1537,2126,0,0,0,0,0,0,72.30
彰化縣,彰化市,復興里,0,1,2683,48,2731,3695,0,0,0,0,0,0,73.91
彰化縣,彰化市,中庄里,0,1,1370,27,1397,1880,0,0,0,0,0,0,74.31
彰化縣,彰化市,國聖里,0,1,1660,23,1683,2150,0,0,0,0,0,0,78.28
彰化縣,彰化市,福山里,0,1,3939,80,4019,5171,0,0,0,0,0,0,77.72
彰化縣,彰化市,安溪里,0,1,647,14,661,816,0,0,0,0,0,0,81.00
彰化縣,彰化市,竹中里,0,1,1127,29,1156,1533,0,0,0,0,0,0,75.41
彰化縣,彰化市,三村里,0,1,801,8,809,953,0,0,0,0,0,0,84.89
彰化縣,彰化市,大竹里,0,1,1734,40,1774,2292,0,0,0,0,0,0,77.40
彰化縣,彰化市,香山里,0,1,1736,29,1765,2228,0,0,0,0,0,0,79.22
彰化縣,彰化市,牛埔里,0,1,1994,27,2021,2572,0,0,0,0,0,0,78.58
彰化縣,彰化市,台鳳里,0,1,2042,36,2078,2854,0,0,0,0,0,0,72.81
彰化縣,彰化市,田中里,0,1,679,7,686,789,0,0,0,0,0,0,86.95
彰化縣,彰化市,快官里,0,1,727,7,734,927,0,0,0,0,0,0,79.18
彰化縣,彰化市,竹巷里,0,1,600,7,607,735,0,0,0,0,0,0,82.59
彰化縣,彰化市,福田里,0,1,864,9,873,1087,0,0,0,0,0,0,80.31
彰化縣,彰化市,石牌里,0,1,833,10,843,1077,0,0,0,0,0,0,78.27
彰化縣,花壇鄉,花壇村,0,1,2045,34,2079,2668,0,0,0,0,0,0,77.92
彰化縣,花壇鄉,金墩村,0,1,1207,16,1223,1521,0,0,0,0,0,0,80.41
彰化縣,花壇鄉,中庄村,0,1,1586,37,1623,2063,0,0,0,0,0,0,78.67
彰化縣,花壇鄉,劉厝村,0,1,800,8,808,974,0,0,0,0,0,0,82.96
彰化縣,花壇鄉,崙雅村,0,1,1030,12,1042,1247,0,0,0,0,0,0,83.56
彰化縣,花壇鄉,南口村,0,1,1050,12,1062,1297,0,0,0,0,0,0,81.88
彰化縣,花壇鄉,中口村,0,1,546,9,555,656,0,0,0,0,0,0,84.60
彰化縣,花壇鄉,北口村,0,1,1238,17,1255,1487,0,0,0,0,0,0,84.40
彰化縣,花壇鄉,長沙村,0,1,2570,39,2609,3323,0,0,0,0,0,0,78.51
彰化縣,花壇鄉,文德村,0,1,1599,24,1623,2022,0,0,0,0,0,0,80.27
彰化縣,花壇鄉,白沙村,0,1,2129,34,2163,2965,0,0,0,0,0,0,72.95
彰化縣,花壇鄉,岩竹村,0,1,999,11,1010,1290,0,0,0,0,0,0,78.29
彰化縣,花壇鄉,橋頭村,0,1,2027,47,2074,2640,0,0,0,0,0,0,78.56
彰化縣,花壇鄉,灣雅村,0,1,634,7,641,794,0,0,0,0,0,0,80.73
彰化縣,花壇鄉,灣東村,0,1,738,9,747,958,0,0,0,0,0,0,77.97
彰化縣,花壇鄉,三春村,0,1,1129,12,1141,1520,0,0,0,0,0,0,75.07
彰化縣,花壇鄉,永春村,0,1,986,17,1003,1317,0,0,0,0,0,0,76.16
彰化縣,花壇鄉,長春村,0,1,1001,12,1013,1306,0,0,0,0,0,0,77.57
彰化縣,芬園鄉,舊社村,0,1,1251,15,1266,1607,0,0,0,0,0,0,78.78
彰化縣,芬園鄉,大埔村,0,1,1001,16,1017,1286,0,0,0,0,0,0,79.08
彰化縣,芬園鄉,竹林村,0,1,1239,17,1256,1538,0,0,0,0,0,0,81.66
彰化縣,芬園鄉,楓坑村,0,1,452,5,457,563,0,0,0,0,0,0,81.17
彰化縣,芬園鄉,社口村,0,1,1563,36,1599,2076,0,0,0,0,0,0,77.02
彰化縣,芬園鄉,茄荖村,0,1,1514,35,1549,2000,0,0,0,0,0,0,77.45
彰化縣,芬園鄉,嘉興村,0,1,1085,22,1107,1388,0,0,0,0,0,0,79.76
彰化縣,芬園鄉,芬園村,0,1,693,10,703,855,0,0,0,0,0,0,82.22
彰化縣,芬園鄉,進芬村,0,1,715,13,728,903,0,0,0,0,0,0,80.62
彰化縣,芬園鄉,縣庄村,0,1,812,11,823,1031,0,0,0,0,0,0,79.83
彰化縣,芬園鄉,圳墘村,0,1,581,8,589,704,0,0,0,0,0,0,83.66
彰化縣,芬園鄉,溪頭村,0,1,1127,14,1141,1441,0,0,0,0,0,0,79.18
彰化縣,芬園鄉,同安村,0,1,940,10,950,1266,0,0,0,0,0,0,75.04
彰化縣,芬園鄉,中崙村,0,1,740,10,750,980,0,0,0,0,0,0,76.53
彰化縣,芬園鄉,大竹村,0,1,780,12,792,1059,0,0,0,0,0,0,74.79
彰化縣,鹿港鎮,大有里,0,1,928,15,943,1184,0,0,0,0,0,0,79.65
彰化縣,鹿港鎮,中興里,0,1,466,4,470,593,0,0,0,0,0,0,79.26
彰化縣,鹿港鎮,洛津里,0,1,861,13,874,1111,0,0,0,0,0,0,78.67
彰化縣,鹿港鎮,順興里,0,1,769,9,778,942,0,0,0,0,0,0,82.59
彰化縣,鹿港鎮,菜園里,0,1,826,8,834,1061,0,0,0,0,0,0,78.61
彰化縣,鹿港鎮,街尾里,0,1,1402,23,1425,1854,0,0,0,0,0,0,76.86
彰化縣,鹿港鎮,泰興里,0,1,938,18,956,1260,0,0,0,0,0,0,75.87
彰化縣,鹿港鎮,長興里,0,1,246,4,250,324,0,0,0,0,0,0,77.16
彰化縣,鹿港鎮,興化里,0,1,579,8,587,727,0,0,0,0,0,0,80.74
彰化縣,鹿港鎮,龍山里,0,1,627,6,633,810,0,0,0,0,0,0,78.15
彰化縣,鹿港鎮,景福里,0,1,914,16,930,1163,0,0,0,0,0,0,79.97
彰化縣,鹿港鎮,郭厝里,0,1,447,2,449,584,0,0,0,0,0,0,76.88
彰化縣,鹿港鎮,新宮里,0,1,770,14,784,971,0,0,0,0,0,0,80.74
彰化縣,鹿港鎮,玉順里,0,1,1023,15,1038,1279,0,0,0,0,0,0,81.16
彰化縣,鹿港鎮,東石里,0,1,2125,32,2157,2783,0,0,0,0,0,0,77.51
彰化縣,鹿港鎮,永安里,0,1,2530,44,2574,3301,0,0,0,0,0,0,77.98
彰化縣,鹿港鎮,埔崙里,0,1,2106,44,2150,2699,0,0,0,0,0,0,79.66
彰化縣,鹿港鎮,頂厝里,0,1,3404,60,3464,4398,0,0,0,0,0,0,78.76
彰化縣,鹿港鎮,東崎里,0,1,2338,40,2378,2996,0,0,0,0,0,0,79.37
彰化縣,鹿港鎮,廖厝里,0,1,2222,37,2259,2782,0,0,0,0,0,0,81.20
彰化縣,鹿港鎮,詔安里,0,1,1160,16,1176,1497,0,0,0,0,0,0,78.56
彰化縣,鹿港鎮,海埔里,0,1,2013,29,2042,2564,0,0,0,0,0,0,79.64
彰化縣,鹿港鎮,洋厝里,0,1,1706,19,1725,2189,0,0,0,0,0,0,78.80
彰化縣,鹿港鎮,草中里,0,1,2151,39,2190,2712,0,0,0,0,0,0,80.75
彰化縣,鹿港鎮,山崙里,0,1,2131,32,2163,2665,0,0,0,0,0,0,81.16
彰化縣,鹿港鎮,頭南里,0,1,1347,23,1370,1648,0,0,0,0,0,0,83.13
彰化縣,鹿港鎮,頭崙里,0,1,1652,25,1677,2020,0,0,0,0,0,0,83.02
彰化縣,鹿港鎮,頂番里,0,1,2282,38,2320,2826,0,0,0,0,0,0,82.09
彰化縣,鹿港鎮,溝墘里,0,1,2437,32,2469,3010,0,0,0,0,0,0,82.03
彰化縣,福興鄉,番婆村,0,1,1473,17,1490,1863,0,0,0,0,0,0,79.98
彰化縣,福興鄉,大崙村,0,1,837,17,854,1063,0,0,0,0,0,0,80.34
彰化縣,福興鄉,外埔村,0,1,756,16,772,939,0,0,0,0,0,0,82.22
彰化縣,福興鄉,三汴村,0,1,892,10,902,1121,0,0,0,0,0,0,80.46
彰化縣,福興鄉,萬豐村,0,1,534,4,538,649,0,0,0,0,0,0,82.90
彰化縣,福興鄉,外中村,0,1,908,7,915,1120,0,0,0,0,0,0,81.70
彰化縣,福興鄉,元中村,0,1,814,18,832,1054,0,0,0,0,0,0,78.94
彰化縣,福興鄉,橋頭村,0,1,1492,17,1509,1886,0,0,0,0,0,0,80.01
彰化縣,福興鄉,社尾村,0,1,1037,19,1056,1271,0,0,0,0,0,0,83.08
彰化縣,福興鄉,番社村,0,1,985,9,994,1205,0,0,0,0,0,0,82.49
彰化縣,福興鄉,同安村,0,1,1468,18,1486,1806,0,0,0,0,0,0,82.28
彰化縣,福興鄉,西勢村,0,1,1222,19,1241,1541,0,0,0,0,0,0,80.53
彰化縣,福興鄉,秀厝村,0,1,1434,7,1441,1810,0,0,0,0,0,0,79.61
彰化縣,福興鄉,鎮平村,0,1,761,12,773,997,0,0,0,0,0,0,77.53
彰化縣,福興鄉,三和村,0,1,760,1,761,998,0,0,0,0,0,0,76.25
彰化縣,福興鄉,麥厝村,0,1,1435,29,1464,1898,0,0,0,0,0,0,77.13
彰化縣,福興鄉,廈粘村,0,1,1291,20,1311,1673,0,0,0,0,0,0,78.36
彰化縣,福興鄉,頂粘村,0,1,1566,18,1584,1901,0,0,0,0,0,0,83.32
彰化縣,福興鄉,福寶村,0,1,848,11,859,1075,0,0,0,0,0,0,79.91
彰化縣,福興鄉,二港村,0,1,933,11,944,1199,0,0,0,0,0,0,78.73
彰化縣,福興鄉,福興村,0,1,1918,28,1946,2488,0,0,0,0,0,0,78.22
彰化縣,福興鄉,福南村,0,1,1475,18,1493,1894,0,0,0,0,0,0,78.83
彰化縣,秀水鄉,秀水村,0,1,1209,11,1220,1476,0,0,0,0,0,0,82.66
彰化縣,秀水鄉,安溪村,0,1,1062,22,1084,1364,0,0,0,0,0,0,79.47
彰化縣,秀水鄉,莊雅村,0,1,1447,25,1472,1821,0,0,0,0,0,0,80.83
彰化縣,秀水鄉,陝西村,0,1,904,12,916,1083,0,0,0,0,0,0,84.58
彰化縣,秀水鄉,金興村,0,1,1272,12,1284,1530,0,0,0,0,0,0,83.92
彰化縣,秀水鄉,安東村,0,1,2306,43,2349,2917,0,0,0,0,0,0,80.53
彰化縣,秀水鄉,鶴鳴村,0,1,1971,33,2004,2386,0,0,0,0,0,0,83.99
彰化縣,秀水鄉,馬興村,0,1,1491,20,1511,1796,0,0,0,0,0,0,84.13
彰化縣,秀水鄉,義興村,0,1,849,21,870,1052,0,0,0,0,0,0,82.70
彰化縣,秀水鄉,福安村,0,1,2280,41,2321,2894,0,0,0,0,0,0,80.20
彰化縣,秀水鄉,埔崙村,0,1,1294,28,1322,1584,0,0,0,0,0,0,83.46
彰化縣,秀水鄉,曾厝村,0,1,975,18,993,1192,0,0,0,0,0,0,83.31
彰化縣,秀水鄉,金陵村,0,1,1080,13,1093,1319,0,0,0,0,0,0,82.87
彰化縣,秀水鄉,下崙村,0,1,1471,18,1489,1754,0,0,0,0,0,0,84.89
彰化縣,和美鎮,竹營里,0,1,2653,46,2699,3383,0,0,0,0,0,0,79.78
彰化縣,和美鎮,和東里,0,1,2276,49,2325,3021,0,0,0,0,0,0,76.96
彰化縣,和美鎮,和南里,0,1,398,2,400,453,0,0,0,0,0,0,88.30
彰化縣,和美鎮,和北里,0,1,951,21,972,1264,0,0,0,0,0,0,76.90
彰化縣,和美鎮,和西里,0,1,2246,34,2280,2928,0,0,0,0,0,0,77.87
彰化縣,和美鎮,四張里,0,1,1523,21,1544,1970,0,0,0,0,0,0,78.38
彰化縣,和美鎮,頭前里,0,1,951,18,969,1141,0,0,0,0,0,0,84.93
彰化縣,和美鎮,還社里,0,1,623,12,635,735,0,0,0,0,0,0,86.39
彰化縣,和美鎮,面前里,0,1,1223,13,1236,1514,0,0,0,0,0,0,81.64
彰化縣,和美鎮,鎮平里,0,1,1745,23,1768,2138,0,0,0,0,0,0,82.69
彰化縣,和美鎮,大霞里,0,1,1012,8,1020,1191,0,0,0,0,0,0,85.64
彰化縣,和美鎮,源埤里,0,1,1186,19,1205,1461,0,0,0,0,0,0,82.48
彰化縣,和美鎮,南佃里,0,1,1159,16,1175,1411,0,0,0,0,0,0,83.27
彰化縣,和美鎮,雅溝里,0,1,963,15,978,1166,0,0,0,0,0,0,83.88
彰化縣,和美鎮,山犁里,0,1,3441,56,3497,4413,0,0,0,0,0,0,79.24
彰化縣,和美鎮,嘉犁里,0,1,1061,20,1081,1377,0,0,0,0,0,0,78.50
彰化縣,和美鎮,詔安里,0,1,1088,25,1113,1472,0,0,0,0,0,0,75.61
彰化縣,和美鎮,鐵山里,0,1,1620,34,1654,2118,0,0,0,0,0,0,78.09
彰化縣,和美鎮,柑井里,0,1,1985,47,2032,2470,0,0,0,0,0,0,82.27
彰化縣,和美鎮,竹園里,0,1,637,6,643,726,0,0,0,0,0,0,88.57
彰化縣,和美鎮,新庄里,0,1,1619,38,1657,2067,0,0,0,0,0,0,80.16
彰化縣,和美鎮,犁盛里,0,1,1606,40,1646,1981,0,0,0,0,0,0,83.09
彰化縣,和美鎮,中寮里,0,1,809,11,820,1035,0,0,0,0,0,0,79.23
彰化縣,和美鎮,中圍里,0,1,1860,44,1904,2377,0,0,0,0,0,0,80.10
彰化縣,和美鎮,糖友里,0,1,1022,13,1035,1351,0,0,0,0,0,0,76.61
彰化縣,和美鎮,塗厝里,0,1,1308,23,1331,1578,0,0,0,0,0,0,84.35
彰化縣,和美鎮,地潭里,0,1,697,12,709,832,0,0,0,0,0,0,85.22
彰化縣,和美鎮,湖內里,0,1,931,10,941,1210,0,0,0,0,0,0,77.77
彰化縣,和美鎮,嘉寶里,0,1,1328,24,1352,1655,0,0,0,0,0,0,81.69
彰化縣,和美鎮,月眉里,0,1,2116,40,2156,2656,0,0,0,0,0,0,81.17
彰化縣,和美鎮,好修里,0,1,1293,16,1309,1557,0,0,0,0,0,0,84.07
彰化縣,線西鄉,線西村,0,1,1434,21,1455,1767,0,0,0,0,0,0,82.34
彰化縣,線西鄉,頂庄村,0,1,859,17,876,1080,0,0,0,0,0,0,81.11
彰化縣,線西鄉,寓埔村,0,1,1313,20,1333,1720,0,0,0,0,0,0,77.50
彰化縣,線西鄉,塭仔村,0,1,910,9,919,1109,0,0,0,0,0,0,82.87
彰化縣,線西鄉,溝內村,0,1,755,16,771,956,0,0,0,0,0,0,80.65
彰化縣,線西鄉,下犁村,0,1,1211,16,1227,1520,0,0,0,0,0,0,80.72
彰化縣,線西鄉,頂犁村,0,1,1552,24,1576,1938,0,0,0,0,0,0,81.32
彰化縣,線西鄉,德興村,0,1,820,17,837,952,0,0,0,0,0,0,87.92
彰化縣,伸港鄉,新港村,0,1,2782,35,2817,3668,0,0,0,0,0,0,76.80
彰化縣,伸港鄉,什股村,0,1,1127,20,1147,1396,0,0,0,0,0,0,82.16
彰化縣,伸港鄉,大同村,0,1,924,10,934,1127,0,0,0,0,0,0,82.87
彰化縣,伸港鄉,海尾村,0,1,1254,12,1266,1480,0,0,0,0,0,0,85.54
彰化縣,伸港鄉,全興村,0,1,1074,12,1086,1330,0,0,0,0,0,0,81.65
彰化縣,伸港鄉,溪底村,0,1,1157,19,1176,1461,0,0,0,0,0,0,80.49
彰化縣,伸港鄉,定興村,0,1,1432,24,1456,1867,0,0,0,0,0,0,77.99
彰化縣,伸港鄉,泉州村,0,1,1153,15,1168,1462,0,0,0,0,0,0,79.89
彰化縣,伸港鄉,泉厝村,0,1,810,17,827,1016,0,0,0,0,0,0,81.40
彰化縣,伸港鄉,曾家村,0,1,1126,16,1142,1428,0,0,0,0,0,0,79.97
彰化縣,伸港鄉,蚵寮村,0,1,853,6,859,1085,0,0,0,0,0,0,79.17
彰化縣,伸港鄉,埤墘村,0,1,651,5,656,785,0,0,0,0,0,0,83.57
彰化縣,伸港鄉,七嘉村,0,1,1260,17,1277,1542,0,0,0,0,0,0,82.81
彰化縣,伸港鄉,汴頭村,0,1,1408,13,1421,1740,0,0,0,0,0,0,81.67
彰化縣,員林鎮,東和里,0,1,792,10,802,1069,0,0,0,0,0,0,75.02
彰化縣,員林鎮,民生里,0,1,1754,34,1788,2483,0,0,0,0,0,0,72.01
彰化縣,員林鎮,中正里,0,1,1739,23,1762,2689,0,0,0,0,0,0,65.53
彰化縣,員林鎮,仁美里,0,1,1869,27,1896,2667,0,0,0,0,0,0,71.09
彰化縣,員林鎮,新興里,0,1,615,8,623,809,0,0,0,0,0,0,77.01
彰化縣,員林鎮,和平里,0,1,1769,26,1795,2511,0,0,0,0,0,0,71.49
彰化縣,員林鎮,光明里,0,1,743,6,749,968,0,0,0,0,0,0,77.38
彰化縣,員林鎮,中山里,0,1,563,9,572,780,0,0,0,0,0,0,73.33
彰化縣,員林鎮,黎明里,0,1,1296,29,1325,1756,0,0,0,0,0,0,75.46
彰化縣,員林鎮,惠來里,0,1,2711,46,2757,3868,0,0,0,0,0,0,71.28
彰化縣,員林鎮,三義里,0,1,1535,35,1570,2230,0,0,0,0,0,0,70.40
彰化縣,員林鎮,新生里,0,1,2541,43,2584,3546,0,0,0,0,0,0,72.87
彰化縣,員林鎮,南平里,0,1,2232,36,2268,3110,0,0,0,0,0,0,72.93
彰化縣,員林鎮,南興里,0,1,2816,45,2861,3880,0,0,0,0,0,0,73.74
彰化縣,員林鎮,源潭里,0,1,1049,17,1066,1331,0,0,0,0,0,0,80.09
彰化縣,員林鎮,大埔里,0,1,1243,11,1254,1598,0,0,0,0,0,0,78.47
彰化縣,員林鎮,三條里,0,1,3355,52,3407,4876,0,0,0,0,0,0,69.87
彰化縣,員林鎮,三和里,0,1,3100,48,3148,4408,0,0,0,0,0,0,71.42
彰化縣,員林鎮,三橋里,0,1,1664,32,1696,2364,0,0,0,0,0,0,71.74
彰化縣,員林鎮,三愛里,0,1,1422,26,1448,2091,0,0,0,0,0,0,69.25
彰化縣,員林鎮,三信里,0,1,1259,13,1272,1785,0,0,0,0,0,0,71.26
彰化縣,員林鎮,三多里,0,1,1249,20,1269,1815,0,0,0,0,0,0,69.92
彰化縣,員林鎮,中央里,0,1,1017,18,1035,1370,0,0,0,0,0,0,75.55
彰化縣,員林鎮,溝皂里,0,1,1373,18,1391,1841,0,0,0,0,0,0,75.56
彰化縣,員林鎮,大饒里,0,1,1603,31,1634,2216,0,0,0,0,0,0,73.74
彰化縣,員林鎮,大明里,0,1,1332,28,1360,1823,0,0,0,0,0,0,74.60
彰化縣,員林鎮,萬年里,0,1,1920,38,1958,2682,0,0,0,0,0,0,73.01
彰化縣,員林鎮,崙雅里,0,1,1586,31,1617,2124,0,0,0,0,0,0,76.13
彰化縣,員林鎮,振興里,0,1,1454,21,1475,1966,0,0,0,0,0,0,75.03
彰化縣,員林鎮,林厝里,0,1,1465,31,1496,2059,0,0,0,0,0,0,72.66
彰化縣,員林鎮,出水里,0,1,1157,29,1186,1593,0,0,0,0,0,0,74.45
彰化縣,員林鎮,湖水里,0,1,962,11,973,1285,0,0,0,0,0,0,75.72
彰化縣,員林鎮,大峰里,0,1,537,13,550,743,0,0,0,0,0,0,74.02
彰化縣,員林鎮,鎮興里,0,1,1356,20,1376,1731,0,0,0,0,0,0,79.49
彰化縣,員林鎮,浮圳里,0,1,1383,29,1412,1916,0,0,0,0,0,0,73.70
彰化縣,員林鎮,西東里,0,1,1071,11,1082,1470,0,0,0,0,0,0,73.61
彰化縣,員林鎮,南東里,0,1,1127,23,1150,1604,0,0,0,0,0,0,71.70
彰化縣,員林鎮,中東里,0,1,1008,14,1022,1342,0,0,0,0,0,0,76.15
彰化縣,員林鎮,東北里,0,1,1460,38,1498,1890,0,0,0,0,0,0,79.26
彰化縣,大村鄉,大村村,0,1,1287,26,1313,1728,0,0,0,0,0,0,75.98
彰化縣,大村鄉,茄苳村,0,1,1243,19,1262,1501,0,0,0,0,0,0,84.08
彰化縣,大村鄉,田洋村,0,1,673,5,678,838,0,0,0,0,0,0,80.91
彰化縣,大村鄉,貢旗村,0,1,960,11,971,1214,0,0,0,0,0,0,79.98
彰化縣,大村鄉,加錫村,0,1,935,8,943,1192,0,0,0,0,0,0,79.11
彰化縣,大村鄉,大崙村,0,1,1120,8,1128,1420,0,0,0,0,0,0,79.44
彰化縣,大村鄉,新興村,0,1,791,17,808,1087,0,0,0,0,0,0,74.33
彰化縣,大村鄉,南勢村,0,1,813,16,829,1078,0,0,0,0,0,0,76.90
彰化縣,大村鄉,擺塘村,0,1,1453,28,1481,1950,0,0,0,0,0,0,75.95
彰化縣,大村鄉,過溝村,0,1,1142,4,1146,1395,0,0,0,0,0,0,82.15
彰化縣,大村鄉,大橋村,0,1,1287,14,1301,1725,0,0,0,0,0,0,75.42
彰化縣,大村鄉,村上村,0,1,893,15,908,1127,0,0,0,0,0,0,80.57
彰化縣,大村鄉,美港村,0,1,1755,25,1780,2329,0,0,0,0,0,0,76.43
彰化縣,大村鄉,黃厝村,0,1,1212,20,1232,1572,0,0,0,0,0,0,78.37
彰化縣,大村鄉,福興村,0,1,1219,26,1245,1624,0,0,0,0,0,0,76.66
彰化縣,大村鄉,平和村,0,1,1413,26,1439,1861,0,0,0,0,0,0,77.32
彰化縣,永靖鄉,永東村,0,1,642,10,652,800,0,0,0,0,0,0,81.50
彰化縣,永靖鄉,永西村,0,1,983,19,1002,1352,0,0,0,0,0,0,74.11
彰化縣,永靖鄉,永南村,0,1,1208,26,1234,1673,0,0,0,0,0,0,73.76
彰化縣,永靖鄉,永北村,0,1,1196,22,1218,1630,0,0,0,0,0,0,74.72
彰化縣,永靖鄉,港西村,0,1,1145,29,1174,1563,0,0,0,0,0,0,75.11
彰化縣,永靖鄉,五福村,0,1,902,19,921,1221,0,0,0,0,0,0,75.43
彰化縣,永靖鄉,湳港村,0,1,655,12,667,853,0,0,0,0,0,0,78.19
彰化縣,永靖鄉,新莊村,0,1,589,7,596,778,0,0,0,0,0,0,76.61
彰化縣,永靖鄉,瑚璉村,0,1,1343,23,1366,1868,0,0,0,0,0,0,73.13
彰化縣,永靖鄉,五汴村,0,1,921,19,940,1210,0,0,0,0,0,0,77.69
彰化縣,永靖鄉,浮圳村,0,1,786,14,800,1000,0,0,0,0,0,0,80.00
彰化縣,永靖鄉,光雲村,0,1,1068,22,1090,1368,0,0,0,0,0,0,79.68
彰化縣,永靖鄉,東寧村,0,1,1139,26,1165,1489,0,0,0,0,0,0,78.24
彰化縣,永靖鄉,永興村,0,1,1128,11,1139,1420,0,0,0,0,0,0,80.21
彰化縣,永靖鄉,崙子村,0,1,818,26,844,1081,0,0,0,0,0,0,78.08
彰化縣,永靖鄉,獨鰲村,0,1,609,22,631,857,0,0,0,0,0,0,73.63
彰化縣,永靖鄉,敦厚村,0,1,471,4,475,620,0,0,0,0,0,0,76.61
彰化縣,永靖鄉,崙美村,0,1,555,13,568,723,0,0,0,0,0,0,78.56
彰化縣,永靖鄉,同安村,0,1,480,11,491,617,0,0,0,0,0,0,79.58
彰化縣,永靖鄉,同仁村,0,1,687,9,696,909,0,0,0,0,0,0,76.57
彰化縣,永靖鄉,湳墘村,0,1,641,11,652,828,0,0,0,0,0,0,78.74
彰化縣,永靖鄉,四芳村,0,1,520,11,531,678,0,0,0,0,0,0,78.32
彰化縣,永靖鄉,福興村,0,1,886,26,912,1137,0,0,0,0,0,0,80.21
彰化縣,永靖鄉,竹子村,0,1,1010,11,1021,1340,0,0,0,0,0,0,76.19
彰化縣,溪湖鎮,光平里,0,1,922,12,934,1149,0,0,0,0,0,0,81.29
彰化縣,溪湖鎮,平和里,0,1,568,6,574,736,0,0,0,0,0,0,77.99
彰化縣,溪湖鎮,太平里,0,1,941,18,959,1244,0,0,0,0,0,0,77.09
彰化縣,溪湖鎮,光華里,0,1,411,4,415,525,0,0,0,0,0,0,79.05
彰化縣,溪湖鎮,東寮里,0,1,1952,17,1969,2633,0,0,0,0,0,0,74.78
彰化縣,溪湖鎮,西寮里,0,1,1320,11,1331,1684,0,0,0,0,0,0,79.04
彰化縣,溪湖鎮,大突里,0,1,1357,17,1374,1820,0,0,0,0,0,0,75.49
彰化縣,溪湖鎮,北勢里,0,1,952,17,969,1197,0,0,0,0,0,0,80.95
彰化縣,溪湖鎮,汴頭里,0,1,1531,18,1549,1901,0,0,0,0,0,0,81.48
彰化縣,溪湖鎮,大竹里,0,1,1600,22,1622,2104,0,0,0,0,0,0,77.09
彰化縣,溪湖鎮,湖西里,0,1,1332,12,1344,1747,0,0,0,0,0,0,76.93
彰化縣,溪湖鎮,田中里,0,1,610,1,611,732,0,0,0,0,0,0,83.47
彰化縣,溪湖鎮,河東里,0,1,1206,19,1225,1515,0,0,0,0,0,0,80.86
彰化縣,溪湖鎮,中山里,0,1,1712,26,1738,2162,0,0,0,0,0,0,80.39
彰化縣,溪湖鎮,中竹里,0,1,605,3,608,730,0,0,0,0,0,0,83.29
彰化縣,溪湖鎮,東溪里,0,1,910,21,931,1160,0,0,0,0,0,0,80.26
彰化縣,溪湖鎮,西溪里,0,1,1026,22,1048,1352,0,0,0,0,0,0,77.51
彰化縣,溪湖鎮,湖東里,0,1,2529,39,2568,3264,0,0,0,0,0,0,78.68
彰化縣,溪湖鎮,頂庄里,0,1,501,14,515,647,0,0,0,0,0,0,79.60
彰化縣,溪湖鎮,忠覺里,0,1,915,13,928,1107,0,0,0,0,0,0,83.83
彰化縣,溪湖鎮,湳底里,0,1,560,4,564,679,0,0,0,0,0,0,83.06
彰化縣,溪湖鎮,大庭里,0,1,901,12,913,1140,0,0,0,0,0,0,80.09
彰化縣,溪湖鎮,媽厝里,0,1,1007,12,1019,1338,0,0,0,0,0,0,76.16
彰化縣,溪湖鎮,西勢里,0,1,1347,17,1364,1725,0,0,0,0,0,0,79.07
彰化縣,溪湖鎮,番婆里,0,1,1049,14,1063,1423,0,0,0,0,0,0,74.70
彰化縣,埔鹽鄉,埔鹽村,0,1,1127,24,1151,1410,0,0,0,0,0,0,81.63
彰化縣,埔鹽鄉,埔南村,0,1,1069,22,1091,1362,0,0,0,0,0,0,80.10
彰化縣,埔鹽鄉,部子村,0,1,904,9,913,1070,0,0,0,0,0,0,85.33
彰化縣,埔鹽鄉,出水村,0,1,633,6,639,758,0,0,0,0,0,0,84.30
彰化縣,埔鹽鄉,南港村,0,1,1286,21,1307,1536,0,0,0,0,0,0,85.09
彰化縣,埔鹽鄉,打廉村,0,1,761,4,765,896,0,0,0,0,0,0,85.38
彰化縣,埔鹽鄉,豐澤村,0,1,918,16,934,1201,0,0,0,0,0,0,77.77
彰化縣,埔鹽鄉,崑崙村,0,1,785,0,785,964,0,0,0,0,0,0,81.43
彰化縣,埔鹽鄉,角樹村,0,1,542,5,547,668,0,0,0,0,0,0,81.89
彰化縣,埔鹽鄉,瓦窯村,0,1,891,12,903,1066,0,0,0,0,0,0,84.71
彰化縣,埔鹽鄉,好修村,0,1,964,17,981,1169,0,0,0,0,0,0,83.92
彰化縣,埔鹽鄉,西湖村,0,1,1534,23,1557,1899,0,0,0,0,0,0,81.99
彰化縣,埔鹽鄉,大有村,0,1,1037,7,1044,1212,0,0,0,0,0,0,86.14
彰化縣,埔鹽鄉,新興村,0,1,308,0,308,385,0,0,0,0,0,0,80.00
彰化縣,埔鹽鄉,永平村,0,1,779,7,786,985,0,0,0,0,0,0,79.80
彰化縣,埔鹽鄉,永樂村,0,1,628,6,634,743,0,0,0,0,0,0,85.33
彰化縣,埔鹽鄉,石埤村,0,1,1024,18,1042,1271,0,0,0,0,0,0,81.98
彰化縣,埔鹽鄉,天盛村,0,1,641,7,648,802,0,0,0,0,0,0,80.80
彰化縣,埔鹽鄉,太平村,0,1,1107,13,1120,1420,0,0,0,0,0,0,78.87
彰化縣,埔鹽鄉,新水村,0,1,1026,17,1043,1273,0,0,0,0,0,0,81.93
彰化縣,埔鹽鄉,三省村,0,1,995,7,1002,1228,0,0,0,0,0,0,81.60
彰化縣,埔鹽鄉,南新村,0,1,978,17,995,1225,0,0,0,0,0,0,81.22
彰化縣,埔心鄉,東門村,0,1,1722,16,1738,2304,0,0,0,0,0,0,75.43
彰化縣,埔心鄉,埔心村,0,1,888,5,893,1171,0,0,0,0,0,0,76.26
彰化縣,埔心鄉,義民村,0,1,1039,15,1054,1347,0,0,0,0,0,0,78.25
彰化縣,埔心鄉,油車村,0,1,824,15,839,1036,0,0,0,0,0,0,80.98
彰化縣,埔心鄉,瓦北村,0,1,1125,18,1143,1510,0,0,0,0,0,0,75.70
彰化縣,埔心鄉,瓦中村,0,1,1147,34,1181,1475,0,0,0,0,0,0,80.07
彰化縣,埔心鄉,瓦南村,0,1,978,14,992,1276,0,0,0,0,0,0,77.74
彰化縣,埔心鄉,經口村,0,1,969,12,981,1348,0,0,0,0,0,0,72.77
彰化縣,埔心鄉,太平村,0,1,1262,26,1288,1622,0,0,0,0,0,0,79.41
彰化縣,埔心鄉,大華村,0,1,460,5,465,580,0,0,0,0,0,0,80.17
彰化縣,埔心鄉,仁里村,0,1,700,15,715,925,0,0,0,0,0,0,77.30
彰化縣,埔心鄉,舊館村,0,1,777,16,793,1025,0,0,0,0,0,0,77.37
彰化縣,埔心鄉,南館村,0,1,519,11,530,689,0,0,0,0,0,0,76.92
彰化縣,埔心鄉,新館村,0,1,608,10,618,782,0,0,0,0,0,0,79.03
彰化縣,埔心鄉,芎蕉村,0,1,1111,23,1134,1527,0,0,0,0,0,0,74.26
彰化縣,埔心鄉,羅厝村,0,1,983,11,994,1274,0,0,0,0,0,0,78.02
彰化縣,埔心鄉,梧鳳村,0,1,673,10,683,852,0,0,0,0,0,0,80.16
彰化縣,埔心鄉,二重村,0,1,899,15,914,1136,0,0,0,0,0,0,80.46
彰化縣,埔心鄉,埤霞村,0,1,601,12,613,713,0,0,0,0,0,0,85.97
彰化縣,埔心鄉,埤腳村,0,1,668,20,688,842,0,0,0,0,0,0,81.71
彰化縣,田中鎮,香山里,0,1,639,10,649,863,0,0,0,0,0,0,75.20
彰化縣,田中鎮,碧峰里,0,1,1548,66,1614,2537,0,0,0,0,0,0,63.62
彰化縣,田中鎮,東源里,0,1,450,10,460,627,0,0,0,0,0,0,73.37
彰化縣,田中鎮,復興里,0,1,1039,18,1057,1485,0,0,0,0,0,0,71.18
彰化縣,田中鎮,平和里,0,1,1026,19,1045,1436,0,0,0,0,0,0,72.77
彰化縣,田中鎮,頂潭里,0,1,857,17,874,1154,0,0,0,0,0,0,75.74
彰化縣,田中鎮,中潭里,0,1,1137,19,1156,1606,0,0,0,0,0,0,71.98
彰化縣,田中鎮,龍潭里,0,1,491,4,495,642,0,0,0,0,0,0,77.10
彰化縣,田中鎮,北路里,0,1,1788,28,1816,2529,0,0,0,0,0,0,71.81
彰化縣,田中鎮,西路里,0,1,1409,23,1432,1974,0,0,0,0,0,0,72.54
彰化縣,田中鎮,東路里,0,1,785,10,795,1056,0,0,0,0,0,0,75.28
彰化縣,田中鎮,南路里,0,1,911,13,924,1269,0,0,0,0,0,0,72.81
彰化縣,田中鎮,中路里,0,1,1432,21,1453,1984,0,0,0,0,0,0,73.24
彰化縣,田中鎮,新庄里,0,1,1327,37,1364,1872,0,0,0,0,0,0,72.86
彰化縣,田中鎮,三安里,0,1,1157,31,1188,1592,0,0,0,0,0,0,74.62
彰化縣,田中鎮,大崙里,0,1,872,13,885,1247,0,0,0,0,0,0,70.97
彰化縣,田中鎮,沙崙里,0,1,1070,24,1094,1469,0,0,0,0,0,0,74.47
彰化縣,田中鎮,新民里,0,1,2087,40,2127,3013,0,0,0,0,0,0,70.59
彰化縣,田中鎮,梅州里,0,1,865,18,883,1284,0,0,0,0,0,0,68.77
彰化縣,田中鎮,三民里,0,1,1039,22,1061,1433,0,0,0,0,0,0,74.04
彰化縣,田中鎮,三光里,0,1,684,17,701,908,0,0,0,0,0,0,77.20
彰化縣,田中鎮,大社里,0,1,560,10,570,744,0,0,0,0,0,0,76.61
彰化縣,社頭鄉,社頭村,0,1,1756,26,1782,2436,0,0,0,0,0,0,73.15
彰化縣,社頭鄉,廣興村,0,1,2434,36,2470,3202,0,0,0,0,0,0,77.14
彰化縣,社頭鄉,仁雅村,0,1,1651,23,1674,2305,0,0,0,0,0,0,72.62
彰化縣,社頭鄉,崙雅村,0,1,555,9,564,751,0,0,0,0,0,0,75.10
彰化縣,社頭鄉,美雅村,0,1,735,13,748,938,0,0,0,0,0,0,79.74
彰化縣,社頭鄉,里仁村,0,1,772,19,791,997,0,0,0,0,0,0,79.34
彰化縣,社頭鄉,舊社村,0,1,962,11,973,1283,0,0,0,0,0,0,75.84
彰化縣,社頭鄉,松竹村,0,1,658,13,671,851,0,0,0,0,0,0,78.85
彰化縣,社頭鄉,東興村,0,1,888,12,900,1214,0,0,0,0,0,0,74.14
彰化縣,社頭鄉,廣福村,0,1,599,7,606,769,0,0,0,0,0,0,78.80
彰化縣,社頭鄉,橋頭村,0,1,1311,19,1330,1752,0,0,0,0,0,0,75.91
彰化縣,社頭鄉,湳底村,0,1,1014,24,1038,1337,0,0,0,0,0,0,77.64
彰化縣,社頭鄉,新厝村,0,1,1022,16,1038,1357,0,0,0,0,0,0,76.49
彰化縣,社頭鄉,張厝村,0,1,829,5,834,1028,0,0,0,0,0,0,81.13
彰化縣,社頭鄉,埤斗村,0,1,792,19,811,977,0,0,0,0,0,0,83.01
彰化縣,社頭鄉,清水村,0,1,810,10,820,1025,0,0,0,0,0,0,80.00
彰化縣,社頭鄉,山湖村,0,1,682,11,693,889,0,0,0,0,0,0,77.95
彰化縣,社頭鄉,朝興村,0,1,716,13,729,925,0,0,0,0,0,0,78.81
彰化縣,社頭鄉,仁和村,0,1,482,30,512,668,0,0,0,0,0,0,76.65
彰化縣,社頭鄉,泰安村,0,1,610,9,619,794,0,0,0,0,0,0,77.96
彰化縣,社頭鄉,平和村,0,1,690,6,696,856,0,0,0,0,0,0,81.31
彰化縣,社頭鄉,龍井村,0,1,583,11,594,763,0,0,0,0,0,0,77.85
彰化縣,社頭鄉,湳雅村,0,1,986,20,1006,1287,0,0,0,0,0,0,78.17
彰化縣,社頭鄉,協和村,0,1,1301,28,1329,1773,0,0,0,0,0,0,74.96
彰化縣,二水鄉,復興村,0,1,800,6,806,1039,0,0,0,0,0,0,77.57
彰化縣,二水鄉,十五村,0,1,529,7,536,700,0,0,0,0,0,0,76.57
彰化縣,二水鄉,合和村,0,1,638,9,647,837,0,0,0,0,0,0,77.30
彰化縣,二水鄉,上豐村,0,1,786,24,810,1040,0,0,0,0,0,0,77.88
彰化縣,二水鄉,過圳村,0,1,518,3,521,652,0,0,0,0,0,0,79.91
彰化縣,二水鄉,五伯村,0,1,543,5,548,692,0,0,0,0,0,0,79.19
彰化縣,二水鄉,光化村,0,1,745,13,758,936,0,0,0,0,0,0,80.98
彰化縣,二水鄉,文化村,0,1,735,8,743,957,0,0,0,0,0,0,77.64
彰化縣,二水鄉,二水村,0,1,701,8,709,877,0,0,0,0,0,0,80.84
彰化縣,二水鄉,聖化村,0,1,402,3,405,519,0,0,0,0,0,0,78.03
彰化縣,二水鄉,裕民村,0,1,648,7,655,867,0,0,0,0,0,0,75.55
彰化縣,二水鄉,惠民村,0,1,646,14,660,859,0,0,0,0,0,0,76.83
彰化縣,二水鄉,大園村,0,1,582,5,587,721,0,0,0,0,0,0,81.41
彰化縣,二水鄉,修仁村,0,1,632,10,642,815,0,0,0,0,0,0,78.77
彰化縣,二水鄉,合興村,0,1,625,8,633,792,0,0,0,0,0,0,79.92
彰化縣,二水鄉,源泉村,0,1,542,5,547,684,0,0,0,0,0,0,79.97
彰化縣,二水鄉,倡和村,0,1,496,9,505,628,0,0,0,0,0,0,80.41
彰化縣,北斗鎮,中寮里,0,1,1632,22,1654,2174,0,0,0,0,0,0,76.08
彰化縣,北斗鎮,大道里,0,1,1239,15,1254,1604,0,0,0,0,0,0,78.18
彰化縣,北斗鎮,西德里,0,1,2722,39,2761,3527,0,0,0,0,0,0,78.28
彰化縣,北斗鎮,西安里,0,1,1110,13,1123,1515,0,0,0,0,0,0,74.13
彰化縣,北斗鎮,光復里,0,1,957,10,967,1278,0,0,0,0,0,0,75.67
彰化縣,北斗鎮,新政里,0,1,630,10,640,817,0,0,0,0,0,0,78.34
彰化縣,北斗鎮,重慶里,0,1,486,7,493,646,0,0,0,0,0,0,76.32
彰化縣,北斗鎮,五權里,0,1,640,7,647,804,0,0,0,0,0,0,80.47
彰化縣,北斗鎮,七星里,0,1,987,18,1005,1369,0,0,0,0,0,0,73.41
彰化縣,北斗鎮,居仁里,0,1,1039,10,1049,1299,0,0,0,0,0,0,80.75
彰化縣,北斗鎮,東光里,0,1,1182,20,1202,1583,0,0,0,0,0,0,75.93
彰化縣,北斗鎮,文昌里,0,1,1495,25,1520,1980,0,0,0,0,0,0,76.77
彰化縣,北斗鎮,中和里,0,1,795,13,808,1058,0,0,0,0,0,0,76.37
彰化縣,北斗鎮,新生里,0,1,1189,32,1221,1579,0,0,0,0,0,0,77.33
彰化縣,北斗鎮,大新里,0,1,940,31,971,1343,0,0,0,0,0,0,72.30
彰化縣,溪州鄉,溪厝村,0,1,1148,31,1179,1728,0,0,0,0,0,0,68.23
彰化縣,溪州鄉,坑厝村,0,1,460,14,474,652,0,0,0,0,0,0,72.70
彰化縣,溪州鄉,瓦厝村,0,1,678,4,682,916,0,0,0,0,0,0,74.45
彰化縣,溪州鄉,溪州村,0,1,1234,22,1256,1619,0,0,0,0,0,0,77.58
彰化縣,溪州鄉,尾厝村,0,1,978,24,1002,1283,0,0,0,0,0,0,78.10
彰化縣,溪州鄉,東州村,0,1,1290,14,1304,1718,0,0,0,0,0,0,75.90
彰化縣,溪州鄉,舊眉村,0,1,955,11,966,1223,0,0,0,0,0,0,78.99
彰化縣,溪州鄉,圳寮村,0,1,973,15,988,1375,0,0,0,0,0,0,71.85
彰化縣,溪州鄉,西畔村,0,1,1441,28,1469,1985,0,0,0,0,0,0,74.01
彰化縣,溪州鄉,成功村,0,1,1254,31,1285,1742,0,0,0,0,0,0,73.77
彰化縣,溪州鄉,大庄村,0,1,1316,19,1335,1890,0,0,0,0,0,0,70.63
彰化縣,溪州鄉,榮光村,0,1,538,17,555,760,0,0,0,0,0,0,73.03
彰化縣,溪州鄉,柑園村,0,1,808,10,818,1080,0,0,0,0,0,0,75.74
彰化縣,溪州鄉,潮洋村,0,1,642,11,653,945,0,0,0,0,0,0,69.10
彰化縣,溪州鄉,張厝村,0,1,508,7,515,749,0,0,0,0,0,0,68.76
彰化縣,溪州鄉,菜公村,0,1,620,12,632,840,0,0,0,0,0,0,75.24
彰化縣,溪州鄉,三圳村,0,1,861,21,882,1163,0,0,0,0,0,0,75.84
彰化縣,溪州鄉,三條村,0,1,662,8,670,881,0,0,0,0,0,0,76.05
彰化縣,溪州鄉,水尾村,0,1,809,12,821,1171,0,0,0,0,0,0,70.11
彰化縣,田尾鄉,田尾村,0,1,896,12,908,1201,0,0,0,0,0,0,75.60
彰化縣,田尾鄉,豐田村,0,1,495,7,502,628,0,0,0,0,0,0,79.94
彰化縣,田尾鄉,饒平村,0,1,1271,26,1297,1691,0,0,0,0,0,0,76.70
彰化縣,田尾鄉,北曾村,0,1,841,14,855,1094,0,0,0,0,0,0,78.15
彰化縣,田尾鄉,南曾村,0,1,847,14,861,1087,0,0,0,0,0,0,79.21
彰化縣,田尾鄉,睦宜村,0,1,779,25,804,1012,0,0,0,0,0,0,79.45
彰化縣,田尾鄉,新生村,0,1,871,12,883,1120,0,0,0,0,0,0,78.84
彰化縣,田尾鄉,北鎮村,0,1,696,12,708,860,0,0,0,0,0,0,82.33
彰化縣,田尾鄉,南鎮村,0,1,519,16,535,648,0,0,0,0,0,0,82.56
彰化縣,田尾鄉,福田村,0,1,635,17,652,842,0,0,0,0,0,0,77.43
彰化縣,田尾鄉,新興村,0,1,810,12,822,981,0,0,0,0,0,0,83.79
彰化縣,田尾鄉,溪畔村,0,1,855,18,873,1168,0,0,0,0,0,0,74.74
彰化縣,田尾鄉,打簾村,0,1,1290,18,1308,1662,0,0,0,0,0,0,78.70
彰化縣,田尾鄉,柳鳳村,0,1,653,5,658,779,0,0,0,0,0,0,84.47
彰化縣,田尾鄉,陸豐村,0,1,647,5,652,839,0,0,0,0,0,0,77.71
彰化縣,田尾鄉,海豐村,0,1,1057,18,1075,1464,0,0,0,0,0,0,73.43
彰化縣,田尾鄉,仁里村,0,1,1130,18,1148,1474,0,0,0,0,0,0,77.88
彰化縣,田尾鄉,新厝村,0,1,253,2,255,315,0,0,0,0,0,0,80.95
彰化縣,田尾鄉,溪頂村,0,1,468,5,473,643,0,0,0,0,0,0,73.56
彰化縣,田尾鄉,正義村,0,1,500,8,508,651,0,0,0,0,0,0,78.03
彰化縣,埤頭鄉,和豐村,0,1,1622,48,1670,2169,0,0,0,0,0,0,76.99
彰化縣,埤頭鄉,興農村,0,1,1061,34,1095,1442,0,0,0,0,0,0,75.94
彰化縣,埤頭鄉,埤頭村,0,1,1157,27,1184,1518,0,0,0,0,0,0,78.00
彰化縣,埤頭鄉,豐崙村,0,1,1544,23,1567,2023,0,0,0,0,0,0,77.46
彰化縣,埤頭鄉,崙子村,0,1,802,8,810,1085,0,0,0,0,0,0,74.65
彰化縣,埤頭鄉,永豐村,0,1,1077,22,1099,1443,0,0,0,0,0,0,76.16
彰化縣,埤頭鄉,合興村,0,1,2180,43,2223,2821,0,0,0,0,0,0,78.80
彰化縣,埤頭鄉,平原村,0,1,1153,25,1178,1557,0,0,0,0,0,0,75.66
彰化縣,埤頭鄉,崙腳村,0,1,488,7,495,662,0,0,0,0,0,0,74.77
彰化縣,埤頭鄉,元埔村,0,1,463,7,470,601,0,0,0,0,0,0,78.20
彰化縣,埤頭鄉,芙朝村,0,1,1171,19,1190,1566,0,0,0,0,0,0,75.99
彰化縣,埤頭鄉,新庄村,0,1,844,19,863,1173,0,0,0,0,0,0,73.57
彰化縣,埤頭鄉,陸嘉村,0,1,613,7,620,829,0,0,0,0,0,0,74.79
彰化縣,埤頭鄉,竹圍村,0,1,580,10,590,788,0,0,0,0,0,0,74.87
彰化縣,埤頭鄉,中和村,0,1,891,19,910,1230,0,0,0,0,0,0,73.98
彰化縣,埤頭鄉,庄內村,0,1,638,14,652,927,0,0,0,0,0,0,70.33
彰化縣,埤頭鄉,大湖村,0,1,702,19,721,961,0,0,0,0,0,0,75.03
彰化縣,二林鎮,東和里,0,1,1498,18,1516,1992,0,0,0,0,0,0,76.10
彰化縣,二林鎮,南光里,0,1,1976,31,2007,2610,0,0,0,0,0,0,76.90
彰化縣,二林鎮,西平里,0,1,1001,19,1020,1327,0,0,0,0,0,0,76.87
彰化縣,二林鎮,北平里,0,1,1724,29,1753,2328,0,0,0,0,0,0,75.30
彰化縣,二林鎮,中西里,0,1,1188,12,1200,1607,0,0,0,0,0,0,74.67
彰化縣,二林鎮,廣興里,0,1,1043,12,1055,1461,0,0,0,0,0,0,72.21
彰化縣,二林鎮,香田里,0,1,855,15,870,1218,0,0,0,0,0,0,71.43
彰化縣,二林鎮,外竹里,0,1,861,14,875,1095,0,0,0,0,0,0,79.91
彰化縣,二林鎮,興華里,0,1,851,16,867,1057,0,0,0,0,0,0,82.02
彰化縣,二林鎮,東興里,0,1,879,10,889,1181,0,0,0,0,0,0,75.28
彰化縣,二林鎮,後厝里,0,1,1645,29,1674,2155,0,0,0,0,0,0,77.68
彰化縣,二林鎮,豐田里,0,1,1486,32,1518,2095,0,0,0,0,0,0,72.46
彰化縣,二林鎮,頂厝里,0,1,945,13,958,1293,0,0,0,0,0,0,74.09
彰化縣,二林鎮,趙甲里,0,1,1251,27,1278,1621,0,0,0,0,0,0,78.84
彰化縣,二林鎮,振興里,0,1,1012,11,1023,1253,0,0,0,0,0,0,81.64
彰化縣,二林鎮,萬興里,0,1,609,10,619,769,0,0,0,0,0,0,80.49
彰化縣,二林鎮,永興里,0,1,1150,14,1164,1439,0,0,0,0,0,0,80.89
彰化縣,二林鎮,西庄里,0,1,868,8,876,1119,0,0,0,0,0,0,78.28
彰化縣,二林鎮,梅芳里,0,1,796,19,815,1043,0,0,0,0,0,0,78.14
彰化縣,二林鎮,華崙里,0,1,2645,54,2699,3386,0,0,0,0,0,0,79.71
彰化縣,二林鎮,萬合里,0,1,998,8,1006,1349,0,0,0,0,0,0,74.57
彰化縣,二林鎮,東勢里,0,1,748,15,763,992,0,0,0,0,0,0,76.92
彰化縣,二林鎮,大永里,0,1,676,6,682,876,0,0,0,0,0,0,77.85
彰化縣,二林鎮,原斗里,0,1,850,7,857,1146,0,0,0,0,0,0,74.78
彰化縣,二林鎮,西斗里,0,1,766,10,776,999,0,0,0,0,0,0,77.68
彰化縣,二林鎮,東華里,0,1,782,8,790,1002,0,0,0,0,0,0,78.84
彰化縣,二林鎮,復豐里,0,1,624,7,631,781,0,0,0,0,0,0,80.79
彰化縣,芳苑鄉,芳苑村,0,1,695,11,706,1112,0,0,0,0,0,0,63.49
彰化縣,芳苑鄉,芳中村,0,1,360,1,361,545,0,0,0,0,0,0,66.24
彰化縣,芳苑鄉,仁愛村,0,1,601,12,613,941,0,0,0,0,0,0,65.14
彰化縣,芳苑鄉,信義村,0,1,425,7,432,703,0,0,0,0,0,0,61.45
彰化縣,芳苑鄉,後寮村,0,1,672,7,679,938,0,0,0,0,0,0,72.39
彰化縣,芳苑鄉,三合村,0,1,1318,15,1333,1720,0,0,0,0,0,0,77.50
彰化縣,芳苑鄉,永興村,0,1,994,13,1007,1427,0,0,0,0,0,0,70.57
彰化縣,芳苑鄉,新街村,0,1,666,8,674,1123,0,0,0,0,0,0,60.02
彰化縣,芳苑鄉,路上村,0,1,516,7,523,784,0,0,0,0,0,0,66.71
彰化縣,芳苑鄉,路平村,0,1,620,12,632,810,0,0,0,0,0,0,78.02
彰化縣,芳苑鄉,三成村,0,1,756,11,767,999,0,0,0,0,0,0,76.78
彰化縣,芳苑鄉,福榮村,0,1,503,2,505,712,0,0,0,0,0,0,70.93
彰化縣,芳苑鄉,頂部村,0,1,468,3,471,683,0,0,0,0,0,0,68.96
彰化縣,芳苑鄉,王功村,0,1,1393,23,1416,2015,0,0,0,0,0,0,70.27
彰化縣,芳苑鄉,博愛村,0,1,588,5,593,805,0,0,0,0,0,0,73.66
彰化縣,芳苑鄉,和平村,0,1,523,11,534,816,0,0,0,0,0,0,65.44
彰化縣,芳苑鄉,興仁村,0,1,916,11,927,1344,0,0,0,0,0,0,68.97
彰化縣,芳苑鄉,民生村,0,1,531,4,535,782,0,0,0,0,0,0,68.41
彰化縣,芳苑鄉,新寶村,0,1,1023,14,1037,1327,0,0,0,0,0,0,78.15
彰化縣,芳苑鄉,五俊村,0,1,387,5,392,622,0,0,0,0,0,0,63.02
彰化縣,芳苑鄉,草湖村,0,1,1010,17,1027,1339,0,0,0,0,0,0,76.70
彰化縣,芳苑鄉,建平村,0,1,1488,36,1524,2013,0,0,0,0,0,0,75.71
彰化縣,芳苑鄉,崙腳村,0,1,575,6,581,749,0,0,0,0,0,0,77.57
彰化縣,芳苑鄉,文津村,0,1,743,9,752,991,0,0,0,0,0,0,75.88
彰化縣,芳苑鄉,新生村,0,1,934,17,951,1326,0,0,0,0,0,0,71.72
彰化縣,芳苑鄉,漢寶村,0,1,1929,34,1963,2643,0,0,0,0,0,0,74.27
彰化縣,大城鄉,潭墘村,0,1,951,13,964,1438,0,0,0,0,0,0,67.04
彰化縣,大城鄉,山腳村,0,1,943,18,961,1427,0,0,0,0,0,0,67.34
彰化縣,大城鄉,西城村,0,1,636,7,643,901,0,0,0,0,0,0,71.37
彰化縣,大城鄉,東城村,0,1,898,11,909,1247,0,0,0,0,0,0,72.89
彰化縣,大城鄉,大城村,0,1,751,7,758,1075,0,0,0,0,0,0,70.51
彰化縣,大城鄉,上山村,0,1,828,14,842,1202,0,0,0,0,0,0,70.05
彰化縣,大城鄉,永和村,0,1,516,7,523,773,0,0,0,0,0,0,67.66
彰化縣,大城鄉,公館村,0,1,875,2,877,1289,0,0,0,0,0,0,68.04
彰化縣,大城鄉,豐美村,0,1,627,10,637,884,0,0,0,0,0,0,72.06
彰化縣,大城鄉,三豐村,0,1,481,8,489,788,0,0,0,0,0,0,62.06
彰化縣,大城鄉,菜寮村,0,1,887,21,908,1191,0,0,0,0,0,0,76.24
彰化縣,大城鄉,東港村,0,1,884,13,897,1327,0,0,0,0,0,0,67.60
彰化縣,大城鄉,西港村,0,1,695,7,702,1093,0,0,0,0,0,0,64.23
彰化縣,大城鄉,頂庄村,0,1,574,5,579,846,0,0,0,0,0,0,68.44
彰化縣,大城鄉,台西村,0,1,667,8,675,1049,0,0,0,0,0,0,64.35
彰化縣,竹塘鄉,竹元村,0,1,790,12,802,1050,0,0,0,0,0,0,76.38
彰化縣,竹塘鄉,竹塘村,0,1,1282,10,1292,1589,0,0,0,0,0,0,81.31
彰化縣,竹塘鄉,小西村,0,1,633,2,635,824,0,0,0,0,0,0,77.06
彰化縣,竹塘鄉,民靖村,0,1,584,6,590,778,0,0,0,0,0,0,75.84
彰化縣,竹塘鄉,五庄村,0,1,1095,23,1118,1477,0,0,0,0,0,0,75.69
彰化縣,竹塘鄉,樹腳村,0,1,461,6,467,630,0,0,0,0,0,0,74.13
彰化縣,竹塘鄉,田頭村,0,1,707,9,716,937,0,0,0,0,0,0,76.41
彰化縣,竹塘鄉,新廣村,0,1,904,11,915,1211,0,0,0,0,0,0,75.56
彰化縣,竹塘鄉,溪墘村,0,1,395,3,398,567,0,0,0,0,0,0,70.19
彰化縣,竹塘鄉,竹林村,0,1,634,5,639,882,0,0,0,0,0,0,72.45
彰化縣,竹塘鄉,土庫村,0,1,539,6,545,720,0,0,0,0,0,0,75.69
彰化縣,竹塘鄉,內新村,0,1,472,2,474,668,0,0,0,0,0,0,70.96
彰化縣,竹塘鄉,長安村,0,1,567,4,571,759,0,0,0,0,0,0,75.23
彰化縣,竹塘鄉,永安村,0,1,505,7,512,732,0,0,0,0,0,0,69.95
南投縣,南投市,龍泉里,0,1,589,2,591,949,0,0,0,0,0,0,62.28
南投縣,南投市,康壽里,0,1,891,6,897,1359,0,0,0,0,0,0,66.00
南投縣,南投市,三民里,0,1,499,1,500,703,0,0,0,0,0,0,71.12
南投縣,南投市,仁和里,0,1,386,2,388,545,0,0,0,0,0,0,71.19
南投縣,南投市,南投里,0,1,535,4,539,737,0,0,0,0,0,0,73.13
南投縣,南投市,彰仁里,0,1,295,1,296,432,0,0,0,0,0,0,68.52
南投縣,南投市,崇文里,0,1,696,5,701,1022,0,0,0,0,0,0,68.59
南投縣,南投市,三興里,0,1,2361,17,2378,3826,0,0,0,0,0,0,62.15
南投縣,南投市,三和里,0,1,1871,13,1884,2767,0,0,0,0,0,0,68.09
南投縣,南投市,嘉興里,0,1,1136,9,1145,1616,0,0,0,0,0,0,70.85
南投縣,南投市,嘉和里,0,1,1783,23,1806,2484,0,0,0,0,0,0,72.71
南投縣,南投市,平和里,0,1,3308,25,3333,5024,0,0,0,0,0,0,66.34
南投縣,南投市,振興里,0,1,1340,7,1347,1939,0,0,0,0,0,0,69.47
南投縣,南投市,千秋里,0,1,561,7,568,799,0,0,0,0,0,0,71.09
南投縣,南投市,軍功里,0,1,2395,37,2432,3594,0,0,0,0,0,0,67.67
南投縣,南投市,東山里,0,1,298,1,299,464,0,0,0,0,0,0,64.44
南投縣,南投市,營南里,0,1,1302,12,1314,1851,0,0,0,0,0,0,70.99
南投縣,南投市,營北里,0,1,2889,30,2919,4292,0,0,0,0,0,0,68.01
南投縣,南投市,內興里,0,1,2972,36,3008,4338,0,0,0,0,0,0,69.34
南投縣,南投市,內新里,0,1,1001,10,1011,1250,0,0,0,0,0,0,80.88
南投縣,南投市,光輝里,0,1,391,3,394,576,0,0,0,0,0,0,68.40
南投縣,南投市,光榮里,0,1,1218,16,1234,1924,0,0,0,0,0,0,64.14
南投縣,南投市,光明里,0,1,1415,21,1436,2099,0,0,0,0,0,0,68.41
南投縣,南投市,光華里,0,1,1117,12,1129,1632,0,0,0,0,0,0,69.18
南投縣,南投市,漳興里,0,1,1460,13,1473,2217,0,0,0,0,0,0,66.44
南投縣,南投市,漳和里,0,1,3498,22,3520,5233,0,0,0,0,0,0,67.27
南投縣,南投市,平山里,0,1,2487,32,2519,3541,0,0,0,0,0,0,71.14
南投縣,南投市,新興里,0,1,2071,17,2088,2966,0,0,0,0,0,0,70.40
南投縣,南投市,永豐里,0,1,1346,20,1366,2186,0,0,0,0,0,0,62.49
南投縣,南投市,福興里,0,1,1685,18,1703,2403,0,0,0,0,0,0,70.87
南投縣,南投市,鳳山里,0,1,819,8,827,1236,0,0,0,0,0,0,66.91
南投縣,南投市,永興里,0,1,565,5,570,738,0,0,0,0,0,0,77.24
南投縣,南投市,鳳鳴里,0,1,567,1,568,769,0,0,0,0,0,0,73.86
南投縣,南投市,福山里,0,1,1222,10,1232,1620,0,0,0,0,0,0,76.05
南投縣,埔里鎮,東門里,0,1,1920,22,1942,2977,0,0,0,0,0,0,65.23
南投縣,埔里鎮,西門里,0,1,1882,12,1894,3115,0,0,0,0,0,0,60.80
南投縣,埔里鎮,南門里,0,1,652,5,657,1021,0,0,0,0,0,0,64.35
南投縣,埔里鎮,北門里,0,1,1454,14,1468,2324,0,0,0,0,0,0,63.17
南投縣,埔里鎮,北安里,0,1,1890,17,1907,2994,0,0,0,0,0,0,63.69
南投縣,埔里鎮,泰安里,0,1,1238,16,1254,1888,0,0,0,0,0,0,66.42
南投縣,埔里鎮,北梅里,0,1,1264,6,1270,2076,0,0,0,0,0,0,61.18
南投縣,埔里鎮,同聲里,0,1,1444,26,1470,2147,0,0,0,0,0,0,68.47
南投縣,埔里鎮,清新里,0,1,2103,16,2119,3442,0,0,0,0,0,0,61.56
南投縣,埔里鎮,薰化里,0,1,903,9,912,1313,0,0,0,0,0,0,69.46
南投縣,埔里鎮,大城里,0,1,3245,34,3279,5275,0,0,0,0,0,0,62.16
南投縣,埔里鎮,籃城里,0,1,545,3,548,753,0,0,0,0,0,0,72.78
南投縣,埔里鎮,杷城里,0,1,1435,9,1444,2194,0,0,0,0,0,0,65.82
南投縣,埔里鎮,枇杷里,0,1,3179,54,3233,5054,0,0,0,0,0,0,63.97
南投縣,埔里鎮,水頭里,0,1,1643,25,1668,2697,0,0,0,0,0,0,61.85
南投縣,埔里鎮,麒麟里,0,1,621,6,627,927,0,0,0,0,0,0,67.64
南投縣,埔里鎮,珠格里,0,1,639,11,650,920,0,0,0,0,0,0,70.65
南投縣,埔里鎮,溪南里,0,1,451,9,460,698,0,0,0,0,0,0,65.90
南投縣,埔里鎮,桃米里,0,1,577,6,583,932,0,0,0,0,0,0,62.55
南投縣,埔里鎮,成功里,0,1,201,2,203,358,0,0,0,0,0,0,56.70
南投縣,埔里鎮,南村里,0,1,782,7,789,1297,0,0,0,0,0,0,60.83
南投縣,埔里鎮,愛蘭里,0,1,790,9,799,1259,0,0,0,0,0,0,63.46
南投縣,埔里鎮,鐵山里,0,1,921,5,926,1466,0,0,0,0,0,0,63.17
南投縣,埔里鎮,房里里,0,1,742,13,755,1180,0,0,0,0,0,0,63.98
南投縣,埔里鎮,向善里,0,1,468,6,474,667,0,0,0,0,0,0,71.06
南投縣,埔里鎮,一新里,0,1,662,9,671,998,0,0,0,0,0,0,67.23
南投縣,埔里鎮,合成里,0,1,991,1,992,1495,0,0,0,0,0,0,66.35
南投縣,埔里鎮,廣成里,0,1,676,6,682,1090,0,0,0,0,0,0,62.57
南投縣,埔里鎮,史港里,0,1,400,2,402,620,0,0,0,0,0,0,64.84
南投縣,埔里鎮,福興里,0,1,610,6,616,945,0,0,0,0,0,0,65.19
南投縣,埔里鎮,牛眠里,0,1,1573,21,1594,2357,0,0,0,0,0,0,67.63
南投縣,埔里鎮,大湳里,0,1,756,7,763,1116,0,0,0,0,0,0,68.37
南投縣,埔里鎮,蜈蚣里,0,1,1545,11,1556,2411,0,0,0,0,0,0,64.54
南投縣,草屯鎮,玉峰里,0,1,1226,23,1249,1791,0,0,0,0,0,0,69.74
南投縣,草屯鎮,明正里,0,1,1939,22,1961,3063,0,0,0,0,0,0,64.02
南投縣,草屯鎮,炎峰里,0,1,1323,16,1339,1989,0,0,0,0,0,0,67.32
南投縣,草屯鎮,中正里,0,1,545,3,548,721,0,0,0,0,0,0,76.01
南投縣,草屯鎮,和平里,0,1,957,7,964,1372,0,0,0,0,0,0,70.26
南投縣,草屯鎮,中山里,0,1,1482,21,1503,2227,0,0,0,0,0,0,67.49
南投縣,草屯鎮,敦和里,0,1,3069,36,3105,4848,0,0,0,0,0,0,64.05
南投縣,草屯鎮,山腳里,0,1,3617,45,3662,5326,0,0,0,0,0,0,68.76
南投縣,草屯鎮,新厝里,0,1,1786,24,1810,2685,0,0,0,0,0,0,67.41
南投縣,草屯鎮,上林里,0,1,1567,25,1592,2163,0,0,0,0,0,0,73.60
南投縣,草屯鎮,碧峰里,0,1,1865,28,1893,2923,0,0,0,0,0,0,64.76
南投縣,草屯鎮,碧洲里,0,1,1064,9,1073,1496,0,0,0,0,0,0,71.72
南投縣,草屯鎮,復興里,0,1,1811,19,1830,2651,0,0,0,0,0,0,69.03
南投縣,草屯鎮,御史里,0,1,2990,32,3022,4623,0,0,0,0,0,0,65.37
南投縣,草屯鎮,新豐里,0,1,2064,21,2085,3160,0,0,0,0,0,0,65.98
南投縣,草屯鎮,新庄里,0,1,1816,25,1841,2598,0,0,0,0,0,0,70.86
南投縣,草屯鎮,加老里,0,1,1252,11,1263,1769,0,0,0,0,0,0,71.40
南投縣,草屯鎮,石川里,0,1,798,7,805,1096,0,0,0,0,0,0,73.45
南投縣,草屯鎮,北投里,0,1,1510,11,1521,2145,0,0,0,0,0,0,70.91
南投縣,草屯鎮,富寮里,0,1,2686,33,2719,4063,0,0,0,0,0,0,66.92
南投縣,草屯鎮,北勢里,0,1,1236,8,1244,1791,0,0,0,0,0,0,69.46
南投縣,草屯鎮,中原里,0,1,1212,12,1224,1717,0,0,0,0,0,0,71.29
南投縣,草屯鎮,南埔里,0,1,1972,28,2000,2921,0,0,0,0,0,0,68.47
南投縣,草屯鎮,坪頂里,0,1,658,6,664,937,0,0,0,0,0,0,70.86
南投縣,草屯鎮,土城里,0,1,1025,13,1038,1568,0,0,0,0,0,0,66.20
南投縣,草屯鎮,平林里,0,1,739,6,745,966,0,0,0,0,0,0,77.12
南投縣,草屯鎮,雙冬里,0,1,1517,14,1531,2292,0,0,0,0,0,0,66.80
南投縣,竹山鎮,竹山里,0,1,1566,15,1581,2240,0,0,0,0,0,0,70.58
南投縣,竹山鎮,中正里,0,1,554,8,562,749,0,0,0,0,0,0,75.03
南投縣,竹山鎮,中山里,0,1,2956,32,2988,4331,0,0,0,0,0,0,68.99
南投縣,竹山鎮,雲林里,0,1,2119,21,2140,3133,0,0,0,0,0,0,68.31
南投縣,竹山鎮,竹圍里,0,1,1333,23,1356,1999,0,0,0,0,0,0,67.83
南投縣,竹山鎮,桂林里,0,1,2208,20,2228,3273,0,0,0,0,0,0,68.07
南投縣,竹山鎮,下坪里,0,1,670,9,679,971,0,0,0,0,0,0,69.93
南投縣,竹山鎮,中和里,0,1,647,6,653,956,0,0,0,0,0,0,68.31
南投縣,竹山鎮,中崎里,0,1,848,3,851,1206,0,0,0,0,0,0,70.56
南投縣,竹山鎮,秀林里,0,1,581,0,581,811,0,0,0,0,0,0,71.64
南投縣,竹山鎮,大鞍里,0,1,133,0,133,182,0,0,0,0,0,0,73.08
南投縣,竹山鎮,延和里,0,1,2545,30,2575,3889,0,0,0,0,0,0,66.21
南投縣,竹山鎮,延祥里,0,1,1870,33,1903,3006,0,0,0,0,0,0,63.31
南投縣,竹山鎮,延正里,0,1,1122,12,1134,1611,0,0,0,0,0,0,70.39
南投縣,竹山鎮,延平里,0,1,1903,17,1920,2655,0,0,0,0,0,0,72.32
南投縣,竹山鎮,延山里,0,1,434,6,440,646,0,0,0,0,0,0,68.11
南投縣,竹山鎮,山崇里,0,1,1274,16,1290,1924,0,0,0,0,0,0,67.05
南投縣,竹山鎮,社寮里,0,1,623,2,625,869,0,0,0,0,0,0,71.92
南投縣,竹山鎮,中央里,0,1,1042,7,1049,1413,0,0,0,0,0,0,74.24
南投縣,竹山鎮,富州里,0,1,497,3,500,719,0,0,0,0,0,0,69.54
南投縣,竹山鎮,田子里,0,1,432,6,438,646,0,0,0,0,0,0,67.80
南投縣,竹山鎮,回窯里,0,1,819,13,832,1239,0,0,0,0,0,0,67.15
南投縣,竹山鎮,德興里,0,1,642,6,648,903,0,0,0,0,0,0,71.76
南投縣,竹山鎮,福興里,0,1,428,2,430,577,0,0,0,0,0,0,74.52
南投縣,竹山鎮,鯉魚里,0,1,640,7,647,943,0,0,0,0,0,0,68.61
南投縣,竹山鎮,坪頂里,0,1,428,3,431,616,0,0,0,0,0,0,69.97
南投縣,竹山鎮,瑞竹里,0,1,540,10,550,771,0,0,0,0,0,0,71.34
南投縣,竹山鎮,桶頭里,0,1,725,13,738,1082,0,0,0,0,0,0,68.21
南投縣,集集鎮,集集里,0,1,608,4,612,879,0,0,0,0,0,0,69.62
南投縣,集集鎮,和平里,0,1,619,4,623,976,0,0,0,0,0,0,63.83
南投縣,集集鎮,林尾里,0,1,393,5,398,584,0,0,0,0,0,0,68.15
南投縣,集集鎮,田寮里,0,1,780,6,786,1091,0,0,0,0,0,0,72.04
南投縣,集集鎮,隘寮里,0,1,392,0,392,542,0,0,0,0,0,0,72.32
南投縣,集集鎮,玉映里,0,1,290,2,292,440,0,0,0,0,0,0,66.36
南投縣,集集鎮,吳厝里,0,1,659,5,664,917,0,0,0,0,0,0,72.41
南投縣,集集鎮,八張里,0,1,861,11,872,1290,0,0,0,0,0,0,67.60
南投縣,集集鎮,永昌里,0,1,588,3,591,872,0,0,0,0,0,0,67.78
南投縣,集集鎮,廣明里,0,1,410,6,416,594,0,0,0,0,0,0,70.03
南投縣,集集鎮,富山里,0,1,554,3,557,837,0,0,0,0,0,0,66.55
南投縣,名間鄉,南雅村,0,1,671,8,679,1001,0,0,0,0,0,0,67.83
南投縣,名間鄉,中正村,0,1,1765,16,1781,2714,0,0,0,0,0,0,65.62
南投縣,名間鄉,中山村,0,1,1323,12,1335,1857,0,0,0,0,0,0,71.89
南投縣,名間鄉,濁水村,0,1,1022,6,1028,1548,0,0,0,0,0,0,66.41
南投縣,名間鄉,新民村,0,1,685,10,695,1015,0,0,0,0,0,0,68.47
南投縣,名間鄉,炭寮村,0,1,710,4,714,979,0,0,0,0,0,0,72.93
南投縣,名間鄉,新街村,0,1,2254,26,2280,3188,0,0,0,0,0,0,71.52
南投縣,名間鄉,東湖村,0,1,1167,12,1179,1593,0,0,0,0,0,0,74.01
南投縣,名間鄉,仁和村,0,1,590,7,597,801,0,0,0,0,0,0,74.53
南投縣,名間鄉,萬丹村,0,1,799,14,813,1022,0,0,0,0,0,0,79.55
南投縣,名間鄉,田仔村,0,1,1328,12,1340,1855,0,0,0,0,0,0,72.24
南投縣,名間鄉,大庄村,0,1,1361,21,1382,1926,0,0,0,0,0,0,71.75
南投縣,名間鄉,部下村,0,1,508,6,514,748,0,0,0,0,0,0,68.72
南投縣,名間鄉,赤水村,0,1,879,7,886,1256,0,0,0,0,0,0,70.54
南投縣,名間鄉,竹圍村,0,1,623,9,632,880,0,0,0,0,0,0,71.82
南投縣,名間鄉,三崙村,0,1,988,23,1011,1428,0,0,0,0,0,0,70.80
南投縣,名間鄉,松山村,0,1,863,10,873,1337,0,0,0,0,0,0,65.30
南投縣,名間鄉,松柏村,0,1,734,15,749,1027,0,0,0,0,0,0,72.93
南投縣,名間鄉,崁腳村,0,1,554,5,559,769,0,0,0,0,0,0,72.69
南投縣,名間鄉,埔中村,0,1,587,7,594,845,0,0,0,0,0,0,70.30
南投縣,名間鄉,新厝村,0,1,572,6,578,811,0,0,0,0,0,0,71.27
南投縣,名間鄉,新光村,0,1,1073,16,1089,1566,0,0,0,0,0,0,69.54
南投縣,鹿谷鄉,初鄉村,0,1,1000,13,1013,1497,0,0,0,0,0,0,67.67
南投縣,鹿谷鄉,鹿谷村,0,1,1121,11,1132,1637,0,0,0,0,0,0,69.15
南投縣,鹿谷鄉,彰雅村,0,1,820,6,826,1118,0,0,0,0,0,0,73.88
南投縣,鹿谷鄉,廣興村,0,1,1280,7,1287,1755,0,0,0,0,0,0,73.33
南投縣,鹿谷鄉,內湖村,0,1,705,6,711,1054,0,0,0,0,0,0,67.46
南投縣,鹿谷鄉,和雅村,0,1,438,3,441,636,0,0,0,0,0,0,69.34
南投縣,鹿谷鄉,竹林村,0,1,1017,4,1021,1564,0,0,0,0,0,0,65.28
南投縣,鹿谷鄉,竹豐村,0,1,599,6,605,898,0,0,0,0,0,0,67.37
南投縣,鹿谷鄉,鳳凰村,0,1,978,8,986,1306,0,0,0,0,0,0,75.50
南投縣,鹿谷鄉,永隆村,0,1,876,5,881,1235,0,0,0,0,0,0,71.34
南投縣,鹿谷鄉,秀峰村,0,1,682,4,686,1141,0,0,0,0,0,0,60.12
南投縣,鹿谷鄉,清水村,0,1,443,7,450,753,0,0,0,0,0,0,59.76
南投縣,鹿谷鄉,瑞田村,0,1,440,4,444,804,0,0,0,0,0,0,55.22
南投縣,中寮鄉,廣興村,0,1,573,5,578,880,0,0,0,0,0,0,65.68
南投縣,中寮鄉,崁頂村,0,1,375,4,379,512,0,0,0,0,0,0,74.02
南投縣,中寮鄉,八仙村,0,1,547,4,551,782,0,0,0,0,0,0,70.46
南投縣,中寮鄉,福盛村,0,1,523,5,528,870,0,0,0,0,0,0,60.69
南投縣,中寮鄉,和興村,0,1,444,4,448,712,0,0,0,0,0,0,62.92
南投縣,中寮鄉,復興村,0,1,188,1,189,294,0,0,0,0,0,0,64.29
南投縣,中寮鄉,永平村,0,1,1373,10,1383,1868,0,0,0,0,0,0,74.04
南投縣,中寮鄉,中寮村,0,1,533,2,535,731,0,0,0,0,0,0,73.19
南投縣,中寮鄉,廣福村,0,1,390,0,390,550,0,0,0,0,0,0,70.91
南投縣,中寮鄉,永福村,0,1,689,3,692,1012,0,0,0,0,0,0,68.38
南投縣,中寮鄉,義和村,0,1,836,8,844,1114,0,0,0,0,0,0,75.76
南投縣,中寮鄉,清水村,0,1,638,8,646,991,0,0,0,0,0,0,65.19
南投縣,中寮鄉,內城村,0,1,344,3,347,472,0,0,0,0,0,0,73.52
南投縣,中寮鄉,龍安村,0,1,531,6,537,720,0,0,0,0,0,0,74.58
南投縣,中寮鄉,爽文村,0,1,399,3,402,601,0,0,0,0,0,0,66.89
南投縣,中寮鄉,龍岩村,0,1,464,5,469,683,0,0,0,0,0,0,68.67
南投縣,中寮鄉,永芳村,0,1,310,1,311,439,0,0,0,0,0,0,70.84
南投縣,中寮鄉,永和村,0,1,408,3,411,587,0,0,0,0,0,0,70.02
南投縣,魚池鄉,魚池村,0,1,1038,8,1046,1812,0,0,0,0,0,0,57.73
南投縣,魚池鄉,東池村,0,1,889,10,899,1519,0,0,0,0,0,0,59.18
南投縣,魚池鄉,大林村,0,1,621,6,627,1023,0,0,0,0,0,0,61.29
南投縣,魚池鄉,東光村,0,1,677,10,687,1185,0,0,0,0,0,0,57.97
南投縣,魚池鄉,共和村,0,1,636,4,640,976,0,0,0,0,0,0,65.57
南投縣,魚池鄉,新城村,0,1,759,4,763,1228,0,0,0,0,0,0,62.13
南投縣,魚池鄉,大雁村,0,1,388,1,389,606,0,0,0,0,0,0,64.19
南投縣,魚池鄉,五城村,0,1,472,2,474,723,0,0,0,0,0,0,65.56
南投縣,魚池鄉,中明村,0,1,597,7,604,978,0,0,0,0,0,0,61.76
南投縣,魚池鄉,水社村,0,1,450,5,455,745,0,0,0,0,0,0,61.07
南投縣,魚池鄉,日月村,0,1,332,0,332,534,0,0,0,0,0,0,62.17
南投縣,魚池鄉,頭社村,0,1,533,3,536,997,0,0,0,0,0,0,53.76
南投縣,魚池鄉,武登村,0,1,430,2,432,798,0,0,0,0,0,0,54.14
南投縣,國姓鄉,國姓村,0,1,1030,11,1041,1693,0,0,0,0,0,0,61.49
南投縣,國姓鄉,石門村,0,1,1002,5,1007,1635,0,0,0,0,0,0,61.59
南投縣,國姓鄉,大旗村,0,1,518,8,526,793,0,0,0,0,0,0,66.33
南投縣,國姓鄉,長流村,0,1,938,17,955,1552,0,0,0,0,0,0,61.53
南投縣,國姓鄉,長福村,0,1,493,5,498,772,0,0,0,0,0,0,64.51
南投縣,國姓鄉,長豐村,0,1,544,10,554,912,0,0,0,0,0,0,60.75
南投縣,國姓鄉,北港村,0,1,1237,13,1250,2113,0,0,0,0,0,0,59.16
南投縣,國姓鄉,福龜村,0,1,1351,16,1367,1936,0,0,0,0,0,0,70.61
南投縣,國姓鄉,乾溝村,0,1,621,6,627,915,0,0,0,0,0,0,68.52
南投縣,國姓鄉,柑林村,0,1,820,10,830,1206,0,0,0,0,0,0,68.82
南投縣,國姓鄉,大石村,0,1,505,3,508,784,0,0,0,0,0,0,64.80
南投縣,國姓鄉,北山村,0,1,1076,14,1090,1637,0,0,0,0,0,0,66.59
南投縣,國姓鄉,南港村,0,1,1157,31,1188,2032,0,0,0,0,0,0,58.46
南投縣,水里鄉,水里村,0,1,550,5,555,916,0,0,0,0,0,0,60.59
南投縣,水里鄉,新城村,0,1,1063,8,1071,1693,0,0,0,0,0,0,63.26
南投縣,水里鄉,中央村,0,1,505,6,511,718,0,0,0,0,0,0,71.17
南投縣,水里鄉,城中村,0,1,674,8,682,1049,0,0,0,0,0,0,65.01
南投縣,水里鄉,農富村,0,1,356,2,358,531,0,0,0,0,0,0,67.42
南投縣,水里鄉,北埔村,0,1,683,5,688,1075,0,0,0,0,0,0,64.00
南投縣,水里鄉,南光村,0,1,772,7,779,1224,0,0,0,0,0,0,63.64
南投縣,水里鄉,鉅工村,0,1,727,5,732,1070,0,0,0,0,0,0,68.41
南投縣,水里鄉,永豐村,0,1,963,8,971,1329,0,0,0,0,0,0,73.06
南投縣,水里鄉,民和村,0,1,656,8,664,1056,0,0,0,0,0,0,62.88
南投縣,水里鄉,頂崁村,0,1,721,7,728,1111,0,0,0,0,0,0,65.53
南投縣,水里鄉,新山村,0,1,271,3,274,407,0,0,0,0,0,0,67.32
南投縣,水里鄉,郡坑村,0,1,266,3,269,397,0,0,0,0,0,0,67.76
南投縣,水里鄉,上安村,0,1,811,6,817,1231,0,0,0,0,0,0,66.37
南投縣,水里鄉,興隆村,0,1,213,5,218,351,0,0,0,0,0,0,62.11
南投縣,水里鄉,永興村,0,1,264,0,264,398,0,0,0,0,0,0,66.33
南投縣,水里鄉,玉峰村,0,1,669,3,672,916,0,0,0,0,0,0,73.36
南投縣,水里鄉,車埕村,0,1,378,9,387,584,0,0,0,0,0,0,66.27
南投縣,水里鄉,新興村,0,1,438,4,442,698,0,0,0,0,0,0,63.32
南投縣,信義鄉,明德村,0,1,738,8,746,1082,0,0,0,0,0,0,68.95
南投縣,信義鄉,愛國村,0,1,378,2,380,548,0,0,0,0,0,0,69.34
南投縣,信義鄉,自強村,0,1,519,7,526,740,0,0,0,0,0,0,71.08
南投縣,信義鄉,豐丘村,0,1,235,4,239,335,0,0,0,0,0,0,71.34
南投縣,信義鄉,新鄉村,0,1,49,1,50,77,0,0,0,0,0,0,64.94
南投縣,信義鄉,羅娜村,0,1,137,0,137,220,0,0,0,0,0,0,62.27
南投縣,信義鄉,望美村,0,1,171,1,172,294,0,0,0,0,0,0,58.50
南投縣,信義鄉,東埔村,0,1,152,5,157,247,0,0,0,0,0,0,63.56
南投縣,信義鄉,神木村,0,1,458,5,463,741,0,0,0,0,0,0,62.48
南投縣,信義鄉,同富村,0,1,838,3,841,1324,0,0,0,0,0,0,63.52
南投縣,信義鄉,人和村,0,1,116,3,119,242,0,0,0,0,0,0,49.17
南投縣,信義鄉,雙龍村,0,1,10,0,10,16,0,0,0,0,0,0,62.50
南投縣,信義鄉,地利村,0,1,56,0,56,104,0,0,0,0,0,0,53.85
南投縣,信義鄉,潭南村,0,1,18,0,18,40,0,0,0,0,0,0,45.00
南投縣,仁愛鄉,南豐村,0,1,285,2,287,534,0,0,0,0,0,0,53.75
南投縣,仁愛鄉,大同村,0,1,656,8,664,1078,0,0,0,0,0,0,61.60
南投縣,仁愛鄉,榮興村,0,1,58,0,58,86,0,0,0,0,0,0,67.44
南投縣,仁愛鄉,春陽村,0,1,29,0,29,58,0,0,0,0,0,0,50.00
南投縣,仁愛鄉,精英村,0,1,72,2,74,143,0,0,0,0,0,0,51.75
南投縣,仁愛鄉,合作村,0,1,17,0,17,27,0,0,0,0,0,0,62.96
南投縣,仁愛鄉,力行村,0,1,146,4,150,257,0,0,0,0,0,0,58.37
南投縣,仁愛鄉,發祥村,0,1,30,1,31,73,0,0,0,0,0,0,42.47
南投縣,仁愛鄉,親愛村,0,1,41,2,43,81,0,0,0,0,0,0,53.09
南投縣,仁愛鄉,萬豐村,0,1,34,1,35,64,0,0,0,0,0,0,54.69
南投縣,仁愛鄉,法治村,0,1,15,0,15,43,0,0,0,0,0,0,34.88
南投縣,仁愛鄉,中正村,0,1,40,1,41,85,0,0,0,0,0,0,48.24
南投縣,仁愛鄉,互助村,0,1,43,1,44,112,0,0,0,0,0,0,39.29
南投縣,仁愛鄉,新生村,0,1,27,0,27,57,0,0,0,0,0,0,47.37
雲林縣,斗六市,信義里,0,1,658,8,666,977,0,0,0,0,0,0,68.17
雲林縣,斗六市,四維里,0,1,487,8,495,682,0,0,0,0,0,0,72.58
雲林縣,斗六市,太平里,0,1,539,12,551,739,0,0,0,0,0,0,74.56
雲林縣,斗六市,中和里,0,1,443,10,453,622,0,0,0,0,0,0,72.83
雲林縣,斗六市,光興里,0,1,626,11,637,924,0,0,0,0,0,0,68.94
雲林縣,斗六市,鎮西里,0,1,1653,38,1691,2448,0,0,0,0,0,0,69.08
雲林縣,斗六市,鎮東里,0,1,2213,42,2255,3212,0,0,0,0,0,0,70.21
雲林縣,斗六市,三平里,0,1,2141,28,2169,3019,0,0,0,0,0,0,71.84
雲林縣,斗六市,鎮北里,0,1,3602,71,3673,5443,0,0,0,0,0,0,67.48
雲林縣,斗六市,忠孝里,0,1,1064,21,1085,1527,0,0,0,0,0,0,71.05
雲林縣,斗六市,仁愛里,0,1,803,15,818,1142,0,0,0,0,0,0,71.63
雲林縣,斗六市,八德里,0,1,1625,33,1658,2326,0,0,0,0,0,0,71.28
雲林縣,斗六市,公正里,0,1,1429,35,1464,2106,0,0,0,0,0,0,69.52
雲林縣,斗六市,重光里,0,1,1345,25,1370,1905,0,0,0,0,0,0,71.92
雲林縣,斗六市,林頭里,0,1,3410,59,3469,5044,0,0,0,0,0,0,68.77
雲林縣,斗六市,鎮南里,0,1,1888,28,1916,2974,0,0,0,0,0,0,64.43
雲林縣,斗六市,社口里,0,1,1444,30,1474,2084,0,0,0,0,0,0,70.73
雲林縣,斗六市,龍潭里,0,1,680,12,692,946,0,0,0,0,0,0,73.15
雲林縣,斗六市,嘉東里,0,1,478,4,482,636,0,0,0,0,0,0,75.79
雲林縣,斗六市,崙峰里,0,1,1148,21,1169,1586,0,0,0,0,0,0,73.71
雲林縣,斗六市,溝埧里,0,1,390,5,395,527,0,0,0,0,0,0,74.95
雲林縣,斗六市,江厝里,0,1,771,14,785,1083,0,0,0,0,0,0,72.48
雲林縣,斗六市,三光里,0,1,441,6,447,608,0,0,0,0,0,0,73.52
雲林縣,斗六市,久安里,0,1,1243,28,1271,1712,0,0,0,0,0,0,74.24
雲林縣,斗六市,虎溪里,0,1,2702,50,2752,3899,0,0,0,0,0,0,70.58
雲林縣,斗六市,保庄里,0,1,1963,32,1995,2713,0,0,0,0,0,0,73.53
雲林縣,斗六市,長平里,0,1,1044,17,1061,1458,0,0,0,0,0,0,72.77
雲林縣,斗六市,榴中里,0,1,2537,51,2588,3434,0,0,0,0,0,0,75.36
雲林縣,斗六市,榴北里,0,1,631,8,639,838,0,0,0,0,0,0,76.25
雲林縣,斗六市,榴南里,0,1,561,8,569,738,0,0,0,0,0,0,77.10
雲林縣,斗六市,梅林里,0,1,1291,33,1324,1720,0,0,0,0,0,0,76.98
雲林縣,斗六市,湖山里,0,1,919,18,937,1272,0,0,0,0,0,0,73.66
雲林縣,斗六市,長安里,0,1,1592,27,1619,2250,0,0,0,0,0,0,71.96
雲林縣,斗六市,溪洲里,0,1,1494,30,1524,2178,0,0,0,0,0,0,69.97
雲林縣,斗六市,十三里,0,1,823,9,832,1092,0,0,0,0,0,0,76.19
雲林縣,斗南鎮,東仁里,0,1,813,18,831,1114,0,0,0,0,0,0,74.60
雲林縣,斗南鎮,西岐里,0,1,2681,45,2726,3792,0,0,0,0,0,0,71.89
雲林縣,斗南鎮,南昌里,0,1,1281,16,1297,1892,0,0,0,0,0,0,68.55
雲林縣,斗南鎮,北銘里,0,1,960,11,971,1225,0,0,0,0,0,0,79.27
雲林縣,斗南鎮,中天里,0,1,934,13,947,1280,0,0,0,0,0,0,73.98
雲林縣,斗南鎮,林子里,0,1,823,14,837,1136,0,0,0,0,0,0,73.68
雲林縣,斗南鎮,石龜里,0,1,637,6,643,857,0,0,0,0,0,0,75.03
雲林縣,斗南鎮,石溪里,0,1,611,9,620,892,0,0,0,0,0,0,69.51
雲林縣,斗南鎮,靖興里,0,1,673,5,678,893,0,0,0,0,0,0,75.92
雲林縣,斗南鎮,新南里,0,1,507,9,516,729,0,0,0,0,0,0,70.78
雲林縣,斗南鎮,阿丹里,0,1,927,7,934,1164,0,0,0,0,0,0,80.24
雲林縣,斗南鎮,將軍里,0,1,1030,15,1045,1350,0,0,0,0,0,0,77.41
雲林縣,斗南鎮,舊社里,0,1,1153,21,1174,1557,0,0,0,0,0,0,75.40
雲林縣,斗南鎮,明昌里,0,1,2934,32,2966,4035,0,0,0,0,0,0,73.51
雲林縣,斗南鎮,大東里,0,1,787,11,798,1020,0,0,0,0,0,0,78.24
雲林縣,斗南鎮,埤麻里,0,1,652,10,662,859,0,0,0,0,0,0,77.07
雲林縣,斗南鎮,西伯里,0,1,701,5,706,937,0,0,0,0,0,0,75.35
雲林縣,斗南鎮,新崙里,0,1,1166,13,1179,1576,0,0,0,0,0,0,74.81
雲林縣,斗南鎮,東明里,0,1,695,12,707,968,0,0,0,0,0,0,73.04
雲林縣,斗南鎮,新光里,0,1,1572,15,1587,2223,0,0,0,0,0,0,71.39
雲林縣,斗南鎮,田頭里,0,1,1514,26,1540,2017,0,0,0,0,0,0,76.35
雲林縣,斗南鎮,小東里,0,1,1107,13,1120,1529,0,0,0,0,0,0,73.25
雲林縣,虎尾鎮,東仁里,0,1,1558,28,1586,2256,0,0,0,0,0,0,70.30
雲林縣,虎尾鎮,新興里,0,1,1141,15,1156,1662,0,0,0,0,0,0,69.55
雲林縣,虎尾鎮,公安里,0,1,1705,26,1731,2594,0,0,0,0,0,0,66.73
雲林縣,虎尾鎮,德興里,0,1,1469,31,1500,2363,0,0,0,0,0,0,63.48
雲林縣,虎尾鎮,中山里,0,1,799,12,811,1145,0,0,0,0,0,0,70.83
雲林縣,虎尾鎮,西安里,0,1,1781,27,1808,2806,0,0,0,0,0,0,64.43
雲林縣,虎尾鎮,立仁里,0,1,2027,35,2062,3076,0,0,0,0,0,0,67.04
雲林縣,虎尾鎮,安慶里,0,1,907,11,918,1263,0,0,0,0,0,0,72.68
雲林縣,虎尾鎮,平和里,0,1,726,15,741,1047,0,0,0,0,0,0,70.77
雲林縣,虎尾鎮,興南里,0,1,970,16,986,1476,0,0,0,0,0,0,66.80
雲林縣,虎尾鎮,新吉里,0,1,1113,20,1133,1691,0,0,0,0,0,0,67.00
雲林縣,虎尾鎮,穎川里,0,1,1107,17,1124,1574,0,0,0,0,0,0,71.41
雲林縣,虎尾鎮,延平里,0,1,629,11,640,849,0,0,0,0,0,0,75.38
雲林縣,虎尾鎮,建國里,0,1,470,9,479,716,0,0,0,0,0,0,66.90
雲林縣,虎尾鎮,埒內里,0,1,1551,35,1586,2174,0,0,0,0,0,0,72.95
雲林縣,虎尾鎮,堀頭里,0,1,568,9,577,741,0,0,0,0,0,0,77.87
雲林縣,虎尾鎮,安溪里,0,1,1081,29,1110,1542,0,0,0,0,0,0,71.98
雲林縣,虎尾鎮,興中里,0,1,1071,16,1087,1474,0,0,0,0,0,0,73.74
雲林縣,虎尾鎮,廉使里,0,1,1869,84,1953,2722,0,0,0,0,0,0,71.75
雲林縣,虎尾鎮,惠來里,0,1,1492,35,1527,2144,0,0,0,0,0,0,71.22
雲林縣,虎尾鎮,頂溪里,0,1,1531,25,1556,2218,0,0,0,0,0,0,70.15
雲林縣,虎尾鎮,中溪里,0,1,833,23,856,1153,0,0,0,0,0,0,74.24
雲林縣,虎尾鎮,下溪里,0,1,918,17,935,1262,0,0,0,0,0,0,74.09
雲林縣,虎尾鎮,東屯里,0,1,795,21,816,1088,0,0,0,0,0,0,75.00
雲林縣,虎尾鎮,西屯里,0,1,1037,11,1048,1433,0,0,0,0,0,0,73.13
雲林縣,虎尾鎮,芳草里,0,1,523,13,536,848,0,0,0,0,0,0,63.21
雲林縣,虎尾鎮,墾地里,0,1,605,14,619,951,0,0,0,0,0,0,65.09
雲林縣,虎尾鎮,北溪里,0,1,545,9,554,737,0,0,0,0,0,0,75.17
雲林縣,虎尾鎮,三合里,0,1,682,6,688,964,0,0,0,0,0,0,71.37
雲林縣,西螺鎮,振興里,0,1,1025,9,1034,1502,0,0,0,0,0,0,68.84
雲林縣,西螺鎮,大園里,0,1,930,18,948,1332,0,0,0,0,0,0,71.17
雲林縣,西螺鎮,廣福里,0,1,1083,18,1101,1561,0,0,0,0,0,0,70.53
雲林縣,西螺鎮,正興里,0,1,1836,20,1856,2755,0,0,0,0,0,0,67.37
雲林縣,西螺鎮,永安里,0,1,337,5,342,469,0,0,0,0,0,0,72.92
雲林縣,西螺鎮,中和里,0,1,531,11,542,761,0,0,0,0,0,0,71.22
雲林縣,西螺鎮,福興里,0,1,440,8,448,705,0,0,0,0,0,0,63.55
雲林縣,西螺鎮,光華里,0,1,684,7,691,1019,0,0,0,0,0,0,67.81
雲林縣,西螺鎮,中興里,0,1,1378,19,1397,2052,0,0,0,0,0,0,68.08
雲林縣,西螺鎮,漢光里,0,1,2018,26,2044,3145,0,0,0,0,0,0,64.99
雲林縣,西螺鎮,新安里,0,1,803,4,807,1231,0,0,0,0,0,0,65.56
雲林縣,西螺鎮,新豐里,0,1,901,14,915,1347,0,0,0,0,0,0,67.93
雲林縣,西螺鎮,大新里,0,1,1149,13,1162,1737,0,0,0,0,0,0,66.90
雲林縣,西螺鎮,埤頭里,0,1,603,10,613,891,0,0,0,0,0,0,68.80
雲林縣,西螺鎮,東興里,0,1,730,9,739,1136,0,0,0,0,0,0,65.05
雲林縣,西螺鎮,鹿場里,0,1,974,16,990,1459,0,0,0,0,0,0,67.85
雲林縣,西螺鎮,廣興里,0,1,596,8,604,863,0,0,0,0,0,0,69.99
雲林縣,西螺鎮,頂湳里,0,1,724,7,731,1000,0,0,0,0,0,0,73.10
雲林縣,西螺鎮,吳厝里,0,1,884,11,895,1351,0,0,0,0,0,0,66.25
雲林縣,西螺鎮,九隆里,0,1,505,12,517,734,0,0,0,0,0,0,70.44
雲林縣,西螺鎮,下湳里,0,1,592,9,601,802,0,0,0,0,0,0,74.94
雲林縣,西螺鎮,七座里,0,1,681,11,692,1005,0,0,0,0,0,0,68.86
雲林縣,西螺鎮,公館里,0,1,925,11,936,1351,0,0,0,0,0,0,69.28
雲林縣,西螺鎮,詔安里,0,1,616,10,626,935,0,0,0,0,0,0,66.95
雲林縣,西螺鎮,河南里,0,1,592,3,595,949,0,0,0,0,0,0,62.70
雲林縣,西螺鎮,安定里,0,1,1052,16,1068,1761,0,0,0,0,0,0,60.65
雲林縣,西螺鎮,福田里,0,1,905,10,915,1354,0,0,0,0,0,0,67.58
雲林縣,土庫鎮,忠正里,0,1,628,16,644,913,0,0,0,0,0,0,70.54
雲林縣,土庫鎮,順天里,0,1,737,15,752,1025,0,0,0,0,0,0,73.37
雲林縣,土庫鎮,宮北里,0,1,898,16,914,1310,0,0,0,0,0,0,69.77
雲林縣,土庫鎮,越港里,0,1,602,10,612,817,0,0,0,0,0,0,74.91
雲林縣,土庫鎮,溪邊里,0,1,802,6,808,1118,0,0,0,0,0,0,72.27
雲林縣,土庫鎮,石廟里,0,1,982,19,1001,1431,0,0,0,0,0,0,69.95
雲林縣,土庫鎮,興新里,0,1,760,7,767,1204,0,0,0,0,0,0,63.70
雲林縣,土庫鎮,奮起里,0,1,888,11,899,1453,0,0,0,0,0,0,61.87
雲林縣,土庫鎮,埤腳里,0,1,975,20,995,1482,0,0,0,0,0,0,67.14
雲林縣,土庫鎮,後埔里,0,1,1515,13,1528,2250,0,0,0,0,0,0,67.91
雲林縣,土庫鎮,崙內里,0,1,967,8,975,1455,0,0,0,0,0,0,67.01
雲林縣,土庫鎮,大荖里,0,1,564,7,571,821,0,0,0,0,0,0,69.55
雲林縣,土庫鎮,東平里,0,1,1130,10,1140,1782,0,0,0,0,0,0,63.97
雲林縣,土庫鎮,南平里,0,1,1221,15,1236,1724,0,0,0,0,0,0,71.69
雲林縣,土庫鎮,西平里,0,1,1192,13,1205,1807,0,0,0,0,0,0,66.69
雲林縣,土庫鎮,北平里,0,1,641,5,646,972,0,0,0,0,0,0,66.46
雲林縣,土庫鎮,新庄里,0,1,952,11,963,1435,0,0,0,0,0,0,67.11
雲林縣,北港鎮,東陽里,0,1,630,24,654,857,0,0,0,0,0,0,76.31
雲林縣,北港鎮,光民里,0,1,598,9,607,811,0,0,0,0,0,0,74.85
雲林縣,北港鎮,東華里,0,1,385,3,388,524,0,0,0,0,0,0,74.05
雲林縣,北港鎮,南安里,0,1,731,19,750,1032,0,0,0,0,0,0,72.67
雲林縣,北港鎮,中和里,0,1,308,6,314,417,0,0,0,0,0,0,75.30
雲林縣,北港鎮,義民里,0,1,333,8,341,467,0,0,0,0,0,0,73.02
雲林縣,北港鎮,共榮里,0,1,356,5,361,487,0,0,0,0,0,0,74.13
雲林縣,北港鎮,西勢里,0,1,617,7,624,885,0,0,0,0,0,0,70.51
雲林縣,北港鎮,仁和里,0,1,396,8,404,556,0,0,0,0,0,0,72.66
雲林縣,北港鎮,賜福里,0,1,319,2,321,426,0,0,0,0,0,0,75.35
雲林縣,北港鎮,公館里,0,1,476,14,490,666,0,0,0,0,0,0,73.57
雲林縣,北港鎮,大同里,0,1,929,15,944,1348,0,0,0,0,0,0,70.03
雲林縣,北港鎮,仁安里,0,1,328,6,334,474,0,0,0,0,0,0,70.46
雲林縣,北港鎮,華勝里,0,1,3279,60,3339,4792,0,0,0,0,0,0,69.68
雲林縣,北港鎮,光復里,0,1,793,13,806,1169,0,0,0,0,0,0,68.95
雲林縣,北港鎮,新街里,0,1,3086,73,3159,4551,0,0,0,0,0,0,69.41
雲林縣,北港鎮,劉厝里,0,1,772,16,788,1142,0,0,0,0,0,0,69.00
雲林縣,北港鎮,後溝里,0,1,611,9,620,976,0,0,0,0,0,0,63.52
雲林縣,北港鎮,新厝里,0,1,294,6,300,437,0,0,0,0,0,0,68.65
雲林縣,北港鎮,府番里,0,1,569,12,581,870,0,0,0,0,0,0,66.78
雲林縣,北港鎮,草湖里,0,1,928,27,955,1411,0,0,0,0,0,0,67.68
雲林縣,北港鎮,溝皂里,0,1,733,13,746,1235,0,0,0,0,0,0,60.40
雲林縣,北港鎮,番溝里,0,1,617,11,628,1087,0,0,0,0,0,0,57.77
雲林縣,北港鎮,大北里,0,1,394,9,403,667,0,0,0,0,0,0,60.42
雲林縣,北港鎮,好收里,0,1,1169,23,1192,1626,0,0,0,0,0,0,73.31
雲林縣,北港鎮,樹腳里,0,1,1738,32,1770,2660,0,0,0,0,0,0,66.54
雲林縣,北港鎮,扶朝里,0,1,703,11,714,1092,0,0,0,0,0,0,65.38
雲林縣,北港鎮,水埔里,0,1,389,5,394,601,0,0,0,0,0,0,65.56
雲林縣,古坑鄉,棋盤村,0,1,1505,21,1526,2045,0,0,0,0,0,0,74.62
雲林縣,古坑鄉,新庄村,0,1,1079,22,1101,1507,0,0,0,0,0,0,73.06
雲林縣,古坑鄉,東和村,0,1,1908,35,1943,2691,0,0,0,0,0,0,72.20
雲林縣,古坑鄉,荷苞村,0,1,1037,10,1047,1425,0,0,0,0,0,0,73.47
雲林縣,古坑鄉,高林村,0,1,840,12,852,1113,0,0,0,0,0,0,76.55
雲林縣,古坑鄉,水碓村,0,1,861,18,879,1223,0,0,0,0,0,0,71.87
雲林縣,古坑鄉,田心村,0,1,682,6,688,890,0,0,0,0,0,0,77.30
雲林縣,古坑鄉,古坑村,0,1,1456,22,1478,1969,0,0,0,0,0,0,75.06
雲林縣,古坑鄉,朝陽村,0,1,1355,20,1375,1880,0,0,0,0,0,0,73.14
雲林縣,古坑鄉,西平村,0,1,1023,12,1035,1353,0,0,0,0,0,0,76.50
雲林縣,古坑鄉,湳仔村,0,1,565,6,571,716,0,0,0,0,0,0,79.75
雲林縣,古坑鄉,永光村,0,1,1339,17,1356,1837,0,0,0,0,0,0,73.82
雲林縣,古坑鄉,永昌村,0,1,1449,23,1472,1949,0,0,0,0,0,0,75.53
雲林縣,古坑鄉,麻園村,0,1,522,5,527,651,0,0,0,0,0,0,80.95
雲林縣,古坑鄉,崁腳村,0,1,974,20,994,1339,0,0,0,0,0,0,74.23
雲林縣,古坑鄉,華南村,0,1,259,2,261,341,0,0,0,0,0,0,76.54
雲林縣,古坑鄉,華山村,0,1,751,16,767,1057,0,0,0,0,0,0,72.56
雲林縣,古坑鄉,桂林村,0,1,674,8,682,929,0,0,0,0,0,0,73.41
雲林縣,古坑鄉,樟湖村,0,1,385,3,388,550,0,0,0,0,0,0,70.55
雲林縣,古坑鄉,草嶺村,0,1,526,4,530,692,0,0,0,0,0,0,76.59
雲林縣,大埤鄉,北和村,0,1,540,10,550,808,0,0,0,0,0,0,68.07
雲林縣,大埤鄉,南和村,0,1,1484,17,1501,2000,0,0,0,0,0,0,75.05
雲林縣,大埤鄉,大德村,0,1,785,15,800,1156,0,0,0,0,0,0,69.20
雲林縣,大埤鄉,松竹村,0,1,734,17,751,1084,0,0,0,0,0,0,69.28
雲林縣,大埤鄉,尚義村,0,1,1244,13,1257,1762,0,0,0,0,0,0,71.34
雲林縣,大埤鄉,嘉興村,0,1,1334,26,1360,1814,0,0,0,0,0,0,74.97
雲林縣,大埤鄉,豐田村,0,1,844,13,857,1137,0,0,0,0,0,0,75.37
雲林縣,大埤鄉,三結村,0,1,895,10,905,1228,0,0,0,0,0,0,73.70
雲林縣,大埤鄉,吉田村,0,1,536,4,540,807,0,0,0,0,0,0,66.91
雲林縣,大埤鄉,豐岡村,0,1,516,7,523,715,0,0,0,0,0,0,73.15
雲林縣,大埤鄉,聯美村,0,1,793,9,802,1244,0,0,0,0,0,0,64.47
雲林縣,大埤鄉,怡然村,0,1,588,4,592,853,0,0,0,0,0,0,69.40
雲林縣,大埤鄉,北鎮村,0,1,483,6,489,730,0,0,0,0,0,0,66.99
雲林縣,大埤鄉,興安村,0,1,574,5,579,865,0,0,0,0,0,0,66.94
雲林縣,大埤鄉,西鎮村,0,1,619,6,625,846,0,0,0,0,0,0,73.88
雲林縣,莿桐鄉,莿桐村,0,1,2300,39,2339,3218,0,0,0,0,0,0,72.68
雲林縣,莿桐鄉,甘厝村,0,1,646,7,653,907,0,0,0,0,0,0,72.00
雲林縣,莿桐鄉,甘西村,0,1,1055,11,1066,1565,0,0,0,0,0,0,68.12
雲林縣,莿桐鄉,興桐村,0,1,933,10,943,1287,0,0,0,0,0,0,73.27
雲林縣,莿桐鄉,義和村,0,1,798,6,804,1112,0,0,0,0,0,0,72.30
雲林縣,莿桐鄉,埔子村,0,1,1198,23,1221,1723,0,0,0,0,0,0,70.86
雲林縣,莿桐鄉,大美村,0,1,1648,30,1678,2209,0,0,0,0,0,0,75.96
雲林縣,莿桐鄉,埔尾村,0,1,936,13,949,1165,0,0,0,0,0,0,81.46
雲林縣,莿桐鄉,興貴村,0,1,1339,19,1358,1823,0,0,0,0,0,0,74.49
雲林縣,莿桐鄉,饒平村,0,1,829,15,844,1128,0,0,0,0,0,0,74.82
雲林縣,莿桐鄉,四合村,0,1,1142,17,1159,1715,0,0,0,0,0,0,67.58
雲林縣,莿桐鄉,麻園村,0,1,1070,12,1082,1533,0,0,0,0,0,0,70.58
雲林縣,莿桐鄉,五華村,0,1,878,17,895,1290,0,0,0,0,0,0,69.38
雲林縣,莿桐鄉,六合村,0,1,1127,8,1135,1652,0,0,0,0,0,0,68.70
雲林縣,林內鄉,林南村,0,1,749,14,763,1033,0,0,0,0,0,0,73.86
雲林縣,林內鄉,林中村,0,1,2133,48,2181,3094,0,0,0,0,0,0,70.49
雲林縣,林內鄉,林北村,0,1,1444,28,1472,2052,0,0,0,0,0,0,71.73
雲林縣,林內鄉,坪頂村,0,1,479,5,484,633,0,0,0,0,0,0,76.46
雲林縣,林內鄉,林茂村,0,1,721,13,734,997,0,0,0,0,0,0,73.62
雲林縣,林內鄉,九芎村,0,1,1744,45,1789,2467,0,0,0,0,0,0,72.52
雲林縣,林內鄉,湖本村,0,1,463,4,467,629,0,0,0,0,0,0,74.24
雲林縣,林內鄉,烏塗村,0,1,846,13,859,1122,0,0,0,0,0,0,76.56
雲林縣,林內鄉,烏麻村,0,1,745,24,769,1057,0,0,0,0,0,0,72.75
雲林縣,林內鄉,重興村,0,1,1227,20,1247,1670,0,0,0,0,0,0,74.67
雲林縣,二崙鄉,崙東村,0,1,883,11,894,1346,0,0,0,0,0,0,66.42
雲林縣,二崙鄉,崙西村,0,1,1042,16,1058,1560,0,0,0,0,0,0,67.82
雲林縣,二崙鄉,來惠村,0,1,1166,13,1179,1837,0,0,0,0,0,0,64.18
雲林縣,二崙鄉,三和村,0,1,1147,12,1159,1692,0,0,0,0,0,0,68.50
雲林縣,二崙鄉,湳仔村,0,1,845,17,862,1223,0,0,0,0,0,0,70.48
雲林縣,二崙鄉,田尾村,0,1,1329,25,1354,1948,0,0,0,0,0,0,69.51
雲林縣,二崙鄉,定安村,0,1,623,5,628,930,0,0,0,0,0,0,67.53
雲林縣,二崙鄉,永定村,0,1,853,11,864,1329,0,0,0,0,0,0,65.01
雲林縣,二崙鄉,大華村,0,1,593,11,604,949,0,0,0,0,0,0,63.65
雲林縣,二崙鄉,義庄村,0,1,490,3,493,799,0,0,0,0,0,0,61.70
雲林縣,二崙鄉,楊賢村,0,1,983,15,998,1491,0,0,0,0,0,0,66.93
雲林縣,二崙鄉,港後村,0,1,1242,15,1257,1961,0,0,0,0,0,0,64.10
雲林縣,二崙鄉,大義村,0,1,564,5,569,899,0,0,0,0,0,0,63.29
雲林縣,二崙鄉,油車村,0,1,1177,13,1190,1780,0,0,0,0,0,0,66.85
雲林縣,二崙鄉,大庄村,0,1,887,7,894,1403,0,0,0,0,0,0,63.72
雲林縣,二崙鄉,庄西村,0,1,615,5,620,1034,0,0,0,0,0,0,59.96
雲林縣,二崙鄉,大同村,0,1,582,8,590,836,0,0,0,0,0,0,70.57
雲林縣,二崙鄉,復興村,0,1,710,5,715,1051,0,0,0,0,0,0,68.03
雲林縣,崙背鄉,東明村,0,1,921,17,938,1294,0,0,0,0,0,0,72.49
雲林縣,崙背鄉,西榮村,0,1,932,14,946,1317,0,0,0,0,0,0,71.83
雲林縣,崙背鄉,南陽村,0,1,1574,36,1610,2195,0,0,0,0,0,0,73.35
雲林縣,崙背鄉,崙前村,0,1,1244,24,1268,1928,0,0,0,0,0,0,65.77
雲林縣,崙背鄉,羅厝村,0,1,1224,14,1238,1873,0,0,0,0,0,0,66.10
雲林縣,崙背鄉,港尾村,0,1,877,16,893,1335,0,0,0,0,0,0,66.89
雲林縣,崙背鄉,阿勸村,0,1,1345,12,1357,1909,0,0,0,0,0,0,71.08
雲林縣,崙背鄉,五魁村,0,1,576,7,583,876,0,0,0,0,0,0,66.55
雲林縣,崙背鄉,大有村,0,1,1126,9,1135,1767,0,0,0,0,0,0,64.23
雲林縣,崙背鄉,豐榮村,0,1,1201,14,1215,2017,0,0,0,0,0,0,60.24
雲林縣,崙背鄉,草湖村,0,1,805,12,817,1446,0,0,0,0,0,0,56.50
雲林縣,崙背鄉,舊庄村,0,1,788,9,797,1144,0,0,0,0,0,0,69.67
雲林縣,崙背鄉,水尾村,0,1,817,7,824,1262,0,0,0,0,0,0,65.29
雲林縣,崙背鄉,枋南村,0,1,589,9,598,872,0,0,0,0,0,0,68.58
雲林縣,麥寮鄉,麥豐村,0,1,1975,22,1997,2905,0,0,0,0,0,0,68.74
雲林縣,麥寮鄉,麥津村,0,1,1520,18,1538,2376,0,0,0,0,0,0,64.73
雲林縣,麥寮鄉,瓦窯村,0,1,934,3,937,1342,0,0,0,0,0,0,69.82
雲林縣,麥寮鄉,興華村,0,1,1217,11,1228,1842,0,0,0,0,0,0,66.67
雲林縣,麥寮鄉,海豐村,0,1,908,9,917,1434,0,0,0,0,0,0,63.95
雲林縣,麥寮鄉,後安村,0,1,1355,14,1369,2059,0,0,0,0,0,0,66.49
雲林縣,麥寮鄉,三盛村,0,1,1315,14,1329,2081,0,0,0,0,0,0,63.86
雲林縣,麥寮鄉,崙後村,0,1,1077,19,1096,1827,0,0,0,0,0,0,59.99
雲林縣,麥寮鄉,橋頭村,0,1,1476,25,1501,2422,0,0,0,0,0,0,61.97
雲林縣,麥寮鄉,新吉村,0,1,500,10,510,804,0,0,0,0,0,0,63.43
雲林縣,麥寮鄉,施厝村,0,1,1328,15,1343,2134,0,0,0,0,0,0,62.93
雲林縣,麥寮鄉,雷厝村,0,1,848,12,860,1444,0,0,0,0,0,0,59.56
雲林縣,東勢鄉,月眉村,0,1,735,8,743,1321,0,0,0,0,0,0,56.25
雲林縣,東勢鄉,復興村,0,1,311,6,317,487,0,0,0,0,0,0,65.09
雲林縣,東勢鄉,嘉隆村,0,1,1121,18,1139,1792,0,0,0,0,0,0,63.56
雲林縣,東勢鄉,東南村,0,1,974,14,988,1431,0,0,0,0,0,0,69.04
雲林縣,東勢鄉,東北村,0,1,753,8,761,1161,0,0,0,0,0,0,65.55
雲林縣,東勢鄉,昌南村,0,1,627,5,632,1021,0,0,0,0,0,0,61.90
雲林縣,東勢鄉,同安村,0,1,1392,23,1415,2215,0,0,0,0,0,0,63.88
雲林縣,東勢鄉,四美村,0,1,748,8,756,1285,0,0,0,0,0,0,58.83
雲林縣,東勢鄉,新坤村,0,1,727,9,736,1269,0,0,0,0,0,0,58.00
雲林縣,東勢鄉,安南村,0,1,496,8,504,971,0,0,0,0,0,0,51.91
雲林縣,東勢鄉,龍潭村,0,1,628,6,634,1044,0,0,0,0,0,0,60.73
雲林縣,東勢鄉,程海村,0,1,366,10,376,592,0,0,0,0,0,0,63.51
雲林縣,褒忠鄉,中民村,0,1,1290,20,1310,1807,0,0,0,0,0,0,72.50
雲林縣,褒忠鄉,埔姜村,0,1,943,8,951,1353,0,0,0,0,0,0,70.29
雲林縣,褒忠鄉,中勝村,0,1,940,12,952,1311,0,0,0,0,0,0,72.62
雲林縣,褒忠鄉,馬鳴村,0,1,957,10,967,1347,0,0,0,0,0,0,71.79
雲林縣,褒忠鄉,新湖村,0,1,895,1,896,1288,0,0,0,0,0,0,69.57
雲林縣,褒忠鄉,有才村,0,1,634,5,639,909,0,0,0,0,0,0,70.30
雲林縣,褒忠鄉,田洋村,0,1,591,5,596,865,0,0,0,0,0,0,68.90
雲林縣,褒忠鄉,龍岩村,0,1,1001,21,1022,1274,0,0,0,0,0,0,80.22
雲林縣,褒忠鄉,潮厝村,0,1,614,9,623,991,0,0,0,0,0,0,62.87
雲林縣,台西鄉,台西村,0,1,887,3,890,1302,0,0,0,0,0,0,68.36
雲林縣,台西鄉,海南村,0,1,634,4,638,997,0,0,0,0,0,0,63.99
雲林縣,台西鄉,海北村,0,1,645,11,656,1023,0,0,0,0,0,0,64.13
雲林縣,台西鄉,海口村,0,1,1188,21,1209,1875,0,0,0,0,0,0,64.48
雲林縣,台西鄉,山寮村,0,1,516,6,522,949,0,0,0,0,0,0,55.01
雲林縣,台西鄉,溪頂村,0,1,954,6,960,1534,0,0,0,0,0,0,62.58
雲林縣,台西鄉,牛厝村,0,1,1273,8,1281,2087,0,0,0,0,0,0,61.38
雲林縣,台西鄉,泉州村,0,1,421,5,426,661,0,0,0,0,0,0,64.45
雲林縣,台西鄉,五榔村,0,1,329,4,333,558,0,0,0,0,0,0,59.68
雲林縣,台西鄉,光華村,0,1,403,5,408,661,0,0,0,0,0,0,61.72
雲林縣,台西鄉,五港村,0,1,1213,11,1224,1814,0,0,0,0,0,0,67.48
雲林縣,台西鄉,富琦村,0,1,963,5,968,1570,0,0,0,0,0,0,61.66
雲林縣,台西鄉,永豐村,0,1,945,14,959,1397,0,0,0,0,0,0,68.65
雲林縣,台西鄉,和豐村,0,1,2159,23,2182,3224,0,0,0,0,0,0,67.68
雲林縣,台西鄉,蚊港村,0,1,1608,14,1622,2017,0,0,0,0,0,0,80.42
雲林縣,元長鄉,長南村,0,1,2044,27,2071,2958,0,0,0,0,0,0,70.01
雲林縣,元長鄉,長北村,0,1,1124,10,1134,1590,0,0,0,0,0,0,71.32
雲林縣,元長鄉,子茂村,0,1,942,12,954,1478,0,0,0,0,0,0,64.55
雲林縣,元長鄉,後湖村,0,1,480,4,484,776,0,0,0,0,0,0,62.37
雲林縣,元長鄉,山內村,0,1,664,10,674,1048,0,0,0,0,0,0,64.31
雲林縣,元長鄉,合和村,0,1,689,9,698,1177,0,0,0,0,0,0,59.30
雲林縣,元長鄉,五塊村,0,1,575,7,582,1050,0,0,0,0,0,0,55.43
雲林縣,元長鄉,潭西村,0,1,517,9,526,968,0,0,0,0,0,0,54.34
雲林縣,元長鄉,潭東村,0,1,438,4,442,739,0,0,0,0,0,0,59.81
雲林縣,元長鄉,客厝村,0,1,505,3,508,853,0,0,0,0,0,0,59.55
雲林縣,元長鄉,卓運村,0,1,302,1,303,467,0,0,0,0,0,0,64.88
雲林縣,元長鄉,頂寮村,0,1,783,12,795,1285,0,0,0,0,0,0,61.87
雲林縣,元長鄉,下寮村,0,1,922,7,929,1544,0,0,0,0,0,0,60.17
雲林縣,元長鄉,龍岩村,0,1,823,4,827,1134,0,0,0,0,0,0,72.93
雲林縣,元長鄉,西莊村,0,1,575,5,580,926,0,0,0,0,0,0,62.63
雲林縣,元長鄉,鹿北村,0,1,898,8,906,1371,0,0,0,0,0,0,66.08
雲林縣,元長鄉,鹿南村,0,1,694,3,697,1086,0,0,0,0,0,0,64.18
雲林縣,元長鄉,瓦窯村,0,1,1100,12,1112,1691,0,0,0,0,0,0,65.76
雲林縣,元長鄉,內寮村,0,1,433,2,435,712,0,0,0,0,0,0,61.10
雲林縣,元長鄉,崙仔村,0,1,582,11,593,982,0,0,0,0,0,0,60.39
雲林縣,元長鄉,新吉村,0,1,513,3,516,772,0,0,0,0,0,0,66.84
雲林縣,四湖鄉,四湖村,0,1,1064,20,1084,1735,0,0,0,0,0,0,62.48
雲林縣,四湖鄉,湖西村,0,1,1359,20,1379,2115,0,0,0,0,0,0,65.20
雲林縣,四湖鄉,新庄村,0,1,447,5,452,720,0,0,0,0,0,0,62.78
雲林縣,四湖鄉,溪底村,0,1,723,11,734,1147,0,0,0,0,0,0,63.99
雲林縣,四湖鄉,鹿場村,0,1,662,9,671,1187,0,0,0,0,0,0,56.53
雲林縣,四湖鄉,蔡厝村,0,1,552,8,560,1021,0,0,0,0,0,0,54.85
雲林縣,四湖鄉,湖寮村,0,1,478,4,482,931,0,0,0,0,0,0,51.77
雲林縣,四湖鄉,施湖村,0,1,701,9,710,1284,0,0,0,0,0,0,55.30
雲林縣,四湖鄉,羊調村,0,1,614,6,620,1169,0,0,0,0,0,0,53.04
雲林縣,四湖鄉,內湖村,0,1,475,13,488,996,0,0,0,0,0,0,49.00
雲林縣,四湖鄉,飛東村,0,1,371,5,376,670,0,0,0,0,0,0,56.12
雲林縣,四湖鄉,飛沙村,0,1,533,5,538,1039,0,0,0,0,0,0,51.78
雲林縣,四湖鄉,三姓村,0,1,247,3,250,414,0,0,0,0,0,0,60.39
雲林縣,四湖鄉,崙北村,0,1,1049,8,1057,1816,0,0,0,0,0,0,58.20
雲林縣,四湖鄉,崙南村,0,1,538,9,547,915,0,0,0,0,0,0,59.78
雲林縣,四湖鄉,廣溝村,0,1,484,10,494,812,0,0,0,0,0,0,60.84
雲林縣,四湖鄉,箔子村,0,1,519,10,529,1023,0,0,0,0,0,0,51.71
雲林縣,四湖鄉,箔東村,0,1,635,12,647,1165,0,0,0,0,0,0,55.54
雲林縣,四湖鄉,林厝村,0,1,708,12,720,1351,0,0,0,0,0,0,53.29
雲林縣,四湖鄉,林東村,0,1,572,14,586,1095,0,0,0,0,0,0,53.52
雲林縣,四湖鄉,溪尾村,0,1,415,2,417,904,0,0,0,0,0,0,46.13
雲林縣,口湖鄉,口湖村,0,1,664,3,667,971,0,0,0,0,0,0,68.69
雲林縣,口湖鄉,湖東村,0,1,810,12,822,1252,0,0,0,0,0,0,65.65
雲林縣,口湖鄉,頂湖村,0,1,423,6,429,762,0,0,0,0,0,0,56.30
雲林縣,口湖鄉,埔南村,0,1,414,9,423,631,0,0,0,0,0,0,67.04
雲林縣,口湖鄉,埔北村,0,1,514,12,526,936,0,0,0,0,0,0,56.20
雲林縣,口湖鄉,謝厝村,0,1,642,4,646,972,0,0,0,0,0,0,66.46
雲林縣,口湖鄉,蚵寮村,0,1,916,14,930,1438,0,0,0,0,0,0,64.67
雲林縣,口湖鄉,下崙村,0,1,1071,10,1081,2012,0,0,0,0,0,0,53.73
雲林縣,口湖鄉,崙中村,0,1,963,8,971,1710,0,0,0,0,0,0,56.78
雲林縣,口湖鄉,崙東村,0,1,911,4,915,1557,0,0,0,0,0,0,58.77
雲林縣,口湖鄉,青蚶村,0,1,347,1,348,573,0,0,0,0,0,0,60.73
雲林縣,口湖鄉,港東村,0,1,911,7,918,1344,0,0,0,0,0,0,68.30
雲林縣,口湖鄉,港西村,0,1,503,10,513,776,0,0,0,0,0,0,66.11
雲林縣,口湖鄉,台子村,0,1,1056,16,1072,1539,0,0,0,0,0,0,69.66
雲林縣,口湖鄉,成龍村,0,1,670,4,674,1046,0,0,0,0,0,0,64.44
雲林縣,口湖鄉,梧南村,0,1,1241,19,1260,1867,0,0,0,0,0,0,67.49
雲林縣,口湖鄉,梧北村,0,1,843,8,851,1314,0,0,0,0,0,0,64.76
雲林縣,口湖鄉,水井村,0,1,743,3,746,1085,0,0,0,0,0,0,68.76
雲林縣,口湖鄉,後厝村,0,1,533,9,542,798,0,0,0,0,0,0,67.92
雲林縣,口湖鄉,湖口村,0,1,602,4,606,1014,0,0,0,0,0,0,59.76
雲林縣,口湖鄉,過港村,0,1,456,6,462,746,0,0,0,0,0,0,61.93
雲林縣,水林鄉,水北村,0,1,1556,28,1584,2223,0,0,0,0,0,0,71.26
雲林縣,水林鄉,水南村,0,1,1326,27,1353,1849,0,0,0,0,0,0,73.17
雲林縣,水林鄉,萬興村,0,1,578,13,591,821,0,0,0,0,0,0,71.99
雲林縣,水林鄉,尖山村,0,1,512,6,518,751,0,0,0,0,0,0,68.97
雲林縣,水林鄉,大溝村,0,1,745,7,752,1122,0,0,0,0,0,0,67.02
雲林縣,水林鄉,順興村,0,1,601,20,621,941,0,0,0,0,0,0,65.99
雲林縣,水林鄉,大山村,0,1,787,9,796,1241,0,0,0,0,0,0,64.14
雲林縣,水林鄉,後寮村,0,1,528,4,532,815,0,0,0,0,0,0,65.28
雲林縣,水林鄉,春埔村,0,1,659,2,661,1087,0,0,0,0,0,0,60.81
雲林縣,水林鄉,西井村,0,1,458,11,469,753,0,0,0,0,0,0,62.28
雲林縣,水林鄉,車港村,0,1,403,7,410,716,0,0,0,0,0,0,57.26
雲林縣,水林鄉,蘇秦村,0,1,761,12,773,1301,0,0,0,0,0,0,59.42
雲林縣,水林鄉,灣東村,0,1,462,8,470,762,0,0,0,0,0,0,61.68
雲林縣,水林鄉,灣西村,0,1,682,10,692,1103,0,0,0,0,0,0,62.74
雲林縣,水林鄉,蕃薯村,0,1,735,14,749,1079,0,0,0,0,0,0,69.42
雲林縣,水林鄉,山腳村,0,1,614,8,622,926,0,0,0,0,0,0,67.17
雲林縣,水林鄉,松北村,0,1,793,11,804,1274,0,0,0,0,0,0,63.11
雲林縣,水林鄉,松中村,0,1,393,2,395,658,0,0,0,0,0,0,60.03
雲林縣,水林鄉,松西村,0,1,541,7,548,877,0,0,0,0,0,0,62.49
雲林縣,水林鄉,舊埔村,0,1,541,12,553,921,0,0,0,0,0,0,60.04
雲林縣,水林鄉,塭底村,0,1,492,6,498,822,0,0,0,0,0,0,60.58
雲林縣,水林鄉,海埔村,0,1,719,6,725,1133,0,0,0,0,0,0,63.99
雲林縣,水林鄉,土厝村,0,1,818,13,831,1292,0,0,0,0,0,0,64.32
雲林縣,水林鄉,溪墘村,0,1,571,7,578,849,0,0,0,0,0,0,68.08
嘉義縣,太保市,太保里,0,1,1174,26,1200,1608,0,0,0,0,0,0,74.63
嘉義縣,太保市,後庄里,0,1,335,4,339,457,0,0,0,0,0,0,74.18
嘉義縣,太保市,前潭里,0,1,1009,12,1021,1352,0,0,0,0,0,0,75.52
嘉義縣,太保市,後潭里,0,1,1097,21,1118,1451,0,0,0,0,0,0,77.05
嘉義縣,太保市,梅埔里,0,1,826,10,836,1078,0,0,0,0,0,0,77.55
嘉義縣,太保市,春珠里,0,1,577,10,587,776,0,0,0,0,0,0,75.64
嘉義縣,太保市,崙頂里,0,1,574,12,586,768,0,0,0,0,0,0,76.30
嘉義縣,太保市,安仁里,0,1,580,3,583,769,0,0,0,0,0,0,75.81
嘉義縣,太保市,東勢里,0,1,635,10,645,863,0,0,0,0,0,0,74.74
嘉義縣,太保市,新埤里,0,1,866,19,885,1183,0,0,0,0,0,0,74.81
嘉義縣,太保市,舊埤里,0,1,643,9,652,947,0,0,0,0,0,0,68.85
嘉義縣,太保市,田尾里,0,1,515,11,526,726,0,0,0,0,0,0,72.45
嘉義縣,太保市,港尾里,0,1,442,2,444,561,0,0,0,0,0,0,79.14
嘉義縣,太保市,過溝里,0,1,1297,20,1317,1796,0,0,0,0,0,0,73.33
嘉義縣,太保市,麻寮里,0,1,1715,26,1741,2419,0,0,0,0,0,0,71.97
嘉義縣,太保市,南新里,0,1,1237,30,1267,1670,0,0,0,0,0,0,75.87
嘉義縣,太保市,北新里,0,1,1512,18,1530,2052,0,0,0,0,0,0,74.56
嘉義縣,太保市,埤鄉里,0,1,568,14,582,715,0,0,0,0,0,0,81.40
嘉義縣,朴子市,安福里,0,1,1126,9,1135,1739,0,0,0,0,0,0,65.27
嘉義縣,朴子市,平和里,0,1,1149,14,1163,1789,0,0,0,0,0,0,65.01
嘉義縣,朴子市,內厝里,0,1,729,12,741,1103,0,0,0,0,0,0,67.18
嘉義縣,朴子市,開元里,0,1,383,4,387,537,0,0,0,0,0,0,72.07
嘉義縣,朴子市,順天里,0,1,476,8,484,773,0,0,0,0,0,0,62.61
嘉義縣,朴子市,中正里,0,1,562,2,564,777,0,0,0,0,0,0,72.59
嘉義縣,朴子市,博厚里,0,1,497,7,504,785,0,0,0,0,0,0,64.20
嘉義縣,朴子市,文化里,0,1,1174,16,1190,1797,0,0,0,0,0,0,66.22
嘉義縣,朴子市,永和里,0,1,1579,26,1605,2331,0,0,0,0,0,0,68.85
嘉義縣,朴子市,竹圍里,0,1,2232,28,2260,3409,0,0,0,0,0,0,66.30
嘉義縣,朴子市,新寮里,0,1,461,4,465,634,0,0,0,0,0,0,73.34
嘉義縣,朴子市,雙溪里,0,1,463,7,470,729,0,0,0,0,0,0,64.47
嘉義縣,朴子市,溪口里,0,1,569,2,571,816,0,0,0,0,0,0,69.98
嘉義縣,朴子市,德興里,0,1,711,5,716,987,0,0,0,0,0,0,72.54
嘉義縣,朴子市,仁和里,0,1,335,9,344,468,0,0,0,0,0,0,73.50
嘉義縣,朴子市,大鄉里,0,1,1762,25,1787,2485,0,0,0,0,0,0,71.91
嘉義縣,朴子市,大葛里,0,1,1060,30,1090,1554,0,0,0,0,0,0,70.14
嘉義縣,朴子市,佳禾里,0,1,408,8,416,566,0,0,0,0,0,0,73.50
嘉義縣,朴子市,竹村里,0,1,565,8,573,955,0,0,0,0,0,0,60.00
嘉義縣,朴子市,崁前里,0,1,703,14,717,1019,0,0,0,0,0,0,70.36
嘉義縣,朴子市,崁後里,0,1,542,13,555,865,0,0,0,0,0,0,64.16
嘉義縣,朴子市,順安里,0,1,191,1,192,295,0,0,0,0,0,0,65.08
嘉義縣,朴子市,德家里,0,1,498,6,504,798,0,0,0,0,0,0,63.16
嘉義縣,朴子市,新庄里,0,1,394,5,399,569,0,0,0,0,0,0,70.12
嘉義縣,朴子市,梅華里,0,1,780,14,794,1184,0,0,0,0,0,0,67.06
嘉義縣,朴子市,松華里,0,1,943,15,958,1475,0,0,0,0,0,0,64.95
嘉義縣,朴子市,南竹里,0,1,360,5,365,560,0,0,0,0,0,0,65.18
嘉義縣,布袋鎮,岱江里,0,1,518,12,530,747,0,0,0,0,0,0,70.95
嘉義縣,布袋鎮,九龍里,0,1,299,5,304,435,0,0,0,0,0,0,69.89
嘉義縣,布袋鎮,岑海里,0,1,934,13,947,1353,0,0,0,0,0,0,69.99
嘉義縣,布袋鎮,興中里,0,1,799,17,816,1205,0,0,0,0,0,0,67.72
嘉義縣,布袋鎮,光復里,0,1,1259,17,1276,1804,0,0,0,0,0,0,70.73
嘉義縣,布袋鎮,見龍里,0,1,645,5,650,931,0,0,0,0,0,0,69.82
嘉義縣,布袋鎮,新厝里,0,1,588,16,604,815,0,0,0,0,0,0,74.11
嘉義縣,布袋鎮,龍江里,0,1,633,15,648,917,0,0,0,0,0,0,70.67
嘉義縣,布袋鎮,西安里,0,1,955,11,966,1437,0,0,0,0,0,0,67.22
嘉義縣,布袋鎮,中安里,0,1,988,22,1010,1616,0,0,0,0,0,0,62.50
嘉義縣,布袋鎮,東安里,0,1,1039,14,1053,1604,0,0,0,0,0,0,65.65
嘉義縣,布袋鎮,樹林里,0,1,410,4,414,618,0,0,0,0,0,0,66.99
嘉義縣,布袋鎮,貴舍里,0,1,566,5,571,793,0,0,0,0,0,0,72.01
嘉義縣,布袋鎮,永安里,0,1,824,23,847,1219,0,0,0,0,0,0,69.48
嘉義縣,布袋鎮,東港里,0,1,1263,26,1289,1951,0,0,0,0,0,0,66.07
嘉義縣,布袋鎮,江山里,0,1,256,6,262,381,0,0,0,0,0,0,68.77
嘉義縣,布袋鎮,菜舖里,0,1,304,7,311,483,0,0,0,0,0,0,64.39
嘉義縣,布袋鎮,考試里,0,1,232,1,233,375,0,0,0,0,0,0,62.13
嘉義縣,布袋鎮,振寮里,0,1,605,5,610,845,0,0,0,0,0,0,72.19
嘉義縣,布袋鎮,新岑里,0,1,727,8,735,995,0,0,0,0,0,0,73.87
嘉義縣,布袋鎮,新民里,0,1,765,12,777,1186,0,0,0,0,0,0,65.51
嘉義縣,布袋鎮,復興里,0,1,1472,23,1495,2318,0,0,0,0,0,0,64.50
嘉義縣,布袋鎮,好美里,0,1,711,19,730,1038,0,0,0,0,0,0,70.33
嘉義縣,大林鎮,東林里,0,1,361,13,374,523,0,0,0,0,0,0,71.51
嘉義縣,大林鎮,西林里,0,1,1170,21,1191,1837,0,0,0,0,0,0,64.83
嘉義縣,大林鎮,吉林里,0,1,667,10,677,958,0,0,0,0,0,0,70.67
嘉義縣,大林鎮,平林里,0,1,2783,54,2837,4439,0,0,0,0,0,0,63.91
嘉義縣,大林鎮,明華里,0,1,813,13,826,1156,0,0,0,0,0,0,71.45
嘉義縣,大林鎮,明和里,0,1,909,15,924,1285,0,0,0,0,0,0,71.91
嘉義縣,大林鎮,排路里,0,1,440,5,445,694,0,0,0,0,0,0,64.12
嘉義縣,大林鎮,西結里,0,1,528,2,530,838,0,0,0,0,0,0,63.25
嘉義縣,大林鎮,湖北里,0,1,518,7,525,715,0,0,0,0,0,0,73.43
嘉義縣,大林鎮,大糖里,0,1,249,1,250,354,0,0,0,0,0,0,70.62
嘉義縣,大林鎮,大美里,0,1,1169,19,1188,1784,0,0,0,0,0,0,66.59
嘉義縣,大林鎮,過溪里,0,1,1084,20,1104,1474,0,0,0,0,0,0,74.90
嘉義縣,大林鎮,中坑里,0,1,1126,13,1139,1590,0,0,0,0,0,0,71.64
嘉義縣,大林鎮,上林里,0,1,646,10,656,897,0,0,0,0,0,0,73.13
嘉義縣,大林鎮,中林里,0,1,1025,15,1040,1505,0,0,0,0,0,0,69.10
嘉義縣,大林鎮,三和里,0,1,1202,22,1224,1831,0,0,0,0,0,0,66.85
嘉義縣,大林鎮,溝背里,0,1,696,2,698,1002,0,0,0,0,0,0,69.66
嘉義縣,大林鎮,義和里,0,1,513,9,522,678,0,0,0,0,0,0,76.99
嘉義縣,大林鎮,內林里,0,1,608,6,614,804,0,0,0,0,0,0,76.37
嘉義縣,大林鎮,三角里,0,1,803,9,812,1153,0,0,0,0,0,0,70.42
嘉義縣,大林鎮,三村里,0,1,522,7,529,721,0,0,0,0,0,0,73.37
嘉義縣,民雄鄉,東榮村,0,1,1384,20,1404,1963,0,0,0,0,0,0,71.52
嘉義縣,民雄鄉,中樂村,0,1,1156,12,1168,1572,0,0,0,0,0,0,74.30
嘉義縣,民雄鄉,西安村,0,1,1957,17,1974,2861,0,0,0,0,0,0,69.00
嘉義縣,民雄鄉,寮頂村,0,1,1324,14,1338,1906,0,0,0,0,0,0,70.20
嘉義縣,民雄鄉,福權村,0,1,759,7,766,1060,0,0,0,0,0,0,72.26
嘉義縣,民雄鄉,東湖村,0,1,1400,15,1415,1796,0,0,0,0,0,0,78.79
嘉義縣,民雄鄉,頂崙村,0,1,919,18,937,1356,0,0,0,0,0,0,69.10
嘉義縣,民雄鄉,菁埔村,0,1,1287,9,1296,1665,0,0,0,0,0,0,77.84
嘉義縣,民雄鄉,中和村,0,1,494,3,497,669,0,0,0,0,0,0,74.29
嘉義縣,民雄鄉,平和村,0,1,512,5,517,693,0,0,0,0,0,0,74.60
嘉義縣,民雄鄉,西昌村,0,1,547,13,560,716,0,0,0,0,0,0,78.21
嘉義縣,民雄鄉,豐收村,0,1,1320,28,1348,1812,0,0,0,0,0,0,74.39
嘉義縣,民雄鄉,三興村,0,1,545,7,552,798,0,0,0,0,0,0,69.17
嘉義縣,民雄鄉,東興村,0,1,399,7,406,611,0,0,0,0,0,0,66.45
嘉義縣,民雄鄉,鎮北村,0,1,545,5,550,793,0,0,0,0,0,0,69.36
嘉義縣,民雄鄉,北斗村,0,1,2078,30,2108,2970,0,0,0,0,0,0,70.98
嘉義縣,民雄鄉,雙福村,0,1,1082,17,1099,1588,0,0,0,0,0,0,69.21
嘉義縣,民雄鄉,福樂村,0,1,2244,38,2282,3250,0,0,0,0,0,0,70.22
嘉義縣,民雄鄉,大崎村,0,1,1247,23,1270,1837,0,0,0,0,0,0,69.13
嘉義縣,民雄鄉,秀林村,0,1,1321,35,1356,1976,0,0,0,0,0,0,68.62
嘉義縣,民雄鄉,松山村,0,1,964,5,969,1559,0,0,0,0,0,0,62.16
嘉義縣,民雄鄉,興中村,0,1,1201,23,1224,1604,0,0,0,0,0,0,76.31
嘉義縣,民雄鄉,興南村,0,1,1349,21,1370,2007,0,0,0,0,0,0,68.26
嘉義縣,民雄鄉,金興村,0,1,1556,49,1605,2289,0,0,0,0,0,0,70.12
嘉義縣,民雄鄉,福興村,0,1,1139,15,1154,1607,0,0,0,0,0,0,71.81
嘉義縣,民雄鄉,文隆村,0,1,1268,17,1285,1871,0,0,0,0,0,0,68.68
嘉義縣,民雄鄉,山中村,0,1,2212,39,2251,2977,0,0,0,0,0,0,75.61
嘉義縣,民雄鄉,中央村,0,1,877,6,883,1172,0,0,0,0,0,0,75.34
嘉義縣,溪口鄉,溪東村,0,1,902,21,923,1371,0,0,0,0,0,0,67.32
嘉義縣,溪口鄉,溪西村,0,1,502,9,511,783,0,0,0,0,0,0,65.26
嘉義縣,溪口鄉,溪北村,0,1,451,7,458,727,0,0,0,0,0,0,63.00
嘉義縣,溪口鄉,柴林村,0,1,522,4,526,877,0,0,0,0,0,0,59.98
嘉義縣,溪口鄉,林腳村,0,1,570,4,574,916,0,0,0,0,0,0,62.66
嘉義縣,溪口鄉,美南村,0,1,737,11,748,1248,0,0,0,0,0,0,59.94
嘉義縣,溪口鄉,美北村,0,1,621,7,628,1016,0,0,0,0,0,0,61.81
嘉義縣,溪口鄉,本厝村,0,1,673,10,683,986,0,0,0,0,0,0,69.27
嘉義縣,溪口鄉,游東村,0,1,671,9,680,1090,0,0,0,0,0,0,62.39
嘉義縣,溪口鄉,游西村,0,1,488,11,499,782,0,0,0,0,0,0,63.81
嘉義縣,溪口鄉,柳溝村,0,1,895,14,909,1280,0,0,0,0,0,0,71.02
嘉義縣,溪口鄉,疊溪村,0,1,630,9,639,965,0,0,0,0,0,0,66.22
嘉義縣,溪口鄉,妙崙村,0,1,475,7,482,728,0,0,0,0,0,0,66.21
嘉義縣,溪口鄉,坪頂村,0,1,624,12,636,903,0,0,0,0,0,0,70.43
嘉義縣,新港鄉,宮前村,0,1,1099,10,1109,1645,0,0,0,0,0,0,67.42
嘉義縣,新港鄉,宮後村,0,1,1024,9,1033,1672,0,0,0,0,0,0,61.78
嘉義縣,新港鄉,大興村,0,1,886,13,899,1380,0,0,0,0,0,0,65.14
嘉義縣,新港鄉,福德村,0,1,891,13,904,1447,0,0,0,0,0,0,62.47
嘉義縣,新港鄉,古民村,0,1,721,11,732,1167,0,0,0,0,0,0,62.72
嘉義縣,新港鄉,中庄村,0,1,931,11,942,1501,0,0,0,0,0,0,62.76
嘉義縣,新港鄉,大潭村,0,1,1077,14,1091,1616,0,0,0,0,0,0,67.51
嘉義縣,新港鄉,西庄村,0,1,603,6,609,941,0,0,0,0,0,0,64.72
嘉義縣,新港鄉,月眉村,0,1,1115,26,1141,1630,0,0,0,0,0,0,70.00
嘉義縣,新港鄉,月潭村,0,1,967,16,983,1432,0,0,0,0,0,0,68.65
嘉義縣,新港鄉,溪北村,0,1,963,22,985,1393,0,0,0,0,0,0,70.71
嘉義縣,新港鄉,菜公村,0,1,560,5,565,854,0,0,0,0,0,0,66.16
嘉義縣,新港鄉,中洋村,0,1,671,21,692,968,0,0,0,0,0,0,71.49
嘉義縣,新港鄉,三間村,0,1,509,9,518,755,0,0,0,0,0,0,68.61
嘉義縣,新港鄉,安和村,0,1,804,12,816,1156,0,0,0,0,0,0,70.59
嘉義縣,新港鄉,潭大村,0,1,708,10,718,1117,0,0,0,0,0,0,64.28
嘉義縣,新港鄉,南港村,0,1,674,27,701,1090,0,0,0,0,0,0,64.31
嘉義縣,新港鄉,板頭村,0,1,432,6,438,627,0,0,0,0,0,0,69.86
嘉義縣,新港鄉,共和村,0,1,493,8,501,793,0,0,0,0,0,0,63.18
嘉義縣,新港鄉,埤子村,0,1,408,3,411,600,0,0,0,0,0,0,68.50
嘉義縣,新港鄉,南崙村,0,1,648,3,651,969,0,0,0,0,0,0,67.18
嘉義縣,新港鄉,北崙村,0,1,397,3,400,611,0,0,0,0,0,0,65.47
嘉義縣,新港鄉,海瀛村,0,1,342,9,351,513,0,0,0,0,0,0,68.42
嘉義縣,六腳鄉,蒜頭村,0,1,888,16,904,1273,0,0,0,0,0,0,71.01
嘉義縣,六腳鄉,蒜東村,0,1,584,9,593,936,0,0,0,0,0,0,63.35
嘉義縣,六腳鄉,蒜南村,0,1,580,11,591,881,0,0,0,0,0,0,67.08
嘉義縣,六腳鄉,工廠村,0,1,274,5,279,374,0,0,0,0,0,0,74.60
嘉義縣,六腳鄉,灣南村,0,1,848,10,858,1251,0,0,0,0,0,0,68.59
嘉義縣,六腳鄉,灣北村,0,1,851,20,871,1365,0,0,0,0,0,0,63.81
嘉義縣,六腳鄉,雙涵村,0,1,571,11,582,902,0,0,0,0,0,0,64.52
嘉義縣,六腳鄉,塗師村,0,1,472,5,477,752,0,0,0,0,0,0,63.43
嘉義縣,六腳鄉,三義村,0,1,507,10,517,812,0,0,0,0,0,0,63.67
嘉義縣,六腳鄉,正義村,0,1,984,16,1000,1457,0,0,0,0,0,0,68.63
嘉義縣,六腳鄉,溪厝村,0,1,394,5,399,666,0,0,0,0,0,0,59.91
嘉義縣,六腳鄉,港美村,0,1,529,6,535,788,0,0,0,0,0,0,67.89
嘉義縣,六腳鄉,豐美村,0,1,708,2,710,1106,0,0,0,0,0,0,64.20
嘉義縣,六腳鄉,六斗村,0,1,583,8,591,851,0,0,0,0,0,0,69.45
嘉義縣,六腳鄉,崙陽村,0,1,678,14,692,1065,0,0,0,0,0,0,64.98
嘉義縣,六腳鄉,蘇厝村,0,1,935,8,943,1394,0,0,0,0,0,0,67.65
嘉義縣,六腳鄉,竹本村,0,1,449,4,453,748,0,0,0,0,0,0,60.56
嘉義縣,六腳鄉,永賢村,0,1,361,5,366,608,0,0,0,0,0,0,60.20
嘉義縣,六腳鄉,魚寮村,0,1,481,2,483,845,0,0,0,0,0,0,57.16
嘉義縣,六腳鄉,潭墘村,0,1,591,17,608,964,0,0,0,0,0,0,63.07
嘉義縣,六腳鄉,六腳村,0,1,608,9,617,939,0,0,0,0,0,0,65.71
嘉義縣,六腳鄉,六南村,0,1,442,9,451,694,0,0,0,0,0,0,64.99
嘉義縣,六腳鄉,崩山村,0,1,520,9,529,836,0,0,0,0,0,0,63.28
嘉義縣,六腳鄉,古林村,0,1,599,4,603,929,0,0,0,0,0,0,64.91
嘉義縣,六腳鄉,更寮村,0,1,423,5,428,680,0,0,0,0,0,0,62.94
嘉義縣,東石鄉,東石村,0,1,1176,18,1194,1658,0,0,0,0,0,0,72.01
嘉義縣,東石鄉,猿樹村,0,1,672,17,689,1009,0,0,0,0,0,0,68.29
嘉義縣,東石鄉,塭港村,0,1,1013,20,1033,1518,0,0,0,0,0,0,68.05
嘉義縣,東石鄉,型厝村,0,1,1125,16,1141,1486,0,0,0,0,0,0,76.78
嘉義縣,東石鄉,三家村,0,1,776,10,786,1250,0,0,0,0,0,0,62.88
嘉義縣,東石鄉,永屯村,0,1,447,9,456,732,0,0,0,0,0,0,62.30
嘉義縣,東石鄉,海埔村,0,1,309,1,310,482,0,0,0,0,0,0,64.32
嘉義縣,東石鄉,龍港村,0,1,633,5,638,1035,0,0,0,0,0,0,61.64
嘉義縣,東石鄉,副瀨村,0,1,768,10,778,1138,0,0,0,0,0,0,68.37
嘉義縣,東石鄉,下揖村,0,1,574,5,579,928,0,0,0,0,0,0,62.39
嘉義縣,東石鄉,頂揖村,0,1,257,0,257,448,0,0,0,0,0,0,57.37
嘉義縣,東石鄉,溪下村,0,1,700,3,703,1107,0,0,0,0,0,0,63.50
嘉義縣,東石鄉,港口村,0,1,258,1,259,400,0,0,0,0,0,0,64.75
嘉義縣,東石鄉,鰲鼓村,0,1,889,14,903,1370,0,0,0,0,0,0,65.91
嘉義縣,東石鄉,港墘村,0,1,898,11,909,1289,0,0,0,0,0,0,70.52
嘉義縣,東石鄉,蔦松村,0,1,618,13,631,924,0,0,0,0,0,0,68.29
嘉義縣,東石鄉,圍潭村,0,1,508,4,512,791,0,0,0,0,0,0,64.73
嘉義縣,東石鄉,洲仔村,0,1,605,6,611,947,0,0,0,0,0,0,64.52
嘉義縣,東石鄉,東崙村,0,1,506,8,514,817,0,0,0,0,0,0,62.91
嘉義縣,東石鄉,西崙村,0,1,690,15,705,1024,0,0,0,0,0,0,68.85
嘉義縣,東石鄉,塭仔村,0,1,676,9,685,993,0,0,0,0,0,0,68.98
嘉義縣,東石鄉,網寮村,0,1,862,15,877,1236,0,0,0,0,0,0,70.95
嘉義縣,東石鄉,掌潭村,0,1,564,6,570,836,0,0,0,0,0,0,68.18
嘉義縣,義竹鄉,岸腳村,0,1,616,15,631,872,0,0,0,0,0,0,72.36
嘉義縣,義竹鄉,義竹村,0,1,1137,9,1146,1568,0,0,0,0,0,0,73.09
嘉義縣,義竹鄉,六桂村,0,1,1007,18,1025,1393,0,0,0,0,0,0,73.58
嘉義縣,義竹鄉,仁里村,0,1,705,6,711,909,0,0,0,0,0,0,78.22
嘉義縣,義竹鄉,傳芳村,0,1,504,11,515,703,0,0,0,0,0,0,73.26
嘉義縣,義竹鄉,頭竹村,0,1,952,12,964,1291,0,0,0,0,0,0,74.67
嘉義縣,義竹鄉,五厝村,0,1,290,2,292,434,0,0,0,0,0,0,67.28
嘉義縣,義竹鄉,中平村,0,1,365,2,367,523,0,0,0,0,0,0,70.17
嘉義縣,義竹鄉,埤前村,0,1,594,6,600,833,0,0,0,0,0,0,72.03
嘉義縣,義竹鄉,平溪村,0,1,303,3,306,433,0,0,0,0,0,0,70.67
嘉義縣,義竹鄉,後鎮村,0,1,380,3,383,510,0,0,0,0,0,0,75.10
嘉義縣,義竹鄉,北華村,0,1,407,5,412,580,0,0,0,0,0,0,71.03
嘉義縣,義竹鄉,新店村,0,1,1153,6,1159,1507,0,0,0,0,0,0,76.91
嘉義縣,義竹鄉,東過村,0,1,617,7,624,882,0,0,0,0,0,0,70.75
嘉義縣,義竹鄉,西過村,0,1,632,6,638,947,0,0,0,0,0,0,67.37
嘉義縣,義竹鄉,官和村,0,1,623,2,625,849,0,0,0,0,0,0,73.62
嘉義縣,義竹鄉,官順村,0,1,377,9,386,554,0,0,0,0,0,0,69.68
嘉義縣,義竹鄉,新富村,0,1,439,10,449,572,0,0,0,0,0,0,78.50
嘉義縣,義竹鄉,東光村,0,1,659,2,661,919,0,0,0,0,0,0,71.93
嘉義縣,義竹鄉,東榮村,0,1,359,3,362,526,0,0,0,0,0,0,68.82
嘉義縣,義竹鄉,龍蛟村,0,1,515,4,519,761,0,0,0,0,0,0,68.20
嘉義縣,義竹鄉,溪洲村,0,1,552,6,558,797,0,0,0,0,0,0,70.01
嘉義縣,鹿草鄉,後寮村,0,1,364,9,373,497,0,0,0,0,0,0,75.05
嘉義縣,鹿草鄉,鹿東村,0,1,471,7,478,641,0,0,0,0,0,0,74.57
嘉義縣,鹿草鄉,鹿草村,0,1,902,21,923,1269,0,0,0,0,0,0,72.73
嘉義縣,鹿草鄉,西井村,0,1,806,23,829,1166,0,0,0,0,0,0,71.10
嘉義縣,鹿草鄉,豐稠村,0,1,272,4,276,412,0,0,0,0,0,0,66.99
嘉義縣,鹿草鄉,重寮村,0,1,773,11,784,1149,0,0,0,0,0,0,68.23
嘉義縣,鹿草鄉,施家村,0,1,369,2,371,553,0,0,0,0,0,0,67.09
嘉義縣,鹿草鄉,下潭村,0,1,615,15,630,955,0,0,0,0,0,0,65.97
嘉義縣,鹿草鄉,光潭村,0,1,793,16,809,1162,0,0,0,0,0,0,69.62
嘉義縣,鹿草鄉,碧潭村,0,1,713,12,725,1113,0,0,0,0,0,0,65.14
嘉義縣,鹿草鄉,松竹村,0,1,676,14,690,941,0,0,0,0,0,0,73.33
嘉義縣,鹿草鄉,竹山村,0,1,631,8,639,920,0,0,0,0,0,0,69.46
嘉義縣,鹿草鄉,後堀村,0,1,976,18,994,1337,0,0,0,0,0,0,74.35
嘉義縣,鹿草鄉,三角村,0,1,1098,23,1121,1547,0,0,0,0,0,0,72.46
嘉義縣,鹿草鄉,下麻村,0,1,428,5,433,589,0,0,0,0,0,0,73.51
嘉義縣,水上鄉,水上村,0,1,1869,40,1909,2732,0,0,0,0,0,0,69.88
嘉義縣,水上鄉,水頭村,0,1,1332,24,1356,1886,0,0,0,0,0,0,71.90
嘉義縣,水上鄉,粗溪村,0,1,1009,20,1029,1427,0,0,0,0,0,0,72.11
嘉義縣,水上鄉,下寮村,0,1,1115,26,1141,1562,0,0,0,0,0,0,73.05
嘉義縣,水上鄉,三和村,0,1,1242,26,1268,1729,0,0,0,0,0,0,73.34
嘉義縣,水上鄉,回歸村,0,1,508,14,522,682,0,0,0,0,0,0,76.54
嘉義縣,水上鄉,大堀村,0,1,1033,12,1045,1355,0,0,0,0,0,0,77.12
嘉義縣,水上鄉,大崙村,0,1,1286,18,1304,1828,0,0,0,0,0,0,71.33
嘉義縣,水上鄉,塗溝村,0,1,641,7,648,797,0,0,0,0,0,0,81.30
嘉義縣,水上鄉,龍德村,0,1,1282,25,1307,1680,0,0,0,0,0,0,77.80
嘉義縣,水上鄉,溪洲村,0,1,741,8,749,1030,0,0,0,0,0,0,72.72
嘉義縣,水上鄉,三鎮村,0,1,489,7,496,635,0,0,0,0,0,0,78.11
嘉義縣,水上鄉,靖和村,0,1,441,5,446,558,0,0,0,0,0,0,79.93
嘉義縣,水上鄉,南和村,0,1,893,17,910,1210,0,0,0,0,0,0,75.21
嘉義縣,水上鄉,柳新村,0,1,1529,32,1561,2149,0,0,0,0,0,0,72.64
嘉義縣,水上鄉,柳林村,0,1,1120,28,1148,1704,0,0,0,0,0,0,67.37
嘉義縣,水上鄉,柳鄉村,0,1,1181,33,1214,1739,0,0,0,0,0,0,69.81
嘉義縣,水上鄉,內溪村,0,1,693,12,705,974,0,0,0,0,0,0,72.38
嘉義縣,水上鄉,寬士村,0,1,2029,47,2076,3208,0,0,0,0,0,0,64.71
嘉義縣,水上鄉,民生村,0,1,1873,43,1916,2826,0,0,0,0,0,0,67.80
嘉義縣,水上鄉,義興村,0,1,547,15,562,759,0,0,0,0,0,0,74.04
嘉義縣,水上鄉,中庄村,0,1,1228,30,1258,1755,0,0,0,0,0,0,71.68
嘉義縣,水上鄉,忠和村,0,1,1243,30,1273,1772,0,0,0,0,0,0,71.84
嘉義縣,水上鄉,南鄉村,0,1,583,19,602,805,0,0,0,0,0,0,74.78
嘉義縣,水上鄉,三界村,0,1,746,14,760,1040,0,0,0,0,0,0,73.08
嘉義縣,水上鄉,國姓村,0,1,854,23,877,1307,0,0,0,0,0,0,67.10
嘉義縣,中埔鄉,中埔村,0,1,1136,18,1154,1580,0,0,0,0,0,0,73.04
嘉義縣,中埔鄉,鹽館村,0,1,525,7,532,758,0,0,0,0,0,0,70.18
嘉義縣,中埔鄉,龍門村,0,1,509,13,522,729,0,0,0,0,0,0,71.60
嘉義縣,中埔鄉,裕民村,0,1,534,6,540,844,0,0,0,0,0,0,63.98
嘉義縣,中埔鄉,金蘭村,0,1,836,10,846,1317,0,0,0,0,0,0,64.24
嘉義縣,中埔鄉,富收村,0,1,1437,24,1461,2409,0,0,0,0,0,0,60.65
嘉義縣,中埔鄉,和睦村,0,1,1361,36,1397,2244,0,0,0,0,0,0,62.25
嘉義縣,中埔鄉,和美村,0,1,3025,72,3097,5001,0,0,0,0,0,0,61.93
嘉義縣,中埔鄉,和興村,0,1,2676,71,2747,4566,0,0,0,0,0,0,60.16
嘉義縣,中埔鄉,隆興村,0,1,1121,15,1136,1653,0,0,0,0,0,0,68.72
嘉義縣,中埔鄉,義仁村,0,1,866,10,876,1240,0,0,0,0,0,0,70.65
嘉義縣,中埔鄉,社口村,0,1,1319,25,1344,2031,0,0,0,0,0,0,66.17
嘉義縣,中埔鄉,灣潭村,0,1,824,11,835,1099,0,0,0,0,0,0,75.98
嘉義縣,中埔鄉,石弄村,0,1,883,6,889,1164,0,0,0,0,0,0,76.37
嘉義縣,中埔鄉,頂埔村,0,1,672,17,689,910,0,0,0,0,0,0,75.71
嘉義縣,中埔鄉,同仁村,0,1,1264,21,1285,1861,0,0,0,0,0,0,69.05
嘉義縣,中埔鄉,深坑村,0,1,542,11,553,738,0,0,0,0,0,0,74.93
嘉義縣,中埔鄉,三層村,0,1,445,10,455,612,0,0,0,0,0,0,74.35
嘉義縣,中埔鄉,瑞豐村,0,1,519,7,526,687,0,0,0,0,0,0,76.56
嘉義縣,中埔鄉,沄水村,0,1,754,12,766,1104,0,0,0,0,0,0,69.38
嘉義縣,中埔鄉,東興村,0,1,185,2,187,336,0,0,0,0,0,0,55.65
嘉義縣,中埔鄉,中崙村,0,1,233,8,241,319,0,0,0,0,0,0,75.55
嘉義縣,竹崎鄉,竹崎村,0,1,1420,19,1439,2095,0,0,0,0,0,0,68.69
嘉義縣,竹崎鄉,和平村,0,1,1261,18,1279,1765,0,0,0,0,0,0,72.46
嘉義縣,竹崎鄉,坑頭村,0,1,555,11,566,741,0,0,0,0,0,0,76.38
嘉義縣,竹崎鄉,沙坑村,0,1,632,7,639,851,0,0,0,0,0,0,75.09
嘉義縣,竹崎鄉,獅埜村,0,1,908,16,924,1261,0,0,0,0,0,0,73.28
嘉義縣,竹崎鄉,義和村,0,1,428,5,433,566,0,0,0,0,0,0,76.50
嘉義縣,竹崎鄉,義仁村,0,1,740,11,751,1061,0,0,0,0,0,0,70.78
嘉義縣,竹崎鄉,灣橋村,0,1,2707,45,2752,4296,0,0,0,0,0,0,64.06
嘉義縣,竹崎鄉,鹿滿村,0,1,821,12,833,1224,0,0,0,0,0,0,68.06
嘉義縣,竹崎鄉,紫雲村,0,1,862,13,875,1298,0,0,0,0,0,0,67.41
嘉義縣,竹崎鄉,內埔村,0,1,1129,16,1145,1633,0,0,0,0,0,0,70.12
嘉義縣,竹崎鄉,昇平村,0,1,1243,22,1265,1686,0,0,0,0,0,0,75.03
嘉義縣,竹崎鄉,桃源村,0,1,737,9,746,1066,0,0,0,0,0,0,69.98
嘉義縣,竹崎鄉,白杞村,0,1,468,4,472,762,0,0,0,0,0,0,61.94
嘉義縣,竹崎鄉,塘興村,0,1,642,16,658,878,0,0,0,0,0,0,74.94
嘉義縣,竹崎鄉,義隆村,0,1,421,3,424,558,0,0,0,0,0,0,75.99
嘉義縣,竹崎鄉,龍山村,0,1,1159,24,1183,1611,0,0,0,0,0,0,73.43
嘉義縣,竹崎鄉,文峰村,0,1,533,10,543,783,0,0,0,0,0,0,69.35
嘉義縣,竹崎鄉,金獅村,0,1,328,3,331,501,0,0,0,0,0,0,66.07
嘉義縣,竹崎鄉,復金村,0,1,1258,15,1273,1801,0,0,0,0,0,0,70.68
嘉義縣,竹崎鄉,緞繻村,0,1,657,7,664,1084,0,0,0,0,0,0,61.25
嘉義縣,竹崎鄉,仁壽村,0,1,171,1,172,312,0,0,0,0,0,0,55.13
嘉義縣,竹崎鄉,中和村,0,1,452,2,454,790,0,0,0,0,0,0,57.47
嘉義縣,竹崎鄉,光華村,0,1,499,6,505,755,0,0,0,0,0,0,66.89
嘉義縣,梅山鄉,梅東村,0,1,1667,34,1701,2424,0,0,0,0,0,0,70.17
嘉義縣,梅山鄉,梅南村,0,1,741,9,750,1005,0,0,0,0,0,0,74.63
嘉義縣,梅山鄉,梅北村,0,1,2363,48,2411,3496,0,0,0,0,0,0,68.96
嘉義縣,梅山鄉,過山村,0,1,447,5,452,601,0,0,0,0,0,0,75.21
嘉義縣,梅山鄉,圳南村,0,1,385,6,391,525,0,0,0,0,0,0,74.48
嘉義縣,梅山鄉,圳北村,0,1,461,6,467,679,0,0,0,0,0,0,68.78
嘉義縣,梅山鄉,雙溪村,0,1,460,3,463,573,0,0,0,0,0,0,80.80
嘉義縣,梅山鄉,大南村,0,1,1130,15,1145,1662,0,0,0,0,0,0,68.89
嘉義縣,梅山鄉,安靖村,0,1,685,6,691,960,0,0,0,0,0,0,71.98
嘉義縣,梅山鄉,永興村,0,1,358,3,361,527,0,0,0,0,0,0,68.50
嘉義縣,梅山鄉,半天村,0,1,378,12,390,500,0,0,0,0,0,0,78.00
嘉義縣,梅山鄉,太平村,0,1,353,8,361,505,0,0,0,0,0,0,71.49
嘉義縣,梅山鄉,太興村,0,1,296,3,299,424,0,0,0,0,0,0,70.52
嘉義縣,梅山鄉,龍眼村,0,1,316,6,322,485,0,0,0,0,0,0,66.39
嘉義縣,梅山鄉,碧湖村,0,1,198,1,199,322,0,0,0,0,0,0,61.80
嘉義縣,梅山鄉,瑞峰村,0,1,520,5,525,732,0,0,0,0,0,0,71.72
嘉義縣,梅山鄉,瑞里村,0,1,556,15,571,754,0,0,0,0,0,0,75.73
嘉義縣,梅山鄉,太和村,0,1,706,11,717,1034,0,0,0,0,0,0,69.34
嘉義縣,番路鄉,江西村,0,1,695,11,706,962,0,0,0,0,0,0,73.39
嘉義縣,番路鄉,內甕村,0,1,239,3,242,362,0,0,0,0,0,0,66.85
嘉義縣,番路鄉,新福村,0,1,560,4,564,782,0,0,0,0,0,0,72.12
嘉義縣,番路鄉,下坑村,0,1,976,14,990,1569,0,0,0,0,0,0,63.10
嘉義縣,番路鄉,番路村,0,1,597,7,604,799,0,0,0,0,0,0,75.59
嘉義縣,番路鄉,民和村,0,1,555,4,559,786,0,0,0,0,0,0,71.12
嘉義縣,番路鄉,觸口村,0,1,571,8,579,856,0,0,0,0,0,0,67.64
嘉義縣,番路鄉,大湖村,0,1,455,5,460,865,0,0,0,0,0,0,53.18
嘉義縣,番路鄉,公田村,0,1,554,9,563,921,0,0,0,0,0,0,61.13
嘉義縣,番路鄉,公興村,0,1,331,2,333,617,0,0,0,0,0,0,53.97
嘉義縣,番路鄉,草山村,0,1,228,1,229,391,0,0,0,0,0,0,58.57
嘉義縣,大埔鄉,大埔村,0,1,544,4,548,992,0,0,0,0,0,0,55.24
嘉義縣,大埔鄉,和平村,0,1,257,2,259,474,0,0,0,0,0,0,54.64
嘉義縣,大埔鄉,永樂村,0,1,188,3,191,294,0,0,0,0,0,0,64.97
嘉義縣,大埔鄉,茄苳村,0,1,386,7,393,729,0,0,0,0,0,0,53.91
嘉義縣,大埔鄉,西興村,0,1,205,2,207,382,0,0,0,0,0,0,54.19
嘉義縣,阿里山鄉,中山村,0,1,198,3,201,362,0,0,0,0,0,0,55.52
嘉義縣,阿里山鄉,中正村,0,1,97,0,97,186,0,0,0,0,0,0,52.15
嘉義縣,阿里山鄉,香林村,0,1,125,0,125,221,0,0,0,0,0,0,56.56
嘉義縣,阿里山鄉,十字村,0,1,135,0,135,300,0,0,0,0,0,0,45.00
嘉義縣,阿里山鄉,豐山村,0,1,178,4,182,263,0,0,0,0,0,0,69.20
嘉義縣,阿里山鄉,達邦村,0,1,69,1,70,141,0,0,0,0,0,0,49.65
嘉義縣,阿里山鄉,樂野村,0,1,165,6,171,260,0,0,0,0,0,0,65.77
嘉義縣,阿里山鄉,來吉村,0,1,16,0,16,22,0,0,0,0,0,0,72.73
嘉義縣,阿里山鄉,里佳村,0,1,12,0,12,23,0,0,0,0,0,0,52.17
嘉義縣,阿里山鄉,山美村,0,1,10,1,11,27,0,0,0,0,0,0,40.74
嘉義縣,阿里山鄉,新美村,0,1,11,0,11,20,0,0,0,0,0,0,55.00
嘉義縣,阿里山鄉,茶山村,0,1,53,0,53,95,0,0,0,0,0,0,55.79
臺南縣,新營市,忠政里,0,1,2352,28,2380,4005,0,0,0,0,0,0,59.43
臺南縣,新營市,民權里,0,1,1453,16,1469,2434,0,0,0,0,0,0,60.35
臺南縣,新營市,三仙里,0,1,1587,23,1610,2695,0,0,0,0,0,0,59.74
臺南縣,新營市,好平里,0,1,523,8,531,915,0,0,0,0,0,0,58.03
臺南縣,新營市,延平里,0,1,766,12,778,1316,0,0,0,0,0,0,59.12
臺南縣,新營市,永生里,0,1,668,6,674,1019,0,0,0,0,0,0,66.14
臺南縣,新營市,大宏里,0,1,1787,22,1809,3184,0,0,0,0,0,0,56.82
臺南縣,新營市,王公里,0,1,2938,45,2983,5134,0,0,0,0,0,0,58.10
臺南縣,新營市,中營里,0,1,483,7,490,825,0,0,0,0,0,0,59.39
臺南縣,新營市,土庫里,0,1,837,13,850,1387,0,0,0,0,0,0,61.28
臺南縣,新營市,興安里,0,1,339,3,342,553,0,0,0,0,0,0,61.84
臺南縣,新營市,南興里,0,1,1431,13,1444,2406,0,0,0,0,0,0,60.02
臺南縣,新營市,興業里,0,1,931,10,941,1426,0,0,0,0,0,0,65.99
臺南縣,新營市,民生里,0,1,1597,18,1615,2915,0,0,0,0,0,0,55.40
臺南縣,新營市,新北里,0,1,1612,21,1633,2813,0,0,0,0,0,0,58.05
臺南縣,新營市,新南里,0,1,1211,18,1229,2177,0,0,0,0,0,0,56.45
臺南縣,新營市,民榮里,0,1,2096,26,2122,3684,0,0,0,0,0,0,57.60
臺南縣,新營市,埤寮里,0,1,967,6,973,1488,0,0,0,0,0,0,65.39
臺南縣,新營市,護鎮里,0,1,742,6,748,1210,0,0,0,0,0,0,61.82
臺南縣,新營市,太南里,0,1,822,14,836,1380,0,0,0,0,0,0,60.58
臺南縣,新營市,太北里,0,1,928,9,937,1481,0,0,0,0,0,0,63.27
臺南縣,新營市,南紙里,0,1,1521,22,1543,2490,0,0,0,0,0,0,61.97
臺南縣,新營市,嘉芳里,0,1,865,22,887,1369,0,0,0,0,0,0,64.79
臺南縣,新營市,舊埔里,0,1,241,2,243,362,0,0,0,0,0,0,67.13
臺南縣,新營市,角帶里,0,1,344,4,348,453,0,0,0,0,0,0,76.82
臺南縣,新營市,鐵線里,0,1,508,11,519,746,0,0,0,0,0,0,69.57
臺南縣,新營市,五興里,0,1,657,13,670,970,0,0,0,0,0,0,69.07
臺南縣,新營市,姑爺里,0,1,397,3,400,572,0,0,0,0,0,0,69.93
臺南縣,鹽水鎮,水秀里,0,1,830,8,838,1317,0,0,0,0,0,0,63.63
臺南縣,鹽水鎮,福得里,0,1,365,5,370,528,0,0,0,0,0,0,70.08
臺南縣,鹽水鎮,三生里,0,1,265,2,267,388,0,0,0,0,0,0,68.81
臺南縣,鹽水鎮,武廟里,0,1,384,3,387,598,0,0,0,0,0,0,64.72
臺南縣,鹽水鎮,中境里,0,1,372,4,376,545,0,0,0,0,0,0,68.99
臺南縣,鹽水鎮,水仙里,0,1,286,1,287,418,0,0,0,0,0,0,68.66
臺南縣,鹽水鎮,水正里,0,1,500,8,508,772,0,0,0,0,0,0,65.80
臺南縣,鹽水鎮,橋南里,0,1,1697,30,1727,2971,0,0,0,0,0,0,58.13
臺南縣,鹽水鎮,舊營里,0,1,422,8,430,729,0,0,0,0,0,0,58.98
臺南縣,鹽水鎮,汫水里,0,1,637,8,645,996,0,0,0,0,0,0,64.76
臺南縣,鹽水鎮,岸內里,0,1,2011,24,2035,3062,0,0,0,0,0,0,66.46
臺南縣,鹽水鎮,義稠里,0,1,457,6,463,619,0,0,0,0,0,0,74.80
臺南縣,鹽水鎮,下中里,0,1,477,1,478,774,0,0,0,0,0,0,61.76
臺南縣,鹽水鎮,歡雅里,0,1,1002,14,1016,1574,0,0,0,0,0,0,64.55
臺南縣,鹽水鎮,大莊里,0,1,327,7,334,543,0,0,0,0,0,0,61.51
臺南縣,鹽水鎮,桐寮里,0,1,204,3,207,292,0,0,0,0,0,0,70.89
臺南縣,鹽水鎮,後宅里,0,1,439,5,444,695,0,0,0,0,0,0,63.88
臺南縣,鹽水鎮,孫厝里,0,1,290,6,296,480,0,0,0,0,0,0,61.67
臺南縣,鹽水鎮,竹埔里,0,1,588,10,598,855,0,0,0,0,0,0,69.94
臺南縣,鹽水鎮,下林里,0,1,275,6,281,424,0,0,0,0,0,0,66.27
臺南縣,鹽水鎮,田寮里,0,1,181,2,183,290,0,0,0,0,0,0,63.10
臺南縣,鹽水鎮,大豐里,0,1,287,3,290,382,0,0,0,0,0,0,75.92
臺南縣,鹽水鎮,飯店里,0,1,299,2,301,437,0,0,0,0,0,0,68.88
臺南縣,鹽水鎮,河南里,0,1,396,7,403,628,0,0,0,0,0,0,64.17
臺南縣,鹽水鎮,南港里,0,1,676,10,686,944,0,0,0,0,0,0,72.67
臺南縣,白河鎮,白河里,0,1,1083,11,1094,1882,0,0,0,0,0,0,58.13
臺南縣,白河鎮,永安里,0,1,1488,18,1506,2665,0,0,0,0,0,0,56.51
臺南縣,白河鎮,外角里,0,1,887,15,902,1426,0,0,0,0,0,0,63.25
臺南縣,白河鎮,庄內里,0,1,904,9,913,1460,0,0,0,0,0,0,62.53
臺南縣,白河鎮,秀祐里,0,1,516,6,522,850,0,0,0,0,0,0,61.41
臺南縣,白河鎮,河東里,0,1,790,15,805,1347,0,0,0,0,0,0,59.76
臺南縣,白河鎮,虎山里,0,1,270,3,273,478,0,0,0,0,0,0,57.11
臺南縣,白河鎮,大林里,0,1,385,2,387,636,0,0,0,0,0,0,60.85
臺南縣,白河鎮,崁頭里,0,1,336,5,341,504,0,0,0,0,0,0,67.66
臺南縣,白河鎮,六溪里,0,1,352,4,356,667,0,0,0,0,0,0,53.37
臺南縣,白河鎮,關嶺里,0,1,718,8,726,1284,0,0,0,0,0,0,56.54
臺南縣,白河鎮,仙草里,0,1,1422,24,1446,2308,0,0,0,0,0,0,62.65
臺南縣,白河鎮,玉豐里,0,1,796,9,805,1193,0,0,0,0,0,0,67.48
臺南縣,白河鎮,大竹里,0,1,879,6,885,1345,0,0,0,0,0,0,65.80
臺南縣,白河鎮,詔安里,0,1,578,11,589,889,0,0,0,0,0,0,66.25
臺南縣,白河鎮,廣安里,0,1,419,6,425,693,0,0,0,0,0,0,61.33
臺南縣,白河鎮,蓮潭里,0,1,622,8,630,922,0,0,0,0,0,0,68.33
臺南縣,白河鎮,竹門里,0,1,607,6,613,958,0,0,0,0,0,0,63.99
臺南縣,白河鎮,崎內里,0,1,515,2,517,822,0,0,0,0,0,0,62.90
臺南縣,白河鎮,昇安里,0,1,816,8,824,1282,0,0,0,0,0,0,64.27
臺南縣,白河鎮,汴頭里,0,1,465,6,471,771,0,0,0,0,0,0,61.09
臺南縣,白河鎮,內角里,0,1,515,7,522,792,0,0,0,0,0,0,65.91
臺南縣,白河鎮,草店里,0,1,585,7,592,932,0,0,0,0,0,0,63.52
臺南縣,白河鎮,甘宅里,0,1,425,5,430,719,0,0,0,0,0,0,59.81
臺南縣,柳營鄉,士林村,0,1,940,11,951,1424,0,0,0,0,0,0,66.78
臺南縣,柳營鄉,光福村,0,1,1171,19,1190,1753,0,0,0,0,0,0,67.88
臺南縣,柳營鄉,中埕村,0,1,500,5,505,704,0,0,0,0,0,0,71.73
臺南縣,柳營鄉,東昇村,0,1,1603,25,1628,2395,0,0,0,0,0,0,67.97
臺南縣,柳營鄉,八翁村,0,1,851,11,862,1203,0,0,0,0,0,0,71.65
臺南縣,柳營鄉,人和村,0,1,511,5,516,754,0,0,0,0,0,0,68.44
臺南縣,柳營鄉,太康村,0,1,1075,13,1088,1515,0,0,0,0,0,0,71.82
臺南縣,柳營鄉,重溪村,0,1,1204,14,1218,1768,0,0,0,0,0,0,68.89
臺南縣,柳營鄉,篤農村,0,1,911,19,930,1395,0,0,0,0,0,0,66.67
臺南縣,柳營鄉,大農村,0,1,468,11,479,650,0,0,0,0,0,0,73.69
臺南縣,柳營鄉,神農村,0,1,892,13,905,1389,0,0,0,0,0,0,65.15
臺南縣,柳營鄉,果毅村,0,1,848,9,857,1247,0,0,0,0,0,0,68.72
臺南縣,柳營鄉,旭山村,0,1,1082,12,1094,1673,0,0,0,0,0,0,65.39
臺南縣,後壁鄉,後壁村,0,1,959,10,969,1462,0,0,0,0,0,0,66.28
臺南縣,後壁鄉,侯伯村,0,1,816,4,820,1252,0,0,0,0,0,0,65.50
臺南縣,後壁鄉,嘉苳村,0,1,820,16,836,1309,0,0,0,0,0,0,63.87
臺南縣,後壁鄉,土溝村,0,1,880,10,890,1311,0,0,0,0,0,0,67.89
臺南縣,後壁鄉,嘉田村,0,1,739,12,751,1186,0,0,0,0,0,0,63.32
臺南縣,後壁鄉,嘉民村,0,1,756,8,764,1239,0,0,0,0,0,0,61.66
臺南縣,後壁鄉,菁豐村,0,1,523,7,530,817,0,0,0,0,0,0,64.87
臺南縣,後壁鄉,崁頂村,0,1,356,8,364,527,0,0,0,0,0,0,69.07
臺南縣,後壁鄉,後部村,0,1,324,10,334,604,0,0,0,0,0,0,55.30
臺南縣,後壁鄉,墨林村,0,1,540,8,548,839,0,0,0,0,0,0,65.32
臺南縣,後壁鄉,菁寮村,0,1,337,2,339,468,0,0,0,0,0,0,72.44
臺南縣,後壁鄉,新嘉村,0,1,750,5,755,1139,0,0,0,0,0,0,66.29
臺南縣,後壁鄉,頂長村,0,1,376,4,380,546,0,0,0,0,0,0,69.60
臺南縣,後壁鄉,平安村,0,1,696,7,703,1066,0,0,0,0,0,0,65.95
臺南縣,後壁鄉,仕安村,0,1,383,3,386,584,0,0,0,0,0,0,66.10
臺南縣,後壁鄉,竹新村,0,1,1002,11,1013,1457,0,0,0,0,0,0,69.53
臺南縣,後壁鄉,新東村,0,1,970,8,978,1507,0,0,0,0,0,0,64.90
臺南縣,後壁鄉,頂安村,0,1,744,10,754,1146,0,0,0,0,0,0,65.79
臺南縣,後壁鄉,長安村,0,1,958,11,969,1365,0,0,0,0,0,0,70.99
臺南縣,後壁鄉,福安村,0,1,760,1,761,1150,0,0,0,0,0,0,66.17
臺南縣,後壁鄉,烏樹村,0,1,423,11,434,698,0,0,0,0,0,0,62.18
臺南縣,後壁鄉,烏林村,0,1,127,1,128,187,0,0,0,0,0,0,68.45
臺南縣,東山鄉,東山村,0,1,821,5,826,1423,0,0,0,0,0,0,58.05
臺南縣,東山鄉,東中村,0,1,1387,15,1402,2286,0,0,0,0,0,0,61.33
臺南縣,東山鄉,東正村,0,1,910,11,921,1549,0,0,0,0,0,0,59.46
臺南縣,東山鄉,三榮村,0,1,567,5,572,970,0,0,0,0,0,0,58.97
臺南縣,東山鄉,大客村,0,1,691,10,701,1206,0,0,0,0,0,0,58.13
臺南縣,東山鄉,科里村,0,1,961,15,976,1416,0,0,0,0,0,0,68.93
臺南縣,東山鄉,東河村,0,1,538,5,543,933,0,0,0,0,0,0,58.20
臺南縣,東山鄉,聖賢村,0,1,1216,10,1226,1878,0,0,0,0,0,0,65.28
臺南縣,東山鄉,南溪村,0,1,384,5,389,561,0,0,0,0,0,0,69.34
臺南縣,東山鄉,水雲村,0,1,319,1,320,513,0,0,0,0,0,0,62.38
臺南縣,東山鄉,林安村,0,1,265,1,266,400,0,0,0,0,0,0,66.50
臺南縣,東山鄉,東原村,0,1,1411,16,1427,2270,0,0,0,0,0,0,62.86
臺南縣,東山鄉,嶺南村,0,1,414,8,422,777,0,0,0,0,0,0,54.31
臺南縣,東山鄉,南勢村,0,1,706,9,715,1137,0,0,0,0,0,0,62.88
臺南縣,東山鄉,青山村,0,1,673,4,677,1133,0,0,0,0,0,0,59.75
臺南縣,東山鄉,高原村,0,1,547,5,552,974,0,0,0,0,0,0,56.67
臺南縣,麻豆鎮,穀興里,0,1,461,4,465,641,0,0,0,0,0,0,72.54
臺南縣,麻豆鎮,保安里,0,1,435,5,440,617,0,0,0,0,0,0,71.31
臺南縣,麻豆鎮,東角里,0,1,1252,12,1264,1888,0,0,0,0,0,0,66.95
臺南縣,麻豆鎮,晉江里,0,1,1503,14,1517,2254,0,0,0,0,0,0,67.30
臺南縣,麻豆鎮,巷口里,0,1,914,11,925,1355,0,0,0,0,0,0,68.27
臺南縣,麻豆鎮,中興里,0,1,1210,7,1217,1764,0,0,0,0,0,0,68.99
臺南縣,麻豆鎮,興農里,0,1,834,12,846,1251,0,0,0,0,0,0,67.63
臺南縣,麻豆鎮,新建里,0,1,726,5,731,964,0,0,0,0,0,0,75.83
臺南縣,麻豆鎮,油車里,0,1,1847,18,1865,2757,0,0,0,0,0,0,67.65
臺南縣,麻豆鎮,北勢里,0,1,809,3,812,1128,0,0,0,0,0,0,71.99
臺南縣,麻豆鎮,大埕里,0,1,1571,22,1593,2379,0,0,0,0,0,0,66.96
臺南縣,麻豆鎮,總榮里,0,1,479,9,488,632,0,0,0,0,0,0,77.22
臺南縣,麻豆鎮,龍泉里,0,1,537,9,546,729,0,0,0,0,0,0,74.90
臺南縣,麻豆鎮,南勢里,0,1,1531,23,1554,2188,0,0,0,0,0,0,71.02
臺南縣,麻豆鎮,寮部里,0,1,991,15,1006,1392,0,0,0,0,0,0,72.27
臺南縣,麻豆鎮,小埤里,0,1,602,3,605,837,0,0,0,0,0,0,72.28
臺南縣,麻豆鎮,埤頭里,0,1,929,11,940,1263,0,0,0,0,0,0,74.43
臺南縣,麻豆鎮,大山里,0,1,408,3,411,517,0,0,0,0,0,0,79.50
臺南縣,麻豆鎮,海埔里,0,1,698,7,705,984,0,0,0,0,0,0,71.65
臺南縣,麻豆鎮,莊禮里,0,1,429,4,433,540,0,0,0,0,0,0,80.19
臺南縣,麻豆鎮,港尾里,0,1,763,10,773,1138,0,0,0,0,0,0,67.93
臺南縣,麻豆鎮,麻口里,0,1,763,7,770,1016,0,0,0,0,0,0,75.79
臺南縣,麻豆鎮,安東里,0,1,408,4,412,584,0,0,0,0,0,0,70.55
臺南縣,麻豆鎮,安業里,0,1,461,6,467,645,0,0,0,0,0,0,72.40
臺南縣,麻豆鎮,安西里,0,1,513,6,519,687,0,0,0,0,0,0,75.55
臺南縣,麻豆鎮,謝安里,0,1,654,11,665,868,0,0,0,0,0,0,76.61
臺南縣,麻豆鎮,中民里,0,1,594,3,597,805,0,0,0,0,0,0,74.16
臺南縣,麻豆鎮,安正里,0,1,604,4,608,809,0,0,0,0,0,0,75.15
臺南縣,麻豆鎮,磚井里,0,1,830,6,836,1122,0,0,0,0,0,0,74.51
臺南縣,下營鄉,下營村,0,1,672,8,680,1012,0,0,0,0,0,0,67.19
臺南縣,下營鄉,仁里村,0,1,1663,16,1679,2485,0,0,0,0,0,0,67.57
臺南縣,下營鄉,宅內村,0,1,814,4,818,1150,0,0,0,0,0,0,71.13
臺南縣,下營鄉,後街村,0,1,1058,10,1068,1498,0,0,0,0,0,0,71.30
臺南縣,下營鄉,新興村,0,1,1373,12,1385,2033,0,0,0,0,0,0,68.13
臺南縣,下營鄉,營前村,0,1,1396,13,1409,2056,0,0,0,0,0,0,68.53
臺南縣,下營鄉,大屯村,0,1,585,6,591,783,0,0,0,0,0,0,75.48
臺南縣,下營鄉,大埤村,0,1,579,2,581,799,0,0,0,0,0,0,72.72
臺南縣,下營鄉,茅港村,0,1,788,12,800,1164,0,0,0,0,0,0,68.73
臺南縣,下營鄉,中營村,0,1,743,5,748,1057,0,0,0,0,0,0,70.77
臺南縣,下營鄉,開化村,0,1,1193,11,1204,1769,0,0,0,0,0,0,68.06
臺南縣,下營鄉,西連村,0,1,666,7,673,893,0,0,0,0,0,0,75.36
臺南縣,下營鄉,賀建村,0,1,946,14,960,1293,0,0,0,0,0,0,74.25
臺南縣,下營鄉,甲中村,0,1,805,8,813,1187,0,0,0,0,0,0,68.49
臺南縣,下營鄉,紅厝村,0,1,902,10,912,1213,0,0,0,0,0,0,75.19
臺南縣,六甲鄉,六甲村,0,1,1747,25,1772,2647,0,0,0,0,0,0,66.94
臺南縣,六甲鄉,甲東村,0,1,1566,21,1587,2465,0,0,0,0,0,0,64.38
臺南縣,六甲鄉,甲南村,0,1,849,3,852,1291,0,0,0,0,0,0,66.00
臺南縣,六甲鄉,龍湖村,0,1,706,6,712,1051,0,0,0,0,0,0,67.75
臺南縣,六甲鄉,七甲村,0,1,549,10,559,829,0,0,0,0,0,0,67.43
臺南縣,六甲鄉,二甲村,0,1,1738,22,1760,2714,0,0,0,0,0,0,64.85
臺南縣,六甲鄉,水林村,0,1,1191,18,1209,1755,0,0,0,0,0,0,68.89
臺南縣,六甲鄉,中社村,0,1,1026,11,1037,1538,0,0,0,0,0,0,67.43
臺南縣,六甲鄉,龜港村,0,1,708,4,712,1047,0,0,0,0,0,0,68.00
臺南縣,六甲鄉,菁埔村,0,1,409,1,410,575,0,0,0,0,0,0,71.30
臺南縣,六甲鄉,王爺村,0,1,564,5,569,898,0,0,0,0,0,0,63.36
臺南縣,六甲鄉,大丘村,0,1,477,3,480,764,0,0,0,0,0,0,62.83
臺南縣,官田鄉,官田村,0,1,1318,13,1331,1923,0,0,0,0,0,0,69.21
臺南縣,官田鄉,二鎮村,0,1,1533,18,1551,2178,0,0,0,0,0,0,71.21
臺南縣,官田鄉,湖山村,0,1,759,11,770,1045,0,0,0,0,0,0,73.68
臺南縣,官田鄉,嘉南村,0,1,492,3,495,635,0,0,0,0,0,0,77.95
臺南縣,官田鄉,大崎村,0,1,329,1,330,496,0,0,0,0,0,0,66.53
臺南縣,官田鄉,隆田村,0,1,1247,15,1262,1803,0,0,0,0,0,0,69.99
臺南縣,官田鄉,隆本村,0,1,1892,20,1912,2710,0,0,0,0,0,0,70.55
臺南縣,官田鄉,南部村,0,1,648,12,660,1021,0,0,0,0,0,0,64.64
臺南縣,官田鄉,東庄村,0,1,942,6,948,1380,0,0,0,0,0,0,68.70
臺南縣,官田鄉,西庄村,0,1,455,5,460,696,0,0,0,0,0,0,66.09
臺南縣,官田鄉,拔林村,0,1,476,3,479,607,0,0,0,0,0,0,78.91
臺南縣,官田鄉,渡頭村,0,1,1607,21,1628,2235,0,0,0,0,0,0,72.84
臺南縣,官田鄉,社子村,0,1,615,6,621,916,0,0,0,0,0,0,67.79
臺南縣,大內鄉,石湖村,0,1,721,7,728,1145,0,0,0,0,0,0,63.58
臺南縣,大內鄉,石林村,0,1,509,8,517,781,0,0,0,0,0,0,66.20
臺南縣,大內鄉,石城村,0,1,933,9,942,1464,0,0,0,0,0,0,64.34
臺南縣,大內鄉,內江村,0,1,716,7,723,1111,0,0,0,0,0,0,65.08
臺南縣,大內鄉,大內村,0,1,576,4,580,838,0,0,0,0,0,0,69.21
臺南縣,大內鄉,內郭村,0,1,452,13,465,698,0,0,0,0,0,0,66.62
臺南縣,大內鄉,頭社村,0,1,614,14,628,1062,0,0,0,0,0,0,59.13
臺南縣,大內鄉,環湖村,0,1,616,5,621,934,0,0,0,0,0,0,66.49
臺南縣,大內鄉,二溪村,0,1,585,4,589,959,0,0,0,0,0,0,61.42
臺南縣,大內鄉,曲溪村,0,1,430,6,436,646,0,0,0,0,0,0,67.49
臺南縣,佳里鎮,東寧里,0,1,1163,11,1174,1723,0,0,0,0,0,0,68.14
臺南縣,佳里鎮,忠仁里,0,1,1660,20,1680,2494,0,0,0,0,0,0,67.36
臺南縣,佳里鎮,鎮山里,0,1,2887,20,2907,4171,0,0,0,0,0,0,69.70
臺南縣,佳里鎮,建南里,0,1,3363,33,3396,5225,0,0,0,0,0,0,65.00
臺南縣,佳里鎮,安西里,0,1,4590,33,4623,7303,0,0,0,0,0,0,63.30
臺南縣,佳里鎮,六安里,0,1,1926,15,1941,2944,0,0,0,0,0,0,65.93
臺南縣,佳里鎮,佳化里,0,1,1258,12,1270,1749,0,0,0,0,0,0,72.61
臺南縣,佳里鎮,禮化里,0,1,603,7,610,837,0,0,0,0,0,0,72.88
臺南縣,佳里鎮,興化里,0,1,928,7,935,1355,0,0,0,0,0,0,69.00
臺南縣,佳里鎮,營頂里,0,1,473,3,476,656,0,0,0,0,0,0,72.56
臺南縣,佳里鎮,溪洲里,0,1,279,1,280,370,0,0,0,0,0,0,75.68
臺南縣,佳里鎮,海澄里,0,1,783,9,792,1218,0,0,0,0,0,0,65.02
臺南縣,佳里鎮,漳洲里,0,1,417,4,421,596,0,0,0,0,0,0,70.64
臺南縣,佳里鎮,頂部里,0,1,516,6,522,758,0,0,0,0,0,0,68.87
臺南縣,佳里鎮,嘉福里,0,1,664,6,670,939,0,0,0,0,0,0,71.35
臺南縣,佳里鎮,通興里,0,1,733,13,746,1108,0,0,0,0,0,0,67.33
臺南縣,佳里鎮,蚶寮里,0,1,596,3,599,827,0,0,0,0,0,0,72.43
臺南縣,佳里鎮,龍安里,0,1,741,5,746,979,0,0,0,0,0,0,76.20
臺南縣,佳里鎮,民安里,0,1,845,14,859,1232,0,0,0,0,0,0,69.72
臺南縣,佳里鎮,子龍里,0,1,1036,11,1047,1497,0,0,0,0,0,0,69.94
臺南縣,佳里鎮,三協里,0,1,566,5,571,816,0,0,0,0,0,0,69.98
臺南縣,學甲鎮,一秀里,0,1,776,5,781,1124,0,0,0,0,0,0,69.48
臺南縣,學甲鎮,西明里,0,1,849,6,855,1225,0,0,0,0,0,0,69.80
臺南縣,學甲鎮,宜民里,0,1,348,2,350,515,0,0,0,0,0,0,67.96
臺南縣,學甲鎮,煥昌里,0,1,624,2,626,859,0,0,0,0,0,0,72.88
臺南縣,學甲鎮,慈生里,0,1,412,0,412,585,0,0,0,0,0,0,70.43
臺南縣,學甲鎮,仁得里,0,1,2334,17,2351,3315,0,0,0,0,0,0,70.92
臺南縣,學甲鎮,新生里,0,1,955,5,960,1405,0,0,0,0,0,0,68.33
臺南縣,學甲鎮,百福里,0,1,894,6,900,1264,0,0,0,0,0,0,71.20
臺南縣,學甲鎮,新榮里,0,1,907,8,915,1320,0,0,0,0,0,0,69.32
臺南縣,學甲鎮,文化里,0,1,358,3,361,551,0,0,0,0,0,0,65.52
臺南縣,學甲鎮,大安里,0,1,377,2,379,543,0,0,0,0,0,0,69.80
臺南縣,學甲鎮,美豐里,0,1,534,6,540,815,0,0,0,0,0,0,66.26
臺南縣,學甲鎮,美和里,0,1,257,1,258,353,0,0,0,0,0,0,73.09
臺南縣,學甲鎮,達明里,0,1,472,4,476,684,0,0,0,0,0,0,69.59
臺南縣,學甲鎮,光明里,0,1,222,0,222,335,0,0,0,0,0,0,66.27
臺南縣,學甲鎮,民吉里,0,1,292,5,297,435,0,0,0,0,0,0,68.28
臺南縣,學甲鎮,西進里,0,1,330,4,334,524,0,0,0,0,0,0,63.74
臺南縣,學甲鎮,白渚里,0,1,228,1,229,341,0,0,0,0,0,0,67.16
臺南縣,學甲鎮,光華里,0,1,600,5,605,834,0,0,0,0,0,0,72.54
臺南縣,學甲鎮,頭港里,0,1,301,1,302,492,0,0,0,0,0,0,61.38
臺南縣,學甲鎮,宅港里,0,1,727,9,736,1142,0,0,0,0,0,0,64.45
臺南縣,學甲鎮,平東里,0,1,353,2,355,516,0,0,0,0,0,0,68.80
臺南縣,學甲鎮,平西里,0,1,451,5,456,722,0,0,0,0,0,0,63.16
臺南縣,學甲鎮,頂洲里,0,1,518,3,521,692,0,0,0,0,0,0,75.29
臺南縣,學甲鎮,紅茄里,0,1,325,2,327,518,0,0,0,0,0,0,63.13
臺南縣,學甲鎮,新芳里,0,1,340,1,341,479,0,0,0,0,0,0,71.19
臺南縣,西港鄉,西港村,0,1,1746,29,1775,2520,0,0,0,0,0,0,70.44
臺南縣,西港鄉,慶安村,0,1,2169,16,2185,3091,0,0,0,0,0,0,70.69
臺南縣,西港鄉,南海村,0,1,1307,23,1330,1853,0,0,0,0,0,0,71.78
臺南縣,西港鄉,港東村,0,1,916,8,924,1248,0,0,0,0,0,0,74.04
臺南縣,西港鄉,檨林村,0,1,1057,17,1074,1528,0,0,0,0,0,0,70.29
臺南縣,西港鄉,後營村,0,1,935,10,945,1282,0,0,0,0,0,0,73.71
臺南縣,西港鄉,營西村,0,1,860,6,866,1276,0,0,0,0,0,0,67.87
臺南縣,西港鄉,金砂村,0,1,598,8,606,836,0,0,0,0,0,0,72.49
臺南縣,西港鄉,劉厝村,0,1,798,8,806,1131,0,0,0,0,0,0,71.26
臺南縣,西港鄉,竹林村,0,1,839,9,848,1160,0,0,0,0,0,0,73.10
臺南縣,西港鄉,永樂村,0,1,626,2,628,845,0,0,0,0,0,0,74.32
臺南縣,西港鄉,新復村,0,1,833,14,847,1150,0,0,0,0,0,0,73.65
臺南縣,七股鄉,後港村,0,1,390,5,395,539,0,0,0,0,0,0,73.28
臺南縣,七股鄉,大潭村,0,1,489,5,494,749,0,0,0,0,0,0,65.95
臺南縣,七股鄉,城內村,0,1,392,5,397,496,0,0,0,0,0,0,80.04
臺南縣,七股鄉,篤加村,0,1,577,6,583,822,0,0,0,0,0,0,70.92
臺南縣,七股鄉,頂山村,0,1,700,5,705,951,0,0,0,0,0,0,74.13
臺南縣,七股鄉,西寮村,0,1,418,2,420,580,0,0,0,0,0,0,72.41
臺南縣,七股鄉,鹽埕村,0,1,323,4,327,461,0,0,0,0,0,0,70.93
臺南縣,七股鄉,中寮村,0,1,529,3,532,776,0,0,0,0,0,0,68.56
臺南縣,七股鄉,龍山村,0,1,1153,11,1164,1646,0,0,0,0,0,0,70.72
臺南縣,七股鄉,溪南村,0,1,274,0,274,347,0,0,0,0,0,0,78.96
臺南縣,七股鄉,七股村,0,1,577,9,586,884,0,0,0,0,0,0,66.29
臺南縣,七股鄉,玉成村,0,1,554,2,556,780,0,0,0,0,0,0,71.28
臺南縣,七股鄉,大埕村,0,1,876,11,887,1284,0,0,0,0,0,0,69.08
臺南縣,七股鄉,大寮村,0,1,711,7,718,967,0,0,0,0,0,0,74.25
臺南縣,七股鄉,看坪村,0,1,409,5,414,590,0,0,0,0,0,0,70.17
臺南縣,七股鄉,樹林村,0,1,715,7,722,1005,0,0,0,0,0,0,71.84
臺南縣,七股鄉,竹港村,0,1,437,0,437,571,0,0,0,0,0,0,76.53
臺南縣,七股鄉,竹橋村,0,1,571,2,573,741,0,0,0,0,0,0,77.33
臺南縣,七股鄉,義合村,0,1,699,3,702,943,0,0,0,0,0,0,74.44
臺南縣,七股鄉,康榔村,0,1,467,7,474,640,0,0,0,0,0,0,74.06
臺南縣,七股鄉,永吉村,0,1,576,2,578,809,0,0,0,0,0,0,71.45
臺南縣,七股鄉,三股村,0,1,1534,15,1549,2012,0,0,0,0,0,0,76.99
臺南縣,七股鄉,十份村,0,1,935,5,940,1320,0,0,0,0,0,0,71.21
臺南縣,將軍鄉,長榮村,0,1,620,7,627,856,0,0,0,0,0,0,73.25
臺南縣,將軍鄉,西華村,0,1,891,6,897,1260,0,0,0,0,0,0,71.19
臺南縣,將軍鄉,西和村,0,1,764,6,770,1091,0,0,0,0,0,0,70.58
臺南縣,將軍鄉,忠興村,0,1,1021,2,1023,1439,0,0,0,0,0,0,71.09
臺南縣,將軍鄉,嘉昌村,0,1,669,4,673,903,0,0,0,0,0,0,74.53
臺南縣,將軍鄉,保源村,0,1,773,1,774,1049,0,0,0,0,0,0,73.78
臺南縣,將軍鄉,苓和村,0,1,679,4,683,1044,0,0,0,0,0,0,65.42
臺南縣,將軍鄉,仁和村,0,1,501,3,504,806,0,0,0,0,0,0,62.53
臺南縣,將軍鄉,北埔村,0,1,447,7,454,662,0,0,0,0,0,0,68.58
臺南縣,將軍鄉,將富村,0,1,472,3,475,748,0,0,0,0,0,0,63.50
臺南縣,將軍鄉,將貴村,0,1,456,0,456,646,0,0,0,0,0,0,70.59
臺南縣,將軍鄉,三吉村,0,1,273,0,273,437,0,0,0,0,0,0,62.47
臺南縣,將軍鄉,玉山村,0,1,604,1,605,915,0,0,0,0,0,0,66.12
臺南縣,將軍鄉,廣山村,0,1,472,4,476,754,0,0,0,0,0,0,63.13
臺南縣,將軍鄉,長沙村,0,1,910,6,916,1416,0,0,0,0,0,0,64.69
臺南縣,將軍鄉,平沙村,0,1,807,7,814,1207,0,0,0,0,0,0,67.44
臺南縣,將軍鄉,鯤鯓村,0,1,1203,7,1210,1922,0,0,0,0,0,0,62.96
臺南縣,將軍鄉,鯤溟村,0,1,543,5,548,988,0,0,0,0,0,0,55.47
臺南縣,北門鄉,北門村,0,1,671,7,678,933,0,0,0,0,0,0,72.67
臺南縣,北門鄉,永隆村,0,1,355,2,357,502,0,0,0,0,0,0,71.12
臺南縣,北門鄉,永華村,0,1,285,2,287,423,0,0,0,0,0,0,67.85
臺南縣,北門鄉,玉港村,0,1,564,6,570,828,0,0,0,0,0,0,68.84
臺南縣,北門鄉,保吉村,0,1,852,11,863,1286,0,0,0,0,0,0,67.11
臺南縣,北門鄉,東壁村,0,1,438,4,442,691,0,0,0,0,0,0,63.97
臺南縣,北門鄉,鯤江村,0,1,514,4,518,773,0,0,0,0,0,0,67.01
臺南縣,北門鄉,雙春村,0,1,356,0,356,595,0,0,0,0,0,0,59.83
臺南縣,北門鄉,錦湖村,0,1,748,8,756,1122,0,0,0,0,0,0,67.38
臺南縣,北門鄉,慈安村,0,1,457,4,461,635,0,0,0,0,0,0,72.60
臺南縣,北門鄉,三光村,0,1,824,3,827,1154,0,0,0,0,0,0,71.66
臺南縣,北門鄉,中樞村,0,1,499,4,503,728,0,0,0,0,0,0,69.09
臺南縣,北門鄉,仁里村,0,1,484,4,488,722,0,0,0,0,0,0,67.59
臺南縣,新化鎮,武安里,0,1,1032,20,1052,1566,0,0,0,0,0,0,67.18
臺南縣,新化鎮,東榮里,0,1,2286,25,2311,3594,0,0,0,0,0,0,64.30
臺南縣,新化鎮,護國里,0,1,950,15,965,1546,0,0,0,0,0,0,62.42
臺南縣,新化鎮,太平里,0,1,2332,37,2369,3370,0,0,0,0,0,0,70.30
臺南縣,新化鎮,中央里,0,1,291,4,295,429,0,0,0,0,0,0,68.76
臺南縣,新化鎮,觀音里,0,1,421,8,429,632,0,0,0,0,0,0,67.88
臺南縣,新化鎮,竹林里,0,1,351,11,362,462,0,0,0,0,0,0,78.35
臺南縣,新化鎮,清水里,0,1,662,5,667,960,0,0,0,0,0,0,69.48
臺南縣,新化鎮,協興里,0,1,1767,26,1793,2795,0,0,0,0,0,0,64.15
臺南縣,新化鎮,唪口里,0,1,957,21,978,1487,0,0,0,0,0,0,65.77
臺南縣,新化鎮,北勢里,0,1,747,5,752,1041,0,0,0,0,0,0,72.24
臺南縣,新化鎮,豐榮里,0,1,1535,23,1558,2177,0,0,0,0,0,0,71.57
臺南縣,新化鎮,全興里,0,1,1118,11,1129,1710,0,0,0,0,0,0,66.02
臺南縣,新化鎮,崙頂里,0,1,1224,22,1246,1662,0,0,0,0,0,0,74.97
臺南縣,新化鎮,知義里,0,1,1346,24,1370,2050,0,0,0,0,0,0,66.83
臺南縣,新化鎮,山腳里,0,1,870,14,884,1200,0,0,0,0,0,0,73.67
臺南縣,新化鎮,大坑里,0,1,379,7,386,529,0,0,0,0,0,0,72.97
臺南縣,新化鎮,那拔里,0,1,1346,26,1372,1964,0,0,0,0,0,0,69.86
臺南縣,新化鎮,羊林里,0,1,574,11,585,859,0,0,0,0,0,0,68.10
臺南縣,新化鎮,礁坑里,0,1,687,10,697,1077,0,0,0,0,0,0,64.72
臺南縣,善化鎮,東關里,0,1,567,4,571,954,0,0,0,0,0,0,59.85
臺南縣,善化鎮,坐駕里,0,1,1550,22,1572,2453,0,0,0,0,0,0,64.08
臺南縣,善化鎮,光文里,0,1,2285,35,2320,3742,0,0,0,0,0,0,62.00
臺南縣,善化鎮,文昌里,0,1,1185,12,1197,1927,0,0,0,0,0,0,62.12
臺南縣,善化鎮,南關里,0,1,809,12,821,1272,0,0,0,0,0,0,64.54
臺南縣,善化鎮,西關里,0,1,406,5,411,654,0,0,0,0,0,0,62.84
臺南縣,善化鎮,北關里,0,1,328,4,332,486,0,0,0,0,0,0,68.31
臺南縣,善化鎮,文正里,0,1,664,6,670,1075,0,0,0,0,0,0,62.33
臺南縣,善化鎮,胡家里,0,1,837,10,847,1263,0,0,0,0,0,0,67.06
臺南縣,善化鎮,胡厝里,0,1,1320,19,1339,1923,0,0,0,0,0,0,69.63
臺南縣,善化鎮,什乃里,0,1,551,6,557,851,0,0,0,0,0,0,65.45
臺南縣,善化鎮,溪美里,0,1,1076,16,1092,1600,0,0,0,0,0,0,68.25
臺南縣,善化鎮,六分里,0,1,441,4,445,659,0,0,0,0,0,0,67.53
臺南縣,善化鎮,六德里,0,1,718,12,730,1047,0,0,0,0,0,0,69.72
臺南縣,善化鎮,田寮里,0,1,1164,11,1175,1654,0,0,0,0,0,0,71.04
臺南縣,善化鎮,東隆里,0,1,577,6,583,809,0,0,0,0,0,0,72.06
臺南縣,善化鎮,東昌里,0,1,671,8,679,980,0,0,0,0,0,0,69.29
臺南縣,善化鎮,牛庄里,0,1,934,5,939,1382,0,0,0,0,0,0,67.95
臺南縣,善化鎮,嘉北里,0,1,902,15,917,1352,0,0,0,0,0,0,67.83
臺南縣,善化鎮,嘉南里,0,1,645,7,652,988,0,0,0,0,0,0,65.99
臺南縣,善化鎮,小新里,0,1,1501,17,1518,2447,0,0,0,0,0,0,62.04
臺南縣,新市鄉,新市村,0,1,1389,19,1408,2238,0,0,0,0,0,0,62.91
臺南縣,新市鄉,新和村,0,1,2911,36,2947,4796,0,0,0,0,0,0,61.45
臺南縣,新市鄉,社內村,0,1,1202,12,1214,1757,0,0,0,0,0,0,69.10
臺南縣,新市鄉,大洲村,0,1,437,5,442,597,0,0,0,0,0,0,74.04
臺南縣,新市鄉,豐華村,0,1,502,4,506,829,0,0,0,0,0,0,61.04
臺南縣,新市鄉,三舍村,0,1,604,12,616,913,0,0,0,0,0,0,67.47
臺南縣,新市鄉,大營村,0,1,1507,18,1525,2135,0,0,0,0,0,0,71.43
臺南縣,新市鄉,大社村,0,1,2001,32,2033,2994,0,0,0,0,0,0,67.90
臺南縣,新市鄉,潭頂村,0,1,911,15,926,1394,0,0,0,0,0,0,66.43
臺南縣,新市鄉,港墘村,0,1,1663,20,1683,2631,0,0,0,0,0,0,63.97
臺南縣,新市鄉,永就村,0,1,1180,9,1189,1856,0,0,0,0,0,0,64.06
臺南縣,安定鄉,蘇林村,0,1,1364,12,1376,1992,0,0,0,0,0,0,69.08
臺南縣,安定鄉,蘇厝村,0,1,1078,18,1096,1718,0,0,0,0,0,0,63.80
臺南縣,安定鄉,安定村,0,1,851,15,866,1322,0,0,0,0,0,0,65.51
臺南縣,安定鄉,安加村,0,1,777,8,785,1110,0,0,0,0,0,0,70.72
臺南縣,安定鄉,保西村,0,1,506,5,511,722,0,0,0,0,0,0,70.78
臺南縣,安定鄉,港尾村,0,1,972,8,980,1424,0,0,0,0,0,0,68.82
臺南縣,安定鄉,中榮村,0,1,666,7,673,977,0,0,0,0,0,0,68.88
臺南縣,安定鄉,港口村,0,1,1396,14,1410,1991,0,0,0,0,0,0,70.82
臺南縣,安定鄉,港南村,0,1,1380,19,1399,2067,0,0,0,0,0,0,67.68
臺南縣,安定鄉,大同村,0,1,481,5,486,617,0,0,0,0,0,0,78.77
臺南縣,安定鄉,六嘉村,0,1,891,11,902,1289,0,0,0,0,0,0,69.98
臺南縣,安定鄉,中沙村,0,1,491,7,498,694,0,0,0,0,0,0,71.76
臺南縣,安定鄉,新吉村,0,1,1061,8,1069,1534,0,0,0,0,0,0,69.69
臺南縣,安定鄉,海寮村,0,1,1580,11,1591,2082,0,0,0,0,0,0,76.42
臺南縣,安定鄉,管寮村,0,1,614,6,620,891,0,0,0,0,0,0,69.58
臺南縣,安定鄉,南安村,0,1,353,6,359,449,0,0,0,0,0,0,79.96
臺南縣,山上鄉,明和村,0,1,1074,15,1089,1672,0,0,0,0,0,0,65.13
臺南縣,山上鄉,南洲村,0,1,1081,7,1088,1490,0,0,0,0,0,0,73.02
臺南縣,山上鄉,山上村,0,1,567,9,576,839,0,0,0,0,0,0,68.65
臺南縣,山上鄉,新莊村,0,1,479,7,486,736,0,0,0,0,0,0,66.03
臺南縣,山上鄉,玉峰村,0,1,368,7,375,574,0,0,0,0,0,0,65.33
臺南縣,山上鄉,平陽村,0,1,268,6,274,369,0,0,0,0,0,0,74.25
臺南縣,山上鄉,豐德村,0,1,211,3,214,323,0,0,0,0,0,0,66.25
臺南縣,玉井鄉,玉井村,0,1,685,7,692,976,0,0,0,0,0,0,70.90
臺南縣,玉井鄉,玉田村,0,1,2805,25,2830,3965,0,0,0,0,0,0,71.37
臺南縣,玉井鄉,中正村,0,1,942,10,952,1288,0,0,0,0,0,0,73.91
臺南縣,玉井鄉,竹圍村,0,1,835,9,844,1319,0,0,0,0,0,0,63.99
臺南縣,玉井鄉,沙田村,0,1,324,5,329,481,0,0,0,0,0,0,68.40
臺南縣,玉井鄉,三埔村,0,1,314,3,317,512,0,0,0,0,0,0,61.91
臺南縣,玉井鄉,三和村,0,1,551,2,553,766,0,0,0,0,0,0,72.19
臺南縣,玉井鄉,望明村,0,1,1069,13,1082,1543,0,0,0,0,0,0,70.12
臺南縣,玉井鄉,層林村,0,1,562,4,566,727,0,0,0,0,0,0,77.85
臺南縣,玉井鄉,豐里村,0,1,731,4,735,1037,0,0,0,0,0,0,70.88
臺南縣,楠西鄉,楠西村,0,1,1303,15,1318,1950,0,0,0,0,0,0,67.59
臺南縣,楠西鄉,灣丘村,0,1,882,6,888,1298,0,0,0,0,0,0,68.41
臺南縣,楠西鄉,密枝村,0,1,610,10,620,899,0,0,0,0,0,0,68.97
臺南縣,楠西鄉,照興村,0,1,705,14,719,1062,0,0,0,0,0,0,67.70
臺南縣,楠西鄉,鹿田村,0,1,776,6,782,1082,0,0,0,0,0,0,72.27
臺南縣,楠西鄉,龜丹村,0,1,542,3,545,730,0,0,0,0,0,0,74.66
臺南縣,楠西鄉,東勢村,0,1,1644,14,1658,2265,0,0,0,0,0,0,73.20
臺南縣,南化鄉,南化村,0,1,1005,7,1012,1406,0,0,0,0,0,0,71.98
臺南縣,南化鄉,小崙村,0,1,578,7,585,809,0,0,0,0,0,0,72.31
臺南縣,南化鄉,東和村,0,1,473,3,476,690,0,0,0,0,0,0,68.99
臺南縣,南化鄉,中坑村,0,1,389,2,391,514,0,0,0,0,0,0,76.07
臺南縣,南化鄉,北平村,0,1,463,3,466,582,0,0,0,0,0,0,80.07
臺南縣,南化鄉,西埔村,0,1,618,9,627,836,0,0,0,0,0,0,75.00
臺南縣,南化鄉,北寮村,0,1,875,6,881,1237,0,0,0,0,0,0,71.22
臺南縣,南化鄉,玉山村,0,1,676,6,682,942,0,0,0,0,0,0,72.40
臺南縣,南化鄉,關山村,0,1,300,4,304,534,0,0,0,0,0,0,56.93
臺南縣,左鎮鄉,光和村,0,1,322,1,323,457,0,0,0,0,0,0,70.68
臺南縣,左鎮鄉,榮和村,0,1,530,4,534,719,0,0,0,0,0,0,74.27
臺南縣,左鎮鄉,左鎮村,0,1,408,7,415,557,0,0,0,0,0,0,74.51
臺南縣,左鎮鄉,中正村,0,1,689,6,695,916,0,0,0,0,0,0,75.87
臺南縣,左鎮鄉,睦光村,0,1,277,2,279,354,0,0,0,0,0,0,78.81
臺南縣,左鎮鄉,內庄村,0,1,361,3,364,475,0,0,0,0,0,0,76.63
臺南縣,左鎮鄉,岡林村,0,1,305,7,312,433,0,0,0,0,0,0,72.06
臺南縣,左鎮鄉,草山村,0,1,209,1,210,295,0,0,0,0,0,0,71.19
臺南縣,左鎮鄉,二寮村,0,1,180,4,184,238,0,0,0,0,0,0,77.31
臺南縣,左鎮鄉,澄山村,0,1,414,7,421,593,0,0,0,0,0,0,70.99
臺南縣,仁德鄉,太子村,0,1,2272,33,2305,3718,0,0,0,0,0,0,62.00
臺南縣,仁德鄉,土庫村,0,1,1257,10,1267,2106,0,0,0,0,0,0,60.16
臺南縣,仁德鄉,一甲村,0,1,1034,8,1042,1663,0,0,0,0,0,0,62.66
臺南縣,仁德鄉,仁德村,0,1,1980,37,2017,3419,0,0,0,0,0,0,58.99
臺南縣,仁德鄉,仁義村,0,1,3649,45,3694,5807,0,0,0,0,0,0,63.61
臺南縣,仁德鄉,新田村,0,1,1428,21,1449,2337,0,0,0,0,0,0,62.00
臺南縣,仁德鄉,後壁村,0,1,3212,37,3249,5476,0,0,0,0,0,0,59.33
臺南縣,仁德鄉,上崙村,0,1,2185,31,2216,3674,0,0,0,0,0,0,60.32
臺南縣,仁德鄉,田厝村,0,1,938,10,948,1249,0,0,0,0,0,0,75.90
臺南縣,仁德鄉,三甲村,0,1,531,5,536,662,0,0,0,0,0,0,80.97
臺南縣,仁德鄉,保安村,0,1,1242,15,1257,2053,0,0,0,0,0,0,61.23
臺南縣,仁德鄉,成功村,0,1,2259,41,2300,3467,0,0,0,0,0,0,66.34
臺南縣,仁德鄉,仁和村,0,1,826,23,849,1197,0,0,0,0,0,0,70.93
臺南縣,仁德鄉,仁愛村,0,1,1292,20,1312,1947,0,0,0,0,0,0,67.39
臺南縣,仁德鄉,二行村,0,1,1450,29,1479,1965,0,0,0,0,0,0,75.27
臺南縣,仁德鄉,大甲村,0,1,1382,22,1404,1850,0,0,0,0,0,0,75.89
臺南縣,仁德鄉,中洲村,0,1,828,10,838,1193,0,0,0,0,0,0,70.24
臺南縣,仁德鄉,中生村,0,1,978,16,994,1373,0,0,0,0,0,0,72.40
臺南縣,歸仁鄉,南保村,0,1,2639,26,2665,4091,0,0,0,0,0,0,65.14
臺南縣,歸仁鄉,南興村,0,1,1563,12,1575,2458,0,0,0,0,0,0,64.08
臺南縣,歸仁鄉,六甲村,0,1,2869,35,2904,4547,0,0,0,0,0,0,63.87
臺南縣,歸仁鄉,後市村,0,1,3064,24,3088,4713,0,0,0,0,0,0,65.52
臺南縣,歸仁鄉,辜厝村,0,1,2742,23,2765,4146,0,0,0,0,0,0,66.69
臺南縣,歸仁鄉,許厝村,0,1,1743,17,1760,2577,0,0,0,0,0,0,68.30
臺南縣,歸仁鄉,看西村,0,1,909,9,918,1258,0,0,0,0,0,0,72.97
臺南縣,歸仁鄉,看東村,0,1,866,12,878,1258,0,0,0,0,0,0,69.79
臺南縣,歸仁鄉,崙頂村,0,1,1276,11,1287,1785,0,0,0,0,0,0,72.10
臺南縣,歸仁鄉,沙崙村,0,1,380,4,384,533,0,0,0,0,0,0,72.05
臺南縣,歸仁鄉,大潭村,0,1,1167,4,1171,1620,0,0,0,0,0,0,72.28
臺南縣,歸仁鄉,武東村,0,1,814,16,830,1247,0,0,0,0,0,0,66.56
臺南縣,歸仁鄉,歸仁村,0,1,1203,7,1210,1780,0,0,0,0,0,0,67.98
臺南縣,歸仁鄉,八甲村,0,1,1229,18,1247,1860,0,0,0,0,0,0,67.04
臺南縣,歸仁鄉,七甲村,0,1,1143,13,1156,1776,0,0,0,0,0,0,65.09
臺南縣,歸仁鄉,媽廟村,0,1,1231,13,1244,1792,0,0,0,0,0,0,69.42
臺南縣,歸仁鄉,西埔村,0,1,899,17,916,1278,0,0,0,0,0,0,71.67
臺南縣,歸仁鄉,大廟村,0,1,1295,16,1311,2088,0,0,0,0,0,0,62.79
臺南縣,關廟鄉,關廟村,0,1,1206,13,1219,1804,0,0,0,0,0,0,67.57
臺南縣,關廟鄉,山西村,0,1,1158,11,1169,1756,0,0,0,0,0,0,66.57
臺南縣,關廟鄉,香洋村,0,1,2188,14,2202,3397,0,0,0,0,0,0,64.82
臺南縣,關廟鄉,北勢村,0,1,1662,14,1676,2442,0,0,0,0,0,0,68.63
臺南縣,關廟鄉,新埔村,0,1,575,8,583,832,0,0,0,0,0,0,70.07
臺南縣,關廟鄉,新光村,0,1,525,3,528,748,0,0,0,0,0,0,70.59
臺南縣,關廟鄉,五甲村,0,1,1684,30,1714,2500,0,0,0,0,0,0,68.56
臺南縣,關廟鄉,東勢村,0,1,1845,14,1859,2775,0,0,0,0,0,0,66.99
臺南縣,關廟鄉,松腳村,0,1,1334,10,1344,1893,0,0,0,0,0,0,71.00
臺南縣,關廟鄉,南花村,0,1,890,7,897,1342,0,0,0,0,0,0,66.84
臺南縣,關廟鄉,北花村,0,1,1344,9,1353,2066,0,0,0,0,0,0,65.49
臺南縣,關廟鄉,深坑村,0,1,994,13,1007,1454,0,0,0,0,0,0,69.26
臺南縣,關廟鄉,布袋村,0,1,786,9,795,1181,0,0,0,0,0,0,67.32
臺南縣,關廟鄉,田中村,0,1,542,6,548,746,0,0,0,0,0,0,73.46
臺南縣,關廟鄉,龜洞村,0,1,582,1,583,745,0,0,0,0,0,0,78.26
臺南縣,關廟鄉,埤頭村,0,1,941,10,951,1443,0,0,0,0,0,0,65.90
臺南縣,關廟鄉,下湖村,0,1,297,1,298,388,0,0,0,0,0,0,76.80
臺南縣,龍崎鄉,崎頂村,0,1,817,2,819,1175,0,0,0,0,0,0,69.70
臺南縣,龍崎鄉,土崎村,0,1,514,4,518,696,0,0,0,0,0,0,74.43
臺南縣,龍崎鄉,中坑村,0,1,102,0,102,212,0,0,0,0,0,0,48.11
臺南縣,龍崎鄉,楠坑村,0,1,235,3,238,301,0,0,0,0,0,0,79.07
臺南縣,龍崎鄉,牛埔村,0,1,217,1,218,285,0,0,0,0,0,0,76.49
臺南縣,龍崎鄉,大坪村,0,1,216,1,217,302,0,0,0,0,0,0,71.85
臺南縣,龍崎鄉,龍船村,0,1,331,1,332,455,0,0,0,0,0,0,72.97
臺南縣,龍崎鄉,石曹村,0,1,279,1,280,377,0,0,0,0,0,0,74.27
臺南縣,永康市,五王里,0,1,1857,22,1879,3565,0,0,0,0,0,0,52.71
臺南縣,永康市,三合里,0,1,1367,14,1381,2480,0,0,0,0,0,0,55.69
臺南縣,永康市,六合里,0,1,1282,23,1305,2627,0,0,0,0,0,0,49.68
臺南縣,永康市,網寮里,0,1,1846,22,1868,3395,0,0,0,0,0,0,55.02
臺南縣,永康市,二王里,0,1,2615,26,2641,5118,0,0,0,0,0,0,51.60
臺南縣,永康市,永康里,0,1,2864,31,2895,5076,0,0,0,0,0,0,57.03
臺南縣,永康市,埔園里,0,1,2476,37,2513,4505,0,0,0,0,0,0,55.78
臺南縣,永康市,正強里,0,1,2880,43,2923,5158,0,0,0,0,0,0,56.67
臺南縣,永康市,大橋里,0,1,1914,16,1930,3743,0,0,0,0,0,0,51.56
臺南縣,永康市,東橋里,0,1,1174,11,1185,2105,0,0,0,0,0,0,56.29
臺南縣,永康市,西橋里,0,1,1182,19,1201,2179,0,0,0,0,0,0,55.12
臺南縣,永康市,安康里,0,1,1125,14,1139,2252,0,0,0,0,0,0,50.58
臺南縣,永康市,蔦松里,0,1,860,10,870,1325,0,0,0,0,0,0,65.66
臺南縣,永康市,三民里,0,1,704,5,709,1065,0,0,0,0,0,0,66.57
臺南縣,永康市,鹽行里,0,1,2793,34,2827,5414,0,0,0,0,0,0,52.22
臺南縣,永康市,鹽洲里,0,1,2191,27,2218,3917,0,0,0,0,0,0,56.62
臺南縣,永康市,甲頂里,0,1,1462,18,1480,2179,0,0,0,0,0,0,67.92
臺南縣,永康市,尚頂里,0,1,1703,13,1716,2991,0,0,0,0,0,0,57.37
臺南縣,永康市,龍潭里,0,1,3010,27,3037,5578,0,0,0,0,0,0,54.45
臺南縣,永康市,王行里,0,1,1115,7,1122,1679,0,0,0,0,0,0,66.83
臺南縣,永康市,烏竹里,0,1,788,5,793,1306,0,0,0,0,0,0,60.72
臺南縣,永康市,西勢里,0,1,1978,31,2009,3384,0,0,0,0,0,0,59.37
臺南縣,永康市,新樹里,0,1,735,6,741,1186,0,0,0,0,0,0,62.48
臺南縣,永康市,大灣里,0,1,1905,23,1928,2785,0,0,0,0,0,0,69.23
臺南縣,永康市,東灣里,0,1,1733,29,1762,2839,0,0,0,0,0,0,62.06
臺南縣,永康市,西灣里,0,1,2604,38,2642,4380,0,0,0,0,0,0,60.32
臺南縣,永康市,南灣里,0,1,2136,12,2148,3256,0,0,0,0,0,0,65.97
臺南縣,永康市,崑山里,0,1,2918,33,2951,4787,0,0,0,0,0,0,61.65
臺南縣,永康市,北灣里,0,1,2726,40,2766,4594,0,0,0,0,0,0,60.21
臺南縣,永康市,復興里,0,1,1154,31,1185,1810,0,0,0,0,0,0,65.47
臺南縣,永康市,建國里,0,1,1313,21,1334,1991,0,0,0,0,0,0,67.00
臺南縣,永康市,復國里,0,1,1245,15,1260,1987,0,0,0,0,0,0,63.41
臺南縣,永康市,復華里,0,1,4453,57,4510,8866,0,0,0,0,0,0,50.87
臺南縣,永康市,光復里,0,1,786,6,792,1214,0,0,0,0,0,0,65.24
臺南縣,永康市,神洲里,0,1,1098,13,1111,1761,0,0,0,0,0,0,63.09
臺南縣,永康市,成功里,0,1,1350,21,1371,2196,0,0,0,0,0,0,62.43
臺南縣,永康市,中華里,0,1,959,7,966,1807,0,0,0,0,0,0,53.46
臺南縣,永康市,中興里,0,1,1605,18,1623,2682,0,0,0,0,0,0,60.51
臺南縣,永康市,勝利里,0,1,2215,30,2245,4168,0,0,0,0,0,0,53.86
高雄縣,鳳山市,鳳崗里,0,1,816,9,825,1300,0,0,0,0,0,0,63.46
高雄縣,鳳山市,縣衙里,0,1,573,3,576,870,0,0,0,0,0,0,66.21
高雄縣,鳳山市,曹公里,0,1,1495,17,1512,2327,0,0,0,0,0,0,64.98
高雄縣,鳳山市,鎮西里,0,1,3160,40,3200,4905,0,0,0,0,0,0,65.24
高雄縣,鳳山市,北門里,0,1,2380,43,2423,3682,0,0,0,0,0,0,65.81
高雄縣,鳳山市,鎮北里,0,1,2521,42,2563,3880,0,0,0,0,0,0,66.06
高雄縣,鳳山市,武松里,0,1,1316,15,1331,2230,0,0,0,0,0,0,59.69
高雄縣,鳳山市,忠誠里,0,1,1833,30,1863,2868,0,0,0,0,0,0,64.96
高雄縣,鳳山市,文英里,0,1,1414,23,1437,2197,0,0,0,0,0,0,65.41
高雄縣,鳳山市,文華里,0,1,2549,31,2580,3984,0,0,0,0,0,0,64.76
高雄縣,鳳山市,文山里,0,1,3017,40,3057,4637,0,0,0,0,0,0,65.93
高雄縣,鳳山市,文德里,0,1,2252,23,2275,4077,0,0,0,0,0,0,55.80
高雄縣,鳳山市,文衡里,0,1,1350,11,1361,2033,0,0,0,0,0,0,66.95
高雄縣,鳳山市,文福里,0,1,2662,34,2696,4625,0,0,0,0,0,0,58.29
高雄縣,鳳山市,成功里,0,1,571,6,577,817,0,0,0,0,0,0,70.62
高雄縣,鳳山市,縣口里,0,1,362,4,366,525,0,0,0,0,0,0,69.71
高雄縣,鳳山市,光明里,0,1,950,9,959,1374,0,0,0,0,0,0,69.80
高雄縣,鳳山市,和德里,0,1,1053,13,1066,1596,0,0,0,0,0,0,66.79
高雄縣,鳳山市,和興里,0,1,2897,25,2922,4412,0,0,0,0,0,0,66.23
高雄縣,鳳山市,南興里,0,1,644,11,655,1008,0,0,0,0,0,0,64.98
高雄縣,鳳山市,三民里,0,1,794,8,802,1099,0,0,0,0,0,0,72.98
高雄縣,鳳山市,新興里,0,1,850,9,859,1166,0,0,0,0,0,0,73.67
高雄縣,鳳山市,興仁里,0,1,2385,26,2411,3601,0,0,0,0,0,0,66.95
高雄縣,鳳山市,興中里,0,1,560,1,561,807,0,0,0,0,0,0,69.52
高雄縣,鳳山市,協和里,0,1,2275,24,2299,3354,0,0,0,0,0,0,68.55
高雄縣,鳳山市,忠義里,0,1,2287,19,2306,3526,0,0,0,0,0,0,65.40
高雄縣,鳳山市,忠孝里,0,1,3178,31,3209,4937,0,0,0,0,0,0,65.00
高雄縣,鳳山市,中和里,0,1,2107,21,2128,3177,0,0,0,0,0,0,66.98
高雄縣,鳳山市,誠正里,0,1,735,7,742,1063,0,0,0,0,0,0,69.80
高雄縣,鳳山市,誠義里,0,1,397,3,400,606,0,0,0,0,0,0,66.01
高雄縣,鳳山市,生明里,0,1,999,11,1010,1452,0,0,0,0,0,0,69.56
高雄縣,鳳山市,鎮東里,0,1,1399,21,1420,2203,0,0,0,0,0,0,64.46
高雄縣,鳳山市,瑞竹里,0,1,3160,40,3200,4798,0,0,0,0,0,0,66.69
高雄縣,鳳山市,瑞興里,0,1,2170,31,2201,3435,0,0,0,0,0,0,64.08
高雄縣,鳳山市,東門里,0,1,2129,20,2149,3342,0,0,0,0,0,0,64.30
高雄縣,鳳山市,誠德里,0,1,1391,16,1407,2059,0,0,0,0,0,0,68.33
高雄縣,鳳山市,誠信里,0,1,919,10,929,1577,0,0,0,0,0,0,58.91
高雄縣,鳳山市,誠智里,0,1,1410,24,1434,2194,0,0,0,0,0,0,65.36
高雄縣,鳳山市,鳳東里,0,1,2379,31,2410,3587,0,0,0,0,0,0,67.19
高雄縣,鳳山市,埤頂里,0,1,2854,27,2881,4281,0,0,0,0,0,0,67.30
高雄縣,鳳山市,美齡里,0,1,666,7,673,902,0,0,0,0,0,0,74.61
高雄縣,鳳山市,中正里,0,1,1366,13,1379,2059,0,0,0,0,0,0,66.97
高雄縣,鳳山市,海光里,0,1,2467,36,2503,3930,0,0,0,0,0,0,63.69
高雄縣,鳳山市,海風里,0,1,1790,20,1810,2477,0,0,0,0,0,0,73.07
高雄縣,鳳山市,國泰里,0,1,2373,24,2397,3679,0,0,0,0,0,0,65.15
高雄縣,鳳山市,國光里,0,1,2672,39,2711,4294,0,0,0,0,0,0,63.13
高雄縣,鳳山市,國隆里,0,1,939,10,949,1521,0,0,0,0,0,0,62.39
高雄縣,鳳山市,國富里,0,1,1164,13,1177,1890,0,0,0,0,0,0,62.28
高雄縣,鳳山市,武漢里,0,1,630,10,640,908,0,0,0,0,0,0,70.48
高雄縣,鳳山市,武慶里,0,1,666,10,676,1008,0,0,0,0,0,0,67.06
高雄縣,鳳山市,武漢里,0,1,2361,37,2398,3564,0,0,0,0,0,0,67.28
高雄縣,鳳山市,新甲里,0,1,1725,28,1753,2862,0,0,0,0,0,0,61.25
高雄縣,鳳山市,新武里,0,1,534,8,542,872,0,0,0,0,0,0,62.16
高雄縣,鳳山市,新泰里,0,1,1474,18,1492,2305,0,0,0,0,0,0,64.73
高雄縣,鳳山市,新樂里,0,1,1496,27,1523,2453,0,0,0,0,0,0,62.09
高雄縣,鳳山市,新強里,0,1,2050,13,2063,3101,0,0,0,0,0,0,66.53
高雄縣,鳳山市,海洋里,0,1,1721,26,1747,2552,0,0,0,0,0,0,68.46
高雄縣,鳳山市,新富里,0,1,1882,28,1910,3065,0,0,0,0,0,0,62.32
高雄縣,鳳山市,老爺里,0,1,3350,48,3398,5364,0,0,0,0,0,0,63.35
高雄縣,鳳山市,中民里,0,1,1759,24,1783,2957,0,0,0,0,0,0,60.30
高雄縣,鳳山市,中崙里,0,1,1116,11,1127,1702,0,0,0,0,0,0,66.22
高雄縣,鳳山市,中榮里,0,1,1974,24,1998,3232,0,0,0,0,0,0,61.82
高雄縣,鳳山市,過埤里,0,1,1517,22,1539,2354,0,0,0,0,0,0,65.38
高雄縣,鳳山市,正義里,0,1,3418,49,3467,5293,0,0,0,0,0,0,65.50
高雄縣,鳳山市,一甲里,0,1,1961,33,1994,3061,0,0,0,0,0,0,65.14
高雄縣,鳳山市,二甲里,0,1,1915,33,1948,2870,0,0,0,0,0,0,67.87
高雄縣,鳳山市,龍成里,0,1,1416,17,1433,2153,0,0,0,0,0,0,66.56
高雄縣,鳳山市,鎮南里,0,1,2540,32,2572,3624,0,0,0,0,0,0,70.97
高雄縣,鳳山市,富甲里,0,1,1307,21,1328,1904,0,0,0,0,0,0,69.75
高雄縣,鳳山市,善美里,0,1,2322,37,2359,3817,0,0,0,0,0,0,61.80
高雄縣,鳳山市,富榮里,0,1,1121,15,1136,1777,0,0,0,0,0,0,63.93
高雄縣,鳳山市,南和里,0,1,1651,14,1665,2494,0,0,0,0,0,0,66.76
高雄縣,鳳山市,南成里,0,1,2137,32,2169,3177,0,0,0,0,0,0,68.27
高雄縣,鳳山市,天興里,0,1,2244,37,2281,3430,0,0,0,0,0,0,66.50
高雄縣,鳳山市,大德里,0,1,1992,29,2021,2896,0,0,0,0,0,0,69.79
高雄縣,鳳山市,五福里,0,1,2044,30,2074,3109,0,0,0,0,0,0,66.71
高雄縣,鳳山市,福興里,0,1,3377,51,3428,5170,0,0,0,0,0,0,66.31
高雄縣,鳳山市,福祥里,0,1,1324,28,1352,2111,0,0,0,0,0,0,64.05
高雄縣,鳳山市,福誠里,0,1,1549,27,1576,2644,0,0,0,0,0,0,59.61
高雄縣,林園鄉,仁愛村,0,1,1659,17,1676,2393,0,0,0,0,0,0,70.04
高雄縣,林園鄉,林園村,0,1,1942,25,1967,2763,0,0,0,0,0,0,71.19
高雄縣,林園鄉,文賢村,0,1,1411,15,1426,2019,0,0,0,0,0,0,70.63
高雄縣,林園鄉,東林村,0,1,1633,15,1648,2393,0,0,0,0,0,0,68.87
高雄縣,林園鄉,溪州村,0,1,2143,22,2165,3081,0,0,0,0,0,0,70.27
高雄縣,林園鄉,五福村,0,1,1131,17,1148,1772,0,0,0,0,0,0,64.79
高雄縣,林園鄉,潭頭村,0,1,1558,20,1578,2205,0,0,0,0,0,0,71.56
高雄縣,林園鄉,中厝村,0,1,1811,28,1839,2469,0,0,0,0,0,0,74.48
高雄縣,林園鄉,林內村,0,1,1301,15,1316,1713,0,0,0,0,0,0,76.82
高雄縣,林園鄉,王公村,0,1,1953,24,1977,2709,0,0,0,0,0,0,72.98
高雄縣,林園鄉,廣應村,0,1,1897,16,1913,2565,0,0,0,0,0,0,74.58
高雄縣,林園鄉,林家村,0,1,968,5,973,1220,0,0,0,0,0,0,79.75
高雄縣,林園鄉,龔厝村,0,1,1114,10,1124,1518,0,0,0,0,0,0,74.04
高雄縣,林園鄉,中門村,0,1,1350,21,1371,1878,0,0,0,0,0,0,73.00
高雄縣,林園鄉,頂厝村,0,1,2181,21,2202,3056,0,0,0,0,0,0,72.05
高雄縣,林園鄉,港埔村,0,1,1144,12,1156,1559,0,0,0,0,0,0,74.15
高雄縣,林園鄉,港嘴村,0,1,869,10,879,1226,0,0,0,0,0,0,71.70
高雄縣,林園鄉,西溪村,0,1,1741,23,1764,2522,0,0,0,0,0,0,69.94
高雄縣,林園鄉,中芸村,0,1,1202,14,1216,1683,0,0,0,0,0,0,72.25
高雄縣,林園鄉,鳳芸村,0,1,1251,11,1262,1629,0,0,0,0,0,0,77.47
高雄縣,林園鄉,東汕村,0,1,640,6,646,904,0,0,0,0,0,0,71.46
高雄縣,林園鄉,西汕村,0,1,528,7,535,743,0,0,0,0,0,0,72.01
高雄縣,林園鄉,中汕村,0,1,1410,11,1421,2104,0,0,0,0,0,0,67.54
高雄縣,林園鄉,北汕村,0,1,984,10,994,1503,0,0,0,0,0,0,66.13
高雄縣,大寮鄉,義和村,0,1,1435,24,1459,1961,0,0,0,0,0,0,74.40
高雄縣,大寮鄉,溪寮村,0,1,982,15,997,1283,0,0,0,0,0,0,77.71
高雄縣,大寮鄉,江山村,0,1,1062,19,1081,1484,0,0,0,0,0,0,72.84
高雄縣,大寮鄉,中庄村,0,1,5149,56,5205,7820,0,0,0,0,0,0,66.56
高雄縣,大寮鄉,後庄村,0,1,3032,39,3071,4639,0,0,0,0,0,0,66.20
高雄縣,大寮鄉,前庄村,0,1,1364,17,1381,1857,0,0,0,0,0,0,74.37
高雄縣,大寮鄉,中興村,0,1,3714,47,3761,5509,0,0,0,0,0,0,68.27
高雄縣,大寮鄉,忠義村,0,1,1743,21,1764,2421,0,0,0,0,0,0,72.86
高雄縣,大寮鄉,光武村,0,1,1552,21,1573,2143,0,0,0,0,0,0,73.40
高雄縣,大寮鄉,復興村,0,1,2812,23,2835,3798,0,0,0,0,0,0,74.64
高雄縣,大寮鄉,翁園村,0,1,1666,21,1687,2205,0,0,0,0,0,0,76.51
高雄縣,大寮鄉,琉球村,0,1,2041,18,2059,2841,0,0,0,0,0,0,72.47
高雄縣,大寮鄉,永芳村,0,1,3678,34,3712,5344,0,0,0,0,0,0,69.46
高雄縣,大寮鄉,山頂村,0,1,3260,52,3312,5033,0,0,0,0,0,0,65.81
高雄縣,大寮鄉,會社村,0,1,2933,35,2968,4298,0,0,0,0,0,0,69.06
高雄縣,大寮鄉,三隆村,0,1,2588,28,2616,3663,0,0,0,0,0,0,71.42
高雄縣,大寮鄉,上寮村,0,1,1415,9,1424,1919,0,0,0,0,0,0,74.21
高雄縣,大寮鄉,大寮村,0,1,3174,48,3222,5003,0,0,0,0,0,0,64.40
高雄縣,大寮鄉,拷潭村,0,1,893,16,909,1198,0,0,0,0,0,0,75.88
高雄縣,大寮鄉,內坑村,0,1,1999,30,2029,3129,0,0,0,0,0,0,64.84
高雄縣,大寮鄉,新厝村,0,1,1021,14,1035,1337,0,0,0,0,0,0,77.41
高雄縣,大寮鄉,過溪村,0,1,1144,19,1163,1599,0,0,0,0,0,0,72.73
高雄縣,大寮鄉,潮寮村,0,1,1904,21,1925,2479,0,0,0,0,0,0,77.65
高雄縣,大寮鄉,會結村,0,1,940,13,953,1202,0,0,0,0,0,0,79.28
高雄縣,大寮鄉,昭明村,0,1,1866,17,1883,2695,0,0,0,0,0,0,69.87
高雄縣,大寮鄉,義仁村,0,1,1214,18,1232,1742,0,0,0,0,0,0,70.72
高雄縣,大樹鄉,小坪村,0,1,914,7,921,1192,0,0,0,0,0,0,77.27
高雄縣,大樹鄉,龍目村,0,1,1137,9,1146,1520,0,0,0,0,0,0,75.39
高雄縣,大樹鄉,大樹村,0,1,1532,9,1541,2146,0,0,0,0,0,0,71.81
高雄縣,大樹鄉,檨腳村,0,1,2130,22,2152,3004,0,0,0,0,0,0,71.64
高雄縣,大樹鄉,興山村,0,1,777,8,785,1066,0,0,0,0,0,0,73.64
高雄縣,大樹鄉,和山村,0,1,695,3,698,950,0,0,0,0,0,0,73.47
高雄縣,大樹鄉,姑山村,0,1,771,8,779,1029,0,0,0,0,0,0,75.70
高雄縣,大樹鄉,三和村,0,1,628,4,632,866,0,0,0,0,0,0,72.98
高雄縣,大樹鄉,大坑村,0,1,883,5,888,1263,0,0,0,0,0,0,70.31
高雄縣,大樹鄉,溪埔村,0,1,633,8,641,822,0,0,0,0,0,0,77.98
高雄縣,大樹鄉,竹寮村,0,1,1361,19,1380,1980,0,0,0,0,0,0,69.70
高雄縣,大樹鄉,九曲村,0,1,2522,35,2557,3707,0,0,0,0,0,0,68.98
高雄縣,大樹鄉,久堂村,0,1,2825,38,2863,3965,0,0,0,0,0,0,72.21
高雄縣,大樹鄉,水安村,0,1,1505,14,1519,2100,0,0,0,0,0,0,72.33
高雄縣,大樹鄉,水寮村,0,1,1679,12,1691,2252,0,0,0,0,0,0,75.09
高雄縣,大樹鄉,井腳村,0,1,1152,9,1161,1548,0,0,0,0,0,0,75.00
高雄縣,大樹鄉,溪埔村,0,1,757,7,764,1032,0,0,0,0,0,0,74.03
高雄縣,大樹鄉,興田村,0,1,1338,17,1355,1909,0,0,0,0,0,0,70.98
高雄縣,大樹鄉,鐘鈴村,0,1,491,5,496,686,0,0,0,0,0,0,72.30
高雄縣,大社鄉,嘉誠村,0,1,685,8,693,936,0,0,0,0,0,0,74.04
高雄縣,大社鄉,保社村,0,1,1247,11,1258,1757,0,0,0,0,0,0,71.60
高雄縣,大社鄉,大社村,0,1,2527,43,2570,3727,0,0,0,0,0,0,68.96
高雄縣,大社鄉,保安村,0,1,1657,26,1683,2352,0,0,0,0,0,0,71.56
高雄縣,大社鄉,三奶村,0,1,1783,31,1814,2524,0,0,0,0,0,0,71.87
高雄縣,大社鄉,觀音村,0,1,2865,38,2903,4276,0,0,0,0,0,0,67.89
高雄縣,大社鄉,神農村,0,1,2190,37,2227,3364,0,0,0,0,0,0,66.20
高雄縣,大社鄉,中里村,0,1,1724,28,1752,2392,0,0,0,0,0,0,73.24
高雄縣,大社鄉,翠屏村,0,1,938,12,950,1286,0,0,0,0,0,0,73.87
高雄縣,仁武鄉,仁武村,0,1,2722,36,2758,3883,0,0,0,0,0,0,71.03
高雄縣,仁武鄉,文武村,0,1,2232,38,2270,3228,0,0,0,0,0,0,70.32
高雄縣,仁武鄉,後安村,0,1,1324,18,1342,1932,0,0,0,0,0,0,69.46
高雄縣,仁武鄉,竹後村,0,1,1463,20,1483,2114,0,0,0,0,0,0,70.15
高雄縣,仁武鄉,中華村,0,1,805,14,819,1269,0,0,0,0,0,0,64.54
高雄縣,仁武鄉,八卦村,0,1,2297,45,2342,3529,0,0,0,0,0,0,66.36
高雄縣,仁武鄉,五和村,0,1,1196,24,1220,1760,0,0,0,0,0,0,69.32
高雄縣,仁武鄉,高楠村,0,1,1176,31,1207,1639,0,0,0,0,0,0,73.64
高雄縣,仁武鄉,大灣村,0,1,946,15,961,1427,0,0,0,0,0,0,67.34
高雄縣,仁武鄉,赤山村,0,1,915,13,928,1302,0,0,0,0,0,0,71.27
高雄縣,仁武鄉,仁和村,0,1,1009,14,1023,1549,0,0,0,0,0,0,66.04
高雄縣,仁武鄉,灣內村,0,1,1704,33,1737,2575,0,0,0,0,0,0,67.46
高雄縣,仁武鄉,仁慈村,0,1,708,10,718,1056,0,0,0,0,0,0,67.99
高雄縣,仁武鄉,考潭村,0,1,1686,20,1706,2489,0,0,0,0,0,0,68.54
高雄縣,仁武鄉,烏林村,0,1,1758,27,1785,2471,0,0,0,0,0,0,72.24
高雄縣,仁武鄉,仁福村,0,1,339,6,345,469,0,0,0,0,0,0,73.56
高雄縣,鳥松鄉,鳥松村,0,1,4004,46,4050,6297,0,0,0,0,0,0,64.32
高雄縣,鳥松鄉,夢裡村,0,1,1568,15,1583,2033,0,0,0,0,0,0,77.87
高雄縣,鳥松鄉,大華村,0,1,4034,47,4081,6317,0,0,0,0,0,0,64.60
高雄縣,鳥松鄉,濫埔村,0,1,1865,21,1886,2468,0,0,0,0,0,0,76.42
高雄縣,鳥松鄉,仁美村,0,1,3851,41,3892,5208,0,0,0,0,0,0,74.73
高雄縣,鳥松鄉,華美村,0,1,2116,26,2142,2919,0,0,0,0,0,0,73.38
高雄縣,鳥松鄉,大竹村,0,1,491,10,501,628,0,0,0,0,0,0,79.78
高雄縣,岡山鎮,岡山里,0,1,2270,29,2299,3371,0,0,0,0,0,0,68.20
高雄縣,岡山鎮,平安里,0,1,895,9,904,1275,0,0,0,0,0,0,70.90
高雄縣,岡山鎮,壽天里,0,1,1873,32,1905,2834,0,0,0,0,0,0,67.22
高雄縣,岡山鎮,維仁里,0,1,911,11,922,1320,0,0,0,0,0,0,69.85
高雄縣,岡山鎮,灣裡里,0,1,842,8,850,1194,0,0,0,0,0,0,71.19
高雄縣,岡山鎮,大遼里,0,1,820,10,830,1138,0,0,0,0,0,0,72.93
高雄縣,岡山鎮,後紅里,0,1,1642,27,1669,2429,0,0,0,0,0,0,68.71
高雄縣,岡山鎮,碧紅里,0,1,1725,20,1745,2610,0,0,0,0,0,0,66.86
高雄縣,岡山鎮,程香里,0,1,1730,27,1757,2562,0,0,0,0,0,0,68.58
高雄縣,岡山鎮,竹圍里,0,1,2184,36,2220,3377,0,0,0,0,0,0,65.74
高雄縣,岡山鎮,台上里,0,1,1915,24,1939,2756,0,0,0,0,0,0,70.36
高雄縣,岡山鎮,為隨里,0,1,464,8,472,568,0,0,0,0,0,0,83.10
高雄縣,岡山鎮,前峰里,0,1,1635,22,1657,2415,0,0,0,0,0,0,68.61
高雄縣,岡山鎮,壽峰里,0,1,1134,23,1157,1616,0,0,0,0,0,0,71.60
高雄縣,岡山鎮,仁壽里,0,1,2208,30,2238,3179,0,0,0,0,0,0,70.40
高雄縣,岡山鎮,協和里,0,1,2023,28,2051,2932,0,0,0,0,0,0,69.95
高雄縣,岡山鎮,本洲里,0,1,975,8,983,1259,0,0,0,0,0,0,78.08
高雄縣,岡山鎮,後協里,0,1,2826,33,2859,4282,0,0,0,0,0,0,66.77
高雄縣,岡山鎮,協榮里,0,1,1316,15,1331,1830,0,0,0,0,0,0,72.73
高雄縣,岡山鎮,劉厝里,0,1,885,18,903,1265,0,0,0,0,0,0,71.38
高雄縣,岡山鎮,白米里,0,1,560,5,565,721,0,0,0,0,0,0,78.36
高雄縣,岡山鎮,石潭里,0,1,909,11,920,1179,0,0,0,0,0,0,78.03
高雄縣,岡山鎮,福興里,0,1,730,6,736,986,0,0,0,0,0,0,74.65
高雄縣,岡山鎮,嘉興里,0,1,2219,31,2250,3067,0,0,0,0,0,0,73.36
高雄縣,岡山鎮,嘉峰里,0,1,1220,10,1230,1564,0,0,0,0,0,0,78.64
高雄縣,岡山鎮,潭底里,0,1,575,10,585,717,0,0,0,0,0,0,81.59
高雄縣,岡山鎮,華崗里,0,1,1028,11,1039,1259,0,0,0,0,0,0,82.53
高雄縣,岡山鎮,三和里,0,1,534,9,543,707,0,0,0,0,0,0,76.80
高雄縣,岡山鎮,大莊里,0,1,625,11,636,819,0,0,0,0,0,0,77.66
高雄縣,岡山鎮,忠孝里,0,1,663,4,667,958,0,0,0,0,0,0,69.62
高雄縣,岡山鎮,和平里,0,1,650,6,656,943,0,0,0,0,0,0,69.57
高雄縣,岡山鎮,信義里,0,1,1464,12,1476,2116,0,0,0,0,0,0,69.75
高雄縣,岡山鎮,仁愛里,0,1,987,8,995,1394,0,0,0,0,0,0,71.38
高雄縣,岡山鎮,四維里,0,1,1005,6,1011,1339,0,0,0,0,0,0,75.50
高雄縣,岡山鎮,復興里,0,1,362,3,365,508,0,0,0,0,0,0,71.85
高雄縣,橋頭鄉,橋頭村,0,1,1034,14,1048,1490,0,0,0,0,0,0,70.34
高雄縣,橋頭鄉,橋南村,0,1,651,8,659,891,0,0,0,0,0,0,73.96
高雄縣,橋頭鄉,興糖村,0,1,237,5,242,321,0,0,0,0,0,0,75.39
高雄縣,橋頭鄉,仕隆村,0,1,1505,17,1522,2184,0,0,0,0,0,0,69.69
高雄縣,橋頭鄉,仕豐村,0,1,1437,20,1457,2080,0,0,0,0,0,0,70.05
高雄縣,橋頭鄉,仕和村,0,1,2078,19,2097,3002,0,0,0,0,0,0,69.85
高雄縣,橋頭鄉,新莊村,0,1,954,11,965,1250,0,0,0,0,0,0,77.20
高雄縣,橋頭鄉,甲北村,0,1,1420,20,1440,1956,0,0,0,0,0,0,73.62
高雄縣,橋頭鄉,甲南村,0,1,1465,25,1490,2021,0,0,0,0,0,0,73.73
高雄縣,橋頭鄉,頂鹽村,0,1,738,9,747,1012,0,0,0,0,0,0,73.81
高雄縣,橋頭鄉,白樹村,0,1,1763,22,1785,2472,0,0,0,0,0,0,72.21
高雄縣,橋頭鄉,芋寮村,0,1,1298,13,1311,1771,0,0,0,0,0,0,74.03
高雄縣,橋頭鄉,西林村,0,1,1111,12,1123,1441,0,0,0,0,0,0,77.93
高雄縣,橋頭鄉,東林村,0,1,1539,15,1554,2022,0,0,0,0,0,0,76.85
高雄縣,橋頭鄉,德松村,0,1,685,7,692,929,0,0,0,0,0,0,74.49
高雄縣,橋頭鄉,筆秀村,0,1,1027,5,1032,1339,0,0,0,0,0,0,77.07
高雄縣,橋頭鄉,中崎村,0,1,480,8,488,640,0,0,0,0,0,0,76.25
高雄縣,燕巢鄉,金山村,0,1,354,3,357,444,0,0,0,0,0,0,80.41
高雄縣,燕巢鄉,尖山村,0,1,852,13,865,1102,0,0,0,0,0,0,78.49
高雄縣,燕巢鄉,東燕村,0,1,1607,20,1627,2105,0,0,0,0,0,0,77.29
高雄縣,燕巢鄉,西燕村,0,1,2141,20,2161,2875,0,0,0,0,0,0,75.17
高雄縣,燕巢鄉,南燕村,0,1,1921,24,1945,2498,0,0,0,0,0,0,77.86
高雄縣,燕巢鄉,瓊林村,0,1,1277,23,1300,1664,0,0,0,0,0,0,78.13
高雄縣,燕巢鄉,安招村,0,1,3065,37,3102,4181,0,0,0,0,0,0,74.19
高雄縣,燕巢鄉,角宿村,0,1,1530,17,1547,2068,0,0,0,0,0,0,74.81
高雄縣,燕巢鄉,鳳雄村,0,1,1680,27,1707,2219,0,0,0,0,0,0,76.93
高雄縣,燕巢鄉,橫山村,0,1,1247,22,1269,1738,0,0,0,0,0,0,73.01
高雄縣,燕巢鄉,深水村,0,1,1733,35,1768,2445,0,0,0,0,0,0,72.31
高雄縣,田寮鄉,鹿埔村,0,1,287,1,288,384,0,0,0,0,0,0,75.00
高雄縣,田寮鄉,古亭村,0,1,509,4,513,680,0,0,0,0,0,0,75.44
高雄縣,田寮鄉,崇德村,0,1,769,6,775,997,0,0,0,0,0,0,77.73
高雄縣,田寮鄉,三和村,0,1,299,3,302,423,0,0,0,0,0,0,71.39
高雄縣,田寮鄉,西德村,0,1,659,15,674,937,0,0,0,0,0,0,71.93
高雄縣,田寮鄉,南安村,0,1,976,19,995,1395,0,0,0,0,0,0,71.33
高雄縣,田寮鄉,大同村,0,1,270,4,274,414,0,0,0,0,0,0,66.18
高雄縣,田寮鄉,田寮村,0,1,332,2,334,471,0,0,0,0,0,0,70.91
高雄縣,田寮鄉,七星村,0,1,690,5,695,1028,0,0,0,0,0,0,67.61
高雄縣,田寮鄉,新興村,0,1,986,16,1002,1304,0,0,0,0,0,0,76.84
高雄縣,阿蓮鄉,阿蓮村,0,1,2602,33,2635,3808,0,0,0,0,0,0,69.20
高雄縣,阿蓮鄉,南蓮村,0,1,1782,33,1815,2568,0,0,0,0,0,0,70.68
高雄縣,阿蓮鄉,清蓮村,0,1,1690,23,1713,2401,0,0,0,0,0,0,71.35
高雄縣,阿蓮鄉,和蓮村,0,1,1305,19,1324,1916,0,0,0,0,0,0,69.10
高雄縣,阿蓮鄉,青旗村,0,1,967,19,986,1285,0,0,0,0,0,0,76.73
高雄縣,阿蓮鄉,石安村,0,1,806,21,827,1246,0,0,0,0,0,0,66.37
高雄縣,阿蓮鄉,中路村,0,1,1286,32,1318,1840,0,0,0,0,0,0,71.63
高雄縣,阿蓮鄉,峰山村,0,1,887,14,901,1116,0,0,0,0,0,0,80.73
高雄縣,阿蓮鄉,港後村,0,1,1290,18,1308,1700,0,0,0,0,0,0,76.94
高雄縣,阿蓮鄉,崗山村,0,1,509,10,519,705,0,0,0,0,0,0,73.62
高雄縣,阿蓮鄉,復安村,0,1,1114,32,1146,1504,0,0,0,0,0,0,76.20
高雄縣,阿蓮鄉,玉庫村,0,1,717,15,732,939,0,0,0,0,0,0,77.96
高雄縣,路竹鄉,竹園村,0,1,1281,13,1294,1666,0,0,0,0,0,0,77.67
高雄縣,路竹鄉,下坑村,0,1,1894,25,1919,2416,0,0,0,0,0,0,79.43
高雄縣,路竹鄉,甲南村,0,1,2070,46,2116,2792,0,0,0,0,0,0,75.79
高雄縣,路竹鄉,甲北村,0,1,1369,16,1385,1826,0,0,0,0,0,0,75.85
高雄縣,路竹鄉,社東村,0,1,1185,13,1198,1526,0,0,0,0,0,0,78.51
高雄縣,路竹鄉,社中村,0,1,722,8,730,919,0,0,0,0,0,0,79.43
高雄縣,路竹鄉,社西村,0,1,1601,29,1630,2170,0,0,0,0,0,0,75.12
高雄縣,路竹鄉,社南村,0,1,2269,32,2301,3114,0,0,0,0,0,0,73.89
高雄縣,路竹鄉,竹東村,0,1,1765,18,1783,2537,0,0,0,0,0,0,70.28
高雄縣,路竹鄉,竹南村,0,1,1811,26,1837,2513,0,0,0,0,0,0,73.10
高雄縣,路竹鄉,竹西村,0,1,1544,20,1564,2001,0,0,0,0,0,0,78.16
高雄縣,路竹鄉,文南村,0,1,1427,18,1445,1956,0,0,0,0,0,0,73.88
高雄縣,路竹鄉,文北村,0,1,1808,32,1840,2416,0,0,0,0,0,0,76.16
高雄縣,路竹鄉,竹滬村,0,1,1607,24,1631,2218,0,0,0,0,0,0,73.53
高雄縣,路竹鄉,頂寮村,0,1,887,14,901,1142,0,0,0,0,0,0,78.90
高雄縣,路竹鄉,新達村,0,1,861,9,870,1147,0,0,0,0,0,0,75.85
高雄縣,路竹鄉,後鄉村,0,1,680,14,694,873,0,0,0,0,0,0,79.50
高雄縣,路竹鄉,北嶺村,0,1,807,4,811,1004,0,0,0,0,0,0,80.78
高雄縣,路竹鄉,三爺村,0,1,669,15,684,816,0,0,0,0,0,0,83.82
高雄縣,路竹鄉,鴨寮村,0,1,1037,17,1054,1369,0,0,0,0,0,0,76.99
高雄縣,湖內鄉,大湖村,0,1,1722,30,1752,2315,0,0,0,0,0,0,75.68
高雄縣,湖內鄉,田尾村,0,1,798,5,803,1046,0,0,0,0,0,0,76.77
高雄縣,湖內鄉,湖內村,0,1,2632,46,2678,4058,0,0,0,0,0,0,65.99
高雄縣,湖內鄉,海埔村,0,1,1211,17,1228,1656,0,0,0,0,0,0,74.15
高雄縣,湖內鄉,海山村,0,1,842,13,855,1128,0,0,0,0,0,0,75.80
高雄縣,湖內鄉,劉家村,0,1,818,10,828,1099,0,0,0,0,0,0,75.34
高雄縣,湖內鄉,太爺村,0,1,612,7,619,845,0,0,0,0,0,0,73.25
高雄縣,湖內鄉,公館村,0,1,1000,16,1016,1429,0,0,0,0,0,0,71.10
高雄縣,湖內鄉,葉厝村,0,1,1123,15,1138,1635,0,0,0,0,0,0,69.60
高雄縣,湖內鄉,文賢村,0,1,800,23,823,1155,0,0,0,0,0,0,71.26
高雄縣,湖內鄉,中賢村,0,1,1397,24,1421,1951,0,0,0,0,0,0,72.83
高雄縣,湖內鄉,逸賢村,0,1,664,11,675,928,0,0,0,0,0,0,72.74
高雄縣,湖內鄉,忠興村,0,1,575,6,581,740,0,0,0,0,0,0,78.51
高雄縣,茄萣鄉,福德村,0,1,769,6,775,1032,0,0,0,0,0,0,75.10
高雄縣,茄萣鄉,萬福村,0,1,633,13,646,887,0,0,0,0,0,0,72.83
高雄縣,茄萣鄉,白雲村,0,1,1089,17,1106,1565,0,0,0,0,0,0,70.67
高雄縣,茄萣鄉,嘉賜村,0,1,1800,21,1821,2602,0,0,0,0,0,0,69.98
高雄縣,茄萣鄉,嘉安村,0,1,960,11,971,1349,0,0,0,0,0,0,71.98
高雄縣,茄萣鄉,嘉樂村,0,1,1328,11,1339,1840,0,0,0,0,0,0,72.77
高雄縣,茄萣鄉,嘉泰村,0,1,853,7,860,1212,0,0,0,0,0,0,70.96
高雄縣,茄萣鄉,嘉福村,0,1,765,11,776,1059,0,0,0,0,0,0,73.28
高雄縣,茄萣鄉,和協村,0,1,851,11,862,1208,0,0,0,0,0,0,71.36
高雄縣,茄萣鄉,嘉定村,0,1,940,10,950,1325,0,0,0,0,0,0,71.70
高雄縣,茄萣鄉,保定村,0,1,1886,26,1912,2816,0,0,0,0,0,0,67.90
高雄縣,茄萣鄉,大定村,0,1,854,9,863,1163,0,0,0,0,0,0,74.20
高雄縣,茄萣鄉,光定村,0,1,737,10,747,1024,0,0,0,0,0,0,72.95
高雄縣,茄萣鄉,吉定村,0,1,942,3,945,1213,0,0,0,0,0,0,77.91
高雄縣,茄萣鄉,崎漏村,0,1,2132,26,2158,3062,0,0,0,0,0,0,70.48
高雄縣,永安鄉,永安村,0,1,558,2,560,738,0,0,0,0,0,0,75.88
高雄縣,永安鄉,永華村,0,1,1931,23,1954,2608,0,0,0,0,0,0,74.92
高雄縣,永安鄉,新港村,0,1,1182,11,1193,1575,0,0,0,0,0,0,75.75
高雄縣,永安鄉,鹽田村,0,1,821,5,826,1173,0,0,0,0,0,0,70.42
高雄縣,永安鄉,保寧村,0,1,1448,7,1455,1906,0,0,0,0,0,0,76.34
高雄縣,永安鄉,維新村,0,1,1715,22,1737,2384,0,0,0,0,0,0,72.86
高雄縣,彌陀鄉,舊港村,0,1,1097,17,1114,1405,0,0,0,0,0,0,79.29
高雄縣,彌陀鄉,文安村,0,1,1416,18,1434,1791,0,0,0,0,0,0,80.07
高雄縣,彌陀鄉,鹽埕村,0,1,1411,35,1446,1830,0,0,0,0,0,0,79.02
高雄縣,彌陀鄉,過港村,0,1,746,8,754,908,0,0,0,0,0,0,83.04
高雄縣,彌陀鄉,光和村,0,1,798,12,810,1051,0,0,0,0,0,0,77.07
高雄縣,彌陀鄉,彌靖村,0,1,1365,13,1378,1769,0,0,0,0,0,0,77.90
高雄縣,彌陀鄉,彌仁村,0,1,471,6,477,586,0,0,0,0,0,0,81.40
高雄縣,彌陀鄉,彌壽村,0,1,593,4,597,758,0,0,0,0,0,0,78.76
高雄縣,彌陀鄉,彌陀村,0,1,1148,16,1164,1461,0,0,0,0,0,0,79.67
高雄縣,彌陀鄉,海尾村,0,1,624,6,630,819,0,0,0,0,0,0,76.92
高雄縣,彌陀鄉,漯底村,0,1,800,7,807,924,0,0,0,0,0,0,87.34
高雄縣,彌陀鄉,南寮村,0,1,1505,21,1526,1883,0,0,0,0,0,0,81.04
高雄縣,梓官鄉,梓信村,0,1,1303,24,1327,1841,0,0,0,0,0,0,72.08
高雄縣,梓官鄉,梓義村,0,1,1340,24,1364,1923,0,0,0,0,0,0,70.93
高雄縣,梓官鄉,梓和村,0,1,1589,15,1604,2179,0,0,0,0,0,0,73.61
高雄縣,梓官鄉,梓平村,0,1,813,9,822,1051,0,0,0,0,0,0,78.21
高雄縣,梓官鄉,中崙村,0,1,734,14,748,954,0,0,0,0,0,0,78.41
高雄縣,梓官鄉,同安村,0,1,671,8,679,841,0,0,0,0,0,0,80.74
高雄縣,梓官鄉,大舍村,0,1,2338,46,2384,3262,0,0,0,0,0,0,73.08
高雄縣,梓官鄉,赤崁村,0,1,1417,25,1442,1888,0,0,0,0,0,0,76.38
高雄縣,梓官鄉,赤東村,0,1,1799,17,1816,2341,0,0,0,0,0,0,77.57
高雄縣,梓官鄉,赤西村,0,1,498,9,507,700,0,0,0,0,0,0,72.43
高雄縣,梓官鄉,禮蚵村,0,1,1699,31,1730,2283,0,0,0,0,0,0,75.78
高雄縣,梓官鄉,智蚵村,0,1,1528,25,1553,2150,0,0,0,0,0,0,72.23
高雄縣,梓官鄉,信蚵村,0,1,975,18,993,1378,0,0,0,0,0,0,72.06
高雄縣,梓官鄉,茄苳村,0,1,1631,28,1659,2152,0,0,0,0,0,0,77.09
高雄縣,梓官鄉,典寶村,0,1,1651,25,1676,2265,0,0,0,0,0,0,74.00
高雄縣,旗山鎮,太平里,0,1,1497,9,1506,2242,0,0,0,0,0,0,67.17
高雄縣,旗山鎮,大德里,0,1,1702,23,1725,2426,0,0,0,0,0,0,71.10
高雄縣,旗山鎮,湄洲里,0,1,619,11,630,928,0,0,0,0,0,0,67.89
高雄縣,旗山鎮,鼓山里,0,1,475,3,478,691,0,0,0,0,0,0,69.18
高雄縣,旗山鎮,新山里,0,1,623,3,626,855,0,0,0,0,0,0,73.22
高雄縣,旗山鎮,和平里,0,1,495,7,502,715,0,0,0,0,0,0,70.21
高雄縣,旗山鎮,竹峰里,0,1,372,4,376,505,0,0,0,0,0,0,74.46
高雄縣,旗山鎮,瑞吉里,0,1,1305,14,1319,1845,0,0,0,0,0,0,71.49
高雄縣,旗山鎮,永和里,0,1,1984,29,2013,2854,0,0,0,0,0,0,70.53
高雄縣,旗山鎮,三協里,0,1,1306,22,1328,1867,0,0,0,0,0,0,71.13
高雄縣,旗山鎮,圓富里,0,1,1299,24,1323,1869,0,0,0,0,0,0,70.79
高雄縣,旗山鎮,中正里,0,1,1164,8,1172,1539,0,0,0,0,0,0,76.15
高雄縣,旗山鎮,大林里,0,1,1102,17,1119,1588,0,0,0,0,0,0,70.47
高雄縣,旗山鎮,上洲里,0,1,750,6,756,994,0,0,0,0,0,0,76.06
高雄縣,旗山鎮,鯤洲里,0,1,723,10,733,937,0,0,0,0,0,0,78.23
高雄縣,旗山鎮,大山里,0,1,1039,17,1056,1349,0,0,0,0,0,0,78.28
高雄縣,旗山鎮,中洲里,0,1,778,7,785,1027,0,0,0,0,0,0,76.44
高雄縣,旗山鎮,南洲里,0,1,1052,16,1068,1402,0,0,0,0,0,0,76.18
高雄縣,旗山鎮,新光里,0,1,743,5,748,958,0,0,0,0,0,0,78.08
高雄縣,旗山鎮,南勝里,0,1,1757,34,1791,2391,0,0,0,0,0,0,74.91
高雄縣,旗山鎮,東平里,0,1,1311,18,1329,1845,0,0,0,0,0,0,72.03
高雄縣,旗山鎮,東昌里,0,1,467,4,471,660,0,0,0,0,0,0,71.36
高雄縣,旗山鎮,糖廠里,0,1,291,1,292,376,0,0,0,0,0,0,77.66
高雄縣,旗山鎮,廣福里,0,1,442,8,450,588,0,0,0,0,0,0,76.53
高雄縣,旗山鎮,中寮里,0,1,145,1,146,201,0,0,0,0,0,0,72.64
高雄縣,美濃鎮,中圳里,0,1,1221,17,1238,1654,0,0,0,0,0,0,74.85
高雄縣,美濃鎮,東門里,0,1,1034,18,1052,1456,0,0,0,0,0,0,72.25
高雄縣,美濃鎮,泰安里,0,1,1011,12,1023,1407,0,0,0,0,0,0,72.71
高雄縣,美濃鎮,合和里,0,1,1640,19,1659,2266,0,0,0,0,0,0,73.21
高雄縣,美濃鎮,瀰濃里,0,1,1622,16,1638,2220,0,0,0,0,0,0,73.78
高雄縣,美濃鎮,福安里,0,1,1846,10,1856,2516,0,0,0,0,0,0,73.77
高雄縣,美濃鎮,祿興里,0,1,1730,23,1753,2474,0,0,0,0,0,0,70.86
高雄縣,美濃鎮,中壇里,0,1,1504,9,1513,2008,0,0,0,0,0,0,75.35
高雄縣,美濃鎮,德興里,0,1,1175,6,1181,1511,0,0,0,0,0,0,78.16
高雄縣,美濃鎮,清水里,0,1,1256,14,1270,1720,0,0,0,0,0,0,73.84
高雄縣,美濃鎮,吉和里,0,1,1063,8,1071,1442,0,0,0,0,0,0,74.27
高雄縣,美濃鎮,吉洋里,0,1,1483,18,1501,2047,0,0,0,0,0,0,73.33
高雄縣,美濃鎮,吉東里,0,1,1254,14,1268,1666,0,0,0,0,0,0,76.11
高雄縣,美濃鎮,龍山里,0,1,1580,25,1605,2235,0,0,0,0,0,0,71.81
高雄縣,美濃鎮,獅山里,0,1,1773,23,1796,2364,0,0,0,0,0,0,75.97
高雄縣,美濃鎮,龍肚里,0,1,1262,15,1277,1677,0,0,0,0,0,0,76.15
高雄縣,美濃鎮,廣德里,0,1,1019,11,1030,1429,0,0,0,0,0,0,72.08
高雄縣,美濃鎮,興隆里,0,1,896,9,905,1215,0,0,0,0,0,0,74.49
高雄縣,美濃鎮,廣林里,0,1,1227,14,1241,1770,0,0,0,0,0,0,70.11
高雄縣,六龜鄉,六龜村,0,1,648,8,656,1075,0,0,0,0,0,0,61.02
高雄縣,六龜鄉,義寶村,0,1,891,14,905,1233,0,0,0,0,0,0,73.40
高雄縣,六龜鄉,文武村,0,1,1013,23,1036,1640,0,0,0,0,0,0,63.17
高雄縣,六龜鄉,中興村,0,1,874,17,891,1387,0,0,0,0,0,0,64.24
高雄縣,六龜鄉,興龍村,0,1,637,10,647,951,0,0,0,0,0,0,68.03
高雄縣,六龜鄉,新威村,0,1,600,7,607,873,0,0,0,0,0,0,69.53
高雄縣,六龜鄉,新興村,0,1,554,8,562,772,0,0,0,0,0,0,72.80
高雄縣,六龜鄉,新寮村,0,1,508,9,517,658,0,0,0,0,0,0,78.57
高雄縣,六龜鄉,大津村,0,1,264,2,266,378,0,0,0,0,0,0,70.37
高雄縣,六龜鄉,新發村,0,1,846,15,861,1480,0,0,0,0,0,0,58.18
高雄縣,六龜鄉,荖濃村,0,1,950,21,971,1555,0,0,0,0,0,0,62.44
高雄縣,六龜鄉,寶來村,0,1,694,12,706,1079,0,0,0,0,0,0,65.43
高雄縣,甲仙鄉,東安村,0,1,466,3,469,643,0,0,0,0,0,0,72.94
高雄縣,甲仙鄉,西安村,0,1,811,11,822,1065,0,0,0,0,0,0,77.18
高雄縣,甲仙鄉,和安村,0,1,575,3,578,801,0,0,0,0,0,0,72.16
高雄縣,甲仙鄉,大田村,0,1,1077,17,1094,1516,0,0,0,0,0,0,72.16
高雄縣,甲仙鄉,寶隆村,0,1,532,3,535,718,0,0,0,0,0,0,74.51
高雄縣,甲仙鄉,關山村,0,1,513,9,522,720,0,0,0,0,0,0,72.50
高雄縣,甲仙鄉,小林村,0,1,710,14,724,1134,0,0,0,0,0,0,63.84
高雄縣,杉林鄉,杉林村,0,1,591,5,596,860,0,0,0,0,0,0,69.30
高雄縣,杉林鄉,木梓村,0,1,506,10,516,827,0,0,0,0,0,0,62.39
高雄縣,杉林鄉,集來村,0,1,1202,24,1226,1918,0,0,0,0,0,0,63.92
高雄縣,杉林鄉,新庄村,0,1,1301,14,1315,1859,0,0,0,0,0,0,70.74
高雄縣,杉林鄉,上平村,0,1,1137,9,1146,1603,0,0,0,0,0,0,71.49
高雄縣,杉林鄉,月眉村,0,1,1300,17,1317,1858,0,0,0,0,0,0,70.88
高雄縣,杉林鄉,月美村,0,1,1021,16,1037,1431,0,0,0,0,0,0,72.47
高雄縣,內門鄉,金竹村,0,1,591,8,599,778,0,0,0,0,0,0,76.99
高雄縣,內門鄉,溝坪村,0,1,752,11,763,1066,0,0,0,0,0,0,71.58
高雄縣,內門鄉,永興村,0,1,340,6,346,508,0,0,0,0,0,0,68.11
高雄縣,內門鄉,永吉村,0,1,383,4,387,499,0,0,0,0,0,0,77.56
高雄縣,內門鄉,永富村,0,1,806,9,815,1028,0,0,0,0,0,0,79.28
高雄縣,內門鄉,觀亭村,0,1,1335,17,1352,1756,0,0,0,0,0,0,76.99
高雄縣,內門鄉,中埔村,0,1,497,2,499,616,0,0,0,0,0,0,81.01
高雄縣,內門鄉,瑞山村,0,1,270,5,275,377,0,0,0,0,0,0,72.94
高雄縣,內門鄉,內南村,0,1,289,6,295,372,0,0,0,0,0,0,79.30
高雄縣,內門鄉,內東村,0,1,642,9,651,805,0,0,0,0,0,0,80.87
高雄縣,內門鄉,光興村,0,1,527,3,530,655,0,0,0,0,0,0,80.92
高雄縣,內門鄉,東埔村,0,1,365,7,372,482,0,0,0,0,0,0,77.18
高雄縣,內門鄉,內豐村,0,1,910,8,918,1145,0,0,0,0,0,0,80.17
高雄縣,內門鄉,內門村,0,1,799,5,804,958,0,0,0,0,0,0,83.92
高雄縣,內門鄉,石坑村,0,1,388,4,392,543,0,0,0,0,0,0,72.19
高雄縣,內門鄉,三平村,0,1,522,5,527,680,0,0,0,0,0,0,77.50
高雄縣,內門鄉,木柵村,0,1,513,5,518,684,0,0,0,0,0,0,75.73
高雄縣,內門鄉,內興村,0,1,493,3,496,615,0,0,0,0,0,0,80.65
高雄縣,茂林鄉,茂林村,0,1,42,0,42,70,0,0,0,0,0,0,60.00
高雄縣,茂林鄉,萬山村,0,1,7,0,7,16,0,0,0,0,0,0,43.75
高雄縣,茂林鄉,多納村,0,1,14,0,14,22,0,0,0,0,0,0,63.64
高雄縣,桃源鄉,寶山村,0,1,14,0,14,34,0,0,0,0,0,0,41.18
高雄縣,桃源鄉,建山村,0,1,54,1,55,76,0,0,0,0,0,0,72.37
高雄縣,桃源鄉,高中村,0,1,41,1,42,83,0,0,0,0,0,0,50.60
高雄縣,桃源鄉,桃源村,0,1,81,0,81,144,0,0,0,0,0,0,56.25
高雄縣,桃源鄉,勤和村,0,1,10,0,10,19,0,0,0,0,0,0,52.63
高雄縣,桃源鄉,復興村,0,1,11,0,11,15,0,0,0,0,0,0,73.33
高雄縣,桃源鄉,梅蘭村,0,1,7,0,7,12,0,0,0,0,0,0,58.33
高雄縣,桃源鄉,梅山村,0,1,8,0,8,16,0,0,0,0,0,0,50.00
高雄縣,三民鄉,民族村,0,1,49,1,50,156,0,0,0,0,0,0,32.05
高雄縣,三民鄉,民權村,0,1,26,0,26,45,0,0,0,0,0,0,57.78
高雄縣,三民鄉,民生村,0,1,58,0,58,98,0,0,0,0,0,0,59.18
屏東縣,屏東市,端正里,0,1,801,5,806,1224,0,0,0,0,0,0,65.85
屏東縣,屏東市,光榮里,0,1,1042,13,1055,1531,0,0,0,0,0,0,68.91
屏東縣,屏東市,大同里,0,1,586,4,590,798,0,0,0,0,0,0,73.93
屏東縣,屏東市,泰安里,0,1,878,3,881,1394,0,0,0,0,0,0,63.20
屏東縣,屏東市,維新里,0,1,1933,14,1947,2882,0,0,0,0,0,0,67.56
屏東縣,屏東市,大埔里,0,1,987,5,992,1486,0,0,0,0,0,0,66.76
屏東縣,屏東市,崇禮里,0,1,608,10,618,897,0,0,0,0,0,0,68.90
屏東縣,屏東市,楠樹里,0,1,599,8,607,853,0,0,0,0,0,0,71.16
屏東縣,屏東市,金泉里,0,1,867,5,872,1282,0,0,0,0,0,0,68.02
屏東縣,屏東市,平和里,0,1,637,8,645,918,0,0,0,0,0,0,70.26
屏東縣,屏東市,安樂里,0,1,740,9,749,1102,0,0,0,0,0,0,67.97
屏東縣,屏東市,橋南里,0,1,947,6,953,1539,0,0,0,0,0,0,61.92
屏東縣,屏東市,橋北里,0,1,658,8,666,954,0,0,0,0,0,0,69.81
屏東縣,屏東市,長春里,0,1,1250,12,1262,2022,0,0,0,0,0,0,62.41
屏東縣,屏東市,豐榮里,0,1,1484,10,1494,2296,0,0,0,0,0,0,65.07
屏東縣,屏東市,豐田里,0,1,2358,14,2372,3665,0,0,0,0,0,0,64.72
屏東縣,屏東市,大連里,0,1,4735,39,4774,7405,0,0,0,0,0,0,64.47
屏東縣,屏東市,豐源里,0,1,2266,17,2283,3441,0,0,0,0,0,0,66.35
屏東縣,屏東市,湖南里,0,1,628,7,635,922,0,0,0,0,0,0,68.87
屏東縣,屏東市,湖西里,0,1,910,7,917,1293,0,0,0,0,0,0,70.92
屏東縣,屏東市,歸心里,0,1,715,6,721,1069,0,0,0,0,0,0,67.45
屏東縣,屏東市,瑞光里,0,1,3649,45,3694,5853,0,0,0,0,0,0,63.11
屏東縣,屏東市,一心里,0,1,958,11,969,1375,0,0,0,0,0,0,70.47
屏東縣,屏東市,建國里,0,1,984,10,994,1537,0,0,0,0,0,0,64.67
屏東縣,屏東市,光華里,0,1,490,6,496,799,0,0,0,0,0,0,62.08
屏東縣,屏東市,萬年里,0,1,578,11,589,820,0,0,0,0,0,0,71.83
屏東縣,屏東市,厚生里,0,1,1859,23,1882,3077,0,0,0,0,0,0,61.16
屏東縣,屏東市,永安里,0,1,3869,39,3908,6149,0,0,0,0,0,0,63.56
屏東縣,屏東市,新生里,0,1,2653,28,2681,4214,0,0,0,0,0,0,63.62
屏東縣,屏東市,頂宅里,0,1,373,2,375,535,0,0,0,0,0,0,70.09
屏東縣,屏東市,頂柳里,0,1,679,1,680,923,0,0,0,0,0,0,73.67
屏東縣,屏東市,龍華里,0,1,1618,23,1641,2323,0,0,0,0,0,0,70.64
屏東縣,屏東市,大湖里,0,1,991,16,1007,1428,0,0,0,0,0,0,70.52
屏東縣,屏東市,新興里,0,1,1433,7,1440,2046,0,0,0,0,0,0,70.38
屏東縣,屏東市,公館里,0,1,1074,10,1084,1472,0,0,0,0,0,0,73.64
屏東縣,屏東市,玉成里,0,1,949,7,956,1248,0,0,0,0,0,0,76.60
屏東縣,屏東市,永光里,0,1,757,8,765,1134,0,0,0,0,0,0,67.46
屏東縣,屏東市,安鎮里,0,1,1208,16,1224,1849,0,0,0,0,0,0,66.20
屏東縣,屏東市,永昌里,0,1,832,13,845,1286,0,0,0,0,0,0,65.71
屏東縣,屏東市,長安里,0,1,1235,18,1253,1972,0,0,0,0,0,0,63.54
屏東縣,屏東市,崇武里,0,1,730,6,736,1154,0,0,0,0,0,0,63.78
屏東縣,屏東市,大武里,0,1,3865,43,3908,6167,0,0,0,0,0,0,63.37
屏東縣,屏東市,清溪里,0,1,2404,21,2425,3662,0,0,0,0,0,0,66.22
屏東縣,屏東市,前進里,0,1,800,5,805,1153,0,0,0,0,0,0,69.82
屏東縣,屏東市,大洲里,0,1,706,11,717,965,0,0,0,0,0,0,74.30
屏東縣,屏東市,凌雲里,0,1,936,9,945,1435,0,0,0,0,0,0,65.85
屏東縣,屏東市,鵬程里,0,1,949,12,961,1375,0,0,0,0,0,0,69.89
屏東縣,屏東市,興樂里,0,1,664,2,666,1012,0,0,0,0,0,0,65.81
屏東縣,屏東市,斯文里,0,1,1225,12,1237,1846,0,0,0,0,0,0,67.01
屏東縣,屏東市,太平里,0,1,668,5,673,1028,0,0,0,0,0,0,65.47
屏東縣,屏東市,華山里,0,1,2673,24,2697,4083,0,0,0,0,0,0,66.05
屏東縣,屏東市,溝美里,0,1,1660,14,1674,2463,0,0,0,0,0,0,67.97
屏東縣,屏東市,中正里,0,1,2027,10,2037,3071,0,0,0,0,0,0,66.33
屏東縣,屏東市,仁愛里,0,1,1211,10,1221,1999,0,0,0,0,0,0,61.08
屏東縣,屏東市,北興里,0,1,3123,26,3149,5071,0,0,0,0,0,0,62.10
屏東縣,屏東市,北勢里,0,1,1553,11,1564,2329,0,0,0,0,0,0,67.15
屏東縣,屏東市,勝利里,0,1,2389,20,2409,3781,0,0,0,0,0,0,63.71
屏東縣,屏東市,永城里,0,1,1517,16,1533,2370,0,0,0,0,0,0,64.68
屏東縣,屏東市,崇蘭里,0,1,3752,27,3779,5587,0,0,0,0,0,0,67.64
屏東縣,屏東市,廣興里,0,1,1343,11,1354,1752,0,0,0,0,0,0,77.28
屏東縣,屏東市,空翔里,0,1,1020,8,1028,1566,0,0,0,0,0,0,65.64
屏東縣,屏東市,大鵬里,0,1,504,6,510,746,0,0,0,0,0,0,68.36
屏東縣,屏東市,潭墘里,0,1,3937,42,3979,6287,0,0,0,0,0,0,63.29
屏東縣,屏東市,三山里,0,1,858,16,874,1192,0,0,0,0,0,0,73.32
屏東縣,屏東市,海豐里,0,1,633,3,636,810,0,0,0,0,0,0,78.52
屏東縣,屏東市,仁義里,0,1,713,4,717,998,0,0,0,0,0,0,71.84
屏東縣,屏東市,信和里,0,1,1040,6,1046,1428,0,0,0,0,0,0,73.25
屏東縣,屏東市,和興里,0,1,657,7,664,935,0,0,0,0,0,0,71.02
屏東縣,潮州鎮,三星里,0,1,2614,27,2641,3927,0,0,0,0,0,0,67.25
屏東縣,潮州鎮,三共里,0,1,3219,25,3244,5018,0,0,0,0,0,0,64.65
屏東縣,潮州鎮,三和里,0,1,1074,7,1081,1686,0,0,0,0,0,0,64.12
屏東縣,潮州鎮,五魁里,0,1,666,5,671,1006,0,0,0,0,0,0,66.70
屏東縣,潮州鎮,潮州里,0,1,448,1,449,645,0,0,0,0,0,0,69.61
屏東縣,潮州鎮,光華里,0,1,2350,25,2375,3596,0,0,0,0,0,0,66.05
屏東縣,潮州鎮,同榮里,0,1,599,8,607,787,0,0,0,0,0,0,77.13
屏東縣,潮州鎮,新生里,0,1,782,11,793,1224,0,0,0,0,0,0,64.79
屏東縣,潮州鎮,新榮里,0,1,971,2,973,1474,0,0,0,0,0,0,66.01
屏東縣,潮州鎮,彭城里,0,1,557,2,559,768,0,0,0,0,0,0,72.79
屏東縣,潮州鎮,蓬萊里,0,1,1252,14,1266,1813,0,0,0,0,0,0,69.83
屏東縣,潮州鎮,八爺里,0,1,1276,13,1289,1930,0,0,0,0,0,0,66.79
屏東縣,潮州鎮,永春里,0,1,2973,29,3002,4563,0,0,0,0,0,0,65.79
屏東縣,潮州鎮,富春里,0,1,892,8,900,1403,0,0,0,0,0,0,64.15
屏東縣,潮州鎮,光春里,0,1,881,13,894,1264,0,0,0,0,0,0,70.73
屏東縣,潮州鎮,興美里,0,1,579,3,582,798,0,0,0,0,0,0,72.93
屏東縣,潮州鎮,檨子里,0,1,377,7,384,583,0,0,0,0,0,0,65.87
屏東縣,潮州鎮,九塊里,0,1,1006,15,1021,1547,0,0,0,0,0,0,66.00
屏東縣,潮州鎮,泗林里,0,1,1025,16,1041,1437,0,0,0,0,0,0,72.44
屏東縣,潮州鎮,四春里,0,1,1337,18,1355,1872,0,0,0,0,0,0,72.38
屏東縣,潮州鎮,崙東里,0,1,1015,8,1023,1559,0,0,0,0,0,0,65.62
屏東縣,東港鎮,新勝里,0,1,1683,13,1696,2289,0,0,0,0,0,0,74.09
屏東縣,東港鎮,頂新里,0,1,426,2,428,577,0,0,0,0,0,0,74.18
屏東縣,東港鎮,頂中里,0,1,382,1,383,492,0,0,0,0,0,0,77.85
屏東縣,東港鎮,東和里,0,1,530,0,530,737,0,0,0,0,0,0,71.91
屏東縣,東港鎮,興台里,0,1,429,6,435,615,0,0,0,0,0,0,70.73
屏東縣,東港鎮,興東里,0,1,3431,30,3461,4983,0,0,0,0,0,0,69.46
屏東縣,東港鎮,興農里,0,1,568,4,572,725,0,0,0,0,0,0,78.90
屏東縣,東港鎮,中興里,0,1,553,11,564,745,0,0,0,0,0,0,75.70
屏東縣,東港鎮,朝安里,0,1,1314,8,1322,1904,0,0,0,0,0,0,69.43
屏東縣,東港鎮,八德里,0,1,610,4,614,884,0,0,0,0,0,0,69.46
屏東縣,東港鎮,東隆里,0,1,956,12,968,1379,0,0,0,0,0,0,70.20
屏東縣,東港鎮,豐漁里,0,1,543,4,547,734,0,0,0,0,0,0,74.52
屏東縣,東港鎮,盛漁里,0,1,917,14,931,1288,0,0,0,0,0,0,72.28
屏東縣,東港鎮,興漁里,0,1,1342,16,1358,1855,0,0,0,0,0,0,73.21
屏東縣,東港鎮,鎮海里,0,1,1716,21,1737,2424,0,0,0,0,0,0,71.66
屏東縣,東港鎮,嘉蓮里,0,1,995,6,1001,1439,0,0,0,0,0,0,69.56
屏東縣,東港鎮,南平里,0,1,1130,9,1139,1609,0,0,0,0,0,0,70.79
屏東縣,東港鎮,船頭里,0,1,2205,16,2221,3227,0,0,0,0,0,0,68.83
屏東縣,東港鎮,下部里,0,1,1258,8,1266,1749,0,0,0,0,0,0,72.38
屏東縣,東港鎮,大潭里,0,1,1141,9,1150,1532,0,0,0,0,0,0,75.07
屏東縣,東港鎮,興和里,0,1,640,6,646,844,0,0,0,0,0,0,76.54
屏東縣,東港鎮,共和里,0,1,506,4,510,733,0,0,0,0,0,0,69.58
屏東縣,東港鎮,大鵬里,0,1,210,0,210,355,0,0,0,0,0,0,59.15
屏東縣,恆春鎮,城南里,0,1,643,7,650,990,0,0,0,0,0,0,65.66
屏東縣,恆春鎮,城北里,0,1,1116,25,1141,1918,0,0,0,0,0,0,59.49
屏東縣,恆春鎮,城西里,0,1,688,4,692,1138,0,0,0,0,0,0,60.81
屏東縣,恆春鎮,山腳里,0,1,1779,30,1809,3247,0,0,0,0,0,0,55.71
屏東縣,恆春鎮,網紗里,0,1,1383,18,1401,2443,0,0,0,0,0,0,57.35
屏東縣,恆春鎮,仁壽里,0,1,433,2,435,802,0,0,0,0,0,0,54.24
屏東縣,恆春鎮,茄湖里,0,1,296,10,306,503,0,0,0,0,0,0,60.83
屏東縣,恆春鎮,頭溝里,0,1,240,2,242,487,0,0,0,0,0,0,49.69
屏東縣,恆春鎮,四溝里,0,1,561,13,574,924,0,0,0,0,0,0,62.12
屏東縣,恆春鎮,德和里,0,1,367,11,378,570,0,0,0,0,0,0,66.32
屏東縣,恆春鎮,龍水里,0,1,598,9,607,956,0,0,0,0,0,0,63.49
屏東縣,恆春鎮,山海里,0,1,883,15,898,1460,0,0,0,0,0,0,61.51
屏東縣,恆春鎮,大光里,0,1,997,21,1018,1741,0,0,0,0,0,0,58.47
屏東縣,恆春鎮,水泉里,0,1,754,14,768,1410,0,0,0,0,0,0,54.47
屏東縣,恆春鎮,南灣里,0,1,787,17,804,1325,0,0,0,0,0,0,60.68
屏東縣,恆春鎮,墾丁里,0,1,758,16,774,1153,0,0,0,0,0,0,67.13
屏東縣,恆春鎮,鵝鑾里,0,1,660,7,667,1031,0,0,0,0,0,0,64.69
屏東縣,萬丹鄉,社上村,0,1,916,6,922,1330,0,0,0,0,0,0,69.32
屏東縣,萬丹鄉,社中村,0,1,931,5,936,1320,0,0,0,0,0,0,70.91
屏東縣,萬丹鄉,社皮村,0,1,1220,11,1231,1680,0,0,0,0,0,0,73.27
屏東縣,萬丹鄉,磚寮村,0,1,631,7,638,819,0,0,0,0,0,0,77.90
屏東縣,萬丹鄉,社口村,0,1,925,4,929,1093,0,0,0,0,0,0,85.00
屏東縣,萬丹鄉,加興村,0,1,813,9,822,1031,0,0,0,0,0,0,79.73
屏東縣,萬丹鄉,上村村,0,1,500,1,501,622,0,0,0,0,0,0,80.55
屏東縣,萬丹鄉,廈北村,0,1,1101,8,1109,1534,0,0,0,0,0,0,72.29
屏東縣,萬丹鄉,廈南村,0,1,987,9,996,1361,0,0,0,0,0,0,73.18
屏東縣,萬丹鄉,崙頂村,0,1,1034,15,1049,1373,0,0,0,0,0,0,76.40
屏東縣,萬丹鄉,田厝村,0,1,639,2,641,825,0,0,0,0,0,0,77.70
屏東縣,萬丹鄉,後村村,0,1,802,11,813,963,0,0,0,0,0,0,84.42
屏東縣,萬丹鄉,灣內村,0,1,914,6,920,1160,0,0,0,0,0,0,79.31
屏東縣,萬丹鄉,香社村,0,1,1095,8,1103,1382,0,0,0,0,0,0,79.81
屏東縣,萬丹鄉,新庄村,0,1,1369,14,1383,1752,0,0,0,0,0,0,78.94
屏東縣,萬丹鄉,新鐘村,0,1,1396,19,1415,1782,0,0,0,0,0,0,79.41
屏東縣,萬丹鄉,水仙村,0,1,383,2,385,498,0,0,0,0,0,0,77.31
屏東縣,萬丹鄉,興安村,0,1,592,6,598,762,0,0,0,0,0,0,78.48
屏東縣,萬丹鄉,興全村,0,1,860,2,862,1084,0,0,0,0,0,0,79.52
屏東縣,萬丹鄉,甘棠村,0,1,268,3,271,351,0,0,0,0,0,0,77.21
屏東縣,萬丹鄉,水泉村,0,1,975,11,986,1292,0,0,0,0,0,0,76.32
屏東縣,萬丹鄉,竹林村,0,1,1031,4,1035,1416,0,0,0,0,0,0,73.09
屏東縣,萬丹鄉,廣安村,0,1,1285,7,1292,1740,0,0,0,0,0,0,74.25
屏東縣,萬丹鄉,四維村,0,1,1205,8,1213,1631,0,0,0,0,0,0,74.37
屏東縣,萬丹鄉,寶厝村,0,1,1455,15,1470,1908,0,0,0,0,0,0,77.04
屏東縣,萬丹鄉,萬生村,0,1,893,10,903,1192,0,0,0,0,0,0,75.76
屏東縣,萬丹鄉,萬惠村,0,1,543,4,547,687,0,0,0,0,0,0,79.62
屏東縣,萬丹鄉,萬安村,0,1,376,9,385,499,0,0,0,0,0,0,77.15
屏東縣,萬丹鄉,萬後村,0,1,351,2,353,446,0,0,0,0,0,0,79.15
屏東縣,萬丹鄉,萬全村,0,1,2368,25,2393,3143,0,0,0,0,0,0,76.14
屏東縣,長治鄉,進興村,0,1,1287,19,1306,1996,0,0,0,0,0,0,65.43
屏東縣,長治鄉,新潭村,0,1,1635,9,1644,2372,0,0,0,0,0,0,69.31
屏東縣,長治鄉,潭頭村,0,1,1002,11,1013,1408,0,0,0,0,0,0,71.95
屏東縣,長治鄉,香楊村,0,1,1059,6,1065,1609,0,0,0,0,0,0,66.19
屏東縣,長治鄉,長興村,0,1,690,4,694,960,0,0,0,0,0,0,72.29
屏東縣,長治鄉,崙上村,0,1,1028,13,1041,1404,0,0,0,0,0,0,74.15
屏東縣,長治鄉,德榮村,0,1,748,11,759,1023,0,0,0,0,0,0,74.19
屏東縣,長治鄉,德和村,0,1,562,8,570,757,0,0,0,0,0,0,75.30
屏東縣,長治鄉,復興村,0,1,974,6,980,1373,0,0,0,0,0,0,71.38
屏東縣,長治鄉,德成村,0,1,618,5,623,813,0,0,0,0,0,0,76.63
屏東縣,長治鄉,德協村,0,1,765,13,778,1038,0,0,0,0,0,0,74.95
屏東縣,長治鄉,繁榮村,0,1,889,5,894,1295,0,0,0,0,0,0,69.03
屏東縣,長治鄉,繁昌村,0,1,1090,8,1098,1582,0,0,0,0,0,0,69.41
屏東縣,長治鄉,繁隆村,0,1,731,2,733,1027,0,0,0,0,0,0,71.37
屏東縣,長治鄉,繁華村,0,1,1413,14,1427,2104,0,0,0,0,0,0,67.82
屏東縣,長治鄉,榮華村,0,1,317,6,323,495,0,0,0,0,0,0,65.25
屏東縣,麟洛鄉,新田村,0,1,1206,13,1219,1650,0,0,0,0,0,0,73.88
屏東縣,麟洛鄉,麟頂村,0,1,632,2,634,827,0,0,0,0,0,0,76.66
屏東縣,麟洛鄉,麟蹄村,0,1,1071,3,1074,1468,0,0,0,0,0,0,73.16
屏東縣,麟洛鄉,麟趾村,0,1,1468,7,1475,2096,0,0,0,0,0,0,70.37
屏東縣,麟洛鄉,田中村,0,1,774,3,777,1041,0,0,0,0,0,0,74.64
屏東縣,麟洛鄉,田心村,0,1,558,6,564,756,0,0,0,0,0,0,74.60
屏東縣,麟洛鄉,田道村,0,1,498,5,503,675,0,0,0,0,0,0,74.52
屏東縣,九如鄉,九清村,0,1,1153,7,1160,1528,0,0,0,0,0,0,75.92
屏東縣,九如鄉,九塊村,0,1,934,12,946,1248,0,0,0,0,0,0,75.80
屏東縣,九如鄉,九明村,0,1,981,10,991,1359,0,0,0,0,0,0,72.92
屏東縣,九如鄉,大坵村,0,1,746,5,751,967,0,0,0,0,0,0,77.66
屏東縣,九如鄉,玉水村,0,1,877,9,886,1211,0,0,0,0,0,0,73.16
屏東縣,九如鄉,玉泉村,0,1,1016,6,1022,1388,0,0,0,0,0,0,73.63
屏東縣,九如鄉,東寧村,0,1,2254,18,2272,3120,0,0,0,0,0,0,72.82
屏東縣,九如鄉,三塊村,0,1,880,9,889,1183,0,0,0,0,0,0,75.15
屏東縣,九如鄉,後庄村,0,1,807,12,819,1145,0,0,0,0,0,0,71.53
屏東縣,九如鄉,耆老村,0,1,1158,10,1168,1611,0,0,0,0,0,0,72.50
屏東縣,九如鄉,洽興村,0,1,952,5,957,1245,0,0,0,0,0,0,76.87
屏東縣,里港鄉,玉田村,0,1,1288,11,1299,1855,0,0,0,0,0,0,70.03
屏東縣,里港鄉,大平村,0,1,876,7,883,1140,0,0,0,0,0,0,77.46
屏東縣,里港鄉,永春村,0,1,570,5,575,795,0,0,0,0,0,0,72.33
屏東縣,里港鄉,春林村,0,1,863,8,871,1176,0,0,0,0,0,0,74.06
屏東縣,里港鄉,過江村,0,1,1068,18,1086,1589,0,0,0,0,0,0,68.34
屏東縣,里港鄉,鐵店村,0,1,826,6,832,1167,0,0,0,0,0,0,71.29
屏東縣,里港鄉,塔樓村,0,1,952,12,964,1303,0,0,0,0,0,0,73.98
屏東縣,里港鄉,潮厝村,0,1,931,5,936,1277,0,0,0,0,0,0,73.30
屏東縣,里港鄉,茄苳村,0,1,1156,11,1167,1561,0,0,0,0,0,0,74.76
屏東縣,里港鄉,載興村,0,1,1627,14,1641,2223,0,0,0,0,0,0,73.82
屏東縣,里港鄉,土庫村,0,1,1449,22,1471,2015,0,0,0,0,0,0,73.00
屏東縣,里港鄉,三部村,0,1,1237,11,1248,1734,0,0,0,0,0,0,71.97
屏東縣,里港鄉,中和村,0,1,526,2,528,773,0,0,0,0,0,0,68.31
屏東縣,里港鄉,瀰力村,0,1,359,4,363,498,0,0,0,0,0,0,72.89
屏東縣,鹽埔鄉,鹽北村,0,1,1183,3,1186,1592,0,0,0,0,0,0,74.50
屏東縣,鹽埔鄉,鹽中村,0,1,1573,23,1596,2187,0,0,0,0,0,0,72.98
屏東縣,鹽埔鄉,鹽南村,0,1,1058,12,1070,1516,0,0,0,0,0,0,70.58
屏東縣,鹽埔鄉,仕絨村,0,1,740,8,748,871,0,0,0,0,0,0,85.88
屏東縣,鹽埔鄉,高朗村,0,1,1835,22,1857,2575,0,0,0,0,0,0,72.12
屏東縣,鹽埔鄉,振興村,0,1,1286,15,1301,1892,0,0,0,0,0,0,68.76
屏東縣,鹽埔鄉,久愛村,0,1,659,3,662,829,0,0,0,0,0,0,79.86
屏東縣,鹽埔鄉,新圍村,0,1,1899,29,1928,2711,0,0,0,0,0,0,71.12
屏東縣,鹽埔鄉,新二村,0,1,1924,21,1945,2884,0,0,0,0,0,0,67.44
屏東縣,鹽埔鄉,彭厝村,0,1,720,3,723,937,0,0,0,0,0,0,77.16
屏東縣,鹽埔鄉,洛陽村,0,1,1004,22,1026,1346,0,0,0,0,0,0,76.23
屏東縣,鹽埔鄉,永隆村,0,1,398,4,402,574,0,0,0,0,0,0,70.03
屏東縣,高樹鄉,高樹村,0,1,1461,15,1476,2170,0,0,0,0,0,0,68.02
屏東縣,高樹鄉,長榮村,0,1,930,9,939,1379,0,0,0,0,0,0,68.09
屏東縣,高樹鄉,東興村,0,1,581,7,588,838,0,0,0,0,0,0,70.17
屏東縣,高樹鄉,東振村,0,1,431,3,434,633,0,0,0,0,0,0,68.56
屏東縣,高樹鄉,源泉村,0,1,657,2,659,1006,0,0,0,0,0,0,65.51
屏東縣,高樹鄉,建興村,0,1,734,10,744,1198,0,0,0,0,0,0,62.10
屏東縣,高樹鄉,大埔村,0,1,444,6,450,696,0,0,0,0,0,0,64.66
屏東縣,高樹鄉,菜寮村,0,1,547,5,552,855,0,0,0,0,0,0,64.56
屏東縣,高樹鄉,司馬村,0,1,518,6,524,761,0,0,0,0,0,0,68.86
屏東縣,高樹鄉,舊寮村,0,1,839,8,847,1329,0,0,0,0,0,0,63.73
屏東縣,高樹鄉,新豐村,0,1,939,25,964,1554,0,0,0,0,0,0,62.03
屏東縣,高樹鄉,泰山村,0,1,1199,15,1214,2020,0,0,0,0,0,0,60.10
屏東縣,高樹鄉,南華村,0,1,789,9,798,1229,0,0,0,0,0,0,64.93
屏東縣,高樹鄉,廣福村,0,1,627,7,634,956,0,0,0,0,0,0,66.32
屏東縣,高樹鄉,廣興村,0,1,695,9,704,1073,0,0,0,0,0,0,65.61
屏東縣,高樹鄉,舊庄村,0,1,739,11,750,1046,0,0,0,0,0,0,71.70
屏東縣,高樹鄉,田子村,0,1,759,9,768,1140,0,0,0,0,0,0,67.37
屏東縣,高樹鄉,鹽樹村,0,1,861,13,874,1371,0,0,0,0,0,0,63.75
屏東縣,高樹鄉,新南村,0,1,909,6,915,1406,0,0,0,0,0,0,65.08
屏東縣,萬巒鄉,萬巒村,0,1,862,4,866,1230,0,0,0,0,0,0,70.41
屏東縣,萬巒鄉,萬全村,0,1,594,5,599,799,0,0,0,0,0,0,74.97
屏東縣,萬巒鄉,萬和村,0,1,940,12,952,1369,0,0,0,0,0,0,69.54
屏東縣,萬巒鄉,鹿寮村,0,1,656,2,658,908,0,0,0,0,0,0,72.47
屏東縣,萬巒鄉,硫黃村,0,1,383,2,385,531,0,0,0,0,0,0,72.50
屏東縣,萬巒鄉,泗溝村,0,1,877,13,890,1280,0,0,0,0,0,0,69.53
屏東縣,萬巒鄉,五溝村,0,1,861,9,870,1152,0,0,0,0,0,0,75.52
屏東縣,萬巒鄉,成德村,0,1,915,17,932,1380,0,0,0,0,0,0,67.54
屏東縣,萬巒鄉,赤山村,0,1,952,22,974,1669,0,0,0,0,0,0,58.36
屏東縣,萬巒鄉,萬金村,0,1,1232,20,1252,1897,0,0,0,0,0,0,66.00
屏東縣,萬巒鄉,佳佐村,0,1,1104,10,1114,1564,0,0,0,0,0,0,71.23
屏東縣,萬巒鄉,佳和村,0,1,1155,13,1168,1497,0,0,0,0,0,0,78.02
屏東縣,萬巒鄉,新厝村,0,1,779,6,785,1063,0,0,0,0,0,0,73.85
屏東縣,萬巒鄉,新置村,0,1,769,5,774,1187,0,0,0,0,0,0,65.21
屏東縣,內埔鄉,內埔村,0,1,1957,24,1981,3015,0,0,0,0,0,0,65.70
屏東縣,內埔鄉,內田村,0,1,1687,19,1706,2680,0,0,0,0,0,0,63.66
屏東縣,內埔鄉,興南村,0,1,976,11,987,1337,0,0,0,0,0,0,73.82
屏東縣,內埔鄉,義亭村,0,1,374,3,377,566,0,0,0,0,0,0,66.61
屏東縣,內埔鄉,美和村,0,1,1362,20,1382,1997,0,0,0,0,0,0,69.20
屏東縣,內埔鄉,和興村,0,1,1195,10,1205,1741,0,0,0,0,0,0,69.21
屏東縣,內埔鄉,東寧村,0,1,2464,12,2476,3755,0,0,0,0,0,0,65.94
屏東縣,內埔鄉,豐田村,0,1,1361,13,1374,2269,0,0,0,0,0,0,60.56
屏東縣,內埔鄉,振豐村,0,1,1138,11,1149,1638,0,0,0,0,0,0,70.15
屏東縣,內埔鄉,富田村,0,1,1291,11,1302,1893,0,0,0,0,0,0,68.78
屏東縣,內埔鄉,竹圍村,0,1,961,17,978,1498,0,0,0,0,0,0,65.29
屏東縣,內埔鄉,東勢村,0,1,1973,26,1999,2901,0,0,0,0,0,0,68.91
屏東縣,內埔鄉,東片村,0,1,635,7,642,949,0,0,0,0,0,0,67.65
屏東縣,內埔鄉,上樹村,0,1,720,6,726,1027,0,0,0,0,0,0,70.69
屏東縣,內埔鄉,老埤村,0,1,1398,11,1409,2319,0,0,0,0,0,0,60.76
屏東縣,內埔鄉,中林村,0,1,953,7,960,1399,0,0,0,0,0,0,68.62
屏東縣,內埔鄉,龍泉村,0,1,1591,13,1604,2469,0,0,0,0,0,0,64.97
屏東縣,內埔鄉,龍潭村,0,1,1577,38,1615,2555,0,0,0,0,0,0,63.21
屏東縣,內埔鄉,建興村,0,1,1355,25,1380,2091,0,0,0,0,0,0,66.00
屏東縣,內埔鄉,大新村,0,1,1151,18,1169,1689,0,0,0,0,0,0,69.21
屏東縣,內埔鄉,黎明村,0,1,1407,13,1420,2166,0,0,0,0,0,0,65.56
屏東縣,內埔鄉,隘寮村,0,1,704,10,714,1150,0,0,0,0,0,0,62.09
屏東縣,內埔鄉,水門村,0,1,527,6,533,800,0,0,0,0,0,0,66.63
屏東縣,竹田鄉,竹田村,0,1,1037,10,1047,1417,0,0,0,0,0,0,73.89
屏東縣,竹田鄉,竹南村,0,1,602,6,608,856,0,0,0,0,0,0,71.03
屏東縣,竹田鄉,糶糴村,0,1,497,3,500,675,0,0,0,0,0,0,74.07
屏東縣,竹田鄉,履豐村,0,1,445,3,448,585,0,0,0,0,0,0,76.58
屏東縣,竹田鄉,頭崙村,0,1,960,12,972,1292,0,0,0,0,0,0,75.23
屏東縣,竹田鄉,二崙村,0,1,738,7,745,966,0,0,0,0,0,0,77.12
屏東縣,竹田鄉,美崙村,0,1,472,2,474,601,0,0,0,0,0,0,78.87
屏東縣,竹田鄉,南勢村,0,1,351,4,355,457,0,0,0,0,0,0,77.68
屏東縣,竹田鄉,西勢村,0,1,1853,19,1872,2561,0,0,0,0,0,0,73.10
屏東縣,竹田鄉,福田村,0,1,336,4,340,425,0,0,0,0,0,0,80.00
屏東縣,竹田鄉,永豐村,0,1,398,4,402,570,0,0,0,0,0,0,70.53
屏東縣,竹田鄉,六巷村,0,1,498,3,501,647,0,0,0,0,0,0,77.43
屏東縣,竹田鄉,泗洲村,0,1,749,11,760,1142,0,0,0,0,0,0,66.55
屏東縣,竹田鄉,大湖村,0,1,783,4,787,1108,0,0,0,0,0,0,71.03
屏東縣,竹田鄉,鳳明村,0,1,693,6,699,942,0,0,0,0,0,0,74.20
屏東縣,新埤鄉,新埤村,0,1,1311,13,1324,1860,0,0,0,0,0,0,71.18
屏東縣,新埤鄉,建功村,0,1,877,6,883,1214,0,0,0,0,0,0,72.73
屏東縣,新埤鄉,打鐵村,0,1,744,7,751,1058,0,0,0,0,0,0,70.98
屏東縣,新埤鄉,南豐村,0,1,503,3,506,753,0,0,0,0,0,0,67.20
屏東縣,新埤鄉,萬隆村,0,1,1042,9,1051,1653,0,0,0,0,0,0,63.58
屏東縣,新埤鄉,餉潭村,0,1,728,5,733,1309,0,0,0,0,0,0,56.00
屏東縣,新埤鄉,箕湖村,0,1,709,2,711,1071,0,0,0,0,0,0,66.39
屏東縣,枋寮鄉,枋寮村,0,1,882,12,894,1344,0,0,0,0,0,0,66.52
屏東縣,枋寮鄉,新龍村,0,1,566,5,571,862,0,0,0,0,0,0,66.24
屏東縣,枋寮鄉,保生村,0,1,606,6,612,944,0,0,0,0,0,0,64.83
屏東縣,枋寮鄉,中寮村,0,1,495,5,500,744,0,0,0,0,0,0,67.20
屏東縣,枋寮鄉,安樂村,0,1,1136,7,1143,1798,0,0,0,0,0,0,63.57
屏東縣,枋寮鄉,隆山村,0,1,2071,15,2086,3476,0,0,0,0,0,0,60.01
屏東縣,枋寮鄉,天時村,0,1,1364,7,1371,1974,0,0,0,0,0,0,69.45
屏東縣,枋寮鄉,地利村,0,1,1156,8,1164,1682,0,0,0,0,0,0,69.20
屏東縣,枋寮鄉,人和村,0,1,1477,26,1503,2194,0,0,0,0,0,0,68.51
屏東縣,枋寮鄉,內寮村,0,1,417,5,422,775,0,0,0,0,0,0,54.45
屏東縣,枋寮鄉,新開村,0,1,585,9,594,1000,0,0,0,0,0,0,59.40
屏東縣,枋寮鄉,東海村,0,1,1816,18,1834,2638,0,0,0,0,0,0,69.52
屏東縣,枋寮鄉,大庄村,0,1,399,3,402,587,0,0,0,0,0,0,68.48
屏東縣,枋寮鄉,太源村,0,1,608,11,619,958,0,0,0,0,0,0,64.61
屏東縣,枋寮鄉,玉泉村,0,1,251,3,254,422,0,0,0,0,0,0,60.19
屏東縣,新園鄉,瓦窯村,0,1,1229,9,1238,1565,0,0,0,0,0,0,79.11
屏東縣,新園鄉,仙吉村,0,1,1630,10,1640,2231,0,0,0,0,0,0,73.51
屏東縣,新園鄉,田洋村,0,1,1433,17,1450,1941,0,0,0,0,0,0,74.70
屏東縣,新園鄉,港墘村,0,1,523,7,530,710,0,0,0,0,0,0,74.65
屏東縣,新園鄉,內庄村,0,1,589,3,592,749,0,0,0,0,0,0,79.04
屏東縣,新園鄉,新東村,0,1,1645,20,1665,2186,0,0,0,0,0,0,76.17
屏東縣,新園鄉,新園村,0,1,1482,10,1492,1965,0,0,0,0,0,0,75.93
屏東縣,新園鄉,港西村,0,1,1741,11,1752,2175,0,0,0,0,0,0,80.55
屏東縣,新園鄉,五房村,0,1,1958,18,1976,2776,0,0,0,0,0,0,71.18
屏東縣,新園鄉,烏龍村,0,1,937,15,952,1247,0,0,0,0,0,0,76.34
屏東縣,新園鄉,興龍村,0,1,1508,12,1520,2025,0,0,0,0,0,0,75.06
屏東縣,新園鄉,中洲村,0,1,1159,15,1174,1625,0,0,0,0,0,0,72.25
屏東縣,新園鄉,南龍村,0,1,956,12,968,1327,0,0,0,0,0,0,72.95
屏東縣,新園鄉,鹽埔村,0,1,2481,16,2497,3719,0,0,0,0,0,0,67.14
屏東縣,新園鄉,共和村,0,1,1502,12,1514,2174,0,0,0,0,0,0,69.64
屏東縣,崁頂鄉,崁頂村,0,1,1320,12,1332,1892,0,0,0,0,0,0,70.40
屏東縣,崁頂鄉,園寮村,0,1,973,6,979,1501,0,0,0,0,0,0,65.22
屏東縣,崁頂鄉,力社村,0,1,780,15,795,1076,0,0,0,0,0,0,73.88
屏東縣,崁頂鄉,圍內村,0,1,796,8,804,1071,0,0,0,0,0,0,75.07
屏東縣,崁頂鄉,洲子村,0,1,615,4,619,834,0,0,0,0,0,0,74.22
屏東縣,崁頂鄉,北勢村,0,1,981,10,991,1433,0,0,0,0,0,0,69.16
屏東縣,崁頂鄉,越溪村,0,1,525,8,533,743,0,0,0,0,0,0,71.74
屏東縣,崁頂鄉,港東村,0,1,1184,15,1199,1685,0,0,0,0,0,0,71.16
屏東縣,林邊鄉,林邊村,0,1,1032,11,1043,1446,0,0,0,0,0,0,72.13
屏東縣,林邊鄉,光林村,0,1,1149,7,1156,1625,0,0,0,0,0,0,71.14
屏東縣,林邊鄉,中林村,0,1,622,10,632,840,0,0,0,0,0,0,75.24
屏東縣,林邊鄉,仁和村,0,1,1110,7,1117,1584,0,0,0,0,0,0,70.52
屏東縣,林邊鄉,永樂村,0,1,2275,32,2307,3077,0,0,0,0,0,0,74.98
屏東縣,林邊鄉,田厝村,0,1,658,5,663,875,0,0,0,0,0,0,75.77
屏東縣,林邊鄉,崎峰村,0,1,881,7,888,1269,0,0,0,0,0,0,69.98
屏東縣,林邊鄉,水利村,0,1,1166,16,1182,1754,0,0,0,0,0,0,67.39
屏東縣,林邊鄉,竹林村,0,1,2102,29,2131,2924,0,0,0,0,0,0,72.88
屏東縣,林邊鄉,鎮安村,0,1,810,18,828,1143,0,0,0,0,0,0,72.44
屏東縣,南州鄉,溪洲村,0,1,1306,13,1319,1760,0,0,0,0,0,0,74.94
屏東縣,南州鄉,溪南村,0,1,722,6,728,1007,0,0,0,0,0,0,72.29
屏東縣,南州鄉,仁里村,0,1,427,5,432,602,0,0,0,0,0,0,71.76
屏東縣,南州鄉,溪北村,0,1,584,9,593,778,0,0,0,0,0,0,76.22
屏東縣,南州鄉,七塊村,0,1,736,8,744,1039,0,0,0,0,0,0,71.61
屏東縣,南州鄉,萬華村,0,1,710,7,717,973,0,0,0,0,0,0,73.69
屏東縣,南州鄉,米崙村,0,1,779,5,784,1035,0,0,0,0,0,0,75.75
屏東縣,南州鄉,壽元村,0,1,738,7,745,1099,0,0,0,0,0,0,67.79
屏東縣,南州鄉,同安村,0,1,629,5,634,895,0,0,0,0,0,0,70.84
屏東縣,南州鄉,南安村,0,1,426,10,436,589,0,0,0,0,0,0,74.02
屏東縣,佳冬鄉,佳冬村,0,1,1045,11,1056,1488,0,0,0,0,0,0,70.97
屏東縣,佳冬鄉,六根村,0,1,1173,14,1187,1701,0,0,0,0,0,0,69.78
屏東縣,佳冬鄉,賴家村,0,1,676,12,688,968,0,0,0,0,0,0,71.07
屏東縣,佳冬鄉,萬建村,0,1,1159,15,1174,1684,0,0,0,0,0,0,69.71
屏東縣,佳冬鄉,石光村,0,1,1254,12,1266,1841,0,0,0,0,0,0,68.77
屏東縣,佳冬鄉,玉光村,0,1,1451,19,1470,2224,0,0,0,0,0,0,66.10
屏東縣,佳冬鄉,昌隆村,0,1,842,6,848,1162,0,0,0,0,0,0,72.98
屏東縣,佳冬鄉,豐隆村,0,1,586,11,597,865,0,0,0,0,0,0,69.02
屏東縣,佳冬鄉,大同村,0,1,887,9,896,1230,0,0,0,0,0,0,72.85
屏東縣,佳冬鄉,羌園村,0,1,736,8,744,970,0,0,0,0,0,0,76.70
屏東縣,佳冬鄉,燄溫村,0,1,763,6,769,1074,0,0,0,0,0,0,71.60
屏東縣,佳冬鄉,塭豐村,0,1,1524,14,1538,2154,0,0,0,0,0,0,71.40
屏東縣,琉球鄉,本福村,0,1,1020,8,1028,1692,0,0,0,0,0,0,60.76
屏東縣,琉球鄉,中福村,0,1,611,3,614,953,0,0,0,0,0,0,64.43
屏東縣,琉球鄉,漁福村,0,1,515,4,519,770,0,0,0,0,0,0,67.40
屏東縣,琉球鄉,大福村,0,1,826,7,833,1411,0,0,0,0,0,0,59.04
屏東縣,琉球鄉,南福村,0,1,582,5,587,1043,0,0,0,0,0,0,56.28
屏東縣,琉球鄉,天福村,0,1,525,1,526,966,0,0,0,0,0,0,54.45
屏東縣,琉球鄉,上福村,0,1,754,10,764,1305,0,0,0,0,0,0,58.54
屏東縣,琉球鄉,杉福村,0,1,419,1,420,693,0,0,0,0,0,0,60.61
屏東縣,車城鄉,福興村,0,1,832,5,837,1354,0,0,0,0,0,0,61.82
屏東縣,車城鄉,福安村,0,1,390,10,400,597,0,0,0,0,0,0,67.00
屏東縣,車城鄉,田中村,0,1,459,2,461,755,0,0,0,0,0,0,61.06
屏東縣,車城鄉,海口村,0,1,495,11,506,841,0,0,0,0,0,0,60.17
屏東縣,車城鄉,統埔村,0,1,243,3,246,427,0,0,0,0,0,0,57.61
屏東縣,車城鄉,溫泉村,0,1,552,8,560,1001,0,0,0,0,0,0,55.94
屏東縣,車城鄉,保力村,0,1,837,15,852,1399,0,0,0,0,0,0,60.90
屏東縣,車城鄉,新街村,0,1,285,5,290,432,0,0,0,0,0,0,67.13
屏東縣,車城鄉,埔墘村,0,1,269,12,281,451,0,0,0,0,0,0,62.31
屏東縣,車城鄉,射寮村,0,1,334,3,337,540,0,0,0,0,0,0,62.41
屏東縣,車城鄉,後灣村,0,1,297,6,303,512,0,0,0,0,0,0,59.18
屏東縣,滿州鄉,滿州村,0,1,762,16,778,1393,0,0,0,0,0,0,55.85
屏東縣,滿州鄉,里德村,0,1,142,3,145,271,0,0,0,0,0,0,53.51
屏東縣,滿州鄉,永靖村,0,1,619,3,622,1133,0,0,0,0,0,0,54.90
屏東縣,滿州鄉,港口村,0,1,611,5,616,1067,0,0,0,0,0,0,57.73
屏東縣,滿州鄉,響林村,0,1,218,1,219,441,0,0,0,0,0,0,49.66
屏東縣,滿州鄉,長樂村,0,1,323,5,328,679,0,0,0,0,0,0,48.31
屏東縣,滿州鄉,九棚村,0,1,113,3,116,242,0,0,0,0,0,0,47.93
屏東縣,滿州鄉,港仔村,0,1,172,1,173,301,0,0,0,0,0,0,57.48
屏東縣,枋山鄉,加祿村,0,1,1301,17,1318,1755,0,0,0,0,0,0,75.10
屏東縣,枋山鄉,枋山村,0,1,714,6,720,1111,0,0,0,0,0,0,64.81
屏東縣,枋山鄉,楓港村,0,1,585,11,596,1129,0,0,0,0,0,0,52.79
屏東縣,枋山鄉,善餘村,0,1,555,10,565,1037,0,0,0,0,0,0,54.48
屏東縣,三地門鄉,三地村,0,1,63,2,65,117,0,0,0,0,0,0,55.56
屏東縣,三地門鄉,達來村,0,1,8,0,8,21,0,0,0,0,0,0,38.10
屏東縣,三地門鄉,德文村,0,1,5,0,5,14,0,0,0,0,0,0,35.71
屏東縣,三地門鄉,大社村,0,1,7,2,9,22,0,0,0,0,0,0,40.91
屏東縣,三地門鄉,賽嘉村,0,1,19,0,19,46,0,0,0,0,0,0,41.30
屏東縣,三地門鄉,口社村,0,1,24,0,24,42,0,0,0,0,0,0,57.14
屏東縣,三地門鄉,馬兒村,0,1,6,0,6,15,0,0,0,0,0,0,40.00
屏東縣,三地門鄉,安坡村,0,1,19,1,20,38,0,0,0,0,0,0,52.63
屏東縣,三地門鄉,青山村,0,1,32,0,32,56,0,0,0,0,0,0,57.14
屏東縣,三地門鄉,青葉村,0,1,22,0,22,38,0,0,0,0,0,0,57.89
屏東縣,霧台鄉,霧台村,0,1,12,0,12,27,0,0,0,0,0,0,44.44
屏東縣,霧台鄉,好茶村,0,1,8,0,8,19,0,0,0,0,0,0,42.11
屏東縣,霧台鄉,阿禮村,0,1,1,0,1,2,0,0,0,0,0,0,50.00
屏東縣,霧台鄉,吉露村,0,1,3,0,3,4,0,0,0,0,0,0,75.00
屏東縣,霧台鄉,大武村,0,1,6,0,6,20,0,0,0,0,0,0,30.00
屏東縣,霧台鄉,佳暮村,0,1,3,0,3,7,0,0,0,0,0,0,42.86
屏東縣,瑪家鄉,瑪家村,0,1,4,1,5,17,0,0,0,0,0,0,29.41
屏東縣,瑪家鄉,北葉村,0,1,59,0,59,96,0,0,0,0,0,0,61.46
屏東縣,瑪家鄉,涼山村,0,1,34,0,34,48,0,0,0,0,0,0,70.83
屏東縣,瑪家鄉,佳義村,0,1,30,1,31,57,0,0,0,0,0,0,54.39
屏東縣,瑪家鄉,排灣村,0,1,7,0,7,14,0,0,0,0,0,0,50.00
屏東縣,瑪家鄉,三和村,0,1,82,2,84,144,0,0,0,0,0,0,58.33
屏東縣,泰武鄉,佳平村,0,1,36,0,36,49,0,0,0,0,0,0,73.47
屏東縣,泰武鄉,武潭村,0,1,15,0,15,33,0,0,0,0,0,0,45.45
屏東縣,泰武鄉,平和村,0,1,19,0,19,33,0,0,0,0,0,0,57.58
屏東縣,泰武鄉,佳興村,0,1,5,0,5,14,0,0,0,0,0,0,35.71
屏東縣,泰武鄉,泰武村,0,1,5,0,5,9,0,0,0,0,0,0,55.56
屏東縣,泰武鄉,萬安村,0,1,13,0,13,34,0,0,0,0,0,0,38.24
屏東縣,來義鄉,來義村,0,1,16,1,17,37,0,0,0,0,0,0,45.95
屏東縣,來義鄉,義林村,0,1,17,0,17,43,0,0,0,0,0,0,39.53
屏東縣,來義鄉,丹林村,0,1,43,1,44,72,0,0,0,0,0,0,61.11
屏東縣,來義鄉,古樓村,0,1,51,3,54,97,0,0,0,0,0,0,55.67
屏東縣,來義鄉,文樂村,0,1,25,3,28,47,0,0,0,0,0,0,59.57
屏東縣,來義鄉,望嘉村,0,1,45,1,46,63,0,0,0,0,0,0,73.02
屏東縣,來義鄉,南和村,0,1,40,2,42,70,0,0,0,0,0,0,60.00
屏東縣,春日鄉,春日村,0,1,28,0,28,59,0,0,0,0,0,0,47.46
屏東縣,春日鄉,古華村,0,1,37,0,37,53,0,0,0,0,0,0,69.81
屏東縣,春日鄉,士文村,0,1,7,0,7,9,0,0,0,0,0,0,77.78
屏東縣,春日鄉,歸崇村,0,1,97,0,97,150,0,0,0,0,0,0,64.67
屏東縣,春日鄉,七佳村,0,1,79,0,79,122,0,0,0,0,0,0,64.75
屏東縣,春日鄉,力里村,0,1,10,0,10,15,0,0,0,0,0,0,66.67
屏東縣,獅子鄉,楓林村,0,1,24,0,24,44,0,0,0,0,0,0,54.55
屏東縣,獅子鄉,丹路村,0,1,31,0,31,76,0,0,0,0,0,0,40.79
屏東縣,獅子鄉,草埔村,0,1,32,0,32,59,0,0,0,0,0,0,54.24
屏東縣,獅子鄉,內文村,0,1,8,0,8,21,0,0,0,0,0,0,38.10
屏東縣,獅子鄉,竹坑村,0,1,19,0,19,32,0,0,0,0,0,0,59.38
屏東縣,獅子鄉,獅子村,0,1,8,0,8,17,0,0,0,0,0,0,47.06
屏東縣,獅子鄉,內獅村,0,1,21,0,21,36,0,0,0,0,0,0,58.33
屏東縣,獅子鄉,南世村,0,1,9,0,9,18,0,0,0,0,0,0,50.00
屏東縣,牡丹鄉,石門村,0,1,105,1,106,176,0,0,0,0,0,0,60.23
屏東縣,牡丹鄉,牡丹村,0,1,17,0,17,47,0,0,0,0,0,0,36.17
屏東縣,牡丹鄉,東源村,0,1,11,0,11,21,0,0,0,0,0,0,52.38
屏東縣,牡丹鄉,旭海村,0,1,49,2,51,106,0,0,0,0,0,0,48.11
屏東縣,牡丹鄉,高士村,0,1,16,0,16,34,0,0,0,0,0,0,47.06
屏東縣,牡丹鄉,四林村,0,1,11,0,11,20,0,0,0,0,0,0,55.00
臺東縣,台東市,文化里,0,1,752,7,759,1172,0,0,0,0,0,0,64.76
臺東縣,台東市,民族里,0,1,1151,11,1162,1632,0,0,0,0,0,0,71.20
臺東縣,台東市,自強里,0,1,1984,20,2004,3194,0,0,0,0,0,0,62.74
臺東縣,台東市,民生里,0,1,1641,22,1663,2605,0,0,0,0,0,0,63.84
臺東縣,台東市,寶桑里,0,1,463,6,469,745,0,0,0,0,0,0,62.95
臺東縣,台東市,民權里,0,1,670,12,682,1067,0,0,0,0,0,0,63.92
臺東縣,台東市,四維里,0,1,264,0,264,455,0,0,0,0,0,0,58.02
臺東縣,台東市,中華里,0,1,1080,15,1095,1760,0,0,0,0,0,0,62.22
臺東縣,台東市,仁愛里,0,1,503,3,506,768,0,0,0,0,0,0,65.89
臺東縣,台東市,強國里,0,1,397,2,399,621,0,0,0,0,0,0,64.25
臺東縣,台東市,大同里,0,1,487,5,492,769,0,0,0,0,0,0,63.98
臺東縣,台東市,成功里,0,1,513,3,516,873,0,0,0,0,0,0,59.11
臺東縣,台東市,建國里,0,1,880,11,891,1441,0,0,0,0,0,0,61.83
臺東縣,台東市,中正里,0,1,570,2,572,916,0,0,0,0,0,0,62.45
臺東縣,台東市,中山里,0,1,688,5,693,1048,0,0,0,0,0,0,66.13
臺東縣,台東市,興國里,0,1,471,5,476,721,0,0,0,0,0,0,66.02
臺東縣,台東市,鐵花里,0,1,291,4,295,473,0,0,0,0,0,0,62.37
臺東縣,台東市,東海里,0,1,1626,16,1642,2664,0,0,0,0,0,0,61.64
臺東縣,台東市,復國里,0,1,454,2,456,724,0,0,0,0,0,0,62.98
臺東縣,台東市,復興里,0,1,285,4,289,501,0,0,0,0,0,0,57.68
臺東縣,台東市,新興里,0,1,776,9,785,1207,0,0,0,0,0,0,65.04
臺東縣,台東市,新生里,0,1,2468,23,2491,4194,0,0,0,0,0,0,59.39
臺東縣,台東市,中心里,0,1,1339,14,1353,2062,0,0,0,0,0,0,65.62
臺東縣,台東市,馬蘭里,0,1,1944,18,1962,2972,0,0,0,0,0,0,66.02
臺東縣,台東市,光明里,0,1,770,4,774,1227,0,0,0,0,0,0,63.08
臺東縣,台東市,豐年里,0,1,1030,16,1046,1602,0,0,0,0,0,0,65.29
臺東縣,台東市,豐樂里,0,1,505,7,512,823,0,0,0,0,0,0,62.21
臺東縣,台東市,永樂里,0,1,694,9,703,983,0,0,0,0,0,0,71.52
臺東縣,台東市,康樂里,0,1,666,5,671,1030,0,0,0,0,0,0,65.15
臺東縣,台東市,豐榮里,0,1,3030,35,3065,5073,0,0,0,0,0,0,60.42
臺東縣,台東市,豐谷里,0,1,1715,23,1738,2835,0,0,0,0,0,0,61.31
臺東縣,台東市,豐里里,0,1,944,11,955,1507,0,0,0,0,0,0,63.37
臺東縣,台東市,豐原里,0,1,629,12,641,956,0,0,0,0,0,0,67.05
臺東縣,台東市,富岡里,0,1,685,9,694,1087,0,0,0,0,0,0,63.85
臺東縣,台東市,富豐里,0,1,284,3,287,459,0,0,0,0,0,0,62.53
臺東縣,台東市,南榮里,0,1,1106,14,1120,1695,0,0,0,0,0,0,66.08
臺東縣,台東市,岩灣里,0,1,578,7,585,1044,0,0,0,0,0,0,56.03
臺東縣,台東市,卑南里,0,1,1129,12,1141,1573,0,0,0,0,0,0,72.54
臺東縣,台東市,南王里,0,1,836,9,845,1333,0,0,0,0,0,0,63.39
臺東縣,台東市,豐田里,0,1,1207,6,1213,1748,0,0,0,0,0,0,69.39
臺東縣,台東市,新園里,0,1,650,6,656,1012,0,0,0,0,0,0,64.82
臺東縣,台東市,建和里,0,1,508,9,517,942,0,0,0,0,0,0,54.88
臺東縣,台東市,建興里,0,1,530,4,534,839,0,0,0,0,0,0,63.65
臺東縣,台東市,建業里,0,1,544,6,550,868,0,0,0,0,0,0,63.36
臺東縣,台東市,知本里,0,1,526,9,535,855,0,0,0,0,0,0,62.57
臺東縣,台東市,建農里,0,1,711,25,736,1121,0,0,0,0,0,0,65.66
臺東縣,成功鎮,信義里,0,1,274,2,276,477,0,0,0,0,0,0,57.86
臺東縣,成功鎮,和平里,0,1,101,0,101,179,0,0,0,0,0,0,56.42
臺東縣,成功鎮,忠仁里,0,1,1615,7,1622,2425,0,0,0,0,0,0,66.89
臺東縣,成功鎮,忠智里,0,1,725,4,729,1066,0,0,0,0,0,0,68.39
臺東縣,成功鎮,三民里,0,1,646,2,648,1036,0,0,0,0,0,0,62.55
臺東縣,成功鎮,三仙里,0,1,331,3,334,610,0,0,0,0,0,0,54.75
臺東縣,成功鎮,忠孝里,0,1,291,0,291,531,0,0,0,0,0,0,54.80
臺東縣,成功鎮,博愛里,0,1,55,0,55,113,0,0,0,0,0,0,48.67
臺東縣,關山鎮,里壟里,0,1,962,10,972,1647,0,0,0,0,0,0,59.02
臺東縣,關山鎮,中福里,0,1,558,7,565,901,0,0,0,0,0,0,62.71
臺東縣,關山鎮,新福里,0,1,410,6,416,657,0,0,0,0,0,0,63.32
臺東縣,關山鎮,豐泉里,0,1,585,2,587,947,0,0,0,0,0,0,61.99
臺東縣,關山鎮,月眉里,0,1,407,4,411,709,0,0,0,0,0,0,57.97
臺東縣,關山鎮,德高里,0,1,775,6,781,1285,0,0,0,0,0,0,60.78
臺東縣,關山鎮,電光里,0,1,118,2,120,242,0,0,0,0,0,0,49.59
臺東縣,卑南鄉,賓朗村,0,1,1160,24,1184,1725,0,0,0,0,0,0,68.64
臺東縣,卑南鄉,美農村,0,1,604,2,606,1008,0,0,0,0,0,0,60.12
臺東縣,卑南鄉,初鹿村,0,1,692,12,704,1057,0,0,0,0,0,0,66.60
臺東縣,卑南鄉,明峰村,0,1,647,13,660,1054,0,0,0,0,0,0,62.62
臺東縣,卑南鄉,嘉豐村,0,1,139,0,139,236,0,0,0,0,0,0,58.90
臺東縣,卑南鄉,太平村,0,1,1887,14,1901,2895,0,0,0,0,0,0,65.66
臺東縣,卑南鄉,泰安村,0,1,447,4,451,715,0,0,0,0,0,0,63.08
臺東縣,卑南鄉,利嘉村,0,1,248,2,250,402,0,0,0,0,0,0,62.19
臺東縣,卑南鄉,東興村,0,1,169,2,171,299,0,0,0,0,0,0,57.19
臺東縣,卑南鄉,溫泉村,0,1,664,7,671,1066,0,0,0,0,0,0,62.95
臺東縣,卑南鄉,富山村,0,1,283,1,284,449,0,0,0,0,0,0,63.25
臺東縣,卑南鄉,富源村,0,1,218,0,218,358,0,0,0,0,0,0,60.89
臺東縣,卑南鄉,利吉村,0,1,144,1,145,261,0,0,0,0,0,0,55.56
臺東縣,鹿野鄉,鹿野村,0,1,511,6,517,799,0,0,0,0,0,0,64.71
臺東縣,鹿野鄉,龍田村,0,1,644,3,647,1055,0,0,0,0,0,0,61.33
臺東縣,鹿野鄉,永安村,0,1,596,9,605,1062,0,0,0,0,0,0,56.97
臺東縣,鹿野鄉,瑞隆村,0,1,474,3,477,793,0,0,0,0,0,0,60.15
臺東縣,鹿野鄉,瑞源村,0,1,388,2,390,655,0,0,0,0,0,0,59.54
臺東縣,鹿野鄉,瑞和村,0,1,243,2,245,377,0,0,0,0,0,0,64.99
臺東縣,鹿野鄉,瑞豐村,0,1,573,2,575,1025,0,0,0,0,0,0,56.10
臺東縣,池上鄉,福原村,0,1,1224,7,1231,1871,0,0,0,0,0,0,65.79
臺東縣,池上鄉,福文村,0,1,801,16,817,1369,0,0,0,0,0,0,59.68
臺東縣,池上鄉,慶豐村,0,1,420,2,422,700,0,0,0,0,0,0,60.29
臺東縣,池上鄉,大坡村,0,1,63,1,64,111,0,0,0,0,0,0,57.66
臺東縣,池上鄉,大埔村,0,1,249,4,253,399,0,0,0,0,0,0,63.41
臺東縣,池上鄉,新興村,0,1,491,9,500,842,0,0,0,0,0,0,59.38
臺東縣,池上鄉,錦園村,0,1,276,0,276,457,0,0,0,0,0,0,60.39
臺東縣,池上鄉,萬安村,0,1,240,1,241,413,0,0,0,0,0,0,58.35
臺東縣,池上鄉,富興村,0,1,224,1,225,383,0,0,0,0,0,0,58.75
臺東縣,池上鄉,振興村,0,1,96,0,96,181,0,0,0,0,0,0,53.04
臺東縣,東河鄉,都蘭村,0,1,698,11,709,1236,0,0,0,0,0,0,57.36
臺東縣,東河鄉,興昌村,0,1,382,4,386,686,0,0,0,0,0,0,56.27
臺東縣,東河鄉,隆昌村,0,1,115,0,115,215,0,0,0,0,0,0,53.49
臺東縣,東河鄉,東河村,0,1,168,2,170,325,0,0,0,0,0,0,52.31
臺東縣,東河鄉,泰源村,0,1,411,3,414,686,0,0,0,0,0,0,60.35
臺東縣,東河鄉,北源村,0,1,520,5,525,1074,0,0,0,0,0,0,48.88
臺東縣,東河鄉,尚德村,0,1,101,0,101,211,0,0,0,0,0,0,47.87
臺東縣,長濱鄉,寧埔村,0,1,187,3,190,415,0,0,0,0,0,0,45.78
臺東縣,長濱鄉,竹湖村,0,1,201,1,202,418,0,0,0,0,0,0,48.33
臺東縣,長濱鄉,長濱村,0,1,663,5,668,1175,0,0,0,0,0,0,56.85
臺東縣,長濱鄉,忠勇村,0,1,257,3,260,550,0,0,0,0,0,0,47.27
臺東縣,長濱鄉,長濱村,0,1,107,0,107,226,0,0,0,0,0,0,47.35
臺東縣,長濱鄉,三間村,0,1,229,2,231,501,0,0,0,0,0,0,46.11
臺東縣,長濱鄉,樟原村,0,1,164,1,165,285,0,0,0,0,0,0,57.89
臺東縣,太麻里鄉,美和村,0,1,592,4,596,924,0,0,0,0,0,0,64.50
臺東縣,太麻里鄉,三和村,0,1,387,1,388,598,0,0,0,0,0,0,64.88
臺東縣,太麻里鄉,華源村,0,1,453,3,456,734,0,0,0,0,0,0,62.13
臺東縣,太麻里鄉,北里村,0,1,246,1,247,386,0,0,0,0,0,0,63.99
臺東縣,太麻里鄉,大王村,0,1,704,2,706,1191,0,0,0,0,0,0,59.28
臺東縣,太麻里鄉,泰和村,0,1,877,9,886,1344,0,0,0,0,0,0,65.92
臺東縣,太麻里鄉,香蘭村,0,1,332,1,333,519,0,0,0,0,0,0,64.16
臺東縣,太麻里鄉,金崙村,0,1,314,6,320,596,0,0,0,0,0,0,53.69
臺東縣,太麻里鄉,多良村,0,1,140,3,143,255,0,0,0,0,0,0,56.08
臺東縣,大武鄉,南興村,0,1,144,2,146,292,0,0,0,0,0,0,50.00
臺東縣,大武鄉,尚武村,0,1,691,3,694,1211,0,0,0,0,0,0,57.31
臺東縣,大武鄉,大武村,0,1,549,9,558,920,0,0,0,0,0,0,60.65
臺東縣,大武鄉,大鳥村,0,1,69,1,70,152,0,0,0,0,0,0,46.05
臺東縣,大武鄉,大竹村,0,1,38,0,38,100,0,0,0,0,0,0,38.00
臺東縣,綠島鄉,南寮村,0,1,384,2,386,665,0,0,0,0,0,0,58.05
臺東縣,綠島鄉,中寮村,0,1,402,3,405,702,0,0,0,0,0,0,57.69
臺東縣,綠島鄉,公館村,0,1,313,6,319,545,0,0,0,0,0,0,58.53
臺東縣,海端鄉,加拿村,0,1,12,1,13,26,0,0,0,0,0,0,50.00
臺東縣,海端鄉,崁頂村,0,1,30,1,31,48,0,0,0,0,0,0,64.58
臺東縣,海端鄉,海端村,0,1,64,1,65,121,0,0,0,0,0,0,53.72
臺東縣,海端鄉,廣原村,0,1,41,2,43,88,0,0,0,0,0,0,48.86
臺東縣,海端鄉,霧鹿村,0,1,16,1,17,29,0,0,0,0,0,0,58.62
臺東縣,海端鄉,利稻村,0,1,15,1,16,29,0,0,0,0,0,0,55.17
臺東縣,延平鄉,桃源村,0,1,56,1,57,104,0,0,0,0,0,0,54.81
臺東縣,延平鄉,紅葉村,0,1,15,1,16,26,0,0,0,0,0,0,61.54
臺東縣,延平鄉,永康村,0,1,11,0,11,23,0,0,0,0,0,0,47.83
臺東縣,延平鄉,武陵村,0,1,21,0,21,41,0,0,0,0,0,0,51.22
臺東縣,延平鄉,鸞山村,0,1,63,0,63,111,0,0,0,0,0,0,56.76
臺東縣,金峰鄉,嘉蘭村,0,1,48,0,48,93,0,0,0,0,0,0,51.61
臺東縣,金峰鄉,正興村,0,1,27,0,27,46,0,0,0,0,0,0,58.70
臺東縣,金峰鄉,新興村,0,1,19,1,20,35,0,0,0,0,0,0,57.14
臺東縣,金峰鄉,賓茂村,0,1,8,0,8,14,0,0,0,0,0,0,57.14
臺東縣,金峰鄉,歷坵村,0,1,4,0,4,18,0,0,0,0,0,0,22.22
臺東縣,達仁鄉,安朔村,0,1,98,1,99,191,0,0,0,0,0,0,51.83
臺東縣,達仁鄉,南田村,0,1,27,0,27,73,0,0,0,0,0,0,36.99
臺東縣,達仁鄉,森永村,0,1,28,2,30,81,0,0,0,0,0,0,37.04
臺東縣,達仁鄉,新化村,0,1,7,0,7,19,0,0,0,0,0,0,36.84
臺東縣,達仁鄉,台板村,0,1,8,0,8,32,0,0,0,0,0,0,25.00
臺東縣,達仁鄉,土板村,0,1,8,0,8,28,0,0,0,0,0,0,28.57
臺東縣,蘭嶼鄉,椰油村,0,1,24,0,24,55,0,0,0,0,0,0,43.64
臺東縣,蘭嶼鄉,紅頭村,0,1,40,1,41,83,0,0,0,0,0,0,49.40
臺東縣,蘭嶼鄉,東清村,0,1,4,0,4,15,0,0,0,0,0,0,26.67
臺東縣,蘭嶼鄉,朗島村,0,1,6,0,6,13,0,0,0,0,0,0,46.15
花蓮縣,花蓮市,民德里,0,1,933,4,937,1485,0,0,0,0,0,0,63.10
花蓮縣,花蓮市,民勤里,0,1,1901,26,1927,3195,0,0,0,0,0,0,60.31
花蓮縣,花蓮市,民意里,0,1,1630,28,1658,2986,0,0,0,0,0,0,55.53
花蓮縣,花蓮市,民心里,0,1,409,9,418,706,0,0,0,0,0,0,59.21
花蓮縣,花蓮市,民享里,0,1,1617,14,1631,2862,0,0,0,0,0,0,56.99
花蓮縣,花蓮市,民運里,0,1,1052,18,1070,1689,0,0,0,0,0,0,63.35
花蓮縣,花蓮市,民政里,0,1,1437,19,1456,2522,0,0,0,0,0,0,57.73
花蓮縣,花蓮市,民立里,0,1,897,14,911,1450,0,0,0,0,0,0,62.83
花蓮縣,花蓮市,民樂里,0,1,234,2,236,428,0,0,0,0,0,0,55.14
花蓮縣,花蓮市,民有里,0,1,363,3,366,618,0,0,0,0,0,0,59.22
花蓮縣,花蓮市,民主里,0,1,391,4,395,635,0,0,0,0,0,0,62.20
花蓮縣,花蓮市,民治里,0,1,265,9,274,432,0,0,0,0,0,0,63.43
花蓮縣,花蓮市,民族里,0,1,340,2,342,622,0,0,0,0,0,0,54.98
花蓮縣,花蓮市,民生里,0,1,772,11,783,1318,0,0,0,0,0,0,59.41
花蓮縣,花蓮市,民權里,0,1,301,2,303,505,0,0,0,0,0,0,60.00
花蓮縣,花蓮市,主商里,0,1,492,3,495,776,0,0,0,0,0,0,63.79
花蓮縣,花蓮市,主勤里,0,1,595,4,599,1008,0,0,0,0,0,0,59.42
花蓮縣,花蓮市,主工里,0,1,407,6,413,687,0,0,0,0,0,0,60.12
花蓮縣,花蓮市,主信里,0,1,419,7,426,734,0,0,0,0,0,0,58.04
花蓮縣,花蓮市,主義里,0,1,593,7,600,995,0,0,0,0,0,0,60.30
花蓮縣,花蓮市,主計里,0,1,443,4,447,824,0,0,0,0,0,0,54.25
花蓮縣,花蓮市,主和里,0,1,1514,19,1533,2724,0,0,0,0,0,0,56.28
花蓮縣,花蓮市,主學里,0,1,933,8,941,1630,0,0,0,0,0,0,57.73
花蓮縣,花蓮市,主農里,0,1,2742,38,2780,4803,0,0,0,0,0,0,57.88
花蓮縣,花蓮市,主權里,0,1,1980,16,1996,3574,0,0,0,0,0,0,55.85
花蓮縣,花蓮市,主力里,0,1,1303,15,1318,2228,0,0,0,0,0,0,59.16
花蓮縣,花蓮市,國風里,0,1,1732,17,1749,3001,0,0,0,0,0,0,58.28
花蓮縣,花蓮市,國威里,0,1,900,4,904,1480,0,0,0,0,0,0,61.08
花蓮縣,花蓮市,國治里,0,1,652,3,655,1086,0,0,0,0,0,0,60.31
花蓮縣,花蓮市,國安里,0,1,265,2,267,450,0,0,0,0,0,0,59.33
花蓮縣,花蓮市,國光里,0,1,857,14,871,1411,0,0,0,0,0,0,61.73
花蓮縣,花蓮市,國防里,0,1,459,3,462,799,0,0,0,0,0,0,57.82
花蓮縣,花蓮市,國華里,0,1,1178,10,1188,2014,0,0,0,0,0,0,58.99
花蓮縣,花蓮市,國魂里,0,1,1027,6,1033,1758,0,0,0,0,0,0,58.76
花蓮縣,花蓮市,國聯里,0,1,2157,21,2178,4233,0,0,0,0,0,0,51.45
花蓮縣,花蓮市,國強里,0,1,487,3,490,908,0,0,0,0,0,0,53.96
花蓮縣,花蓮市,國富里,0,1,2273,21,2294,4015,0,0,0,0,0,0,57.14
花蓮縣,花蓮市,國裕里,0,1,1550,14,1564,2848,0,0,0,0,0,0,54.92
花蓮縣,花蓮市,國慶里,0,1,1602,14,1616,3060,0,0,0,0,0,0,52.81
花蓮縣,花蓮市,國福里,0,1,368,3,371,788,0,0,0,0,0,0,47.08
花蓮縣,新城鄉,新城村,0,1,704,8,712,1299,0,0,0,0,0,0,54.81
花蓮縣,新城鄉,順安村,0,1,459,3,462,874,0,0,0,0,0,0,52.86
花蓮縣,新城鄉,康樂村,0,1,1079,13,1092,1940,0,0,0,0,0,0,56.29
花蓮縣,新城鄉,大漢村,0,1,848,29,877,1636,0,0,0,0,0,0,53.61
花蓮縣,新城鄉,北埔村,0,1,1197,16,1213,2271,0,0,0,0,0,0,53.41
花蓮縣,新城鄉,佳林村,0,1,279,4,283,536,0,0,0,0,0,0,52.80
花蓮縣,新城鄉,嘉里村,0,1,1477,28,1505,2558,0,0,0,0,0,0,58.84
花蓮縣,新城鄉,嘉新村,0,1,647,15,662,1016,0,0,0,0,0,0,65.16
花蓮縣,秀林鄉,和平村,0,1,141,0,141,403,0,0,0,0,0,0,34.99
花蓮縣,秀林鄉,崇德村,0,1,200,1,201,349,0,0,0,0,0,0,57.59
花蓮縣,秀林鄉,富世村,0,1,204,2,206,466,0,0,0,0,0,0,44.21
花蓮縣,秀林鄉,秀林村,0,1,58,0,58,139,0,0,0,0,0,0,41.73
花蓮縣,秀林鄉,景美村,0,1,68,5,73,147,0,0,0,0,0,0,49.66
花蓮縣,秀林鄉,佳民村,0,1,73,3,76,138,0,0,0,0,0,0,55.07
花蓮縣,秀林鄉,水源村,0,1,63,0,63,113,0,0,0,0,0,0,55.75
花蓮縣,秀林鄉,銅門村,0,1,64,0,64,117,0,0,0,0,0,0,54.70
花蓮縣,秀林鄉,文蘭村,0,1,38,1,39,89,0,0,0,0,0,0,43.82
花蓮縣,吉安鄉,永安村,0,1,1525,18,1543,2837,0,0,0,0,0,0,54.39
花蓮縣,吉安鄉,太昌村,0,1,1276,15,1291,2295,0,0,0,0,0,0,56.25
花蓮縣,吉安鄉,慶豐村,0,1,2121,27,2148,3759,0,0,0,0,0,0,57.14
花蓮縣,吉安鄉,吉安村,0,1,1467,19,1486,2659,0,0,0,0,0,0,55.89
花蓮縣,吉安鄉,福興村,0,1,1070,16,1086,1832,0,0,0,0,0,0,59.28
花蓮縣,吉安鄉,南華村,0,1,668,19,687,1128,0,0,0,0,0,0,60.90
花蓮縣,吉安鄉,干城村,0,1,506,11,517,907,0,0,0,0,0,0,57.00
花蓮縣,吉安鄉,永興村,0,1,828,7,835,1420,0,0,0,0,0,0,58.80
花蓮縣,吉安鄉,稻香村,0,1,1233,9,1242,2212,0,0,0,0,0,0,56.15
花蓮縣,吉安鄉,南昌村,0,1,964,8,972,1834,0,0,0,0,0,0,53.00
花蓮縣,吉安鄉,宜昌村,0,1,1376,20,1396,2505,0,0,0,0,0,0,55.73
花蓮縣,吉安鄉,北昌村,0,1,3073,24,3097,5228,0,0,0,0,0,0,59.24
花蓮縣,吉安鄉,勝安村,0,1,1644,22,1666,2940,0,0,0,0,0,0,56.67
花蓮縣,吉安鄉,仁里村,0,1,2409,15,2424,4189,0,0,0,0,0,0,57.87
花蓮縣,吉安鄉,東昌村,0,1,1470,22,1492,2756,0,0,0,0,0,0,54.14
花蓮縣,吉安鄉,仁安村,0,1,670,13,683,1354,0,0,0,0,0,0,50.44
花蓮縣,吉安鄉,仁和村,0,1,1683,30,1713,3065,0,0,0,0,0,0,55.89
花蓮縣,吉安鄉,光華村,0,1,469,11,480,855,0,0,0,0,0,0,56.14
花蓮縣,壽豐鄉,溪口村,0,1,410,5,415,718,0,0,0,0,0,0,57.80
花蓮縣,壽豐鄉,樹湖村,0,1,171,3,174,323,0,0,0,0,0,0,53.87
花蓮縣,壽豐鄉,豐山村,0,1,1018,11,1029,1834,0,0,0,0,0,0,56.11
花蓮縣,壽豐鄉,豐裡村,0,1,658,13,671,1207,0,0,0,0,0,0,55.59
花蓮縣,壽豐鄉,豐坪村,0,1,391,4,395,655,0,0,0,0,0,0,60.31
花蓮縣,壽豐鄉,壽豐村,0,1,605,7,612,1062,0,0,0,0,0,0,57.63
花蓮縣,壽豐鄉,共和村,0,1,305,4,309,561,0,0,0,0,0,0,55.08
花蓮縣,壽豐鄉,光榮村,0,1,79,4,83,149,0,0,0,0,0,0,55.70
花蓮縣,壽豐鄉,池南村,0,1,307,5,312,561,0,0,0,0,0,0,55.61
花蓮縣,壽豐鄉,平和村,0,1,617,6,623,1035,0,0,0,0,0,0,60.19
花蓮縣,壽豐鄉,志學村,0,1,1140,15,1155,2113,0,0,0,0,0,0,54.66
花蓮縣,壽豐鄉,米棧村,0,1,76,2,78,132,0,0,0,0,0,0,59.09
花蓮縣,壽豐鄉,月眉村,0,1,125,3,128,269,0,0,0,0,0,0,47.58
花蓮縣,壽豐鄉,鹽寮村,0,1,194,4,198,384,0,0,0,0,0,0,51.56
花蓮縣,壽豐鄉,水璉村,0,1,207,4,211,474,0,0,0,0,0,0,44.51
花蓮縣,鳳林鎮,鳳仁里,0,1,690,5,695,1124,0,0,0,0,0,0,61.83
花蓮縣,鳳林鎮,鳳義里,0,1,408,1,409,683,0,0,0,0,0,0,59.88
花蓮縣,鳳林鎮,鳳禮里,0,1,456,5,461,734,0,0,0,0,0,0,62.81
花蓮縣,鳳林鎮,鳳智里,0,1,740,8,748,1206,0,0,0,0,0,0,62.02
花蓮縣,鳳林鎮,鳳信里,0,1,542,4,546,903,0,0,0,0,0,0,60.47
花蓮縣,鳳林鎮,山興里,0,1,134,2,136,265,0,0,0,0,0,0,51.32
花蓮縣,鳳林鎮,大榮里,0,1,638,17,655,1278,0,0,0,0,0,0,51.25
花蓮縣,鳳林鎮,北林里,0,1,366,12,378,647,0,0,0,0,0,0,58.42
花蓮縣,鳳林鎮,南平里,0,1,387,3,390,719,0,0,0,0,0,0,54.24
花蓮縣,鳳林鎮,林榮里,0,1,549,8,557,868,0,0,0,0,0,0,64.17
花蓮縣,鳳林鎮,長橋里,0,1,586,9,595,1087,0,0,0,0,0,0,54.74
花蓮縣,鳳林鎮,森榮里,0,1,89,1,90,165,0,0,0,0,0,0,54.55
花蓮縣,光復鄉,大華村,0,1,532,5,537,931,0,0,0,0,0,0,57.68
花蓮縣,光復鄉,大安村,0,1,593,4,597,952,0,0,0,0,0,0,62.71
花蓮縣,光復鄉,大馬村,0,1,209,2,211,436,0,0,0,0,0,0,48.39
花蓮縣,光復鄉,大平村,0,1,144,3,147,315,0,0,0,0,0,0,46.67
花蓮縣,光復鄉,大同村,0,1,414,2,416,729,0,0,0,0,0,0,57.06
花蓮縣,光復鄉,東富村,0,1,93,5,98,230,0,0,0,0,0,0,42.61
花蓮縣,光復鄉,西富村,0,1,71,1,72,128,0,0,0,0,0,0,56.25
花蓮縣,光復鄉,南富村,0,1,54,0,54,120,0,0,0,0,0,0,45.00
花蓮縣,光復鄉,北富村,0,1,83,2,85,219,0,0,0,0,0,0,38.81
花蓮縣,光復鄉,西富村,0,1,118,2,120,230,0,0,0,0,0,0,52.17
花蓮縣,光復鄉,大進村,0,1,345,4,349,515,0,0,0,0,0,0,67.77
花蓮縣,光復鄉,大全村,0,1,380,5,385,678,0,0,0,0,0,0,56.78
花蓮縣,光復鄉,大興村,0,1,193,2,195,380,0,0,0,0,0,0,51.32
花蓮縣,光復鄉,大富村,0,1,212,4,216,388,0,0,0,0,0,0,55.67
花蓮縣,光復鄉,大豐村,0,1,348,4,352,606,0,0,0,0,0,0,58.09
花蓮縣,豐濱鄉,靜浦村,0,1,44,0,44,138,0,0,0,0,0,0,31.88
花蓮縣,豐濱鄉,港口村,0,1,64,1,65,165,0,0,0,0,0,0,39.39
花蓮縣,豐濱鄉,豐濱村,0,1,392,5,397,752,0,0,0,0,0,0,52.79
花蓮縣,豐濱鄉,新社村,0,1,58,0,58,126,0,0,0,0,0,0,46.03
花蓮縣,豐濱鄉,磯崎村,0,1,55,0,55,103,0,0,0,0,0,0,53.40
花蓮縣,萬榮鄉,西林村,0,1,30,1,31,67,0,0,0,0,0,0,46.27
花蓮縣,萬榮鄉,見晴村,0,1,13,0,13,29,0,0,0,0,0,0,44.83
花蓮縣,萬榮鄉,萬榮村,0,1,27,0,27,63,0,0,0,0,0,0,42.86
花蓮縣,萬榮鄉,明利村,0,1,25,0,25,63,0,0,0,0,0,0,39.68
花蓮縣,萬榮鄉,馬遠村,0,1,14,0,14,38,0,0,0,0,0,0,36.84
花蓮縣,萬榮鄉,紅葉村,0,1,47,0,47,120,0,0,0,0,0,0,39.17
花蓮縣,瑞穗鄉,瑞穗村,0,1,1042,10,1052,1848,0,0,0,0,0,0,56.93
花蓮縣,瑞穗鄉,瑞美村,0,1,892,11,903,1649,0,0,0,0,0,0,54.76
花蓮縣,瑞穗鄉,瑞良村,0,1,243,3,246,419,0,0,0,0,0,0,58.71
花蓮縣,瑞穗鄉,瑞祥村,0,1,451,4,455,850,0,0,0,0,0,0,53.53
花蓮縣,瑞穗鄉,瑞北村,0,1,231,2,233,437,0,0,0,0,0,0,53.32
花蓮縣,瑞穗鄉,舞鶴村,0,1,267,3,270,518,0,0,0,0,0,0,52.12
花蓮縣,瑞穗鄉,鶴岡村,0,1,146,2,148,335,0,0,0,0,0,0,44.18
花蓮縣,瑞穗鄉,奇美村,0,1,24,0,24,53,0,0,0,0,0,0,45.28
花蓮縣,瑞穗鄉,富源村,0,1,379,1,380,670,0,0,0,0,0,0,56.72
花蓮縣,瑞穗鄉,富民村,0,1,133,4,137,323,0,0,0,0,0,0,42.41
花蓮縣,瑞穗鄉,富興村,0,1,268,3,271,492,0,0,0,0,0,0,55.08
花蓮縣,玉里鎮,中城里,0,1,2253,20,2273,4081,0,0,0,0,0,0,55.70
花蓮縣,玉里鎮,國武里,0,1,780,8,788,1385,0,0,0,0,0,0,56.90
花蓮縣,玉里鎮,啟模里,0,1,942,7,949,1762,0,0,0,0,0,0,53.86
花蓮縣,玉里鎮,泰昌里,0,1,1647,120,1767,3354,0,0,0,0,0,0,52.68
花蓮縣,玉里鎮,永昌里,0,1,560,13,573,1065,0,0,0,0,0,0,53.80
花蓮縣,玉里鎮,源城里,0,1,553,10,563,1106,0,0,0,0,0,0,50.90
花蓮縣,玉里鎮,長良里,0,1,351,15,366,691,0,0,0,0,0,0,52.97
花蓮縣,玉里鎮,樂合里,0,1,156,2,158,399,0,0,0,0,0,0,39.60
花蓮縣,玉里鎮,東豐里,0,1,178,5,183,352,0,0,0,0,0,0,51.99
花蓮縣,玉里鎮,觀音里,0,1,493,11,504,1069,0,0,0,0,0,0,47.15
花蓮縣,玉里鎮,松浦里,0,1,271,8,279,577,0,0,0,0,0,0,48.35
花蓮縣,玉里鎮,春日里,0,1,249,5,254,525,0,0,0,0,0,0,48.38
花蓮縣,玉里鎮,德武里,0,1,38,1,39,85,0,0,0,0,0,0,45.88
花蓮縣,玉里鎮,三民里,0,1,531,13,544,1016,0,0,0,0,0,0,53.54
花蓮縣,玉里鎮,大禹里,0,1,540,11,551,1100,0,0,0,0,0,0,50.09
花蓮縣,富里鄉,吳江村,0,1,242,0,242,470,0,0,0,0,0,0,51.49
花蓮縣,富里鄉,東里村,0,1,582,11,593,1265,0,0,0,0,0,0,46.88
花蓮縣,富里鄉,萬寧村,0,1,269,2,271,544,0,0,0,0,0,0,49.82
花蓮縣,富里鄉,新興村,0,1,292,9,301,643,0,0,0,0,0,0,46.81
花蓮縣,富里鄉,竹田村,0,1,574,5,579,1077,0,0,0,0,0,0,53.76
花蓮縣,富里鄉,羅山村,0,1,232,2,234,468,0,0,0,0,0,0,50.00
花蓮縣,富里鄉,石牌村,0,1,464,4,468,888,0,0,0,0,0,0,52.70
花蓮縣,富里鄉,明里村,0,1,238,2,240,403,0,0,0,0,0,0,59.55
花蓮縣,富里鄉,富里村,0,1,875,7,882,1663,0,0,0,0,0,0,53.04
花蓮縣,富里鄉,永豐村,0,1,267,2,269,549,0,0,0,0,0,0,49.00
花蓮縣,富里鄉,豐南村,0,1,178,1,179,376,0,0,0,0,0,0,47.61
花蓮縣,富里鄉,富南村,0,1,275,2,277,535,0,0,0,0,0,0,51.78
花蓮縣,富里鄉,學田村,0,1,313,3,316,580,0,0,0,0,0,0,54.48
花蓮縣,卓溪鄉,崙山村,0,1,11,0,11,31,0,0,0,0,0,0,35.48
花蓮縣,卓溪鄉,立山村,0,1,20,0,20,46,0,0,0,0,0,0,43.48
花蓮縣,卓溪鄉,太平村,0,1,16,0,16,31,0,0,0,0,0,0,51.61
花蓮縣,卓溪鄉,卓溪村,0,1,38,3,41,78,0,0,0,0,0,0,52.56
花蓮縣,卓溪鄉,卓清村,0,1,54,4,58,103,0,0,0,0,0,0,56.31
花蓮縣,卓溪鄉,古風村,0,1,41,1,42,97,0,0,0,0,0,0,43.30
澎湖縣,馬公市,新復里,0,1,266,4,270,393,0,0,0,0,0,0,68.70
澎湖縣,馬公市,復興里,0,1,210,2,212,315,0,0,0,0,0,0,67.30
澎湖縣,馬公市,長安里,0,1,341,5,346,560,0,0,0,0,0,0,61.79
澎湖縣,馬公市,中央里,0,1,291,4,295,507,0,0,0,0,0,0,58.19
澎湖縣,馬公市,啟明里,0,1,513,3,516,879,0,0,0,0,0,0,58.70
澎湖縣,馬公市,重慶里,0,1,570,4,574,1016,0,0,0,0,0,0,56.50
澎湖縣,馬公市,中興里,0,1,427,7,434,720,0,0,0,0,0,0,60.28
澎湖縣,馬公市,光復里,0,1,1033,12,1045,1722,0,0,0,0,0,0,60.69
澎湖縣,馬公市,光明里,0,1,708,14,722,1201,0,0,0,0,0,0,60.12
澎湖縣,馬公市,光榮里,0,1,1364,18,1382,2286,0,0,0,0,0,0,60.45
澎湖縣,馬公市,朝陽里,0,1,2301,23,2324,4075,0,0,0,0,0,0,57.03
澎湖縣,馬公市,陽明里,0,1,1217,13,1230,2209,0,0,0,0,0,0,55.68
澎湖縣,馬公市,重光里,0,1,550,8,558,950,0,0,0,0,0,0,58.74
澎湖縣,馬公市,西衛里,0,1,1338,22,1360,2298,0,0,0,0,0,0,59.18
澎湖縣,馬公市,西文里,0,1,1070,8,1078,1821,0,0,0,0,0,0,59.20
澎湖縣,馬公市,東文里,0,1,968,12,980,1626,0,0,0,0,0,0,60.27
澎湖縣,馬公市,案山里,0,1,761,16,777,1204,0,0,0,0,0,0,64.53
澎湖縣,馬公市,光華里,0,1,303,5,308,475,0,0,0,0,0,0,64.84
澎湖縣,馬公市,前寮里,0,1,330,7,337,495,0,0,0,0,0,0,68.08
澎湖縣,馬公市,石泉里,0,1,698,15,713,1135,0,0,0,0,0,0,62.82
澎湖縣,馬公市,菜園里,0,1,235,1,236,324,0,0,0,0,0,0,72.84
澎湖縣,馬公市,東衛里,0,1,716,14,730,1169,0,0,0,0,0,0,62.45
澎湖縣,馬公市,安宅里,0,1,273,1,274,412,0,0,0,0,0,0,66.50
澎湖縣,馬公市,興仁里,0,1,317,4,321,500,0,0,0,0,0,0,64.20
澎湖縣,馬公市,烏崁里,0,1,455,10,465,781,0,0,0,0,0,0,59.54
澎湖縣,馬公市,鐵線里,0,1,214,3,217,338,0,0,0,0,0,0,64.20
澎湖縣,馬公市,鎖港里,0,1,1014,12,1026,1904,0,0,0,0,0,0,53.89
澎湖縣,馬公市,山水里,0,1,698,4,702,1287,0,0,0,0,0,0,54.55
澎湖縣,馬公市,五德里,0,1,98,3,101,164,0,0,0,0,0,0,61.59
澎湖縣,馬公市,井垵里,0,1,198,2,200,333,0,0,0,0,0,0,60.06
澎湖縣,馬公市,時裡里,0,1,654,6,660,972,0,0,0,0,0,0,67.90
澎湖縣,馬公市,風櫃里,0,1,681,7,688,1078,0,0,0,0,0,0,63.82
澎湖縣,馬公市,虎井里,0,1,182,2,184,533,0,0,0,0,0,0,34.52
澎湖縣,馬公市,桶盤里,0,1,61,0,61,192,0,0,0,0,0,0,31.77
澎湖縣,湖西鄉,湖西村,0,1,525,5,530,815,0,0,0,0,0,0,65.03
澎湖縣,湖西鄉,湖東村,0,1,166,1,167,273,0,0,0,0,0,0,61.17
澎湖縣,湖西鄉,青螺村,0,1,112,1,113,189,0,0,0,0,0,0,59.79
澎湖縣,湖西鄉,白坑村,0,1,142,4,146,235,0,0,0,0,0,0,62.13
澎湖縣,湖西鄉,南寮村,0,1,325,8,333,592,0,0,0,0,0,0,56.25
澎湖縣,湖西鄉,北寮村,0,1,174,4,178,258,0,0,0,0,0,0,68.99
澎湖縣,湖西鄉,紅羅村,0,1,307,5,312,535,0,0,0,0,0,0,58.32
澎湖縣,湖西鄉,西溪村,0,1,248,2,250,421,0,0,0,0,0,0,59.38
澎湖縣,湖西鄉,成功村,0,1,233,1,234,382,0,0,0,0,0,0,61.26
澎湖縣,湖西鄉,東石村,0,1,51,0,51,102,0,0,0,0,0,0,50.00
澎湖縣,湖西鄉,沙港村,0,1,431,3,434,703,0,0,0,0,0,0,61.74
澎湖縣,湖西鄉,中西村,0,1,98,2,100,161,0,0,0,0,0,0,62.11
澎湖縣,湖西鄉,鼎灣村,0,1,175,6,181,295,0,0,0,0,0,0,61.36
澎湖縣,湖西鄉,潭邊村,0,1,143,1,144,215,0,0,0,0,0,0,66.98
澎湖縣,湖西鄉,許家村,0,1,94,6,100,177,0,0,0,0,0,0,56.50
澎湖縣,湖西鄉,城北村,0,1,124,2,126,174,0,0,0,0,0,0,72.41
澎湖縣,湖西鄉,太武村,0,1,50,1,51,80,0,0,0,0,0,0,63.75
澎湖縣,湖西鄉,隘門村,0,1,392,4,396,598,0,0,0,0,0,0,66.22
澎湖縣,湖西鄉,林投村,0,1,460,9,469,811,0,0,0,0,0,0,57.83
澎湖縣,湖西鄉,尖山村,0,1,292,5,297,500,0,0,0,0,0,0,59.40
澎湖縣,湖西鄉,龍門村,0,1,870,12,882,1493,0,0,0,0,0,0,59.08
澎湖縣,湖西鄉,果葉村,0,1,346,2,348,598,0,0,0,0,0,0,58.19
澎湖縣,白沙鄉,中屯村,0,1,256,2,258,401,0,0,0,0,0,0,64.34
澎湖縣,白沙鄉,講美村,0,1,298,1,299,495,0,0,0,0,0,0,60.40
澎湖縣,白沙鄉,城前村,0,1,56,1,57,85,0,0,0,0,0,0,67.06
澎湖縣,白沙鄉,鎮海村,0,1,64,1,65,101,0,0,0,0,0,0,64.36
澎湖縣,白沙鄉,港子村,0,1,150,3,153,252,0,0,0,0,0,0,60.71
澎湖縣,白沙鄉,岐頭村,0,1,104,1,105,197,0,0,0,0,0,0,53.30
澎湖縣,白沙鄉,小赤村,0,1,104,3,107,166,0,0,0,0,0,0,64.46
澎湖縣,白沙鄉,赤崁村,0,1,771,14,785,1265,0,0,0,0,0,0,62.06
澎湖縣,白沙鄉,瓦硐村,0,1,164,3,167,261,0,0,0,0,0,0,63.98
澎湖縣,白沙鄉,後寮村,0,1,358,7,365,637,0,0,0,0,0,0,57.30
澎湖縣,白沙鄉,通梁村,0,1,404,3,407,677,0,0,0,0,0,0,60.12
澎湖縣,白沙鄉,吉貝村,0,1,408,1,409,1109,0,0,0,0,0,0,36.88
澎湖縣,白沙鄉,鳥嶼村,0,1,292,6,298,848,0,0,0,0,0,0,35.14
澎湖縣,白沙鄉,員貝村,0,1,82,0,82,205,0,0,0,0,0,0,40.00
澎湖縣,白沙鄉,大倉村,0,1,75,1,76,148,0,0,0,0,0,0,51.35
澎湖縣,西嶼鄉,橫礁村,0,1,111,3,114,233,0,0,0,0,0,0,48.93
澎湖縣,西嶼鄉,合界村,0,1,205,1,206,410,0,0,0,0,0,0,50.24
澎湖縣,西嶼鄉,竹灣村,0,1,351,7,358,735,0,0,0,0,0,0,48.71
澎湖縣,西嶼鄉,小門村,0,1,124,2,126,241,0,0,0,0,0,0,52.28
澎湖縣,西嶼鄉,大池村,0,1,286,7,293,575,0,0,0,0,0,0,50.96
澎湖縣,西嶼鄉,二崁村,0,1,55,0,55,108,0,0,0,0,0,0,50.93
澎湖縣,西嶼鄉,池東村,0,1,257,10,267,479,0,0,0,0,0,0,55.74
澎湖縣,西嶼鄉,池西村,0,1,114,1,115,202,0,0,0,0,0,0,56.93
澎湖縣,西嶼鄉,赤馬村,0,1,277,4,281,583,0,0,0,0,0,0,48.20
澎湖縣,西嶼鄉,內垵村,0,1,543,14,557,1159,0,0,0,0,0,0,48.06
澎湖縣,西嶼鄉,外垵村,0,1,848,6,854,1706,0,0,0,0,0,0,50.06
澎湖縣,望安鄉,東安村,0,1,170,2,172,394,0,0,0,0,0,0,43.65
澎湖縣,望安鄉,西安村,0,1,152,3,155,303,0,0,0,0,0,0,51.16
澎湖縣,望安鄉,中社村,0,1,62,2,64,209,0,0,0,0,0,0,30.62
澎湖縣,望安鄉,水垵村,0,1,100,3,103,265,0,0,0,0,0,0,38.87
澎湖縣,望安鄉,將軍村,0,1,360,4,364,1107,0,0,0,0,0,0,32.88
澎湖縣,望安鄉,東吉村,0,1,20,0,20,320,0,0,0,0,0,0,6.25
澎湖縣,望安鄉,東坪村,0,1,30,0,30,227,0,0,0,0,0,0,13.22
澎湖縣,望安鄉,西坪村,0,1,26,0,26,116,0,0,0,0,0,0,22.41
澎湖縣,望安鄉,花嶼村,0,1,104,0,104,217,0,0,0,0,0,0,47.93
澎湖縣,七美鄉,東湖村,0,1,110,4,114,225,0,0,0,0,0,0,50.67
澎湖縣,七美鄉,西湖村,0,1,153,5,158,388,0,0,0,0,0,0,40.72
澎湖縣,七美鄉,中和村,0,1,167,2,169,376,0,0,0,0,0,0,44.95
澎湖縣,七美鄉,平和村,0,1,101,0,101,216,0,0,0,0,0,0,46.76
澎湖縣,七美鄉,海豐村,0,1,100,1,101,240,0,0,0,0,0,0,42.08
澎湖縣,七美鄉,南港村,0,1,365,8,373,742,0,0,0,0,0,0,50.27
基隆市,中正區,長潭里,0,1,413,3,416,629,0,0,0,0,0,0,66.14
基隆市,中正區,砂子里,0,1,1019,20,1039,1926,0,0,0,0,0,0,53.95
基隆市,中正區,八斗里,0,1,967,8,975,1593,0,0,0,0,0,0,61.21
基隆市,中正區,碧砂里,0,1,741,5,746,1367,0,0,0,0,0,0,54.57
基隆市,中正區,新豐里,0,1,1632,16,1648,4064,0,0,0,0,0,0,40.55
基隆市,中正區,平寮里,0,1,893,14,907,1588,0,0,0,0,0,0,57.12
基隆市,中正區,社寮里,0,1,1082,13,1095,1995,0,0,0,0,0,0,54.89
基隆市,中正區,和憲里,0,1,563,6,569,1004,0,0,0,0,0,0,56.67
基隆市,中正區,海濱里,0,1,516,5,521,1030,0,0,0,0,0,0,50.58
基隆市,中正區,正濱里,0,1,687,11,698,1342,0,0,0,0,0,0,52.01
基隆市,中正區,中正里,0,1,1093,9,1102,1996,0,0,0,0,0,0,55.21
基隆市,中正區,中濱里,0,1,771,4,775,1477,0,0,0,0,0,0,52.47
基隆市,中正區,建國里,0,1,1213,16,1229,2156,0,0,0,0,0,0,57.00
基隆市,中正區,砂灣里,0,1,1045,14,1059,2091,0,0,0,0,0,0,50.65
基隆市,中正區,真砂里,0,1,798,7,805,1474,0,0,0,0,0,0,54.61
基隆市,中正區,正砂里,0,1,1271,26,1297,2422,0,0,0,0,0,0,53.55
基隆市,中正區,中砂里,0,1,816,3,819,1425,0,0,0,0,0,0,57.47
基隆市,中正區,入船里,0,1,723,5,728,1388,0,0,0,0,0,0,52.45
基隆市,中正區,正船里,0,1,887,7,894,1559,0,0,0,0,0,0,57.34
基隆市,中正區,中船里,0,1,699,9,708,1425,0,0,0,0,0,0,49.68
基隆市,中正區,港通里,0,1,696,8,704,1273,0,0,0,0,0,0,55.30
基隆市,中正區,義重里,0,1,616,7,623,1216,0,0,0,0,0,0,51.23
基隆市,中正區,信義里,0,1,582,8,590,1106,0,0,0,0,0,0,53.35
基隆市,中正區,正義里,0,1,822,13,835,1512,0,0,0,0,0,0,55.22
基隆市,中正區,德義里,0,1,482,3,485,834,0,0,0,0,0,0,58.15
基隆市,信義區,仁壽里,0,1,699,11,710,1202,0,0,0,0,0,0,59.07
基隆市,信義區,仁義里,0,1,742,7,749,1237,0,0,0,0,0,0,60.55
基隆市,信義區,義昭里,0,1,636,4,640,1071,0,0,0,0,0,0,59.76
基隆市,信義區,義幸里,0,1,1441,14,1455,2435,0,0,0,0,0,0,59.75
基隆市,信義區,義民里,0,1,508,5,513,855,0,0,0,0,0,0,60.00
基隆市,信義區,義和里,0,1,813,7,820,1357,0,0,0,0,0,0,60.43
基隆市,信義區,智慧里,0,1,440,7,447,725,0,0,0,0,0,0,61.66
基隆市,信義區,智誠里,0,1,956,15,971,1794,0,0,0,0,0,0,54.12
基隆市,信義區,禮儀里,0,1,849,7,856,1511,0,0,0,0,0,0,56.65
基隆市,信義區,禮東里,0,1,972,4,976,1641,0,0,0,0,0,0,59.48
基隆市,信義區,信綠里,0,1,1381,14,1395,2380,0,0,0,0,0,0,58.61
基隆市,信義區,東信里,0,1,1392,14,1406,2574,0,0,0,0,0,0,54.62
基隆市,信義區,東光里,0,1,988,10,998,1863,0,0,0,0,0,0,53.57
基隆市,信義區,東明里,0,1,1760,14,1774,3312,0,0,0,0,0,0,53.56
基隆市,信義區,東安里,0,1,1545,26,1571,2725,0,0,0,0,0,0,57.65
基隆市,信義區,孝賢里,0,1,1221,8,1229,2306,0,0,0,0,0,0,53.30
基隆市,信義區,孝深里,0,1,2002,25,2027,3933,0,0,0,0,0,0,51.54
基隆市,信義區,孝岡里,0,1,520,3,523,857,0,0,0,0,0,0,61.03
基隆市,仁愛區,林泉里,0,1,974,4,978,1842,0,0,0,0,0,0,53.09
基隆市,仁愛區,花崗里,0,1,578,7,585,990,0,0,0,0,0,0,59.09
基隆市,仁愛區,虹橋里,0,1,894,13,907,1569,0,0,0,0,0,0,57.81
基隆市,仁愛區,水錦里,0,1,1024,14,1038,1794,0,0,0,0,0,0,57.86
基隆市,仁愛區,智仁里,0,1,1280,13,1293,2280,0,0,0,0,0,0,56.71
基隆市,仁愛區,和明里,0,1,600,6,606,1118,0,0,0,0,0,0,54.20
基隆市,仁愛區,忠勇里,0,1,554,8,562,1082,0,0,0,0,0,0,51.94
基隆市,仁愛區,玉田里,0,1,657,5,662,1160,0,0,0,0,0,0,57.07
基隆市,仁愛區,仁德里,0,1,608,6,614,1052,0,0,0,0,0,0,58.37
基隆市,仁愛區,博愛里,0,1,940,12,952,1734,0,0,0,0,0,0,54.90
基隆市,仁愛區,福仁里,0,1,460,5,465,902,0,0,0,0,0,0,51.55
基隆市,仁愛區,誠仁里,0,1,540,7,547,1074,0,0,0,0,0,0,50.93
基隆市,仁愛區,吉仁里,0,1,1520,21,1541,3044,0,0,0,0,0,0,50.62
基隆市,仁愛區,育仁里,0,1,439,6,445,920,0,0,0,0,0,0,48.37
基隆市,仁愛區,英仁里,0,1,786,12,798,1585,0,0,0,0,0,0,50.35
基隆市,仁愛區,龍門里,0,1,444,9,453,937,0,0,0,0,0,0,48.35
基隆市,仁愛區,德厚里,0,1,669,7,676,1346,0,0,0,0,0,0,50.22
基隆市,仁愛區,曲水里,0,1,497,8,505,982,0,0,0,0,0,0,51.43
基隆市,仁愛區,崇文里,0,1,515,6,521,948,0,0,0,0,0,0,54.96
基隆市,仁愛區,文安里,0,1,612,5,617,1170,0,0,0,0,0,0,52.74
基隆市,仁愛區,兆連里,0,1,346,1,347,685,0,0,0,0,0,0,50.66
基隆市,仁愛區,獅球里,0,1,624,13,637,1243,0,0,0,0,0,0,51.25
基隆市,仁愛區,書院里,0,1,693,7,700,1165,0,0,0,0,0,0,60.09
基隆市,仁愛區,朝棟里,0,1,1588,14,1602,2708,0,0,0,0,0,0,59.16
基隆市,仁愛區,光華里,0,1,1228,17,1245,2315,0,0,0,0,0,0,53.78
基隆市,仁愛區,明德里,0,1,434,2,436,752,0,0,0,0,0,0,57.98
基隆市,仁愛區,同風里,0,1,389,8,397,699,0,0,0,0,0,0,56.80
基隆市,仁愛區,文昌里,0,1,499,4,503,883,0,0,0,0,0,0,56.96
基隆市,仁愛區,新店里,0,1,452,2,454,808,0,0,0,0,0,0,56.19
基隆市,中山區,新建里,0,1,498,13,511,828,0,0,0,0,0,0,61.71
基隆市,中山區,安民里,0,1,639,6,645,1135,0,0,0,0,0,0,56.83
基隆市,中山區,安平里,0,1,588,10,598,988,0,0,0,0,0,0,60.53
基隆市,中山區,中山里,0,1,664,13,677,1153,0,0,0,0,0,0,58.72
基隆市,中山區,民治里,0,1,603,11,614,1062,0,0,0,0,0,0,57.82
基隆市,中山區,中興里,0,1,856,10,866,1455,0,0,0,0,0,0,59.52
基隆市,中山區,仁正里,0,1,506,5,511,875,0,0,0,0,0,0,58.40
基隆市,中山區,健民里,0,1,958,16,974,1663,0,0,0,0,0,0,58.57
基隆市,中山區,通化里,0,1,698,8,706,1321,0,0,0,0,0,0,53.44
基隆市,中山區,居仁里,0,1,855,9,864,1622,0,0,0,0,0,0,53.27
基隆市,中山區,通明里,0,1,1244,16,1260,2085,0,0,0,0,0,0,60.43
基隆市,中山區,和平里,0,1,467,7,474,816,0,0,0,0,0,0,58.09
基隆市,中山區,仙洞里,0,1,444,3,447,838,0,0,0,0,0,0,53.34
基隆市,中山區,太白里,0,1,631,13,644,1029,0,0,0,0,0,0,62.59
基隆市,中山區,協和里,0,1,921,20,941,1654,0,0,0,0,0,0,56.89
基隆市,中山區,文化里,0,1,601,6,607,1114,0,0,0,0,0,0,54.49
基隆市,中山區,德安里,0,1,1619,22,1641,2887,0,0,0,0,0,0,56.84
基隆市,中山區,德和里,0,1,2100,26,2126,3599,0,0,0,0,0,0,59.07
基隆市,中山區,中和里,0,1,2792,35,2827,5795,0,0,0,0,0,0,48.78
基隆市,中山區,西康里,0,1,969,10,979,1814,0,0,0,0,0,0,53.97
基隆市,中山區,西定里,0,1,567,2,569,1027,0,0,0,0,0,0,55.40
基隆市,中山區,西華里,0,1,596,7,603,1036,0,0,0,0,0,0,58.20
基隆市,中山區,西榮里,0,1,509,11,520,910,0,0,0,0,0,0,57.14
基隆市,安樂區,新西里,0,1,869,8,877,1594,0,0,0,0,0,0,55.02
基隆市,安樂區,西川里,0,1,795,16,811,1456,0,0,0,0,0,0,55.70
基隆市,安樂區,定國里,0,1,600,12,612,1251,0,0,0,0,0,0,48.92
基隆市,安樂區,定邦里,0,1,713,16,729,1368,0,0,0,0,0,0,53.29
基隆市,安樂區,干城里,0,1,1291,17,1308,2429,0,0,0,0,0,0,53.85
基隆市,安樂區,永康里,0,1,913,16,929,2025,0,0,0,0,0,0,45.88
基隆市,安樂區,慈仁里,0,1,505,9,514,1083,0,0,0,0,0,0,47.46
基隆市,安樂區,安和里,0,1,464,5,469,898,0,0,0,0,0,0,52.23
基隆市,安樂區,樂一里,0,1,450,3,453,763,0,0,0,0,0,0,59.37
基隆市,安樂區,嘉仁里,0,1,1675,25,1700,3241,0,0,0,0,0,0,52.45
基隆市,安樂區,鶯歌里,0,1,1828,22,1850,3636,0,0,0,0,0,0,50.88
基隆市,安樂區,七賢里,0,1,1449,7,1456,2812,0,0,0,0,0,0,51.78
基隆市,安樂區,三民里,0,1,1926,23,1949,3805,0,0,0,0,0,0,51.22
基隆市,安樂區,四維里,0,1,1669,12,1681,3135,0,0,0,0,0,0,53.62
基隆市,安樂區,五福里,0,1,1797,22,1819,3311,0,0,0,0,0,0,54.94
基隆市,安樂區,長樂里,0,1,930,6,936,1794,0,0,0,0,0,0,52.17
基隆市,安樂區,六合里,0,1,1824,17,1841,3352,0,0,0,0,0,0,54.92
基隆市,安樂區,外寮里,0,1,2424,24,2448,5075,0,0,0,0,0,0,48.24
基隆市,安樂區,新崙里,0,1,1288,14,1302,2720,0,0,0,0,0,0,47.87
基隆市,安樂區,武崙里,0,1,1022,8,1030,2185,0,0,0,0,0,0,47.14
基隆市,安樂區,中崙里,0,1,596,5,601,1152,0,0,0,0,0,0,52.17
基隆市,安樂區,內寮里,0,1,1352,13,1365,3085,0,0,0,0,0,0,44.25
基隆市,暖暖區,八西里,0,1,644,12,656,1236,0,0,0,0,0,0,53.07
基隆市,暖暖區,八中里,0,1,390,5,395,686,0,0,0,0,0,0,57.58
基隆市,暖暖區,八堵里,0,1,414,3,417,809,0,0,0,0,0,0,51.55
基隆市,暖暖區,八南里,0,1,291,3,294,608,0,0,0,0,0,0,48.36
基隆市,暖暖區,過港里,0,1,1567,19,1586,3183,0,0,0,0,0,0,49.83
基隆市,暖暖區,暖暖里,0,1,978,9,987,2032,0,0,0,0,0,0,48.57
基隆市,暖暖區,暖同里,0,1,1050,9,1059,1947,0,0,0,0,0,0,54.39
基隆市,暖暖區,暖東里,0,1,200,4,204,389,0,0,0,0,0,0,52.44
基隆市,暖暖區,暖西里,0,1,1612,19,1631,3363,0,0,0,0,0,0,48.50
基隆市,暖暖區,碇內里,0,1,1038,10,1048,2097,0,0,0,0,0,0,49.98
基隆市,暖暖區,碇和里,0,1,1131,11,1142,2164,0,0,0,0,0,0,52.77
基隆市,暖暖區,碇祥里,0,1,1076,16,1092,2667,0,0,0,0,0,0,40.94
基隆市,暖暖區,碇安里,0,1,1679,21,1700,3277,0,0,0,0,0,0,51.88
基隆市,七堵區,長興里,0,1,1828,25,1853,3757,0,0,0,0,0,0,49.32
基隆市,七堵區,正光里,0,1,1094,13,1107,1917,0,0,0,0,0,0,57.75
基隆市,七堵區,正明里,0,1,1102,13,1115,2067,0,0,0,0,0,0,53.94
基隆市,七堵區,富民里,0,1,1965,14,1979,3570,0,0,0,0,0,0,55.43
基隆市,七堵區,永平里,0,1,1164,13,1177,2139,0,0,0,0,0,0,55.03
基隆市,七堵區,永安里,0,1,1090,12,1102,2041,0,0,0,0,0,0,53.99
基隆市,七堵區,八德里,0,1,821,3,824,1472,0,0,0,0,0,0,55.98
基隆市,七堵區,自強里,0,1,472,7,479,931,0,0,0,0,0,0,51.45
基隆市,七堵區,泰安里,0,1,1428,24,1452,2942,0,0,0,0,0,0,49.35
基隆市,七堵區,六堵里,0,1,614,8,622,1317,0,0,0,0,0,0,47.23
基隆市,七堵區,堵南里,0,1,1255,17,1272,2758,0,0,0,0,0,0,46.12
基隆市,七堵區,堵北里,0,1,1308,17,1325,2622,0,0,0,0,0,0,50.53
基隆市,七堵區,百福里,0,1,1791,24,1815,3833,0,0,0,0,0,0,47.35
基隆市,七堵區,實踐里,0,1,1515,21,1536,3139,0,0,0,0,0,0,48.93
基隆市,七堵區,瑪南里,0,1,214,1,215,436,0,0,0,0,0,0,49.31
基隆市,七堵區,瑪東里,0,1,151,2,153,330,0,0,0,0,0,0,46.36
基隆市,七堵區,瑪西里,0,1,193,6,199,378,0,0,0,0,0,0,52.65
基隆市,七堵區,友一里,0,1,416,3,419,895,0,0,0,0,0,0,46.82
基隆市,七堵區,友二里,0,1,241,1,242,448,0,0,0,0,0,0,54.02
新竹市,東區,育賢里,0,1,322,6,328,667,0,0,0,0,0,0,49.18
新竹市,東區,親仁里,0,1,919,17,936,1858,0,0,0,0,0,0,50.38
新竹市,東區,東門里,0,1,419,13,432,838,0,0,0,0,0,0,51.55
新竹市,東區,成功里,0,1,401,11,412,806,0,0,0,0,0,0,51.12
新竹市,東區,榮光里,0,1,252,10,262,514,0,0,0,0,0,0,50.97
新竹市,東區,中正里,0,1,280,4,284,592,0,0,0,0,0,0,47.97
新竹市,東區,錦華里,0,1,1032,17,1049,1876,0,0,0,0,0,0,55.92
新竹市,東區,文華里,0,1,1604,28,1632,3055,0,0,0,0,0,0,53.42
新竹市,東區,復中里,0,1,1673,35,1708,3379,0,0,0,0,0,0,50.55
新竹市,東區,復興里,0,1,1373,27,1400,2859,0,0,0,0,0,0,48.97
新竹市,東區,三民里,0,1,2086,40,2126,4056,0,0,0,0,0,0,52.42
新竹市,東區,東園里,0,1,1119,22,1141,2131,0,0,0,0,0,0,53.54
新竹市,東區,公園里,0,1,954,24,978,1942,0,0,0,0,0,0,50.36
新竹市,東區,建華里,0,1,1025,26,1051,2075,0,0,0,0,0,0,50.65
新竹市,東區,東山里,0,1,1445,31,1476,2872,0,0,0,0,0,0,51.39
新竹市,東區,綠水里,0,1,2059,40,2099,3956,0,0,0,0,0,0,53.06
新竹市,東區,光復里,0,1,874,19,893,1761,0,0,0,0,0,0,50.71
新竹市,東區,東勢里,0,1,508,13,521,1030,0,0,0,0,0,0,50.58
新竹市,東區,前溪里,0,1,1169,26,1195,2233,0,0,0,0,0,0,53.52
新竹市,東區,水源里,0,1,1345,82,1427,2899,0,0,0,0,0,0,49.22
新竹市,東區,千甲里,0,1,847,42,889,1497,0,0,0,0,0,0,59.39
新竹市,東區,豐功里,0,1,1445,37,1482,2690,0,0,0,0,0,0,55.09
新竹市,東區,偉功里,0,1,445,10,455,737,0,0,0,0,0,0,61.74
新竹市,東區,武功里,0,1,213,2,215,409,0,0,0,0,0,0,52.57
新竹市,東區,軍功里,0,1,1717,31,1748,2923,0,0,0,0,0,0,59.80
新竹市,東區,立功里,0,1,477,11,488,757,0,0,0,0,0,0,64.46
新竹市,東區,建功里,0,1,1836,39,1875,2877,0,0,0,0,0,0,65.17
新竹市,東區,光明里,0,1,1544,19,1563,2884,0,0,0,0,0,0,54.20
新竹市,東區,龍山里,0,1,1389,31,1420,2588,0,0,0,0,0,0,54.87
新竹市,東區,科園里,0,1,2447,40,2487,4461,0,0,0,0,0,0,55.75
新竹市,東區,埔頂里,0,1,1000,31,1031,2065,0,0,0,0,0,0,49.93
新竹市,東區,新莊里,0,1,1833,30,1863,3673,0,0,0,0,0,0,50.72
新竹市,東區,關東里,0,1,1824,57,1881,3585,0,0,0,0,0,0,52.47
新竹市,東區,金山里,0,1,1288,27,1315,2275,0,0,0,0,0,0,57.80
新竹市,東區,仙水里,0,1,1349,23,1372,2616,0,0,0,0,0,0,52.45
新竹市,東區,仙宮里,0,1,371,7,378,709,0,0,0,0,0,0,53.31
新竹市,東區,關帝里,0,1,296,8,304,632,0,0,0,0,0,0,48.10
新竹市,東區,南門里,0,1,370,9,379,684,0,0,0,0,0,0,55.41
新竹市,東區,南市里,0,1,481,21,502,914,0,0,0,0,0,0,54.92
新竹市,東區,福德里,0,1,651,16,667,1221,0,0,0,0,0,0,54.63
新竹市,東區,振興里,0,1,1812,37,1849,4089,0,0,0,0,0,0,45.22
新竹市,東區,新興里,0,1,1523,34,1557,2951,0,0,0,0,0,0,52.76
新竹市,東區,寺前里,0,1,410,12,422,829,0,0,0,0,0,0,50.90
新竹市,東區,竹蓮里,0,1,446,16,462,880,0,0,0,0,0,0,52.50
新竹市,東區,下竹里,0,1,645,16,661,1199,0,0,0,0,0,0,55.13
新竹市,東區,頂竹里,0,1,1468,29,1497,3038,0,0,0,0,0,0,49.28
新竹市,東區,南大里,0,1,753,21,774,1617,0,0,0,0,0,0,47.87
新竹市,東區,新光里,0,1,1579,52,1631,3075,0,0,0,0,0,0,53.04
新竹市,東區,光鎮里,0,1,1323,28,1351,2726,0,0,0,0,0,0,49.56
新竹市,東區,高峰里,0,1,1940,57,1997,3953,0,0,0,0,0,0,50.52
新竹市,東區,湖濱里,0,1,1208,27,1235,2312,0,0,0,0,0,0,53.42
新竹市,東區,柴橋里,0,1,1170,21,1191,2517,0,0,0,0,0,0,47.32
新竹市,東區,明湖里,0,1,865,11,876,2025,0,0,0,0,0,0,43.26
新竹市,北區,西門里,0,1,267,9,276,541,0,0,0,0,0,0,51.02
新竹市,北區,仁德里,0,1,385,10,395,778,0,0,0,0,0,0,50.77
新竹市,北區,中央里,0,1,295,7,302,567,0,0,0,0,0,0,53.26
新竹市,北區,石坊里,0,1,271,5,276,552,0,0,0,0,0,0,50.00
新竹市,北區,潛園里,0,1,447,13,460,835,0,0,0,0,0,0,55.09
新竹市,北區,崇禮里,0,1,612,24,636,1147,0,0,0,0,0,0,55.45
新竹市,北區,興南里,0,1,635,23,658,1287,0,0,0,0,0,0,51.13
新竹市,北區,育英里,0,1,1780,40,1820,3581,0,0,0,0,0,0,50.82
新竹市,北區,台溪里,0,1,477,5,482,1018,0,0,0,0,0,0,47.35
新竹市,北區,曲溪里,0,1,2425,64,2489,4571,0,0,0,0,0,0,54.45
新竹市,北區,西雅里,0,1,1241,45,1286,2393,0,0,0,0,0,0,53.74
新竹市,北區,客雅里,0,1,1644,51,1695,3077,0,0,0,0,0,0,55.09
新竹市,北區,南勢里,0,1,1623,54,1677,3084,0,0,0,0,0,0,54.38
新竹市,北區,大鵬里,0,1,1013,25,1038,1510,0,0,0,0,0,0,68.74
新竹市,北區,大同里,0,1,452,10,462,816,0,0,0,0,0,0,56.62
新竹市,北區,中山里,0,1,333,14,347,658,0,0,0,0,0,0,52.74
新竹市,北區,中興里,0,1,279,11,290,618,0,0,0,0,0,0,46.93
新竹市,北區,新民里,0,1,693,17,710,1293,0,0,0,0,0,0,54.91
新竹市,北區,長和里,0,1,600,12,612,1125,0,0,0,0,0,0,54.40
新竹市,北區,北門里,0,1,482,12,494,946,0,0,0,0,0,0,52.22
新竹市,北區,民富里,0,1,1825,54,1879,3818,0,0,0,0,0,0,49.21
新竹市,北區,磐石里,0,1,1697,49,1746,3346,0,0,0,0,0,0,52.18
新竹市,北區,新雅里,0,1,1769,46,1815,3504,0,0,0,0,0,0,51.80
新竹市,北區,文雅里,0,1,1563,40,1603,2948,0,0,0,0,0,0,54.38
新竹市,北區,水田里,0,1,1167,19,1186,2328,0,0,0,0,0,0,50.95
新竹市,北區,光田里,0,1,1052,27,1079,2022,0,0,0,0,0,0,53.36
新竹市,北區,光華里,0,1,1071,23,1094,2480,0,0,0,0,0,0,44.11
新竹市,北區,金華里,0,1,1479,24,1503,3102,0,0,0,0,0,0,48.45
新竹市,北區,湳雅里,0,1,1023,25,1048,2074,0,0,0,0,0,0,50.53
新竹市,北區,金雅里,0,1,601,20,621,1149,0,0,0,0,0,0,54.05
新竹市,北區,湳中里,0,1,839,13,852,1633,0,0,0,0,0,0,52.17
新竹市,北區,舊社里,0,1,1723,45,1768,3557,0,0,0,0,0,0,49.70
新竹市,北區,金竹里,0,1,1671,35,1706,3405,0,0,0,0,0,0,50.10
新竹市,北區,武陵里,0,1,741,14,755,1222,0,0,0,0,0,0,61.78
新竹市,北區,福林里,0,1,1349,37,1386,2553,0,0,0,0,0,0,54.29
新竹市,北區,境福里,0,1,1575,35,1610,3195,0,0,0,0,0,0,50.39
新竹市,北區,士林里,0,1,1699,33,1732,2934,0,0,0,0,0,0,59.03
新竹市,北區,古賢里,0,1,394,11,405,816,0,0,0,0,0,0,49.63
新竹市,北區,南寮里,0,1,1499,30,1529,3301,0,0,0,0,0,0,46.32
新竹市,北區,康樂里,0,1,724,31,755,1505,0,0,0,0,0,0,50.17
新竹市,北區,中寮里,0,1,542,17,559,1100,0,0,0,0,0,0,50.82
新竹市,北區,海濱里,0,1,611,20,631,1265,0,0,0,0,0,0,49.88
新竹市,北區,港北里,0,1,493,11,504,1058,0,0,0,0,0,0,47.64
新竹市,北區,舊港里,0,1,261,4,265,491,0,0,0,0,0,0,53.97
新竹市,香山區,頂埔里,0,1,1306,29,1335,2601,0,0,0,0,0,0,51.33
新竹市,香山區,頂福里,0,1,1018,32,1050,2048,0,0,0,0,0,0,51.27
新竹市,香山區,中埔里,0,1,1005,23,1028,1991,0,0,0,0,0,0,51.63
新竹市,香山區,牛埔里,0,1,869,16,885,1804,0,0,0,0,0,0,49.06
新竹市,香山區,埔前里,0,1,1060,28,1088,2126,0,0,0,0,0,0,51.18
新竹市,香山區,樹下里,0,1,832,19,851,1635,0,0,0,0,0,0,52.05
新竹市,香山區,浸水里,0,1,670,18,688,1361,0,0,0,0,0,0,50.55
新竹市,香山區,虎林里,0,1,875,19,894,1759,0,0,0,0,0,0,50.82
新竹市,香山區,虎山里,0,1,1782,55,1837,4031,0,0,0,0,0,0,45.57
新竹市,香山區,港南里,0,1,789,20,809,1600,0,0,0,0,0,0,50.56
新竹市,香山區,東香里,0,1,731,16,747,1508,0,0,0,0,0,0,49.54
新竹市,香山區,香村里,0,1,809,18,827,1654,0,0,0,0,0,0,50.00
新竹市,香山區,香山里,0,1,1172,29,1201,2482,0,0,0,0,0,0,48.39
新竹市,香山區,大庄里,0,1,880,19,899,1764,0,0,0,0,0,0,50.96
新竹市,香山區,美山里,0,1,435,9,444,933,0,0,0,0,0,0,47.59
新竹市,香山區,朝山里,0,1,752,61,813,1592,0,0,0,0,0,0,51.07
新竹市,香山區,海山里,0,1,848,31,879,1593,0,0,0,0,0,0,55.18
新竹市,香山區,鹽水里,0,1,506,18,524,1034,0,0,0,0,0,0,50.68
新竹市,香山區,內湖里,0,1,1253,36,1289,2836,0,0,0,0,0,0,45.45
新竹市,香山區,南港里,0,1,405,7,412,735,0,0,0,0,0,0,56.05
新竹市,香山區,中隘里,0,1,588,20,608,1143,0,0,0,0,0,0,53.19
新竹市,香山區,南隘里,0,1,358,7,365,594,0,0,0,0,0,0,61.45
新竹市,香山區,大湖里,0,1,353,3,356,667,0,0,0,0,0,0,53.37
新竹市,香山區,茄苳里,0,1,402,8,410,682,0,0,0,0,0,0,60.12
臺中市,中區,中山里,0,1,575,7,582,996,0,0,0,0,0,0,58.43
臺中市,中區,南京里,0,1,647,5,652,1031,0,0,0,0,0,0,63.24
臺中市,中區,繼光里,0,1,675,5,680,1162,0,0,0,0,0,0,58.52
臺中市,中區,自由里,0,1,745,5,750,1391,0,0,0,0,0,0,53.92
臺中市,中區,重慶里,0,1,566,6,572,908,0,0,0,0,0,0,63.00
臺中市,中區,錦上里,0,1,787,9,796,1269,0,0,0,0,0,0,62.73
臺中市,中區,錦花里,0,1,699,9,708,1142,0,0,0,0,0,0,62.00
臺中市,中區,大墩里,0,1,830,11,841,1413,0,0,0,0,0,0,59.52
臺中市,中區,中墩里,0,1,734,9,743,1208,0,0,0,0,0,0,61.51
臺中市,中區,柳岸里,0,1,691,11,702,1100,0,0,0,0,0,0,63.82
臺中市,中區,柳原里,0,1,658,5,663,1099,0,0,0,0,0,0,60.33
臺中市,中區,光音里,0,1,811,9,820,1307,0,0,0,0,0,0,62.74
臺中市,中區,博松里,0,1,834,6,840,1298,0,0,0,0,0,0,64.71
臺中市,中區,中政里,0,1,774,6,780,1239,0,0,0,0,0,0,62.95
臺中市,東區,新庄里,0,1,661,9,670,1051,0,0,0,0,0,0,63.75
臺中市,東區,立德里,0,1,392,10,402,629,0,0,0,0,0,0,63.91
臺中市,東區,朱文里,0,1,516,4,520,874,0,0,0,0,0,0,59.50
臺中市,東區,翰第里,0,1,623,7,630,957,0,0,0,0,0,0,65.83
臺中市,東區,振興里,0,1,746,5,751,1233,0,0,0,0,0,0,60.91
臺中市,東區,曙峰里,0,1,722,8,730,1099,0,0,0,0,0,0,66.42
臺中市,東區,頂峰里,0,1,874,11,885,1297,0,0,0,0,0,0,68.23
臺中市,東區,忠孝里,0,1,678,4,682,1039,0,0,0,0,0,0,65.64
臺中市,東區,東橋里,0,1,2326,31,2357,3688,0,0,0,0,0,0,63.91
臺中市,東區,東興里,0,1,1321,9,1330,1920,0,0,0,0,0,0,69.27
臺中市,東區,樂業里,0,1,559,8,567,843,0,0,0,0,0,0,67.26
臺中市,東區,泉源里,0,1,575,5,580,824,0,0,0,0,0,0,70.39
臺中市,東區,文化里,0,1,709,9,718,1162,0,0,0,0,0,0,61.79
臺中市,東區,干城里,0,1,487,3,490,781,0,0,0,0,0,0,62.74
臺中市,東區,祖聖里,0,1,687,8,695,999,0,0,0,0,0,0,69.57
臺中市,東區,旱溪里,0,1,984,16,1000,1371,0,0,0,0,0,0,72.94
臺中市,東區,樂成里,0,1,920,12,932,1395,0,0,0,0,0,0,66.81
臺中市,東區,東門里,0,1,2904,38,2942,4524,0,0,0,0,0,0,65.03
臺中市,東區,十甲里,0,1,2798,49,2847,4673,0,0,0,0,0,0,60.92
臺中市,東區,東南里,0,1,1968,25,1993,3171,0,0,0,0,0,0,62.85
臺中市,東區,東勢里,0,1,956,16,972,1609,0,0,0,0,0,0,60.41
臺中市,東區,合作里,0,1,1037,13,1050,1709,0,0,0,0,0,0,61.44
臺中市,東區,東明里,0,1,908,10,918,1449,0,0,0,0,0,0,63.35
臺中市,東區,成功里,0,1,489,13,502,834,0,0,0,0,0,0,60.19
臺中市,東區,尚武里,0,1,911,8,919,1398,0,0,0,0,0,0,65.74
臺中市,東區,富台里,0,1,1007,13,1020,1542,0,0,0,0,0,0,66.15
臺中市,東區,富仁里,0,1,746,12,758,1295,0,0,0,0,0,0,58.53
臺中市,東區,東信里,0,1,2798,24,2822,4401,0,0,0,0,0,0,64.12
臺中市,南區,南興里,0,1,446,1,447,714,0,0,0,0,0,0,62.61
臺中市,南區,正義里,0,1,387,1,388,714,0,0,0,0,0,0,54.34
臺中市,南區,民主里,0,1,553,7,560,872,0,0,0,0,0,0,64.22
臺中市,南區,復興里,0,1,1115,7,1122,1655,0,0,0,0,0,0,67.79
臺中市,南區,萬安里,0,1,639,13,652,1030,0,0,0,0,0,0,63.30
臺中市,南區,信義里,0,1,666,15,681,1051,0,0,0,0,0,0,64.80
臺中市,南區,城隍里,0,1,878,8,886,1404,0,0,0,0,0,0,63.11
臺中市,南區,頂南里,0,1,661,7,668,1036,0,0,0,0,0,0,64.48
臺中市,南區,國光里,0,1,1994,28,2022,3284,0,0,0,0,0,0,61.57
臺中市,南區,南門里,0,1,1869,27,1896,3193,0,0,0,0,0,0,59.38
臺中市,南區,德義里,0,1,1391,11,1402,2257,0,0,0,0,0,0,62.12
臺中市,南區,積善里,0,1,1641,20,1661,2677,0,0,0,0,0,0,62.05
臺中市,南區,江川里,0,1,1091,9,1100,1740,0,0,0,0,0,0,63.22
臺中市,南區,新榮里,0,1,1104,20,1124,1976,0,0,0,0,0,0,56.88
臺中市,南區,福興里,0,1,1609,17,1626,2553,0,0,0,0,0,0,63.69
臺中市,南區,福平里,0,1,3735,49,3784,6387,0,0,0,0,0,0,59.25
臺中市,南區,和平里,0,1,4214,38,4252,7574,0,0,0,0,0,0,56.14
臺中市,南區,永興里,0,1,3356,27,3383,5884,0,0,0,0,0,0,57.49
臺中市,南區,樹義里,0,1,3644,36,3680,6461,0,0,0,0,0,0,56.96
臺中市,南區,樹德里,0,1,1468,23,1491,2443,0,0,0,0,0,0,61.03
臺中市,南區,西川里,0,1,3323,45,3368,5262,0,0,0,0,0,0,64.01
臺中市,西區,福壽里,0,1,870,9,879,1403,0,0,0,0,0,0,62.65
臺中市,西區,光明里,0,1,533,8,541,931,0,0,0,0,0,0,58.11
臺中市,西區,利民里,0,1,1054,12,1066,2093,0,0,0,0,0,0,50.93
臺中市,西區,平和里,0,1,888,15,903,1532,0,0,0,0,0,0,58.94
臺中市,西區,公民里,0,1,2297,21,2318,3784,0,0,0,0,0,0,61.26
臺中市,西區,中民里,0,1,1115,12,1127,1751,0,0,0,0,0,0,64.36
臺中市,西區,藍興里,0,1,1469,18,1487,2294,0,0,0,0,0,0,64.82
臺中市,西區,公館里,0,1,2729,42,2771,4203,0,0,0,0,0,0,65.93
臺中市,西區,元龍里,0,1,526,6,532,794,0,0,0,0,0,0,67.00
臺中市,西區,和龍里,0,1,901,11,912,1531,0,0,0,0,0,0,59.57
臺中市,西區,三民里,0,1,730,8,738,1256,0,0,0,0,0,0,58.76
臺中市,西區,平民里,0,1,641,5,646,1049,0,0,0,0,0,0,61.58
臺中市,西區,東昇里,0,1,902,11,913,1529,0,0,0,0,0,0,59.71
臺中市,西區,廣民里,0,1,774,12,786,1272,0,0,0,0,0,0,61.79
臺中市,西區,民龍里,0,1,1103,12,1115,1885,0,0,0,0,0,0,59.15
臺中市,西區,福龍里,0,1,757,12,769,1260,0,0,0,0,0,0,61.03
臺中市,西區,靖龍里,0,1,1071,11,1082,1789,0,0,0,0,0,0,60.48
臺中市,西區,雲龍里,0,1,1126,14,1140,1941,0,0,0,0,0,0,58.73
臺中市,西區,永龍里,0,1,624,7,631,930,0,0,0,0,0,0,67.85
臺中市,西區,安龍里,0,1,1196,19,1215,2082,0,0,0,0,0,0,58.36
臺中市,西區,吉龍里,0,1,2900,27,2927,4776,0,0,0,0,0,0,61.29
臺中市,西區,昇平里,0,1,2052,27,2079,3533,0,0,0,0,0,0,58.85
臺中市,西區,忠明里,0,1,2259,21,2280,3958,0,0,0,0,0,0,57.60
臺中市,西區,忠誠里,0,1,2650,32,2682,4634,0,0,0,0,0,0,57.88
臺中市,西區,公正里,0,1,5235,58,5293,9118,0,0,0,0,0,0,58.05
臺中市,西區,公益里,0,1,1525,29,1554,2386,0,0,0,0,0,0,65.13
臺中市,西區,中興里,0,1,1804,24,1828,2929,0,0,0,0,0,0,62.41
臺中市,西區,土庫里,0,1,3866,38,3904,6530,0,0,0,0,0,0,59.79
臺中市,北區,高風里,0,1,564,6,570,868,0,0,0,0,0,0,65.67
臺中市,北區,高平里,0,1,669,6,675,1056,0,0,0,0,0,0,63.92
臺中市,北區,大安里,0,1,562,10,572,956,0,0,0,0,0,0,59.83
臺中市,北區,光興里,0,1,671,13,684,1132,0,0,0,0,0,0,60.42
臺中市,北區,光大里,0,1,1124,31,1155,1863,0,0,0,0,0,0,62.00
臺中市,北區,文莊里,0,1,1195,11,1206,1959,0,0,0,0,0,0,61.56
臺中市,北區,湖北里,0,1,617,3,620,1014,0,0,0,0,0,0,61.14
臺中市,北區,中湖里,0,1,1018,15,1033,1615,0,0,0,0,0,0,63.96
臺中市,北區,錦和里,0,1,644,2,646,1001,0,0,0,0,0,0,64.54
臺中市,北區,五常里,0,1,972,7,979,1638,0,0,0,0,0,0,59.77
臺中市,北區,仁和里,0,1,509,8,517,747,0,0,0,0,0,0,69.21
臺中市,北區,新興里,0,1,734,8,742,1209,0,0,0,0,0,0,61.37
臺中市,北區,武順里,0,1,493,5,498,867,0,0,0,0,0,0,57.44
臺中市,北區,新北里,0,1,1361,20,1381,2390,0,0,0,0,0,0,57.78
臺中市,北區,樂英里,0,1,1961,19,1980,3135,0,0,0,0,0,0,63.16
臺中市,北區,錦村里,0,1,1875,20,1895,2919,0,0,0,0,0,0,64.92
臺中市,北區,建成里,0,1,4005,58,4063,6725,0,0,0,0,0,0,60.42
臺中市,北區,錦洲里,0,1,1796,23,1819,2897,0,0,0,0,0,0,62.79
臺中市,北區,錦祥里,0,1,1549,20,1569,2863,0,0,0,0,0,0,54.80
臺中市,北區,金華里,0,1,843,11,854,1517,0,0,0,0,0,0,56.30
臺中市,北區,金龍里,0,1,2425,31,2456,4079,0,0,0,0,0,0,60.21
臺中市,北區,邱厝里,0,1,1138,12,1150,2129,0,0,0,0,0,0,54.02
臺中市,北區,建興里,0,1,2635,25,2660,4654,0,0,0,0,0,0,57.16
臺中市,北區,頂厝里,0,1,3247,37,3284,5422,0,0,0,0,0,0,60.57
臺中市,北區,賴厝里,0,1,2243,27,2270,3746,0,0,0,0,0,0,60.60
臺中市,北區,賴明里,0,1,2256,24,2280,4068,0,0,0,0,0,0,56.05
臺中市,北區,賴興里,0,1,2855,31,2886,5148,0,0,0,0,0,0,56.06
臺中市,北區,賴村里,0,1,2179,35,2214,3610,0,0,0,0,0,0,61.33
臺中市,北區,育德里,0,1,1659,10,1669,2860,0,0,0,0,0,0,58.36
臺中市,北區,淡溝里,0,1,2291,21,2312,3553,0,0,0,0,0,0,65.07
臺中市,北區,健行里,0,1,2984,39,3023,4940,0,0,0,0,0,0,61.19
臺中市,北區,明德里,0,1,3520,25,3545,6051,0,0,0,0,0,0,58.59
臺中市,北區,長青里,0,1,4062,38,4100,6972,0,0,0,0,0,0,58.81
臺中市,北區,中達里,0,1,1528,16,1544,2513,0,0,0,0,0,0,61.44
臺中市,西屯區,西安里,0,1,2983,31,3014,4849,0,0,0,0,0,0,62.16
臺中市,西屯區,西平里,0,1,2253,16,2269,3676,0,0,0,0,0,0,61.72
臺中市,西屯區,西墩里,0,1,2020,20,2040,3265,0,0,0,0,0,0,62.48
臺中市,西屯區,潮洋里,0,1,866,7,873,1325,0,0,0,0,0,0,65.89
臺中市,西屯區,龍潭里,0,1,686,5,691,947,0,0,0,0,0,0,72.97
臺中市,西屯區,惠來里,0,1,2103,20,2123,3237,0,0,0,0,0,0,65.59
臺中市,西屯區,上石里,0,1,3644,44,3688,6664,0,0,0,0,0,0,55.34
臺中市,西屯區,逢甲里,0,1,3568,34,3602,6085,0,0,0,0,0,0,59.19
臺中市,西屯區,鵬程里,0,1,1266,16,1282,1710,0,0,0,0,0,0,74.97
臺中市,西屯區,何厝里,0,1,2818,31,2849,4852,0,0,0,0,0,0,58.72
臺中市,西屯區,何南里,0,1,3699,32,3731,6450,0,0,0,0,0,0,57.84
臺中市,西屯區,何安里,0,1,2024,20,2044,3412,0,0,0,0,0,0,59.91
臺中市,西屯區,何仁里,0,1,2394,27,2421,4180,0,0,0,0,0,0,57.92
臺中市,西屯區,何德里,0,1,3040,26,3066,5166,0,0,0,0,0,0,59.35
臺中市,西屯區,何源里,0,1,2456,27,2483,4260,0,0,0,0,0,0,58.29
臺中市,西屯區,大河里,0,1,2013,31,2044,3216,0,0,0,0,0,0,63.56
臺中市,西屯區,大石里,0,1,703,2,705,1027,0,0,0,0,0,0,68.65
臺中市,西屯區,大福里,0,1,1704,27,1731,2683,0,0,0,0,0,0,64.52
臺中市,西屯區,大鵬里,0,1,2359,24,2383,3844,0,0,0,0,0,0,61.99
臺中市,西屯區,港尾里,0,1,2803,30,2833,4410,0,0,0,0,0,0,64.24
臺中市,西屯區,廣福里,0,1,1307,15,1322,1829,0,0,0,0,0,0,72.28
臺中市,西屯區,林厝里,0,1,1238,20,1258,2119,0,0,0,0,0,0,59.37
臺中市,西屯區,永安里,0,1,2295,24,2319,3860,0,0,0,0,0,0,60.08
臺中市,西屯區,福安里,0,1,8676,75,8751,15904,0,0,0,0,0,0,55.02
臺中市,西屯區,協和里,0,1,2312,21,2333,3754,0,0,0,0,0,0,62.15
臺中市,南屯區,南屯里,0,1,2599,25,2624,4075,0,0,0,0,0,0,64.39
臺中市,南屯區,豐樂里,0,1,2523,29,2552,4080,0,0,0,0,0,0,62.55
臺中市,南屯區,楓樹里,0,1,2226,36,2262,3385,0,0,0,0,0,0,66.82
臺中市,南屯區,中和里,0,1,2239,32,2271,3243,0,0,0,0,0,0,70.03
臺中市,南屯區,鎮平里,0,1,1097,13,1110,1494,0,0,0,0,0,0,74.30
臺中市,南屯區,永定里,0,1,1583,22,1605,2604,0,0,0,0,0,0,61.64
臺中市,南屯區,春社里,0,1,2855,36,2891,4653,0,0,0,0,0,0,62.13
臺中市,南屯區,春安里,0,1,1409,17,1426,1967,0,0,0,0,0,0,72.50
臺中市,南屯區,文山里,0,1,3724,38,3762,5938,0,0,0,0,0,0,63.35
臺中市,南屯區,新生里,0,1,732,9,741,1155,0,0,0,0,0,0,64.16
臺中市,南屯區,三厝里,0,1,4124,45,4169,7115,0,0,0,0,0,0,58.59
臺中市,南屯區,黎光里,0,1,1532,13,1545,2445,0,0,0,0,0,0,63.19
臺中市,南屯區,黎明里,0,1,871,20,891,1316,0,0,0,0,0,0,67.71
臺中市,南屯區,田心里,0,1,6131,82,6213,10067,0,0,0,0,0,0,61.72
臺中市,南屯區,大同里,0,1,4262,41,4303,7113,0,0,0,0,0,0,60.49
臺中市,南屯區,溝墘里,0,1,5480,36,5516,8966,0,0,0,0,0,0,61.52
臺中市,北屯區,北屯里,0,1,3170,36,3206,5155,0,0,0,0,0,0,62.19
臺中市,北屯區,北興里,0,1,1971,21,1992,3150,0,0,0,0,0,0,63.24
臺中市,北屯區,三光里,0,1,5170,40,5210,8895,0,0,0,0,0,0,58.57
臺中市,北屯區,平田里,0,1,4856,59,4915,8431,0,0,0,0,0,0,58.30
臺中市,北屯區,平和里,0,1,3410,43,3453,5978,0,0,0,0,0,0,57.76
臺中市,北屯區,平安里,0,1,2383,42,2425,3880,0,0,0,0,0,0,62.50
臺中市,北屯區,平順里,0,1,3556,44,3600,6052,0,0,0,0,0,0,59.48
臺中市,北屯區,平德里,0,1,2223,24,2247,3755,0,0,0,0,0,0,59.84
臺中市,北屯區,東光里,0,1,2098,30,2128,3351,0,0,0,0,0,0,63.50
臺中市,北屯區,舊社里,0,1,2580,28,2608,4301,0,0,0,0,0,0,60.64
臺中市,北屯區,水景里,0,1,3067,30,3097,4748,0,0,0,0,0,0,65.23
臺中市,北屯區,軍功里,0,1,3658,52,3710,5578,0,0,0,0,0,0,66.51
臺中市,北屯區,和平里,0,1,2581,21,2602,3972,0,0,0,0,0,0,65.51
臺中市,北屯區,東山里,0,1,1037,9,1046,1484,0,0,0,0,0,0,70.49
臺中市,北屯區,部子里,0,1,1152,30,1182,1792,0,0,0,0,0,0,65.96
臺中市,北屯區,民政里,0,1,641,3,644,894,0,0,0,0,0,0,72.04
臺中市,北屯區,民德里,0,1,512,3,515,708,0,0,0,0,0,0,72.74
臺中市,北屯區,大坑里,0,1,950,15,965,1338,0,0,0,0,0,0,72.12
臺中市,北屯區,松竹里,0,1,2389,30,2419,3890,0,0,0,0,0,0,62.19
臺中市,北屯區,松安里,0,1,4037,45,4082,7005,0,0,0,0,0,0,58.27
臺中市,北屯區,松茂里,0,1,5208,57,5265,8988,0,0,0,0,0,0,58.58
臺中市,北屯區,仁和里,0,1,3900,38,3938,5589,0,0,0,0,0,0,70.46
臺中市,北屯區,仁美里,0,1,3524,79,3603,4872,0,0,0,0,0,0,73.95
臺中市,北屯區,四民里,0,1,783,7,790,1005,0,0,0,0,0,0,78.61
臺中市,北屯區,同榮里,0,1,3033,38,3071,4538,0,0,0,0,0,0,67.67
臺中市,北屯區,后庄里,0,1,2710,34,2744,4207,0,0,0,0,0,0,65.22
臺中市,北屯區,陳平里,0,1,3543,45,3588,5991,0,0,0,0,0,0,59.89
臺中市,北屯區,大德里,0,1,2270,20,2290,3568,0,0,0,0,0,0,64.18
臺中市,北屯區,新平里,0,1,2549,43,2592,4155,0,0,0,0,0,0,62.38
臺中市,北屯區,仁愛里,0,1,562,7,569,807,0,0,0,0,0,0,70.51
臺中市,北屯區,水湳里,0,1,3385,41,3426,5267,0,0,0,0,0,0,65.05
嘉義市,東區,短竹里,0,1,2064,29,2093,3632,0,0,0,0,0,0,57.63
嘉義市,東區,東川里,0,1,1071,8,1079,1743,0,0,0,0,0,0,61.90
嘉義市,東區,鹿寮里,0,1,374,8,382,587,0,0,0,0,0,0,65.08
嘉義市,東區,盧厝里,0,1,1434,15,1449,2583,0,0,0,0,0,0,56.10
嘉義市,東區,東平里,0,1,533,6,539,885,0,0,0,0,0,0,60.90
嘉義市,東區,太平里,0,1,1827,20,1847,3099,0,0,0,0,0,0,59.60
嘉義市,東區,王田里,0,1,1226,21,1247,2166,0,0,0,0,0,0,57.57
嘉義市,東區,長竹里,0,1,1485,11,1496,2271,0,0,0,0,0,0,65.87
嘉義市,東區,後庄里,0,1,1649,21,1670,2976,0,0,0,0,0,0,56.12
嘉義市,東區,新店里,0,1,1676,16,1692,2928,0,0,0,0,0,0,57.79
嘉義市,東區,圳頭里,0,1,2390,36,2426,3689,0,0,0,0,0,0,65.76
嘉義市,東區,東噴里,0,1,727,10,737,1274,0,0,0,0,0,0,57.85
嘉義市,東區,希康里,0,1,246,0,246,335,0,0,0,0,0,0,73.43
嘉義市,東區,東山里,0,1,285,3,288,487,0,0,0,0,0,0,59.14
嘉義市,東區,東安里,0,1,314,5,319,533,0,0,0,0,0,0,59.85
嘉義市,東區,大街里,0,1,301,4,305,511,0,0,0,0,0,0,59.69
嘉義市,東區,祐民里,0,1,397,5,402,611,0,0,0,0,0,0,65.79
嘉義市,東區,東仁里,0,1,330,2,332,550,0,0,0,0,0,0,60.36
嘉義市,東區,內安里,0,1,299,2,301,480,0,0,0,0,0,0,62.71
嘉義市,東區,雲霄里,0,1,792,10,802,1304,0,0,0,0,0,0,61.50
嘉義市,東區,建國里,0,1,368,3,371,625,0,0,0,0,0,0,59.36
嘉義市,東區,府路里,0,1,581,2,583,998,0,0,0,0,0,0,58.42
嘉義市,東區,鎮南里,0,1,238,1,239,395,0,0,0,0,0,0,60.51
嘉義市,東區,神農里,0,1,657,6,663,1039,0,0,0,0,0,0,63.81
嘉義市,東區,崇文里,0,1,390,1,391,649,0,0,0,0,0,0,60.25
嘉義市,東區,龍山里,0,1,397,4,401,741,0,0,0,0,0,0,54.12
嘉義市,東區,安平里,0,1,449,4,453,777,0,0,0,0,0,0,58.30
嘉義市,東區,文昌里,0,1,414,2,416,682,0,0,0,0,0,0,61.00
嘉義市,東區,志航里,0,1,807,10,817,1250,0,0,0,0,0,0,65.36
嘉義市,東區,蘭井里,0,1,361,2,363,638,0,0,0,0,0,0,56.90
嘉義市,東區,光復里,0,1,721,6,727,1156,0,0,0,0,0,0,62.89
嘉義市,東區,初陽里,0,1,717,9,726,1242,0,0,0,0,0,0,58.45
嘉義市,東區,震安里,0,1,514,2,516,818,0,0,0,0,0,0,63.08
嘉義市,東區,新開里,0,1,771,5,776,1337,0,0,0,0,0,0,58.04
嘉義市,東區,宣信里,0,1,1038,8,1046,1939,0,0,0,0,0,0,53.95
嘉義市,東區,興南里,0,1,792,8,800,1351,0,0,0,0,0,0,59.22
嘉義市,東區,豐年里,0,1,858,9,867,1539,0,0,0,0,0,0,56.34
嘉義市,東區,芳草里,0,1,1690,21,1711,3070,0,0,0,0,0,0,55.73
嘉義市,東區,芳安里,0,1,1188,16,1204,2028,0,0,0,0,0,0,59.37
嘉義市,東區,頂寮里,0,1,1143,10,1153,1918,0,0,0,0,0,0,60.11
嘉義市,東區,安寮里,0,1,2332,20,2352,4443,0,0,0,0,0,0,52.94
嘉義市,東區,興村里,0,1,1507,18,1525,2615,0,0,0,0,0,0,58.32
嘉義市,東區,興安里,0,1,1205,13,1218,2004,0,0,0,0,0,0,60.78
嘉義市,東區,興仁里,0,1,1502,14,1516,2839,0,0,0,0,0,0,53.40
嘉義市,東區,北城里,0,1,522,9,531,874,0,0,0,0,0,0,60.76
嘉義市,東區,仁武里,0,1,495,9,504,673,0,0,0,0,0,0,74.89
嘉義市,東區,泰安里,0,1,732,10,742,1113,0,0,0,0,0,0,66.67
嘉義市,東區,檜村里,0,1,877,8,885,1480,0,0,0,0,0,0,59.80
嘉義市,東區,社口里,0,1,582,14,596,881,0,0,0,0,0,0,67.65
嘉義市,東區,仁和里,0,1,324,1,325,496,0,0,0,0,0,0,65.52
嘉義市,東區,中庄里,0,1,1470,10,1480,2426,0,0,0,0,0,0,61.01
嘉義市,東區,仁義里,0,1,1093,17,1110,2017,0,0,0,0,0,0,55.03
嘉義市,東區,後湖里,0,1,1702,27,1729,2757,0,0,0,0,0,0,62.71
嘉義市,東區,荖藤里,0,1,1127,11,1138,2095,0,0,0,0,0,0,54.32
嘉義市,東區,頂庄里,0,1,2300,31,2331,4101,0,0,0,0,0,0,56.84
嘉義市,西區,書院里,0,1,637,10,647,1039,0,0,0,0,0,0,62.27
嘉義市,西區,驛站里,0,1,397,5,402,651,0,0,0,0,0,0,61.75
嘉義市,西區,民安里,0,1,333,3,336,567,0,0,0,0,0,0,59.26
嘉義市,西區,菜園里,0,1,424,6,430,671,0,0,0,0,0,0,64.08
嘉義市,西區,集英里,0,1,340,1,341,595,0,0,0,0,0,0,57.31
嘉義市,西區,福松里,0,1,556,3,559,832,0,0,0,0,0,0,67.19
嘉義市,西區,義昌里,0,1,409,8,417,590,0,0,0,0,0,0,70.68
嘉義市,西區,自治里,0,1,691,9,700,1023,0,0,0,0,0,0,68.43
嘉義市,西區,大業里,0,1,544,8,552,906,0,0,0,0,0,0,60.93
嘉義市,西區,中庸里,0,1,517,4,521,864,0,0,0,0,0,0,60.30
嘉義市,西區,學圃里,0,1,361,4,365,550,0,0,0,0,0,0,66.36
嘉義市,西區,北杏里,0,1,477,2,479,809,0,0,0,0,0,0,59.21
嘉義市,西區,社內里,0,1,340,0,340,550,0,0,0,0,0,0,61.82
嘉義市,西區,民生里,0,1,348,6,354,556,0,0,0,0,0,0,63.67
嘉義市,西區,慶昇里,0,1,271,3,274,436,0,0,0,0,0,0,62.84
嘉義市,西區,通運里,0,1,253,5,258,440,0,0,0,0,0,0,58.64
嘉義市,西區,榮檜里,0,1,369,8,377,642,0,0,0,0,0,0,58.72
嘉義市,西區,功科里,0,1,486,2,488,722,0,0,0,0,0,0,67.59
嘉義市,西區,康莊里,0,1,409,1,410,655,0,0,0,0,0,0,62.60
嘉義市,西區,福全里,0,1,2769,25,2794,5096,0,0,0,0,0,0,54.83
嘉義市,西區,力行里,0,1,594,3,597,1012,0,0,0,0,0,0,58.99
嘉義市,西區,劉厝里,0,1,1588,13,1601,2990,0,0,0,0,0,0,53.55
嘉義市,西區,港坪里,0,1,900,12,912,1475,0,0,0,0,0,0,61.83
嘉義市,西區,頭港里,0,1,644,10,654,1089,0,0,0,0,0,0,60.06
嘉義市,西區,西平里,0,1,744,10,754,1215,0,0,0,0,0,0,62.06
嘉義市,西區,大溪里,0,1,960,14,974,1653,0,0,0,0,0,0,58.92
嘉義市,西區,磚窯里,0,1,1590,23,1613,2722,0,0,0,0,0,0,59.26
嘉義市,西區,新西里,0,1,1162,10,1172,2129,0,0,0,0,0,0,55.05
嘉義市,西區,華明里,0,1,465,5,470,761,0,0,0,0,0,0,61.76
嘉義市,西區,導民里,0,1,724,6,730,1307,0,0,0,0,0,0,55.85
嘉義市,西區,培元里,0,1,576,9,585,1052,0,0,0,0,0,0,55.61
嘉義市,西區,垂楊里,0,1,1083,10,1093,1916,0,0,0,0,0,0,57.05
嘉義市,西區,車店里,0,1,2002,13,2015,3628,0,0,0,0,0,0,55.54
嘉義市,西區,福民里,0,1,1897,14,1911,3198,0,0,0,0,0,0,59.76
嘉義市,西區,湖內里,0,1,3077,29,3106,5621,0,0,0,0,0,0,55.26
嘉義市,西區,美源里,0,1,1916,10,1926,3140,0,0,0,0,0,0,61.34
嘉義市,西區,光路里,0,1,2147,31,2178,3722,0,0,0,0,0,0,58.52
嘉義市,西區,育英里,0,1,1245,7,1252,2220,0,0,0,0,0,0,56.40
嘉義市,西區,致遠里,0,1,383,4,387,639,0,0,0,0,0,0,60.56
嘉義市,西區,翠岱里,0,1,298,10,308,478,0,0,0,0,0,0,64.44
嘉義市,西區,自強里,0,1,1061,12,1073,1765,0,0,0,0,0,0,60.79
嘉義市,西區,長安里,0,1,766,11,777,1264,0,0,0,0,0,0,61.47
嘉義市,西區,北榮里,0,1,1045,11,1056,1793,0,0,0,0,0,0,58.90
嘉義市,西區,重興里,0,1,1145,20,1165,2038,0,0,0,0,0,0,57.16
嘉義市,西區,慶昌里,0,1,300,4,304,550,0,0,0,0,0,0,55.27
嘉義市,西區,小湖里,0,1,488,7,495,678,0,0,0,0,0,0,73.01
嘉義市,西區,竹文里,0,1,923,14,937,1405,0,0,0,0,0,0,66.69
嘉義市,西區,香湖里,0,1,722,7,729,1289,0,0,0,0,0,0,56.56
嘉義市,西區,湖邊里,0,1,937,11,948,1724,0,0,0,0,0,0,54.99
嘉義市,西區,竹圍里,0,1,2113,27,2140,3485,0,0,0,0,0,0,61.41
嘉義市,西區,保安里,0,1,4411,57,4468,7465,0,0,0,0,0,0,59.85
嘉義市,西區,新厝里,0,1,1796,17,1813,3030,0,0,0,0,0,0,59.83
嘉義市,西區,北湖里,0,1,1306,15,1321,2153,0,0,0,0,0,0,61.36
嘉義市,西區,下埤里,0,1,556,8,564,1105,0,0,0,0,0,0,51.04
嘉義市,西區,竹村里,0,1,507,6,513,862,0,0,0,0,0,0,59.51
臺南市,東區,崇學里,0,1,3191,29,3220,5740,0,0,0,0,0,0,56.10
臺南市,東區,崇德里,0,1,2158,21,2179,3559,0,0,0,0,0,0,61.23
臺南市,東區,崇善里,0,1,1573,23,1596,2730,0,0,0,0,0,0,58.46
臺南市,東區,崇成里,0,1,3159,24,3183,5242,0,0,0,0,0,0,60.72
臺南市,東區,大智里,0,1,2530,39,2569,4110,0,0,0,0,0,0,62.51
臺南市,東區,東智里,0,1,1122,19,1141,1765,0,0,0,0,0,0,64.65
臺南市,東區,德高里,0,1,1427,24,1451,2504,0,0,0,0,0,0,57.95
臺南市,東區,和平里,0,1,1403,15,1418,2234,0,0,0,0,0,0,63.47
臺南市,東區,仁和里,0,1,1517,17,1534,2620,0,0,0,0,0,0,58.55
臺南市,東區,虎尾里,0,1,2966,32,2998,5035,0,0,0,0,0,0,59.54
臺南市,東區,自強里,0,1,2939,37,2976,5396,0,0,0,0,0,0,55.15
臺南市,東區,東聖里,0,1,1220,13,1233,2052,0,0,0,0,0,0,60.09
臺南市,東區,關聖里,0,1,1819,28,1847,2978,0,0,0,0,0,0,62.02
臺南市,東區,後甲里,0,1,1531,9,1540,2564,0,0,0,0,0,0,60.06
臺南市,東區,復國里,0,1,1435,11,1446,2101,0,0,0,0,0,0,68.82
臺南市,東區,中興里,0,1,1267,8,1275,1856,0,0,0,0,0,0,68.70
臺南市,東區,東光里,0,1,1871,14,1885,3291,0,0,0,0,0,0,57.28
臺南市,東區,東明里,0,1,1657,11,1668,2979,0,0,0,0,0,0,55.99
臺南市,東區,莊敬里,0,1,1609,14,1623,2687,0,0,0,0,0,0,60.40
臺南市,東區,小東里,0,1,2189,17,2206,3676,0,0,0,0,0,0,60.01
臺南市,東區,大學里,0,1,855,5,860,1454,0,0,0,0,0,0,59.15
臺南市,東區,育樂里,0,1,526,10,536,900,0,0,0,0,0,0,59.56
臺南市,東區,前鋒里,0,1,443,7,450,777,0,0,0,0,0,0,57.92
臺南市,東區,大廟里,0,1,649,9,658,1185,0,0,0,0,0,0,55.53
臺南市,東區,泉北里,0,1,651,5,656,1131,0,0,0,0,0,0,58.00
臺南市,東區,圍上里,0,1,470,11,481,777,0,0,0,0,0,0,61.90
臺南市,東區,圍下里,0,1,1036,14,1050,1806,0,0,0,0,0,0,58.14
臺南市,東區,中西里,0,1,1549,15,1564,2737,0,0,0,0,0,0,57.14
臺南市,東區,東安里,0,1,947,16,963,1699,0,0,0,0,0,0,56.68
臺南市,東區,新東里,0,1,1351,19,1370,2352,0,0,0,0,0,0,58.25
臺南市,東區,崇誨里,0,1,1600,14,1614,2702,0,0,0,0,0,0,59.73
臺南市,東區,衛國里,0,1,886,9,895,1542,0,0,0,0,0,0,58.04
臺南市,東區,裕農里,0,1,1527,20,1547,2632,0,0,0,0,0,0,58.78
臺南市,東區,富裕里,0,1,1153,6,1159,2011,0,0,0,0,0,0,57.63
臺南市,東區,富強里,0,1,2482,26,2508,3742,0,0,0,0,0,0,67.02
臺南市,東區,崇明里,0,1,1066,5,1071,1892,0,0,0,0,0,0,56.61
臺南市,東區,大德里,0,1,1026,7,1033,1771,0,0,0,0,0,0,58.33
臺南市,東區,忠孝里,0,1,2832,27,2859,4690,0,0,0,0,0,0,60.96
臺南市,東區,大福里,0,1,1187,21,1208,1937,0,0,0,0,0,0,62.36
臺南市,東區,路東里,0,1,753,9,762,1335,0,0,0,0,0,0,57.08
臺南市,東區,府宅里,0,1,750,9,759,1200,0,0,0,0,0,0,63.25
臺南市,東區,川東里,0,1,491,7,498,812,0,0,0,0,0,0,61.33
臺南市,東區,大興里,0,1,632,9,641,1093,0,0,0,0,0,0,58.65
臺南市,東區,泉南里,0,1,2329,34,2363,3954,0,0,0,0,0,0,59.76
臺南市,東區,龍山里,0,1,2831,29,2860,5014,0,0,0,0,0,0,57.04
臺南市,南區,大恩里,0,1,1747,17,1764,2949,0,0,0,0,0,0,59.82
臺南市,南區,大林里,0,1,1201,15,1216,2072,0,0,0,0,0,0,58.69
臺南市,南區,大忠里,0,1,2463,30,2493,4120,0,0,0,0,0,0,60.51
臺南市,南區,新生里,0,1,286,4,290,513,0,0,0,0,0,0,56.53
臺南市,南區,竹溪里,0,1,755,15,770,1345,0,0,0,0,0,0,57.25
臺南市,南區,明德里,0,1,690,11,701,1074,0,0,0,0,0,0,65.27
臺南市,南區,興中里,0,1,851,8,859,1255,0,0,0,0,0,0,68.45
臺南市,南區,荔宅里,0,1,939,14,953,1444,0,0,0,0,0,0,66.00
臺南市,南區,大成里,0,1,615,7,622,1012,0,0,0,0,0,0,61.46
臺南市,南區,田寮里,0,1,1976,16,1992,3336,0,0,0,0,0,0,59.71
臺南市,南區,新興里,0,1,1494,15,1509,2603,0,0,0,0,0,0,57.97
臺南市,南區,再興里,0,1,1253,11,1264,2051,0,0,0,0,0,0,61.63
臺南市,南區,廣州里,0,1,1628,9,1637,2549,0,0,0,0,0,0,64.22
臺南市,南區,新昌里,0,1,1366,12,1378,2373,0,0,0,0,0,0,58.07
臺南市,南區,文華里,0,1,1728,14,1742,3009,0,0,0,0,0,0,57.89
臺南市,南區,文南里,0,1,1924,15,1939,3207,0,0,0,0,0,0,60.46
臺南市,南區,金華里,0,1,2567,23,2590,4489,0,0,0,0,0,0,57.70
臺南市,南區,國宅里,0,1,1716,11,1727,2962,0,0,0,0,0,0,58.31
臺南市,南區,日新里,0,1,1102,10,1112,1948,0,0,0,0,0,0,57.08
臺南市,南區,光明里,0,1,2240,16,2256,3936,0,0,0,0,0,0,57.32
臺南市,南區,白雪里,0,1,1169,19,1188,1949,0,0,0,0,0,0,60.95
臺南市,南區,明亮里,0,1,1837,17,1854,3310,0,0,0,0,0,0,56.01
臺南市,南區,府南里,0,1,2020,24,2044,3722,0,0,0,0,0,0,54.92
臺南市,南區,明興里,0,1,1822,18,1840,3060,0,0,0,0,0,0,60.13
臺南市,南區,郡南里,0,1,1859,11,1870,3203,0,0,0,0,0,0,58.38
臺南市,南區,建南里,0,1,1977,21,1998,3312,0,0,0,0,0,0,60.33
臺南市,南區,南都里,0,1,2273,25,2298,4178,0,0,0,0,0,0,55.00
臺南市,南區,開南里,0,1,2011,25,2036,3680,0,0,0,0,0,0,55.33
臺南市,南區,彰南里,0,1,1098,12,1110,1907,0,0,0,0,0,0,58.21
臺南市,南區,清泉里,0,1,725,9,734,1018,0,0,0,0,0,0,72.10
臺南市,南區,龍崗里,0,1,656,7,663,963,0,0,0,0,0,0,68.85
臺南市,南區,喜北里,0,1,1226,13,1239,2105,0,0,0,0,0,0,58.86
臺南市,南區,喜南里,0,1,921,9,930,1467,0,0,0,0,0,0,63.39
臺南市,南區,喜東里,0,1,889,5,894,1411,0,0,0,0,0,0,63.36
臺南市,南區,省躬里,0,1,1585,10,1595,2446,0,0,0,0,0,0,65.21
臺南市,南區,覺醒里,0,1,418,3,421,596,0,0,0,0,0,0,70.64
臺南市,南區,海豐里,0,1,407,5,412,588,0,0,0,0,0,0,70.07
臺南市,南區,松山里,0,1,612,0,612,986,0,0,0,0,0,0,62.07
臺南市,南區,南山里,0,1,517,4,521,725,0,0,0,0,0,0,71.86
臺南市,南區,佛壇里,0,1,1074,18,1092,1635,0,0,0,0,0,0,66.79
臺南市,南區,同安里,0,1,1122,12,1134,1775,0,0,0,0,0,0,63.89
臺南市,南區,中和里,0,1,525,5,530,733,0,0,0,0,0,0,72.31
臺南市,南區,興農里,0,1,1150,9,1159,1752,0,0,0,0,0,0,66.15
臺南市,西區,西賢里,0,1,1678,13,1691,2813,0,0,0,0,0,0,60.11
臺南市,西區,西湖里,0,1,1425,14,1439,2267,0,0,0,0,0,0,63.48
臺南市,西區,光賢里,0,1,1482,22,1504,2333,0,0,0,0,0,0,64.47
臺南市,西區,文賢里,0,1,809,3,812,1295,0,0,0,0,0,0,62.70
臺南市,西區,協和里,0,1,1394,22,1416,2066,0,0,0,0,0,0,68.54
臺南市,西區,金安里,0,1,438,5,443,687,0,0,0,0,0,0,64.48
臺南市,西區,忠信里,0,1,487,2,489,784,0,0,0,0,0,0,62.37
臺南市,西區,工業里,0,1,550,6,556,809,0,0,0,0,0,0,68.73
臺南市,西區,普濟里,0,1,486,8,494,740,0,0,0,0,0,0,66.76
臺南市,西區,濟同里,0,1,442,3,445,655,0,0,0,0,0,0,67.94
臺南市,西區,水仙里,0,1,618,9,627,993,0,0,0,0,0,0,63.14
臺南市,西區,北勢里,0,1,545,9,554,870,0,0,0,0,0,0,63.68
臺南市,西區,藥王里,0,1,1351,13,1364,2232,0,0,0,0,0,0,61.11
臺南市,西區,協進里,0,1,675,12,687,1010,0,0,0,0,0,0,68.02
臺南市,西區,西羅里,0,1,601,1,602,879,0,0,0,0,0,0,68.49
臺南市,西區,安新里,0,1,334,4,338,543,0,0,0,0,0,0,62.25
臺南市,西區,中正里,0,1,541,9,550,905,0,0,0,0,0,0,60.77
臺南市,西區,正德里,0,1,385,2,387,608,0,0,0,0,0,0,63.65
臺南市,西區,安海里,0,1,580,3,583,942,0,0,0,0,0,0,61.89
臺南市,西區,大涼里,0,1,1271,17,1288,2150,0,0,0,0,0,0,59.91
臺南市,西區,民主里,0,1,495,5,500,850,0,0,0,0,0,0,58.82
臺南市,西區,運河里,0,1,351,3,354,562,0,0,0,0,0,0,62.99
臺南市,西區,北頭里,0,1,192,2,194,263,0,0,0,0,0,0,73.76
臺南市,西區,保民里,0,1,286,0,286,422,0,0,0,0,0,0,67.77
臺南市,西區,保良里,0,1,272,4,276,474,0,0,0,0,0,0,58.23
臺南市,西區,天池里,0,1,190,0,190,283,0,0,0,0,0,0,67.14
臺南市,西區,中頭里,0,1,596,3,599,943,0,0,0,0,0,0,63.52
臺南市,西區,民生里,0,1,769,6,775,1130,0,0,0,0,0,0,68.58
臺南市,西區,新安里,0,1,600,10,610,823,0,0,0,0,0,0,74.12
臺南市,西區,元安里,0,1,882,9,891,1460,0,0,0,0,0,0,61.03
臺南市,北區,城隍里,0,1,544,9,553,948,0,0,0,0,0,0,58.33
臺南市,北區,元和里,0,1,594,6,600,994,0,0,0,0,0,0,60.36
臺南市,北區,城朔里,0,1,515,4,519,978,0,0,0,0,0,0,53.07
臺南市,北區,共和里,0,1,724,10,734,1252,0,0,0,0,0,0,58.63
臺南市,北區,福德里,0,1,591,8,599,942,0,0,0,0,0,0,63.59
臺南市,北區,花園里,0,1,650,5,655,1055,0,0,0,0,0,0,62.09
臺南市,北區,西華里,0,1,715,12,727,1219,0,0,0,0,0,0,59.64
臺南市,北區,北門里,0,1,522,4,526,880,0,0,0,0,0,0,59.77
臺南市,北區,東豐里,0,1,755,13,768,1186,0,0,0,0,0,0,64.76
臺南市,北區,水源里,0,1,570,14,584,939,0,0,0,0,0,0,62.19
臺南市,北區,仁愛里,0,1,1025,13,1038,1732,0,0,0,0,0,0,59.93
臺南市,北區,振興里,0,1,1209,16,1225,1917,0,0,0,0,0,0,63.90
臺南市,北區,東興里,0,1,1216,17,1233,1978,0,0,0,0,0,0,62.34
臺南市,北區,重興里,0,1,1711,24,1735,2730,0,0,0,0,0,0,63.55
臺南市,北區,華興里,0,1,1176,11,1187,2065,0,0,0,0,0,0,57.48
臺南市,北區,力行里,0,1,1232,20,1252,2018,0,0,0,0,0,0,62.04
臺南市,北區,國興里,0,1,910,14,924,1480,0,0,0,0,0,0,62.43
臺南市,北區,新勝里,0,1,1043,11,1054,1852,0,0,0,0,0,0,56.91
臺南市,北區,開元里,0,1,1908,30,1938,3365,0,0,0,0,0,0,57.59
臺南市,北區,北垣里,0,1,522,7,529,842,0,0,0,0,0,0,62.83
臺南市,北區,富台里,0,1,372,4,376,551,0,0,0,0,0,0,68.24
臺南市,北區,勝安里,0,1,768,17,785,1280,0,0,0,0,0,0,61.33
臺南市,北區,大仁里,0,1,675,2,677,1078,0,0,0,0,0,0,62.80
臺南市,北區,大山里,0,1,881,13,894,1422,0,0,0,0,0,0,62.87
臺南市,北區,大道里,0,1,440,8,448,753,0,0,0,0,0,0,59.50
臺南市,北區,光武里,0,1,334,2,336,585,0,0,0,0,0,0,57.44
臺南市,北區,實踐里,0,1,887,15,902,1536,0,0,0,0,0,0,58.72
臺南市,北區,小康里,0,1,2792,36,2828,4791,0,0,0,0,0,0,59.03
臺南市,北區,正風里,0,1,897,8,905,1560,0,0,0,0,0,0,58.01
臺南市,北區,延平里,0,1,1063,16,1079,1896,0,0,0,0,0,0,56.91
臺南市,北區,興北里,0,1,972,13,985,1624,0,0,0,0,0,0,60.65
臺南市,北區,興南里,0,1,721,12,733,1304,0,0,0,0,0,0,56.21
臺南市,北區,國姓里,0,1,946,13,959,1550,0,0,0,0,0,0,61.87
臺南市,北區,六甲里,0,1,1248,13,1261,2239,0,0,0,0,0,0,56.32
臺南市,北區,正覺里,0,1,1985,14,1999,3305,0,0,0,0,0,0,60.48
臺南市,北區,成功里,0,1,2881,23,2904,5087,0,0,0,0,0,0,57.09
臺南市,北區,和順里,0,1,2111,23,2134,3935,0,0,0,0,0,0,54.23
臺南市,北區,安民里,0,1,795,9,804,1205,0,0,0,0,0,0,66.72
臺南市,北區,裕民里,0,1,893,10,903,1426,0,0,0,0,0,0,63.32
臺南市,北區,文元里,0,1,2689,30,2719,4413,0,0,0,0,0,0,61.61
臺南市,北區,大港里,0,1,3998,33,4031,6354,0,0,0,0,0,0,63.44
臺南市,北區,大豐里,0,1,3189,46,3235,5356,0,0,0,0,0,0,60.40
臺南市,中區,萬壽里,0,1,806,4,810,1182,0,0,0,0,0,0,68.53
臺南市,中區,文昌里,0,1,754,11,765,1132,0,0,0,0,0,0,67.58
臺南市,中區,萬鍾里,0,1,721,10,731,1203,0,0,0,0,0,0,60.76
臺南市,中區,銀同里,0,1,828,9,837,1441,0,0,0,0,0,0,58.08
臺南市,中區,清水里,0,1,439,5,444,702,0,0,0,0,0,0,63.25
臺南市,中區,環翠里,0,1,401,2,403,706,0,0,0,0,0,0,57.08
臺南市,中區,公正里,0,1,272,1,273,442,0,0,0,0,0,0,61.76
臺南市,中區,廣慈里,0,1,257,0,257,447,0,0,0,0,0,0,57.49
臺南市,中區,啟智里,0,1,744,7,751,1233,0,0,0,0,0,0,60.91
臺南市,中區,永慶里,0,1,285,1,286,423,0,0,0,0,0,0,67.61
臺南市,中區,保西里,0,1,472,7,479,783,0,0,0,0,0,0,61.17
臺南市,中區,中南里,0,1,373,7,380,577,0,0,0,0,0,0,65.86
臺南市,中區,福安里,0,1,547,4,551,913,0,0,0,0,0,0,60.35
臺南市,中區,昇平里,0,1,307,2,309,483,0,0,0,0,0,0,63.98
臺南市,中區,聖前里,0,1,288,4,292,477,0,0,0,0,0,0,61.22
臺南市,中區,小西里,0,1,670,4,674,1076,0,0,0,0,0,0,62.64
臺南市,中區,仙草里,0,1,1246,12,1258,2304,0,0,0,0,0,0,54.60
臺南市,中區,五妃里,0,1,658,5,663,1065,0,0,0,0,0,0,62.25
臺南市,中區,大南里,0,1,881,6,887,1462,0,0,0,0,0,0,60.67
臺南市,中區,天中里,0,1,304,6,310,520,0,0,0,0,0,0,59.62
臺南市,中區,中山里,0,1,365,6,371,579,0,0,0,0,0,0,64.08
臺南市,中區,白金里,0,1,468,6,474,688,0,0,0,0,0,0,68.90
臺南市,中區,武聖里,0,1,473,4,477,717,0,0,0,0,0,0,66.53
臺南市,中區,蓬壺里,0,1,642,7,649,1028,0,0,0,0,0,0,63.13
臺南市,中區,赤嵌里,0,1,308,5,313,517,0,0,0,0,0,0,60.54
臺南市,中區,觀音里,0,1,402,4,406,686,0,0,0,0,0,0,59.18
臺南市,中區,竹翠里,0,1,328,7,335,544,0,0,0,0,0,0,61.58
臺南市,中區,溫陵里,0,1,368,4,372,641,0,0,0,0,0,0,58.03
臺南市,中區,開仙里,0,1,459,5,464,746,0,0,0,0,0,0,62.20
臺南市,中區,進學里,0,1,420,6,426,671,0,0,0,0,0,0,63.49
臺南市,中區,川西里,0,1,474,8,482,773,0,0,0,0,0,0,62.35
臺南市,中區,開山里,0,1,879,10,889,1528,0,0,0,0,0,0,58.18
臺南市,中區,郡王里,0,1,1046,11,1057,1735,0,0,0,0,0,0,60.92
臺南市,中區,法華里,0,1,1812,12,1824,3176,0,0,0,0,0,0,57.43
臺南市,安南區,東和里,0,1,365,7,372,522,0,0,0,0,0,0,71.26
臺南市,安南區,塭南里,0,1,1851,26,1877,3142,0,0,0,0,0,0,59.74
臺南市,安南區,州南里,0,1,2556,39,2595,3972,0,0,0,0,0,0,65.33
臺南市,安南區,安順里,0,1,1384,23,1407,2083,0,0,0,0,0,0,67.55
臺南市,安南區,州北里,0,1,1753,24,1777,2693,0,0,0,0,0,0,65.99
臺南市,安南區,新順里,0,1,1436,24,1460,2400,0,0,0,0,0,0,60.83
臺南市,安南區,頂安里,0,1,1445,13,1458,2279,0,0,0,0,0,0,63.98
臺南市,安南區,安慶里,0,1,2280,31,2311,3620,0,0,0,0,0,0,63.84
臺南市,安南區,溪北里,0,1,1366,11,1377,2290,0,0,0,0,0,0,60.13
臺南市,安南區,安和里,0,1,1102,18,1120,1804,0,0,0,0,0,0,62.08
臺南市,安南區,安西里,0,1,1424,18,1442,2013,0,0,0,0,0,0,71.63
臺南市,安南區,溪頂里,0,1,1669,26,1695,2864,0,0,0,0,0,0,59.18
臺南市,安南區,安東里,0,1,1516,23,1539,2501,0,0,0,0,0,0,61.54
臺南市,安南區,鳳凰里,0,1,1654,18,1672,3005,0,0,0,0,0,0,55.64
臺南市,安南區,梅花里,0,1,1586,25,1611,2612,0,0,0,0,0,0,61.68
臺南市,安南區,理想里,0,1,3158,34,3192,5487,0,0,0,0,0,0,58.17
臺南市,安南區,原佃里,0,1,883,15,898,1240,0,0,0,0,0,0,72.42
臺南市,安南區,長安里,0,1,1701,26,1727,2746,0,0,0,0,0,0,62.89
臺南市,安南區,公親里,0,1,594,9,603,888,0,0,0,0,0,0,67.91
臺南市,安南區,布袋里,0,1,690,11,701,1084,0,0,0,0,0,0,64.67
臺南市,安南區,總頭里,0,1,1001,10,1011,1566,0,0,0,0,0,0,64.56
臺南市,安南區,南興里,0,1,774,13,787,1166,0,0,0,0,0,0,67.50
臺南市,安南區,學東里,0,1,1098,18,1116,1620,0,0,0,0,0,0,68.89
臺南市,安南區,公塭里,0,1,636,3,639,787,0,0,0,0,0,0,81.19
臺南市,安南區,佃東里,0,1,1250,19,1269,1959,0,0,0,0,0,0,64.78
臺南市,安南區,佃西里,0,1,938,14,952,1356,0,0,0,0,0,0,70.21
臺南市,安南區,淵西里,0,1,1355,23,1378,2250,0,0,0,0,0,0,61.24
臺南市,安南區,海西里,0,1,1217,18,1235,2162,0,0,0,0,0,0,57.12
臺南市,安南區,海東里,0,1,1456,19,1475,2562,0,0,0,0,0,0,57.57
臺南市,安南區,溪心里,0,1,1671,27,1698,2824,0,0,0,0,0,0,60.13
臺南市,安南區,淵東里,0,1,1321,15,1336,2319,0,0,0,0,0,0,57.61
臺南市,安南區,淵中里,0,1,1435,19,1454,2465,0,0,0,0,0,0,58.99
臺南市,安南區,溪墘里,0,1,1588,21,1609,2628,0,0,0,0,0,0,61.23
臺南市,安南區,海佃里,0,1,2071,32,2103,3413,0,0,0,0,0,0,61.62
臺南市,安南區,國安里,0,1,856,15,871,1419,0,0,0,0,0,0,61.38
臺南市,安南區,溪東里,0,1,1308,22,1330,2317,0,0,0,0,0,0,57.40
臺南市,安南區,安富里,0,1,2057,29,2086,3699,0,0,0,0,0,0,56.39
臺南市,安南區,幸福里,0,1,1928,24,1952,3149,0,0,0,0,0,0,61.99
臺南市,安南區,海南里,0,1,1093,7,1100,1863,0,0,0,0,0,0,59.04
臺南市,安南區,城東里,0,1,931,10,941,1312,0,0,0,0,0,0,71.72
臺南市,安南區,城南里,0,1,1576,18,1594,2182,0,0,0,0,0,0,73.05
臺南市,安南區,青草里,0,1,858,9,867,1115,0,0,0,0,0,0,77.76
臺南市,安南區,城西里,0,1,611,7,618,875,0,0,0,0,0,0,70.63
臺南市,安南區,城北里,0,1,818,8,826,1091,0,0,0,0,0,0,75.71
臺南市,安南區,城中里,0,1,557,7,564,676,0,0,0,0,0,0,83.43
臺南市,安南區,砂崙里,0,1,690,9,699,945,0,0,0,0,0,0,73.97
臺南市,安南區,顯宮里,0,1,726,6,732,990,0,0,0,0,0,0,73.94
臺南市,安南區,鹿耳里,0,1,446,6,452,605,0,0,0,0,0,0,74.71
臺南市,安南區,四草里,0,1,953,11,964,1368,0,0,0,0,0,0,70.47
臺南市,安南區,鹽田里,0,1,404,8,412,558,0,0,0,0,0,0,73.84
臺南市,安平區,校前里,0,1,545,5,550,825,0,0,0,0,0,0,66.67
臺南市,安平區,海興里,0,1,530,6,536,857,0,0,0,0,0,0,62.54
臺南市,安平區,菩薩里,0,1,256,1,257,360,0,0,0,0,0,0,71.39
臺南市,安平區,妙壽里,0,1,223,5,228,389,0,0,0,0,0,0,58.61
臺南市,安平區,西門里,0,1,1400,7,1407,2103,0,0,0,0,0,0,66.90
臺南市,安平區,文朱里,0,1,242,1,243,344,0,0,0,0,0,0,70.64
臺南市,安平區,金城里,0,1,892,8,900,1386,0,0,0,0,0,0,64.94
臺南市,安平區,石門里,0,1,2826,25,2851,4560,0,0,0,0,0,0,62.52
臺南市,安平區,安中里,0,1,306,2,308,464,0,0,0,0,0,0,66.38
臺南市,安平區,漁光里,0,1,356,6,362,486,0,0,0,0,0,0,74.49
臺南市,安平區,建平里,0,1,1052,12,1064,1908,0,0,0,0,0,0,55.77
臺南市,安平區,怡平里,0,1,657,4,661,1375,0,0,0,0,0,0,48.07
臺南市,安平區,華平里,0,1,1473,12,1485,2791,0,0,0,0,0,0,53.21
臺南市,安平區,平通里,0,1,1414,10,1424,2667,0,0,0,0,0,0,53.39
臺南市,安平區,文平里,0,1,1169,11,1180,2065,0,0,0,0,0,0,57.14
臺南市,安平區,國平里,0,1,961,3,964,1863,0,0,0,0,0,0,51.74
臺南市,安平區,育平里,0,1,1218,6,1224,2662,0,0,0,0,0,0,45.98
臺南市,安平區,億載里,0,1,502,5,507,885,0,0,0,0,0,0,57.29
金門縣,金城鎮,東門里,0,1,910,6,916,1553,0,0,0,0,0,0,58.98
金門縣,金城鎮,南門里,0,1,1128,22,1150,1869,0,0,0,0,0,0,61.53
金門縣,金城鎮,西門里,0,1,1714,29,1743,2901,0,0,0,0,0,0,60.08
金門縣,金城鎮,北門里,0,1,755,12,767,1341,0,0,0,0,0,0,57.20
金門縣,金城鎮,賢庵里,0,1,625,12,637,1062,0,0,0,0,0,0,59.98
金門縣,金城鎮,金水里,0,1,383,5,388,575,0,0,0,0,0,0,67.48
金門縣,金城鎮,古城里,0,1,695,16,711,1133,0,0,0,0,0,0,62.75
金門縣,金城鎮,珠沙里,0,1,304,7,311,565,0,0,0,0,0,0,55.04
金門縣,金寧鄉,古寧村,0,1,696,11,707,1069,0,0,0,0,0,0,66.14
金門縣,金寧鄉,安美村,0,1,771,12,783,1314,0,0,0,0,0,0,59.59
金門縣,金寧鄉,湖埔村,0,1,606,11,617,1029,0,0,0,0,0,0,59.96
金門縣,金寧鄉,榜林村,0,1,698,13,711,1293,0,0,0,0,0,0,54.99
金門縣,金寧鄉,盤山村,0,1,606,7,613,990,0,0,0,0,0,0,61.92
金門縣,金寧鄉,后盤村,0,1,239,6,245,442,0,0,0,0,0,0,55.43
金門縣,金湖鎮,新市里,0,1,1049,13,1062,1590,0,0,0,0,0,0,66.79
金門縣,金湖鎮,山外里,0,1,730,11,741,1164,0,0,0,0,0,0,63.66
金門縣,金湖鎮,溪湖里,0,1,301,4,305,514,0,0,0,0,0,0,59.34
金門縣,金湖鎮,蓮庵里,0,1,312,4,316,500,0,0,0,0,0,0,63.20
金門縣,金湖鎮,料羅里,0,1,327,3,330,527,0,0,0,0,0,0,62.62
金門縣,金湖鎮,新湖里,0,1,802,19,821,1298,0,0,0,0,0,0,63.25
金門縣,金湖鎮,正義里,0,1,553,11,564,799,0,0,0,0,0,0,70.59
金門縣,金湖鎮,瓊林里,0,1,653,16,669,1078,0,0,0,0,0,0,62.06
金門縣,金沙鎮,汶沙里,0,1,1034,11,1045,1701,0,0,0,0,0,0,61.43
金門縣,金沙鎮,何斗里,0,1,449,6,455,675,0,0,0,0,0,0,67.41
金門縣,金沙鎮,浦山里,0,1,432,7,439,756,0,0,0,0,0,0,58.07
金門縣,金沙鎮,西園里,0,1,274,7,281,509,0,0,0,0,0,0,55.21
金門縣,金沙鎮,官嶼里,0,1,321,3,324,629,0,0,0,0,0,0,51.51
金門縣,金沙鎮,三山里,0,1,373,6,379,641,0,0,0,0,0,0,59.13
金門縣,金沙鎮,大洋里,0,1,224,4,228,405,0,0,0,0,0,0,56.30
金門縣,金沙鎮,光前里,0,1,381,11,392,671,0,0,0,0,0,0,58.42
金門縣,烈嶼鄉,林湖村,0,1,609,10,619,1022,0,0,0,0,0,0,60.57
金門縣,烈嶼鄉,黃埔村,0,1,243,8,251,445,0,0,0,0,0,0,56.40
金門縣,烈嶼鄉,西口村,0,1,352,7,359,684,0,0,0,0,0,0,52.49
金門縣,烈嶼鄉,上林村,0,1,246,2,248,427,0,0,0,0,0,0,58.08
金門縣,烈嶼鄉,上歧村,0,1,491,9,500,869,0,0,0,0,0,0,57.54
金門縣,烏坵鄉,大坵村,0,1,38,0,38,276,0,0,0,0,0,0,13.77
連江縣,南竿鄉,介壽村,0,1,568,63,631,996,0,0,0,0,0,0,63.35
連江縣,南竿鄉,福沃村、復興村,0,1,477,35,512,790,0,0,0,0,0,0,64.81
連江縣,南竿鄉,仁愛村、馬祖村、津沙村、珠螺村、清水村、四維村,0,1,443,52,495,852,0,0,0,0,0,0,58.10
連江縣,北竿鄉,后沃村、橋仔村、塘岐村,0,1,277,76,353,666,0,0,0,0,0,0,53.00
連江縣,北竿鄉,白沙村、板里村、芹壁村,0,1,122,28,150,263,0,0,0,0,0,0,57.03
連江縣,莒光鄉,青帆村、田沃村、西坵村,0,1,140,19,159,426,0,0,0,0,0,0,37.32
連江縣,莒光鄉,大坪村、福正村,0,1,113,9,122,226,0,0,0,0,0,0,53.98
連江縣,東引鄉,中柳村、樂華村,0,1,303,30,333,515,0,0,0,0,0,0,64.66
臺北市,北投區,建民里,1,1,887,16,903,1062,0,0,0,0,0,0,85.03
臺北市,北投區,建民里,2,1,1030,17,1047,1279,0,0,0,0,0,0,81.86
臺北市,北投區,建民里,3,1,1115,22,1137,1379,0,0,0,0,0,0,82.45
臺北市,北投區,文林里,4,1,1237,23,1260,1484,0,0,0,0,0,0,84.91
臺北市,北投區,文林里,5,1,1462,22,1484,1786,0,0,0,0,0,0,83.09
臺北市,北投區,石牌里,6,1,1014,17,1031,1232,0,0,0,0,0,0,83.69
臺北市,北投區,石牌里,7,1,1230,20,1250,1483,0,0,0,0,0,0,84.29
臺北市,北投區,石牌里,8,1,1197,15,1212,1477,0,0,0,0,0,0,82.06
臺北市,北投區,福興里,9,1,1086,23,1109,1318,0,0,0,0,0,0,84.14
臺北市,北投區,福興里,10,1,1030,27,1057,1238,0,0,0,0,0,0,85.38
臺北市,北投區,福興里,11,1,902,12,914,1093,0,0,0,0,0,0,83.62
臺北市,北投區,福興里,12,1,1067,18,1085,1244,0,0,0,0,0,0,87.22
臺北市,北投區,榮光里,13,1,1094,23,1117,1349,0,0,0,0,0,0,82.80
臺北市,北投區,榮光里,14,1,1136,14,1150,1345,0,0,0,0,0,0,85.50
臺北市,北投區,榮光里,15,1,1183,12,1195,1416,0,0,0,0,0,0,84.39
臺北市,北投區,榮光里,16,1,969,18,987,1181,0,0,0,0,0,0,83.57
臺北市,北投區,榮華里,17,1,1035,20,1055,1260,0,0,0,0,0,0,83.73
臺北市,北投區,榮華里,18,1,1107,11,1118,1431,0,0,0,0,0,0,78.13
臺北市,北投區,榮華里,19,1,1040,20,1060,1287,0,0,0,0,0,0,82.36
臺北市,北投區,榮華里,20,1,1154,22,1176,1407,0,0,0,0,0,0,83.58
臺北市,北投區,裕民里,21,1,1245,25,1270,1546,0,0,0,0,0,0,82.15
臺北市,北投區,裕民里,22,1,963,20,983,1147,0,0,0,0,0,0,85.70
臺北市,北投區,裕民里,23,1,999,13,1012,1189,0,0,0,0,0,0,85.11
臺北市,北投區,裕民里,24,1,934,24,958,1172,0,0,0,0,0,0,81.74
臺北市,北投區,振華里,25,1,1171,12,1183,1435,0,0,0,0,0,0,82.44
臺北市,北投區,振華里,26,1,1121,23,1144,1357,0,0,0,0,0,0,84.30
臺北市,北投區,振華里,27,1,1293,21,1314,1516,0,0,0,0,0,0,86.68
臺北市,北投區,振華里,28,1,1381,23,1404,1714,0,0,0,0,0,0,81.91
臺北市,北投區,永和里,29,1,1100,27,1127,1351,0,0,0,0,0,0,83.42
臺北市,北投區,永和里,30,1,1206,16,1222,1500,0,0,0,0,0,0,81.47
臺北市,北投區,永和里,31,1,1178,20,1198,1515,0,0,0,0,0,0,79.08
臺北市,北投區,永和里,32,1,995,14,1009,1265,0,0,0,0,0,0,79.76
臺北市,北投區,永欣里,33,1,1190,19,1209,1509,0,0,0,0,0,0,80.12
臺北市,北投區,永欣里,34,1,1294,21,1315,1660,0,0,0,0,0,0,79.22
臺北市,北投區,永欣里,35,1,1260,20,1280,1574,0,0,0,0,0,0,81.32
臺北市,北投區,永明里,36,1,1210,21,1231,1478,0,0,0,0,0,0,83.29
臺北市,北投區,永明里,37,1,1530,28,1558,1852,0,0,0,0,0,0,84.13
臺北市,北投區,東華里,38,1,968,22,990,1149,0,0,0,0,0,0,86.16
臺北市,北投區,東華里,39,1,1108,15,1123,1272,0,0,0,0,0,0,88.29
臺北市,北投區,東華里,40,1,967,19,986,1226,0,0,0,0,0,0,80.42
臺北市,北投區,吉利里,41,1,1033,23,1056,1274,0,0,0,0,0,0,82.89
臺北市,北投區,吉利里,42,1,952,13,965,1182,0,0,0,0,0,0,81.64
臺北市,北投區,吉利里,43,1,810,17,827,997,0,0,0,0,0,0,82.95
臺北市,北投區,吉利里,44,1,968,20,988,1131,0,0,0,0,0,0,87.36
臺北市,北投區,吉慶里,45,1,1004,9,1013,1206,0,0,0,0,0,0,84.00
臺北市,北投區,吉慶里,46,1,1215,21,1236,1471,0,0,0,0,0,0,84.02
臺北市,北投區,吉慶里,47,1,959,14,973,1146,0,0,0,0,0,0,84.90
臺北市,北投區,尊賢里,48,1,912,17,929,1118,0,0,0,0,0,0,83.09
臺北市,北投區,尊賢里,49,1,1008,7,1015,1217,0,0,0,0,0,0,83.40
臺北市,北投區,尊賢里,50,1,1086,27,1113,1322,0,0,0,0,0,0,84.19
臺北市,北投區,立賢里,51,1,1069,24,1093,1298,0,0,0,0,0,0,84.21
臺北市,北投區,立賢里,52,1,1004,18,1022,1210,0,0,0,0,0,0,84.46
臺北市,北投區,立賢里,53,1,1117,18,1135,1370,0,0,0,0,0,0,82.85
臺北市,北投區,立農里,54,1,1244,19,1263,1481,0,0,0,0,0,0,85.28
臺北市,北投區,立農里,55,1,1388,17,1405,1640,0,0,0,0,0,0,85.67
臺北市,北投區,立農里,56,1,1214,20,1234,1457,0,0,0,0,0,0,84.69
臺北市,北投區,立農里,57,1,1281,26,1307,1528,0,0,0,0,0,0,85.54
臺北市,北投區,八仙里,58,1,898,21,919,1095,0,0,0,0,0,0,83.93
臺北市,北投區,八仙里,59,1,911,17,928,1116,0,0,0,0,0,0,83.15
臺北市,北投區,八仙里,60,1,959,24,983,1187,0,0,0,0,0,0,82.81
臺北市,北投區,洲美里,61,1,1083,25,1108,1271,0,0,0,0,0,0,87.18
臺北市,北投區,奇岩里,62,1,1145,24,1169,1392,0,0,0,0,0,0,83.98
臺北市,北投區,奇岩里,63,1,1084,24,1108,1312,0,0,0,0,0,0,84.45
臺北市,北投區,奇岩里,64,1,1099,14,1113,1306,0,0,0,0,0,0,85.22
臺北市,北投區,奇岩里,65,1,1112,25,1137,1363,0,0,0,0,0,0,83.42
臺北市,北投區,奇岩里,66,1,1195,13,1208,1510,0,0,0,0,0,0,80.00
臺北市,北投區,清江里,67,1,1137,21,1158,1329,0,0,0,0,0,0,87.13
臺北市,北投區,清江里,68,1,1327,41,1368,1616,0,0,0,0,0,0,84.65
臺北市,北投區,清江里,69,1,1293,18,1311,1543,0,0,0,0,0,0,84.96
臺北市,北投區,清江里,70,1,1171,37,1208,1499,0,0,0,0,0,0,80.59
臺北市,北投區,中央里,71,1,973,14,987,1173,0,0,0,0,0,0,84.14
臺北市,北投區,中央里,72,1,1280,9,1289,1555,0,0,0,0,0,0,82.89
臺北市,北投區,中央里,73,1,1303,21,1324,1578,0,0,0,0,0,0,83.90
臺北市,北投區,中央里,74,1,1114,35,1149,1364,0,0,0,0,0,0,84.24
臺北市,北投區,長安里,75,1,1169,20,1189,1408,0,0,0,0,0,0,84.45
臺北市,北投區,長安里,76,1,1156,28,1184,1424,0,0,0,0,0,0,83.15
臺北市,北投區,長安里,77,1,1129,19,1148,1434,0,0,0,0,0,0,80.06
臺北市,北投區,大同里,78,1,1161,24,1185,1363,0,0,0,0,0,0,86.94
臺北市,北投區,大同里,79,1,1287,18,1305,1539,0,0,0,0,0,0,84.80
臺北市,北投區,大同里,80,1,1079,17,1096,1352,0,0,0,0,0,0,81.07
臺北市,北投區,溫泉里,81,1,1017,19,1036,1216,0,0,0,0,0,0,85.20
臺北市,北投區,溫泉里,82,1,953,18,971,1191,0,0,0,0,0,0,81.53
臺北市,北投區,溫泉里,83,1,1010,18,1028,1241,0,0,0,0,0,0,82.84
臺北市,北投區,溫泉里,84,1,905,14,919,1134,0,0,0,0,0,0,81.04
臺北市,北投區,林泉里,85,1,987,16,1003,1272,0,0,0,0,0,0,78.85
臺北市,北投區,林泉里,86,1,1071,25,1096,1409,0,0,0,0,0,0,77.79
臺北市,北投區,中心里,87,1,1162,14,1176,1474,0,0,0,0,0,0,79.78
臺北市,北投區,中心里,88,1,1149,19,1168,1515,0,0,0,0,0,0,77.10
臺北市,北投區,中心里,89,1,969,13,982,1213,0,0,0,0,0,0,80.96
臺北市,北投區,中庸里,90,1,931,7,938,1104,0,0,0,0,0,0,84.96
臺北市,北投區,中庸里,91,1,791,19,810,939,0,0,0,0,0,0,86.26
臺北市,北投區,中庸里,92,1,1056,16,1072,1250,0,0,0,0,0,0,85.76
臺北市,北投區,開明里,93,1,1104,21,1125,1389,0,0,0,0,0,0,80.99
臺北市,北投區,開明里,94,1,1050,18,1068,1281,0,0,0,0,0,0,83.37
臺北市,北投區,開明里,95,1,994,23,1017,1306,0,0,0,0,0,0,77.87
臺北市,北投區,開明里,96,1,890,17,907,1099,0,0,0,0,0,0,82.53
臺北市,北投區,中和里,97,1,1051,14,1065,1283,0,0,0,0,0,0,83.01
臺北市,北投區,中和里,98,1,934,29,963,1148,0,0,0,0,0,0,83.89
臺北市,北投區,中和里,99,1,956,16,972,1194,0,0,0,0,0,0,81.41
臺北市,北投區,中和里,100,1,593,9,602,756,0,0,0,0,0,0,79.63
臺北市,北投區,智仁里,101,1,1258,19,1277,1539,0,0,0,0,0,0,82.98
臺北市,北投區,智仁里,102,1,1216,14,1230,1513,0,0,0,0,0,0,81.30
臺北市,北投區,智仁里,103,1,1336,23,1359,1673,0,0,0,0,0,0,81.23
臺北市,北投區,秀山里,104,1,1185,19,1204,1474,0,0,0,0,0,0,81.68
臺北市,北投區,秀山里,105,1,1128,34,1162,1463,0,0,0,0,0,0,79.43
臺北市,北投區,文化里,106,1,1340,13,1353,1632,0,0,0,0,0,0,82.90
臺北市,北投區,文化里,107,1,1271,23,1294,1531,0,0,0,0,0,0,84.52
臺北市,北投區,豐年里,108,1,831,7,838,984,0,0,0,0,0,0,85.16
臺北市,北投區,豐年里,109,1,908,18,926,1068,0,0,0,0,0,0,86.70
臺北市,北投區,豐年里,110,1,961,12,973,1172,0,0,0,0,0,0,83.02
臺北市,北投區,稻香里,111,1,814,14,828,1027,0,0,0,0,0,0,80.62
臺北市,北投區,稻香里,112,1,1046,18,1064,1260,0,0,0,0,0,0,84.44
臺北市,北投區,稻香里,113,1,989,17,1006,1297,0,0,0,0,0,0,77.56
臺北市,北投區,桃源里,114,1,1283,21,1304,1539,0,0,0,0,0,0,84.73
臺北市,北投區,桃源里,115,1,1026,18,1044,1271,0,0,0,0,0,0,82.14
臺北市,北投區,桃源里,116,1,950,11,961,1143,0,0,0,0,0,0,84.08
臺北市,北投區,一德里,117,1,1357,36,1393,1630,0,0,0,0,0,0,85.46
臺北市,北投區,一德里,118,1,1316,29,1345,1622,0,0,0,0,0,0,82.92
臺北市,北投區,一德里,119,1,1129,30,1159,1353,0,0,0,0,0,0,85.66
臺北市,北投區,關渡里,120,1,1196,28,1224,1445,0,0,0,0,0,0,84.71
臺北市,北投區,關渡里,121,1,1059,100,1159,1388,0,0,0,0,0,0,83.50
臺北市,北投區,關渡里,122,1,1188,36,1224,1462,0,0,0,0,0,0,83.72
臺北市,北投區,關渡里,123,1,1380,16,1396,1620,0,0,0,0,0,0,86.17
臺北市,北投區,關渡里,124,1,1204,31,1235,1448,0,0,0,0,0,0,85.29
臺北市,北投區,泉源里,125,1,281,6,287,365,0,0,0,0,0,0,78.63
臺北市,北投區,泉源里,126,1,1254,30,1284,1505,0,0,0,0,0,0,85.32
臺北市,北投區,湖山里,127,1,575,11,586,715,0,0,0,0,0,0,81.96
臺北市,北投區,湖山里,128,1,714,8,722,908,0,0,0,0,0,0,79.52
臺北市,北投區,湖山里,129,1,580,19,599,720,0,0,0,0,0,0,83.19
臺北市,士林區,永福里,130,1,1021,18,1039,1252,0,0,0,0,0,0,82.99
臺北市,士林區,永福里,131,1,1061,26,1087,1267,0,0,0,0,0,0,85.79
臺北市,士林區,永福里,132,1,922,20,942,1146,0,0,0,0,0,0,82.20
臺北市,士林區,公館里,133,1,1008,20,1028,1231,0,0,0,0,0,0,83.51
臺北市,士林區,公館里,134,1,906,21,927,1096,0,0,0,0,0,0,84.58
臺北市,士林區,新安里,135,1,910,17,927,1196,0,0,0,0,0,0,77.51
臺北市,士林區,新安里,136,1,617,13,630,789,0,0,0,0,0,0,79.85
臺北市,士林區,新安里,137,1,1190,10,1200,1427,0,0,0,0,0,0,84.09
臺北市,士林區,陽明里,138,1,896,6,902,1117,0,0,0,0,0,0,80.75
臺北市,士林區,陽明里,139,1,786,11,797,966,0,0,0,0,0,0,82.51
臺北市,士林區,陽明里,140,1,944,14,958,1172,0,0,0,0,0,0,81.74
臺北市,士林區,菁山里,141,1,975,17,992,1235,0,0,0,0,0,0,80.32
臺北市,士林區,菁山里,142,1,989,15,1004,1230,0,0,0,0,0,0,81.63
臺北市,士林區,菁山里,143,1,941,13,954,1175,0,0,0,0,0,0,81.19
臺北市,士林區,菁山里,144,1,994,18,1012,1240,0,0,0,0,0,0,81.61
臺北市,士林區,菁山里,145,1,1038,8,1046,1274,0,0,0,0,0,0,82.10
臺北市,士林區,平等里,146,1,1159,20,1179,1397,0,0,0,0,0,0,84.40
臺北市,士林區,平等里,147,1,918,13,931,1167,0,0,0,0,0,0,79.78
臺北市,士林區,平等里,148,1,1225,21,1246,1492,0,0,0,0,0,0,83.51
臺北市,士林區,平等里,149,1,1030,17,1047,1278,0,0,0,0,0,0,81.92
臺北市,士林區,溪山里,150,1,1034,16,1050,1309,0,0,0,0,0,0,80.21
臺北市,士林區,溪山里,151,1,1200,18,1218,1444,0,0,0,0,0,0,84.35
臺北市,士林區,溪山里,152,1,1134,22,1156,1418,0,0,0,0,0,0,81.52
臺北市,士林區,溪山里,153,1,1273,21,1294,1535,0,0,0,0,0,0,84.30
臺北市,士林區,翠山里,154,1,1173,36,1209,1409,0,0,0,0,0,0,85.81
臺北市,士林區,翠山里,155,1,1046,17,1063,1316,0,0,0,0,0,0,80.78
臺北市,士林區,翠山里,156,1,972,25,997,1201,0,0,0,0,0,0,83.01
臺北市,士林區,翠山里,157,1,942,18,960,1153,0,0,0,0,0,0,83.26
臺北市,士林區,翠山里,158,1,901,14,915,1126,0,0,0,0,0,0,81.26
臺北市,士林區,三玉里,159,1,1081,23,1104,1318,0,0,0,0,0,0,83.76
臺北市,士林區,三玉里,160,1,1199,12,1211,1406,0,0,0,0,0,0,86.13
臺北市,士林區,三玉里,161,1,1193,30,1223,1430,0,0,0,0,0,0,85.52
臺北市,士林區,天福里,162,1,844,26,870,1053,0,0,0,0,0,0,82.62
臺北市,士林區,天福里,163,1,883,7,890,1043,0,0,0,0,0,0,85.33
臺北市,士林區,天福里,164,1,943,14,957,1099,0,0,0,0,0,0,87.08
臺北市,士林區,天祿里,165,1,1019,20,1039,1272,0,0,0,0,0,0,81.68
臺北市,士林區,天祿里,166,1,1141,13,1154,1365,0,0,0,0,0,0,84.54
臺北市,士林區,天祿里,167,1,1231,32,1263,1468,0,0,0,0,0,0,86.04
臺北市,士林區,天祿里,168,1,1197,30,1227,1471,0,0,0,0,0,0,83.41
臺北市,士林區,天壽里,169,1,1095,16,1111,1349,0,0,0,0,0,0,82.36
臺北市,士林區,天壽里,170,1,1095,31,1126,1357,0,0,0,0,0,0,82.98
臺北市,士林區,天壽里,171,1,987,24,1011,1236,0,0,0,0,0,0,81.80
臺北市,士林區,天和里,172,1,1170,27,1197,1513,0,0,0,0,0,0,79.11
臺北市,士林區,天和里,173,1,1043,30,1073,1331,0,0,0,0,0,0,80.62
臺北市,士林區,天和里,174,1,1080,26,1106,1356,0,0,0,0,0,0,81.56
臺北市,士林區,天和里,175,1,1039,17,1056,1262,0,0,0,0,0,0,83.68
臺北市,士林區,天山里,176,1,1081,21,1102,1372,0,0,0,0,0,0,80.32
臺北市,士林區,天山里,177,1,938,21,959,1187,0,0,0,0,0,0,80.79
臺北市,士林區,天山里,178,1,1117,25,1142,1440,0,0,0,0,0,0,79.31
臺北市,士林區,天玉里,179,1,1129,30,1159,1428,0,0,0,0,0,0,81.16
臺北市,士林區,天玉里,180,1,1172,28,1200,1462,0,0,0,0,0,0,82.08
臺北市,士林區,天玉里,181,1,1234,18,1252,1476,0,0,0,0,0,0,84.82
臺北市,士林區,天母里,182,1,953,22,975,1154,0,0,0,0,0,0,84.49
臺北市,士林區,天母里,183,1,898,27,925,1099,0,0,0,0,0,0,84.17
臺北市,士林區,天母里,184,1,915,16,931,1090,0,0,0,0,0,0,85.41
臺北市,士林區,天母里,185,1,1040,28,1068,1281,0,0,0,0,0,0,83.37
臺北市,士林區,岩山里,186,1,883,21,904,1068,0,0,0,0,0,0,84.64
臺北市,士林區,岩山里,187,1,816,26,842,1015,0,0,0,0,0,0,82.96
臺北市,士林區,岩山里,188,1,742,12,754,888,0,0,0,0,0,0,84.91
臺北市,士林區,名山里,189,1,1283,30,1313,1556,0,0,0,0,0,0,84.38
臺北市,士林區,名山里,190,1,1077,27,1104,1323,0,0,0,0,0,0,83.45
臺北市,士林區,名山里,191,1,1159,19,1178,1391,0,0,0,0,0,0,84.69
臺北市,士林區,名山里,192,1,1171,13,1184,1381,0,0,0,0,0,0,85.73
臺北市,士林區,聖山里,193,1,1147,24,1171,1369,0,0,0,0,0,0,85.54
臺北市,士林區,聖山里,194,1,1140,31,1171,1345,0,0,0,0,0,0,87.06
臺北市,士林區,聖山里,195,1,1077,23,1100,1297,0,0,0,0,0,0,84.81
臺北市,士林區,聖山里,196,1,910,19,929,1125,0,0,0,0,0,0,82.58
臺北市,士林區,聖山里,197,1,945,21,966,1151,0,0,0,0,0,0,83.93
臺北市,士林區,芝山里,198,1,981,28,1009,1169,0,0,0,0,0,0,86.31
臺北市,士林區,芝山里,199,1,991,26,1017,1203,0,0,0,0,0,0,84.54
臺北市,士林區,芝山里,200,1,1078,23,1101,1290,0,0,0,0,0,0,85.35
臺北市,士林區,芝山里,201,1,1046,31,1077,1262,0,0,0,0,0,0,85.34
臺北市,士林區,東山里,202,1,1014,22,1036,1220,0,0,0,0,0,0,84.92
臺北市,士林區,東山里,203,1,1030,31,1061,1253,0,0,0,0,0,0,84.68
臺北市,士林區,東山里,204,1,1139,21,1160,1363,0,0,0,0,0,0,85.11
臺北市,士林區,東山里,205,1,1079,22,1101,1292,0,0,0,0,0,0,85.22
臺北市,士林區,德行里,206,1,1085,36,1121,1257,0,0,0,0,0,0,89.18
臺北市,士林區,德行里,207,1,1078,24,1102,1275,0,0,0,0,0,0,86.43
臺北市,士林區,德行里,208,1,1047,35,1082,1263,0,0,0,0,0,0,85.67
臺北市,士林區,德華里,209,1,1164,26,1190,1440,0,0,0,0,0,0,82.64
臺北市,士林區,德華里,210,1,1164,20,1184,1401,0,0,0,0,0,0,84.51
臺北市,士林區,德華里,211,1,1111,23,1134,1358,0,0,0,0,0,0,83.51
臺北市,士林區,德華里,212,1,1201,25,1226,1468,0,0,0,0,0,0,83.51
臺北市,士林區,忠誠里,213,1,1060,30,1090,1261,0,0,0,0,0,0,86.44
臺北市,士林區,忠誠里,214,1,1120,37,1157,1378,0,0,0,0,0,0,83.96
臺北市,士林區,忠誠里,215,1,1336,32,1368,1577,0,0,0,0,0,0,86.75
臺北市,士林區,蘭雅里,216,1,805,23,828,1119,0,0,0,0,0,0,73.99
臺北市,士林區,蘭雅里,217,1,960,15,975,1228,0,0,0,0,0,0,79.40
臺北市,士林區,蘭雅里,218,1,930,13,943,1141,0,0,0,0,0,0,82.65
臺北市,士林區,蘭興里,219,1,973,6,979,1171,0,0,0,0,0,0,83.60
臺北市,士林區,蘭興里,220,1,962,17,979,1202,0,0,0,0,0,0,81.45
臺北市,士林區,蘭興里,221,1,1061,20,1081,1319,0,0,0,0,0,0,81.96
臺北市,士林區,蘭興里,222,1,980,18,998,1247,0,0,0,0,0,0,80.03
臺北市,士林區,仁勇里,223,1,951,14,965,1184,0,0,0,0,0,0,81.50
臺北市,士林區,仁勇里,224,1,835,21,856,1051,0,0,0,0,0,0,81.45
臺北市,士林區,仁勇里,225,1,839,13,852,1021,0,0,0,0,0,0,83.45
臺北市,士林區,義信里,226,1,1266,16,1282,1498,0,0,0,0,0,0,85.58
臺北市,士林區,義信里,227,1,1023,13,1036,1302,0,0,0,0,0,0,79.57
臺北市,士林區,義信里,228,1,1211,18,1229,1545,0,0,0,0,0,0,79.55
臺北市,士林區,福林里,229,1,968,12,980,1187,0,0,0,0,0,0,82.56
臺北市,士林區,福林里,230,1,1036,12,1048,1288,0,0,0,0,0,0,81.37
臺北市,士林區,福林里,231,1,1140,15,1155,1388,0,0,0,0,0,0,83.21
臺北市,士林區,福德里,232,1,1154,19,1173,1391,0,0,0,0,0,0,84.33
臺北市,士林區,福德里,233,1,1299,20,1319,1515,0,0,0,0,0,0,87.06
臺北市,士林區,福德里,234,1,1179,14,1193,1496,0,0,0,0,0,0,79.75
臺北市,士林區,福志里,235,1,939,20,959,1224,0,0,0,0,0,0,78.35
臺北市,士林區,福志里,236,1,1201,23,1224,1449,0,0,0,0,0,0,84.47
臺北市,士林區,福志里,237,1,932,8,940,1182,0,0,0,0,0,0,79.53
臺北市,士林區,福志里,238,1,1072,17,1089,1328,0,0,0,0,0,0,82.00
臺北市,士林區,舊佳里,239,1,1029,17,1046,1251,0,0,0,0,0,0,83.61
臺北市,士林區,舊佳里,240,1,1065,20,1085,1295,0,0,0,0,0,0,83.78
臺北市,士林區,舊佳里,241,1,1045,17,1062,1294,0,0,0,0,0,0,82.07
臺北市,士林區,福佳里,242,1,1145,16,1161,1405,0,0,0,0,0,0,82.63
臺北市,士林區,福佳里,243,1,1211,16,1227,1476,0,0,0,0,0,0,83.13
臺北市,士林區,福佳里,244,1,1100,18,1118,1362,0,0,0,0,0,0,82.09
臺北市,士林區,後港里,245,1,977,18,995,1208,0,0,0,0,0,0,82.37
臺北市,士林區,後港里,246,1,1032,17,1049,1270,0,0,0,0,0,0,82.60
臺北市,士林區,後港里,247,1,1138,21,1159,1412,0,0,0,0,0,0,82.08
臺北市,士林區,後港里,248,1,1096,20,1116,1369,0,0,0,0,0,0,81.52
臺北市,士林區,後港里,249,1,1024,19,1043,1252,0,0,0,0,0,0,83.31
臺北市,士林區,福中里,250,1,960,12,972,1179,0,0,0,0,0,0,82.44
臺北市,士林區,福中里,251,1,888,14,902,1142,0,0,0,0,0,0,78.98
臺北市,士林區,福中里,252,1,896,13,909,1103,0,0,0,0,0,0,82.41
臺北市,士林區,福中里,253,1,940,6,946,1163,0,0,0,0,0,0,81.34
臺北市,士林區,前港里,254,1,991,15,1006,1177,0,0,0,0,0,0,85.47
臺北市,士林區,前港里,255,1,931,20,951,1154,0,0,0,0,0,0,82.41
臺北市,士林區,前港里,256,1,1014,13,1027,1226,0,0,0,0,0,0,83.77
臺北市,士林區,前港里,257,1,1054,14,1068,1367,0,0,0,0,0,0,78.13
臺北市,士林區,百齡里,258,1,933,19,952,1187,0,0,0,0,0,0,80.20
臺北市,士林區,百齡里,259,1,1091,9,1100,1338,0,0,0,0,0,0,82.21
臺北市,士林區,百齡里,260,1,1124,10,1134,1392,0,0,0,0,0,0,81.47
臺北市,士林區,承德里,261,1,885,16,901,1151,0,0,0,0,0,0,78.28
臺北市,士林區,承德里,262,1,908,8,916,1184,0,0,0,0,0,0,77.36
臺北市,士林區,承德里,263,1,951,13,964,1224,0,0,0,0,0,0,78.76
臺北市,士林區,福華里,264,1,1160,13,1173,1434,0,0,0,0,0,0,81.80
臺北市,士林區,福華里,265,1,1126,16,1142,1397,0,0,0,0,0,0,81.75
臺北市,士林區,福華里,266,1,1135,22,1157,1473,0,0,0,0,0,0,78.55
臺北市,士林區,福華里,267,1,1048,20,1068,1324,0,0,0,0,0,0,80.66
臺北市,士林區,明勝里,268,1,999,10,1009,1298,0,0,0,0,0,0,77.73
臺北市,士林區,明勝里,269,1,1082,16,1098,1363,0,0,0,0,0,0,80.56
臺北市,士林區,明勝里,270,1,946,13,959,1202,0,0,0,0,0,0,79.78
臺北市,士林區,明勝里,271,1,1084,9,1093,1406,0,0,0,0,0,0,77.74
臺北市,士林區,福順里,272,1,946,3,949,1237,0,0,0,0,0,0,76.72
臺北市,士林區,福順里,273,1,954,4,958,1172,0,0,0,0,0,0,81.74
臺北市,士林區,福順里,274,1,1023,14,1037,1263,0,0,0,0,0,0,82.11
臺北市,士林區,福順里,275,1,1055,15,1070,1366,0,0,0,0,0,0,78.33
臺北市,士林區,福順里,276,1,962,10,972,1232,0,0,0,0,0,0,78.90
臺北市,士林區,富光里,277,1,1007,12,1019,1334,0,0,0,0,0,0,76.39
臺北市,士林區,富光里,278,1,947,14,961,1200,0,0,0,0,0,0,80.08
臺北市,士林區,富光里,279,1,1019,19,1038,1288,0,0,0,0,0,0,80.59
臺北市,士林區,富光里,280,1,894,14,908,1158,0,0,0,0,0,0,78.41
臺北市,士林區,葫蘆里,281,1,850,21,871,1084,0,0,0,0,0,0,80.35
臺北市,士林區,葫東里,282,1,913,15,928,1127,0,0,0,0,0,0,82.34
臺北市,士林區,社子里,283,1,601,13,614,786,0,0,0,0,0,0,78.12
臺北市,士林區,社子里,284,1,717,13,730,921,0,0,0,0,0,0,79.26
臺北市,士林區,社新里,285,1,707,9,716,903,0,0,0,0,0,0,79.29
臺北市,士林區,社新里,286,1,642,12,654,939,0,0,0,0,0,0,69.65
臺北市,士林區,社新里,287,1,635,11,646,822,0,0,0,0,0,0,78.59
臺北市,士林區,社園里,288,1,1058,29,1087,1307,0,0,0,0,0,0,83.17
臺北市,士林區,永倫里,289,1,980,12,992,1166,0,0,0,0,0,0,85.08
臺北市,士林區,福安里,290,1,962,28,990,1176,0,0,0,0,0,0,84.18
臺北市,士林區,富洲里,291,1,1050,24,1074,1353,0,0,0,0,0,0,79.38
臺北市,士林區,富洲里,292,1,1012,16,1028,1352,0,0,0,0,0,0,76.04
臺北市,士林區,富洲里,293,1,725,19,744,953,0,0,0,0,0,0,78.07
臺北市,士林區,富洲里,294,1,1012,35,1047,1365,0,0,0,0,0,0,76.70
臺北市,內湖區,西湖里,295,1,974,26,1000,1187,0,0,0,0,0,0,84.25
臺北市,內湖區,西湖里,296,1,1080,21,1101,1291,0,0,0,0,0,0,85.28
臺北市,內湖區,西湖里,297,1,987,9,996,1176,0,0,0,0,0,0,84.69
臺北市,內湖區,西湖里,298,1,1009,16,1025,1228,0,0,0,0,0,0,83.47
臺北市,內湖區,西湖里,299,1,946,17,963,1167,0,0,0,0,0,0,82.52
臺北市,內湖區,西康里,300,1,875,31,906,1102,0,0,0,0,0,0,82.21
臺北市,內湖區,西康里,301,1,942,14,956,1135,0,0,0,0,0,0,84.23
臺北市,內湖區,西康里,302,1,1059,14,1073,1270,0,0,0,0,0,0,84.49
臺北市,內湖區,西康里,303,1,850,13,863,1040,0,0,0,0,0,0,82.98
臺北市,內湖區,西康里,304,1,965,27,992,1172,0,0,0,0,0,0,84.64
臺北市,內湖區,西安里,305,1,989,19,1008,1184,0,0,0,0,0,0,85.14
臺北市,內湖區,西安里,306,1,974,10,984,1193,0,0,0,0,0,0,82.48
臺北市,內湖區,西安里,307,1,846,15,861,1023,0,0,0,0,0,0,84.16
臺北市,內湖區,西安里,308,1,957,23,980,1187,0,0,0,0,0,0,82.56
臺北市,內湖區,港墘里,309,1,1103,16,1119,1306,0,0,0,0,0,0,85.68
臺北市,內湖區,港墘里,310,1,1134,27,1161,1393,0,0,0,0,0,0,83.35
臺北市,內湖區,港墘里,311,1,1021,15,1036,1242,0,0,0,0,0,0,83.41
臺北市,內湖區,港都里,312,1,1074,15,1089,1282,0,0,0,0,0,0,84.95
臺北市,內湖區,港都里,313,1,1058,13,1071,1298,0,0,0,0,0,0,82.51
臺北市,內湖區,港都里,314,1,1219,14,1233,1452,0,0,0,0,0,0,84.92
臺北市,內湖區,港都里,315,1,1168,27,1195,1416,0,0,0,0,0,0,84.39
臺北市,內湖區,港都里,316,1,1046,28,1074,1302,0,0,0,0,0,0,82.49
臺北市,內湖區,港都里,317,1,980,8,988,1181,0,0,0,0,0,0,83.66
臺北市,內湖區,港富里,318,1,1186,15,1201,1435,0,0,0,0,0,0,83.69
臺北市,內湖區,港富里,319,1,1174,20,1194,1433,0,0,0,0,0,0,83.32
臺北市,內湖區,港富里,320,1,1057,13,1070,1261,0,0,0,0,0,0,84.85
臺北市,內湖區,港富里,321,1,1134,15,1149,1367,0,0,0,0,0,0,84.05
臺北市,內湖區,港富里,322,1,1057,11,1068,1320,0,0,0,0,0,0,80.91
臺北市,內湖區,港華里,323,1,1166,30,1196,1406,0,0,0,0,0,0,85.06
臺北市,內湖區,港華里,324,1,1201,14,1215,1418,0,0,0,0,0,0,85.68
臺北市,內湖區,港華里,325,1,1178,16,1194,1430,0,0,0,0,0,0,83.50
臺北市,內湖區,港華里,326,1,1223,13,1236,1526,0,0,0,0,0,0,81.00
臺北市,內湖區,內湖里,327,1,1100,27,1127,1336,0,0,0,0,0,0,84.36
臺北市,內湖區,內湖里,328,1,963,12,975,1188,0,0,0,0,0,0,82.07
臺北市,內湖區,內湖里,329,1,1091,17,1108,1376,0,0,0,0,0,0,80.52
臺北市,內湖區,湖濱里,330,1,1157,11,1168,1466,0,0,0,0,0,0,79.67
臺北市,內湖區,湖濱里,331,1,1149,11,1160,1382,0,0,0,0,0,0,83.94
臺北市,內湖區,湖濱里,332,1,809,7,816,1047,0,0,0,0,0,0,77.94
臺北市,內湖區,湖濱里,333,1,1235,21,1256,1513,0,0,0,0,0,0,83.01
臺北市,內湖區,紫星里,334,1,916,17,933,1162,0,0,0,0,0,0,80.29
臺北市,內湖區,紫星里,335,1,1069,11,1080,1311,0,0,0,0,0,0,82.38
臺北市,內湖區,紫星里,336,1,981,21,1002,1161,0,0,0,0,0,0,86.30
臺北市,內湖區,紫星里,337,1,974,16,990,1152,0,0,0,0,0,0,85.94
臺北市,內湖區,紫星里,338,1,1046,15,1061,1288,0,0,0,0,0,0,82.38
臺北市,內湖區,大湖里,339,1,928,14,942,1214,0,0,0,0,0,0,77.59
臺北市,內湖區,大湖里,340,1,950,15,965,1183,0,0,0,0,0,0,81.57
臺北市,內湖區,大湖里,341,1,903,11,914,1137,0,0,0,0,0,0,80.39
臺北市,內湖區,大湖里,342,1,931,17,948,1167,0,0,0,0,0,0,81.23
臺北市,內湖區,大湖里,343,1,901,21,922,1136,0,0,0,0,0,0,81.16
臺北市,內湖區,大湖里,344,1,919,10,929,1132,0,0,0,0,0,0,82.07
臺北市,內湖區,大湖里,345,1,875,16,891,1106,0,0,0,0,0,0,80.56
臺北市,內湖區,金龍里,346,1,1139,18,1157,1382,0,0,0,0,0,0,83.72
臺北市,內湖區,金龍里,347,1,1200,18,1218,1497,0,0,0,0,0,0,81.36
臺北市,內湖區,金龍里,348,1,1158,20,1178,1386,0,0,0,0,0,0,84.99
臺北市,內湖區,金瑞里,349,1,980,22,1002,1186,0,0,0,0,0,0,84.49
臺北市,內湖區,金瑞里,350,1,892,9,901,1126,0,0,0,0,0,0,80.02
臺北市,內湖區,金瑞里,351,1,1010,18,1028,1217,0,0,0,0,0,0,84.47
臺北市,內湖區,金瑞里,352,1,962,19,981,1182,0,0,0,0,0,0,82.99
臺北市,內湖區,碧山里,353,1,311,7,318,389,0,0,0,0,0,0,81.75
臺北市,內湖區,碧山里,354,1,1387,12,1399,1712,0,0,0,0,0,0,81.72
臺北市,內湖區,碧山里,355,1,1258,10,1268,1547,0,0,0,0,0,0,81.97
臺北市,內湖區,碧山里,356,1,1145,16,1161,1414,0,0,0,0,0,0,82.11
臺北市,內湖區,紫雲里,357,1,970,26,996,1196,0,0,0,0,0,0,83.28
臺北市,內湖區,紫雲里,358,1,1025,20,1045,1271,0,0,0,0,0,0,82.22
臺北市,內湖區,紫雲里,359,1,1082,32,1114,1320,0,0,0,0,0,0,84.39
臺北市,內湖區,清白里,360,1,1077,16,1093,1299,0,0,0,0,0,0,84.14
臺北市,內湖區,清白里,361,1,999,20,1019,1275,0,0,0,0,0,0,79.92
臺北市,內湖區,清白里,362,1,1121,25,1146,1405,0,0,0,0,0,0,81.57
臺北市,內湖區,葫洲里,363,1,1132,24,1156,1414,0,0,0,0,0,0,81.75
臺北市,內湖區,葫洲里,364,1,1116,17,1133,1366,0,0,0,0,0,0,82.94
臺北市,內湖區,葫洲里,365,1,1052,11,1063,1279,0,0,0,0,0,0,83.11
臺北市,內湖區,葫洲里,366,1,1180,13,1193,1462,0,0,0,0,0,0,81.60
臺北市,內湖區,葫洲里,367,1,1045,20,1065,1299,0,0,0,0,0,0,81.99
臺北市,內湖區,葫洲里,368,1,1101,20,1121,1348,0,0,0,0,0,0,83.16
臺北市,內湖區,葫洲里,369,1,1135,20,1155,1373,0,0,0,0,0,0,84.12
臺北市,內湖區,葫洲里,370,1,1036,11,1047,1308,0,0,0,0,0,0,80.05
臺北市,內湖區,葫洲里,371,1,1135,19,1154,1440,0,0,0,0,0,0,80.14
臺北市,內湖區,葫洲里,372,1,1079,14,1093,1333,0,0,0,0,0,0,82.00
臺北市,內湖區,葫洲里,373,1,1120,18,1138,1346,0,0,0,0,0,0,84.55
臺北市,內湖區,葫洲里,374,1,561,15,576,711,0,0,0,0,0,0,81.01
臺北市,內湖區,紫陽里,375,1,1051,16,1067,1296,0,0,0,0,0,0,82.33
臺北市,內湖區,紫陽里,376,1,980,14,994,1201,0,0,0,0,0,0,82.76
臺北市,內湖區,紫陽里,377,1,1007,11,1018,1211,0,0,0,0,0,0,84.06
臺北市,內湖區,紫陽里,378,1,1040,13,1053,1248,0,0,0,0,0,0,84.38
臺北市,內湖區,瑞陽里,379,1,1025,23,1048,1223,0,0,0,0,0,0,85.69
臺北市,內湖區,瑞陽里,380,1,962,11,973,1133,0,0,0,0,0,0,85.88
臺北市,內湖區,瑞陽里,381,1,1013,16,1029,1224,0,0,0,0,0,0,84.07
臺北市,內湖區,瑞陽里,382,1,983,11,994,1170,0,0,0,0,0,0,84.96
臺北市,內湖區,瑞陽里,383,1,1069,23,1092,1293,0,0,0,0,0,0,84.45
臺北市,內湖區,瑞光里,384,1,1020,14,1034,1232,0,0,0,0,0,0,83.93
臺北市,內湖區,瑞光里,385,1,1030,21,1051,1231,0,0,0,0,0,0,85.38
臺北市,內湖區,瑞光里,386,1,898,14,912,1076,0,0,0,0,0,0,84.76
臺北市,內湖區,五分里,387,1,956,19,975,1162,0,0,0,0,0,0,83.91
臺北市,內湖區,五分里,388,1,1033,29,1062,1268,0,0,0,0,0,0,83.75
臺北市,內湖區,五分里,389,1,973,15,988,1191,0,0,0,0,0,0,82.96
臺北市,內湖區,五分里,390,1,923,15,938,1145,0,0,0,0,0,0,81.92
臺北市,內湖區,五分里,391,1,977,18,995,1188,0,0,0,0,0,0,83.75
臺北市,內湖區,東湖里,392,1,1026,16,1042,1242,0,0,0,0,0,0,83.90
臺北市,內湖區,東湖里,393,1,1056,18,1074,1266,0,0,0,0,0,0,84.83
臺北市,內湖區,東湖里,394,1,940,17,957,1151,0,0,0,0,0,0,83.15
臺北市,內湖區,東湖里,395,1,960,20,980,1181,0,0,0,0,0,0,82.98
臺北市,內湖區,東湖里,396,1,1060,14,1074,1310,0,0,0,0,0,0,81.98
臺北市,內湖區,東湖里,397,1,1077,20,1097,1272,0,0,0,0,0,0,86.24
臺北市,內湖區,東湖里,398,1,973,11,984,1204,0,0,0,0,0,0,81.73
臺北市,內湖區,東湖里,399,1,1023,17,1040,1286,0,0,0,0,0,0,80.87
臺北市,內湖區,樂康里,400,1,1059,19,1078,1289,0,0,0,0,0,0,83.63
臺北市,內湖區,樂康里,401,1,995,13,1008,1198,0,0,0,0,0,0,84.14
臺北市,內湖區,樂康里,402,1,1129,16,1145,1381,0,0,0,0,0,0,82.91
臺北市,內湖區,樂康里,403,1,1056,25,1081,1292,0,0,0,0,0,0,83.67
臺北市,內湖區,內溝里,404,1,495,15,510,626,0,0,0,0,0,0,81.47
臺北市,內湖區,內溝里,405,1,1055,9,1064,1310,0,0,0,0,0,0,81.22
臺北市,內湖區,內溝里,406,1,1105,24,1129,1380,0,0,0,0,0,0,81.81
臺北市,內湖區,內溝里,407,1,1022,27,1049,1261,0,0,0,0,0,0,83.19
臺北市,內湖區,內溝里,408,1,1193,23,1216,1455,0,0,0,0,0,0,83.57
臺北市,內湖區,週美里,409,1,1066,18,1084,1265,0,0,0,0,0,0,85.69
臺北市,內湖區,週美里,410,1,910,17,927,1126,0,0,0,0,0,0,82.33
臺北市,內湖區,週美里,411,1,987,20,1007,1171,0,0,0,0,0,0,85.99
臺北市,內湖區,行善里,412,1,992,22,1014,1193,0,0,0,0,0,0,85.00
臺北市,內湖區,行善里,413,1,897,16,913,1072,0,0,0,0,0,0,85.17
臺北市,內湖區,行善里,414,1,1006,28,1034,1307,0,0,0,0,0,0,79.11
臺北市,內湖區,石潭里,415,1,791,23,814,980,0,0,0,0,0,0,83.06
臺北市,內湖區,石潭里,416,1,848,19,867,1093,0,0,0,0,0,0,79.32
臺北市,內湖區,湖興里,417,1,1097,10,1107,1355,0,0,0,0,0,0,81.70
臺北市,內湖區,湖興里,418,1,912,16,928,1133,0,0,0,0,0,0,81.91
臺北市,內湖區,湖興里,419,1,963,26,989,1173,0,0,0,0,0,0,84.31
臺北市,內湖區,湖興里,420,1,1060,12,1072,1241,0,0,0,0,0,0,86.38
臺北市,內湖區,湖元里,421,1,982,21,1003,1214,0,0,0,0,0,0,82.62
臺北市,內湖區,湖元里,422,1,923,12,935,1125,0,0,0,0,0,0,83.11
臺北市,內湖區,湖元里,423,1,831,18,849,1025,0,0,0,0,0,0,82.83
臺北市,南港區,百福里,424,1,1017,26,1043,1224,0,0,0,0,0,0,85.21
臺北市,南港區,百福里,425,1,978,24,1002,1234,0,0,0,0,0,0,81.20
臺北市,南港區,百福里,426,1,1027,15,1042,1223,0,0,0,0,0,0,85.20
臺北市,南港區,鴻福里,427,1,1136,20,1156,1375,0,0,0,0,0,0,84.07
臺北市,南港區,鴻福里,428,1,1100,29,1129,1356,0,0,0,0,0,0,83.26
臺北市,南港區,鴻福里,429,1,1049,22,1071,1264,0,0,0,0,0,0,84.73
臺北市,南港區,成福里,430,1,1034,13,1047,1265,0,0,0,0,0,0,82.77
臺北市,南港區,成福里,431,1,922,12,934,1104,0,0,0,0,0,0,84.60
臺北市,南港區,成福里,432,1,1022,18,1040,1237,0,0,0,0,0,0,84.07
臺北市,南港區,成福里,433,1,984,16,1000,1211,0,0,0,0,0,0,82.58
臺北市,南港區,成福里,434,1,1128,22,1150,1455,0,0,0,0,0,0,79.04
臺北市,南港區,萬福里,435,1,891,10,901,1065,0,0,0,0,0,0,84.60
臺北市,南港區,萬福里,436,1,949,12,961,1130,0,0,0,0,0,0,85.04
臺北市,南港區,萬福里,437,1,952,23,975,1175,0,0,0,0,0,0,82.98
臺北市,南港區,聯成里,438,1,1172,19,1191,1395,0,0,0,0,0,0,85.38
臺北市,南港區,聯成里,439,1,1104,23,1127,1331,0,0,0,0,0,0,84.67
臺北市,南港區,聯成里,440,1,1129,21,1150,1352,0,0,0,0,0,0,85.06
臺北市,南港區,新光里,441,1,1025,20,1045,1243,0,0,0,0,0,0,84.07
臺北市,南港區,新光里,442,1,1035,15,1050,1253,0,0,0,0,0,0,83.80
臺北市,南港區,新光里,443,1,699,11,710,896,0,0,0,0,0,0,79.24
臺北市,南港區,合成里,444,1,1139,28,1167,1378,0,0,0,0,0,0,84.69
臺北市,南港區,合成里,445,1,1085,19,1104,1315,0,0,0,0,0,0,83.95
臺北市,南港區,合成里,446,1,912,18,930,1083,0,0,0,0,0,0,85.87
臺北市,南港區,合成里,447,1,859,18,877,1042,0,0,0,0,0,0,84.17
臺北市,南港區,玉成里,448,1,949,17,966,1128,0,0,0,0,0,0,85.64
臺北市,南港區,玉成里,449,1,1105,14,1119,1371,0,0,0,0,0,0,81.62
臺北市,南港區,玉成里,450,1,1004,17,1021,1196,0,0,0,0,0,0,85.37
臺北市,南港區,西新里,451,1,934,17,951,1158,0,0,0,0,0,0,82.12
臺北市,南港區,西新里,452,1,972,16,988,1202,0,0,0,0,0,0,82.20
臺北市,南港區,西新里,453,1,953,25,978,1134,0,0,0,0,0,0,86.24
臺北市,南港區,東新里,454,1,889,22,911,1081,0,0,0,0,0,0,84.27
臺北市,南港區,東新里,455,1,875,18,893,1057,0,0,0,0,0,0,84.48
臺北市,南港區,東新里,456,1,1228,18,1246,1482,0,0,0,0,0,0,84.08
臺北市,南港區,東新里,457,1,1218,24,1242,1489,0,0,0,0,0,0,83.41
臺北市,南港區,東明里,458,1,879,14,893,1097,0,0,0,0,0,0,81.40
臺北市,南港區,東明里,459,1,1085,21,1106,1355,0,0,0,0,0,0,81.62
臺北市,南港區,東明里,460,1,790,18,808,1019,0,0,0,0,0,0,79.29
臺北市,南港區,南港里,461,1,1096,23,1119,1387,0,0,0,0,0,0,80.68
臺北市,南港區,南港里,462,1,1192,31,1223,1444,0,0,0,0,0,0,84.70
臺北市,南港區,南港里,463,1,1248,24,1272,1546,0,0,0,0,0,0,82.28
臺北市,南港區,三重里,464,1,1168,26,1194,1395,0,0,0,0,0,0,85.59
臺北市,南港區,三重里,465,1,1075,31,1106,1310,0,0,0,0,0,0,84.43
臺北市,南港區,中南里,466,1,954,25,979,1133,0,0,0,0,0,0,86.41
臺北市,南港區,中南里,467,1,897,17,914,1063,0,0,0,0,0,0,85.98
臺北市,南港區,中南里,468,1,864,19,883,1040,0,0,0,0,0,0,84.90
臺北市,南港區,新富里,469,1,806,16,822,998,0,0,0,0,0,0,82.36
臺北市,南港區,新富里,470,1,940,18,958,1179,0,0,0,0,0,0,81.26
臺北市,南港區,新富里,471,1,967,23,990,1164,0,0,0,0,0,0,85.05
臺北市,南港區,中研里,472,1,1002,17,1019,1228,0,0,0,0,0,0,82.98
臺北市,南港區,中研里,473,1,895,19,914,1211,0,0,0,0,0,0,75.47
臺北市,南港區,中研里,474,1,949,24,973,1123,0,0,0,0,0,0,86.64
臺北市,南港區,中研里,475,1,947,22,969,1138,0,0,0,0,0,0,85.15
臺北市,南港區,中研里,476,1,949,12,961,1126,0,0,0,0,0,0,85.35
臺北市,南港區,中研里,477,1,936,19,955,1158,0,0,0,0,0,0,82.47
臺北市,南港區,舊莊里,478,1,1086,24,1110,1323,0,0,0,0,0,0,83.90
臺北市,南港區,舊莊里,479,1,862,9,871,1075,0,0,0,0,0,0,81.02
臺北市,南港區,舊莊里,480,1,1052,16,1068,1296,0,0,0,0,0,0,82.41
臺北市,南港區,舊莊里,481,1,1014,24,1038,1241,0,0,0,0,0,0,83.64
臺北市,南港區,舊莊里,482,1,959,28,987,1219,0,0,0,0,0,0,80.97
臺北市,南港區,九如里,483,1,1409,21,1430,1713,0,0,0,0,0,0,83.48
臺北市,南港區,九如里,484,1,1186,21,1207,1434,0,0,0,0,0,0,84.17
臺北市,南港區,九如里,485,1,1210,36,1246,1522,0,0,0,0,0,0,81.87
臺北市,松山區,莊敬里,486,1,816,18,834,1018,0,0,0,0,0,0,81.93
臺北市,松山區,莊敬里,487,1,1005,12,1017,1233,0,0,0,0,0,0,82.48
臺北市,松山區,莊敬里,488,1,916,12,928,1119,0,0,0,0,0,0,82.93
臺北市,松山區,莊敬里,489,1,1092,16,1108,1378,0,0,0,0,0,0,80.41
臺北市,松山區,東榮里,490,1,1114,11,1125,1415,0,0,0,0,0,0,79.51
臺北市,松山區,東榮里,491,1,1147,15,1162,1508,0,0,0,0,0,0,77.06
臺北市,松山區,東榮里,492,1,1075,12,1087,1444,0,0,0,0,0,0,75.28
臺北市,松山區,東榮里,493,1,1131,11,1142,1423,0,0,0,0,0,0,80.25
臺北市,松山區,東榮里,494,1,851,7,858,1097,0,0,0,0,0,0,78.21
臺北市,松山區,三民里,495,1,1049,12,1061,1303,0,0,0,0,0,0,81.43
臺北市,松山區,三民里,496,1,1042,19,1061,1414,0,0,0,0,0,0,75.04
臺北市,松山區,三民里,497,1,1054,11,1065,1374,0,0,0,0,0,0,77.51
臺北市,松山區,三民里,498,1,1128,24,1152,1389,0,0,0,0,0,0,82.94
臺北市,松山區,新益里,499,1,1038,12,1050,1294,0,0,0,0,0,0,81.14
臺北市,松山區,新益里,500,1,939,25,964,1211,0,0,0,0,0,0,79.60
臺北市,松山區,新益里,501,1,1032,12,1044,1274,0,0,0,0,0,0,81.95
臺北市,松山區,富錦里,502,1,1103,11,1114,1523,0,0,0,0,0,0,73.15
臺北市,松山區,富錦里,503,1,860,6,866,1069,0,0,0,0,0,0,81.01
臺北市,松山區,富錦里,504,1,1382,13,1395,1682,0,0,0,0,0,0,82.94
臺北市,松山區,新東里,505,1,941,17,958,1206,0,0,0,0,0,0,79.44
臺北市,松山區,新東里,506,1,1123,23,1146,1443,0,0,0,0,0,0,79.42
臺北市,松山區,新東里,507,1,977,15,992,1225,0,0,0,0,0,0,80.98
臺北市,松山區,富泰里,508,1,1001,12,1013,1357,0,0,0,0,0,0,74.65
臺北市,松山區,富泰里,509,1,759,9,768,971,0,0,0,0,0,0,79.09
臺北市,松山區,富泰里,510,1,983,13,996,1334,0,0,0,0,0,0,74.66
臺北市,松山區,介壽里,511,1,971,9,980,1264,0,0,0,0,0,0,77.53
臺北市,松山區,介壽里,512,1,904,17,921,1253,0,0,0,0,0,0,73.50
臺北市,松山區,介壽里,513,1,951,21,972,1246,0,0,0,0,0,0,78.01
臺北市,松山區,精忠里,514,1,1039,14,1053,1368,0,0,0,0,0,0,76.97
臺北市,松山區,精忠里,515,1,861,15,876,1169,0,0,0,0,0,0,74.94
臺北市,松山區,精忠里,516,1,905,12,917,1202,0,0,0,0,0,0,76.29
臺北市,松山區,東光里,517,1,987,18,1005,1351,0,0,0,0,0,0,74.39
臺北市,松山區,東光里,518,1,986,14,1000,1260,0,0,0,0,0,0,79.37
臺北市,松山區,東光里,519,1,906,28,934,1189,0,0,0,0,0,0,78.55
臺北市,松山區,東光里,520,1,871,14,885,1151,0,0,0,0,0,0,76.89
臺北市,松山區,東光里,521,1,877,17,894,1156,0,0,0,0,0,0,77.34
臺北市,松山區,龍田里,522,1,1072,15,1087,1406,0,0,0,0,0,0,77.31
臺北市,松山區,龍田里,523,1,1187,15,1202,1538,0,0,0,0,0,0,78.15
臺北市,松山區,龍田里,524,1,1192,11,1203,1590,0,0,0,0,0,0,75.66
臺北市,松山區,東昌里,525,1,964,15,979,1237,0,0,0,0,0,0,79.14
臺北市,松山區,東昌里,526,1,878,13,891,1126,0,0,0,0,0,0,79.13
臺北市,松山區,東昌里,527,1,1016,17,1033,1332,0,0,0,0,0,0,77.55
臺北市,松山區,東勢里,528,1,1063,10,1073,1377,0,0,0,0,0,0,77.92
臺北市,松山區,東勢里,529,1,970,14,984,1246,0,0,0,0,0,0,78.97
臺北市,松山區,中華里,530,1,1024,18,1042,1271,0,0,0,0,0,0,81.98
臺北市,松山區,中華里,531,1,980,13,993,1235,0,0,0,0,0,0,80.40
臺北市,松山區,中華里,532,1,1028,12,1040,1282,0,0,0,0,0,0,81.12
臺北市,松山區,民有里,533,1,1097,10,1107,1448,0,0,0,0,0,0,76.45
臺北市,松山區,民有里,534,1,1150,16,1166,1470,0,0,0,0,0,0,79.32
臺北市,松山區,民有里,535,1,997,17,1014,1354,0,0,0,0,0,0,74.89
臺北市,松山區,民有里,536,1,942,6,948,1248,0,0,0,0,0,0,75.96
臺北市,松山區,民有里,537,1,1071,19,1090,1398,0,0,0,0,0,0,77.97
臺北市,松山區,民福里,538,1,1080,33,1113,1360,0,0,0,0,0,0,81.84
臺北市,松山區,民福里,539,1,1101,13,1114,1366,0,0,0,0,0,0,81.55
臺北市,松山區,民福里,540,1,1092,22,1114,1361,0,0,0,0,0,0,81.85
臺北市,松山區,民福里,541,1,928,17,945,1231,0,0,0,0,0,0,76.77
臺北市,松山區,松基里,542,1,1187,27,1214,1555,0,0,0,0,0,0,78.07
臺北市,松山區,松基里,543,1,1096,21,1117,1445,0,0,0,0,0,0,77.30
臺北市,松山區,慈祐里,544,1,1056,13,1069,1281,0,0,0,0,0,0,83.45
臺北市,松山區,慈祐里,545,1,979,12,991,1191,0,0,0,0,0,0,83.21
臺北市,松山區,慈祐里,546,1,935,12,947,1180,0,0,0,0,0,0,80.25
臺北市,松山區,慈祐里,547,1,878,8,886,1132,0,0,0,0,0,0,78.27
臺北市,松山區,安平里,548,1,1247,21,1268,1561,0,0,0,0,0,0,81.23
臺北市,松山區,安平里,549,1,1259,25,1284,1519,0,0,0,0,0,0,84.53
臺北市,松山區,安平里,550,1,956,22,978,1174,0,0,0,0,0,0,83.30
臺北市,松山區,安平里,551,1,1214,26,1240,1490,0,0,0,0,0,0,83.22
臺北市,松山區,安平里,552,1,1056,24,1080,1325,0,0,0,0,0,0,81.51
臺北市,松山區,鵬程里,553,1,1126,11,1137,1368,0,0,0,0,0,0,83.11
臺北市,松山區,鵬程里,554,1,1120,17,1137,1351,0,0,0,0,0,0,84.16
臺北市,松山區,鵬程里,555,1,986,20,1006,1262,0,0,0,0,0,0,79.71
臺北市,松山區,自強里,556,1,967,14,981,1296,0,0,0,0,0,0,75.69
臺北市,松山區,自強里,557,1,1211,28,1239,1563,0,0,0,0,0,0,79.27
臺北市,松山區,自強里,558,1,1206,12,1218,1500,0,0,0,0,0,0,81.20
臺北市,松山區,自強里,559,1,1161,10,1171,1435,0,0,0,0,0,0,81.60
臺北市,松山區,吉祥里,560,1,956,21,977,1225,0,0,0,0,0,0,79.76
臺北市,松山區,吉祥里,561,1,889,11,900,1181,0,0,0,0,0,0,76.21
臺北市,松山區,吉祥里,562,1,903,21,924,1171,0,0,0,0,0,0,78.91
臺北市,松山區,吉祥里,563,1,954,12,966,1231,0,0,0,0,0,0,78.47
臺北市,松山區,吉祥里,564,1,1073,19,1092,1335,0,0,0,0,0,0,81.80
臺北市,松山區,新聚里,565,1,1099,18,1117,1346,0,0,0,0,0,0,82.99
臺北市,松山區,新聚里,566,1,1140,24,1164,1481,0,0,0,0,0,0,78.60
臺北市,松山區,新聚里,567,1,1159,12,1171,1441,0,0,0,0,0,0,81.26
臺北市,松山區,新聚里,568,1,1022,19,1041,1402,0,0,0,0,0,0,74.25
臺北市,松山區,復盛里,569,1,963,26,989,1238,0,0,0,0,0,0,79.89
臺北市,松山區,復盛里,570,1,1136,18,1154,1447,0,0,0,0,0,0,79.75
臺北市,松山區,復盛里,571,1,1013,8,1021,1219,0,0,0,0,0,0,83.76
臺北市,松山區,復盛里,572,1,931,16,947,1163,0,0,0,0,0,0,81.43
臺北市,松山區,中正里,573,1,990,18,1008,1273,0,0,0,0,0,0,79.18
臺北市,松山區,中正里,574,1,911,14,925,1201,0,0,0,0,0,0,77.02
臺北市,松山區,中正里,575,1,985,18,1003,1306,0,0,0,0,0,0,76.80
臺北市,松山區,中正里,576,1,834,11,845,1113,0,0,0,0,0,0,75.92
臺北市,松山區,中正里,577,1,871,15,886,1167,0,0,0,0,0,0,75.92
臺北市,松山區,中崙里,578,1,942,19,961,1224,0,0,0,0,0,0,78.51
臺北市,松山區,中崙里,579,1,926,12,938,1120,0,0,0,0,0,0,83.75
臺北市,松山區,中崙里,580,1,626,19,645,786,0,0,0,0,0,0,82.06
臺北市,松山區,美仁里,581,1,1219,15,1234,1490,0,0,0,0,0,0,82.82
臺北市,松山區,美仁里,582,1,927,11,938,1179,0,0,0,0,0,0,79.56
臺北市,松山區,吉仁里,583,1,1191,17,1208,1484,0,0,0,0,0,0,81.40
臺北市,松山區,吉仁里,584,1,1199,9,1208,1527,0,0,0,0,0,0,79.11
臺北市,松山區,敦化里,585,1,1049,15,1064,1372,0,0,0,0,0,0,77.55
臺北市,松山區,敦化里,586,1,1032,9,1041,1286,0,0,0,0,0,0,80.95
臺北市,松山區,敦化里,587,1,1135,18,1153,1402,0,0,0,0,0,0,82.24
臺北市,松山區,敦化里,588,1,1144,21,1165,1416,0,0,0,0,0,0,82.27
臺北市,松山區,復源里,589,1,872,13,885,1083,0,0,0,0,0,0,81.72
臺北市,松山區,復源里,590,1,1112,13,1125,1440,0,0,0,0,0,0,78.13
臺北市,松山區,復建里,591,1,1062,17,1079,1376,0,0,0,0,0,0,78.42
臺北市,松山區,復建里,592,1,1169,18,1187,1512,0,0,0,0,0,0,78.51
臺北市,松山區,復勢里,593,1,910,23,933,1161,0,0,0,0,0,0,80.36
臺北市,松山區,復勢里,594,1,963,17,980,1197,0,0,0,0,0,0,81.87
臺北市,松山區,復勢里,595,1,972,22,994,1278,0,0,0,0,0,0,77.78
臺北市,松山區,復勢里,596,1,876,16,892,1163,0,0,0,0,0,0,76.70
臺北市,松山區,福成里,597,1,992,23,1015,1345,0,0,0,0,0,0,75.46
臺北市,松山區,福成里,598,1,582,16,598,828,0,0,0,0,0,0,72.22
臺北市,信義區,西村里,599,1,1092,15,1107,1412,0,0,0,0,0,0,78.40
臺北市,信義區,西村里,600,1,1016,10,1026,1259,0,0,0,0,0,0,81.49
臺北市,信義區,西村里,601,1,980,11,991,1239,0,0,0,0,0,0,79.98
臺北市,信義區,正和里,602,1,1054,19,1073,1404,0,0,0,0,0,0,76.42
臺北市,信義區,正和里,603,1,972,28,1000,1269,0,0,0,0,0,0,78.80
臺北市,信義區,正和里,604,1,984,14,998,1290,0,0,0,0,0,0,77.36
臺北市,信義區,興隆里,605,1,906,24,930,1165,0,0,0,0,0,0,79.83
臺北市,信義區,興隆里,606,1,941,16,957,1350,0,0,0,0,0,0,70.89
臺北市,信義區,中興里,607,1,888,21,909,1222,0,0,0,0,0,0,74.39
臺北市,信義區,中興里,608,1,757,10,767,1047,0,0,0,0,0,0,73.26
臺北市,信義區,新仁里,609,1,895,14,909,1225,0,0,0,0,0,0,74.20
臺北市,信義區,新仁里,610,1,910,16,926,1151,0,0,0,0,0,0,80.45
臺北市,信義區,新仁里,611,1,804,19,823,1111,0,0,0,0,0,0,74.08
臺北市,信義區,興雅里,612,1,840,12,852,1171,0,0,0,0,0,0,72.76
臺北市,信義區,興雅里,613,1,1047,10,1057,1374,0,0,0,0,0,0,76.93
臺北市,信義區,興雅里,614,1,966,13,979,1166,0,0,0,0,0,0,83.96
臺北市,信義區,興雅里,615,1,1000,29,1029,1241,0,0,0,0,0,0,82.92
臺北市,信義區,敦厚里,616,1,957,8,965,1236,0,0,0,0,0,0,78.07
臺北市,信義區,敦厚里,617,1,910,24,934,1188,0,0,0,0,0,0,78.62
臺北市,信義區,敦厚里,618,1,1034,24,1058,1322,0,0,0,0,0,0,80.03
臺北市,信義區,廣居里,619,1,885,15,900,1124,0,0,0,0,0,0,80.07
臺北市,信義區,廣居里,620,1,1066,17,1083,1346,0,0,0,0,0,0,80.46
臺北市,信義區,廣居里,621,1,867,10,877,1119,0,0,0,0,0,0,78.37
臺北市,信義區,廣居里,622,1,1002,14,1016,1284,0,0,0,0,0,0,79.13
臺北市,信義區,安康里,623,1,1044,18,1062,1311,0,0,0,0,0,0,81.01
臺北市,信義區,安康里,624,1,1229,14,1243,1564,0,0,0,0,0,0,79.48
臺北市,信義區,安康里,625,1,1260,12,1272,1627,0,0,0,0,0,0,78.18
臺北市,信義區,安康里,626,1,1100,14,1114,1437,0,0,0,0,0,0,77.52
臺北市,信義區,六藝里,627,1,979,27,1006,1221,0,0,0,0,0,0,82.39
臺北市,信義區,六藝里,628,1,1289,27,1316,1601,0,0,0,0,0,0,82.20
臺北市,信義區,雅祥里,629,1,997,18,1015,1242,0,0,0,0,0,0,81.72
臺北市,信義區,雅祥里,630,1,964,11,975,1221,0,0,0,0,0,0,79.85
臺北市,信義區,雅祥里,631,1,1032,11,1043,1239,0,0,0,0,0,0,84.18
臺北市,信義區,五常里,632,1,1261,29,1290,1555,0,0,0,0,0,0,82.96
臺北市,信義區,五常里,633,1,1142,25,1167,1431,0,0,0,0,0,0,81.55
臺北市,信義區,五全里,634,1,1139,21,1160,1390,0,0,0,0,0,0,83.45
臺北市,信義區,五全里,635,1,1180,29,1209,1464,0,0,0,0,0,0,82.58
臺北市,信義區,五全里,636,1,1044,26,1070,1289,0,0,0,0,0,0,83.01
臺北市,信義區,永吉里,637,1,878,18,896,1124,0,0,0,0,0,0,79.72
臺北市,信義區,永吉里,638,1,1046,25,1071,1294,0,0,0,0,0,0,82.77
臺北市,信義區,永吉里,639,1,1127,32,1159,1357,0,0,0,0,0,0,85.41
臺北市,信義區,長春里,640,1,950,20,970,1199,0,0,0,0,0,0,80.90
臺北市,信義區,長春里,641,1,1097,23,1120,1385,0,0,0,0,0,0,80.87
臺北市,信義區,長春里,642,1,911,27,938,1124,0,0,0,0,0,0,83.45
臺北市,信義區,四育里,643,1,1035,16,1051,1245,0,0,0,0,0,0,84.42
臺北市,信義區,四育里,644,1,1263,21,1284,1525,0,0,0,0,0,0,84.20
臺北市,信義區,四育里,645,1,1399,33,1432,1730,0,0,0,0,0,0,82.77
臺北市,信義區,四維里,646,1,1244,13,1257,1542,0,0,0,0,0,0,81.52
臺北市,信義區,四維里,647,1,1239,20,1259,1551,0,0,0,0,0,0,81.17
臺北市,信義區,四維里,648,1,1197,18,1215,1509,0,0,0,0,0,0,80.52
臺北市,信義區,永春里,649,1,1369,18,1387,1664,0,0,0,0,0,0,83.35
臺北市,信義區,永春里,650,1,1159,21,1180,1419,0,0,0,0,0,0,83.16
臺北市,信義區,永春里,651,1,1113,16,1129,1392,0,0,0,0,0,0,81.11
臺北市,信義區,富台里,652,1,679,13,692,904,0,0,0,0,0,0,76.55
臺北市,信義區,富台里,653,1,1084,17,1101,1344,0,0,0,0,0,0,81.92
臺北市,信義區,富台里,654,1,730,16,746,910,0,0,0,0,0,0,81.98
臺北市,信義區,國業里,655,1,1088,20,1108,1350,0,0,0,0,0,0,82.07
臺北市,信義區,國業里,656,1,1084,18,1102,1387,0,0,0,0,0,0,79.45
臺北市,信義區,國業里,657,1,1217,14,1231,1512,0,0,0,0,0,0,81.42
臺北市,信義區,國業里,658,1,892,26,918,1122,0,0,0,0,0,0,81.82
臺北市,信義區,松隆里,659,1,971,23,994,1235,0,0,0,0,0,0,80.49
臺北市,信義區,松隆里,660,1,887,22,909,1133,0,0,0,0,0,0,80.23
臺北市,信義區,松友里,661,1,1102,39,1141,1395,0,0,0,0,0,0,81.79
臺北市,信義區,松友里,662,1,1012,18,1030,1248,0,0,0,0,0,0,82.53
臺北市,信義區,松友里,663,1,969,17,986,1184,0,0,0,0,0,0,83.28
臺北市,信義區,松友里,664,1,945,19,964,1177,0,0,0,0,0,0,81.90
臺北市,信義區,松光里,665,1,1295,17,1312,1621,0,0,0,0,0,0,80.94
臺北市,信義區,松光里,666,1,1183,10,1193,1459,0,0,0,0,0,0,81.77
臺北市,信義區,松光里,667,1,1179,14,1193,1474,0,0,0,0,0,0,80.94
臺北市,信義區,中坡里,668,1,1058,16,1074,1288,0,0,0,0,0,0,83.39
臺北市,信義區,中坡里,669,1,1026,20,1046,1251,0,0,0,0,0,0,83.61
臺北市,信義區,中坡里,670,1,976,20,996,1212,0,0,0,0,0,0,82.18
臺北市,信義區,中行里,671,1,949,18,967,1172,0,0,0,0,0,0,82.51
臺北市,信義區,中行里,672,1,1044,21,1065,1266,0,0,0,0,0,0,84.12
臺北市,信義區,中行里,673,1,1014,19,1033,1270,0,0,0,0,0,0,81.34
臺北市,信義區,中行里,674,1,1102,23,1125,1327,0,0,0,0,0,0,84.78
臺北市,信義區,中行里,675,1,1003,24,1027,1217,0,0,0,0,0,0,84.39
臺北市,信義區,大道里,676,1,988,28,1016,1261,0,0,0,0,0,0,80.57
臺北市,信義區,大道里,677,1,1088,27,1115,1337,0,0,0,0,0,0,83.40
臺北市,信義區,大道里,678,1,1130,14,1144,1415,0,0,0,0,0,0,80.85
臺北市,信義區,大道里,679,1,995,23,1018,1231,0,0,0,0,0,0,82.70
臺北市,信義區,大仁里,680,1,1027,26,1053,1290,0,0,0,0,0,0,81.63
臺北市,信義區,大仁里,681,1,980,73,1053,1359,0,0,0,0,0,0,77.48
臺北市,信義區,大仁里,682,1,1006,10,1016,1248,0,0,0,0,0,0,81.41
臺北市,信義區,大仁里,683,1,814,44,858,1032,0,0,0,0,0,0,83.14
臺北市,信義區,景新里,684,1,990,14,1004,1228,0,0,0,0,0,0,81.76
臺北市,信義區,景新里,685,1,1094,21,1115,1378,0,0,0,0,0,0,80.91
臺北市,信義區,景新里,686,1,1047,14,1061,1377,0,0,0,0,0,0,77.05
臺北市,信義區,惠安里,687,1,1078,20,1098,1355,0,0,0,0,0,0,81.03
臺北市,信義區,惠安里,688,1,1113,19,1132,1354,0,0,0,0,0,0,83.60
臺北市,信義區,惠安里,689,1,1107,25,1132,1366,0,0,0,0,0,0,82.87
臺北市,信義區,惠安里,690,1,1162,34,1196,1430,0,0,0,0,0,0,83.64
臺北市,信義區,三張里,691,1,1044,22,1066,1364,0,0,0,0,0,0,78.15
臺北市,信義區,三張里,692,1,1206,15,1221,1511,0,0,0,0,0,0,80.81
臺北市,信義區,三張里,693,1,1176,17,1193,1488,0,0,0,0,0,0,80.17
臺北市,信義區,三張里,694,1,1145,24,1169,1456,0,0,0,0,0,0,80.29
臺北市,信義區,三張里,695,1,1205,16,1221,1503,0,0,0,0,0,0,81.24
臺北市,信義區,三犁里,696,1,987,20,1007,1289,0,0,0,0,0,0,78.12
臺北市,信義區,三犁里,697,1,985,21,1006,1264,0,0,0,0,0,0,79.59
臺北市,信義區,三犁里,698,1,1094,25,1119,1402,0,0,0,0,0,0,79.81
臺北市,信義區,六合里,699,1,1069,15,1084,1355,0,0,0,0,0,0,80.00
臺北市,信義區,六合里,700,1,1271,17,1288,1589,0,0,0,0,0,0,81.06
臺北市,信義區,六合里,701,1,805,19,824,1008,0,0,0,0,0,0,81.75
臺北市,信義區,六合里,702,1,893,19,912,1241,0,0,0,0,0,0,73.49
臺北市,信義區,泰和里,703,1,974,29,1003,1313,0,0,0,0,0,0,76.39
臺北市,信義區,泰和里,704,1,990,26,1016,1256,0,0,0,0,0,0,80.89
臺北市,信義區,泰和里,705,1,1086,20,1106,1342,0,0,0,0,0,0,82.41
臺北市,信義區,泰和里,706,1,1082,16,1098,1368,0,0,0,0,0,0,80.26
臺北市,信義區,泰和里,707,1,1080,24,1104,1340,0,0,0,0,0,0,82.39
臺北市,信義區,景聯里,708,1,966,27,993,1282,0,0,0,0,0,0,77.46
臺北市,信義區,景聯里,709,1,1016,19,1035,1289,0,0,0,0,0,0,80.29
臺北市,信義區,景聯里,710,1,1158,19,1177,1389,0,0,0,0,0,0,84.74
臺北市,信義區,景勤里,711,1,944,25,969,1200,0,0,0,0,0,0,80.75
臺北市,信義區,景勤里,712,1,1005,21,1026,1273,0,0,0,0,0,0,80.60
臺北市,信義區,景勤里,713,1,1167,13,1180,1436,0,0,0,0,0,0,82.17
臺北市,信義區,雙和里,714,1,984,21,1005,1252,0,0,0,0,0,0,80.27
臺北市,信義區,雙和里,715,1,1135,21,1156,1409,0,0,0,0,0,0,82.04
臺北市,信義區,雙和里,716,1,1212,18,1230,1485,0,0,0,0,0,0,82.83
臺北市,信義區,雙和里,717,1,1057,14,1071,1332,0,0,0,0,0,0,80.41
臺北市,信義區,嘉興里,718,1,1134,20,1154,1417,0,0,0,0,0,0,81.44
臺北市,信義區,嘉興里,719,1,1011,25,1036,1251,0,0,0,0,0,0,82.81
臺北市,信義區,黎順里,720,1,757,20,777,971,0,0,0,0,0,0,80.02
臺北市,信義區,黎順里,721,1,1073,13,1086,1328,0,0,0,0,0,0,81.78
臺北市,信義區,黎順里,722,1,960,15,975,1267,0,0,0,0,0,0,76.95
臺北市,信義區,黎平里,723,1,1128,26,1154,1369,0,0,0,0,0,0,84.30
臺北市,信義區,黎平里,724,1,1181,16,1197,1470,0,0,0,0,0,0,81.43
臺北市,信義區,黎平里,725,1,1032,29,1061,1310,0,0,0,0,0,0,80.99
臺北市,信義區,黎平里,726,1,1141,32,1173,1441,0,0,0,0,0,0,81.40
臺北市,信義區,黎忠里,727,1,1129,28,1157,1418,0,0,0,0,0,0,81.59
臺北市,信義區,黎忠里,728,1,941,25,966,1174,0,0,0,0,0,0,82.28
臺北市,信義區,黎忠里,729,1,1006,26,1032,1212,0,0,0,0,0,0,85.15
臺北市,信義區,黎安里,730,1,996,19,1015,1206,0,0,0,0,0,0,84.16
臺北市,信義區,黎安里,731,1,918,40,958,1267,0,0,0,0,0,0,75.61
臺北市,中山區,正守里,732,2,956,18,974,1248,0,0,0,0,0,0,78.04
臺北市,中山區,正守里,733,2,980,19,999,1265,0,0,0,0,0,0,78.97
臺北市,中山區,正義里,734,2,592,23,615,830,0,0,0,0,0,0,74.10
臺北市,中山區,正義里,735,2,1010,26,1036,1426,0,0,0,0,0,0,72.65
臺北市,中山區,正義里,736,2,950,35,985,1270,0,0,0,0,0,0,77.56
臺北市,中山區,正得里,737,2,814,14,828,1098,0,0,0,0,0,0,75.41
臺北市,中山區,正得里,738,2,1027,20,1047,1467,0,0,0,0,0,0,71.37
臺北市,中山區,民安里,739,2,1002,20,1022,1303,0,0,0,0,0,0,78.43
臺北市,中山區,民安里,740,2,1019,23,1042,1434,0,0,0,0,0,0,72.66
臺北市,中山區,民安里,741,2,1044,19,1063,1373,0,0,0,0,0,0,77.42
臺北市,中山區,康樂里,742,2,615,22,637,932,0,0,0,0,0,0,68.35
臺北市,中山區,康樂里,743,2,639,25,664,958,0,0,0,0,0,0,69.31
臺北市,中山區,中山里,744,2,1002,23,1025,1361,0,0,0,0,0,0,75.31
臺北市,中山區,中山里,745,2,906,28,934,1263,0,0,0,0,0,0,73.95
臺北市,中山區,中山里,746,2,980,22,1002,1318,0,0,0,0,0,0,76.02
臺北市,中山區,聚盛里,747,2,1031,21,1052,1418,0,0,0,0,0,0,74.19
臺北市,中山區,聚盛里,748,2,972,21,993,1368,0,0,0,0,0,0,72.59
臺北市,中山區,集英里,749,2,1052,25,1077,1317,0,0,0,0,0,0,81.78
臺北市,中山區,集英里,750,2,772,19,791,998,0,0,0,0,0,0,79.26
臺北市,中山區,集英里,751,2,767,21,788,1008,0,0,0,0,0,0,78.17
臺北市,中山區,集英里,752,2,930,27,957,1232,0,0,0,0,0,0,77.68
臺北市,中山區,聚葉里,753,2,1137,39,1176,1577,0,0,0,0,0,0,74.57
臺北市,中山區,聚葉里,754,2,1085,21,1106,1426,0,0,0,0,0,0,77.56
臺北市,中山區,恆安里,755,2,863,26,889,1288,0,0,0,0,0,0,69.02
臺北市,中山區,恆安里,756,2,886,24,910,1189,0,0,0,0,0,0,76.53
臺北市,中山區,晴光里,757,2,833,20,853,1137,0,0,0,0,0,0,75.02
臺北市,中山區,晴光里,758,2,694,9,703,1013,0,0,0,0,0,0,69.40
臺北市,中山區,晴光里,759,2,772,12,784,1109,0,0,0,0,0,0,70.69
臺北市,中山區,圓山里,760,2,796,20,816,1076,0,0,0,0,0,0,75.84
臺北市,中山區,圓山里,761,2,651,20,671,860,0,0,0,0,0,0,78.02
臺北市,中山區,圓山里,762,2,747,26,773,1037,0,0,0,0,0,0,74.54
臺北市,中山區,圓山里,763,2,553,18,571,753,0,0,0,0,0,0,75.83
臺北市,中山區,新庄里,764,2,1078,18,1096,1423,0,0,0,0,0,0,77.02
臺北市,中山區,新庄里,765,2,1029,20,1049,1304,0,0,0,0,0,0,80.44
臺北市,中山區,新庄里,766,2,937,20,957,1178,0,0,0,0,0,0,81.24
臺北市,中山區,劍潭里,767,2,835,14,849,1111,0,0,0,0,0,0,76.42
臺北市,中山區,劍潭里,768,2,1017,18,1035,1246,0,0,0,0,0,0,83.07
臺北市,中山區,大直里,769,2,993,14,1007,1257,0,0,0,0,0,0,80.11
臺北市,中山區,大直里,770,2,1043,10,1053,1316,0,0,0,0,0,0,80.02
臺北市,中山區,大直里,771,2,1117,21,1138,1357,0,0,0,0,0,0,83.86
臺北市,中山區,大直里,772,2,1066,13,1079,1294,0,0,0,0,0,0,83.38
臺北市,中山區,大直里,773,2,1056,9,1065,1305,0,0,0,0,0,0,81.61
臺北市,中山區,大直里,774,2,967,20,987,1232,0,0,0,0,0,0,80.11
臺北市,中山區,成功里,775,2,926,13,939,1158,0,0,0,0,0,0,81.09
臺北市,中山區,成功里,776,2,885,27,912,1074,0,0,0,0,0,0,84.92
臺北市,中山區,成功里,777,2,815,22,837,983,0,0,0,0,0,0,85.15
臺北市,中山區,成功里,778,2,757,12,769,918,0,0,0,0,0,0,83.77
臺北市,中山區,永安里,779,2,1184,20,1204,1445,0,0,0,0,0,0,83.32
臺北市,中山區,永安里,780,2,1088,12,1100,1297,0,0,0,0,0,0,84.81
臺北市,中山區,永安里,781,2,1077,14,1091,1346,0,0,0,0,0,0,81.05
臺北市,中山區,永安里,782,2,965,12,977,1173,0,0,0,0,0,0,83.29
臺北市,中山區,大佳里,783,2,726,24,750,909,0,0,0,0,0,0,82.51
臺北市,中山區,新喜里,784,2,1135,17,1152,1336,0,0,0,0,0,0,86.23
臺北市,中山區,新喜里,785,2,1044,22,1066,1302,0,0,0,0,0,0,81.87
臺北市,中山區,新喜里,786,2,1008,25,1033,1317,0,0,0,0,0,0,78.44
臺北市,中山區,新福里,787,2,985,30,1015,1232,0,0,0,0,0,0,82.39
臺北市,中山區,新福里,788,2,1075,34,1109,1460,0,0,0,0,0,0,75.96
臺北市,中山區,新福里,789,2,1091,31,1122,1418,0,0,0,0,0,0,79.13
臺北市,中山區,松江里,790,2,957,24,981,1214,0,0,0,0,0,0,80.81
臺北市,中山區,松江里,791,2,1004,14,1018,1316,0,0,0,0,0,0,77.36
臺北市,中山區,松江里,792,2,1055,15,1070,1344,0,0,0,0,0,0,79.61
臺北市,中山區,松江里,793,2,927,16,943,1182,0,0,0,0,0,0,79.78
臺北市,中山區,新生里,794,2,868,26,894,1110,0,0,0,0,0,0,80.54
臺北市,中山區,新生里,795,2,758,16,774,992,0,0,0,0,0,0,78.02
臺北市,中山區,新生里,796,2,694,16,710,901,0,0,0,0,0,0,78.80
臺北市,中山區,新生里,797,2,697,15,712,908,0,0,0,0,0,0,78.41
臺北市,中山區,中庄里,798,2,834,22,856,1087,0,0,0,0,0,0,78.75
臺北市,中山區,中庄里,799,2,766,23,789,995,0,0,0,0,0,0,79.30
臺北市,中山區,中庄里,800,2,1002,20,1022,1270,0,0,0,0,0,0,80.47
臺北市,中山區,中庄里,801,2,893,28,921,1222,0,0,0,0,0,0,75.37
臺北市,中山區,行政里,802,2,1053,27,1080,1301,0,0,0,0,0,0,83.01
臺北市,中山區,行政里,803,2,1157,21,1178,1466,0,0,0,0,0,0,80.35
臺北市,中山區,行政里,804,2,1023,33,1056,1395,0,0,0,0,0,0,75.70
臺北市,中山區,行仁里,805,2,1011,21,1032,1256,0,0,0,0,0,0,82.17
臺北市,中山區,行仁里,806,2,886,26,912,1071,0,0,0,0,0,0,85.15
臺北市,中山區,行仁里,807,2,1152,17,1169,1427,0,0,0,0,0,0,81.92
臺北市,中山區,行仁里,808,2,1042,23,1065,1303,0,0,0,0,0,0,81.73
臺北市,中山區,行仁里,809,2,1151,27,1178,1417,0,0,0,0,0,0,83.13
臺北市,中山區,行孝里,810,2,712,20,732,897,0,0,0,0,0,0,81.61
臺北市,中山區,行孝里,811,2,814,23,837,1031,0,0,0,0,0,0,81.18
臺北市,中山區,行孝里,812,2,894,18,912,1117,0,0,0,0,0,0,81.65
臺北市,中山區,下埤里,813,2,785,12,797,1017,0,0,0,0,0,0,78.37
臺北市,中山區,下埤里,814,2,898,26,924,1094,0,0,0,0,0,0,84.46
臺北市,中山區,下埤里,815,2,962,23,985,1198,0,0,0,0,0,0,82.22
臺北市,中山區,下埤里,816,2,859,12,871,1065,0,0,0,0,0,0,81.78
臺北市,中山區,下埤里,817,2,951,22,973,1199,0,0,0,0,0,0,81.15
臺北市,中山區,江寧里,818,2,875,15,890,1110,0,0,0,0,0,0,80.18
臺北市,中山區,江寧里,819,2,842,15,857,1100,0,0,0,0,0,0,77.91
臺北市,中山區,江寧里,820,2,1010,14,1024,1224,0,0,0,0,0,0,83.66
臺北市,中山區,江寧里,821,2,645,14,659,830,0,0,0,0,0,0,79.40
臺北市,中山區,江寧里,822,2,687,13,700,904,0,0,0,0,0,0,77.43
臺北市,中山區,江山里,823,2,959,12,971,1184,0,0,0,0,0,0,82.01
臺北市,中山區,江山里,824,2,915,24,939,1134,0,0,0,0,0,0,82.80
臺北市,中山區,江山里,825,2,976,15,991,1200,0,0,0,0,0,0,82.58
臺北市,中山區,江山里,826,2,922,14,936,1156,0,0,0,0,0,0,80.97
臺北市,中山區,江山里,827,2,926,16,942,1172,0,0,0,0,0,0,80.38
臺北市,中山區,中吉里,828,2,1011,16,1027,1363,0,0,0,0,0,0,75.35
臺北市,中山區,中吉里,829,2,1034,17,1051,1372,0,0,0,0,0,0,76.60
臺北市,中山區,中吉里,830,2,1131,27,1158,1472,0,0,0,0,0,0,78.67
臺北市,中山區,中原里,831,2,818,18,836,1088,0,0,0,0,0,0,76.84
臺北市,中山區,中原里,832,2,1055,23,1078,1363,0,0,0,0,0,0,79.09
臺北市,中山區,中原里,833,2,991,27,1018,1362,0,0,0,0,0,0,74.74
臺北市,中山區,興亞里,834,2,991,25,1016,1374,0,0,0,0,0,0,73.94
臺北市,中山區,興亞里,835,2,1021,18,1039,1356,0,0,0,0,0,0,76.62
臺北市,中山區,興亞里,836,2,1072,16,1088,1442,0,0,0,0,0,0,75.45
臺北市,中山區,中央里,837,2,711,22,733,974,0,0,0,0,0,0,75.26
臺北市,中山區,中央里,838,2,782,11,793,1009,0,0,0,0,0,0,78.59
臺北市,中山區,中央里,839,2,714,10,724,892,0,0,0,0,0,0,81.17
臺北市,中山區,朱馥里,840,2,988,26,1014,1294,0,0,0,0,0,0,78.36
臺北市,中山區,朱馥里,841,2,850,12,862,1128,0,0,0,0,0,0,76.42
臺北市,中山區,朱馥里,842,2,1047,22,1069,1324,0,0,0,0,0,0,80.74
臺北市,中山區,朱馥里,843,2,1006,23,1029,1264,0,0,0,0,0,0,81.41
臺北市,中山區,龍洲里,844,2,1154,22,1176,1451,0,0,0,0,0,0,81.05
臺北市,中山區,龍洲里,845,2,1161,11,1172,1427,0,0,0,0,0,0,82.13
臺北市,中山區,龍洲里,846,2,1140,25,1165,1426,0,0,0,0,0,0,81.70
臺北市,中山區,朱園里,847,2,851,15,866,1121,0,0,0,0,0,0,77.25
臺北市,中山區,朱園里,848,2,888,18,906,1161,0,0,0,0,0,0,78.04
臺北市,中山區,朱園里,849,2,924,17,941,1136,0,0,0,0,0,0,82.83
臺北市,中山區,埤頭里,850,2,878,17,895,1121,0,0,0,0,0,0,79.84
臺北市,中山區,埤頭里,851,2,902,16,918,1147,0,0,0,0,0,0,80.03
臺北市,中山區,埤頭里,852,2,889,13,902,1163,0,0,0,0,0,0,77.56
臺北市,中山區,朱崙里,853,2,1089,15,1104,1395,0,0,0,0,0,0,79.14
臺北市,中山區,朱崙里,854,2,965,23,988,1240,0,0,0,0,0,0,79.68
臺北市,中山區,力行里,855,2,1010,17,1027,1294,0,0,0,0,0,0,79.37
臺北市,中山區,力行里,856,2,906,23,929,1221,0,0,0,0,0,0,76.09
臺北市,中山區,力行里,857,2,934,13,947,1224,0,0,0,0,0,0,77.37
臺北市,中山區,力行里,858,2,998,11,1009,1293,0,0,0,0,0,0,78.04
臺北市,中山區,復華里,859,2,1210,31,1241,1578,0,0,0,0,0,0,78.64
臺北市,中山區,復華里,860,2,1074,29,1103,1432,0,0,0,0,0,0,77.03
臺北市,大同區,玉泉里,861,2,804,16,820,1045,0,0,0,0,0,0,78.47
臺北市,大同區,玉泉里,862,2,763,12,775,982,0,0,0,0,0,0,78.92
臺北市,大同區,玉泉里,863,2,895,21,916,1235,0,0,0,0,0,0,74.17
臺北市,大同區,建明里,864,2,845,20,865,1091,0,0,0,0,0,0,79.29
臺北市,大同區,建明里,865,2,771,20,791,1025,0,0,0,0,0,0,77.17
臺北市,大同區,建明里,866,2,757,10,767,980,0,0,0,0,0,0,78.27
臺北市,大同區,建功里,867,2,848,14,862,1056,0,0,0,0,0,0,81.63
臺北市,大同區,建功里,868,2,903,25,928,1148,0,0,0,0,0,0,80.84
臺北市,大同區,建功里,869,2,812,17,829,1039,0,0,0,0,0,0,79.79
臺北市,大同區,建泰里,870,2,1247,35,1282,1641,0,0,0,0,0,0,78.12
臺北市,大同區,建泰里,871,2,947,20,967,1245,0,0,0,0,0,0,77.67
臺北市,大同區,永樂里,872,2,1096,20,1116,1443,0,0,0,0,0,0,77.34
臺北市,大同區,永樂里,873,2,1079,9,1088,1358,0,0,0,0,0,0,80.12
臺北市,大同區,永樂里,874,2,1065,21,1086,1338,0,0,0,0,0,0,81.17
臺北市,大同區,朝陽里,875,2,1225,22,1247,1529,0,0,0,0,0,0,81.56
臺北市,大同區,朝陽里,876,2,1115,24,1139,1446,0,0,0,0,0,0,78.77
臺北市,大同區,星明里,877,2,1011,23,1034,1259,0,0,0,0,0,0,82.13
臺北市,大同區,星明里,878,2,900,25,925,1189,0,0,0,0,0,0,77.80
臺北市,大同區,星明里,879,2,933,27,960,1136,0,0,0,0,0,0,84.51
臺北市,大同區,光能里,880,2,1205,27,1232,1474,0,0,0,0,0,0,83.58
臺北市,大同區,光能里,881,2,1037,19,1056,1276,0,0,0,0,0,0,82.76
臺北市,大同區,光能里,882,2,1197,45,1242,1512,0,0,0,0,0,0,82.14
臺北市,大同區,大有里,883,2,1196,25,1221,1480,0,0,0,0,0,0,82.50
臺北市,大同區,大有里,884,2,982,19,1001,1227,0,0,0,0,0,0,81.58
臺北市,大同區,大有里,885,2,1103,19,1122,1348,0,0,0,0,0,0,83.23
臺北市,大同區,延平里,886,2,819,20,839,1023,0,0,0,0,0,0,82.01
臺北市,大同區,延平里,887,2,821,27,848,1094,0,0,0,0,0,0,77.51
臺北市,大同區,延平里,888,2,767,13,780,1024,0,0,0,0,0,0,76.17
臺北市,大同區,雙連里,889,2,1205,31,1236,1513,0,0,0,0,0,0,81.69
臺北市,大同區,雙連里,890,2,1284,14,1298,1594,0,0,0,0,0,0,81.43
臺北市,大同區,雙連里,891,2,1386,42,1428,1730,0,0,0,0,0,0,82.54
臺北市,大同區,雙連里,892,2,1113,27,1140,1399,0,0,0,0,0,0,81.49
臺北市,大同區,雙連里,893,2,771,18,789,997,0,0,0,0,0,0,79.14
臺北市,大同區,南芳里,894,2,958,19,977,1245,0,0,0,0,0,0,78.47
臺北市,大同區,南芳里,895,2,739,10,749,957,0,0,0,0,0,0,78.27
臺北市,大同區,南芳里,896,2,876,20,896,1067,0,0,0,0,0,0,83.97
臺北市,大同區,民權里,897,2,1097,27,1124,1396,0,0,0,0,0,0,80.52
臺北市,大同區,民權里,898,2,1143,38,1181,1440,0,0,0,0,0,0,82.01
臺北市,大同區,民權里,899,2,932,27,959,1251,0,0,0,0,0,0,76.66
臺北市,大同區,民權里,900,2,977,15,992,1264,0,0,0,0,0,0,78.48
臺北市,大同區,景星里,901,2,1063,26,1089,1325,0,0,0,0,0,0,82.19
臺北市,大同區,景星里,902,2,882,27,909,1126,0,0,0,0,0,0,80.73
臺北市,大同區,隆和里,903,2,1046,22,1068,1323,0,0,0,0,0,0,80.73
臺北市,大同區,隆和里,904,2,1110,23,1133,1357,0,0,0,0,0,0,83.49
臺北市,大同區,蓬萊里,905,2,942,22,964,1222,0,0,0,0,0,0,78.89
臺北市,大同區,蓬萊里,906,2,1122,26,1148,1426,0,0,0,0,0,0,80.50
臺北市,大同區,蓬萊里,907,2,987,24,1011,1229,0,0,0,0,0,0,82.26
臺北市,大同區,國順里,908,2,863,23,886,1063,0,0,0,0,0,0,83.35
臺北市,大同區,國順里,909,2,1081,26,1107,1321,0,0,0,0,0,0,83.80
臺北市,大同區,國順里,910,2,929,25,954,1148,0,0,0,0,0,0,83.10
臺北市,大同區,國慶里,911,2,835,22,857,1029,0,0,0,0,0,0,83.28
臺北市,大同區,國慶里,912,2,736,14,750,917,0,0,0,0,0,0,81.79
臺北市,大同區,揚雅里,913,2,1009,35,1044,1288,0,0,0,0,0,0,81.06
臺北市,大同區,揚雅里,914,2,997,22,1019,1257,0,0,0,0,0,0,81.07
臺北市,大同區,斯文里,915,2,1098,36,1134,1424,0,0,0,0,0,0,79.63
臺北市,大同區,斯文里,916,2,1358,24,1382,1671,0,0,0,0,0,0,82.70
臺北市,大同區,斯文里,917,2,1097,24,1121,1359,0,0,0,0,0,0,82.49
臺北市,大同區,鄰江里,918,2,1184,27,1211,1448,0,0,0,0,0,0,83.63
臺北市,大同區,鄰江里,919,2,1012,26,1038,1294,0,0,0,0,0,0,80.22
臺北市,大同區,鄰江里,920,2,912,20,932,1100,0,0,0,0,0,0,84.73
臺北市,大同區,鄰江里,921,2,1096,24,1120,1304,0,0,0,0,0,0,85.89
臺北市,大同區,至聖里,922,2,871,19,890,1102,0,0,0,0,0,0,80.76
臺北市,大同區,至聖里,923,2,1220,23,1243,1511,0,0,0,0,0,0,82.26
臺北市,大同區,至聖里,924,2,1041,15,1056,1285,0,0,0,0,0,0,82.18
臺北市,大同區,至聖里,925,2,1082,27,1109,1335,0,0,0,0,0,0,83.07
臺北市,大同區,至聖里,926,2,955,23,978,1198,0,0,0,0,0,0,81.64
臺北市,大同區,文昌里,927,2,857,16,873,1026,0,0,0,0,0,0,85.09
臺北市,大同區,老師里,928,2,1063,26,1089,1394,0,0,0,0,0,0,78.12
臺北市,大同區,老師里,929,2,1129,22,1151,1397,0,0,0,0,0,0,82.39
臺北市,大同區,老師里,930,2,717,19,736,882,0,0,0,0,0,0,83.45
臺北市,大同區,重慶里,931,2,826,20,846,1004,0,0,0,0,0,0,84.26
臺北市,大同區,重慶里,932,2,906,19,925,1098,0,0,0,0,0,0,84.24
臺北市,大同區,重慶里,933,2,902,18,920,1095,0,0,0,0,0,0,84.02
臺北市,大同區,保安里,934,2,1122,20,1142,1379,0,0,0,0,0,0,82.81
臺北市,大同區,保安里,935,2,1162,24,1186,1399,0,0,0,0,0,0,84.77
臺北市,大同區,保安里,936,2,895,27,922,1095,0,0,0,0,0,0,84.20
臺北市,大同區,保安里,937,2,702,21,723,910,0,0,0,0,0,0,79.45
臺北市,中正區,水源里,938,2,1180,22,1202,1519,0,0,0,0,0,0,79.13
臺北市,中正區,水源里,939,2,1042,24,1066,1313,0,0,0,0,0,0,81.19
臺北市,中正區,富水里,940,2,658,10,668,957,0,0,0,0,0,0,69.80
臺北市,中正區,富水里,941,2,950,34,984,1292,0,0,0,0,0,0,76.16
臺北市,中正區,文盛里,942,2,876,12,888,1109,0,0,0,0,0,0,80.07
臺北市,中正區,文盛里,943,2,816,18,834,1080,0,0,0,0,0,0,77.22
臺北市,中正區,林興里,944,2,1056,29,1085,1351,0,0,0,0,0,0,80.31
臺北市,中正區,林興里,945,2,1016,24,1040,1309,0,0,0,0,0,0,79.45
臺北市,中正區,林興里,946,2,904,8,912,1162,0,0,0,0,0,0,78.49
臺北市,中正區,河堤里,947,2,960,15,975,1227,0,0,0,0,0,0,79.46
臺北市,中正區,河堤里,948,2,992,18,1010,1352,0,0,0,0,0,0,74.70
臺北市,中正區,河堤里,949,2,984,16,1000,1343,0,0,0,0,0,0,74.46
臺北市,中正區,頂東里,950,2,713,13,726,970,0,0,0,0,0,0,74.85
臺北市,中正區,頂東里,951,2,1014,18,1032,1276,0,0,0,0,0,0,80.88
臺北市,中正區,頂東里,952,2,908,12,920,1121,0,0,0,0,0,0,82.07
臺北市,中正區,頂東里,953,2,927,13,940,1180,0,0,0,0,0,0,79.66
臺北市,中正區,網溪里,954,2,834,6,840,1060,0,0,0,0,0,0,79.25
臺北市,中正區,網溪里,955,2,835,14,849,1092,0,0,0,0,0,0,77.75
臺北市,中正區,網溪里,956,2,917,15,932,1186,0,0,0,0,0,0,78.58
臺北市,中正區,網溪里,957,2,897,22,919,1180,0,0,0,0,0,0,77.88
臺北市,中正區,板溪里,958,2,680,14,694,888,0,0,0,0,0,0,78.15
臺北市,中正區,板溪里,959,2,720,15,735,973,0,0,0,0,0,0,75.54
臺北市,中正區,板溪里,960,2,776,17,793,962,0,0,0,0,0,0,82.43
臺北市,中正區,螢圃里,961,2,1035,22,1057,1334,0,0,0,0,0,0,79.24
臺北市,中正區,螢圃里,962,2,1173,28,1201,1462,0,0,0,0,0,0,82.15
臺北市,中正區,螢圃里,963,2,1174,9,1183,1436,0,0,0,0,0,0,82.38
臺北市,中正區,螢雪里,964,2,991,13,1004,1238,0,0,0,0,0,0,81.10
臺北市,中正區,螢雪里,965,2,944,19,963,1185,0,0,0,0,0,0,81.27
臺北市,中正區,螢雪里,966,2,946,22,968,1214,0,0,0,0,0,0,79.74
臺北市,中正區,永功里,967,2,1052,26,1078,1316,0,0,0,0,0,0,81.91
臺北市,中正區,永功里,968,2,860,27,887,1082,0,0,0,0,0,0,81.98
臺北市,中正區,永功里,969,2,796,20,816,999,0,0,0,0,0,0,81.68
臺北市,中正區,永功里,970,2,791,19,810,995,0,0,0,0,0,0,81.41
臺北市,中正區,永昌里,971,2,936,16,952,1154,0,0,0,0,0,0,82.50
臺北市,中正區,永昌里,972,2,1031,21,1052,1324,0,0,0,0,0,0,79.46
臺北市,中正區,永昌里,973,2,1029,17,1046,1247,0,0,0,0,0,0,83.88
臺北市,中正區,龍興里,974,2,875,28,903,1095,0,0,0,0,0,0,82.47
臺北市,中正區,龍興里,975,2,838,22,860,1063,0,0,0,0,0,0,80.90
臺北市,中正區,龍興里,976,2,965,12,977,1217,0,0,0,0,0,0,80.28
臺北市,中正區,龍興里,977,2,865,15,880,1117,0,0,0,0,0,0,78.78
臺北市,中正區,龍興里,978,2,764,12,776,947,0,0,0,0,0,0,81.94
臺北市,中正區,忠勤里,979,2,956,28,984,1223,0,0,0,0,0,0,80.46
臺北市,中正區,忠勤里,980,2,849,32,881,1113,0,0,0,0,0,0,79.16
臺北市,中正區,忠勤里,981,2,884,28,912,1161,0,0,0,0,0,0,78.55
臺北市,中正區,忠勤里,982,2,1002,29,1031,1300,0,0,0,0,0,0,79.31
臺北市,中正區,忠勤里,983,2,968,26,994,1224,0,0,0,0,0,0,81.21
臺北市,中正區,廈安里,984,2,1073,15,1088,1303,0,0,0,0,0,0,83.50
臺北市,中正區,廈安里,985,2,1262,25,1287,1619,0,0,0,0,0,0,79.49
臺北市,中正區,愛國里,986,2,689,14,703,903,0,0,0,0,0,0,77.85
臺北市,中正區,愛國里,987,2,693,8,701,894,0,0,0,0,0,0,78.41
臺北市,中正區,愛國里,988,2,680,9,689,863,0,0,0,0,0,0,79.84
臺北市,中正區,南門里,989,2,837,11,848,1032,0,0,0,0,0,0,82.17
臺北市,中正區,南門里,990,2,814,15,829,1053,0,0,0,0,0,0,78.73
臺北市,中正區,南門里,991,2,714,13,727,964,0,0,0,0,0,0,75.41
臺北市,中正區,龍光里,992,2,671,15,686,910,0,0,0,0,0,0,75.38
臺北市,中正區,龍光里,993,2,918,12,930,1183,0,0,0,0,0,0,78.61
臺北市,中正區,龍光里,994,2,911,6,917,1120,0,0,0,0,0,0,81.88
臺北市,中正區,南福里,995,2,952,13,965,1226,0,0,0,0,0,0,78.71
臺北市,中正區,南福里,996,2,962,17,979,1254,0,0,0,0,0,0,78.07
臺北市,中正區,南福里,997,2,913,19,932,1213,0,0,0,0,0,0,76.83
臺北市,中正區,南福里,998,2,921,11,932,1144,0,0,0,0,0,0,81.47
臺北市,中正區,南福里,999,2,932,14,946,1154,0,0,0,0,0,0,81.98
臺北市,中正區,龍福里,1000,2,981,15,996,1276,0,0,0,0,0,0,78.06
臺北市,中正區,龍福里,1001,2,981,17,998,1238,0,0,0,0,0,0,80.61
臺北市,中正區,龍福里,1002,2,788,13,801,990,0,0,0,0,0,0,80.91
臺北市,中正區,龍福里,1003,2,860,19,879,1078,0,0,0,0,0,0,81.54
臺北市,中正區,新營里,1004,2,1078,11,1089,1328,0,0,0,0,0,0,82.00
臺北市,中正區,新營里,1005,2,1061,18,1079,1332,0,0,0,0,0,0,81.01
臺北市,中正區,新營里,1006,2,975,12,987,1213,0,0,0,0,0,0,81.37
臺北市,中正區,新營里,1007,2,878,13,891,1090,0,0,0,0,0,0,81.74
臺北市,中正區,新營里,1008,2,1021,16,1037,1209,0,0,0,0,0,0,85.77
臺北市,中正區,建國里,1009,2,872,14,886,1293,0,0,0,0,0,0,68.52
臺北市,中正區,光復里,1010,2,1044,18,1062,1416,0,0,0,0,0,0,75.00
臺北市,中正區,光復里,1011,2,1068,29,1097,1526,0,0,0,0,0,0,71.89
臺北市,中正區,黎明里,1012,2,673,16,689,1011,0,0,0,0,0,0,68.15
臺北市,中正區,黎明里,1013,2,810,19,829,1134,0,0,0,0,0,0,73.10
臺北市,中正區,梅花里,1014,2,801,11,812,1031,0,0,0,0,0,0,78.76
臺北市,中正區,梅花里,1015,2,747,24,771,998,0,0,0,0,0,0,77.25
臺北市,中正區,梅花里,1016,2,724,19,743,927,0,0,0,0,0,0,80.15
臺北市,中正區,幸福里,1017,2,884,14,898,1187,0,0,0,0,0,0,75.65
臺北市,中正區,幸福里,1018,2,897,24,921,1152,0,0,0,0,0,0,79.95
臺北市,中正區,幸福里,1019,2,828,21,849,1124,0,0,0,0,0,0,75.53
臺北市,中正區,幸市里,1020,2,963,16,979,1332,0,0,0,0,0,0,73.50
臺北市,中正區,幸市里,1021,2,951,13,964,1289,0,0,0,0,0,0,74.79
臺北市,中正區,幸市里,1022,2,704,9,713,928,0,0,0,0,0,0,76.83
臺北市,中正區,東門里,1023,2,784,18,802,1001,0,0,0,0,0,0,80.12
臺北市,中正區,東門里,1024,2,724,17,741,990,0,0,0,0,0,0,74.85
臺北市,中正區,東門里,1025,2,837,16,853,1097,0,0,0,0,0,0,77.76
臺北市,中正區,文北里,1026,2,1061,16,1077,1408,0,0,0,0,0,0,76.49
臺北市,中正區,文北里,1027,2,1003,19,1022,1351,0,0,0,0,0,0,75.65
臺北市,中正區,文北里,1028,2,939,15,954,1268,0,0,0,0,0,0,75.24
臺北市,中正區,文祥里,1029,2,814,4,818,1035,0,0,0,0,0,0,79.03
臺北市,中正區,文祥里,1030,2,872,6,878,1062,0,0,0,0,0,0,82.67
臺北市,中正區,文祥里,1031,2,829,14,843,1036,0,0,0,0,0,0,81.37
臺北市,中正區,文祥里,1032,2,892,12,904,1107,0,0,0,0,0,0,81.66
臺北市,中正區,文祥里,1033,2,754,16,770,952,0,0,0,0,0,0,80.88
臺北市,中正區,三愛里,1034,2,935,6,941,1254,0,0,0,0,0,0,75.04
臺北市,中正區,三愛里,1035,2,894,12,906,1166,0,0,0,0,0,0,77.70
臺北市,中正區,三愛里,1036,2,925,21,946,1230,0,0,0,0,0,0,76.91
臺北市,中正區,三愛里,1037,2,844,15,859,1109,0,0,0,0,0,0,77.46
臺北市,中正區,三愛里,1038,2,966,18,984,1284,0,0,0,0,0,0,76.64
臺北市,萬華區,福星里,1039,2,1025,15,1040,1325,0,0,0,0,0,0,78.49
臺北市,萬華區,福星里,1040,2,889,18,907,1189,0,0,0,0,0,0,76.28
臺北市,萬華區,福星里,1041,2,1062,24,1086,1424,0,0,0,0,0,0,76.26
臺北市,萬華區,萬壽里,1042,2,726,20,746,1079,0,0,0,0,0,0,69.14
臺北市,萬華區,萬壽里,1043,2,1113,17,1130,1550,0,0,0,0,0,0,72.90
臺北市,萬華區,西門里,1044,2,1153,32,1185,1617,0,0,0,0,0,0,73.28
臺北市,萬華區,西門里,1045,2,945,21,966,1248,0,0,0,0,0,0,77.40
臺北市,萬華區,新起里,1046,2,1080,21,1101,1359,0,0,0,0,0,0,81.02
臺北市,萬華區,新起里,1047,2,1079,46,1125,1383,0,0,0,0,0,0,81.34
臺北市,萬華區,新起里,1048,2,1031,37,1068,1390,0,0,0,0,0,0,76.83
臺北市,萬華區,新起里,1049,2,1213,25,1238,1526,0,0,0,0,0,0,81.13
臺北市,萬華區,菜園里,1050,2,823,20,843,1124,0,0,0,0,0,0,75.00
臺北市,萬華區,菜園里,1051,2,822,16,838,1030,0,0,0,0,0,0,81.36
臺北市,萬華區,菜園里,1052,2,1056,15,1071,1285,0,0,0,0,0,0,83.35
臺北市,萬華區,菜園里,1053,2,952,20,972,1173,0,0,0,0,0,0,82.86
臺北市,萬華區,青山里,1054,2,1091,27,1118,1376,0,0,0,0,0,0,81.25
臺北市,萬華區,青山里,1055,2,1160,31,1191,1462,0,0,0,0,0,0,81.46
臺北市,萬華區,青山里,1056,2,1066,25,1091,1368,0,0,0,0,0,0,79.75
臺北市,萬華區,富民里,1057,2,1075,21,1096,1367,0,0,0,0,0,0,80.18
臺北市,萬華區,富民里,1058,2,1196,24,1220,1482,0,0,0,0,0,0,82.32
臺北市,萬華區,富民里,1059,2,1044,11,1055,1315,0,0,0,0,0,0,80.23
臺北市,萬華區,福音里,1060,2,830,13,843,1012,0,0,0,0,0,0,83.30
臺北市,萬華區,福音里,1061,2,872,15,887,1069,0,0,0,0,0,0,82.97
臺北市,萬華區,福音里,1062,2,846,15,861,1040,0,0,0,0,0,0,82.79
臺北市,萬華區,仁德里,1063,2,860,14,874,1055,0,0,0,0,0,0,82.84
臺北市,萬華區,仁德里,1064,2,1128,18,1146,1394,0,0,0,0,0,0,82.21
臺北市,萬華區,仁德里,1065,2,983,20,1003,1188,0,0,0,0,0,0,84.43
臺北市,萬華區,富福里,1066,2,822,11,833,995,0,0,0,0,0,0,83.72
臺北市,萬華區,富福里,1067,2,1219,24,1243,1495,0,0,0,0,0,0,83.14
臺北市,萬華區,富福里,1068,2,1145,13,1158,1386,0,0,0,0,0,0,83.55
臺北市,萬華區,糖廍里,1069,2,1613,27,1640,1990,0,0,0,0,0,0,82.41
臺北市,萬華區,糖廍里,1070,2,1293,20,1313,1559,0,0,0,0,0,0,84.22
臺北市,萬華區,糖廍里,1071,2,1152,19,1171,1383,0,0,0,0,0,0,84.67
臺北市,萬華區,糖廍里,1072,2,717,8,725,871,0,0,0,0,0,0,83.24
臺北市,萬華區,糖廍里,1073,2,687,13,700,873,0,0,0,0,0,0,80.18
臺北市,萬華區,綠堤里,1074,2,1032,19,1051,1269,0,0,0,0,0,0,82.82
臺北市,萬華區,綠堤里,1075,2,1139,35,1174,1454,0,0,0,0,0,0,80.74
臺北市,萬華區,綠堤里,1076,2,1118,24,1142,1388,0,0,0,0,0,0,82.28
臺北市,萬華區,華江里,1077,2,735,29,764,969,0,0,0,0,0,0,78.84
臺北市,萬華區,華江里,1078,2,886,17,903,1175,0,0,0,0,0,0,76.85
臺北市,萬華區,華江里,1079,2,1023,12,1035,1296,0,0,0,0,0,0,79.86
臺北市,萬華區,柳鄉里,1080,2,996,13,1009,1224,0,0,0,0,0,0,82.43
臺北市,萬華區,柳鄉里,1081,2,883,28,911,1096,0,0,0,0,0,0,83.12
臺北市,萬華區,柳鄉里,1082,2,966,10,976,1174,0,0,0,0,0,0,83.13
臺北市,萬華區,柳鄉里,1083,2,960,21,981,1193,0,0,0,0,0,0,82.23
臺北市,萬華區,柳鄉里,1084,2,877,7,884,1197,0,0,0,0,0,0,73.85
臺北市,萬華區,柳鄉里,1085,2,1096,42,1138,1360,0,0,0,0,0,0,83.68
臺北市,萬華區,壽德里,1086,2,906,16,922,1141,0,0,0,0,0,0,80.81
臺北市,萬華區,壽德里,1087,2,912,20,932,1151,0,0,0,0,0,0,80.97
臺北市,萬華區,壽德里,1088,2,1034,20,1054,1287,0,0,0,0,0,0,81.90
臺北市,萬華區,興德里,1089,2,1201,34,1235,1511,0,0,0,0,0,0,81.73
臺北市,萬華區,興德里,1090,2,1166,28,1194,1439,0,0,0,0,0,0,82.97
臺北市,萬華區,興德里,1091,2,1258,21,1279,1543,0,0,0,0,0,0,82.89
臺北市,萬華區,興德里,1092,2,1208,30,1238,1492,0,0,0,0,0,0,82.98
臺北市,萬華區,華中里,1093,2,1052,15,1067,1309,0,0,0,0,0,0,81.51
臺北市,萬華區,華中里,1094,2,880,27,907,1173,0,0,0,0,0,0,77.32
臺北市,萬華區,華中里,1095,2,828,21,849,1091,0,0,0,0,0,0,77.82
臺北市,萬華區,華中里,1096,2,1040,19,1059,1269,0,0,0,0,0,0,83.45
臺北市,萬華區,日祥里,1097,2,1138,29,1167,1404,0,0,0,0,0,0,83.12
臺北市,萬華區,日祥里,1098,2,1081,30,1111,1328,0,0,0,0,0,0,83.66
臺北市,萬華區,日祥里,1099,2,1116,16,1132,1350,0,0,0,0,0,0,83.85
臺北市,萬華區,日祥里,1100,2,1161,18,1179,1456,0,0,0,0,0,0,80.98
臺北市,萬華區,日祥里,1101,2,1116,28,1144,1472,0,0,0,0,0,0,77.72
臺北市,萬華區,忠貞里,1102,2,1319,39,1358,1677,0,0,0,0,0,0,80.98
臺北市,萬華區,忠貞里,1103,2,1093,27,1120,1381,0,0,0,0,0,0,81.10
臺北市,萬華區,忠貞里,1104,2,1252,34,1286,1565,0,0,0,0,0,0,82.17
臺北市,萬華區,凌霄里,1105,2,859,17,876,1060,0,0,0,0,0,0,82.64
臺北市,萬華區,凌霄里,1106,2,881,12,893,1038,0,0,0,0,0,0,86.03
臺北市,萬華區,凌霄里,1107,2,857,8,865,1015,0,0,0,0,0,0,85.22
臺北市,萬華區,騰雲里,1108,2,1195,31,1226,1516,0,0,0,0,0,0,80.87
臺北市,萬華區,騰雲里,1109,2,1163,29,1192,1453,0,0,0,0,0,0,82.04
臺北市,萬華區,騰雲里,1110,2,930,14,944,1221,0,0,0,0,0,0,77.31
臺北市,萬華區,騰雲里,1111,2,1086,13,1099,1333,0,0,0,0,0,0,82.45
臺北市,萬華區,忠德里,1112,2,1021,20,1041,1281,0,0,0,0,0,0,81.26
臺北市,萬華區,忠德里,1113,2,1034,15,1049,1249,0,0,0,0,0,0,83.99
臺北市,萬華區,忠德里,1114,2,874,27,901,1106,0,0,0,0,0,0,81.46
臺北市,萬華區,孝德里,1115,2,1192,19,1211,1470,0,0,0,0,0,0,82.38
臺北市,萬華區,孝德里,1116,2,984,24,1008,1212,0,0,0,0,0,0,83.17
臺北市,萬華區,和德里,1117,2,1192,23,1215,1482,0,0,0,0,0,0,81.98
臺北市,萬華區,和德里,1118,2,957,34,991,1256,0,0,0,0,0,0,78.90
臺北市,萬華區,和德里,1119,2,1060,31,1091,1393,0,0,0,0,0,0,78.32
臺北市,萬華區,和德里,1120,2,1341,24,1365,1666,0,0,0,0,0,0,81.93
臺北市,萬華區,錦德里,1121,2,1222,32,1254,1487,0,0,0,0,0,0,84.33
臺北市,萬華區,錦德里,1122,2,1225,28,1253,1506,0,0,0,0,0,0,83.20
臺北市,萬華區,錦德里,1123,2,1094,17,1111,1311,0,0,0,0,0,0,84.74
臺北市,萬華區,全德里,1124,2,948,26,974,1205,0,0,0,0,0,0,80.83
臺北市,萬華區,全德里,1125,2,908,7,915,1130,0,0,0,0,0,0,80.97
臺北市,萬華區,全德里,1126,2,696,15,711,871,0,0,0,0,0,0,81.63
臺北市,萬華區,保德里,1127,2,1048,29,1077,1290,0,0,0,0,0,0,83.49
臺北市,萬華區,保德里,1128,2,1017,14,1031,1242,0,0,0,0,0,0,83.01
臺北市,萬華區,銘德里,1129,2,939,21,960,1119,0,0,0,0,0,0,85.79
臺北市,萬華區,銘德里,1130,2,1107,23,1130,1327,0,0,0,0,0,0,85.15
臺北市,萬華區,銘德里,1131,2,1179,23,1202,1457,0,0,0,0,0,0,82.50
臺北市,萬華區,榮德里,1132,2,821,20,841,981,0,0,0,0,0,0,85.73
臺北市,萬華區,榮德里,1133,2,925,36,961,1136,0,0,0,0,0,0,84.60
臺北市,萬華區,榮德里,1134,2,1062,16,1078,1260,0,0,0,0,0,0,85.56
臺北市,萬華區,和平里,1135,2,1268,19,1287,1500,0,0,0,0,0,0,85.80
臺北市,萬華區,和平里,1136,2,1097,15,1112,1371,0,0,0,0,0,0,81.11
臺北市,萬華區,和平里,1137,2,981,13,994,1172,0,0,0,0,0,0,84.81
臺北市,萬華區,日善里,1138,2,1028,13,1041,1264,0,0,0,0,0,0,82.36
臺北市,萬華區,日善里,1139,2,1081,19,1100,1329,0,0,0,0,0,0,82.77
臺北市,萬華區,日善里,1140,2,1008,25,1033,1278,0,0,0,0,0,0,80.83
臺北市,萬華區,新安里,1141,2,1125,21,1146,1358,0,0,0,0,0,0,84.39
臺北市,萬華區,新安里,1142,2,1268,26,1294,1563,0,0,0,0,0,0,82.79
臺北市,萬華區,新安里,1143,2,955,25,980,1152,0,0,0,0,0,0,85.07
臺北市,萬華區,新安里,1144,2,945,15,960,1147,0,0,0,0,0,0,83.70
臺北市,萬華區,頂碩里,1145,2,1368,30,1398,1702,0,0,0,0,0,0,82.14
臺北市,萬華區,頂碩里,1146,2,1006,30,1036,1256,0,0,0,0,0,0,82.48
臺北市,萬華區,頂碩里,1147,2,1021,23,1044,1273,0,0,0,0,0,0,82.01
臺北市,萬華區,雙園里,1148,2,826,17,843,1014,0,0,0,0,0,0,83.14
臺北市,萬華區,雙園里,1149,2,972,19,991,1189,0,0,0,0,0,0,83.35
臺北市,萬華區,雙園里,1150,2,941,17,958,1160,0,0,0,0,0,0,82.59
臺北市,萬華區,雙園里,1151,2,803,14,817,1014,0,0,0,0,0,0,80.57
臺北市,萬華區,新忠里,1152,2,917,30,947,1152,0,0,0,0,0,0,82.20
臺北市,萬華區,新忠里,1153,2,955,10,965,1157,0,0,0,0,0,0,83.41
臺北市,萬華區,新忠里,1154,2,1022,25,1047,1317,0,0,0,0,0,0,79.50
臺北市,萬華區,新和里,1155,2,1012,20,1032,1317,0,0,0,0,0,0,78.36
臺北市,萬華區,新和里,1156,2,1027,11,1038,1246,0,0,0,0,0,0,83.31
臺北市,大安區,德安里,1157,2,1115,16,1131,1443,0,0,0,0,0,0,78.38
臺北市,大安區,德安里,1158,2,1080,19,1099,1547,0,0,0,0,0,0,71.04
臺北市,大安區,德安里,1159,2,1031,23,1054,1461,0,0,0,0,0,0,72.14
臺北市,大安區,仁慈里,1160,2,946,10,956,1284,0,0,0,0,0,0,74.45
臺北市,大安區,仁慈里,1161,2,814,11,825,1120,0,0,0,0,0,0,73.66
臺北市,大安區,仁慈里,1162,2,975,13,988,1307,0,0,0,0,0,0,75.59
臺北市,大安區,和安里,1163,2,811,9,820,1140,0,0,0,0,0,0,71.93
臺北市,大安區,和安里,1164,2,1025,24,1049,1350,0,0,0,0,0,0,77.70
臺北市,大安區,和安里,1165,2,1130,14,1144,1391,0,0,0,0,0,0,82.24
臺北市,大安區,和安里,1166,2,972,17,989,1237,0,0,0,0,0,0,79.95
臺北市,大安區,民炤里,1167,2,974,20,994,1276,0,0,0,0,0,0,77.90
臺北市,大安區,民炤里,1168,2,885,12,897,1221,0,0,0,0,0,0,73.46
臺北市,大安區,民炤里,1169,2,971,12,983,1258,0,0,0,0,0,0,78.14
臺北市,大安區,民炤里,1170,2,913,14,927,1246,0,0,0,0,0,0,74.40
臺北市,大安區,民炤里,1171,2,857,13,870,1242,0,0,0,0,0,0,70.05
臺北市,大安區,仁愛里,1172,2,747,15,762,1056,0,0,0,0,0,0,72.16
臺北市,大安區,仁愛里,1173,2,821,13,834,1218,0,0,0,0,0,0,68.47
臺北市,大安區,仁愛里,1174,2,857,13,870,1211,0,0,0,0,0,0,71.84
臺北市,大安區,仁愛里,1175,2,676,9,685,1007,0,0,0,0,0,0,68.02
臺北市,大安區,義村里,1176,2,1066,11,1077,1405,0,0,0,0,0,0,76.65
臺北市,大安區,義村里,1177,2,1163,15,1178,1510,0,0,0,0,0,0,78.01
臺北市,大安區,義村里,1178,2,1073,13,1086,1368,0,0,0,0,0,0,79.39
臺北市,大安區,義村里,1179,2,993,10,1003,1320,0,0,0,0,0,0,75.98
臺北市,大安區,民輝里,1180,2,838,17,855,1118,0,0,0,0,0,0,76.48
臺北市,大安區,民輝里,1181,2,925,17,942,1236,0,0,0,0,0,0,76.21
臺北市,大安區,民輝里,1182,2,712,7,719,1016,0,0,0,0,0,0,70.77
臺北市,大安區,民輝里,1183,2,1040,22,1062,1354,0,0,0,0,0,0,78.43
臺北市,大安區,昌隆里,1184,2,797,9,806,1049,0,0,0,0,0,0,76.84
臺北市,大安區,昌隆里,1185,2,768,11,779,1045,0,0,0,0,0,0,74.55
臺北市,大安區,昌隆里,1186,2,854,14,868,1149,0,0,0,0,0,0,75.54
臺北市,大安區,誠安里,1187,2,895,9,904,1235,0,0,0,0,0,0,73.20
臺北市,大安區,誠安里,1188,2,953,16,969,1260,0,0,0,0,0,0,76.90
臺北市,大安區,誠安里,1189,2,828,10,838,1070,0,0,0,0,0,0,78.32
臺北市,大安區,光武里,1190,2,1065,26,1091,1616,0,0,0,0,0,0,67.51
臺北市,大安區,光武里,1191,2,1162,22,1184,1530,0,0,0,0,0,0,77.39
臺北市,大安區,光武里,1192,2,1095,16,1111,1477,0,0,0,0,0,0,75.22
臺北市,大安區,光武里,1193,2,1046,16,1062,1493,0,0,0,0,0,0,71.13
臺北市,大安區,龍坡里,1194,2,1141,18,1159,1510,0,0,0,0,0,0,76.75
臺北市,大安區,龍坡里,1195,2,974,19,993,1227,0,0,0,0,0,0,80.93
臺北市,大安區,龍坡里,1196,2,1133,13,1146,1487,0,0,0,0,0,0,77.07
臺北市,大安區,龍泉里,1197,2,763,14,777,1081,0,0,0,0,0,0,71.88
臺北市,大安區,龍泉里,1198,2,943,11,954,1188,0,0,0,0,0,0,80.30
臺北市,大安區,龍泉里,1199,2,881,25,906,1191,0,0,0,0,0,0,76.07
臺北市,大安區,古風里,1200,2,825,10,835,1057,0,0,0,0,0,0,79.00
臺北市,大安區,古風里,1201,2,787,17,804,1021,0,0,0,0,0,0,78.75
臺北市,大安區,古風里,1202,2,899,12,911,1154,0,0,0,0,0,0,78.94
臺北市,大安區,古莊里,1203,2,879,14,893,1135,0,0,0,0,0,0,78.68
臺北市,大安區,古莊里,1204,2,1075,23,1098,1367,0,0,0,0,0,0,80.32
臺北市,大安區,古莊里,1205,2,1001,25,1026,1311,0,0,0,0,0,0,78.26
臺北市,大安區,古莊里,1206,2,885,13,898,1140,0,0,0,0,0,0,78.77
臺北市,大安區,龍安里,1207,2,1043,17,1060,1444,0,0,0,0,0,0,73.41
臺北市,大安區,龍安里,1208,2,937,13,950,1223,0,0,0,0,0,0,77.68
臺北市,大安區,龍安里,1209,2,958,22,980,1224,0,0,0,0,0,0,80.07
臺北市,大安區,錦安里,1210,2,955,13,968,1221,0,0,0,0,0,0,79.28
臺北市,大安區,錦安里,1211,2,823,10,833,1129,0,0,0,0,0,0,73.78
臺北市,大安區,錦安里,1212,2,1081,13,1094,1379,0,0,0,0,0,0,79.33
臺北市,大安區,福住里,1213,2,992,8,1000,1238,0,0,0,0,0,0,80.78
臺北市,大安區,福住里,1214,2,973,11,984,1262,0,0,0,0,0,0,77.97
臺北市,大安區,福住里,1215,2,1064,23,1087,1391,0,0,0,0,0,0,78.15
臺北市,大安區,永康里,1216,2,1045,9,1054,1319,0,0,0,0,0,0,79.91
臺北市,大安區,永康里,1217,2,959,14,973,1240,0,0,0,0,0,0,78.47
臺北市,大安區,光明里,1218,2,684,10,694,897,0,0,0,0,0,0,77.37
臺北市,大安區,光明里,1219,2,848,7,855,1039,0,0,0,0,0,0,82.29
臺北市,大安區,光明里,1220,2,684,10,694,881,0,0,0,0,0,0,78.77
臺北市,大安區,錦泰里,1221,2,1126,23,1149,1430,0,0,0,0,0,0,80.35
臺北市,大安區,錦泰里,1222,2,1020,15,1035,1269,0,0,0,0,0,0,81.56
臺北市,大安區,錦泰里,1223,2,1068,6,1074,1326,0,0,0,0,0,0,81.00
臺北市,大安區,錦華里,1224,2,1124,9,1133,1430,0,0,0,0,0,0,79.23
臺北市,大安區,錦華里,1225,2,1070,24,1094,1375,0,0,0,0,0,0,79.56
臺北市,大安區,錦華里,1226,2,1052,14,1066,1334,0,0,0,0,0,0,79.91
臺北市,大安區,龍圖里,1227,2,1008,16,1024,1301,0,0,0,0,0,0,78.71
臺北市,大安區,龍圖里,1228,2,987,14,1001,1236,0,0,0,0,0,0,80.99
臺北市,大安區,龍圖里,1229,2,895,20,915,1230,0,0,0,0,0,0,74.39
臺北市,大安區,龍圖里,1230,2,1113,7,1120,1410,0,0,0,0,0,0,79.43
臺北市,大安區,新龍里,1231,2,1017,10,1027,1341,0,0,0,0,0,0,76.58
臺北市,大安區,新龍里,1232,2,933,8,941,1152,0,0,0,0,0,0,81.68
臺北市,大安區,新龍里,1233,2,1006,21,1027,1272,0,0,0,0,0,0,80.74
臺北市,大安區,新龍里,1234,2,915,10,925,1169,0,0,0,0,0,0,79.13
臺北市,大安區,龍陣里,1235,2,1069,15,1084,1419,0,0,0,0,0,0,76.39
臺北市,大安區,龍陣里,1236,2,1223,13,1236,1598,0,0,0,0,0,0,77.35
臺北市,大安區,龍雲里,1237,2,995,14,1009,1232,0,0,0,0,0,0,81.90
臺北市,大安區,龍雲里,1238,2,1099,20,1119,1402,0,0,0,0,0,0,79.81
臺北市,大安區,龍雲里,1239,2,1052,13,1065,1403,0,0,0,0,0,0,75.91
臺北市,大安區,龍生里,1240,2,992,17,1009,1200,0,0,0,0,0,0,84.08
臺北市,大安區,龍生里,1241,2,934,14,948,1179,0,0,0,0,0,0,80.41
臺北市,大安區,龍生里,1242,2,849,8,857,1128,0,0,0,0,0,0,75.98
臺北市,大安區,龍生里,1243,2,949,14,963,1249,0,0,0,0,0,0,77.10
臺北市,大安區,住安里,1244,2,1223,19,1242,1577,0,0,0,0,0,0,78.76
臺北市,大安區,住安里,1245,2,1029,30,1059,1342,0,0,0,0,0,0,78.91
臺北市,大安區,住安里,1246,2,1200,17,1217,1580,0,0,0,0,0,0,77.03
臺北市,大安區,義安里,1247,2,1034,25,1059,1376,0,0,0,0,0,0,76.96
臺北市,大安區,義安里,1248,2,1195,13,1208,1572,0,0,0,0,0,0,76.84
臺北市,大安區,義安里,1249,2,1050,14,1064,1404,0,0,0,0,0,0,75.78
臺北市,大安區,通化里,1250,2,1058,18,1076,1306,0,0,0,0,0,0,82.39
臺北市,大安區,通化里,1251,2,1016,27,1043,1297,0,0,0,0,0,0,80.42
臺北市,大安區,通化里,1252,2,1013,17,1030,1284,0,0,0,0,0,0,80.22
臺北市,大安區,通化里,1253,2,884,18,902,1091,0,0,0,0,0,0,82.68
臺北市,大安區,通安里,1254,2,1327,30,1357,1710,0,0,0,0,0,0,79.36
臺北市,大安區,通安里,1255,2,1085,10,1095,1369,0,0,0,0,0,0,79.99
臺北市,大安區,通安里,1256,2,1104,25,1129,1402,0,0,0,0,0,0,80.53
臺北市,大安區,臨江里,1257,2,1018,27,1045,1281,0,0,0,0,0,0,81.58
臺北市,大安區,臨江里,1258,2,829,32,861,1055,0,0,0,0,0,0,81.61
臺北市,大安區,臨江里,1259,2,954,28,982,1224,0,0,0,0,0,0,80.23
臺北市,大安區,法治里,1260,2,938,19,957,1201,0,0,0,0,0,0,79.68
臺北市,大安區,法治里,1261,2,908,19,927,1169,0,0,0,0,0,0,79.30
臺北市,大安區,法治里,1262,2,818,9,827,1041,0,0,0,0,0,0,79.44
臺北市,大安區,全安里,1263,2,833,2,835,1099,0,0,0,0,0,0,75.98
臺北市,大安區,全安里,1264,2,905,11,916,1182,0,0,0,0,0,0,77.50
臺北市,大安區,全安里,1265,2,878,18,896,1142,0,0,0,0,0,0,78.46
臺北市,大安區,群賢里,1266,2,930,12,942,1235,0,0,0,0,0,0,76.28
臺北市,大安區,群賢里,1267,2,814,16,830,1011,0,0,0,0,0,0,82.10
臺北市,大安區,群賢里,1268,2,943,14,957,1290,0,0,0,0,0,0,74.19
臺北市,大安區,群賢里,1269,2,1060,7,1067,1399,0,0,0,0,0,0,76.27
臺北市,大安區,群英里,1270,2,1163,10,1173,1476,0,0,0,0,0,0,79.47
臺北市,大安區,群英里,1271,2,1221,8,1229,1526,0,0,0,0,0,0,80.54
臺北市,大安區,群英里,1272,2,1168,16,1184,1479,0,0,0,0,0,0,80.05
臺北市,大安區,群英里,1273,2,1095,13,1108,1348,0,0,0,0,0,0,82.20
臺北市,大安區,虎嘯里,1274,2,858,12,870,1122,0,0,0,0,0,0,77.54
臺北市,大安區,虎嘯里,1275,2,1092,15,1107,1473,0,0,0,0,0,0,75.15
臺北市,大安區,臥龍里,1276,2,940,24,964,1203,0,0,0,0,0,0,80.13
臺北市,大安區,臥龍里,1277,2,989,8,997,1284,0,0,0,0,0,0,77.65
臺北市,大安區,龍淵里,1278,2,968,13,981,1246,0,0,0,0,0,0,78.73
臺北市,大安區,龍淵里,1279,2,1021,12,1033,1337,0,0,0,0,0,0,77.26
臺北市,大安區,龍淵里,1280,2,1137,13,1150,1434,0,0,0,0,0,0,80.20
臺北市,大安區,龍淵里,1281,2,1081,10,1091,1426,0,0,0,0,0,0,76.51
臺北市,大安區,龍淵里,1282,2,1070,10,1080,1345,0,0,0,0,0,0,80.30
臺北市,大安區,龍門里,1283,2,964,24,988,1311,0,0,0,0,0,0,75.36
臺北市,大安區,龍門里,1284,2,727,12,739,1015,0,0,0,0,0,0,72.81
臺北市,大安區,龍門里,1285,2,1175,16,1191,1518,0,0,0,0,0,0,78.46
臺北市,大安區,農場里,1286,2,785,21,806,986,0,0,0,0,0,0,81.74
臺北市,大安區,農場里,1287,2,708,10,718,1030,0,0,0,0,0,0,69.71
臺北市,大安區,大學里,1288,2,1125,12,1137,1469,0,0,0,0,0,0,77.40
臺北市,大安區,大學里,1289,2,1000,24,1024,1320,0,0,0,0,0,0,77.58
臺北市,大安區,大學里,1290,2,1000,12,1012,1317,0,0,0,0,0,0,76.84
臺北市,大安區,大學里,1291,2,778,14,792,1078,0,0,0,0,0,0,73.47
臺北市,大安區,大學里,1292,2,927,7,934,1207,0,0,0,0,0,0,77.38
臺北市,大安區,芳和里,1293,2,947,15,962,1157,0,0,0,0,0,0,83.15
臺北市,大安區,芳和里,1294,2,936,18,954,1174,0,0,0,0,0,0,81.26
臺北市,大安區,芳和里,1295,2,1005,22,1027,1256,0,0,0,0,0,0,81.77
臺北市,大安區,芳和里,1296,2,970,13,983,1242,0,0,0,0,0,0,79.15
臺北市,大安區,青峰里,1297,2,674,21,695,898,0,0,0,0,0,0,77.39
臺北市,大安區,青峰里,1298,2,636,19,655,931,0,0,0,0,0,0,70.35
臺北市,大安區,黎元里,1299,2,832,19,851,1040,0,0,0,0,0,0,81.83
臺北市,大安區,黎元里,1300,2,977,16,993,1221,0,0,0,0,0,0,81.33
臺北市,大安區,黎元里,1301,2,937,23,960,1178,0,0,0,0,0,0,81.49
臺北市,大安區,黎元里,1302,2,801,27,828,992,0,0,0,0,0,0,83.47
臺北市,大安區,黎孝里,1303,2,957,7,964,1216,0,0,0,0,0,0,79.28
臺北市,大安區,黎孝里,1304,2,1035,11,1046,1260,0,0,0,0,0,0,83.02
臺北市,大安區,黎孝里,1305,2,1086,18,1104,1328,0,0,0,0,0,0,83.13
臺北市,大安區,黎孝里,1306,2,854,19,873,1087,0,0,0,0,0,0,80.31
臺北市,大安區,黎孝里,1307,2,840,18,858,1059,0,0,0,0,0,0,81.02
臺北市,大安區,黎和里,1308,2,733,11,744,942,0,0,0,0,0,0,78.98
臺北市,大安區,黎和里,1309,2,988,8,996,1186,0,0,0,0,0,0,83.98
臺北市,大安區,黎和里,1310,2,945,29,974,1181,0,0,0,0,0,0,82.47
臺北市,大安區,建安里,1311,2,1053,13,1066,1456,0,0,0,0,0,0,73.21
臺北市,大安區,建安里,1312,2,778,17,795,1144,0,0,0,0,0,0,69.49
臺北市,大安區,建安里,1313,2,1030,14,1044,1390,0,0,0,0,0,0,75.11
臺北市,大安區,建倫里,1314,2,819,13,832,1202,0,0,0,0,0,0,69.22
臺北市,大安區,建倫里,1315,2,806,10,816,1095,0,0,0,0,0,0,74.52
臺北市,大安區,建倫里,1316,2,816,16,832,1108,0,0,0,0,0,0,75.09
臺北市,大安區,建倫里,1317,2,937,15,952,1261,0,0,0,0,0,0,75.50
臺北市,大安區,敦安里,1318,2,853,16,869,1155,0,0,0,0,0,0,75.24
臺北市,大安區,敦安里,1319,2,908,21,929,1164,0,0,0,0,0,0,79.81
臺北市,大安區,敦安里,1320,2,831,24,855,1146,0,0,0,0,0,0,74.61
臺北市,大安區,敦安里,1321,2,1010,12,1022,1327,0,0,0,0,0,0,77.02
臺北市,大安區,正聲里,1322,2,917,8,925,1209,0,0,0,0,0,0,76.51
臺北市,大安區,正聲里,1323,2,921,23,944,1177,0,0,0,0,0,0,80.20
臺北市,大安區,正聲里,1324,2,972,23,995,1392,0,0,0,0,0,0,71.48
臺北市,大安區,敦煌里,1325,2,931,14,945,1202,0,0,0,0,0,0,78.62
臺北市,大安區,敦煌里,1326,2,781,13,794,1029,0,0,0,0,0,0,77.16
臺北市,大安區,敦煌里,1327,2,885,13,898,1130,0,0,0,0,0,0,79.47
臺北市,大安區,敦煌里,1328,2,937,13,950,1238,0,0,0,0,0,0,76.74
臺北市,大安區,華聲里,1329,2,769,11,780,1060,0,0,0,0,0,0,73.58
臺北市,大安區,華聲里,1330,2,847,19,866,1086,0,0,0,0,0,0,79.74
臺北市,大安區,華聲里,1331,2,928,13,941,1212,0,0,0,0,0,0,77.64
臺北市,大安區,車層里,1332,2,929,24,953,1221,0,0,0,0,0,0,78.05
臺北市,大安區,車層里,1333,2,1090,25,1115,1491,0,0,0,0,0,0,74.78
臺北市,大安區,車層里,1334,2,788,18,806,1096,0,0,0,0,0,0,73.54
臺北市,大安區,車層里,1335,2,999,24,1023,1304,0,0,0,0,0,0,78.45
臺北市,大安區,光信里,1336,2,833,16,849,1075,0,0,0,0,0,0,78.98
臺北市,大安區,光信里,1337,2,869,19,888,1111,0,0,0,0,0,0,79.93
臺北市,大安區,光信里,1338,2,960,14,974,1266,0,0,0,0,0,0,76.94
臺北市,大安區,光信里,1339,2,896,11,907,1173,0,0,0,0,0,0,77.32
臺北市,大安區,光信里,1340,2,1012,18,1030,1316,0,0,0,0,0,0,78.27
臺北市,文山區,景行里,1341,2,1187,21,1208,1448,0,0,0,0,0,0,83.43
臺北市,文山區,景行里,1342,2,1055,9,1064,1287,0,0,0,0,0,0,82.67
臺北市,文山區,景行里,1343,2,920,11,931,1150,0,0,0,0,0,0,80.96
臺北市,文山區,景東里,1344,2,968,22,990,1230,0,0,0,0,0,0,80.49
臺北市,文山區,景東里,1345,2,949,18,967,1195,0,0,0,0,0,0,80.92
臺北市,文山區,景東里,1346,2,924,20,944,1147,0,0,0,0,0,0,82.30
臺北市,文山區,景東里,1347,2,987,9,996,1195,0,0,0,0,0,0,83.35
臺北市,文山區,景美里,1348,2,981,18,999,1206,0,0,0,0,0,0,82.84
臺北市,文山區,景美里,1349,2,964,13,977,1161,0,0,0,0,0,0,84.15
臺北市,文山區,景美里,1350,2,787,15,802,995,0,0,0,0,0,0,80.60
臺北市,文山區,景慶里,1351,2,920,17,937,1174,0,0,0,0,0,0,79.81
臺北市,文山區,景慶里,1352,2,943,17,960,1169,0,0,0,0,0,0,82.12
臺北市,文山區,景慶里,1353,2,985,8,993,1206,0,0,0,0,0,0,82.34
臺北市,文山區,景慶里,1354,2,1009,22,1031,1234,0,0,0,0,0,0,83.55
臺北市,文山區,景仁里,1355,2,910,24,934,1125,0,0,0,0,0,0,83.02
臺北市,文山區,景仁里,1356,2,954,23,977,1206,0,0,0,0,0,0,81.01
臺北市,文山區,景仁里,1357,2,1118,6,1124,1318,0,0,0,0,0,0,85.28
臺北市,文山區,景華里,1358,2,1158,18,1176,1453,0,0,0,0,0,0,80.94
臺北市,文山區,景華里,1359,2,1185,16,1201,1493,0,0,0,0,0,0,80.44
臺北市,文山區,景華里,1360,2,1123,9,1132,1356,0,0,0,0,0,0,83.48
臺北市,文山區,萬有里,1361,2,1087,21,1108,1324,0,0,0,0,0,0,83.69
臺北市,文山區,萬有里,1362,2,883,15,898,1075,0,0,0,0,0,0,83.53
臺北市,文山區,萬有里,1363,2,950,3,953,1128,0,0,0,0,0,0,84.49
臺北市,文山區,萬祥里,1364,2,985,19,1004,1197,0,0,0,0,0,0,83.88
臺北市,文山區,萬祥里,1365,2,901,18,919,1105,0,0,0,0,0,0,83.17
臺北市,文山區,萬祥里,1366,2,1005,23,1028,1226,0,0,0,0,0,0,83.85
臺北市,文山區,萬隆里,1367,2,1170,13,1183,1458,0,0,0,0,0,0,81.14
臺北市,文山區,萬隆里,1368,2,1134,15,1149,1394,0,0,0,0,0,0,82.42
臺北市,文山區,萬隆里,1369,2,1212,13,1225,1479,0,0,0,0,0,0,82.83
臺北市,文山區,萬年里,1370,2,980,23,1003,1247,0,0,0,0,0,0,80.43
臺北市,文山區,萬年里,1371,2,1032,27,1059,1347,0,0,0,0,0,0,78.62
臺北市,文山區,萬年里,1372,2,1127,16,1143,1441,0,0,0,0,0,0,79.32
臺北市,文山區,萬和里,1373,2,1207,25,1232,1474,0,0,0,0,0,0,83.58
臺北市,文山區,萬和里,1374,2,1152,26,1178,1393,0,0,0,0,0,0,84.57
臺北市,文山區,萬盛里,1375,2,962,14,976,1228,0,0,0,0,0,0,79.48
臺北市,文山區,萬盛里,1376,2,1062,22,1084,1343,0,0,0,0,0,0,80.71
臺北市,文山區,萬盛里,1377,2,942,12,954,1187,0,0,0,0,0,0,80.37
臺北市,文山區,興豐里,1378,2,1231,17,1248,1504,0,0,0,0,0,0,82.98
臺北市,文山區,興豐里,1379,2,1126,30,1156,1415,0,0,0,0,0,0,81.70
臺北市,文山區,興豐里,1380,2,1115,7,1122,1397,0,0,0,0,0,0,80.31
臺北市,文山區,興豐里,1381,2,1171,25,1196,1426,0,0,0,0,0,0,83.87
臺北市,文山區,興光里,1382,2,937,25,962,1183,0,0,0,0,0,0,81.32
臺北市,文山區,興光里,1383,2,934,16,950,1182,0,0,0,0,0,0,80.37
臺北市,文山區,興光里,1384,2,1109,16,1125,1341,0,0,0,0,0,0,83.89
臺北市,文山區,興家里,1385,2,809,16,825,994,0,0,0,0,0,0,83.00
臺北市,文山區,興家里,1386,2,1269,14,1283,1511,0,0,0,0,0,0,84.91
臺北市,文山區,興家里,1387,2,1392,19,1411,1735,0,0,0,0,0,0,81.33
臺北市,文山區,興得里,1388,2,1213,17,1230,1498,0,0,0,0,0,0,82.11
臺北市,文山區,興得里,1389,2,1248,13,1261,1567,0,0,0,0,0,0,80.47
臺北市,文山區,興得里,1390,2,1205,25,1230,1533,0,0,0,0,0,0,80.23
臺北市,文山區,興業里,1391,2,1207,10,1217,1487,0,0,0,0,0,0,81.84
臺北市,文山區,興業里,1392,2,1154,18,1172,1390,0,0,0,0,0,0,84.32
臺北市,文山區,興業里,1393,2,1063,21,1084,1342,0,0,0,0,0,0,80.77
臺北市,文山區,興安里,1394,2,1242,16,1258,1513,0,0,0,0,0,0,83.15
臺北市,文山區,興安里,1395,2,1033,19,1052,1293,0,0,0,0,0,0,81.36
臺北市,文山區,興安里,1396,2,1194,13,1207,1472,0,0,0,0,0,0,82.00
臺北市,文山區,興福里,1397,2,1142,19,1161,1365,0,0,0,0,0,0,85.05
臺北市,文山區,興福里,1398,2,1166,29,1195,1452,0,0,0,0,0,0,82.30
臺北市,文山區,興福里,1399,2,1220,23,1243,1479,0,0,0,0,0,0,84.04
臺北市,文山區,興旺里,1400,2,1345,35,1380,1690,0,0,0,0,0,0,81.66
臺北市,文山區,興旺里,1401,2,1032,15,1047,1263,0,0,0,0,0,0,82.90
臺北市,文山區,興旺里,1402,2,1203,19,1222,1509,0,0,0,0,0,0,80.98
臺北市,文山區,興泰里,1403,2,1227,21,1248,1486,0,0,0,0,0,0,83.98
臺北市,文山區,興泰里,1404,2,1113,24,1137,1381,0,0,0,0,0,0,82.33
臺北市,文山區,興昌里,1405,2,1028,15,1043,1300,0,0,0,0,0,0,80.23
臺北市,文山區,興昌里,1406,2,1099,23,1122,1354,0,0,0,0,0,0,82.87
臺北市,文山區,興昌里,1407,2,1164,15,1179,1422,0,0,0,0,0,0,82.91
臺北市,文山區,試院里,1408,2,1070,14,1084,1298,0,0,0,0,0,0,83.51
臺北市,文山區,試院里,1409,2,735,21,756,984,0,0,0,0,0,0,76.83
臺北市,文山區,試院里,1410,2,952,9,961,1155,0,0,0,0,0,0,83.20
臺北市,文山區,試院里,1411,2,1066,20,1086,1310,0,0,0,0,0,0,82.90
臺北市,文山區,華興里,1412,2,1085,17,1102,1320,0,0,0,0,0,0,83.48
臺北市,文山區,華興里,1413,2,1038,19,1057,1300,0,0,0,0,0,0,81.31
臺北市,文山區,華興里,1414,2,1013,18,1031,1283,0,0,0,0,0,0,80.36
臺北市,文山區,華興里,1415,2,1024,28,1052,1334,0,0,0,0,0,0,78.86
臺北市,文山區,明義里,1416,2,830,58,888,1187,0,0,0,0,0,0,74.81
臺北市,文山區,明義里,1417,2,660,32,692,988,0,0,0,0,0,0,70.04
臺北市,文山區,明義里,1418,2,1138,19,1157,1413,0,0,0,0,0,0,81.88
臺北市,文山區,明興里,1419,2,1050,23,1073,1306,0,0,0,0,0,0,82.16
臺北市,文山區,明興里,1420,2,1037,30,1067,1355,0,0,0,0,0,0,78.75
臺北市,文山區,明興里,1421,2,957,16,973,1182,0,0,0,0,0,0,82.32
臺北市,文山區,明興里,1422,2,1127,18,1145,1346,0,0,0,0,0,0,85.07
臺北市,文山區,木柵里,1423,2,1171,21,1192,1420,0,0,0,0,0,0,83.94
臺北市,文山區,木柵里,1424,2,1200,30,1230,1465,0,0,0,0,0,0,83.96
臺北市,文山區,木柵里,1425,2,1091,24,1115,1319,0,0,0,0,0,0,84.53
臺北市,文山區,木柵里,1426,2,1272,22,1294,1554,0,0,0,0,0,0,83.27
臺北市,文山區,木新里,1427,2,1094,25,1119,1363,0,0,0,0,0,0,82.10
臺北市,文山區,木新里,1428,2,998,22,1020,1254,0,0,0,0,0,0,81.34
臺北市,文山區,木新里,1429,2,1185,32,1217,1471,0,0,0,0,0,0,82.73
臺北市,文山區,木新里,1430,2,1032,6,1038,1279,0,0,0,0,0,0,81.16
臺北市,文山區,木新里,1431,2,887,26,913,1115,0,0,0,0,0,0,81.88
臺北市,文山區,順興里,1432,2,1261,31,1292,1554,0,0,0,0,0,0,83.14
臺北市,文山區,順興里,1433,2,1271,17,1288,1517,0,0,0,0,0,0,84.90
臺北市,文山區,順興里,1434,2,1161,18,1179,1441,0,0,0,0,0,0,81.82
臺北市,文山區,順興里,1435,2,1263,21,1284,1592,0,0,0,0,0,0,80.65
臺北市,文山區,順興里,1436,2,1148,23,1171,1436,0,0,0,0,0,0,81.55
臺北市,文山區,樟林里,1437,2,1030,12,1042,1303,0,0,0,0,0,0,79.97
臺北市,文山區,樟林里,1438,2,1106,19,1125,1342,0,0,0,0,0,0,83.83
臺北市,文山區,樟林里,1439,2,1139,18,1157,1378,0,0,0,0,0,0,83.96
臺北市,文山區,樟林里,1440,2,913,10,923,1119,0,0,0,0,0,0,82.48
臺北市,文山區,樟林里,1441,2,1076,24,1100,1315,0,0,0,0,0,0,83.65
臺北市,文山區,樟新里,1442,2,1045,17,1062,1261,0,0,0,0,0,0,84.22
臺北市,文山區,樟新里,1443,2,1020,12,1032,1231,0,0,0,0,0,0,83.83
臺北市,文山區,樟新里,1444,2,868,22,890,1119,0,0,0,0,0,0,79.54
臺北市,文山區,樟新里,1445,2,1081,20,1101,1349,0,0,0,0,0,0,81.62
臺北市,文山區,樟新里,1446,2,1332,28,1360,1621,0,0,0,0,0,0,83.90
臺北市,文山區,樟新里,1447,2,1188,19,1207,1455,0,0,0,0,0,0,82.96
臺北市,文山區,樟腳里,1448,2,1362,27,1389,1671,0,0,0,0,0,0,83.12
臺北市,文山區,樟腳里,1449,2,1167,23,1190,1437,0,0,0,0,0,0,82.81
臺北市,文山區,樟腳里,1450,2,880,16,896,1106,0,0,0,0,0,0,81.01
臺北市,文山區,樟腳里,1451,2,1089,21,1110,1325,0,0,0,0,0,0,83.77
臺北市,文山區,樟腳里,1452,2,1251,15,1266,1510,0,0,0,0,0,0,83.84
臺北市,文山區,萬芳里,1453,2,736,12,748,896,0,0,0,0,0,0,83.48
臺北市,文山區,萬芳里,1454,2,1127,19,1146,1405,0,0,0,0,0,0,81.57
臺北市,文山區,萬芳里,1455,2,1098,21,1119,1373,0,0,0,0,0,0,81.50
臺北市,文山區,萬芳里,1456,2,1027,15,1042,1229,0,0,0,0,0,0,84.78
臺北市,文山區,萬芳里,1457,2,1132,26,1158,1432,0,0,0,0,0,0,80.87
臺北市,文山區,萬芳里,1458,2,1497,21,1518,1848,0,0,0,0,0,0,82.14
臺北市,文山區,博嘉里,1459,2,1066,23,1089,1357,0,0,0,0,0,0,80.25
臺北市,文山區,博嘉里,1460,2,1224,27,1251,1589,0,0,0,0,0,0,78.73
臺北市,文山區,萬興里,1461,2,1251,23,1274,1631,0,0,0,0,0,0,78.11
臺北市,文山區,萬興里,1462,2,1316,23,1339,1644,0,0,0,0,0,0,81.45
臺北市,文山區,萬興里,1463,2,1273,27,1300,1588,0,0,0,0,0,0,81.86
臺北市,文山區,萬興里,1464,2,1032,27,1059,1287,0,0,0,0,0,0,82.28
臺北市,文山區,指南里,1465,2,1059,25,1084,1330,0,0,0,0,0,0,81.50
臺北市,文山區,指南里,1466,2,567,21,588,696,0,0,0,0,0,0,84.48
臺北市,文山區,老泉里,1467,2,518,12,530,621,0,0,0,0,0,0,85.35
高雄市,鹽埕區,藍橋里,1,1,803,20,823,1021,0,0,0,0,0,0,80.61
高雄市,鹽埕區,慈愛里,2,1,523,8,531,647,0,0,0,0,0,0,82.07
高雄市,鹽埕區,博愛里,3,1,804,19,823,957,0,0,0,0,0,0,86.00
高雄市,鹽埕區,壽星里,4,1,1049,16,1065,1334,0,0,0,0,0,0,79.84
高雄市,鹽埕區,中山里,5,1,1059,6,1065,1316,0,0,0,0,0,0,80.93
高雄市,鹽埕區,教仁里,6,1,1737,32,1769,2182,0,0,0,0,0,0,81.07
高雄市,鹽埕區,新樂里,7,1,665,9,674,839,0,0,0,0,0,0,80.33
高雄市,鹽埕區,中原里,8,1,583,11,594,732,0,0,0,0,0,0,81.15
高雄市,鹽埕區,光明里,9,1,890,19,909,1128,0,0,0,0,0,0,80.59
高雄市,鹽埕區,育仁里,10,1,697,9,706,896,0,0,0,0,0,0,78.79
高雄市,鹽埕區,河濱里,11,1,1447,20,1467,1889,0,0,0,0,0,0,77.66
高雄市,鹽埕區,沙地里,12,1,838,15,853,1110,0,0,0,0,0,0,76.85
高雄市,鹽埕區,南端里,13,1,882,19,901,1166,0,0,0,0,0,0,77.27
高雄市,鹽埕區,港都里,14,1,903,21,924,1162,0,0,0,0,0,0,79.52
高雄市,鹽埕區,江西里,15,1,975,11,986,1248,0,0,0,0,0,0,79.01
高雄市,鹽埕區,新豐里,16,1,570,13,583,678,0,0,0,0,0,0,85.99
高雄市,鹽埕區,府北里,17,1,1267,28,1295,1692,0,0,0,0,0,0,76.54
高雄市,鹽埕區,陸橋里,18,1,1069,12,1081,1338,0,0,0,0,0,0,80.79
高雄市,鹽埕區,瀨南里,19,1,581,11,592,730,0,0,0,0,0,0,81.10
高雄市,鹽埕區,新化里,20,1,649,17,666,853,0,0,0,0,0,0,78.08
高雄市,鹽埕區,江南里,21,1,740,10,750,941,0,0,0,0,0,0,79.70
高雄市,鼓山區,鼓峰里,22,1,791,17,808,1022,0,0,0,0,0,0,79.06
高雄市,鼓山區,鼓峰里,23,1,782,13,795,1000,0,0,0,0,0,0,79.50
高雄市,鼓山區,雄峰里,24,1,812,19,831,1045,0,0,0,0,0,0,79.52
高雄市,鼓山區,雄峰里,25,1,778,12,790,981,0,0,0,0,0,0,80.53
高雄市,鼓山區,前峰里,26,1,1066,12,1078,1282,0,0,0,0,0,0,84.09
高雄市,鼓山區,前峰里,27,1,1227,16,1243,1526,0,0,0,0,0,0,81.45
高雄市,鼓山區,前峰里,28,1,1042,8,1050,1244,0,0,0,0,0,0,84.41
高雄市,鼓山區,光榮里,29,1,1047,22,1069,1264,0,0,0,0,0,0,84.57
高雄市,鼓山區,光榮里,30,1,1114,16,1130,1362,0,0,0,0,0,0,82.97
高雄市,鼓山區,光榮里,31,1,1118,12,1130,1397,0,0,0,0,0,0,80.89
高雄市,鼓山區,民族里,32,1,1133,25,1158,1417,0,0,0,0,0,0,81.72
高雄市,鼓山區,內惟里,33,1,1037,22,1059,1285,0,0,0,0,0,0,82.41
高雄市,鼓山區,建國里,34,1,820,26,846,1022,0,0,0,0,0,0,82.78
高雄市,鼓山區,建國里,35,1,814,9,823,1018,0,0,0,0,0,0,80.84
高雄市,鼓山區,忠正里,36,1,1094,20,1114,1376,0,0,0,0,0,0,80.96
高雄市,鼓山區,忠正里,37,1,1516,33,1549,1938,0,0,0,0,0,0,79.93
高雄市,鼓山區,忠正里,38,1,1102,28,1130,1416,0,0,0,0,0,0,79.80
高雄市,鼓山區,自強里,39,1,670,11,681,857,0,0,0,0,0,0,79.46
高雄市,鼓山區,龍井里,40,1,1264,19,1283,1584,0,0,0,0,0,0,81.00
高雄市,鼓山區,正德里,41,1,1405,30,1435,1751,0,0,0,0,0,0,81.95
高雄市,鼓山區,平和里,42,1,1161,21,1182,1420,0,0,0,0,0,0,83.24
高雄市,鼓山區,平和里,43,1,1213,17,1230,1491,0,0,0,0,0,0,82.49
高雄市,鼓山區,民強里,44,1,962,17,979,1140,0,0,0,0,0,0,85.88
高雄市,鼓山區,民強里,45,1,749,17,766,896,0,0,0,0,0,0,85.49
高雄市,鼓山區,厚生里,46,1,806,12,818,984,0,0,0,0,0,0,83.13
高雄市,鼓山區,厚生里,47,1,806,15,821,1006,0,0,0,0,0,0,81.61
高雄市,鼓山區,龍子里,48,1,1311,31,1342,1672,0,0,0,0,0,0,80.26
高雄市,鼓山區,龍子里,49,1,1125,16,1141,1544,0,0,0,0,0,0,73.90
高雄市,鼓山區,龍子里,50,1,1153,28,1181,1526,0,0,0,0,0,0,77.39
高雄市,鼓山區,龍水里,51,1,942,22,964,1268,0,0,0,0,0,0,76.03
高雄市,鼓山區,明誠里,52,1,1331,17,1348,1651,0,0,0,0,0,0,81.65
高雄市,鼓山區,明誠里,53,1,1370,24,1394,1744,0,0,0,0,0,0,79.93
高雄市,鼓山區,明誠里,54,1,1405,22,1427,1872,0,0,0,0,0,0,76.23
高雄市,鼓山區,明誠里,55,1,1735,24,1759,2327,0,0,0,0,0,0,75.59
高雄市,鼓山區,華豐里,56,1,1253,19,1272,1569,0,0,0,0,0,0,81.07
高雄市,鼓山區,華豐里,57,1,1500,18,1518,1884,0,0,0,0,0,0,80.57
高雄市,鼓山區,裕興里,58,1,921,14,935,1161,0,0,0,0,0,0,80.53
高雄市,鼓山區,裕興里,59,1,808,15,823,1040,0,0,0,0,0,0,79.13
高雄市,鼓山區,裕豐里,60,1,742,8,750,923,0,0,0,0,0,0,81.26
高雄市,鼓山區,裕豐里,61,1,1034,15,1049,1325,0,0,0,0,0,0,79.17
高雄市,鼓山區,鼓岩里,62,1,650,14,664,822,0,0,0,0,0,0,80.78
高雄市,鼓山區,鼓岩里,63,1,672,18,690,856,0,0,0,0,0,0,80.61
高雄市,鼓山區,樹德里,64,1,891,15,906,1083,0,0,0,0,0,0,83.66
高雄市,鼓山區,寶樹里,65,1,735,17,752,935,0,0,0,0,0,0,80.43
高雄市,鼓山區,興宗里,66,1,1316,21,1337,1617,0,0,0,0,0,0,82.68
高雄市,鼓山區,光化里,67,1,1242,25,1267,1607,0,0,0,0,0,0,78.84
高雄市,鼓山區,山下里,68,1,759,17,776,932,0,0,0,0,0,0,83.26
高雄市,鼓山區,山下里,69,1,652,14,666,850,0,0,0,0,0,0,78.35
高雄市,鼓山區,河邊里,70,1,1204,22,1226,1523,0,0,0,0,0,0,80.50
高雄市,鼓山區,綠川里,71,1,1389,32,1421,1744,0,0,0,0,0,0,81.48
高雄市,鼓山區,登山里,72,1,640,6,646,815,0,0,0,0,0,0,79.26
高雄市,鼓山區,峰南里,73,1,908,18,926,1146,0,0,0,0,0,0,80.80
高雄市,鼓山區,麗興里,74,1,936,17,953,1211,0,0,0,0,0,0,78.70
高雄市,鼓山區,新民里,75,1,974,21,995,1237,0,0,0,0,0,0,80.44
高雄市,鼓山區,延平里,76,1,810,15,825,1077,0,0,0,0,0,0,76.60
高雄市,鼓山區,維生里,77,1,1213,27,1240,1579,0,0,0,0,0,0,78.53
高雄市,鼓山區,惠安里,78,1,1112,26,1138,1436,0,0,0,0,0,0,79.25
高雄市,鼓山區,壽山里,79,1,1233,47,1280,1670,0,0,0,0,0,0,76.65
高雄市,鼓山區,哨船頭里,80,1,1013,16,1029,1282,0,0,0,0,0,0,80.27
高雄市,鼓山區,桃源里,81,1,623,9,632,773,0,0,0,0,0,0,81.76
高雄市,左營區,進學里,82,1,710,15,725,942,0,0,0,0,0,0,76.96
高雄市,左營區,進學里,83,1,603,18,621,765,0,0,0,0,0,0,81.18
高雄市,左營區,尾西里,84,1,1043,24,1067,1283,0,0,0,0,0,0,83.16
高雄市,左營區,頂北里,85,1,552,6,558,661,0,0,0,0,0,0,84.42
高雄市,左營區,中北里,86,1,585,9,594,700,0,0,0,0,0,0,84.86
高雄市,左營區,中南里,87,1,543,10,553,652,0,0,0,0,0,0,84.82
高雄市,左營區,廟東里,88,1,843,14,857,984,0,0,0,0,0,0,87.09
高雄市,左營區,廟北里,89,1,912,28,940,1083,0,0,0,0,0,0,86.80
高雄市,左營區,尾南里,90,1,883,15,898,1034,0,0,0,0,0,0,86.85
高雄市,左營區,尾北里,91,1,867,20,887,1068,0,0,0,0,0,0,83.05
高雄市,左營區,尾北里,92,1,1129,16,1145,1395,0,0,0,0,0,0,82.08
高雄市,左營區,海光里,93,1,1340,27,1367,1670,0,0,0,0,0,0,81.86
高雄市,左營區,屏山里,94,1,660,18,678,848,0,0,0,0,0,0,79.95
高雄市,左營區,屏山里,95,1,689,12,701,879,0,0,0,0,0,0,79.75
高雄市,左營區,祥和里,96,1,614,15,629,745,0,0,0,0,0,0,84.43
高雄市,左營區,永清里,97,1,876,25,901,1147,0,0,0,0,0,0,78.55
高雄市,左營區,永清里,98,1,846,22,868,1059,0,0,0,0,0,0,81.96
高雄市,左營區,復興里,99,1,1037,19,1056,1320,0,0,0,0,0,0,80.00
高雄市,左營區,莒光里,100,1,658,9,667,826,0,0,0,0,0,0,80.75
高雄市,左營區,莒光里,101,1,690,7,697,859,0,0,0,0,0,0,81.14
高雄市,左營區,光輝里,102,1,971,15,986,1208,0,0,0,0,0,0,81.62
高雄市,左營區,光輝里,103,1,1064,22,1086,1322,0,0,0,0,0,0,82.15
高雄市,左營區,合群里,104,1,1032,11,1043,1350,0,0,0,0,0,0,77.26
高雄市,左營區,自治里,105,1,709,6,715,897,0,0,0,0,0,0,79.71
高雄市,左營區,自治里,106,1,775,21,796,999,0,0,0,0,0,0,79.68
高雄市,左營區,明建里,107,1,1142,24,1166,1497,0,0,0,0,0,0,77.89
高雄市,左營區,自立里,108,1,766,11,777,973,0,0,0,0,0,0,79.86
高雄市,左營區,頂西里,109,1,1136,8,1144,1340,0,0,0,0,0,0,85.37
高雄市,左營區,聖后里,110,1,799,20,819,1014,0,0,0,0,0,0,80.77
高雄市,左營區,聖西里,111,1,383,6,389,464,0,0,0,0,0,0,83.84
高雄市,左營區,聖南里,112,1,481,3,484,558,0,0,0,0,0,0,86.74
高雄市,左營區,城南里,113,1,509,6,515,648,0,0,0,0,0,0,79.48
高雄市,左營區,路東里,114,1,667,14,681,810,0,0,0,0,0,0,84.07
高雄市,左營區,部北里,115,1,468,5,473,555,0,0,0,0,0,0,85.23
高雄市,左營區,部南里,116,1,636,13,649,774,0,0,0,0,0,0,83.85
高雄市,左營區,埤西里,117,1,1005,15,1020,1221,0,0,0,0,0,0,83.54
高雄市,左營區,埤北里,118,1,1162,25,1187,1546,0,0,0,0,0,0,76.78
高雄市,左營區,埤東里,119,1,588,12,600,771,0,0,0,0,0,0,77.82
高雄市,左營區,埤東里,120,1,568,13,581,687,0,0,0,0,0,0,84.57
高雄市,左營區,海勝里,121,1,1107,20,1127,1365,0,0,0,0,0,0,82.56
高雄市,左營區,自勉里,122,1,850,26,876,1050,0,0,0,0,0,0,83.43
高雄市,左營區,自勉里,123,1,579,10,589,727,0,0,0,0,0,0,81.02
高雄市,左營區,崇實里,124,1,915,10,925,1166,0,0,0,0,0,0,79.33
高雄市,左營區,自助里,125,1,1194,17,1211,1543,0,0,0,0,0,0,78.48
高雄市,左營區,自助里,126,1,764,5,769,980,0,0,0,0,0,0,78.47
高雄市,左營區,果貿里,127,1,793,9,802,976,0,0,0,0,0,0,82.17
高雄市,左營區,果貿里,128,1,884,11,895,1116,0,0,0,0,0,0,80.20
高雄市,左營區,果惠里,129,1,1225,17,1242,1601,0,0,0,0,0,0,77.58
高雄市,左營區,果峰里,130,1,757,20,777,998,0,0,0,0,0,0,77.86
高雄市,左營區,果峰里,131,1,679,12,691,851,0,0,0,0,0,0,81.20
高雄市,左營區,新下里,132,1,825,7,832,1024,0,0,0,0,0,0,81.25
高雄市,左營區,新下里,133,1,971,10,981,1206,0,0,0,0,0,0,81.34
高雄市,左營區,新下里,134,1,958,15,973,1186,0,0,0,0,0,0,82.04
高雄市,左營區,新下里,135,1,1202,13,1215,1548,0,0,0,0,0,0,78.49
高雄市,左營區,新下里,136,1,1143,26,1169,1407,0,0,0,0,0,0,83.08
高雄市,左營區,新上里,137,1,955,27,982,1200,0,0,0,0,0,0,81.83
高雄市,左營區,新上里,138,1,1073,20,1093,1329,0,0,0,0,0,0,82.24
高雄市,左營區,新上里,139,1,1089,21,1110,1460,0,0,0,0,0,0,76.03
高雄市,左營區,新上里,140,1,1030,23,1053,1337,0,0,0,0,0,0,78.76
高雄市,左營區,新上里,141,1,1115,20,1135,1574,0,0,0,0,0,0,72.11
高雄市,左營區,新上里,142,1,1323,17,1340,1727,0,0,0,0,0,0,77.59
高雄市,左營區,新上里,143,1,1191,14,1205,1614,0,0,0,0,0,0,74.66
高雄市,左營區,新上里,144,1,1232,26,1258,1690,0,0,0,0,0,0,74.44
高雄市,左營區,新上里,145,1,1139,11,1150,1553,0,0,0,0,0,0,74.05
高雄市,左營區,新中里,146,1,1213,21,1234,1483,0,0,0,0,0,0,83.21
高雄市,左營區,新中里,147,1,1005,21,1026,1224,0,0,0,0,0,0,83.82
高雄市,左營區,新中里,148,1,1102,28,1130,1403,0,0,0,0,0,0,80.54
高雄市,左營區,新光里,149,1,1211,17,1228,1517,0,0,0,0,0,0,80.95
高雄市,左營區,新光里,150,1,1110,16,1126,1424,0,0,0,0,0,0,79.07
高雄市,左營區,新光里,151,1,1014,15,1029,1288,0,0,0,0,0,0,79.89
高雄市,左營區,新光里,152,1,1159,15,1174,1487,0,0,0,0,0,0,78.95
高雄市,左營區,菜公里,153,1,1462,31,1493,1931,0,0,0,0,0,0,77.32
高雄市,左營區,菜公里,154,1,1322,44,1366,1724,0,0,0,0,0,0,79.23
高雄市,左營區,菜公里,155,1,1481,29,1510,1947,0,0,0,0,0,0,77.56
高雄市,左營區,菜公里,156,1,1422,32,1454,1790,0,0,0,0,0,0,81.23
高雄市,左營區,菜公里,157,1,1163,26,1189,1532,0,0,0,0,0,0,77.61
高雄市,左營區,福山里,158,1,1504,36,1540,2076,0,0,0,0,0,0,74.18
高雄市,左營區,福山里,159,1,1393,29,1422,1899,0,0,0,0,0,0,74.88
高雄市,左營區,福山里,160,1,1460,24,1484,1951,0,0,0,0,0,0,76.06
高雄市,左營區,福山里,161,1,1369,23,1392,1850,0,0,0,0,0,0,75.24
高雄市,左營區,福山里,162,1,1743,26,1769,2300,0,0,0,0,0,0,76.91
高雄市,楠梓區,清豐里,163,1,1036,32,1068,1291,0,0,0,0,0,0,82.73
高雄市,楠梓區,清豐里,164,1,1047,22,1069,1267,0,0,0,0,0,0,84.37
高雄市,楠梓區,清豐里,165,1,842,17,859,1065,0,0,0,0,0,0,80.66
高雄市,楠梓區,清豐里,166,1,693,17,710,903,0,0,0,0,0,0,78.63
高雄市,楠梓區,清豐里,167,1,827,13,840,1066,0,0,0,0,0,0,78.80
高雄市,楠梓區,清豐里,168,1,971,18,989,1273,0,0,0,0,0,0,77.69
高雄市,楠梓區,東寧里,169,1,904,10,914,1094,0,0,0,0,0,0,83.55
高雄市,楠梓區,東寧里,170,1,836,21,857,1063,0,0,0,0,0,0,80.62
高雄市,楠梓區,五常里,171,1,875,20,895,1113,0,0,0,0,0,0,80.41
高雄市,楠梓區,五常里,172,1,1040,25,1065,1329,0,0,0,0,0,0,80.14
高雄市,楠梓區,五常里,173,1,933,22,955,1210,0,0,0,0,0,0,78.93
高雄市,楠梓區,享平里,174,1,925,9,934,1095,0,0,0,0,0,0,85.30
高雄市,楠梓區,享平里,175,1,993,17,1010,1235,0,0,0,0,0,0,81.78
高雄市,楠梓區,中陽里,176,1,1058,28,1086,1326,0,0,0,0,0,0,81.90
高雄市,楠梓區,中陽里,177,1,955,13,968,1198,0,0,0,0,0,0,80.80
高雄市,楠梓區,惠楠里,178,1,846,24,870,1058,0,0,0,0,0,0,82.23
高雄市,楠梓區,惠楠里,179,1,888,14,902,1143,0,0,0,0,0,0,78.92
高雄市,楠梓區,惠民里,180,1,1201,23,1224,1503,0,0,0,0,0,0,81.44
高雄市,楠梓區,惠民里,181,1,1099,19,1118,1355,0,0,0,0,0,0,82.51
高雄市,楠梓區,惠豐里,182,1,821,16,837,1036,0,0,0,0,0,0,80.79
高雄市,楠梓區,惠豐里,183,1,942,17,959,1143,0,0,0,0,0,0,83.90
高雄市,楠梓區,錦屏里,184,1,877,15,892,1062,0,0,0,0,0,0,83.99
高雄市,楠梓區,錦屏里,185,1,987,11,998,1145,0,0,0,0,0,0,87.16
高雄市,楠梓區,錦屏里,186,1,818,20,838,984,0,0,0,0,0,0,85.16
高雄市,楠梓區,玉屏里,187,1,831,15,846,967,0,0,0,0,0,0,87.49
高雄市,楠梓區,玉屏里,188,1,1003,23,1026,1165,0,0,0,0,0,0,88.07
高雄市,楠梓區,金田里,189,1,1246,29,1275,1493,0,0,0,0,0,0,85.40
高雄市,楠梓區,金田里,190,1,1198,21,1219,1444,0,0,0,0,0,0,84.42
高雄市,楠梓區,稔田里,191,1,1283,27,1310,1557,0,0,0,0,0,0,84.14
高雄市,楠梓區,瑞屏里,192,1,1163,22,1185,1398,0,0,0,0,0,0,84.76
高雄市,楠梓區,瑞屏里,193,1,1201,27,1228,1484,0,0,0,0,0,0,82.75
高雄市,楠梓區,翠屏里,194,1,946,24,970,1226,0,0,0,0,0,0,79.12
高雄市,楠梓區,翠屏里,195,1,1059,24,1083,1356,0,0,0,0,0,0,79.87
高雄市,楠梓區,翠屏里,196,1,748,10,758,998,0,0,0,0,0,0,75.95
高雄市,楠梓區,翠屏里,197,1,914,18,932,1189,0,0,0,0,0,0,78.39
高雄市,楠梓區,翠屏里,198,1,760,13,773,1022,0,0,0,0,0,0,75.64
高雄市,楠梓區,翠屏里,199,1,906,20,926,1202,0,0,0,0,0,0,77.04
高雄市,楠梓區,翠屏里,200,1,1139,11,1150,1421,0,0,0,0,0,0,80.93
高雄市,楠梓區,翠屏里,201,1,1032,21,1053,1334,0,0,0,0,0,0,78.94
高雄市,楠梓區,宏南里,202,1,569,6,575,687,0,0,0,0,0,0,83.70
高雄市,楠梓區,宏南里,203,1,746,13,759,964,0,0,0,0,0,0,78.73
高雄市,楠梓區,宏毅里,204,1,1213,18,1231,1514,0,0,0,0,0,0,81.31
高雄市,楠梓區,宏毅里,205,1,1231,16,1247,1469,0,0,0,0,0,0,84.89
高雄市,楠梓區,宏榮里,206,1,1216,15,1231,1464,0,0,0,0,0,0,84.08
高雄市,楠梓區,廣昌里,207,1,876,20,896,1054,0,0,0,0,0,0,85.01
高雄市,楠梓區,廣昌里,208,1,708,19,727,891,0,0,0,0,0,0,81.59
高雄市,楠梓區,廣昌里,209,1,744,13,757,905,0,0,0,0,0,0,83.65
高雄市,楠梓區,久昌里,210,1,823,23,846,1031,0,0,0,0,0,0,82.06
高雄市,楠梓區,久昌里,211,1,809,14,823,1020,0,0,0,0,0,0,80.69
高雄市,楠梓區,大昌里,212,1,843,21,864,1034,0,0,0,0,0,0,83.56
高雄市,楠梓區,大昌里,213,1,844,12,856,1044,0,0,0,0,0,0,81.99
高雄市,楠梓區,福昌里,214,1,782,6,788,929,0,0,0,0,0,0,84.82
高雄市,楠梓區,福昌里,215,1,660,10,670,822,0,0,0,0,0,0,81.51
高雄市,楠梓區,盛昌里,216,1,1101,22,1123,1331,0,0,0,0,0,0,84.37
高雄市,楠梓區,盛昌里,217,1,1089,20,1109,1343,0,0,0,0,0,0,82.58
高雄市,楠梓區,泰昌里,218,1,1208,27,1235,1456,0,0,0,0,0,0,84.82
高雄市,楠梓區,興昌里,219,1,990,15,1005,1192,0,0,0,0,0,0,84.31
高雄市,楠梓區,興昌里,220,1,889,17,906,1132,0,0,0,0,0,0,80.04
高雄市,楠梓區,建昌里,221,1,907,9,916,1126,0,0,0,0,0,0,81.35
高雄市,楠梓區,建昌里,222,1,909,11,920,1090,0,0,0,0,0,0,84.40
高雄市,楠梓區,宏昌里,223,1,711,10,721,881,0,0,0,0,0,0,81.84
高雄市,楠梓區,宏昌里,224,1,771,10,781,913,0,0,0,0,0,0,85.54
高雄市,楠梓區,和昌里,225,1,840,16,856,1025,0,0,0,0,0,0,83.51
高雄市,楠梓區,和昌里,226,1,852,8,860,1022,0,0,0,0,0,0,84.15
高雄市,楠梓區,慶昌里,227,1,1119,17,1136,1362,0,0,0,0,0,0,83.41
高雄市,楠梓區,慶昌里,228,1,1171,28,1199,1419,0,0,0,0,0,0,84.50
高雄市,楠梓區,隆昌里,229,1,830,19,849,1030,0,0,0,0,0,0,82.43
高雄市,楠梓區,隆昌里,230,1,917,12,929,1096,0,0,0,0,0,0,84.76
高雄市,楠梓區,隆昌里,231,1,856,15,871,1024,0,0,0,0,0,0,85.06
高雄市,楠梓區,秀昌里,232,1,677,21,698,855,0,0,0,0,0,0,81.64
高雄市,楠梓區,秀昌里,233,1,774,14,788,938,0,0,0,0,0,0,84.01
高雄市,楠梓區,裕昌里,234,1,797,16,813,946,0,0,0,0,0,0,85.94
高雄市,楠梓區,裕昌里,235,1,797,14,811,1001,0,0,0,0,0,0,81.02
高雄市,楠梓區,國昌里,236,1,921,20,941,1129,0,0,0,0,0,0,83.35
高雄市,楠梓區,國昌里,237,1,974,20,994,1246,0,0,0,0,0,0,79.78
高雄市,楠梓區,加昌里,238,1,882,18,900,1124,0,0,0,0,0,0,80.07
高雄市,楠梓區,加昌里,239,1,995,16,1011,1237,0,0,0,0,0,0,81.73
高雄市,楠梓區,加昌里,240,1,975,10,985,1183,0,0,0,0,0,0,83.26
高雄市,楠梓區,加昌里,241,1,925,11,936,1158,0,0,0,0,0,0,80.83
高雄市,楠梓區,仁昌里,242,1,1069,21,1090,1346,0,0,0,0,0,0,80.98
高雄市,楠梓區,仁昌里,243,1,1060,26,1086,1378,0,0,0,0,0,0,78.81
高雄市,楠梓區,藍田里,244,1,796,12,808,910,0,0,0,0,0,0,88.79
高雄市,楠梓區,中興里,245,1,698,3,701,830,0,0,0,0,0,0,84.46
高雄市,楠梓區,中和里,246,1,667,14,681,825,0,0,0,0,0,0,82.55
高雄市,楠梓區,中和里,247,1,572,9,581,655,0,0,0,0,0,0,88.70
高雄市,三民區,鼎金里,248,1,1071,25,1096,1363,0,0,0,0,0,0,80.41
高雄市,三民區,鼎金里,249,1,1111,26,1137,1409,0,0,0,0,0,0,80.70
高雄市,三民區,鼎盛里,250,1,1349,20,1369,1681,0,0,0,0,0,0,81.44
高雄市,三民區,鼎盛里,251,1,1190,20,1210,1463,0,0,0,0,0,0,82.71
高雄市,三民區,鼎強里,252,1,1249,17,1266,1567,0,0,0,0,0,0,80.79
高雄市,三民區,鼎強里,253,1,1211,27,1238,1483,0,0,0,0,0,0,83.48
高雄市,三民區,鼎強里,254,1,1207,22,1229,1532,0,0,0,0,0,0,80.22
高雄市,三民區,鼎力里,255,1,1150,22,1172,1524,0,0,0,0,0,0,76.90
高雄市,三民區,鼎力里,256,1,1216,27,1243,1513,0,0,0,0,0,0,82.15
高雄市,三民區,鼎西里,257,1,1460,32,1492,1821,0,0,0,0,0,0,81.93
高雄市,三民區,鼎西里,258,1,1398,23,1421,1781,0,0,0,0,0,0,79.79
高雄市,三民區,鼎中里,259,1,1233,22,1255,1483,0,0,0,0,0,0,84.63
高雄市,三民區,鼎中里,260,1,1244,20,1264,1486,0,0,0,0,0,0,85.06
高雄市,三民區,鼎泰里,261,1,1578,24,1602,2032,0,0,0,0,0,0,78.84
高雄市,三民區,鼎泰里,262,1,2152,28,2180,3035,0,0,0,0,0,0,71.83
高雄市,三民區,鼎泰里,263,1,1730,24,1754,2258,0,0,0,0,0,0,77.68
高雄市,三民區,鼎泰里,264,1,1549,30,1579,1938,0,0,0,0,0,0,81.48
高雄市,三民區,鼎泰里,265,1,1420,16,1436,1837,0,0,0,0,0,0,78.17
高雄市,三民區,本館里,266,1,1640,36,1676,2060,0,0,0,0,0,0,81.36
高雄市,三民區,本館里,267,1,1596,36,1632,2027,0,0,0,0,0,0,80.51
高雄市,三民區,本館里,268,1,1719,26,1745,2100,0,0,0,0,0,0,83.10
高雄市,三民區,本和里,269,1,1382,27,1409,1669,0,0,0,0,0,0,84.42
高雄市,三民區,本和里,270,1,1081,24,1105,1333,0,0,0,0,0,0,82.90
高雄市,三民區,本和里,271,1,1191,16,1207,1491,0,0,0,0,0,0,80.95
高雄市,三民區,本文里,272,1,1568,29,1597,1933,0,0,0,0,0,0,82.62
高雄市,三民區,本武里,273,1,1195,24,1219,1492,0,0,0,0,0,0,81.70
高雄市,三民區,本元里,274,1,1567,25,1592,1955,0,0,0,0,0,0,81.43
高雄市,三民區,本元里,275,1,1548,19,1567,1988,0,0,0,0,0,0,78.82
高雄市,三民區,本安里,276,1,1161,18,1179,1450,0,0,0,0,0,0,81.31
高雄市,三民區,本安里,277,1,1381,31,1412,1683,0,0,0,0,0,0,83.90
高雄市,三民區,本上里,278,1,1328,25,1353,1655,0,0,0,0,0,0,81.75
高雄市,三民區,本上里,279,1,1397,26,1423,1810,0,0,0,0,0,0,78.62
高雄市,三民區,本揚里,280,1,1438,26,1464,1837,0,0,0,0,0,0,79.70
高雄市,三民區,本揚里,281,1,1423,18,1441,1806,0,0,0,0,0,0,79.79
高雄市,三民區,本揚里,282,1,1440,18,1458,1808,0,0,0,0,0,0,80.64
高雄市,三民區,寶獅里,283,1,1214,14,1228,1564,0,0,0,0,0,0,78.52
高雄市,三民區,寶獅里,284,1,1249,22,1271,1577,0,0,0,0,0,0,80.60
高雄市,三民區,寶德里,285,1,1491,29,1520,1969,0,0,0,0,0,0,77.20
高雄市,三民區,寶德里,286,1,1467,20,1487,1823,0,0,0,0,0,0,81.57
高雄市,三民區,寶泰里,287,1,899,8,907,1129,0,0,0,0,0,0,80.34
高雄市,三民區,寶泰里,288,1,1043,17,1060,1329,0,0,0,0,0,0,79.76
高雄市,三民區,寶興里,289,1,1252,23,1275,1560,0,0,0,0,0,0,81.73
高雄市,三民區,寶興里,290,1,1353,32,1385,1687,0,0,0,0,0,0,82.10
高雄市,三民區,寶興里,291,1,1289,20,1309,1647,0,0,0,0,0,0,79.48
高雄市,三民區,寶中里,292,1,995,19,1014,1213,0,0,0,0,0,0,83.59
高雄市,三民區,寶中里,293,1,1034,12,1046,1266,0,0,0,0,0,0,82.62
高雄市,三民區,寶華里,294,1,940,19,959,1174,0,0,0,0,0,0,81.69
高雄市,三民區,寶華里,295,1,911,10,921,1187,0,0,0,0,0,0,77.59
高雄市,三民區,寶國里,296,1,1269,19,1288,1595,0,0,0,0,0,0,80.75
高雄市,三民區,寶國里,297,1,1408,20,1428,1747,0,0,0,0,0,0,81.74
高雄市,三民區,寶國里,298,1,1092,16,1108,1401,0,0,0,0,0,0,79.09
高雄市,三民區,寶民里,299,1,1699,31,1730,2136,0,0,0,0,0,0,80.99
高雄市,三民區,寶慶里,300,1,832,18,850,1033,0,0,0,0,0,0,82.28
高雄市,三民區,寶慶里,301,1,896,21,917,1151,0,0,0,0,0,0,79.67
高雄市,三民區,寶業里,302,1,1407,25,1432,1803,0,0,0,0,0,0,79.42
高雄市,三民區,寶業里,303,1,1215,19,1234,1591,0,0,0,0,0,0,77.56
高雄市,三民區,寶盛里,304,1,1382,27,1409,1765,0,0,0,0,0,0,79.83
高雄市,三民區,寶盛里,305,1,1358,22,1380,1764,0,0,0,0,0,0,78.23
高雄市,三民區,寶安里,306,1,1005,12,1017,1239,0,0,0,0,0,0,82.08
高雄市,三民區,寶安里,307,1,1232,28,1260,1600,0,0,0,0,0,0,78.75
高雄市,三民區,寶安里,308,1,1204,18,1222,1556,0,0,0,0,0,0,78.53
高雄市,三民區,寶龍里,309,1,1261,24,1285,1560,0,0,0,0,0,0,82.37
高雄市,三民區,寶龍里,310,1,1481,37,1518,1857,0,0,0,0,0,0,81.74
高雄市,三民區,寶珠里,311,1,1687,42,1729,2204,0,0,0,0,0,0,78.45
高雄市,三民區,寶珠里,312,1,1670,41,1711,2102,0,0,0,0,0,0,81.40
高雄市,三民區,寶玉里,313,1,1317,22,1339,1725,0,0,0,0,0,0,77.62
高雄市,三民區,寶玉里,314,1,1457,15,1472,1787,0,0,0,0,0,0,82.37
高雄市,三民區,寶玉里,315,1,1359,29,1388,1722,0,0,0,0,0,0,80.60
高雄市,三民區,灣子里,316,1,1104,20,1124,1443,0,0,0,0,0,0,77.89
高雄市,三民區,灣子里,317,1,1026,17,1043,1344,0,0,0,0,0,0,77.60
高雄市,三民區,灣愛里,318,1,942,17,959,1247,0,0,0,0,0,0,76.90
高雄市,三民區,灣愛里,319,1,897,22,919,1177,0,0,0,0,0,0,78.08
高雄市,三民區,灣中里,320,1,1501,34,1535,1972,0,0,0,0,0,0,77.84
高雄市,三民區,灣中里,321,1,1577,32,1609,2003,0,0,0,0,0,0,80.33
高雄市,三民區,灣華里,322,1,1854,41,1895,2322,0,0,0,0,0,0,81.61
高雄市,三民區,灣勝里,323,1,1547,27,1574,1942,0,0,0,0,0,0,81.05
高雄市,三民區,灣利里,324,1,1375,23,1398,1702,0,0,0,0,0,0,82.14
高雄市,三民區,灣利里,325,1,1361,26,1387,1628,0,0,0,0,0,0,85.20
高雄市,三民區,灣復里,326,1,1030,10,1040,1444,0,0,0,0,0,0,72.02
高雄市,三民區,灣復里,327,1,1059,20,1079,1306,0,0,0,0,0,0,82.62
高雄市,三民區,正興里,328,1,1730,22,1752,2274,0,0,0,0,0,0,77.04
高雄市,三民區,正興里,329,1,1707,33,1740,2192,0,0,0,0,0,0,79.38
高雄市,三民區,正興里,330,1,1723,28,1751,2277,0,0,0,0,0,0,76.90
高雄市,三民區,正順里,331,1,1185,21,1206,1536,0,0,0,0,0,0,78.52
高雄市,三民區,正順里,332,1,1183,18,1201,1492,0,0,0,0,0,0,80.50
高雄市,三民區,灣興里,333,1,1164,17,1181,1465,0,0,0,0,0,0,80.61
高雄市,三民區,灣成里,334,1,1239,15,1254,1550,0,0,0,0,0,0,80.90
高雄市,三民區,安康里,335,1,1148,21,1169,1529,0,0,0,0,0,0,76.46
高雄市,三民區,安康里,336,1,1193,26,1219,1537,0,0,0,0,0,0,79.31
高雄市,三民區,安寧里,337,1,1741,39,1780,2207,0,0,0,0,0,0,80.65
高雄市,三民區,安吉里,338,1,1380,15,1395,1870,0,0,0,0,0,0,74.60
高雄市,三民區,安吉里,339,1,1310,21,1331,1695,0,0,0,0,0,0,78.53
高雄市,三民區,安發里,340,1,1395,34,1429,1784,0,0,0,0,0,0,80.10
高雄市,三民區,安發里,341,1,1554,29,1583,1968,0,0,0,0,0,0,80.44
高雄市,三民區,安東里,342,1,1308,21,1329,1620,0,0,0,0,0,0,82.04
高雄市,三民區,安東里,343,1,1193,18,1211,1540,0,0,0,0,0,0,78.64
高雄市,三民區,安和里,344,1,917,19,936,1154,0,0,0,0,0,0,81.11
高雄市,三民區,安和里,345,1,1150,25,1175,1458,0,0,0,0,0,0,80.59
高雄市,三民區,達德里,346,1,1240,24,1264,1542,0,0,0,0,0,0,81.97
高雄市,三民區,達明里,347,1,1336,26,1362,1687,0,0,0,0,0,0,80.74
高雄市,三民區,達仁里,348,1,1165,12,1177,1479,0,0,0,0,0,0,79.58
高雄市,三民區,達勇里,349,1,917,15,932,1109,0,0,0,0,0,0,84.04
高雄市,三民區,同德里,350,1,1015,19,1034,1303,0,0,0,0,0,0,79.36
高雄市,三民區,同德里,351,1,1146,18,1164,1490,0,0,0,0,0,0,78.12
高雄市,三民區,德智里,352,1,916,19,935,1157,0,0,0,0,0,0,80.81
高雄市,三民區,德智里,353,1,881,17,898,1154,0,0,0,0,0,0,77.82
高雄市,三民區,德仁里,354,1,1461,32,1493,1879,0,0,0,0,0,0,79.46
高雄市,三民區,安生里,355,1,1378,26,1404,1774,0,0,0,0,0,0,79.14
高雄市,三民區,德東里,356,1,707,18,725,908,0,0,0,0,0,0,79.85
高雄市,三民區,德行里,357,1,949,14,963,1188,0,0,0,0,0,0,81.06
高雄市,三民區,精華里,358,1,1362,17,1379,1730,0,0,0,0,0,0,79.71
高雄市,三民區,民享里,359,1,817,18,835,1008,0,0,0,0,0,0,82.84
高雄市,三民區,民享里,360,1,846,14,860,1043,0,0,0,0,0,0,82.45
高雄市,三民區,安宜里,361,1,1315,26,1341,1632,0,0,0,0,0,0,82.17
高雄市,三民區,安宜里,362,1,1235,26,1261,1530,0,0,0,0,0,0,82.42
高雄市,三民區,安泰里,363,1,1563,33,1596,1950,0,0,0,0,0,0,81.85
高雄市,三民區,安泰里,364,1,1542,23,1565,1992,0,0,0,0,0,0,78.56
高雄市,三民區,安邦里,365,1,1334,26,1360,1671,0,0,0,0,0,0,81.39
高雄市,三民區,安邦里,366,1,1370,18,1388,1770,0,0,0,0,0,0,78.42
高雄市,三民區,十全里,367,1,1134,24,1158,1426,0,0,0,0,0,0,81.21
高雄市,三民區,十美里,368,1,1397,31,1428,1751,0,0,0,0,0,0,81.55
高雄市,三民區,德北里,369,1,1001,20,1021,1261,0,0,0,0,0,0,80.97
高雄市,三民區,德北里,370,1,744,17,761,967,0,0,0,0,0,0,78.70
高雄市,三民區,立誠里,371,1,803,13,816,1011,0,0,0,0,0,0,80.71
高雄市,三民區,立業里,372,1,927,23,950,1129,0,0,0,0,0,0,84.15
高雄市,三民區,港東里,373,1,1005,16,1021,1310,0,0,0,0,0,0,77.94
高雄市,三民區,港新里,374,1,1088,19,1107,1481,0,0,0,0,0,0,74.75
高雄市,三民區,港西里,375,1,640,13,653,886,0,0,0,0,0,0,73.70
高雄市,三民區,港北里,376,1,445,8,453,547,0,0,0,0,0,0,82.82
高雄市,三民區,博愛里,377,1,862,20,882,1167,0,0,0,0,0,0,75.58
高雄市,三民區,博惠里,378,1,1451,21,1472,1890,0,0,0,0,0,0,77.88
高雄市,三民區,博惠里,379,1,1538,33,1571,1996,0,0,0,0,0,0,78.71
高雄市,三民區,長明里,380,1,944,20,964,1230,0,0,0,0,0,0,78.37
高雄市,三民區,建東里,381,1,598,11,609,864,0,0,0,0,0,0,70.49
高雄市,三民區,興德里,382,1,992,12,1004,1299,0,0,0,0,0,0,77.29
高雄市,三民區,鳳南里,383,1,964,21,985,1207,0,0,0,0,0,0,81.61
高雄市,三民區,鳳北里,384,1,773,7,780,952,0,0,0,0,0,0,81.93
高雄市,三民區,鳳北里,385,1,920,23,943,1165,0,0,0,0,0,0,80.94
高雄市,三民區,德西里,386,1,1031,29,1060,1282,0,0,0,0,0,0,82.68
高雄市,三民區,九如里,387,1,342,8,350,451,0,0,0,0,0,0,77.61
高雄市,三民區,豐裕里,388,1,1130,22,1152,1422,0,0,0,0,0,0,81.01
高雄市,三民區,豐裕里,389,1,1087,24,1111,1333,0,0,0,0,0,0,83.35
高雄市,三民區,川東里,390,1,1494,36,1530,1926,0,0,0,0,0,0,79.44
高雄市,三民區,裕民里,391,1,713,21,734,863,0,0,0,0,0,0,85.05
高雄市,三民區,力行里,392,1,998,15,1013,1185,0,0,0,0,0,0,85.49
高雄市,三民區,千歲里,393,1,926,26,952,1171,0,0,0,0,0,0,81.30
高雄市,三民區,立德里,394,1,1017,23,1040,1328,0,0,0,0,0,0,78.31
高雄市,三民區,千北里,395,1,1099,24,1123,1419,0,0,0,0,0,0,79.14
高雄市,三民區,千秋里,396,1,954,21,975,1220,0,0,0,0,0,0,79.92
高雄市,三民區,千秋里,397,1,918,20,938,1157,0,0,0,0,0,0,81.07
高雄市,旗津區,旗下里,398,1,1092,28,1120,1357,0,0,0,0,0,0,82.54
高雄市,旗津區,永安里,399,1,844,26,870,1128,0,0,0,0,0,0,77.13
高雄市,旗津區,振興里,400,1,1348,25,1373,1779,0,0,0,0,0,0,77.18
高雄市,旗津區,慈愛里,401,1,853,36,889,1083,0,0,0,0,0,0,82.09
高雄市,旗津區,慈愛里,402,1,717,37,754,957,0,0,0,0,0,0,78.79
高雄市,旗津區,復興里,403,1,1040,25,1065,1271,0,0,0,0,0,0,83.79
高雄市,旗津區,復興里,404,1,979,22,1001,1266,0,0,0,0,0,0,79.07
高雄市,旗津區,中華里,405,1,1022,19,1041,1260,0,0,0,0,0,0,82.62
高雄市,旗津區,實踐里,406,1,969,29,998,1328,0,0,0,0,0,0,75.15
高雄市,旗津區,北汕里,407,1,904,26,930,1211,0,0,0,0,0,0,76.80
高雄市,旗津區,北汕里,408,1,926,24,950,1148,0,0,0,0,0,0,82.75
高雄市,旗津區,南汕里,409,1,1344,30,1374,1692,0,0,0,0,0,0,81.21
高雄市,旗津區,上竹里,410,1,674,21,695,859,0,0,0,0,0,0,80.91
高雄市,旗津區,上竹里,411,1,1253,35,1288,1562,0,0,0,0,0,0,82.46
高雄市,旗津區,中洲里,412,1,1352,34,1386,1651,0,0,0,0,0,0,83.95
高雄市,旗津區,安順里,413,1,926,16,942,1183,0,0,0,0,0,0,79.63
高雄市,旗津區,中興里,414,1,786,24,810,924,0,0,0,0,0,0,87.66
高雄市,旗津區,中興里,415,1,846,20,866,1016,0,0,0,0,0,0,85.24
高雄市,新興區,浩然里,416,2,836,21,857,1123,0,0,0,0,0,0,76.31
高雄市,新興區,浩然里,417,2,742,12,754,964,0,0,0,0,0,0,78.22
高雄市,新興區,振成里,418,2,907,13,920,1224,0,0,0,0,0,0,75.16
高雄市,新興區,德生里,419,2,578,9,587,775,0,0,0,0,0,0,75.74
高雄市,新興區,德生里,420,2,991,8,999,1317,0,0,0,0,0,0,75.85
高雄市,新興區,振華里,421,2,989,16,1005,1301,0,0,0,0,0,0,77.25
高雄市,新興區,正氣里,422,2,622,12,634,806,0,0,0,0,0,0,78.66
高雄市,新興區,正氣里,423,2,600,14,614,777,0,0,0,0,0,0,79.02
高雄市,新興區,德政里,424,2,589,12,601,772,0,0,0,0,0,0,77.85
高雄市,新興區,仁聲里,425,2,583,6,589,766,0,0,0,0,0,0,76.89
高雄市,新興區,德望里,426,2,707,13,720,966,0,0,0,0,0,0,74.53
高雄市,新興區,德望里,427,2,654,14,668,889,0,0,0,0,0,0,75.14
高雄市,新興區,華聲里,428,2,784,12,796,1036,0,0,0,0,0,0,76.83
高雄市,新興區,蕉園里,429,2,605,9,614,756,0,0,0,0,0,0,81.22
高雄市,新興區,永寧里,430,2,1126,16,1142,1458,0,0,0,0,0,0,78.33
高雄市,新興區,玉衡里,431,2,838,13,851,1049,0,0,0,0,0,0,81.12
高雄市,新興區,順昌里,432,2,929,21,950,1209,0,0,0,0,0,0,78.58
高雄市,新興區,順昌里,433,2,754,11,765,976,0,0,0,0,0,0,78.38
高雄市,新興區,文昌里,434,2,774,8,782,1027,0,0,0,0,0,0,76.14
高雄市,新興區,文昌里,435,2,869,10,879,1121,0,0,0,0,0,0,78.41
高雄市,新興區,光耀里,436,2,950,9,959,1230,0,0,0,0,0,0,77.97
高雄市,新興區,光耀里,437,2,995,11,1006,1277,0,0,0,0,0,0,78.78
高雄市,新興區,興昌里,438,2,701,8,709,883,0,0,0,0,0,0,80.29
高雄市,新興區,南港里,439,2,732,5,737,914,0,0,0,0,0,0,80.63
高雄市,新興區,開平里,440,2,1043,13,1056,1320,0,0,0,0,0,0,80.00
高雄市,新興區,開平里,441,2,1001,17,1018,1241,0,0,0,0,0,0,82.03
高雄市,新興區,成功里,442,2,920,14,934,1210,0,0,0,0,0,0,77.19
高雄市,新興區,新江里,443,2,895,11,906,1214,0,0,0,0,0,0,74.63
高雄市,新興區,黎明里,444,2,682,16,698,910,0,0,0,0,0,0,76.70
高雄市,新興區,愛平里,445,2,747,15,762,951,0,0,0,0,0,0,80.13
高雄市,新興區,南港里,446,2,1081,14,1095,1365,0,0,0,0,0,0,80.22
高雄市,新興區,南港里,447,2,722,9,731,938,0,0,0,0,0,0,77.93
高雄市,新興區,中東里,448,2,775,8,783,1093,0,0,0,0,0,0,71.64
高雄市,新興區,中東里,449,2,951,16,967,1319,0,0,0,0,0,0,73.31
高雄市,新興區,明莊里,450,2,690,20,710,893,0,0,0,0,0,0,79.51
高雄市,新興區,大明里,451,2,937,12,949,1197,0,0,0,0,0,0,79.28
高雄市,新興區,秋山里,452,2,933,16,949,1187,0,0,0,0,0,0,79.95
高雄市,新興區,長驛里,453,2,655,8,663,840,0,0,0,0,0,0,78.93
高雄市,新興區,建興里,454,2,689,16,705,873,0,0,0,0,0,0,80.76
高雄市,新興區,建華里,455,2,777,9,786,1015,0,0,0,0,0,0,77.44
高雄市,新興區,漢民里,456,2,762,16,778,935,0,0,0,0,0,0,83.21
高雄市,新興區,榮治里,457,2,662,14,676,819,0,0,0,0,0,0,82.54
高雄市,新興區,東坡里,458,2,1130,15,1145,1407,0,0,0,0,0,0,81.38
高雄市,前金區,三川里,459,2,657,17,674,854,0,0,0,0,0,0,78.92
高雄市,前金區,草江里,460,2,926,15,941,1204,0,0,0,0,0,0,78.16
高雄市,前金區,長城里,461,2,1170,15,1185,1492,0,0,0,0,0,0,79.42
高雄市,前金區,北金里,462,2,666,14,680,858,0,0,0,0,0,0,79.25
高雄市,前金區,東金里,463,2,688,18,706,949,0,0,0,0,0,0,74.39
高雄市,前金區,新生里,464,2,1464,27,1491,1912,0,0,0,0,0,0,77.98
高雄市,前金區,新生里,465,2,877,18,895,1186,0,0,0,0,0,0,75.46
高雄市,前金區,後金里,466,2,822,15,837,1047,0,0,0,0,0,0,79.94
高雄市,前金區,長興里,467,2,832,8,840,1120,0,0,0,0,0,0,75.00
高雄市,前金區,青山里,468,2,988,19,1007,1313,0,0,0,0,0,0,76.69
高雄市,前金區,民生里,469,2,558,12,570,742,0,0,0,0,0,0,76.82
高雄市,前金區,復元里,470,2,753,10,763,1014,0,0,0,0,0,0,75.25
高雄市,前金區,林投里,471,2,1014,26,1040,1292,0,0,0,0,0,0,80.50
高雄市,前金區,國民里,472,2,941,10,951,1189,0,0,0,0,0,0,79.98
高雄市,前金區,社東里,473,2,1434,21,1455,1789,0,0,0,0,0,0,81.33
高雄市,前金區,社西里,474,2,824,26,850,1060,0,0,0,0,0,0,80.19
高雄市,前金區,博孝里,475,2,781,8,789,1018,0,0,0,0,0,0,77.50
高雄市,前金區,長生里,476,2,1207,18,1225,1633,0,0,0,0,0,0,75.02
高雄市,前金區,榮復里,477,2,1069,16,1085,1363,0,0,0,0,0,0,79.60
高雄市,前金區,文西里,478,2,884,11,895,1158,0,0,0,0,0,0,77.29
高雄市,前金區,文東里,479,2,1163,17,1180,1475,0,0,0,0,0,0,80.00
高雄市,苓雅區,博仁里,480,2,598,11,609,754,0,0,0,0,0,0,80.77
高雄市,苓雅區,苓洲里,481,2,1029,18,1047,1353,0,0,0,0,0,0,77.38
高雄市,苓雅區,苓昇里,482,2,1123,37,1160,1439,0,0,0,0,0,0,80.61
高雄市,苓雅區,苓中里,483,2,1237,26,1263,1556,0,0,0,0,0,0,81.17
高雄市,苓雅區,苓雅里,484,2,1048,20,1068,1372,0,0,0,0,0,0,77.84
高雄市,苓雅區,苓東里,485,2,1162,28,1190,1504,0,0,0,0,0,0,79.12
高雄市,苓雅區,城北里,486,2,1190,24,1214,1533,0,0,0,0,0,0,79.19
高雄市,苓雅區,城西里,487,2,566,10,576,692,0,0,0,0,0,0,83.24
高雄市,苓雅區,城東里,488,2,614,9,623,784,0,0,0,0,0,0,79.46
高雄市,苓雅區,城東里,489,2,762,10,772,966,0,0,0,0,0,0,79.92
高雄市,苓雅區,意誠里,490,2,976,19,995,1326,0,0,0,0,0,0,75.04
高雄市,苓雅區,意誠里,491,2,388,12,400,530,0,0,0,0,0,0,75.47
高雄市,苓雅區,鼓中里,492,2,1074,14,1088,1294,0,0,0,0,0,0,84.08
高雄市,苓雅區,田西里,493,2,1189,17,1206,1481,0,0,0,0,0,0,81.43
高雄市,苓雅區,人和里,494,2,1415,25,1440,1827,0,0,0,0,0,0,78.82
高雄市,苓雅區,仁政里,495,2,1262,34,1296,1688,0,0,0,0,0,0,76.78
高雄市,苓雅區,廣澤里,496,2,832,13,845,1059,0,0,0,0,0,0,79.79
高雄市,苓雅區,廣澤里,497,2,695,20,715,874,0,0,0,0,0,0,81.81
高雄市,苓雅區,美田里,498,2,968,17,985,1238,0,0,0,0,0,0,79.56
高雄市,苓雅區,華堂里,499,2,1172,23,1195,1565,0,0,0,0,0,0,76.36
高雄市,苓雅區,華堂里,500,2,1102,17,1119,1483,0,0,0,0,0,0,75.46
高雄市,苓雅區,日中里,501,2,900,23,923,1168,0,0,0,0,0,0,79.02
高雄市,苓雅區,日中里,502,2,983,14,997,1260,0,0,0,0,0,0,79.13
高雄市,苓雅區,普照里,503,2,1020,13,1033,1280,0,0,0,0,0,0,80.70
高雄市,苓雅區,普照里,504,2,964,16,980,1280,0,0,0,0,0,0,76.56
高雄市,苓雅區,和煦里,505,2,781,9,790,983,0,0,0,0,0,0,80.37
高雄市,苓雅區,和煦里,506,2,916,19,935,1179,0,0,0,0,0,0,79.30
高雄市,苓雅區,晴朗里,507,2,733,14,747,926,0,0,0,0,0,0,80.67
高雄市,苓雅區,普天里,508,2,1188,21,1209,1506,0,0,0,0,0,0,80.28
高雄市,苓雅區,普天里,509,2,909,15,924,1220,0,0,0,0,0,0,75.74
高雄市,苓雅區,林富里,510,2,1219,17,1236,1534,0,0,0,0,0,0,80.57
高雄市,苓雅區,林圍里,511,2,729,8,737,962,0,0,0,0,0,0,76.61
高雄市,苓雅區,林圍里,512,2,782,21,803,1019,0,0,0,0,0,0,78.80
高雄市,苓雅區,林安里,513,2,1194,17,1211,1522,0,0,0,0,0,0,79.57
高雄市,苓雅區,光華里,514,2,618,13,631,782,0,0,0,0,0,0,80.69
高雄市,苓雅區,林興里,515,2,1172,26,1198,1484,0,0,0,0,0,0,80.73
高雄市,苓雅區,林華里,516,2,1112,21,1133,1388,0,0,0,0,0,0,81.63
高雄市,苓雅區,林華里,517,2,1262,30,1292,1622,0,0,0,0,0,0,79.65
高雄市,苓雅區,林西里,518,2,1482,43,1525,1930,0,0,0,0,0,0,79.02
高雄市,苓雅區,林中里,519,2,1453,35,1488,1839,0,0,0,0,0,0,80.91
高雄市,苓雅區,林中里,520,2,1065,18,1083,1338,0,0,0,0,0,0,80.94
高雄市,苓雅區,林泉里,521,2,1320,10,1330,1676,0,0,0,0,0,0,79.36
高雄市,苓雅區,林南里,522,2,1132,16,1148,1481,0,0,0,0,0,0,77.52
高雄市,苓雅區,林南里,523,2,908,12,920,1243,0,0,0,0,0,0,74.01
高雄市,苓雅區,中正里,524,2,855,14,869,1141,0,0,0,0,0,0,76.16
高雄市,苓雅區,中正里,525,2,933,9,942,1236,0,0,0,0,0,0,76.21
高雄市,苓雅區,尚義里,526,2,1028,23,1051,1399,0,0,0,0,0,0,75.13
高雄市,苓雅區,同慶里,527,2,1174,22,1196,1528,0,0,0,0,0,0,78.27
高雄市,苓雅區,凱旋里,528,2,584,9,593,733,0,0,0,0,0,0,80.90
高雄市,苓雅區,凱旋里,529,2,939,14,953,1215,0,0,0,0,0,0,78.44
高雄市,苓雅區,安祥里,530,2,711,22,733,938,0,0,0,0,0,0,78.14
高雄市,苓雅區,安祥里,531,2,986,17,1003,1337,0,0,0,0,0,0,75.02
高雄市,苓雅區,奏捷里,532,2,567,7,574,719,0,0,0,0,0,0,79.83
高雄市,苓雅區,奏捷里,533,2,669,14,683,831,0,0,0,0,0,0,82.19
高雄市,苓雅區,福壽里,534,2,1306,18,1324,1624,0,0,0,0,0,0,81.53
高雄市,苓雅區,福南里,535,2,848,27,875,1080,0,0,0,0,0,0,81.02
高雄市,苓雅區,福南里,536,2,1004,14,1018,1189,0,0,0,0,0,0,85.62
高雄市,苓雅區,五權里,537,2,638,9,647,831,0,0,0,0,0,0,77.86
高雄市,苓雅區,五權里,538,2,817,14,831,1056,0,0,0,0,0,0,78.69
高雄市,苓雅區,民主里,539,2,1243,17,1260,1641,0,0,0,0,0,0,76.78
高雄市,苓雅區,民主里,540,2,1398,26,1424,1873,0,0,0,0,0,0,76.03
高雄市,苓雅區,林德里,541,2,701,13,714,891,0,0,0,0,0,0,80.13
高雄市,苓雅區,林德里,542,2,713,14,727,929,0,0,0,0,0,0,78.26
高雄市,苓雅區,林貴里,543,2,1080,19,1099,1335,0,0,0,0,0,0,82.32
高雄市,苓雅區,林榮里,544,2,1037,16,1053,1326,0,0,0,0,0,0,79.41
高雄市,苓雅區,林榮里,545,2,887,14,901,1140,0,0,0,0,0,0,79.04
高雄市,苓雅區,林榮里,546,2,1021,32,1053,1307,0,0,0,0,0,0,80.57
高雄市,苓雅區,英明里,547,2,725,13,738,934,0,0,0,0,0,0,79.01
高雄市,苓雅區,英明里,548,2,835,16,851,1046,0,0,0,0,0,0,81.36
高雄市,苓雅區,林靖里,549,2,1316,21,1337,1625,0,0,0,0,0,0,82.28
高雄市,苓雅區,朝陽里,550,2,623,14,637,806,0,0,0,0,0,0,79.03
高雄市,苓雅區,朝陽里,551,2,568,8,576,731,0,0,0,0,0,0,78.80
高雄市,苓雅區,福隆里,552,2,1172,13,1185,1458,0,0,0,0,0,0,81.28
高雄市,苓雅區,福隆里,553,2,1011,13,1024,1257,0,0,0,0,0,0,81.46
高雄市,苓雅區,福祥里,554,2,1088,11,1099,1367,0,0,0,0,0,0,80.40
高雄市,苓雅區,福海里,555,2,806,26,832,1049,0,0,0,0,0,0,79.31
高雄市,苓雅區,福康里,556,2,836,12,848,1051,0,0,0,0,0,0,80.69
高雄市,苓雅區,福康里,557,2,801,8,809,988,0,0,0,0,0,0,81.88
高雄市,苓雅區,福人里,558,2,978,26,1004,1188,0,0,0,0,0,0,84.51
高雄市,苓雅區,福人里,559,2,918,19,937,1164,0,0,0,0,0,0,80.50
高雄市,苓雅區,福地里,560,2,1196,24,1220,1448,0,0,0,0,0,0,84.25
高雄市,苓雅區,福地里,561,2,1125,24,1149,1433,0,0,0,0,0,0,80.18
高雄市,苓雅區,福居里,562,2,1177,17,1194,1428,0,0,0,0,0,0,83.61
高雄市,苓雅區,福居里,563,2,1149,21,1170,1421,0,0,0,0,0,0,82.34
高雄市,苓雅區,福東里,564,2,912,19,931,1137,0,0,0,0,0,0,81.88
高雄市,苓雅區,福東里,565,2,852,20,872,1151,0,0,0,0,0,0,75.76
高雄市,苓雅區,福西里,566,2,967,17,984,1191,0,0,0,0,0,0,82.62
高雄市,苓雅區,福西里,567,2,902,11,913,1163,0,0,0,0,0,0,78.50
高雄市,苓雅區,永康里,568,2,839,15,854,1017,0,0,0,0,0,0,83.97
高雄市,苓雅區,永康里,569,2,937,18,955,1222,0,0,0,0,0,0,78.15
高雄市,苓雅區,正文里,570,2,1287,24,1311,1604,0,0,0,0,0,0,81.73
高雄市,苓雅區,正言里,571,2,1059,18,1077,1338,0,0,0,0,0,0,80.49
高雄市,苓雅區,正言里,572,2,702,11,713,932,0,0,0,0,0,0,76.50
高雄市,苓雅區,正大里,573,2,958,20,978,1216,0,0,0,0,0,0,80.43
高雄市,苓雅區,正大里,574,2,1043,12,1055,1351,0,0,0,0,0,0,78.09
高雄市,苓雅區,正大里,575,2,1041,18,1059,1375,0,0,0,0,0,0,77.02
高雄市,苓雅區,五福里,576,2,871,22,893,1114,0,0,0,0,0,0,80.16
高雄市,苓雅區,五福里,577,2,1098,16,1114,1426,0,0,0,0,0,0,78.12
高雄市,苓雅區,五福里,578,2,930,26,956,1238,0,0,0,0,0,0,77.22
高雄市,苓雅區,正心里,579,2,1243,28,1271,1591,0,0,0,0,0,0,79.89
高雄市,苓雅區,正心里,580,2,1327,26,1353,1704,0,0,0,0,0,0,79.40
高雄市,苓雅區,正道里,581,2,948,16,964,1206,0,0,0,0,0,0,79.93
高雄市,苓雅區,正道里,582,2,952,13,965,1193,0,0,0,0,0,0,80.89
高雄市,苓雅區,正道里,583,2,873,19,892,1118,0,0,0,0,0,0,79.79
高雄市,苓雅區,正義里,584,2,841,17,858,1036,0,0,0,0,0,0,82.82
高雄市,苓雅區,正義里,585,2,847,12,859,1044,0,0,0,0,0,0,82.28
高雄市,苓雅區,正仁里,586,2,996,26,1022,1281,0,0,0,0,0,0,79.78
高雄市,苓雅區,正仁里,587,2,795,18,813,997,0,0,0,0,0,0,81.54
高雄市,苓雅區,文昌里,588,2,942,15,957,1142,0,0,0,0,0,0,83.80
高雄市,苓雅區,文昌里,589,2,975,23,998,1204,0,0,0,0,0,0,82.89
高雄市,苓雅區,文昌里,590,2,1124,18,1142,1313,0,0,0,0,0,0,86.98
高雄市,苓雅區,建軍里,591,2,758,15,773,954,0,0,0,0,0,0,81.03
高雄市,苓雅區,建軍里,592,2,804,19,823,981,0,0,0,0,0,0,83.89
高雄市,苓雅區,衛武里,593,2,829,15,844,1048,0,0,0,0,0,0,80.53
高雄市,苓雅區,衛武里,594,2,792,23,815,1033,0,0,0,0,0,0,78.90
高雄市,前鎮區,草衙里,595,2,1021,20,1041,1238,0,0,0,0,0,0,84.09
高雄市,前鎮區,草衙里,596,2,891,20,911,1130,0,0,0,0,0,0,80.62
高雄市,前鎮區,草衙里,597,2,983,19,1002,1267,0,0,0,0,0,0,79.08
高雄市,前鎮區,草衙里,598,2,918,19,937,1166,0,0,0,0,0,0,80.36
高雄市,前鎮區,草衙里,599,2,947,36,983,1219,0,0,0,0,0,0,80.64
高雄市,前鎮區,草衙里,600,2,1073,26,1099,1358,0,0,0,0,0,0,80.93
高雄市,前鎮區,明孝里,601,2,1241,29,1270,1548,0,0,0,0,0,0,82.04
高雄市,前鎮區,明孝里,602,2,706,17,723,950,0,0,0,0,0,0,76.11
高雄市,前鎮區,明正里,603,2,1128,21,1149,1384,0,0,0,0,0,0,83.02
高雄市,前鎮區,明正里,604,2,1443,30,1473,1836,0,0,0,0,0,0,80.23
高雄市,前鎮區,明義里,605,2,852,17,869,1031,0,0,0,0,0,0,84.29
高雄市,前鎮區,明義里,606,2,624,13,637,743,0,0,0,0,0,0,85.73
高雄市,前鎮區,仁愛里,607,2,1228,40,1268,1551,0,0,0,0,0,0,81.75
高雄市,前鎮區,德昌里,608,2,875,19,894,1133,0,0,0,0,0,0,78.91
高雄市,前鎮區,德昌里,609,2,632,21,653,843,0,0,0,0,0,0,77.46
高雄市,前鎮區,平等里,610,2,594,26,620,802,0,0,0,0,0,0,77.31
高雄市,前鎮區,平等里,611,2,700,17,717,905,0,0,0,0,0,0,79.23
高雄市,前鎮區,平昌里,612,2,668,10,678,825,0,0,0,0,0,0,82.18
高雄市,前鎮區,明禮里,613,2,734,19,753,934,0,0,0,0,0,0,80.62
高雄市,前鎮區,明禮里,614,2,718,13,731,870,0,0,0,0,0,0,84.02
高雄市,前鎮區,信義里,615,2,812,16,828,1018,0,0,0,0,0,0,81.34
高雄市,前鎮區,信義里,616,2,536,9,545,646,0,0,0,0,0,0,84.37
高雄市,前鎮區,信德里,617,2,914,26,940,1171,0,0,0,0,0,0,80.27
高雄市,前鎮區,信德里,618,2,1131,30,1161,1447,0,0,0,0,0,0,80.23
高雄市,前鎮區,明道里,619,2,1075,18,1093,1339,0,0,0,0,0,0,81.63
高雄市,前鎮區,興化里,620,2,574,13,587,730,0,0,0,0,0,0,80.41
高雄市,前鎮區,興仁里,621,2,806,23,829,1008,0,0,0,0,0,0,82.24
高雄市,前鎮區,前鎮里,622,2,1356,24,1380,1601,0,0,0,0,0,0,86.20
高雄市,前鎮區,鎮東里,623,2,713,16,729,848,0,0,0,0,0,0,85.97
高雄市,前鎮區,鎮東里,624,2,906,20,926,1094,0,0,0,0,0,0,84.64
高雄市,前鎮區,鎮榮里,625,2,1126,31,1157,1397,0,0,0,0,0,0,82.82
高雄市,前鎮區,鎮榮里,626,2,846,36,882,1102,0,0,0,0,0,0,80.04
高雄市,前鎮區,鎮昌里,627,2,926,19,945,1143,0,0,0,0,0,0,82.68
高雄市,前鎮區,鎮昌里,628,2,660,16,676,814,0,0,0,0,0,0,83.05
高雄市,前鎮區,鎮海里,629,2,891,21,912,1123,0,0,0,0,0,0,81.21
高雄市,前鎮區,鎮海里,630,2,955,37,992,1221,0,0,0,0,0,0,81.24
高雄市,前鎮區,鎮海里,631,2,907,26,933,1163,0,0,0,0,0,0,80.22
高雄市,前鎮區,鎮陽里,632,2,997,20,1017,1172,0,0,0,0,0,0,86.77
高雄市,前鎮區,興邦里,633,2,943,26,969,1195,0,0,0,0,0,0,81.09
高雄市,前鎮區,鎮中里,634,2,757,24,781,930,0,0,0,0,0,0,83.98
高雄市,前鎮區,鎮北里,635,2,905,15,920,1117,0,0,0,0,0,0,82.36
高雄市,前鎮區,忠純里,636,2,1038,21,1059,1272,0,0,0,0,0,0,83.25
高雄市,前鎮區,忠純里,637,2,1091,27,1118,1364,0,0,0,0,0,0,81.96
高雄市,前鎮區,忠誠里,638,2,948,20,968,1203,0,0,0,0,0,0,80.47
高雄市,前鎮區,忠誠里,639,2,681,25,706,816,0,0,0,0,0,0,86.52
高雄市,前鎮區,西山里,640,2,1156,24,1180,1479,0,0,0,0,0,0,79.78
高雄市,前鎮區,西山里,641,2,1131,23,1154,1451,0,0,0,0,0,0,79.53
高雄市,前鎮區,民權里,642,2,1161,10,1171,1409,0,0,0,0,0,0,83.11
高雄市,前鎮區,民權里,643,2,1091,27,1118,1364,0,0,0,0,0,0,81.96
高雄市,前鎮區,建隆里,644,2,751,19,770,972,0,0,0,0,0,0,79.22
高雄市,前鎮區,振興里,645,2,732,18,750,903,0,0,0,0,0,0,83.06
高雄市,前鎮區,振興里,646,2,602,18,620,727,0,0,0,0,0,0,85.28
高雄市,前鎮區,良和里,647,2,980,14,994,1257,0,0,0,0,0,0,79.08
高雄市,前鎮區,良和里,648,2,790,12,802,1072,0,0,0,0,0,0,74.81
高雄市,前鎮區,西甲里,649,2,811,18,829,985,0,0,0,0,0,0,84.16
高雄市,前鎮區,西甲里,650,2,821,19,840,1046,0,0,0,0,0,0,80.31
高雄市,前鎮區,盛興里,651,2,708,13,721,1018,0,0,0,0,0,0,70.83
高雄市,前鎮區,盛興里,652,2,902,19,921,1246,0,0,0,0,0,0,73.92
高雄市,前鎮區,盛豐里,653,2,1174,20,1194,1545,0,0,0,0,0,0,77.28
高雄市,前鎮區,盛豐里,654,2,1000,23,1023,1377,0,0,0,0,0,0,74.29
高雄市,前鎮區,興中里,655,2,1144,30,1174,1521,0,0,0,0,0,0,77.19
高雄市,前鎮區,興中里,656,2,1136,29,1165,1583,0,0,0,0,0,0,73.59
高雄市,前鎮區,興東里,657,2,959,27,986,1187,0,0,0,0,0,0,83.07
高雄市,前鎮區,興東里,658,2,930,24,954,1191,0,0,0,0,0,0,80.10
高雄市,前鎮區,興東里,659,2,918,19,937,1185,0,0,0,0,0,0,79.07
高雄市,前鎮區,忠孝里,660,2,964,12,976,1196,0,0,0,0,0,0,81.61
高雄市,前鎮區,忠孝里,661,2,956,23,979,1243,0,0,0,0,0,0,78.76
高雄市,前鎮區,復國里,662,2,1111,17,1128,1378,0,0,0,0,0,0,81.86
高雄市,前鎮區,復國里,663,2,1091,21,1112,1372,0,0,0,0,0,0,81.05
高雄市,前鎮區,竹內里,664,2,906,21,927,1168,0,0,0,0,0,0,79.37
高雄市,前鎮區,竹內里,665,2,1056,28,1084,1381,0,0,0,0,0,0,78.49
高雄市,前鎮區,竹東里,666,2,734,21,755,1016,0,0,0,0,0,0,74.31
高雄市,前鎮區,竹東里,667,2,739,17,756,962,0,0,0,0,0,0,78.59
高雄市,前鎮區,竹南里,668,2,911,19,930,1170,0,0,0,0,0,0,79.49
高雄市,前鎮區,竹南里,669,2,884,76,960,1204,0,0,0,0,0,0,79.73
高雄市,前鎮區,竹北里,670,2,814,14,828,1060,0,0,0,0,0,0,78.11
高雄市,前鎮區,竹北里,671,2,643,15,658,851,0,0,0,0,0,0,77.32
高雄市,前鎮區,竹西里,672,2,1053,22,1075,1297,0,0,0,0,0,0,82.88
高雄市,前鎮區,竹西里,673,2,1373,13,1386,1698,0,0,0,0,0,0,81.63
高雄市,前鎮區,竹中里,674,2,1100,19,1119,1409,0,0,0,0,0,0,79.42
高雄市,前鎮區,竹中里,675,2,972,21,993,1243,0,0,0,0,0,0,79.89
高雄市,前鎮區,瑞竹里,676,2,1054,26,1080,1333,0,0,0,0,0,0,81.02
高雄市,前鎮區,瑞南里,677,2,1058,25,1083,1321,0,0,0,0,0,0,81.98
高雄市,前鎮區,瑞南里,678,2,1283,21,1304,1540,0,0,0,0,0,0,84.68
高雄市,前鎮區,瑞南里,679,2,1198,24,1222,1486,0,0,0,0,0,0,82.23
高雄市,前鎮區,瑞豐里,680,2,970,20,990,1197,0,0,0,0,0,0,82.71
高雄市,前鎮區,瑞豐里,681,2,816,23,839,1013,0,0,0,0,0,0,82.82
高雄市,前鎮區,瑞祥里,682,2,909,14,923,1170,0,0,0,0,0,0,78.89
高雄市,前鎮區,瑞祥里,683,2,954,26,980,1165,0,0,0,0,0,0,84.12
高雄市,前鎮區,瑞祥里,684,2,1530,18,1548,1854,0,0,0,0,0,0,83.50
高雄市,前鎮區,瑞東里,685,2,929,15,944,1156,0,0,0,0,0,0,81.66
高雄市,前鎮區,瑞東里,686,2,973,15,988,1252,0,0,0,0,0,0,78.91
高雄市,前鎮區,瑞和里,687,2,769,20,789,947,0,0,0,0,0,0,83.32
高雄市,前鎮區,瑞和里,688,2,783,29,812,1019,0,0,0,0,0,0,79.69
高雄市,前鎮區,瑞平里,689,2,1189,24,1213,1451,0,0,0,0,0,0,83.60
高雄市,前鎮區,瑞平里,690,2,1225,29,1254,1506,0,0,0,0,0,0,83.27
高雄市,前鎮區,瑞隆里,691,2,1014,26,1040,1332,0,0,0,0,0,0,78.08
高雄市,前鎮區,瑞隆里,692,2,1260,27,1287,1608,0,0,0,0,0,0,80.04
高雄市,前鎮區,瑞北里,693,2,1137,22,1159,1375,0,0,0,0,0,0,84.29
高雄市,前鎮區,瑞北里,694,2,1095,18,1113,1347,0,0,0,0,0,0,82.63
高雄市,前鎮區,瑞西里,695,2,1146,22,1168,1390,0,0,0,0,0,0,84.03
高雄市,前鎮區,瑞西里,696,2,1126,21,1147,1307,0,0,0,0,0,0,87.76
高雄市,前鎮區,瑞崗里,697,2,1173,27,1200,1481,0,0,0,0,0,0,81.03
高雄市,前鎮區,瑞崗里,698,2,885,18,903,1124,0,0,0,0,0,0,80.34
高雄市,前鎮區,瑞興里,699,2,1010,20,1030,1257,0,0,0,0,0,0,81.94
高雄市,前鎮區,瑞興里,700,2,1041,16,1057,1320,0,0,0,0,0,0,80.08
高雄市,前鎮區,瑞誠里,701,2,1011,25,1036,1265,0,0,0,0,0,0,81.90
高雄市,前鎮區,瑞誠里,702,2,700,14,714,883,0,0,0,0,0,0,80.86
高雄市,前鎮區,瑞文里,703,2,736,16,752,921,0,0,0,0,0,0,81.65
高雄市,前鎮區,瑞文里,704,2,984,20,1004,1237,0,0,0,0,0,0,81.16
高雄市,前鎮區,瑞華里,705,2,1384,31,1415,1758,0,0,0,0,0,0,80.49
高雄市,前鎮區,瑞華里,706,2,1260,22,1282,1630,0,0,0,0,0,0,78.65
高雄市,前鎮區,瑞昌里,707,2,924,24,948,1208,0,0,0,0,0,0,78.48
高雄市,前鎮區,瑞昌里,708,2,932,31,963,1235,0,0,0,0,0,0,77.98
高雄市,小港區,小港里,709,2,576,20,596,713,0,0,0,0,0,0,83.59
高雄市,小港區,小港里,710,2,826,19,845,1029,0,0,0,0,0,0,82.12
高雄市,小港區,港口里,711,2,1083,14,1097,1362,0,0,0,0,0,0,80.54
高雄市,小港區,港口里,712,2,1050,15,1065,1347,0,0,0,0,0,0,79.06
高雄市,小港區,港正里,713,2,762,9,771,953,0,0,0,0,0,0,80.90
高雄市,小港區,港正里,714,2,745,14,759,912,0,0,0,0,0,0,83.22
高雄市,小港區,港墘里,715,2,1094,25,1119,1321,0,0,0,0,0,0,84.71
高雄市,小港區,港明里,716,2,1031,26,1057,1240,0,0,0,0,0,0,85.24
高雄市,小港區,港明里,717,2,1054,26,1080,1283,0,0,0,0,0,0,84.18
高雄市,小港區,港后里,718,2,691,14,705,831,0,0,0,0,0,0,84.84
高雄市,小港區,港后里,719,2,646,9,655,782,0,0,0,0,0,0,83.76
高雄市,小港區,港南里,720,2,1031,15,1046,1295,0,0,0,0,0,0,80.77
高雄市,小港區,港興里,721,2,1398,21,1419,1685,0,0,0,0,0,0,84.21
高雄市,小港區,鳳宮里,722,2,1222,24,1246,1542,0,0,0,0,0,0,80.80
高雄市,小港區,店鎮里,723,2,984,20,1004,1222,0,0,0,0,0,0,82.16
高雄市,小港區,店鎮里,724,2,1067,18,1085,1287,0,0,0,0,0,0,84.30
高雄市,小港區,店鎮里,725,2,998,12,1010,1261,0,0,0,0,0,0,80.10
高雄市,小港區,大苓里,726,2,726,5,731,913,0,0,0,0,0,0,80.07
高雄市,小港區,大苓里,727,2,823,15,838,991,0,0,0,0,0,0,84.56
高雄市,小港區,二苓里,728,2,991,19,1010,1222,0,0,0,0,0,0,82.65
高雄市,小港區,二苓里,729,2,1083,17,1100,1340,0,0,0,0,0,0,82.09
高雄市,小港區,三苓里,730,2,949,22,971,1184,0,0,0,0,0,0,82.01
高雄市,小港區,三苓里,731,2,854,10,864,1001,0,0,0,0,0,0,86.31
高雄市,小港區,正苓里,732,2,1146,26,1172,1472,0,0,0,0,0,0,79.62
高雄市,小港區,正苓里,733,2,1153,19,1172,1467,0,0,0,0,0,0,79.89
高雄市,小港區,順苓里,734,2,1072,21,1093,1368,0,0,0,0,0,0,79.90
高雄市,小港區,順苓里,735,2,1154,20,1174,1448,0,0,0,0,0,0,81.08
高雄市,小港區,六苓里,736,2,888,19,907,1093,0,0,0,0,0,0,82.98
高雄市,小港區,宏亮里,737,2,1496,32,1528,1856,0,0,0,0,0,0,82.33
高雄市,小港區,山東里,738,2,928,26,954,1201,0,0,0,0,0,0,79.43
高雄市,小港區,山東里,739,2,826,16,842,1056,0,0,0,0,0,0,79.73
高雄市,小港區,青島里,740,2,1378,35,1413,1700,0,0,0,0,0,0,83.12
高雄市,小港區,濟南里,741,2,1007,21,1028,1250,0,0,0,0,0,0,82.24
高雄市,小港區,濟南里,742,2,871,22,893,1102,0,0,0,0,0,0,81.03
高雄市,小港區,泰山里,743,2,1421,26,1447,1712,0,0,0,0,0,0,84.52
高雄市,小港區,山明里,744,2,1263,31,1294,1562,0,0,0,0,0,0,82.84
高雄市,小港區,山明里,745,2,1295,26,1321,1611,0,0,0,0,0,0,82.00
高雄市,小港區,高松里,746,2,1214,26,1240,1477,0,0,0,0,0,0,83.95
高雄市,小港區,高松里,747,2,1213,19,1232,1445,0,0,0,0,0,0,85.26
高雄市,小港區,松金里,748,2,1241,35,1276,1610,0,0,0,0,0,0,79.25
高雄市,小港區,松山里,749,2,1050,17,1067,1272,0,0,0,0,0,0,83.88
高雄市,小港區,大坪里,750,2,800,13,813,950,0,0,0,0,0,0,85.58
高雄市,小港區,坪頂里,751,2,818,13,831,958,0,0,0,0,0,0,86.74
高雄市,小港區,孔宅里,752,2,889,21,910,1053,0,0,0,0,0,0,86.42
高雄市,小港區,孔宅里,753,2,709,21,730,955,0,0,0,0,0,0,76.44
高雄市,小港區,孔宅里,754,2,734,21,755,981,0,0,0,0,0,0,76.96
高雄市,小港區,廈莊里,755,2,1240,23,1263,1489,0,0,0,0,0,0,84.82
高雄市,小港區,合作里,756,2,790,12,802,966,0,0,0,0,0,0,83.02
高雄市,小港區,合作里,757,2,753,19,772,935,0,0,0,0,0,0,82.57
高雄市,小港區,桂林里,758,2,1240,26,1266,1589,0,0,0,0,0,0,79.67
高雄市,小港區,桂林里,759,2,1354,41,1395,1699,0,0,0,0,0,0,82.11
高雄市,小港區,桂林里,760,2,1137,27,1164,1460,0,0,0,0,0,0,79.73
高雄市,小港區,中厝里,761,2,845,15,860,1029,0,0,0,0,0,0,83.58
高雄市,小港區,中厝里,762,2,1045,15,1060,1266,0,0,0,0,0,0,83.73
高雄市,小港區,鳳鳴里,763,2,811,8,819,948,0,0,0,0,0,0,86.39
高雄市,小港區,鳳鳴里,764,2,943,20,963,1100,0,0,0,0,0,0,87.55
高雄市,小港區,龍鳳里,765,2,776,18,794,920,0,0,0,0,0,0,86.30
高雄市,小港區,龍鳳里,766,2,867,9,876,1018,0,0,0,0,0,0,86.05
高雄市,小港區,鳳森里,767,2,1229,15,1244,1470,0,0,0,0,0,0,84.63
高雄市,小港區,鳳林里,768,2,818,14,832,1035,0,0,0,0,0,0,80.39
高雄市,小港區,鳳林里,769,2,854,15,869,1063,0,0,0,0,0,0,81.75
高雄市,小港區,鳳興里,770,2,1231,19,1250,1473,0,0,0,0,0,0,84.86
高雄市,小港區,鳳源里,771,2,896,9,905,1059,0,0,0,0,0,0,85.46
高雄市,小港區,鳳源里,772,2,970,24,994,1222,0,0,0,0,0,0,81.34
高雄市,小港區,海澄里,773,2,1159,30,1189,1399,0,0,0,0,0,0,84.99
高雄市,小港區,海澄里,774,2,1074,32,1106,1315,0,0,0,0,0,0,84.11
高雄市,小港區,海澄里,775,2,1238,22,1260,1590,0,0,0,0,0,0,79.25
高雄市,小港區,海昌里,776,2,873,16,889,1120,0,0,0,0,0,0,79.38
高雄市,小港區,海昌里,777,2,913,18,931,1135,0,0,0,0,0,0,82.03
高雄市,小港區,海豐里,778,2,1061,29,1090,1334,0,0,0,0,0,0,81.71
高雄市,小港區,海豐里,779,2,866,7,873,1062,0,0,0,0,0,0,82.20
高雄市,小港區,海原里,780,2,998,25,1023,1300,0,0,0,0,0,0,78.69
高雄市,小港區,海原里,781,2,1093,27,1120,1429,0,0,0,0,0,0,78.38
高雄市,小港區,海城里,782,2,1044,23,1067,1355,0,0,0,0,0,0,78.75
高雄市,小港區,海城里,783,2,1045,34,1079,1380,0,0,0,0,0,0,78.19
臺北縣,板橋市,留侯里,1,1,681,9,690,1166,0,0,0,0,0,0,59.18
臺北縣,板橋市,流芳里,2,1,763,12,775,1234,0,0,0,0,0,0,62.80
臺北縣,板橋市,赤松里,3,1,417,12,429,642,0,0,0,0,0,0,66.82
臺北縣,板橋市,黃石里,4,1,701,8,709,1066,0,0,0,0,0,0,66.51
臺北縣,板橋市,挹秀里,5,1,526,8,534,819,0,0,0,0,0,0,65.20
臺北縣,板橋市,挹秀里,6,1,405,5,410,680,0,0,0,0,0,0,60.29
臺北縣,板橋市,湳興里,7,1,580,15,595,878,0,0,0,0,0,0,67.77
臺北縣,板橋市,湳興里,8,1,541,11,552,921,0,0,0,0,0,0,59.93
臺北縣,板橋市,湳興里,9,1,523,9,532,817,0,0,0,0,0,0,65.12
臺北縣,板橋市,湳興里,10,1,712,10,722,1127,0,0,0,0,0,0,64.06
臺北縣,板橋市,新興里,11,1,795,13,808,1170,0,0,0,0,0,0,69.06
臺北縣,板橋市,新興里,12,1,759,11,770,1228,0,0,0,0,0,0,62.70
臺北縣,板橋市,社後里,13,1,641,13,654,1077,0,0,0,0,0,0,60.72
臺北縣,板橋市,社後里,14,1,866,12,878,1360,0,0,0,0,0,0,64.56
臺北縣,板橋市,社後里,15,1,667,10,677,1076,0,0,0,0,0,0,62.92
臺北縣,板橋市,社後里,16,1,574,7,581,980,0,0,0,0,0,0,59.29
臺北縣,板橋市,香社里,17,1,747,12,759,1145,0,0,0,0,0,0,66.29
臺北縣,板橋市,香社里,18,1,681,10,691,1057,0,0,0,0,0,0,65.37
臺北縣,板橋市,香社里,19,1,636,7,643,1002,0,0,0,0,0,0,64.17
臺北縣,板橋市,香雅里,20,1,626,4,630,963,0,0,0,0,0,0,65.42
臺北縣,板橋市,香雅里,21,1,645,5,650,1062,0,0,0,0,0,0,61.21
臺北縣,板橋市,中正里,22,1,647,8,655,1131,0,0,0,0,0,0,57.91
臺北縣,板橋市,中正里,23,1,709,10,719,1171,0,0,0,0,0,0,61.40
臺北縣,板橋市,中正里,24,1,626,8,634,1139,0,0,0,0,0,0,55.66
臺北縣,板橋市,自強里,25,1,667,6,673,1108,0,0,0,0,0,0,60.74
臺北縣,板橋市,自強里,26,1,638,8,646,974,0,0,0,0,0,0,66.32
臺北縣,板橋市,自強里,27,1,653,9,662,1154,0,0,0,0,0,0,57.37
臺北縣,板橋市,自強里,28,1,627,12,639,1046,0,0,0,0,0,0,61.09
臺北縣,板橋市,自立里,29,1,843,11,854,1237,0,0,0,0,0,0,69.04
臺北縣,板橋市,自立里,30,1,721,12,733,1086,0,0,0,0,0,0,67.50
臺北縣,板橋市,光華里,31,1,656,11,667,1132,0,0,0,0,0,0,58.92
臺北縣,板橋市,光華里,32,1,630,2,632,964,0,0,0,0,0,0,65.56
臺北縣,板橋市,光榮里,33,1,686,6,692,1078,0,0,0,0,0,0,64.19
臺北縣,板橋市,光榮里,34,1,686,12,698,1053,0,0,0,0,0,0,66.29
臺北縣,板橋市,國光里,35,1,759,6,765,1113,0,0,0,0,0,0,68.73
臺北縣,板橋市,國光里,36,1,742,1,743,1038,0,0,0,0,0,0,71.58
臺北縣,板橋市,國光里,37,1,584,10,594,941,0,0,0,0,0,0,63.12
臺北縣,板橋市,港尾里,38,1,495,3,498,890,0,0,0,0,0,0,55.96
臺北縣,板橋市,港尾里,39,1,451,4,455,784,0,0,0,0,0,0,58.04
臺北縣,板橋市,新生里,40,1,652,7,659,1145,0,0,0,0,0,0,57.55
臺北縣,板橋市,新生里,41,1,692,13,705,1200,0,0,0,0,0,0,58.75
臺北縣,板橋市,新生里,42,1,563,5,568,999,0,0,0,0,0,0,56.86
臺北縣,板橋市,金華里,43,1,582,7,589,1060,0,0,0,0,0,0,55.57
臺北縣,板橋市,金華里,44,1,551,13,564,1036,0,0,0,0,0,0,54.44
臺北縣,板橋市,金華里,45,1,575,6,581,1005,0,0,0,0,0,0,57.81
臺北縣,板橋市,港德里,46,1,581,12,593,1125,0,0,0,0,0,0,52.71
臺北縣,板橋市,港德里,47,1,512,9,521,1038,0,0,0,0,0,0,50.19
臺北縣,板橋市,港德里,48,1,455,11,466,856,0,0,0,0,0,0,54.44
臺北縣,板橋市,港德里,49,1,579,5,584,1018,0,0,0,0,0,0,57.37
臺北縣,板橋市,民權里,50,1,765,5,770,1184,0,0,0,0,0,0,65.03
臺北縣,板橋市,民權里,51,1,818,10,828,1257,0,0,0,0,0,0,65.87
臺北縣,板橋市,民安里,52,1,509,8,517,775,0,0,0,0,0,0,66.71
臺北縣,板橋市,民安里,53,1,610,8,618,920,0,0,0,0,0,0,67.17
臺北縣,板橋市,建國里,54,1,606,3,609,966,0,0,0,0,0,0,63.04
臺北縣,板橋市,建國里,55,1,737,17,754,1163,0,0,0,0,0,0,64.83
臺北縣,板橋市,建國里,56,1,642,7,649,963,0,0,0,0,0,0,67.39
臺北縣,板橋市,漢生里,57,1,581,1,582,957,0,0,0,0,0,0,60.82
臺北縣,板橋市,漢生里,58,1,866,3,869,1302,0,0,0,0,0,0,66.74
臺北縣,板橋市,漢生里,59,1,720,17,737,1270,0,0,0,0,0,0,58.03
臺北縣,板橋市,新民里,60,1,736,9,745,1130,0,0,0,0,0,0,65.93
臺北縣,板橋市,新民里,61,1,613,8,621,975,0,0,0,0,0,0,63.69
臺北縣,板橋市,新民里,62,1,546,6,552,932,0,0,0,0,0,0,59.23
臺北縣,板橋市,公館里,63,1,728,14,742,1161,0,0,0,0,0,0,63.91
臺北縣,板橋市,公館里,64,1,595,6,601,933,0,0,0,0,0,0,64.42
臺北縣,板橋市,公館里,65,1,809,15,824,1264,0,0,0,0,0,0,65.19
臺北縣,板橋市,幸福里,66,1,574,8,582,880,0,0,0,0,0,0,66.14
臺北縣,板橋市,幸福里,67,1,693,12,705,1150,0,0,0,0,0,0,61.30
臺北縣,板橋市,幸福里,68,1,697,4,701,1184,0,0,0,0,0,0,59.21
臺北縣,板橋市,文德里,69,1,445,12,457,900,0,0,0,0,0,0,50.78
臺北縣,板橋市,文德里,70,1,552,8,560,933,0,0,0,0,0,0,60.02
臺北縣,板橋市,忠誠里,71,1,709,7,716,1069,0,0,0,0,0,0,66.98
臺北縣,板橋市,忠誠里,72,1,663,9,672,992,0,0,0,0,0,0,67.74
臺北縣,板橋市,陽明里,73,1,746,5,751,1182,0,0,0,0,0,0,63.54
臺北縣,板橋市,陽明里,74,1,643,15,658,1081,0,0,0,0,0,0,60.87
臺北縣,板橋市,百壽里,75,1,621,9,630,966,0,0,0,0,0,0,65.22
臺北縣,板橋市,百壽里,76,1,701,8,709,992,0,0,0,0,0,0,71.47
臺北縣,板橋市,介壽里,77,1,785,14,799,1228,0,0,0,0,0,0,65.07
臺北縣,板橋市,介壽里,78,1,742,10,752,1174,0,0,0,0,0,0,64.05
臺北縣,板橋市,新埔里,79,1,588,5,593,907,0,0,0,0,0,0,65.38
臺北縣,板橋市,新埔里,80,1,742,15,757,1111,0,0,0,0,0,0,68.14
臺北縣,板橋市,華江里,81,1,470,12,482,831,0,0,0,0,0,0,58.00
臺北縣,板橋市,華江里,82,1,566,4,570,866,0,0,0,0,0,0,65.82
臺北縣,板橋市,華江里,83,1,799,17,816,1322,0,0,0,0,0,0,61.72
臺北縣,板橋市,江翠里,84,1,739,10,749,1204,0,0,0,0,0,0,62.21
臺北縣,板橋市,江翠里,85,1,791,12,803,1196,0,0,0,0,0,0,67.14
臺北縣,板橋市,江翠里,86,1,711,13,724,1211,0,0,0,0,0,0,59.79
臺北縣,板橋市,純翠里,87,1,604,10,614,1023,0,0,0,0,0,0,60.02
臺北縣,板橋市,純翠里,88,1,680,12,692,1161,0,0,0,0,0,0,59.60
臺北縣,板橋市,純翠里,89,1,768,12,780,1339,0,0,0,0,0,0,58.25
臺北縣,板橋市,溪頭里,90,1,565,8,573,968,0,0,0,0,0,0,59.19
臺北縣,板橋市,溪頭里,91,1,641,8,649,1122,0,0,0,0,0,0,57.84
臺北縣,板橋市,溪頭里,92,1,622,6,628,1049,0,0,0,0,0,0,59.87
臺北縣,板橋市,溪頭里,93,1,605,12,617,992,0,0,0,0,0,0,62.20
臺北縣,板橋市,聯翠里,94,1,469,4,473,831,0,0,0,0,0,0,56.92
臺北縣,板橋市,聯翠里,95,1,727,8,735,1136,0,0,0,0,0,0,64.70
臺北縣,板橋市,文化里,96,1,716,10,726,1172,0,0,0,0,0,0,61.95
臺北縣,板橋市,文化里,97,1,774,8,782,1224,0,0,0,0,0,0,63.89
臺北縣,板橋市,宏翠里,98,1,743,15,758,1092,0,0,0,0,0,0,69.41
臺北縣,板橋市,宏翠里,99,1,757,15,772,1144,0,0,0,0,0,0,67.48
臺北縣,板橋市,仁翠里,100,1,751,24,775,1209,0,0,0,0,0,0,64.10
臺北縣,板橋市,仁翠里,101,1,888,15,903,1336,0,0,0,0,0,0,67.59
臺北縣,板橋市,新翠里,102,1,828,12,840,1386,0,0,0,0,0,0,60.61
臺北縣,板橋市,新翠里,103,1,913,7,920,1575,0,0,0,0,0,0,58.41
臺北縣,板橋市,新翠里,104,1,930,20,950,1543,0,0,0,0,0,0,61.57
臺北縣,板橋市,朝陽里,105,1,456,4,460,736,0,0,0,0,0,0,62.50
臺北縣,板橋市,朝陽里,106,1,481,3,484,786,0,0,0,0,0,0,61.58
臺北縣,板橋市,朝陽里,107,1,628,9,637,1075,0,0,0,0,0,0,59.26
臺北縣,板橋市,吉翠里,108,1,620,6,626,984,0,0,0,0,0,0,63.62
臺北縣,板橋市,吉翠里,109,1,541,14,555,890,0,0,0,0,0,0,62.36
臺北縣,板橋市,吉翠里,110,1,571,14,585,901,0,0,0,0,0,0,64.93
臺北縣,板橋市,德翠里,111,1,571,12,583,955,0,0,0,0,0,0,61.05
臺北縣,板橋市,德翠里,112,1,676,12,688,1038,0,0,0,0,0,0,66.28
臺北縣,板橋市,德翠里,113,1,650,8,658,1063,0,0,0,0,0,0,61.90
臺北縣,板橋市,新海里,114,1,543,5,548,950,0,0,0,0,0,0,57.68
臺北縣,板橋市,新海里,115,1,531,9,540,865,0,0,0,0,0,0,62.43
臺北縣,板橋市,新海里,116,1,512,9,521,809,0,0,0,0,0,0,64.40
臺北縣,板橋市,滿翠里,117,1,527,4,531,790,0,0,0,0,0,0,67.22
臺北縣,板橋市,滿翠里,118,1,501,6,507,861,0,0,0,0,0,0,58.89
臺北縣,板橋市,滿翠里,119,1,573,14,587,941,0,0,0,0,0,0,62.38
臺北縣,板橋市,明翠里,120,1,470,8,478,775,0,0,0,0,0,0,61.68
臺北縣,板橋市,明翠里,121,1,618,7,625,1015,0,0,0,0,0,0,61.58
臺北縣,板橋市,明翠里,122,1,648,6,654,1073,0,0,0,0,0,0,60.95
臺北縣,板橋市,明翠里,123,1,690,11,701,1118,0,0,0,0,0,0,62.70
臺北縣,板橋市,松翠里,124,1,734,6,740,1303,0,0,0,0,0,0,56.79
臺北縣,板橋市,松翠里,125,1,869,11,880,1454,0,0,0,0,0,0,60.52
臺北縣,板橋市,柏翠里,126,1,697,6,703,1171,0,0,0,0,0,0,60.03
臺北縣,板橋市,柏翠里,127,1,754,10,764,1251,0,0,0,0,0,0,61.07
臺北縣,板橋市,龍翠里,128,1,513,4,517,894,0,0,0,0,0,0,57.83
臺北縣,板橋市,龍翠里,129,1,615,6,621,1089,0,0,0,0,0,0,57.02
臺北縣,板橋市,龍翠里,130,1,636,6,642,979,0,0,0,0,0,0,65.58
臺北縣,板橋市,松柏里,131,1,738,13,751,1075,0,0,0,0,0,0,69.86
臺北縣,板橋市,松柏里,132,1,526,6,532,854,0,0,0,0,0,0,62.30
臺北縣,板橋市,華翠里,133,1,748,12,760,1238,0,0,0,0,0,0,61.39
臺北縣,板橋市,華翠里,134,1,773,13,786,1358,0,0,0,0,0,0,57.88
臺北縣,板橋市,莒光里,135,1,751,14,765,1251,0,0,0,0,0,0,61.15
臺北縣,板橋市,莒光里,136,1,639,6,645,1084,0,0,0,0,0,0,59.50
臺北縣,板橋市,忠翠里,137,1,839,7,846,1370,0,0,0,0,0,0,61.75
臺北縣,板橋市,忠翠里,138,1,752,21,773,1208,0,0,0,0,0,0,63.99
臺北縣,板橋市,忠翠里,139,1,782,14,796,1381,0,0,0,0,0,0,57.64
臺北縣,板橋市,嵐翠里,140,1,609,12,621,1094,0,0,0,0,0,0,56.76
臺北縣,板橋市,嵐翠里,141,1,608,10,618,1030,0,0,0,0,0,0,60.00
臺北縣,板橋市,文聖里,142,1,694,11,705,1102,0,0,0,0,0,0,63.97
臺北縣,板橋市,文聖里,143,1,638,16,654,979,0,0,0,0,0,0,66.80
臺北縣,板橋市,文翠里,144,1,703,6,709,1140,0,0,0,0,0,0,62.19
臺北縣,板橋市,文翠里,145,1,546,9,555,922,0,0,0,0,0,0,60.20
臺北縣,板橋市,文翠里,146,1,638,9,647,1041,0,0,0,0,0,0,62.15
臺北縣,板橋市,青翠里,147,1,624,7,631,1203,0,0,0,0,0,0,52.45
臺北縣,板橋市,青翠里,148,1,698,12,710,1273,0,0,0,0,0,0,55.77
臺北縣,板橋市,懷翠里,149,1,736,15,751,1284,0,0,0,0,0,0,58.49
臺北縣,板橋市,懷翠里,150,1,741,6,747,1332,0,0,0,0,0,0,56.08
臺北縣,板橋市,懷翠里,151,1,693,9,702,1263,0,0,0,0,0,0,55.58
臺北縣,板橋市,福翠里,152,1,446,8,454,726,0,0,0,0,0,0,62.53
臺北縣,板橋市,福翠里,153,1,588,11,599,910,0,0,0,0,0,0,65.82
臺北縣,板橋市,港嘴里,154,1,757,10,767,1251,0,0,0,0,0,0,61.31
臺北縣,板橋市,港嘴里,155,1,748,10,758,1186,0,0,0,0,0,0,63.91
臺北縣,板橋市,港嘴里,156,1,471,4,475,895,0,0,0,0,0,0,53.07
臺北縣,板橋市,港嘴里,157,1,383,6,389,774,0,0,0,0,0,0,50.26
臺北縣,板橋市,振興里,158,1,720,8,728,1171,0,0,0,0,0,0,62.17
臺北縣,板橋市,振興里,159,1,760,12,772,1202,0,0,0,0,0,0,64.23
臺北縣,板橋市,振興里,160,1,615,14,629,883,0,0,0,0,0,0,71.23
臺北縣,板橋市,振義里,161,1,657,11,668,1035,0,0,0,0,0,0,64.54
臺北縣,板橋市,振義里,162,1,619,13,632,1051,0,0,0,0,0,0,60.13
臺北縣,板橋市,振義里,163,1,575,7,582,849,0,0,0,0,0,0,68.55
臺北縣,板橋市,光復里,164,1,712,10,722,1154,0,0,0,0,0,0,62.56
臺北縣,板橋市,光復里,165,1,724,14,738,1240,0,0,0,0,0,0,59.52
臺北縣,板橋市,埔墘里,166,1,741,15,756,1162,0,0,0,0,0,0,65.06
臺北縣,板橋市,埔墘里,167,1,774,14,788,1247,0,0,0,0,0,0,63.19
臺北縣,板橋市,埔墘里,168,1,805,7,812,1419,0,0,0,0,0,0,57.22
臺北縣,板橋市,富貴里,169,1,481,4,485,898,0,0,0,0,0,0,54.01
臺北縣,板橋市,富貴里,170,1,463,3,466,834,0,0,0,0,0,0,55.88
臺北縣,板橋市,長壽里,171,1,805,15,820,1144,0,0,0,0,0,0,71.68
臺北縣,板橋市,長壽里,172,1,678,16,694,1022,0,0,0,0,0,0,67.91
臺北縣,板橋市,福壽里,173,1,544,9,553,972,0,0,0,0,0,0,56.89
臺北縣,板橋市,福壽里,174,1,658,20,678,1059,0,0,0,0,0,0,64.02
臺北縣,板橋市,居仁里,175,1,806,13,819,1300,0,0,0,0,0,0,63.00
臺北縣,板橋市,居仁里,176,1,639,19,658,1016,0,0,0,0,0,0,64.76
臺北縣,板橋市,海山里,177,1,682,16,698,1095,0,0,0,0,0,0,63.74
臺北縣,板橋市,海山里,178,1,638,6,644,1037,0,0,0,0,0,0,62.10
臺北縣,板橋市,海山里,179,1,781,11,792,1191,0,0,0,0,0,0,66.50
臺北縣,板橋市,海山里,180,1,592,6,598,1106,0,0,0,0,0,0,54.07
臺北縣,板橋市,九如里,181,1,716,10,726,1225,0,0,0,0,0,0,59.27
臺北縣,板橋市,九如里,182,1,654,8,662,1085,0,0,0,0,0,0,61.01
臺北縣,板橋市,正泰里,183,1,696,15,711,1143,0,0,0,0,0,0,62.20
臺北縣,板橋市,正泰里,184,1,714,12,726,1070,0,0,0,0,0,0,67.85
臺北縣,板橋市,玉光里,185,1,688,12,700,1215,0,0,0,0,0,0,57.61
臺北縣,板橋市,玉光里,186,1,719,17,736,1153,0,0,0,0,0,0,63.83
臺北縣,板橋市,玉光里,187,1,672,16,688,1079,0,0,0,0,0,0,63.76
臺北縣,板橋市,光仁里,188,1,782,13,795,1194,0,0,0,0,0,0,66.58
臺北縣,板橋市,光仁里,189,1,724,16,740,1105,0,0,0,0,0,0,66.97
臺北縣,板橋市,埤墘里,190,1,912,8,920,1482,0,0,0,0,0,0,62.08
臺北縣,板橋市,埤墘里,191,1,743,5,748,1196,0,0,0,0,0,0,62.54
臺北縣,板橋市,莊敬里,192,1,627,7,634,976,0,0,0,0,0,0,64.96
臺北縣,板橋市,莊敬里,193,1,507,9,516,738,0,0,0,0,0,0,69.92
臺北縣,板橋市,永安里,194,1,608,13,621,1039,0,0,0,0,0,0,59.77
臺北縣,板橋市,永安里,195,1,706,8,714,1161,0,0,0,0,0,0,61.50
臺北縣,板橋市,雙玉里,196,1,753,13,766,1231,0,0,0,0,0,0,62.23
臺北縣,板橋市,雙玉里,197,1,741,21,762,1197,0,0,0,0,0,0,63.66
臺北縣,板橋市,廣新里,198,1,529,9,538,881,0,0,0,0,0,0,61.07
臺北縣,板橋市,廣新里,199,1,584,12,596,971,0,0,0,0,0,0,61.38
臺北縣,板橋市,廣新里,200,1,607,7,614,961,0,0,0,0,0,0,63.89
臺北縣,板橋市,深丘里,201,1,619,1,620,1064,0,0,0,0,0,0,58.27
臺北縣,板橋市,深丘里,202,1,773,7,780,1268,0,0,0,0,0,0,61.51
臺北縣,板橋市,深丘里,203,1,549,8,557,936,0,0,0,0,0,0,59.51
臺北縣,板橋市,深丘里,204,1,452,4,456,759,0,0,0,0,0,0,60.08
臺北縣,板橋市,香丘里,205,1,543,8,551,869,0,0,0,0,0,0,63.41
臺北縣,板橋市,香丘里,206,1,479,4,483,758,0,0,0,0,0,0,63.72
臺北縣,板橋市,香丘里,207,1,560,6,566,943,0,0,0,0,0,0,60.02
臺北縣,板橋市,西安里,208,1,613,10,623,1011,0,0,0,0,0,0,61.62
臺北縣,板橋市,西安里,209,1,605,9,614,886,0,0,0,0,0,0,69.30
臺北縣,板橋市,東丘里,210,1,587,13,600,995,0,0,0,0,0,0,60.30
臺北縣,板橋市,東丘里,211,1,717,16,733,1150,0,0,0,0,0,0,63.74
臺北縣,板橋市,東丘里,212,1,679,16,695,1101,0,0,0,0,0,0,63.12
臺北縣,板橋市,民生里,213,1,399,6,405,685,0,0,0,0,0,0,59.12
臺北縣,板橋市,民生里,214,1,472,7,479,761,0,0,0,0,0,0,62.94
臺北縣,板橋市,長安里,215,1,718,12,730,1250,0,0,0,0,0,0,58.40
臺北縣,板橋市,長安里,216,1,771,12,783,1250,0,0,0,0,0,0,62.64
臺北縣,板橋市,東安里,217,1,587,12,599,927,0,0,0,0,0,0,64.62
臺北縣,板橋市,東安里,218,1,594,6,600,993,0,0,0,0,0,0,60.42
臺北縣,板橋市,福丘里,219,1,494,8,502,826,0,0,0,0,0,0,60.77
臺北縣,板橋市,福丘里,220,1,457,4,461,695,0,0,0,0,0,0,66.33
臺北縣,板橋市,福祿里,221,1,696,7,703,1221,0,0,0,0,0,0,57.58
臺北縣,板橋市,福祿里,222,1,744,16,760,1216,0,0,0,0,0,0,62.50
臺北縣,板橋市,民族里,223,1,667,12,679,1091,0,0,0,0,0,0,62.24
臺北縣,板橋市,民族里,224,1,654,4,658,1034,0,0,0,0,0,0,63.64
臺北縣,板橋市,民族里,225,1,529,6,535,875,0,0,0,0,0,0,61.14
臺北縣,板橋市,國泰里,226,1,669,10,679,1087,0,0,0,0,0,0,62.47
臺北縣,板橋市,國泰里,227,1,580,16,596,1004,0,0,0,0,0,0,59.36
臺北縣,板橋市,後埔里,228,1,898,5,903,1429,0,0,0,0,0,0,63.19
臺北縣,板橋市,後埔里,229,1,670,12,682,1136,0,0,0,0,0,0,60.04
臺北縣,板橋市,福德里,230,1,709,7,716,1168,0,0,0,0,0,0,61.30
臺北縣,板橋市,福德里,231,1,794,13,807,1208,0,0,0,0,0,0,66.80
臺北縣,板橋市,福德里,232,1,849,10,859,1267,0,0,0,0,0,0,67.80
臺北縣,板橋市,景星里,233,1,771,10,781,1149,0,0,0,0,0,0,67.97
臺北縣,板橋市,景星里,234,1,792,12,804,1309,0,0,0,0,0,0,61.42
臺北縣,板橋市,福星里,235,1,686,15,701,1073,0,0,0,0,0,0,65.33
臺北縣,板橋市,福星里,236,1,626,9,635,1020,0,0,0,0,0,0,62.25
臺北縣,板橋市,鄉雲里,237,1,723,14,737,1121,0,0,0,0,0,0,65.74
臺北縣,板橋市,鄉雲里,238,1,780,10,790,1255,0,0,0,0,0,0,62.95
臺北縣,板橋市,廣德里,239,1,748,9,757,1183,0,0,0,0,0,0,63.99
臺北縣,板橋市,廣德里,240,1,514,12,526,865,0,0,0,0,0,0,60.81
臺北縣,板橋市,廣德里,241,1,643,10,653,1058,0,0,0,0,0,0,61.72
臺北縣,板橋市,廣德里,242,1,644,10,654,1102,0,0,0,0,0,0,59.35
臺北縣,板橋市,大豐里,243,1,790,9,799,1269,0,0,0,0,0,0,62.96
臺北縣,板橋市,大豐里,244,1,671,6,677,1066,0,0,0,0,0,0,63.51
臺北縣,板橋市,大豐里,245,1,714,4,718,1166,0,0,0,0,0,0,61.58
臺北縣,板橋市,重慶里,246,1,766,18,784,1394,0,0,0,0,0,0,56.24
臺北縣,板橋市,重慶里,247,1,707,13,720,1135,0,0,0,0,0,0,63.44
臺北縣,板橋市,重慶里,248,1,951,18,969,1629,0,0,0,0,0,0,59.48
臺北縣,板橋市,重慶里,249,1,719,11,730,1256,0,0,0,0,0,0,58.12
臺北縣,板橋市,仁愛里,250,1,624,8,632,948,0,0,0,0,0,0,66.67
臺北縣,板橋市,仁愛里,251,1,516,5,521,839,0,0,0,0,0,0,62.10
臺北縣,板橋市,仁愛里,252,1,554,7,561,889,0,0,0,0,0,0,63.10
臺北縣,板橋市,和平里,253,1,527,8,535,848,0,0,0,0,0,0,63.09
臺北縣,板橋市,廣福里,254,1,609,11,620,1052,0,0,0,0,0,0,58.94
臺北縣,板橋市,廣福里,255,1,652,10,662,1117,0,0,0,0,0,0,59.27
臺北縣,板橋市,五權里,256,1,650,5,655,1078,0,0,0,0,0,0,60.76
臺北縣,板橋市,五權里,257,1,722,7,729,1210,0,0,0,0,0,0,60.25
臺北縣,板橋市,五權里,258,1,680,9,689,1200,0,0,0,0,0,0,57.42
臺北縣,板橋市,華興里,259,1,781,15,796,1333,0,0,0,0,0,0,59.71
臺北縣,板橋市,華興里,260,1,855,13,868,1408,0,0,0,0,0,0,61.65
臺北縣,板橋市,華貴里,261,1,694,17,711,1049,0,0,0,0,0,0,67.78
臺北縣,板橋市,華貴里,262,1,738,19,757,1114,0,0,0,0,0,0,67.95
臺北縣,板橋市,華福里,263,1,546,6,552,836,0,0,0,0,0,0,66.03
臺北縣,板橋市,華福里,264,1,510,5,515,775,0,0,0,0,0,0,66.45
臺北縣,板橋市,華德里,265,1,730,21,751,1204,0,0,0,0,0,0,62.38
臺北縣,板橋市,華德里,266,1,900,13,913,1452,0,0,0,0,0,0,62.88
臺北縣,板橋市,華德里,267,1,819,18,837,1363,0,0,0,0,0,0,61.41
臺北縣,板橋市,華東里,268,1,508,13,521,798,0,0,0,0,0,0,65.29
臺北縣,板橋市,華東里,269,1,862,10,872,1480,0,0,0,0,0,0,58.92
臺北縣,板橋市,華東里,270,1,836,12,848,1300,0,0,0,0,0,0,65.23
臺北縣,板橋市,信義里,271,1,585,24,609,1020,0,0,0,0,0,0,59.71
臺北縣,板橋市,信義里,272,1,607,6,613,942,0,0,0,0,0,0,65.07
臺北縣,板橋市,信義里,273,1,695,16,711,1101,0,0,0,0,0,0,64.58
臺北縣,板橋市,浮洲里,274,1,706,17,723,1205,0,0,0,0,0,0,60.00
臺北縣,板橋市,浮洲里,275,1,689,11,700,1106,0,0,0,0,0,0,63.29
臺北縣,板橋市,浮洲里,276,1,496,3,499,1133,0,0,0,0,0,0,44.04
臺北縣,板橋市,華中里,277,1,660,8,668,1118,0,0,0,0,0,0,59.75
臺北縣,板橋市,華中里,278,1,753,15,768,1304,0,0,0,0,0,0,58.90
臺北縣,板橋市,華中里,279,1,786,18,804,1306,0,0,0,0,0,0,61.56
臺北縣,板橋市,僑中里,280,1,695,12,707,1090,0,0,0,0,0,0,64.86
臺北縣,板橋市,僑中里,281,1,455,10,465,759,0,0,0,0,0,0,61.26
臺北縣,板橋市,僑中里,282,1,482,6,488,746,0,0,0,0,0,0,65.42
臺北縣,板橋市,大觀里,283,1,687,8,695,1128,0,0,0,0,0,0,61.61
臺北縣,板橋市,大觀里,284,1,792,11,803,1273,0,0,0,0,0,0,63.08
臺北縣,板橋市,歡園里,285,1,726,11,737,1005,0,0,0,0,0,0,73.33
臺北縣,板橋市,中山里,286,1,579,17,596,1010,0,0,0,0,0,0,59.01
臺北縣,板橋市,中山里,287,1,512,6,518,892,0,0,0,0,0,0,58.07
臺北縣,板橋市,中山里,288,1,610,10,620,1076,0,0,0,0,0,0,57.62
臺北縣,板橋市,中山里,289,1,609,6,615,939,0,0,0,0,0,0,65.50
臺北縣,板橋市,復興里,290,1,591,11,602,888,0,0,0,0,0,0,67.79
臺北縣,板橋市,復興里,291,1,773,15,788,1020,0,0,0,0,0,0,77.25
臺北縣,板橋市,復興里,292,1,374,6,380,681,0,0,0,0,0,0,55.80
臺北縣,板橋市,大安里,293,1,670,15,685,1142,0,0,0,0,0,0,59.98
臺北縣,板橋市,大安里,294,1,767,9,776,1238,0,0,0,0,0,0,62.68
臺北縣,板橋市,大安里,295,1,538,11,549,881,0,0,0,0,0,0,62.32
臺北縣,板橋市,福安里,296,1,724,7,731,1168,0,0,0,0,0,0,62.59
臺北縣,板橋市,福安里,297,1,540,10,550,982,0,0,0,0,0,0,56.01
臺北縣,板橋市,聚安里,298,1,535,8,543,865,0,0,0,0,0,0,62.77
臺北縣,板橋市,聚安里,299,1,599,11,610,941,0,0,0,0,0,0,64.82
臺北縣,板橋市,聚安里,300,1,528,11,539,839,0,0,0,0,0,0,64.24
臺北縣,板橋市,聚安里,301,1,640,19,659,1078,0,0,0,0,0,0,61.13
臺北縣,板橋市,龍安里,302,1,687,10,697,1105,0,0,0,0,0,0,63.08
臺北縣,板橋市,龍安里,303,1,721,15,736,1219,0,0,0,0,0,0,60.38
臺北縣,板橋市,崑崙里,304,1,801,18,819,1263,0,0,0,0,0,0,64.85
臺北縣,板橋市,崑崙里,305,1,618,10,628,1144,0,0,0,0,0,0,54.90
臺北縣,板橋市,崑崙里,306,1,571,7,578,942,0,0,0,0,0,0,61.36
臺北縣,板橋市,崑崙里,307,1,867,16,883,1534,0,0,0,0,0,0,57.56
臺北縣,板橋市,成和里,308,1,789,13,802,1367,0,0,0,0,0,0,58.67
臺北縣,板橋市,成和里,309,1,714,12,726,1175,0,0,0,0,0,0,61.79
臺北縣,板橋市,溪洲里,310,1,832,17,849,1286,0,0,0,0,0,0,66.02
臺北縣,板橋市,溪洲里,311,1,737,11,748,1277,0,0,0,0,0,0,58.57
臺北縣,板橋市,溪洲里,312,1,639,11,650,1086,0,0,0,0,0,0,59.85
臺北縣,板橋市,溪福里,313,1,673,9,682,1172,0,0,0,0,0,0,58.19
臺北縣,板橋市,溪福里,314,1,651,9,660,1096,0,0,0,0,0,0,60.22
臺北縣,板橋市,溪福里,315,1,710,28,738,1210,0,0,0,0,0,0,60.99
臺北縣,板橋市,溪福里,316,1,710,12,722,1231,0,0,0,0,0,0,58.65
臺北縣,板橋市,溪北里,317,1,730,18,748,1158,0,0,0,0,0,0,64.59
臺北縣,板橋市,溪北里,318,1,840,10,850,1272,0,0,0,0,0,0,66.82
臺北縣,板橋市,堂春里,319,1,788,13,801,1259,0,0,0,0,0,0,63.62
臺北縣,板橋市,堂春里,320,1,876,10,886,1308,0,0,0,0,0,0,67.74
臺北縣,土城市,祖田里,321,1,719,18,737,1123,0,0,0,0,0,0,65.63
臺北縣,土城市,頂新里,322,1,742,12,754,1099,0,0,0,0,0,0,68.61
臺北縣,土城市,頂福里,323,1,954,19,973,1524,0,0,0,0,0,0,63.85
臺北縣,土城市,頂福里,324,1,1024,27,1051,1539,0,0,0,0,0,0,68.29
臺北縣,土城市,頂埔里,325,1,637,21,658,1062,0,0,0,0,0,0,61.96
臺北縣,土城市,頂埔里,326,1,753,16,769,1294,0,0,0,0,0,0,59.43
臺北縣,土城市,沛陂里,327,1,746,17,763,1210,0,0,0,0,0,0,63.06
臺北縣,土城市,沛陂里,328,1,694,19,713,1093,0,0,0,0,0,0,65.23
臺北縣,土城市,永寧里,329,1,735,19,754,1153,0,0,0,0,0,0,65.39
臺北縣,土城市,永寧里,330,1,732,13,745,1189,0,0,0,0,0,0,62.66
臺北縣,土城市,永寧里,331,1,594,9,603,946,0,0,0,0,0,0,63.74
臺北縣,土城市,永寧里,332,1,749,10,759,1407,0,0,0,0,0,0,53.94
臺北縣,土城市,大安里,333,1,832,15,847,1541,0,0,0,0,0,0,54.96
臺北縣,土城市,大安里,334,1,819,17,836,1465,0,0,0,0,0,0,57.06
臺北縣,土城市,員仁里,335,1,739,23,762,1315,0,0,0,0,0,0,57.95
臺北縣,土城市,員仁里,336,1,595,13,608,1058,0,0,0,0,0,0,57.47
臺北縣,土城市,員仁里,337,1,773,12,785,1339,0,0,0,0,0,0,58.63
臺北縣,土城市,埤塘里,338,1,608,10,618,921,0,0,0,0,0,0,67.10
臺北縣,土城市,埤塘里,339,1,651,19,670,1112,0,0,0,0,0,0,60.25
臺北縣,土城市,土城里,340,1,1006,17,1023,1528,0,0,0,0,0,0,66.95
臺北縣,土城市,長風里,341,1,566,6,572,853,0,0,0,0,0,0,67.06
臺北縣,土城市,員信里,342,1,885,14,899,1463,0,0,0,0,0,0,61.45
臺北縣,土城市,員信里,343,1,777,17,794,1363,0,0,0,0,0,0,58.25
臺北縣,土城市,員林里,344,1,705,15,720,1156,0,0,0,0,0,0,62.28
臺北縣,土城市,員林里,345,1,775,14,789,1353,0,0,0,0,0,0,58.31
臺北縣,土城市,員林里,346,1,759,13,772,1268,0,0,0,0,0,0,60.88
臺北縣,土城市,員福里,347,1,601,14,615,996,0,0,0,0,0,0,61.75
臺北縣,土城市,員福里,348,1,807,11,818,1387,0,0,0,0,0,0,58.98
臺北縣,土城市,員福里,349,1,843,12,855,1400,0,0,0,0,0,0,61.07
臺北縣,土城市,日和里,350,1,734,11,745,1188,0,0,0,0,0,0,62.71
臺北縣,土城市,日和里,351,1,908,13,921,1478,0,0,0,0,0,0,62.31
臺北縣,土城市,日和里,352,1,591,9,600,1005,0,0,0,0,0,0,59.70
臺北縣,土城市,日新里,353,1,750,15,765,1267,0,0,0,0,0,0,60.38
臺北縣,土城市,日新里,354,1,708,15,723,1046,0,0,0,0,0,0,69.12
臺北縣,土城市,日新里,355,1,726,12,738,1099,0,0,0,0,0,0,67.15
臺北縣,土城市,裕生里,356,1,690,14,704,1112,0,0,0,0,0,0,63.31
臺北縣,土城市,裕生里,357,1,778,13,791,1284,0,0,0,0,0,0,61.60
臺北縣,土城市,裕生里,358,1,579,12,591,1025,0,0,0,0,0,0,57.66
臺北縣,土城市,貨饒里,359,1,866,17,883,1447,0,0,0,0,0,0,61.02
臺北縣,土城市,貨饒里,360,1,913,12,925,1403,0,0,0,0,0,0,65.93
臺北縣,土城市,瑞興里,361,1,836,17,853,1211,0,0,0,0,0,0,70.44
臺北縣,土城市,瑞興里,362,1,777,8,785,1230,0,0,0,0,0,0,63.82
臺北縣,土城市,復興里,363,1,912,17,929,1457,0,0,0,0,0,0,63.76
臺北縣,土城市,復興里,364,1,1013,9,1022,1572,0,0,0,0,0,0,65.01
臺北縣,土城市,廣福里,365,1,711,8,719,1170,0,0,0,0,0,0,61.45
臺北縣,土城市,廣福里,366,1,618,7,625,1102,0,0,0,0,0,0,56.72
臺北縣,土城市,廣福里,367,1,801,10,811,1220,0,0,0,0,0,0,66.48
臺北縣,土城市,學成里,368,1,812,11,823,1213,0,0,0,0,0,0,67.85
臺北縣,土城市,學成里,369,1,638,11,649,1007,0,0,0,0,0,0,64.45
臺北縣,土城市,埤林里,370,1,882,16,898,1378,0,0,0,0,0,0,65.17
臺北縣,土城市,埤林里,371,1,884,10,894,1495,0,0,0,0,0,0,59.80
臺北縣,土城市,埤林里,372,1,1013,7,1020,1659,0,0,0,0,0,0,61.48
臺北縣,土城市,埤林里,373,1,945,18,963,1581,0,0,0,0,0,0,60.91
臺北縣,土城市,埤林里,374,1,683,12,695,1077,0,0,0,0,0,0,64.53
臺北縣,土城市,樂利里,375,1,785,14,799,1178,0,0,0,0,0,0,67.83
臺北縣,土城市,樂利里,376,1,865,15,880,1300,0,0,0,0,0,0,67.69
臺北縣,土城市,樂利里,377,1,708,11,719,1255,0,0,0,0,0,0,57.29
臺北縣,土城市,學府里,378,1,703,15,718,1116,0,0,0,0,0,0,64.34
臺北縣,土城市,學府里,379,1,653,13,666,1040,0,0,0,0,0,0,64.04
臺北縣,土城市,柑林里,380,1,682,11,693,1150,0,0,0,0,0,0,60.26
臺北縣,土城市,柑林里,381,1,775,12,787,1554,0,0,0,0,0,0,50.64
臺北縣,土城市,柑林里,382,1,831,12,843,1674,0,0,0,0,0,0,50.36
臺北縣,土城市,柑林里,383,1,781,17,798,1627,0,0,0,0,0,0,49.05
臺北縣,土城市,柑林里,384,1,759,15,774,1492,0,0,0,0,0,0,51.88
臺北縣,土城市,柑林里,385,1,682,12,694,1272,0,0,0,0,0,0,54.56
臺北縣,土城市,青雲里,386,1,744,9,753,1116,0,0,0,0,0,0,67.47
臺北縣,土城市,青雲里,387,1,477,8,485,856,0,0,0,0,0,0,56.66
臺北縣,土城市,清和里,388,1,852,13,865,1339,0,0,0,0,0,0,64.60
臺北縣,土城市,清和里,389,1,892,11,903,1599,0,0,0,0,0,0,56.47
臺北縣,土城市,清和里,390,1,749,8,757,1297,0,0,0,0,0,0,58.37
臺北縣,土城市,清化里,391,1,711,19,730,1178,0,0,0,0,0,0,61.97
臺北縣,土城市,清溪里,392,1,958,23,981,1526,0,0,0,0,0,0,64.29
臺北縣,土城市,清溪里,393,1,851,13,864,1404,0,0,0,0,0,0,61.54
臺北縣,土城市,清溪里,394,1,964,18,982,1514,0,0,0,0,0,0,64.86
臺北縣,土城市,清水里,395,1,856,15,871,1351,0,0,0,0,0,0,64.47
臺北縣,土城市,清水里,396,1,768,16,784,1258,0,0,0,0,0,0,62.32
臺北縣,土城市,清水里,397,1,880,22,902,1427,0,0,0,0,0,0,63.21
臺北縣,土城市,清水里,398,1,862,13,875,1426,0,0,0,0,0,0,61.36
臺北縣,土城市,清水里,399,1,848,7,855,1436,0,0,0,0,0,0,59.54
臺北縣,土城市,永豐里,400,1,641,13,654,944,0,0,0,0,0,0,69.28
臺北縣,土城市,永豐里,401,1,690,24,714,1186,0,0,0,0,0,0,60.20
臺北縣,土城市,永富里,402,1,654,19,673,1082,0,0,0,0,0,0,62.20
臺北縣,土城市,永富里,403,1,699,14,713,1132,0,0,0,0,0,0,62.99
臺北縣,土城市,永富里,404,1,720,11,731,1284,0,0,0,0,0,0,56.93
臺北縣,土城市,廷寮里,405,1,719,7,726,1470,0,0,0,0,0,0,49.39
臺北縣,土城市,廷寮里,406,1,804,9,813,1442,0,0,0,0,0,0,56.38
臺北縣,土城市,廷寮里,407,1,526,8,534,1005,0,0,0,0,0,0,53.13
臺北縣,土城市,廷寮里,408,1,512,7,519,868,0,0,0,0,0,0,59.79
臺北縣,土城市,廷寮里,409,1,669,14,683,1188,0,0,0,0,0,0,57.49
臺北縣,土城市,峰廷里,410,1,604,12,616,1012,0,0,0,0,0,0,60.87
臺北縣,土城市,峰廷里,411,1,782,8,790,1264,0,0,0,0,0,0,62.50
臺北縣,土城市,峰廷里,412,1,612,6,618,1028,0,0,0,0,0,0,60.12
臺北縣,土城市,峰廷里,413,1,770,13,783,1400,0,0,0,0,0,0,55.93
臺北縣,土城市,延吉里,414,1,792,17,809,1303,0,0,0,0,0,0,62.09
臺北縣,土城市,延吉里,415,1,956,18,974,1566,0,0,0,0,0,0,62.20
臺北縣,土城市,延壽里,416,1,785,17,802,1167,0,0,0,0,0,0,68.72
臺北縣,土城市,延壽里,417,1,842,13,855,1389,0,0,0,0,0,0,61.56
臺北縣,土城市,延壽里,418,1,917,9,926,1491,0,0,0,0,0,0,62.11
臺北縣,土城市,延壽里,419,1,966,21,987,1603,0,0,0,0,0,0,61.57
臺北縣,土城市,平和里,420,1,843,13,856,1326,0,0,0,0,0,0,64.56
臺北縣,土城市,平和里,421,1,713,11,724,1127,0,0,0,0,0,0,64.24
臺北縣,土城市,平和里,422,1,576,17,593,919,0,0,0,0,0,0,64.53
臺北縣,土城市,平和里,423,1,675,10,685,1163,0,0,0,0,0,0,58.90
臺北縣,土城市,安和里,424,1,955,18,973,1733,0,0,0,0,0,0,56.15
臺北縣,土城市,安和里,425,1,1033,23,1056,1641,0,0,0,0,0,0,64.35
臺北縣,土城市,延和里,426,1,983,21,1004,1670,0,0,0,0,0,0,60.12
臺北縣,土城市,延和里,427,1,926,25,951,1619,0,0,0,0,0,0,58.74
臺北縣,樹林鎮,保安里,428,1,534,2,536,901,0,0,0,0,0,0,59.49
臺北縣,樹林鎮,保安里,429,1,712,7,719,1122,0,0,0,0,0,0,64.08
臺北縣,樹林鎮,保安里,430,1,539,15,554,879,0,0,0,0,0,0,63.03
臺北縣,樹林鎮,保安里,431,1,637,15,652,1023,0,0,0,0,0,0,63.73
臺北縣,樹林鎮,圳福里,432,1,569,10,579,933,0,0,0,0,0,0,62.06
臺北縣,樹林鎮,圳福里,433,1,568,9,577,910,0,0,0,0,0,0,63.41
臺北縣,樹林鎮,圳福里,434,1,535,11,546,882,0,0,0,0,0,0,61.90
臺北縣,樹林鎮,圳安里,435,1,865,9,874,1478,0,0,0,0,0,0,59.13
臺北縣,樹林鎮,圳民里,436,1,448,9,457,782,0,0,0,0,0,0,58.44
臺北縣,樹林鎮,圳民里,437,1,496,8,504,875,0,0,0,0,0,0,57.60
臺北縣,樹林鎮,圳生里,438,1,621,6,627,1035,0,0,0,0,0,0,60.58
臺北縣,樹林鎮,三龍里,439,1,831,12,843,1398,0,0,0,0,0,0,60.30
臺北縣,樹林鎮,三多里,440,1,669,18,687,1219,0,0,0,0,0,0,56.36
臺北縣,樹林鎮,三多里,441,1,801,15,816,1333,0,0,0,0,0,0,61.22
臺北縣,樹林鎮,三福里,442,1,592,11,603,1042,0,0,0,0,0,0,57.87
臺北縣,樹林鎮,三福里,443,1,569,12,581,844,0,0,0,0,0,0,68.84
臺北縣,樹林鎮,三福里,444,1,643,15,658,1045,0,0,0,0,0,0,62.97
臺北縣,樹林鎮,三興里,445,1,596,20,616,1048,0,0,0,0,0,0,58.78
臺北縣,樹林鎮,三興里,446,1,621,8,629,1109,0,0,0,0,0,0,56.72
臺北縣,樹林鎮,三興里,447,1,651,7,658,1267,0,0,0,0,0,0,51.93
臺北縣,樹林鎮,羌寮里,448,1,706,8,714,1142,0,0,0,0,0,0,62.52
臺北縣,樹林鎮,羌寮里,449,1,709,13,722,1312,0,0,0,0,0,0,55.03
臺北縣,樹林鎮,光興里,450,1,655,8,663,1203,0,0,0,0,0,0,55.11
臺北縣,樹林鎮,光興里,451,1,592,9,601,1119,0,0,0,0,0,0,53.71
臺北縣,樹林鎮,金寮里,452,1,752,15,767,1217,0,0,0,0,0,0,63.02
臺北縣,樹林鎮,金寮里,453,1,677,14,691,1247,0,0,0,0,0,0,55.41
臺北縣,樹林鎮,潭底里,454,1,634,10,644,981,0,0,0,0,0,0,65.65
臺北縣,樹林鎮,潭底里,455,1,646,7,653,1094,0,0,0,0,0,0,59.69
臺北縣,樹林鎮,潭底里,456,1,568,4,572,909,0,0,0,0,0,0,62.93
臺北縣,樹林鎮,文林里,457,1,832,16,848,1416,0,0,0,0,0,0,59.89
臺北縣,樹林鎮,文林里,458,1,708,13,721,1403,0,0,0,0,0,0,51.39
臺北縣,樹林鎮,樹東里,459,1,648,8,656,961,0,0,0,0,0,0,68.26
臺北縣,樹林鎮,樹北里,460,1,614,3,617,929,0,0,0,0,0,0,66.42
臺北縣,樹林鎮,樹福里,461,1,631,13,644,989,0,0,0,0,0,0,65.12
臺北縣,樹林鎮,樹福里,462,1,529,7,536,847,0,0,0,0,0,0,63.28
臺北縣,樹林鎮,樹德里,463,1,679,7,686,1151,0,0,0,0,0,0,59.60
臺北縣,樹林鎮,樹德里,464,1,950,16,966,1434,0,0,0,0,0,0,67.36
臺北縣,樹林鎮,樹西里,465,1,671,7,678,953,0,0,0,0,0,0,71.14
臺北縣,樹林鎮,樹西里,466,1,796,12,808,1236,0,0,0,0,0,0,65.37
臺北縣,樹林鎮,樹西里,467,1,851,12,863,1338,0,0,0,0,0,0,64.50
臺北縣,樹林鎮,育英里,468,1,638,19,657,990,0,0,0,0,0,0,66.36
臺北縣,樹林鎮,育英里,469,1,667,9,676,1018,0,0,0,0,0,0,66.40
臺北縣,樹林鎮,樹南里,470,1,847,11,858,1398,0,0,0,0,0,0,61.37
臺北縣,樹林鎮,樹南里,471,1,852,10,862,1306,0,0,0,0,0,0,66.00
臺北縣,樹林鎮,樹人里,472,1,713,11,724,1153,0,0,0,0,0,0,62.79
臺北縣,樹林鎮,樹人里,473,1,732,13,745,1177,0,0,0,0,0,0,63.30
臺北縣,樹林鎮,樹興里,474,1,743,11,754,1124,0,0,0,0,0,0,67.08
臺北縣,樹林鎮,樹興里,475,1,831,7,838,1368,0,0,0,0,0,0,61.26
臺北縣,樹林鎮,坡內里,476,1,710,8,718,1065,0,0,0,0,0,0,67.42
臺北縣,樹林鎮,大同里,477,1,603,8,611,925,0,0,0,0,0,0,66.05
臺北縣,樹林鎮,大同里,478,1,442,9,451,864,0,0,0,0,0,0,52.20
臺北縣,樹林鎮,中華里,479,1,580,16,596,909,0,0,0,0,0,0,65.57
臺北縣,樹林鎮,中華里,480,1,482,5,487,812,0,0,0,0,0,0,59.98
臺北縣,樹林鎮,太順里,481,1,476,13,489,748,0,0,0,0,0,0,65.37
臺北縣,樹林鎮,太順里,482,1,435,5,440,786,0,0,0,0,0,0,55.98
臺北縣,樹林鎮,和平里,483,1,970,7,977,1414,0,0,0,0,0,0,69.09
臺北縣,樹林鎮,和平里,484,1,873,16,889,1408,0,0,0,0,0,0,63.14
臺北縣,樹林鎮,彭興里,485,1,623,6,629,1029,0,0,0,0,0,0,61.13
臺北縣,樹林鎮,彭興里,486,1,699,13,712,1212,0,0,0,0,0,0,58.75
臺北縣,樹林鎮,彭興里,487,1,678,11,689,1201,0,0,0,0,0,0,57.37
臺北縣,樹林鎮,彭厝里,488,1,920,16,936,1395,0,0,0,0,0,0,67.10
臺北縣,樹林鎮,彭厝里,489,1,675,8,683,1192,0,0,0,0,0,0,57.30
臺北縣,樹林鎮,彭福里,490,1,748,17,765,1220,0,0,0,0,0,0,62.70
臺北縣,樹林鎮,彭福里,491,1,894,17,911,1418,0,0,0,0,0,0,64.25
臺北縣,樹林鎮,東昇里,492,1,608,8,616,926,0,0,0,0,0,0,66.52
臺北縣,樹林鎮,東昇里,493,1,623,9,632,1007,0,0,0,0,0,0,62.76
臺北縣,樹林鎮,東昇里,494,1,518,10,528,800,0,0,0,0,0,0,66.00
臺北縣,樹林鎮,東陽里,495,1,625,10,635,1213,0,0,0,0,0,0,52.35
臺北縣,樹林鎮,東陽里,496,1,680,10,690,1174,0,0,0,0,0,0,58.77
臺北縣,樹林鎮,東陽里,497,1,835,12,847,1380,0,0,0,0,0,0,61.38
臺北縣,樹林鎮,東山里,498,1,830,16,846,1328,0,0,0,0,0,0,63.70
臺北縣,樹林鎮,東山里,499,1,661,15,676,958,0,0,0,0,0,0,70.56
臺北縣,樹林鎮,山佳里,500,1,703,15,718,1167,0,0,0,0,0,0,61.53
臺北縣,樹林鎮,山佳里,501,1,770,16,786,1117,0,0,0,0,0,0,70.37
臺北縣,樹林鎮,中山里,502,1,759,19,778,1120,0,0,0,0,0,0,69.46
臺北縣,樹林鎮,中山里,503,1,881,17,898,1319,0,0,0,0,0,0,68.08
臺北縣,樹林鎮,樂山里,504,1,750,23,773,1146,0,0,0,0,0,0,67.45
臺北縣,樹林鎮,東園里,505,1,745,11,756,1113,0,0,0,0,0,0,67.92
臺北縣,樹林鎮,北園里,506,1,824,15,839,1270,0,0,0,0,0,0,66.06
臺北縣,樹林鎮,柑園里,507,1,761,7,768,1141,0,0,0,0,0,0,67.31
臺北縣,樹林鎮,南園里,508,1,420,7,427,643,0,0,0,0,0,0,66.41
臺北縣,樹林鎮,西園里,509,1,662,18,680,1119,0,0,0,0,0,0,60.77
臺北縣,鶯歌鎮,建德里,510,1,325,8,333,466,0,0,0,0,0,0,71.46
臺北縣,鶯歌鎮,東鶯里,511,1,614,7,621,873,0,0,0,0,0,0,71.13
臺北縣,鶯歌鎮,北鶯里,512,1,860,10,870,1209,0,0,0,0,0,0,71.96
臺北縣,鶯歌鎮,西鶯里,513,1,690,7,697,988,0,0,0,0,0,0,70.55
臺北縣,鶯歌鎮,西鶯里,514,1,517,4,521,701,0,0,0,0,0,0,74.32
臺北縣,鶯歌鎮,中鶯里,515,1,616,6,622,799,0,0,0,0,0,0,77.85
臺北縣,鶯歌鎮,南鶯里,516,1,1132,14,1146,1624,0,0,0,0,0,0,70.57
臺北縣,鶯歌鎮,南鶯里,517,1,596,8,604,852,0,0,0,0,0,0,70.89
臺北縣,鶯歌鎮,南鶯里,518,1,668,4,672,958,0,0,0,0,0,0,70.15
臺北縣,鶯歌鎮,建國里,519,1,633,9,642,952,0,0,0,0,0,0,67.44
臺北縣,鶯歌鎮,建國里,520,1,740,16,756,1265,0,0,0,0,0,0,59.76
臺北縣,鶯歌鎮,建國里,521,1,790,10,800,1297,0,0,0,0,0,0,61.68
臺北縣,鶯歌鎮,南靖里,522,1,751,7,758,1076,0,0,0,0,0,0,70.45
臺北縣,鶯歌鎮,南靖里,523,1,926,11,937,1362,0,0,0,0,0,0,68.80
臺北縣,鶯歌鎮,尖山里,524,1,1149,25,1174,1749,0,0,0,0,0,0,67.12
臺北縣,鶯歌鎮,尖山里,525,1,1154,11,1165,1712,0,0,0,0,0,0,68.05
臺北縣,鶯歌鎮,二橋里,526,1,950,16,966,1404,0,0,0,0,0,0,68.80
臺北縣,鶯歌鎮,二橋里,527,1,910,15,925,1273,0,0,0,0,0,0,72.66
臺北縣,鶯歌鎮,二橋里,528,1,740,14,754,1023,0,0,0,0,0,0,73.70
臺北縣,鶯歌鎮,二甲里,529,1,529,14,543,738,0,0,0,0,0,0,73.58
臺北縣,鶯歌鎮,同慶里,530,1,728,7,735,1048,0,0,0,0,0,0,70.13
臺北縣,鶯歌鎮,永昌里,531,1,980,10,990,1639,0,0,0,0,0,0,60.40
臺北縣,鶯歌鎮,永昌里,532,1,736,13,749,1115,0,0,0,0,0,0,67.17
臺北縣,鶯歌鎮,永昌里,533,1,721,14,735,1195,0,0,0,0,0,0,61.51
臺北縣,鶯歌鎮,永昌里,534,1,816,11,827,1189,0,0,0,0,0,0,69.55
臺北縣,鶯歌鎮,永吉里,535,1,785,10,795,1161,0,0,0,0,0,0,68.48
臺北縣,鶯歌鎮,永吉里,536,1,689,12,701,979,0,0,0,0,0,0,71.60
臺北縣,鶯歌鎮,永吉里,537,1,623,11,634,934,0,0,0,0,0,0,67.88
臺北縣,鶯歌鎮,鳳鳴里,538,1,945,21,966,1498,0,0,0,0,0,0,64.49
臺北縣,鶯歌鎮,鳳鳴里,539,1,807,17,824,1334,0,0,0,0,0,0,61.77
臺北縣,鶯歌鎮,鳳祥里,540,1,734,14,748,1160,0,0,0,0,0,0,64.48
臺北縣,鶯歌鎮,鳳祥里,541,1,540,14,554,897,0,0,0,0,0,0,61.76
臺北縣,鶯歌鎮,鳳祥里,542,1,530,5,535,1051,0,0,0,0,0,0,50.90
臺北縣,鶯歌鎮,鳳福里,543,1,604,6,610,922,0,0,0,0,0,0,66.16
臺北縣,鶯歌鎮,鳳福里,544,1,524,6,530,934,0,0,0,0,0,0,56.75
臺北縣,鶯歌鎮,鳳福里,545,1,757,12,769,1177,0,0,0,0,0,0,65.34
臺北縣,鶯歌鎮,大湖里,546,1,682,14,696,1160,0,0,0,0,0,0,60.00
臺北縣,鶯歌鎮,大湖里,547,1,843,10,853,1348,0,0,0,0,0,0,63.28
臺北縣,鶯歌鎮,大湖里,548,1,680,14,694,1147,0,0,0,0,0,0,60.51
臺北縣,鶯歌鎮,中湖里,549,1,799,12,811,1413,0,0,0,0,0,0,57.40
臺北縣,鶯歌鎮,中湖里,550,1,797,7,804,1203,0,0,0,0,0,0,66.83
臺北縣,鶯歌鎮,中湖里,551,1,809,13,822,1233,0,0,0,0,0,0,66.67
臺北縣,鶯歌鎮,東湖里,552,1,153,3,156,231,0,0,0,0,0,0,67.53
臺北縣,三峽鎮,三峽里,553,1,239,1,240,356,0,0,0,0,0,0,67.42
臺北縣,三峽鎮,秀川里,554,1,308,4,312,442,0,0,0,0,0,0,70.59
臺北縣,三峽鎮,八張里,555,1,751,10,761,1065,0,0,0,0,0,0,71.46
臺北縣,三峽鎮,八張里,556,1,704,23,727,1066,0,0,0,0,0,0,68.20
臺北縣,三峽鎮,中埔里,557,1,739,9,748,1199,0,0,0,0,0,0,62.39
臺北縣,三峽鎮,弘道里,558,1,559,4,563,823,0,0,0,0,0,0,68.41
臺北縣,三峽鎮,永館里,559,1,713,11,724,1104,0,0,0,0,0,0,65.58
臺北縣,三峽鎮,永館里,560,1,877,9,886,1360,0,0,0,0,0,0,65.15
臺北縣,三峽鎮,永館里,561,1,809,13,822,1305,0,0,0,0,0,0,62.99
臺北縣,三峽鎮,中正里,562,1,905,14,919,1553,0,0,0,0,0,0,59.18
臺北縣,三峽鎮,中正里,563,1,919,20,939,1421,0,0,0,0,0,0,66.08
臺北縣,三峽鎮,礁溪里,564,1,789,13,802,1286,0,0,0,0,0,0,62.36
臺北縣,三峽鎮,礁溪里,565,1,674,6,680,1154,0,0,0,0,0,0,58.93
臺北縣,三峽鎮,介壽里,566,1,891,17,908,1426,0,0,0,0,0,0,63.67
臺北縣,三峽鎮,介壽里,567,1,879,13,892,1488,0,0,0,0,0,0,59.95
臺北縣,三峽鎮,安溪里,568,1,710,16,726,1125,0,0,0,0,0,0,64.53
臺北縣,三峽鎮,安溪里,569,1,607,10,617,1076,0,0,0,0,0,0,57.34
臺北縣,三峽鎮,安溪里,570,1,616,8,624,1003,0,0,0,0,0,0,62.21
臺北縣,三峽鎮,安溪里,571,1,628,4,632,1013,0,0,0,0,0,0,62.39
臺北縣,三峽鎮,龍埔里,572,1,840,14,854,1476,0,0,0,0,0,0,57.86
臺北縣,三峽鎮,龍埔里,573,1,781,17,798,1242,0,0,0,0,0,0,64.25
臺北縣,三峽鎮,龍埔里,574,1,849,16,865,1388,0,0,0,0,0,0,62.32
臺北縣,三峽鎮,鳶山里,575,1,808,14,822,1283,0,0,0,0,0,0,64.07
臺北縣,三峽鎮,鳶山里,576,1,745,10,755,1148,0,0,0,0,0,0,65.77
臺北縣,三峽鎮,鳶山里,577,1,682,14,696,1199,0,0,0,0,0,0,58.05
臺北縣,三峽鎮,鳶山里,578,1,736,15,751,1326,0,0,0,0,0,0,56.64
臺北縣,三峽鎮,大埔里,579,1,978,19,997,1580,0,0,0,0,0,0,63.10
臺北縣,三峽鎮,大埔里,580,1,933,10,943,1409,0,0,0,0,0,0,66.93
臺北縣,三峽鎮,二鬮里,581,1,505,7,512,961,0,0,0,0,0,0,53.28
臺北縣,三峽鎮,二鬮里,582,1,599,8,607,1097,0,0,0,0,0,0,55.33
臺北縣,三峽鎮,嘉添里,583,1,756,14,770,1146,0,0,0,0,0,0,67.19
臺北縣,三峽鎮,嘉添里,584,1,1099,13,1112,1541,0,0,0,0,0,0,72.16
臺北縣,三峽鎮,添福里,585,1,612,11,623,908,0,0,0,0,0,0,68.61
臺北縣,三峽鎮,五寮里,586,1,611,9,620,925,0,0,0,0,0,0,67.03
臺北縣,三峽鎮,金圳里,587,1,282,6,288,466,0,0,0,0,0,0,61.80
臺北縣,三峽鎮,插角里,588,1,573,7,580,856,0,0,0,0,0,0,67.76
臺北縣,三峽鎮,有木里,589,1,506,6,512,824,0,0,0,0,0,0,62.14
臺北縣,三峽鎮,溪南里,590,1,838,12,850,1126,0,0,0,0,0,0,75.49
臺北縣,三峽鎮,溪北里,591,1,352,3,355,561,0,0,0,0,0,0,63.28
臺北縣,三峽鎮,溪北里,592,1,913,10,923,1212,0,0,0,0,0,0,76.16
臺北縣,三峽鎮,溪東里,593,1,655,18,673,937,0,0,0,0,0,0,71.82
臺北縣,三峽鎮,溪東里,594,1,778,12,790,1241,0,0,0,0,0,0,63.66
臺北縣,三峽鎮,成福里,595,1,621,3,624,830,0,0,0,0,0,0,75.18
臺北縣,三峽鎮,安坑里,596,1,822,15,837,1327,0,0,0,0,0,0,63.07
臺北縣,三峽鎮,竹崙里,597,1,1030,15,1045,1632,0,0,0,0,0,0,64.03
臺北縣,三重市,大有里,598,2,884,12,896,1368,0,0,0,0,0,0,65.50
臺北縣,三重市,大有里,599,2,682,9,691,1062,0,0,0,0,0,0,65.07
臺北縣,三重市,大有里,600,2,462,6,468,684,0,0,0,0,0,0,68.42
臺北縣,三重市,博愛里,601,2,693,8,701,1072,0,0,0,0,0,0,65.39
臺北縣,三重市,博愛里,602,2,793,14,807,1195,0,0,0,0,0,0,67.53
臺北縣,三重市,博愛里,603,2,518,6,524,880,0,0,0,0,0,0,59.55
臺北縣,三重市,二重里,604,2,453,8,461,769,0,0,0,0,0,0,59.95
臺北縣,三重市,二重里,605,2,606,14,620,980,0,0,0,0,0,0,63.27
臺北縣,三重市,頂崁里,606,2,480,7,487,824,0,0,0,0,0,0,59.10
臺北縣,三重市,頂崁里,607,2,460,13,473,774,0,0,0,0,0,0,61.11
臺北縣,三重市,谷王里,608,2,744,7,751,1121,0,0,0,0,0,0,66.99
臺北縣,三重市,五谷里,609,2,618,6,624,933,0,0,0,0,0,0,66.88
臺北縣,三重市,五谷里,610,2,533,8,541,884,0,0,0,0,0,0,61.20
臺北縣,三重市,中興里,611,2,975,12,987,1529,0,0,0,0,0,0,64.55
臺北縣,三重市,中興里,612,2,917,17,934,1310,0,0,0,0,0,0,71.30
臺北縣,三重市,德厚里,613,2,281,5,286,391,0,0,0,0,0,0,73.15
臺北縣,三重市,成功里,614,2,672,5,677,1232,0,0,0,0,0,0,54.95
臺北縣,三重市,成功里,615,2,725,9,734,1258,0,0,0,0,0,0,58.35
臺北縣,三重市,福祉里,616,2,846,11,857,1326,0,0,0,0,0,0,64.63
臺北縣,三重市,福祉里,617,2,859,15,874,1314,0,0,0,0,0,0,66.51
臺北縣,三重市,福德里,618,2,786,7,793,1337,0,0,0,0,0,0,59.31
臺北縣,三重市,福德里,619,2,814,10,824,1446,0,0,0,0,0,0,56.98
臺北縣,三重市,福民里,620,2,729,8,737,1133,0,0,0,0,0,0,65.05
臺北縣,三重市,福民里,621,2,832,10,842,1259,0,0,0,0,0,0,66.88
臺北縣,三重市,過田里,622,2,635,6,641,1044,0,0,0,0,0,0,61.40
臺北縣,三重市,過田里,623,2,796,14,810,1275,0,0,0,0,0,0,63.53
臺北縣,三重市,過田里,624,2,731,8,739,1172,0,0,0,0,0,0,63.05
臺北縣,三重市,錦田里,625,2,485,8,493,774,0,0,0,0,0,0,63.70
臺北縣,三重市,錦田里,626,2,664,11,675,1008,0,0,0,0,0,0,66.96
臺北縣,三重市,重明里,627,2,768,12,780,1185,0,0,0,0,0,0,65.82
臺北縣,三重市,重明里,628,2,595,11,606,897,0,0,0,0,0,0,67.56
臺北縣,三重市,光田里,629,2,520,8,528,899,0,0,0,0,0,0,58.73
臺北縣,三重市,光田里,630,2,708,12,720,1156,0,0,0,0,0,0,62.28
臺北縣,三重市,光田里,631,2,710,11,721,1171,0,0,0,0,0,0,61.57
臺北縣,三重市,光陽里,632,2,652,10,662,1129,0,0,0,0,0,0,58.64
臺北縣,三重市,光陽里,633,2,1032,19,1051,1557,0,0,0,0,0,0,67.50
臺北縣,三重市,光陽里,634,2,1011,10,1021,1539,0,0,0,0,0,0,66.34
臺北縣,三重市,田心里,635,2,674,12,686,1101,0,0,0,0,0,0,62.31
臺北縣,三重市,田心里,636,2,688,7,695,1099,0,0,0,0,0,0,63.24
臺北縣,三重市,田心里,637,2,701,9,710,1188,0,0,0,0,0,0,59.76
臺北縣,三重市,福田里,638,2,713,10,723,1096,0,0,0,0,0,0,65.97
臺北縣,三重市,福田里,639,2,737,11,748,1185,0,0,0,0,0,0,63.12
臺北縣,三重市,田中里,640,2,791,7,798,1197,0,0,0,0,0,0,66.67
臺北縣,三重市,田中里,641,2,978,12,990,1474,0,0,0,0,0,0,67.16
臺北縣,三重市,田中里,642,2,922,10,932,1510,0,0,0,0,0,0,61.72
臺北縣,三重市,田安里,643,2,727,5,732,1158,0,0,0,0,0,0,63.21
臺北縣,三重市,田安里,644,2,808,17,825,1428,0,0,0,0,0,0,57.77
臺北縣,三重市,田安里,645,2,870,12,882,1485,0,0,0,0,0,0,59.39
臺北縣,三重市,三民里,646,2,791,12,803,1233,0,0,0,0,0,0,65.13
臺北縣,三重市,三民里,647,2,524,4,528,777,0,0,0,0,0,0,67.95
臺北縣,三重市,光明里,648,2,758,12,770,1378,0,0,0,0,0,0,55.88
臺北縣,三重市,光明里,649,2,775,14,789,1396,0,0,0,0,0,0,56.52
臺北縣,三重市,光明里,650,2,797,11,808,1369,0,0,0,0,0,0,59.02
臺北縣,三重市,光正里,651,2,646,9,655,1188,0,0,0,0,0,0,55.13
臺北縣,三重市,同安里,652,2,871,17,888,1468,0,0,0,0,0,0,60.49
臺北縣,三重市,同慶里,653,2,884,26,910,1473,0,0,0,0,0,0,61.78
臺北縣,三重市,菜寮里,654,2,525,2,527,887,0,0,0,0,0,0,59.41
臺北縣,三重市,菜寮里,655,2,480,8,488,808,0,0,0,0,0,0,60.40
臺北縣,三重市,永春里,656,2,795,8,803,1249,0,0,0,0,0,0,64.29
臺北縣,三重市,中正里,657,2,731,11,742,1134,0,0,0,0,0,0,65.43
臺北縣,三重市,吉利里,658,2,716,11,727,1292,0,0,0,0,0,0,56.27
臺北縣,三重市,大同里,659,2,893,9,902,1475,0,0,0,0,0,0,61.15
臺北縣,三重市,中民里,660,2,719,12,731,1180,0,0,0,0,0,0,61.95
臺北縣,三重市,平和里,661,2,473,7,480,774,0,0,0,0,0,0,62.02
臺北縣,三重市,平和里,662,2,471,7,478,774,0,0,0,0,0,0,61.76
臺北縣,三重市,大安里,663,2,881,19,900,1422,0,0,0,0,0,0,63.29
臺北縣,三重市,仁德里,664,2,528,11,539,894,0,0,0,0,0,0,60.29
臺北縣,三重市,仁德里,665,2,630,10,640,995,0,0,0,0,0,0,64.32
臺北縣,三重市,忠孝里,666,2,903,12,915,1601,0,0,0,0,0,0,57.15
臺北縣,三重市,仁義里,667,2,705,6,711,1070,0,0,0,0,0,0,66.45
臺北縣,三重市,光榮里,668,2,611,6,617,1001,0,0,0,0,0,0,61.64
臺北縣,三重市,光輝里,669,2,597,3,600,873,0,0,0,0,0,0,68.73
臺北縣,三重市,光輝里,670,2,474,2,476,711,0,0,0,0,0,0,66.95
臺北縣,三重市,福星里,671,2,539,3,542,818,0,0,0,0,0,0,66.26
臺北縣,三重市,福利里,672,2,754,8,762,1378,0,0,0,0,0,0,55.30
臺北縣,三重市,清和里,673,2,488,3,491,814,0,0,0,0,0,0,60.32
臺北縣,三重市,清和里,674,2,535,3,538,960,0,0,0,0,0,0,56.04
臺北縣,三重市,永興里,675,2,580,6,586,968,0,0,0,0,0,0,60.54
臺北縣,三重市,中山里,676,2,624,4,628,1008,0,0,0,0,0,0,62.30
臺北縣,三重市,中山里,677,2,530,7,537,1006,0,0,0,0,0,0,53.38
臺北縣,三重市,大園里,678,2,611,8,619,953,0,0,0,0,0,0,64.95
臺北縣,三重市,大園里,679,2,664,17,681,1112,0,0,0,0,0,0,61.24
臺北縣,三重市,國隆里,680,2,574,12,586,916,0,0,0,0,0,0,63.97
臺北縣,三重市,國隆里,681,2,675,8,683,1088,0,0,0,0,0,0,62.78
臺北縣,三重市,重陽里,682,2,722,11,733,1217,0,0,0,0,0,0,60.23
臺北縣,三重市,重陽里,683,2,817,4,821,1351,0,0,0,0,0,0,60.77
臺北縣,三重市,民生里,684,2,817,16,833,1334,0,0,0,0,0,0,62.44
臺北縣,三重市,民生里,685,2,568,9,577,946,0,0,0,0,0,0,60.99
臺北縣,三重市,民生里,686,2,719,11,730,1148,0,0,0,0,0,0,63.59
臺北縣,三重市,重新里,687,2,848,13,861,1363,0,0,0,0,0,0,63.17
臺北縣,三重市,正德里,688,2,652,11,663,1040,0,0,0,0,0,0,63.75
臺北縣,三重市,正義里,689,2,915,9,924,1450,0,0,0,0,0,0,63.72
臺北縣,三重市,正安里,690,2,926,16,942,1555,0,0,0,0,0,0,60.58
臺北縣,三重市,自強里,691,2,979,12,991,1492,0,0,0,0,0,0,66.42
臺北縣,三重市,文化里,692,2,664,9,673,1164,0,0,0,0,0,0,57.82
臺北縣,三重市,文化里,693,2,612,5,617,1016,0,0,0,0,0,0,60.73
臺北縣,三重市,中央里,694,2,954,17,971,1463,0,0,0,0,0,0,66.37
臺北縣,三重市,雙園里,695,2,566,3,569,944,0,0,0,0,0,0,60.28
臺北縣,三重市,錦通里,696,2,938,13,951,1510,0,0,0,0,0,0,62.98
臺北縣,三重市,錦安里,697,2,553,4,557,874,0,0,0,0,0,0,63.73
臺北縣,三重市,錦安里,698,2,588,6,594,839,0,0,0,0,0,0,70.80
臺北縣,三重市,長安里,699,2,536,5,541,873,0,0,0,0,0,0,61.97
臺北縣,三重市,長安里,700,2,540,7,547,971,0,0,0,0,0,0,56.33
臺北縣,三重市,光華里,701,2,870,11,881,1482,0,0,0,0,0,0,59.45
臺北縣,三重市,長生里,702,2,406,10,416,724,0,0,0,0,0,0,57.46
臺北縣,三重市,開元里,703,2,842,9,851,1331,0,0,0,0,0,0,63.94
臺北縣,三重市,大德里,704,2,398,7,405,619,0,0,0,0,0,0,65.43
臺北縣,三重市,長元里,705,2,600,16,616,962,0,0,0,0,0,0,64.03
臺北縣,三重市,長元里,706,2,621,7,628,1021,0,0,0,0,0,0,61.51
臺北縣,三重市,長江里,707,2,1056,20,1076,1563,0,0,0,0,0,0,68.84
臺北縣,三重市,長泰里,708,2,680,11,691,1067,0,0,0,0,0,0,64.76
臺北縣,三重市,長泰里,709,2,487,11,498,889,0,0,0,0,0,0,56.02
臺北縣,三重市,長福里,710,2,864,11,875,1404,0,0,0,0,0,0,62.32
臺北縣,三重市,介壽里,711,2,722,14,736,1097,0,0,0,0,0,0,67.09
臺北縣,三重市,萬壽里,712,2,959,16,975,1525,0,0,0,0,0,0,63.93
臺北縣,三重市,錦江里,713,2,737,18,755,1134,0,0,0,0,0,0,66.58
臺北縣,三重市,錦江里,714,2,655,12,667,921,0,0,0,0,0,0,72.42
臺北縣,三重市,龍濱里,715,2,770,25,795,1139,0,0,0,0,0,0,69.80
臺北縣,三重市,龍濱里,716,2,782,10,792,1188,0,0,0,0,0,0,66.67
臺北縣,三重市,龍門里,717,2,868,14,882,1495,0,0,0,0,0,0,59.00
臺北縣,三重市,秀江里,718,2,687,15,702,1118,0,0,0,0,0,0,62.79
臺北縣,三重市,奕壽里,719,2,860,9,869,1367,0,0,0,0,0,0,63.57
臺北縣,三重市,三安里,720,2,692,11,703,1128,0,0,0,0,0,0,62.32
臺北縣,三重市,三安里,721,2,677,11,688,1072,0,0,0,0,0,0,64.18
臺北縣,三重市,福安里,722,2,676,12,688,1166,0,0,0,0,0,0,59.01
臺北縣,三重市,福安里,723,2,559,3,562,1006,0,0,0,0,0,0,55.86
臺北縣,三重市,信安里,724,2,790,16,806,1350,0,0,0,0,0,0,59.70
臺北縣,三重市,安慶里,725,2,482,11,493,845,0,0,0,0,0,0,58.34
臺北縣,三重市,安慶里,726,2,586,2,588,963,0,0,0,0,0,0,61.06
臺北縣,三重市,幸福里,727,2,782,13,795,1335,0,0,0,0,0,0,59.55
臺北縣,三重市,幸福里,728,2,729,15,744,1247,0,0,0,0,0,0,59.66
臺北縣,三重市,幸福里,729,2,544,6,550,939,0,0,0,0,0,0,58.57
臺北縣,三重市,六合里,730,2,1068,13,1081,1554,0,0,0,0,0,0,69.56
臺北縣,三重市,六合里,731,2,944,12,956,1440,0,0,0,0,0,0,66.39
臺北縣,三重市,六福里,732,2,811,7,818,1423,0,0,0,0,0,0,57.48
臺北縣,三重市,六福里,733,2,731,11,742,1224,0,0,0,0,0,0,60.62
臺北縣,三重市,六福里,734,2,724,5,729,1157,0,0,0,0,0,0,63.01
臺北縣,三重市,順德里,735,2,621,10,631,1016,0,0,0,0,0,0,62.11
臺北縣,三重市,順德里,736,2,538,8,546,874,0,0,0,0,0,0,62.47
臺北縣,三重市,承德里,737,2,507,8,515,773,0,0,0,0,0,0,66.62
臺北縣,三重市,承德里,738,2,520,10,530,866,0,0,0,0,0,0,61.20
臺北縣,三重市,瑞德里,739,2,608,7,615,945,0,0,0,0,0,0,65.08
臺北縣,三重市,瑞德里,740,2,713,13,726,1143,0,0,0,0,0,0,63.52
臺北縣,三重市,崇德里,741,2,641,10,651,1129,0,0,0,0,0,0,57.66
臺北縣,三重市,崇德里,742,2,665,18,683,1122,0,0,0,0,0,0,60.87
臺北縣,三重市,崇德里,743,2,709,10,719,1124,0,0,0,0,0,0,63.97
臺北縣,三重市,厚德里,744,2,731,9,740,1061,0,0,0,0,0,0,69.75
臺北縣,三重市,厚德里,745,2,730,10,740,1053,0,0,0,0,0,0,70.28
臺北縣,三重市,維德里,746,2,691,14,705,1113,0,0,0,0,0,0,63.34
臺北縣,三重市,維德里,747,2,687,7,694,1096,0,0,0,0,0,0,63.32
臺北縣,三重市,尚德里,748,2,833,8,841,1359,0,0,0,0,0,0,61.88
臺北縣,三重市,尚德里,749,2,762,7,769,1169,0,0,0,0,0,0,65.78
臺北縣,三重市,培德里,750,2,574,13,587,854,0,0,0,0,0,0,68.74
臺北縣,三重市,培德里,751,2,991,13,1004,1678,0,0,0,0,0,0,59.83
臺北縣,三重市,立德里,752,2,777,9,786,1326,0,0,0,0,0,0,59.28
臺北縣,三重市,立德里,753,2,762,13,775,1233,0,0,0,0,0,0,62.85
臺北縣,三重市,永德里,754,2,993,24,1017,1517,0,0,0,0,0,0,67.04
臺北縣,三重市,永德里,755,2,707,12,719,1163,0,0,0,0,0,0,61.82
臺北縣,三重市,永德里,756,2,709,11,720,1174,0,0,0,0,0,0,61.33
臺北縣,三重市,永煇里,757,2,661,17,678,1084,0,0,0,0,0,0,62.55
臺北縣,三重市,永煇里,758,2,507,9,516,901,0,0,0,0,0,0,57.27
臺北縣,三重市,永發里,759,2,558,13,571,881,0,0,0,0,0,0,64.81
臺北縣,三重市,永發里,760,2,721,7,728,1124,0,0,0,0,0,0,64.77
臺北縣,三重市,永發里,761,2,676,3,679,1125,0,0,0,0,0,0,60.36
臺北縣,三重市,永盛里,762,2,871,17,888,1306,0,0,0,0,0,0,67.99
臺北縣,三重市,永盛里,763,2,952,18,970,1376,0,0,0,0,0,0,70.49
臺北縣,三重市,永吉里,764,2,748,14,762,1229,0,0,0,0,0,0,62.00
臺北縣,三重市,永吉里,765,2,583,8,591,906,0,0,0,0,0,0,65.23
臺北縣,三重市,永安里,766,2,847,12,859,1346,0,0,0,0,0,0,63.82
臺北縣,三重市,永安里,767,2,661,15,676,1119,0,0,0,0,0,0,60.41
臺北縣,三重市,永豐里,768,2,799,15,814,1160,0,0,0,0,0,0,70.17
臺北縣,三重市,永豐里,769,2,589,9,598,890,0,0,0,0,0,0,67.19
臺北縣,三重市,永豐里,770,2,759,9,768,1152,0,0,0,0,0,0,66.67
臺北縣,三重市,永福里,771,2,728,5,733,1168,0,0,0,0,0,0,62.76
臺北縣,三重市,永福里,772,2,687,5,692,1075,0,0,0,0,0,0,64.37
臺北縣,三重市,永福里,773,2,876,12,888,1387,0,0,0,0,0,0,64.02
臺北縣,三重市,永清里,774,2,889,11,900,1495,0,0,0,0,0,0,60.20
臺北縣,三重市,永清里,775,2,803,13,816,1346,0,0,0,0,0,0,60.62
臺北縣,三重市,永清里,776,2,699,9,708,1094,0,0,0,0,0,0,64.72
臺北縣,三重市,永順里,777,2,862,14,876,1280,0,0,0,0,0,0,68.44
臺北縣,三重市,永順里,778,2,616,24,640,995,0,0,0,0,0,0,64.32
臺北縣,三重市,永順里,779,2,622,16,638,921,0,0,0,0,0,0,69.27
臺北縣,三重市,溪美里,780,2,1179,15,1194,1755,0,0,0,0,0,0,68.03
臺北縣,三重市,溪美里,781,2,792,13,805,1273,0,0,0,0,0,0,63.24
臺北縣,三重市,溪美里,782,2,774,14,788,1425,0,0,0,0,0,0,55.30
臺北縣,三重市,福隆里,783,2,840,10,850,1289,0,0,0,0,0,0,65.94
臺北縣,三重市,福隆里,784,2,807,14,821,1323,0,0,0,0,0,0,62.06
臺北縣,三重市,五常里,785,2,797,17,814,1179,0,0,0,0,0,0,69.04
臺北縣,三重市,五常里,786,2,1017,23,1040,1538,0,0,0,0,0,0,67.62
臺北縣,三重市,五福里,787,2,709,14,723,1042,0,0,0,0,0,0,69.39
臺北縣,三重市,五福里,788,2,701,13,714,1123,0,0,0,0,0,0,63.58
臺北縣,三重市,仁忠里,789,2,875,13,888,1328,0,0,0,0,0,0,66.87
臺北縣,三重市,仁忠里,790,2,756,24,780,1144,0,0,0,0,0,0,68.18
臺北縣,三重市,慈福里,791,2,461,11,472,730,0,0,0,0,0,0,64.66
臺北縣,三重市,慈福里,792,2,827,14,841,1207,0,0,0,0,0,0,69.68
臺北縣,三重市,慈生里,793,2,709,8,717,1001,0,0,0,0,0,0,71.63
臺北縣,三重市,慈生里,794,2,622,15,637,966,0,0,0,0,0,0,65.94
臺北縣,三重市,慈惠里,795,2,705,9,714,1002,0,0,0,0,0,0,71.26
臺北縣,三重市,慈惠里,796,2,586,11,597,863,0,0,0,0,0,0,69.18
臺北縣,三重市,慈愛里,797,2,883,24,907,1282,0,0,0,0,0,0,70.75
臺北縣,三重市,慈愛里,798,2,1156,24,1180,1657,0,0,0,0,0,0,71.21
臺北縣,三重市,慈化里,799,2,617,12,629,903,0,0,0,0,0,0,69.66
臺北縣,三重市,慈化里,800,2,741,19,760,1036,0,0,0,0,0,0,73.36
臺北縣,三重市,慈祐里,801,2,744,11,755,1122,0,0,0,0,0,0,67.29
臺北縣,三重市,慈祐里,802,2,700,12,712,1110,0,0,0,0,0,0,64.14
臺北縣,三重市,慈祐里,803,2,625,9,634,955,0,0,0,0,0,0,66.39
臺北縣,三重市,富華里,804,2,684,10,694,976,0,0,0,0,0,0,71.11
臺北縣,三重市,富華里,805,2,778,14,792,1110,0,0,0,0,0,0,71.35
臺北縣,三重市,富貴里,806,2,867,23,890,1320,0,0,0,0,0,0,67.42
臺北縣,三重市,富貴里,807,2,699,14,713,1050,0,0,0,0,0,0,67.90
臺北縣,三重市,富福里,808,2,474,7,481,721,0,0,0,0,0,0,66.71
臺北縣,三重市,富福里,809,2,630,14,644,944,0,0,0,0,0,0,68.22
臺北縣,三重市,五華里,810,2,922,9,931,1315,0,0,0,0,0,0,70.80
臺北縣,三重市,五華里,811,2,858,15,873,1221,0,0,0,0,0,0,71.50
臺北縣,三重市,碧華里,812,2,566,10,576,854,0,0,0,0,0,0,67.45
臺北縣,三重市,碧華里,813,2,545,7,552,890,0,0,0,0,0,0,62.02
臺北縣,三重市,福樂里,814,2,951,14,965,1447,0,0,0,0,0,0,66.69
臺北縣,三重市,福樂里,815,2,886,15,901,1281,0,0,0,0,0,0,70.34
臺北縣,三重市,仁華里,816,2,1083,13,1096,1576,0,0,0,0,0,0,69.54
臺北縣,三重市,仁華里,817,2,881,14,895,1257,0,0,0,0,0,0,71.20
臺北縣,三重市,五順里,818,2,792,12,804,1327,0,0,0,0,0,0,60.59
臺北縣,三重市,五順里,819,2,741,8,749,1313,0,0,0,0,0,0,57.04
臺北縣,蘆洲市,光華里,820,2,781,11,792,1192,0,0,0,0,0,0,66.44
臺北縣,蘆洲市,光華里,821,2,757,14,771,1153,0,0,0,0,0,0,66.87
臺北縣,蘆洲市,光華里,822,2,668,11,679,1042,0,0,0,0,0,0,65.16
臺北縣,蘆洲市,光明里,823,2,929,9,938,1451,0,0,0,0,0,0,64.65
臺北縣,蘆洲市,光明里,824,2,811,13,824,1342,0,0,0,0,0,0,61.40
臺北縣,蘆洲市,中路里,825,2,768,8,776,1143,0,0,0,0,0,0,67.89
臺北縣,蘆洲市,中路里,826,2,806,9,815,1222,0,0,0,0,0,0,66.69
臺北縣,蘆洲市,中華里,827,2,678,11,689,980,0,0,0,0,0,0,70.31
臺北縣,蘆洲市,中華里,828,2,752,14,766,1176,0,0,0,0,0,0,65.14
臺北縣,蘆洲市,九芎里,829,2,824,10,834,1392,0,0,0,0,0,0,59.91
臺北縣,蘆洲市,九芎里,830,2,763,11,774,1341,0,0,0,0,0,0,57.72
臺北縣,蘆洲市,永安里,831,2,667,14,681,1053,0,0,0,0,0,0,64.67
臺北縣,蘆洲市,永安里,832,2,849,8,857,1310,0,0,0,0,0,0,65.42
臺北縣,蘆洲市,延平里,833,2,572,7,579,945,0,0,0,0,0,0,61.27
臺北縣,蘆洲市,延平里,834,2,624,8,632,1014,0,0,0,0,0,0,62.33
臺北縣,蘆洲市,長安里,835,2,735,12,747,1196,0,0,0,0,0,0,62.46
臺北縣,蘆洲市,長安里,836,2,835,12,847,1358,0,0,0,0,0,0,62.37
臺北縣,蘆洲市,忠義里,837,2,1061,12,1073,1560,0,0,0,0,0,0,68.78
臺北縣,蘆洲市,中原里,838,2,759,6,765,1191,0,0,0,0,0,0,64.23
臺北縣,蘆洲市,中原里,839,2,801,6,807,1325,0,0,0,0,0,0,60.91
臺北縣,蘆洲市,永康里,840,2,809,5,814,1365,0,0,0,0,0,0,59.63
臺北縣,蘆洲市,永康里,841,2,800,12,812,1246,0,0,0,0,0,0,65.17
臺北縣,蘆洲市,永德里,842,2,631,10,641,1107,0,0,0,0,0,0,57.90
臺北縣,蘆洲市,永德里,843,2,709,12,721,1210,0,0,0,0,0,0,59.59
臺北縣,蘆洲市,成功里,844,2,691,12,703,1234,0,0,0,0,0,0,56.97
臺北縣,蘆洲市,成功里,845,2,677,10,687,1171,0,0,0,0,0,0,58.67
臺北縣,蘆洲市,成功里,846,2,652,9,661,1096,0,0,0,0,0,0,60.31
臺北縣,蘆洲市,永樂里,847,2,625,10,635,1125,0,0,0,0,0,0,56.44
臺北縣,蘆洲市,永樂里,848,2,619,11,630,1156,0,0,0,0,0,0,54.50
臺北縣,蘆洲市,永樂里,849,2,640,9,649,1153,0,0,0,0,0,0,56.29
臺北縣,蘆洲市,南港里,850,2,682,14,696,1156,0,0,0,0,0,0,60.21
臺北縣,蘆洲市,南港里,851,2,621,8,629,1064,0,0,0,0,0,0,59.12
臺北縣,蘆洲市,南港里,852,2,645,7,652,1056,0,0,0,0,0,0,61.74
臺北縣,蘆洲市,正義里,853,2,422,8,430,619,0,0,0,0,0,0,69.47
臺北縣,蘆洲市,樓厝里,854,2,977,12,989,1517,0,0,0,0,0,0,65.19
臺北縣,蘆洲市,樓厝里,855,2,980,16,996,1477,0,0,0,0,0,0,67.43
臺北縣,蘆洲市,信義里,856,2,1033,13,1046,1430,0,0,0,0,0,0,73.15
臺北縣,蘆洲市,信義里,857,2,883,9,892,1286,0,0,0,0,0,0,69.36
臺北縣,蘆洲市,玉清里,858,2,839,8,847,1317,0,0,0,0,0,0,64.31
臺北縣,蘆洲市,玉清里,859,2,780,14,794,1263,0,0,0,0,0,0,62.87
臺北縣,蘆洲市,復興里,860,2,655,11,666,984,0,0,0,0,0,0,67.68
臺北縣,蘆洲市,復興里,861,2,689,17,706,1087,0,0,0,0,0,0,64.95
臺北縣,蘆洲市,福安里,862,2,683,8,691,1018,0,0,0,0,0,0,67.88
臺北縣,蘆洲市,福安里,863,2,591,11,602,869,0,0,0,0,0,0,69.28
臺北縣,蘆洲市,鷺江里,864,2,831,12,843,1245,0,0,0,0,0,0,67.71
臺北縣,蘆洲市,鷺江里,865,2,909,21,930,1440,0,0,0,0,0,0,64.58
臺北縣,蘆洲市,恆德里,866,2,920,10,930,1586,0,0,0,0,0,0,58.64
臺北縣,蘆洲市,恆德里,867,2,743,17,760,1144,0,0,0,0,0,0,66.43
臺北縣,蘆洲市,恆德里,868,2,679,9,688,1151,0,0,0,0,0,0,59.77
臺北縣,蘆洲市,溪墘里,869,2,769,13,782,1144,0,0,0,0,0,0,68.36
臺北縣,蘆洲市,溪墘里,870,2,781,9,790,1098,0,0,0,0,0,0,71.95
臺北縣,蘆洲市,樹德里,871,2,825,8,833,1240,0,0,0,0,0,0,67.18
臺北縣,蘆洲市,樹德里,872,2,727,11,738,1084,0,0,0,0,0,0,68.08
臺北縣,蘆洲市,民和里,873,2,673,11,684,961,0,0,0,0,0,0,71.18
臺北縣,蘆洲市,民和里,874,2,739,21,760,1047,0,0,0,0,0,0,72.59
臺北縣,蘆洲市,得仁里,875,2,701,12,713,1037,0,0,0,0,0,0,68.76
臺北縣,蘆洲市,得仁里,876,2,567,9,576,856,0,0,0,0,0,0,67.29
臺北縣,蘆洲市,得勝里,877,2,892,5,897,1279,0,0,0,0,0,0,70.13
臺北縣,蘆洲市,得勝里,878,2,993,20,1013,1441,0,0,0,0,0,0,70.30
臺北縣,蘆洲市,仁復里,879,2,997,21,1018,1454,0,0,0,0,0,0,70.01
臺北縣,蘆洲市,仁德里,880,2,718,14,732,1078,0,0,0,0,0,0,67.90
臺北縣,蘆洲市,仁德里,881,2,867,20,887,1284,0,0,0,0,0,0,69.08
臺北縣,蘆洲市,仁德里,882,2,677,11,688,1056,0,0,0,0,0,0,65.15
臺北縣,蘆洲市,仁義里,883,2,553,4,557,895,0,0,0,0,0,0,62.23
臺北縣,蘆洲市,仁義里,884,2,711,14,725,1048,0,0,0,0,0,0,69.18
臺北縣,蘆洲市,保和里,885,2,628,7,635,895,0,0,0,0,0,0,70.95
臺北縣,蘆洲市,保和里,886,2,615,15,630,925,0,0,0,0,0,0,68.11
臺北縣,蘆洲市,水湳里,887,2,861,8,869,1428,0,0,0,0,0,0,60.85
臺北縣,蘆洲市,水湳里,888,2,855,18,873,1370,0,0,0,0,0,0,63.72
臺北縣,蘆洲市,水湳里,889,2,840,12,852,1392,0,0,0,0,0,0,61.21
臺北縣,蘆洲市,水河里,890,2,756,18,774,1220,0,0,0,0,0,0,63.44
臺北縣,蘆洲市,水河里,891,2,974,9,983,1598,0,0,0,0,0,0,61.51
臺北縣,蘆洲市,水河里,892,2,854,25,879,1331,0,0,0,0,0,0,66.04
臺北縣,蘆洲市,仁愛里,893,2,1035,20,1055,1681,0,0,0,0,0,0,62.76
臺北縣,蘆洲市,仁愛里,894,2,791,13,804,1320,0,0,0,0,0,0,60.91
臺北縣,蘆洲市,忠孝里,895,2,996,19,1015,1505,0,0,0,0,0,0,67.44
臺北縣,蘆洲市,保佑里,896,2,830,10,840,1321,0,0,0,0,0,0,63.59
臺北縣,蘆洲市,保佑里,897,2,783,7,790,1241,0,0,0,0,0,0,63.66
臺北縣,蘆洲市,保新里,898,2,596,11,607,920,0,0,0,0,0,0,65.98
臺北縣,蘆洲市,保新里,899,2,856,19,875,1240,0,0,0,0,0,0,70.56
臺北縣,新莊市,全安里,900,2,801,10,811,1209,0,0,0,0,0,0,67.08
臺北縣,新莊市,全安里,901,2,616,8,624,1111,0,0,0,0,0,0,56.17
臺北縣,新莊市,全安里,902,2,612,11,623,920,0,0,0,0,0,0,67.72
臺北縣,新莊市,海山里,903,2,879,11,890,1458,0,0,0,0,0,0,61.04
臺北縣,新莊市,海山里,904,2,838,12,850,1423,0,0,0,0,0,0,59.73
臺北縣,新莊市,海山里,905,2,692,11,703,1156,0,0,0,0,0,0,60.81
臺北縣,新莊市,國泰里,906,2,872,10,882,1424,0,0,0,0,0,0,61.94
臺北縣,新莊市,豐年里,907,2,712,14,726,1357,0,0,0,0,0,0,53.50
臺北縣,新莊市,豐年里,908,2,761,10,771,1310,0,0,0,0,0,0,58.85
臺北縣,新莊市,文聖里,909,2,1042,13,1055,1599,0,0,0,0,0,0,65.98
臺北縣,新莊市,文聖里,910,2,840,9,849,1377,0,0,0,0,0,0,61.66
臺北縣,新莊市,文衡里,911,2,967,9,976,1487,0,0,0,0,0,0,65.64
臺北縣,新莊市,中全里,912,2,667,8,675,1201,0,0,0,0,0,0,56.20
臺北縣,新莊市,中全里,913,2,782,7,789,1370,0,0,0,0,0,0,57.59
臺北縣,新莊市,中和里,914,2,708,11,719,1267,0,0,0,0,0,0,56.75
臺北縣,新莊市,中和里,915,2,669,8,677,1085,0,0,0,0,0,0,62.40
臺北縣,新莊市,中和里,916,2,764,14,778,1219,0,0,0,0,0,0,63.82
臺北縣,新莊市,立基里,917,2,817,10,827,1434,0,0,0,0,0,0,57.67
臺北縣,新莊市,立基里,918,2,694,6,700,1245,0,0,0,0,0,0,56.22
臺北縣,新莊市,立基里,919,2,677,3,680,1226,0,0,0,0,0,0,55.46
臺北縣,新莊市,立廷里,920,2,536,5,541,911,0,0,0,0,0,0,59.39
臺北縣,新莊市,立廷里,921,2,479,1,480,887,0,0,0,0,0,0,54.11
臺北縣,新莊市,立志里,922,2,755,13,768,1365,0,0,0,0,0,0,56.26
臺北縣,新莊市,立志里,923,2,889,7,896,1516,0,0,0,0,0,0,59.10
臺北縣,新莊市,中泰里,924,2,759,11,770,1228,0,0,0,0,0,0,62.70
臺北縣,新莊市,中泰里,925,2,769,11,780,1287,0,0,0,0,0,0,60.61
臺北縣,新莊市,中泰里,926,2,761,10,771,1261,0,0,0,0,0,0,61.14
臺北縣,新莊市,中宏里,927,2,648,15,663,1085,0,0,0,0,0,0,61.11
臺北縣,新莊市,中宏里,928,2,721,10,731,1194,0,0,0,0,0,0,61.22
臺北縣,新莊市,忠孝里,929,2,644,12,656,1135,0,0,0,0,0,0,57.80
臺北縣,新莊市,忠孝里,930,2,702,6,708,1181,0,0,0,0,0,0,59.95
臺北縣,新莊市,忠孝里,931,2,717,5,722,1202,0,0,0,0,0,0,60.07
臺北縣,新莊市,立言里,932,2,648,11,659,1098,0,0,0,0,0,0,60.02
臺北縣,新莊市,立言里,933,2,746,8,754,1207,0,0,0,0,0,0,62.47
臺北縣,新莊市,立言里,934,2,791,6,797,1312,0,0,0,0,0,0,60.75
臺北縣,新莊市,全泰里,935,2,700,11,711,1154,0,0,0,0,0,0,61.61
臺北縣,新莊市,全泰里,936,2,680,4,684,1166,0,0,0,0,0,0,58.66
臺北縣,新莊市,全泰里,937,2,749,6,755,1176,0,0,0,0,0,0,64.20
臺北縣,新莊市,興漢里,938,2,622,4,626,966,0,0,0,0,0,0,64.80
臺北縣,新莊市,興漢里,939,2,682,11,693,1092,0,0,0,0,0,0,63.46
臺北縣,新莊市,興漢里,940,2,550,11,561,843,0,0,0,0,0,0,66.55
臺北縣,新莊市,榮和里,941,2,787,10,797,1198,0,0,0,0,0,0,66.53
臺北縣,新莊市,榮和里,942,2,850,16,866,1475,0,0,0,0,0,0,58.71
臺北縣,新莊市,文德里,943,2,748,10,758,1146,0,0,0,0,0,0,66.14
臺北縣,新莊市,文明里,944,2,994,10,1004,1554,0,0,0,0,0,0,64.61
臺北縣,新莊市,福基里,945,2,695,4,699,1078,0,0,0,0,0,0,64.84
臺北縣,新莊市,福基里,946,2,537,14,551,835,0,0,0,0,0,0,65.99
臺北縣,新莊市,福興里,947,2,599,8,607,1066,0,0,0,0,0,0,56.94
臺北縣,新莊市,福興里,948,2,644,7,651,1131,0,0,0,0,0,0,57.56
臺北縣,新莊市,化成里,949,2,644,8,652,1056,0,0,0,0,0,0,61.74
臺北縣,新莊市,化成里,950,2,629,8,637,998,0,0,0,0,0,0,63.83
臺北縣,新莊市,思賢里,951,2,790,14,804,1268,0,0,0,0,0,0,63.41
臺北縣,新莊市,思賢里,952,2,792,12,804,1327,0,0,0,0,0,0,60.59
臺北縣,新莊市,仁愛里,953,2,668,8,676,1161,0,0,0,0,0,0,58.23
臺北縣,新莊市,仁愛里,954,2,653,11,664,1152,0,0,0,0,0,0,57.64
臺北縣,新莊市,仁義里,955,2,713,9,722,1267,0,0,0,0,0,0,56.99
臺北縣,新莊市,仁義里,956,2,705,8,713,1211,0,0,0,0,0,0,58.88
臺北縣,新莊市,思源里,957,2,746,8,754,1277,0,0,0,0,0,0,59.04
臺北縣,新莊市,思源里,958,2,693,7,700,1198,0,0,0,0,0,0,58.43
臺北縣,新莊市,思源里,959,2,718,10,728,1261,0,0,0,0,0,0,57.73
臺北縣,新莊市,自強里,960,2,686,12,698,1176,0,0,0,0,0,0,59.35
臺北縣,新莊市,自強里,961,2,709,10,719,1196,0,0,0,0,0,0,60.12
臺北縣,新莊市,自立里,962,2,740,10,750,1226,0,0,0,0,0,0,61.17
臺北縣,新莊市,自立里,963,2,703,15,718,1187,0,0,0,0,0,0,60.49
臺北縣,新莊市,自立里,964,2,761,12,773,1247,0,0,0,0,0,0,61.99
臺北縣,新莊市,自信里,965,2,1065,18,1083,1746,0,0,0,0,0,0,62.03
臺北縣,新莊市,中信里,966,2,924,16,940,1489,0,0,0,0,0,0,63.13
臺北縣,新莊市,中信里,967,2,854,10,864,1399,0,0,0,0,0,0,61.76
臺北縣,新莊市,中信里,968,2,700,6,706,1224,0,0,0,0,0,0,57.68
臺北縣,新莊市,中平里,969,2,825,6,831,1488,0,0,0,0,0,0,55.85
臺北縣,新莊市,中平里,970,2,806,16,822,1614,0,0,0,0,0,0,50.93
臺北縣,新莊市,中港里,971,2,786,13,799,1352,0,0,0,0,0,0,59.10
臺北縣,新莊市,中港里,972,2,762,12,774,1347,0,0,0,0,0,0,57.46
臺北縣,新莊市,中港里,973,2,684,5,689,1273,0,0,0,0,0,0,54.12
臺北縣,新莊市,立德里,974,2,601,5,606,981,0,0,0,0,0,0,61.77
臺北縣,新莊市,立德里,975,2,565,3,568,996,0,0,0,0,0,0,57.03
臺北縣,新莊市,立功里,976,2,860,10,870,1546,0,0,0,0,0,0,56.27
臺北縣,新莊市,立功里,977,2,760,8,768,1441,0,0,0,0,0,0,53.30
臺北縣,新莊市,立泰里,978,2,987,13,1000,1600,0,0,0,0,0,0,62.50
臺北縣,新莊市,立泰里,979,2,774,11,785,1315,0,0,0,0,0,0,59.70
臺北縣,新莊市,頭前里,980,2,954,14,968,1552,0,0,0,0,0,0,62.37
臺北縣,新莊市,頭前里,981,2,927,14,941,1492,0,0,0,0,0,0,63.07
臺北縣,新莊市,和平里,982,2,535,2,537,1016,0,0,0,0,0,0,52.85
臺北縣,新莊市,和平里,983,2,553,5,558,939,0,0,0,0,0,0,59.42
臺北縣,新莊市,和平里,984,2,666,12,678,1100,0,0,0,0,0,0,61.64
臺北縣,新莊市,昌平里,985,2,574,9,583,1086,0,0,0,0,0,0,53.68
臺北縣,新莊市,昌平里,986,2,638,9,647,1186,0,0,0,0,0,0,54.55
臺北縣,新莊市,信義里,987,2,703,14,717,1257,0,0,0,0,0,0,57.04
臺北縣,新莊市,信義里,988,2,687,11,698,1128,0,0,0,0,0,0,61.88
臺北縣,新莊市,信義里,989,2,572,7,579,1056,0,0,0,0,0,0,54.83
臺北縣,新莊市,昌信里,990,2,835,11,846,1481,0,0,0,0,0,0,57.12
臺北縣,新莊市,昌隆里,991,2,625,3,628,992,0,0,0,0,0,0,63.31
臺北縣,新莊市,昌隆里,992,2,546,4,550,945,0,0,0,0,0,0,58.20
臺北縣,新莊市,昌明里,993,2,857,20,877,1214,0,0,0,0,0,0,72.24
臺北縣,新莊市,昌明里,994,2,676,8,684,1144,0,0,0,0,0,0,59.79
臺北縣,新莊市,幸福里,995,2,568,3,571,1071,0,0,0,0,0,0,53.31
臺北縣,新莊市,幸福里,996,2,613,11,624,1127,0,0,0,0,0,0,55.37
臺北縣,新莊市,幸福里,997,2,627,11,638,1155,0,0,0,0,0,0,55.24
臺北縣,新莊市,中原里,998,2,692,8,700,1197,0,0,0,0,0,0,58.48
臺北縣,新莊市,中原里,999,2,651,9,660,1152,0,0,0,0,0,0,57.29
臺北縣,新莊市,中原里,1000,2,707,10,717,1228,0,0,0,0,0,0,58.39
臺北縣,新莊市,中誠里,1001,2,1039,18,1057,1675,0,0,0,0,0,0,63.10
臺北縣,新莊市,中隆里,1002,2,774,12,786,1235,0,0,0,0,0,0,63.64
臺北縣,新莊市,中隆里,1003,2,541,6,547,965,0,0,0,0,0,0,56.68
臺北縣,新莊市,中美里,1004,2,765,5,770,1219,0,0,0,0,0,0,63.17
臺北縣,新莊市,中美里,1005,2,774,13,787,1415,0,0,0,0,0,0,55.62
臺北縣,新莊市,中美里,1006,2,870,7,877,1396,0,0,0,0,0,0,62.82
臺北縣,新莊市,中華里,1007,2,803,11,814,1242,0,0,0,0,0,0,65.54
臺北縣,新莊市,恆安里,1008,2,698,11,709,1123,0,0,0,0,0,0,63.13
臺北縣,新莊市,恆安里,1009,2,669,10,679,1109,0,0,0,0,0,0,61.23
臺北縣,新莊市,恆安里,1010,2,789,5,794,1327,0,0,0,0,0,0,59.83
臺北縣,新莊市,立人里,1011,2,984,11,995,1537,0,0,0,0,0,0,64.74
臺北縣,新莊市,瓊林里,1012,2,898,15,913,1476,0,0,0,0,0,0,61.86
臺北縣,新莊市,瓊林里,1013,2,820,14,834,1488,0,0,0,0,0,0,56.05
臺北縣,新莊市,瓊林里,1014,2,762,9,771,1343,0,0,0,0,0,0,57.41
臺北縣,新莊市,營盤里,1015,2,586,4,590,937,0,0,0,0,0,0,62.97
臺北縣,新莊市,營盤里,1016,2,624,7,631,1000,0,0,0,0,0,0,63.10
臺北縣,新莊市,福營里,1017,2,613,7,620,997,0,0,0,0,0,0,62.19
臺北縣,新莊市,福營里,1018,2,616,12,628,972,0,0,0,0,0,0,64.61
臺北縣,新莊市,泰豐里,1019,2,583,10,593,986,0,0,0,0,0,0,60.14
臺北縣,新莊市,泰豐里,1020,2,481,3,484,860,0,0,0,0,0,0,56.28
臺北縣,新莊市,丹鳳里,1021,2,925,12,937,1750,0,0,0,0,0,0,53.54
臺北縣,新莊市,丹鳳里,1022,2,814,5,819,1430,0,0,0,0,0,0,57.27
臺北縣,新莊市,合鳳里,1023,2,595,6,601,990,0,0,0,0,0,0,60.71
臺北縣,新莊市,合鳳里,1024,2,584,4,588,1062,0,0,0,0,0,0,55.37
臺北縣,新莊市,合鳳里,1025,2,718,8,726,1086,0,0,0,0,0,0,66.85
臺北縣,新莊市,雙鳳里,1026,2,816,9,825,1391,0,0,0,0,0,0,59.31
臺北縣,新莊市,雙鳳里,1027,2,771,10,781,1318,0,0,0,0,0,0,59.26
臺北縣,新莊市,雙鳳里,1028,2,357,6,363,532,0,0,0,0,0,0,68.23
臺北縣,新莊市,祥鳳里,1029,2,927,9,936,1453,0,0,0,0,0,0,64.42
臺北縣,新莊市,富國里,1030,2,588,8,596,938,0,0,0,0,0,0,63.54
臺北縣,新莊市,富國里,1031,2,507,7,514,885,0,0,0,0,0,0,58.08
臺北縣,新莊市,富民里,1032,2,559,9,568,1031,0,0,0,0,0,0,55.09
臺北縣,新莊市,富民里,1033,2,720,12,732,1336,0,0,0,0,0,0,54.79
臺北縣,新莊市,龍鳳里,1034,2,590,6,596,1101,0,0,0,0,0,0,54.13
臺北縣,新莊市,龍鳳里,1035,2,631,8,639,1128,0,0,0,0,0,0,56.65
臺北縣,新莊市,龍鳳里,1036,2,607,7,614,1032,0,0,0,0,0,0,59.50
臺北縣,新莊市,龍安里,1037,2,443,5,448,819,0,0,0,0,0,0,54.70
臺北縣,新莊市,龍安里,1038,2,456,1,457,853,0,0,0,0,0,0,53.58
臺北縣,新莊市,裕民里,1039,2,674,7,681,1244,0,0,0,0,0,0,54.74
臺北縣,新莊市,裕民里,1040,2,775,15,790,1354,0,0,0,0,0,0,58.35
臺北縣,新莊市,裕民里,1041,2,791,10,801,1436,0,0,0,0,0,0,55.78
臺北縣,新莊市,建福里,1042,2,469,14,483,850,0,0,0,0,0,0,56.82
臺北縣,新莊市,建福里,1043,2,544,10,554,950,0,0,0,0,0,0,58.32
臺北縣,新莊市,民本里,1044,2,669,4,673,1112,0,0,0,0,0,0,60.52
臺北縣,新莊市,民本里,1045,2,634,10,644,1114,0,0,0,0,0,0,57.81
臺北縣,新莊市,民全里,1046,2,612,8,620,1064,0,0,0,0,0,0,58.27
臺北縣,新莊市,民全里,1047,2,591,13,604,1032,0,0,0,0,0,0,58.53
臺北縣,新莊市,八德里,1048,2,512,7,519,969,0,0,0,0,0,0,53.56
臺北縣,新莊市,八德里,1049,2,605,6,611,1149,0,0,0,0,0,0,53.18
臺北縣,新莊市,民安里,1050,2,899,18,917,1567,0,0,0,0,0,0,58.52
臺北縣,新莊市,民安里,1051,2,757,5,762,1314,0,0,0,0,0,0,57.99
臺北縣,新莊市,建安里,1052,2,906,9,915,1762,0,0,0,0,0,0,51.93
臺北縣,新莊市,建安里,1053,2,819,18,837,1692,0,0,0,0,0,0,49.47
臺北縣,新莊市,民有里,1054,2,550,6,556,1034,0,0,0,0,0,0,53.77
臺北縣,新莊市,民有里,1055,2,641,10,651,1105,0,0,0,0,0,0,58.91
臺北縣,新莊市,四維里,1056,2,520,13,533,1053,0,0,0,0,0,0,50.62
臺北縣,新莊市,四維里,1057,2,656,17,673,1248,0,0,0,0,0,0,53.93
臺北縣,新莊市,四維里,1058,2,503,8,511,980,0,0,0,0,0,0,52.14
臺北縣,新莊市,南港里,1059,2,569,10,579,1129,0,0,0,0,0,0,51.28
臺北縣,新莊市,南港里,1060,2,795,8,803,1528,0,0,0,0,0,0,52.55
臺北縣,新莊市,南港里,1061,2,360,6,366,664,0,0,0,0,0,0,55.12
臺北縣,新莊市,後德里,1062,2,526,4,530,939,0,0,0,0,0,0,56.44
臺北縣,新莊市,後德里,1063,2,571,5,576,1007,0,0,0,0,0,0,57.20
臺北縣,新莊市,萬安里,1064,2,662,7,669,1221,0,0,0,0,0,0,54.79
臺北縣,新莊市,萬安里,1065,2,626,7,633,1118,0,0,0,0,0,0,56.62
臺北縣,新莊市,光華里,1066,2,577,8,585,1209,0,0,0,0,0,0,48.39
臺北縣,新莊市,光華里,1067,2,594,10,604,1210,0,0,0,0,0,0,49.92
臺北縣,新莊市,光華里,1068,2,645,13,658,1288,0,0,0,0,0,0,51.09
臺北縣,新莊市,光明里,1069,2,534,8,542,1008,0,0,0,0,0,0,53.77
臺北縣,新莊市,光明里,1070,2,704,15,719,1383,0,0,0,0,0,0,51.99
臺北縣,新莊市,成德里,1071,2,617,8,625,1179,0,0,0,0,0,0,53.01
臺北縣,新莊市,成德里,1072,2,765,10,775,1451,0,0,0,0,0,0,53.41
臺北縣,新莊市,龍福里,1073,2,560,4,564,1026,0,0,0,0,0,0,54.97
臺北縣,新莊市,西盛里,1074,2,594,14,608,1111,0,0,0,0,0,0,54.73
臺北縣,新莊市,西盛里,1075,2,698,9,707,1439,0,0,0,0,0,0,49.13
臺北縣,新莊市,西盛里,1076,2,659,13,672,1202,0,0,0,0,0,0,55.91
臺北縣,新莊市,光正里,1077,2,506,2,508,1014,0,0,0,0,0,0,50.10
臺北縣,新莊市,光正里,1078,2,595,5,600,1027,0,0,0,0,0,0,58.42
臺北縣,新莊市,光榮里,1079,2,595,5,600,1086,0,0,0,0,0,0,55.25
臺北縣,新莊市,光榮里,1080,2,531,8,539,966,0,0,0,0,0,0,55.80
臺北縣,新莊市,光和里,1081,2,458,9,467,861,0,0,0,0,0,0,54.24
臺北縣,新莊市,光和里,1082,2,380,3,383,732,0,0,0,0,0,0,52.32
臺北縣,新莊市,後港里,1083,2,451,9,460,849,0,0,0,0,0,0,54.18
臺北縣,新莊市,後港里,1084,2,486,6,492,917,0,0,0,0,0,0,53.65
臺北縣,新莊市,後港里,1085,2,607,10,617,1117,0,0,0,0,0,0,55.24
臺北縣,新莊市,後港里,1086,2,778,4,782,1456,0,0,0,0,0,0,53.71
臺北縣,五股鄉,興珍村,1087,2,691,4,695,1103,0,0,0,0,0,0,63.01
臺北縣,五股鄉,興珍村,1088,2,691,4,695,1112,0,0,0,0,0,0,62.50
臺北縣,五股鄉,興珍村,1089,2,751,14,765,1148,0,0,0,0,0,0,66.64
臺北縣,五股鄉,更寮村,1090,2,674,5,679,1073,0,0,0,0,0,0,63.28
臺北縣,五股鄉,集福村,1091,2,708,10,718,1184,0,0,0,0,0,0,60.64
臺北縣,五股鄉,集福村,1092,2,454,16,470,652,0,0,0,0,0,0,72.09
臺北縣,五股鄉,集賢村,1093,2,695,6,701,1121,0,0,0,0,0,0,62.53
臺北縣,五股鄉,集賢村,1094,2,622,9,631,1074,0,0,0,0,0,0,58.75
臺北縣,五股鄉,觀音村,1095,2,781,11,792,1214,0,0,0,0,0,0,65.24
臺北縣,五股鄉,成德村,1096,2,588,17,605,972,0,0,0,0,0,0,62.24
臺北縣,五股鄉,成德村,1097,2,677,11,688,1109,0,0,0,0,0,0,62.04
臺北縣,五股鄉,成州村,1098,2,653,8,661,1087,0,0,0,0,0,0,60.81
臺北縣,五股鄉,成州村,1099,2,733,13,746,1126,0,0,0,0,0,0,66.25
臺北縣,五股鄉,成州村,1100,2,714,8,722,1168,0,0,0,0,0,0,61.82
臺北縣,五股鄉,成功村,1101,2,741,18,759,1218,0,0,0,0,0,0,62.32
臺北縣,五股鄉,成功村,1102,2,580,10,590,1077,0,0,0,0,0,0,54.78
臺北縣,五股鄉,成泰村,1103,2,662,22,684,1038,0,0,0,0,0,0,65.90
臺北縣,五股鄉,成泰村,1104,2,615,6,621,1000,0,0,0,0,0,0,62.10
臺北縣,五股鄉,五福村,1105,2,668,12,680,1103,0,0,0,0,0,0,61.65
臺北縣,五股鄉,五福村,1106,2,771,5,776,1253,0,0,0,0,0,0,61.93
臺北縣,五股鄉,六福村,1107,2,568,5,573,948,0,0,0,0,0,0,60.44
臺北縣,五股鄉,六福村,1108,2,614,5,619,1035,0,0,0,0,0,0,59.81
臺北縣,五股鄉,五龍村,1109,2,729,11,740,1099,0,0,0,0,0,0,67.33
臺北縣,五股鄉,五股村,1110,2,758,7,765,1282,0,0,0,0,0,0,59.67
臺北縣,五股鄉,五股村,1111,2,836,7,843,1350,0,0,0,0,0,0,62.44
臺北縣,五股鄉,民義村,1112,2,640,7,647,1036,0,0,0,0,0,0,62.45
臺北縣,五股鄉,民義村,1113,2,612,6,618,882,0,0,0,0,0,0,70.07
臺北縣,五股鄉,德音村,1114,2,640,7,647,1062,0,0,0,0,0,0,60.92
臺北縣,五股鄉,德音村,1115,2,468,3,471,732,0,0,0,0,0,0,64.34
臺北縣,五股鄉,德音村,1116,2,523,4,527,850,0,0,0,0,0,0,62.00
臺北縣,五股鄉,水碓村,1117,2,604,11,615,953,0,0,0,0,0,0,64.53
臺北縣,五股鄉,水碓村,1118,2,546,12,558,945,0,0,0,0,0,0,59.05
臺北縣,五股鄉,水碓村,1119,2,714,13,727,1051,0,0,0,0,0,0,69.17
臺北縣,五股鄉,水碓村,1120,2,695,11,706,1136,0,0,0,0,0,0,62.15
臺北縣,五股鄉,德泰村,1121,2,623,12,635,1061,0,0,0,0,0,0,59.85
臺北縣,五股鄉,德泰村,1122,2,639,5,644,1048,0,0,0,0,0,0,61.45
臺北縣,五股鄉,德泰村,1123,2,618,14,632,1053,0,0,0,0,0,0,60.02
臺北縣,五股鄉,陸一村,1124,2,714,7,721,1071,0,0,0,0,0,0,67.32
臺北縣,五股鄉,陸一村,1125,2,633,7,640,966,0,0,0,0,0,0,66.25
臺北縣,五股鄉,貿商村,1126,2,441,6,447,718,0,0,0,0,0,0,62.26
臺北縣,泰山鄉,大科村,1127,2,438,4,442,604,0,0,0,0,0,0,73.18
臺北縣,泰山鄉,大科村,1128,2,177,2,179,249,0,0,0,0,0,0,71.89
臺北縣,泰山鄉,黎明村,1129,2,491,11,502,778,0,0,0,0,0,0,64.52
臺北縣,泰山鄉,黎明村,1130,2,405,9,414,777,0,0,0,0,0,0,53.28
臺北縣,泰山鄉,黎明村,1131,2,344,5,349,513,0,0,0,0,0,0,68.03
臺北縣,泰山鄉,山腳村,1132,2,690,7,697,1294,0,0,0,0,0,0,53.86
臺北縣,泰山鄉,山腳村,1133,2,687,8,695,1144,0,0,0,0,0,0,60.75
臺北縣,泰山鄉,山腳村,1134,2,487,6,493,860,0,0,0,0,0,0,57.33
臺北縣,泰山鄉,山腳村,1135,2,560,5,565,940,0,0,0,0,0,0,60.11
臺北縣,泰山鄉,福泰村,1136,2,612,9,621,1002,0,0,0,0,0,0,61.98
臺北縣,泰山鄉,福泰村,1137,2,583,9,592,947,0,0,0,0,0,0,62.51
臺北縣,泰山鄉,福泰村,1138,2,596,4,600,905,0,0,0,0,0,0,66.30
臺北縣,泰山鄉,福泰村,1139,2,556,8,564,945,0,0,0,0,0,0,59.68
臺北縣,泰山鄉,楓樹村,1140,2,477,5,482,793,0,0,0,0,0,0,60.78
臺北縣,泰山鄉,楓樹村,1141,2,466,2,468,789,0,0,0,0,0,0,59.32
臺北縣,泰山鄉,楓樹村,1142,2,536,11,547,839,0,0,0,0,0,0,65.20
臺北縣,泰山鄉,同榮村,1143,2,553,6,559,829,0,0,0,0,0,0,67.43
臺北縣,泰山鄉,同榮村,1144,2,599,9,608,965,0,0,0,0,0,0,63.01
臺北縣,泰山鄉,同榮村,1145,2,465,2,467,766,0,0,0,0,0,0,60.97
臺北縣,泰山鄉,同興村,1146,2,641,10,651,967,0,0,0,0,0,0,67.32
臺北縣,泰山鄉,同興村,1147,2,539,6,545,888,0,0,0,0,0,0,61.37
臺北縣,泰山鄉,義學村,1148,2,542,10,552,891,0,0,0,0,0,0,61.95
臺北縣,泰山鄉,義學村,1149,2,490,5,495,777,0,0,0,0,0,0,63.71
臺北縣,泰山鄉,義學村,1150,2,661,6,667,1115,0,0,0,0,0,0,59.82
臺北縣,泰山鄉,義仁村,1151,2,612,7,619,1065,0,0,0,0,0,0,58.12
臺北縣,泰山鄉,義仁村,1152,2,708,7,715,1252,0,0,0,0,0,0,57.11
臺北縣,泰山鄉,義仁村,1153,2,623,4,627,1096,0,0,0,0,0,0,57.21
臺北縣,泰山鄉,明志村,1154,2,477,16,493,903,0,0,0,0,0,0,54.60
臺北縣,泰山鄉,明志村,1155,2,504,7,511,810,0,0,0,0,0,0,63.09
臺北縣,泰山鄉,明志村,1156,2,559,6,565,870,0,0,0,0,0,0,64.94
臺北縣,泰山鄉,泰友村,1157,2,550,4,554,859,0,0,0,0,0,0,64.49
臺北縣,泰山鄉,泰友村,1158,2,466,6,472,773,0,0,0,0,0,0,61.06
臺北縣,泰山鄉,新明村,1159,2,667,11,678,1086,0,0,0,0,0,0,62.43
臺北縣,泰山鄉,新明村,1160,2,704,10,714,1222,0,0,0,0,0,0,58.43
臺北縣,泰山鄉,貴子村,1161,2,618,7,625,1055,0,0,0,0,0,0,59.24
臺北縣,泰山鄉,貴子村,1162,2,525,11,536,849,0,0,0,0,0,0,63.13
臺北縣,泰山鄉,貴子村,1163,2,461,4,465,710,0,0,0,0,0,0,65.49
臺北縣,泰山鄉,貴賢村,1164,2,783,6,789,1195,0,0,0,0,0,0,66.03
臺北縣,泰山鄉,貴賢村,1165,2,761,18,779,1310,0,0,0,0,0,0,59.47
臺北縣,泰山鄉,貴和村,1166,2,713,9,722,1125,0,0,0,0,0,0,64.18
臺北縣,泰山鄉,貴和村,1167,2,762,5,767,1256,0,0,0,0,0,0,61.07
臺北縣,泰山鄉,貴和村,1168,2,604,13,617,1109,0,0,0,0,0,0,55.64
臺北縣,林口鄉,東林村,1169,2,700,6,706,1067,0,0,0,0,0,0,66.17
臺北縣,林口鄉,東林村,1170,2,579,4,583,925,0,0,0,0,0,0,63.03
臺北縣,林口鄉,東林村,1171,2,711,12,723,1140,0,0,0,0,0,0,63.42
臺北縣,林口鄉,林口村,1172,2,479,13,492,1017,0,0,0,0,0,0,48.38
臺北縣,林口鄉,林口村,1173,2,739,10,749,1156,0,0,0,0,0,0,64.79
臺北縣,林口鄉,林口村,1174,2,690,4,694,1015,0,0,0,0,0,0,68.37
臺北縣,林口鄉,西林村,1175,2,707,13,720,1063,0,0,0,0,0,0,67.73
臺北縣,林口鄉,西林村,1176,2,621,7,628,1030,0,0,0,0,0,0,60.97
臺北縣,林口鄉,西林村,1177,2,516,8,524,858,0,0,0,0,0,0,61.07
臺北縣,林口鄉,菁湖村,1178,2,869,13,882,1410,0,0,0,0,0,0,62.55
臺北縣,林口鄉,菁湖村,1179,2,907,5,912,1418,0,0,0,0,0,0,64.32
臺北縣,林口鄉,中湖村,1180,2,848,11,859,1256,0,0,0,0,0,0,68.39
臺北縣,林口鄉,中湖村,1181,2,734,8,742,1088,0,0,0,0,0,0,68.20
臺北縣,林口鄉,湖北村,1182,2,793,10,803,998,0,0,0,0,0,0,80.46
臺北縣,林口鄉,湖南村,1183,2,994,11,1005,1453,0,0,0,0,0,0,69.17
臺北縣,林口鄉,南勢村,1184,2,647,34,681,967,0,0,0,0,0,0,70.42
臺北縣,林口鄉,南勢村,1185,2,636,8,644,1367,0,0,0,0,0,0,47.11
臺北縣,林口鄉,南勢村,1186,2,823,10,833,1610,0,0,0,0,0,0,51.74
臺北縣,林口鄉,南勢村,1187,2,644,4,648,1245,0,0,0,0,0,0,52.05
臺北縣,林口鄉,東勢村,1188,2,544,8,552,1021,0,0,0,0,0,0,54.06
臺北縣,林口鄉,東勢村,1189,2,570,9,579,1011,0,0,0,0,0,0,57.27
臺北縣,林口鄉,東勢村,1190,2,672,16,688,1096,0,0,0,0,0,0,62.77
臺北縣,林口鄉,東勢村,1191,2,768,8,776,1274,0,0,0,0,0,0,60.91
臺北縣,林口鄉,東勢村,1192,2,550,7,557,1032,0,0,0,0,0,0,53.97
臺北縣,林口鄉,頂福村,1193,2,595,5,600,900,0,0,0,0,0,0,66.67
臺北縣,林口鄉,下福村,1194,2,626,11,637,882,0,0,0,0,0,0,72.22
臺北縣,林口鄉,嘉寶村,1195,2,488,9,497,618,0,0,0,0,0,0,80.42
臺北縣,林口鄉,瑞平村,1196,2,338,7,345,447,0,0,0,0,0,0,77.18
臺北縣,林口鄉,太平村,1197,2,533,6,539,788,0,0,0,0,0,0,68.40
臺北縣,淡水鎮,中和里,1198,2,434,8,442,573,0,0,0,0,0,0,77.14
臺北縣,淡水鎮,屯山里,1199,2,752,11,763,957,0,0,0,0,0,0,79.73
臺北縣,淡水鎮,賢孝里,1200,2,924,13,937,1237,0,0,0,0,0,0,75.75
臺北縣,淡水鎮,興仁里,1201,2,961,12,973,1280,0,0,0,0,0,0,76.02
臺北縣,淡水鎮,蕃薯里,1202,2,430,1,431,748,0,0,0,0,0,0,57.62
臺北縣,淡水鎮,義山里,1203,2,695,10,705,1066,0,0,0,0,0,0,66.14
臺北縣,淡水鎮,義山里,1204,2,654,18,672,1073,0,0,0,0,0,0,62.63
臺北縣,淡水鎮,忠山里,1205,2,631,8,639,785,0,0,0,0,0,0,81.40
臺北縣,淡水鎮,水源里,1206,2,1064,11,1075,1659,0,0,0,0,0,0,64.80
臺北縣,淡水鎮,忠寮里,1207,2,652,10,662,909,0,0,0,0,0,0,72.83
臺北縣,淡水鎮,樹興里,1208,2,468,11,479,706,0,0,0,0,0,0,67.85
臺北縣,淡水鎮,坪頂里,1209,2,558,7,565,907,0,0,0,0,0,0,62.29
臺北縣,淡水鎮,福德里,1210,2,861,10,871,1557,0,0,0,0,0,0,55.94
臺北縣,淡水鎮,福德里,1211,2,720,11,731,1293,0,0,0,0,0,0,56.54
臺北縣,淡水鎮,福德里,1212,2,609,5,614,1282,0,0,0,0,0,0,47.89
臺北縣,淡水鎮,竹圍里,1213,2,934,19,953,1697,0,0,0,0,0,0,56.16
臺北縣,淡水鎮,竹圍里,1214,2,728,18,746,1241,0,0,0,0,0,0,60.11
臺北縣,淡水鎮,竹圍里,1215,2,673,9,682,1218,0,0,0,0,0,0,55.99
臺北縣,淡水鎮,民生里,1216,2,722,13,735,1327,0,0,0,0,0,0,55.39
臺北縣,淡水鎮,民生里,1217,2,778,16,794,1284,0,0,0,0,0,0,61.84
臺北縣,淡水鎮,民生里,1218,2,688,12,700,1160,0,0,0,0,0,0,60.34
臺北縣,淡水鎮,八勢里,1219,2,545,8,553,876,0,0,0,0,0,0,63.13
臺北縣,淡水鎮,竿蓁里,1220,2,586,0,586,1169,0,0,0,0,0,0,50.13
臺北縣,淡水鎮,竿蓁里,1221,2,521,8,529,936,0,0,0,0,0,0,56.52
臺北縣,淡水鎮,崁頂里,1222,2,787,11,798,1136,0,0,0,0,0,0,70.25
臺北縣,淡水鎮,埤島里,1223,2,809,19,828,1067,0,0,0,0,0,0,77.60
臺北縣,淡水鎮,新興里,1224,2,853,5,858,1325,0,0,0,0,0,0,64.75
臺北縣,淡水鎮,新興里,1225,2,1107,11,1118,1622,0,0,0,0,0,0,68.93
臺北縣,淡水鎮,新興里,1226,2,944,18,962,1764,0,0,0,0,0,0,54.54
臺北縣,淡水鎮,新興里,1227,2,870,13,883,1625,0,0,0,0,0,0,54.34
臺北縣,淡水鎮,新興里,1228,2,871,11,882,1653,0,0,0,0,0,0,53.36
臺北縣,淡水鎮,新興里,1229,2,817,7,824,1488,0,0,0,0,0,0,55.38
臺北縣,淡水鎮,水碓里,1230,2,891,24,915,1263,0,0,0,0,0,0,72.45
臺北縣,淡水鎮,水碓里,1231,2,888,15,903,1504,0,0,0,0,0,0,60.04
臺北縣,淡水鎮,水碓里,1232,2,804,13,817,1431,0,0,0,0,0,0,57.09
臺北縣,淡水鎮,水碓里,1233,2,797,9,806,1651,0,0,0,0,0,0,48.82
臺北縣,淡水鎮,水碓里,1234,2,739,16,755,1184,0,0,0,0,0,0,63.77
臺北縣,淡水鎮,北投里,1235,2,925,18,943,1548,0,0,0,0,0,0,60.92
臺北縣,淡水鎮,鄧公里,1236,2,741,12,753,1188,0,0,0,0,0,0,63.38
臺北縣,淡水鎮,鄧公里,1237,2,765,8,773,1227,0,0,0,0,0,0,63.00
臺北縣,淡水鎮,鄧公里,1238,2,936,13,949,1720,0,0,0,0,0,0,55.17
臺北縣,淡水鎮,鄧公里,1239,2,880,16,896,1594,0,0,0,0,0,0,56.21
臺北縣,淡水鎮,鄧公里,1240,2,716,11,727,1092,0,0,0,0,0,0,66.58
臺北縣,淡水鎮,鄧公里,1241,2,733,15,748,1157,0,0,0,0,0,0,64.65
臺北縣,淡水鎮,中興里,1242,2,632,6,638,1100,0,0,0,0,0,0,58.00
臺北縣,淡水鎮,中興里,1243,2,825,16,841,1278,0,0,0,0,0,0,65.81
臺北縣,淡水鎮,中興里,1244,2,822,26,848,1195,0,0,0,0,0,0,70.96
臺北縣,淡水鎮,長庚里,1245,2,1028,19,1047,1543,0,0,0,0,0,0,67.85
臺北縣,淡水鎮,清文里,1246,2,678,12,690,988,0,0,0,0,0,0,69.84
臺北縣,淡水鎮,草東里,1247,2,561,8,569,804,0,0,0,0,0,0,70.77
臺北縣,淡水鎮,協元里,1248,2,883,17,900,1385,0,0,0,0,0,0,64.98
臺北縣,淡水鎮,永吉里,1249,2,496,13,509,731,0,0,0,0,0,0,69.63
臺北縣,淡水鎮,民安里,1250,2,479,4,483,748,0,0,0,0,0,0,64.57
臺北縣,淡水鎮,新生里,1251,2,327,10,337,498,0,0,0,0,0,0,67.67
臺北縣,淡水鎮,文化里,1252,2,679,9,688,1061,0,0,0,0,0,0,64.84
臺北縣,淡水鎮,油車里,1253,2,841,4,845,1209,0,0,0,0,0,0,69.89
臺北縣,淡水鎮,油車里,1254,2,478,15,493,981,0,0,0,0,0,0,50.25
臺北縣,淡水鎮,油車里,1255,2,651,8,659,1024,0,0,0,0,0,0,64.36
臺北縣,淡水鎮,沙崙里,1256,2,616,10,626,1095,0,0,0,0,0,0,57.17
臺北縣,淡水鎮,沙崙里,1257,2,974,15,989,1543,0,0,0,0,0,0,64.10
臺北縣,淡水鎮,沙崙里,1258,2,743,13,756,1217,0,0,0,0,0,0,62.12
臺北縣,八里鄉,龍源村,1259,2,932,26,958,1499,0,0,0,0,0,0,63.91
臺北縣,八里鄉,龍源村,1260,2,698,18,716,1045,0,0,0,0,0,0,68.52
臺北縣,八里鄉,龍源村,1261,2,553,6,559,917,0,0,0,0,0,0,60.96
臺北縣,八里鄉,米倉村,1262,2,581,10,591,899,0,0,0,0,0,0,65.74
臺北縣,八里鄉,米倉村,1263,2,590,13,603,924,0,0,0,0,0,0,65.26
臺北縣,八里鄉,大崁村,1264,2,828,14,842,1149,0,0,0,0,0,0,73.28
臺北縣,八里鄉,埤頭村,1265,2,546,5,551,908,0,0,0,0,0,0,60.68
臺北縣,八里鄉,埤頭村,1266,2,671,10,681,1062,0,0,0,0,0,0,64.12
臺北縣,八里鄉,頂罟村,1267,2,602,21,623,865,0,0,0,0,0,0,72.02
臺北縣,八里鄉,舊城村,1268,2,677,15,692,1063,0,0,0,0,0,0,65.10
臺北縣,八里鄉,舊城村,1269,2,514,10,524,914,0,0,0,0,0,0,57.33
臺北縣,八里鄉,舊城村,1270,2,700,10,710,1290,0,0,0,0,0,0,55.04
臺北縣,八里鄉,訊塘村,1271,2,715,11,726,1137,0,0,0,0,0,0,63.85
臺北縣,八里鄉,訊塘村,1272,2,655,17,672,940,0,0,0,0,0,0,71.49
臺北縣,八里鄉,荖阡村,1273,2,682,15,697,916,0,0,0,0,0,0,76.09
臺北縣,八里鄉,下罟村,1274,2,788,14,802,951,0,0,0,0,0,0,84.33
臺北縣,八里鄉,長坑村,1275,2,765,10,775,1030,0,0,0,0,0,0,75.24
臺北縣,三芝鄉,八賢村,1276,2,219,1,220,335,0,0,0,0,0,0,65.67
臺北縣,三芝鄉,埔頭村,1277,2,1015,12,1027,1599,0,0,0,0,0,0,64.23
臺北縣,三芝鄉,埔頭村,1278,2,939,15,954,1609,0,0,0,0,0,0,59.29
臺北縣,三芝鄉,古庄村,1279,2,568,8,576,808,0,0,0,0,0,0,71.29
臺北縣,三芝鄉,新庄村,1280,2,490,5,495,794,0,0,0,0,0,0,62.34
臺北縣,三芝鄉,埔坪村,1281,2,927,9,936,1643,0,0,0,0,0,0,56.97
臺北縣,三芝鄉,埔坪村,1282,2,778,10,788,1196,0,0,0,0,0,0,65.89
臺北縣,三芝鄉,埔坪村,1283,2,809,13,822,1282,0,0,0,0,0,0,64.12
臺北縣,三芝鄉,茂長村,1284,2,228,2,230,413,0,0,0,0,0,0,55.69
臺北縣,三芝鄉,橫山村,1285,2,369,5,374,536,0,0,0,0,0,0,69.78
臺北縣,三芝鄉,錫板村,1286,2,469,6,475,779,0,0,0,0,0,0,60.98
臺北縣,三芝鄉,後厝村,1287,2,729,20,749,1248,0,0,0,0,0,0,60.02
臺北縣,三芝鄉,福德村,1288,2,359,5,364,577,0,0,0,0,0,0,63.08
臺北縣,三芝鄉,圓山村,1289,2,302,5,307,500,0,0,0,0,0,0,61.40
臺北縣,三芝鄉,店子村,1290,2,423,7,430,641,0,0,0,0,0,0,67.08
臺北縣,三芝鄉,興華村,1291,2,683,3,686,1117,0,0,0,0,0,0,61.41
臺北縣,石門鄉,德茂村,1292,2,515,3,518,752,0,0,0,0,0,0,68.88
臺北縣,石門鄉,富基村,1293,2,648,6,654,1002,0,0,0,0,0,0,65.27
臺北縣,石門鄉,老梅村,1294,2,991,34,1025,1534,0,0,0,0,0,0,66.82
臺北縣,石門鄉,山溪村,1295,2,431,5,436,638,0,0,0,0,0,0,68.34
臺北縣,石門鄉,石門村,1296,2,727,7,734,1046,0,0,0,0,0,0,70.17
臺北縣,石門鄉,尖鹿村,1297,2,735,10,745,1091,0,0,0,0,0,0,68.29
臺北縣,石門鄉,乾華村,1298,2,151,2,153,268,0,0,0,0,0,0,57.09
臺北縣,石門鄉,茂林村,1299,2,351,6,357,511,0,0,0,0,0,0,69.86
臺北縣,石門鄉,草里村,1300,2,449,7,456,652,0,0,0,0,0,0,69.94
臺北縣,金山鄉,和平村,1301,2,269,4,273,437,0,0,0,0,0,0,62.47
臺北縣,金山鄉,大同村,1302,2,424,5,429,645,0,0,0,0,0,0,66.51
臺北縣,金山鄉,豐漁村,1303,2,293,2,295,445,0,0,0,0,0,0,66.29
臺北縣,金山鄉,磺港村,1304,2,859,9,868,1409,0,0,0,0,0,0,61.60
臺北縣,金山鄉,美田村,1305,2,792,4,796,1200,0,0,0,0,0,0,66.33
臺北縣,金山鄉,美田村,1306,2,1070,13,1083,1751,0,0,0,0,0,0,61.85
臺北縣,金山鄉,美田村,1307,2,905,9,914,1479,0,0,0,0,0,0,61.80
臺北縣,金山鄉,美田村,1308,2,863,7,870,1399,0,0,0,0,0,0,62.19
臺北縣,金山鄉,五湖村,1309,2,415,4,419,625,0,0,0,0,0,0,67.04
臺北縣,金山鄉,五湖村,1310,2,459,8,467,752,0,0,0,0,0,0,62.10
臺北縣,金山鄉,重和村,1311,2,469,3,472,823,0,0,0,0,0,0,57.35
臺北縣,金山鄉,兩湖村,1312,2,242,3,245,368,0,0,0,0,0,0,66.58
臺北縣,金山鄉,六股村,1313,2,336,2,338,515,0,0,0,0,0,0,65.63
臺北縣,金山鄉,三界村,1314,2,343,4,347,545,0,0,0,0,0,0,63.67
臺北縣,金山鄉,清泉村,1315,2,469,9,478,765,0,0,0,0,0,0,62.48
臺北縣,金山鄉,西湖村,1316,2,147,0,147,239,0,0,0,0,0,0,61.51
臺北縣,金山鄉,萬壽村,1317,2,273,7,280,429,0,0,0,0,0,0,65.27
臺北縣,金山鄉,永興村,1318,2,317,1,318,552,0,0,0,0,0,0,57.61
臺北縣,萬里鄉,萬里村,1319,2,982,16,998,1503,0,0,0,0,0,0,66.40
臺北縣,萬里鄉,萬里村,1320,2,887,7,894,1405,0,0,0,0,0,0,63.63
臺北縣,萬里鄉,北基村,1321,2,438,3,441,723,0,0,0,0,0,0,61.00
臺北縣,萬里鄉,北基村,1322,2,643,18,661,1188,0,0,0,0,0,0,55.64
臺北縣,萬里鄉,龜吼村,1323,2,331,8,339,576,0,0,0,0,0,0,58.85
臺北縣,萬里鄉,龜吼村,1324,2,643,3,646,961,0,0,0,0,0,0,67.22
臺北縣,萬里鄉,野柳村,1325,2,651,9,660,1106,0,0,0,0,0,0,59.67
臺北縣,萬里鄉,野柳村,1326,2,610,8,618,1024,0,0,0,0,0,0,60.35
臺北縣,萬里鄉,大鵬村,1327,2,405,5,410,651,0,0,0,0,0,0,62.98
臺北縣,萬里鄉,大鵬村,1328,2,902,15,917,1400,0,0,0,0,0,0,65.50
臺北縣,萬里鄉,磺潭村,1329,2,309,4,313,455,0,0,0,0,0,0,68.79
臺北縣,萬里鄉,雙興村,1330,2,446,5,451,758,0,0,0,0,0,0,59.50
臺北縣,萬里鄉,溪底村,1331,2,314,3,317,538,0,0,0,0,0,0,58.92
臺北縣,萬里鄉,崁腳村,1332,2,308,3,311,564,0,0,0,0,0,0,55.14
臺北縣,萬里鄉,中幅村,1333,2,464,17,481,767,0,0,0,0,0,0,62.71
臺北縣,中和市,中原里,1334,3,701,9,710,1351,0,0,0,0,0,0,52.55
臺北縣,中和市,中原里,1335,3,370,5,375,660,0,0,0,0,0,0,56.82
臺北縣,中和市,中原里,1336,3,290,4,294,534,0,0,0,0,0,0,55.06
臺北縣,中和市,連和里,1337,3,370,3,373,634,0,0,0,0,0,0,58.83
臺北縣,中和市,連和里,1338,3,409,3,412,648,0,0,0,0,0,0,63.58
臺北縣,中和市,連城里,1339,3,786,11,797,1384,0,0,0,0,0,0,57.59
臺北縣,中和市,連城里,1340,3,914,8,922,1412,0,0,0,0,0,0,65.30
臺北縣,中和市,連城里,1341,3,867,13,880,1559,0,0,0,0,0,0,56.45
臺北縣,中和市,力行里,1342,3,886,10,896,1496,0,0,0,0,0,0,59.89
臺北縣,中和市,力行里,1343,3,898,15,913,1567,0,0,0,0,0,0,58.26
臺北縣,中和市,正行里,1344,3,521,8,529,925,0,0,0,0,0,0,57.19
臺北縣,中和市,正行里,1345,3,518,4,522,958,0,0,0,0,0,0,54.49
臺北縣,中和市,德行里,1346,3,986,16,1002,1679,0,0,0,0,0,0,59.68
臺北縣,中和市,德行里,1347,3,869,14,883,1472,0,0,0,0,0,0,59.99
臺北縣,中和市,枋寮里,1348,3,842,14,856,1391,0,0,0,0,0,0,61.54
臺北縣,中和市,枋寮里,1349,3,789,4,793,1305,0,0,0,0,0,0,60.77
臺北縣,中和市,漳和里,1350,3,769,12,781,1219,0,0,0,0,0,0,64.07
臺北縣,中和市,漳和里,1351,3,859,12,871,1399,0,0,0,0,0,0,62.26
臺北縣,中和市,廟美里,1352,3,728,13,741,1191,0,0,0,0,0,0,62.22
臺北縣,中和市,廟美里,1353,3,672,7,679,1182,0,0,0,0,0,0,57.45
臺北縣,中和市,廟美里,1354,3,727,5,732,1209,0,0,0,0,0,0,60.55
臺北縣,中和市,福真里,1355,3,855,16,871,1621,0,0,0,0,0,0,53.73
臺北縣,中和市,福真里,1356,3,1017,21,1038,1712,0,0,0,0,0,0,60.63
臺北縣,中和市,福善里,1357,3,458,6,464,693,0,0,0,0,0,0,66.96
臺北縣,中和市,福善里,1358,3,603,3,606,987,0,0,0,0,0,0,61.40
臺北縣,中和市,福善里,1359,3,757,9,766,1232,0,0,0,0,0,0,62.18
臺北縣,中和市,福美里,1360,3,1038,8,1046,1555,0,0,0,0,0,0,67.27
臺北縣,中和市,福美里,1361,3,612,8,620,1069,0,0,0,0,0,0,58.00
臺北縣,中和市,福美里,1362,3,679,10,689,1129,0,0,0,0,0,0,61.03
臺北縣,中和市,福祥里,1363,3,931,17,948,1615,0,0,0,0,0,0,58.70
臺北縣,中和市,福祥里,1364,3,996,15,1011,1640,0,0,0,0,0,0,61.65
臺北縣,中和市,瓦窯里,1365,3,518,7,525,950,0,0,0,0,0,0,55.26
臺北縣,中和市,瓦窯里,1366,3,792,5,797,1363,0,0,0,0,0,0,58.47
臺北縣,中和市,瓦窯里,1367,3,766,9,775,1387,0,0,0,0,0,0,55.88
臺北縣,中和市,福和里,1368,3,770,8,778,1388,0,0,0,0,0,0,56.05
臺北縣,中和市,福和里,1369,3,974,10,984,1607,0,0,0,0,0,0,61.23
臺北縣,中和市,佳和里,1370,3,864,14,878,1586,0,0,0,0,0,0,55.36
臺北縣,中和市,佳和里,1371,3,771,18,789,1242,0,0,0,0,0,0,63.53
臺北縣,中和市,佳和里,1372,3,585,3,588,986,0,0,0,0,0,0,59.63
臺北縣,中和市,新南里,1373,3,788,9,797,1413,0,0,0,0,0,0,56.40
臺北縣,中和市,新南里,1374,3,539,7,546,962,0,0,0,0,0,0,56.76
臺北縣,中和市,新南里,1375,3,1015,18,1033,1765,0,0,0,0,0,0,58.53
臺北縣,中和市,南山里,1376,3,1015,11,1026,1732,0,0,0,0,0,0,59.24
臺北縣,中和市,南山里,1377,3,773,10,783,1316,0,0,0,0,0,0,59.50
臺北縣,中和市,平河里,1378,3,943,13,956,1749,0,0,0,0,0,0,54.66
臺北縣,中和市,平河里,1379,3,1017,18,1035,1849,0,0,0,0,0,0,55.98
臺北縣,中和市,信和里,1380,3,772,23,795,1420,0,0,0,0,0,0,55.99
臺北縣,中和市,信和里,1381,3,1074,21,1095,1835,0,0,0,0,0,0,59.67
臺北縣,中和市,仁和里,1382,3,736,13,749,1256,0,0,0,0,0,0,59.63
臺北縣,中和市,仁和里,1383,3,727,15,742,1152,0,0,0,0,0,0,64.41
臺北縣,中和市,仁和里,1384,3,522,11,533,886,0,0,0,0,0,0,60.16
臺北縣,中和市,中正里,1385,3,835,10,845,1359,0,0,0,0,0,0,62.18
臺北縣,中和市,中正里,1386,3,983,9,992,1610,0,0,0,0,0,0,61.61
臺北縣,中和市,中山里,1387,3,598,6,604,940,0,0,0,0,0,0,64.26
臺北縣,中和市,中山里,1388,3,485,9,494,843,0,0,0,0,0,0,58.60
臺北縣,中和市,建和里,1389,3,1136,3,1139,1662,0,0,0,0,0,0,68.53
臺北縣,中和市,建和里,1390,3,889,29,918,1641,0,0,0,0,0,0,55.94
臺北縣,中和市,碧河里,1391,3,544,13,557,1018,0,0,0,0,0,0,54.72
臺北縣,中和市,碧河里,1392,3,696,11,707,1250,0,0,0,0,0,0,56.56
臺北縣,中和市,宜安里,1393,3,1023,13,1036,1625,0,0,0,0,0,0,63.75
臺北縣,中和市,安樂里,1394,3,843,9,852,1347,0,0,0,0,0,0,63.25
臺北縣,中和市,安樂里,1395,3,733,13,746,1210,0,0,0,0,0,0,61.65
臺北縣,中和市,安和里,1396,3,806,9,815,1297,0,0,0,0,0,0,62.84
臺北縣,中和市,安和里,1397,3,607,11,618,1019,0,0,0,0,0,0,60.65
臺北縣,中和市,安順里,1398,3,785,10,795,1292,0,0,0,0,0,0,61.53
臺北縣,中和市,安順里,1399,3,1148,12,1160,1935,0,0,0,0,0,0,59.95
臺北縣,中和市,安平里,1400,3,711,5,716,1111,0,0,0,0,0,0,64.45
臺北縣,中和市,安平里,1401,3,770,12,782,1176,0,0,0,0,0,0,66.50
臺北縣,中和市,安平里,1402,3,941,9,950,1496,0,0,0,0,0,0,63.50
臺北縣,中和市,中安里,1403,3,934,10,944,1504,0,0,0,0,0,0,62.77
臺北縣,中和市,中安里,1404,3,976,11,987,1501,0,0,0,0,0,0,65.76
臺北縣,中和市,泰安里,1405,3,657,12,669,1019,0,0,0,0,0,0,65.65
臺北縣,中和市,泰安里,1406,3,560,8,568,925,0,0,0,0,0,0,61.41
臺北縣,中和市,泰安里,1407,3,722,10,732,1225,0,0,0,0,0,0,59.76
臺北縣,中和市,秀山里,1408,3,936,18,954,1571,0,0,0,0,0,0,60.73
臺北縣,中和市,秀山里,1409,3,1029,18,1047,1780,0,0,0,0,0,0,58.82
臺北縣,中和市,秀成里,1410,3,750,10,760,1278,0,0,0,0,0,0,59.47
臺北縣,中和市,秀成里,1411,3,855,14,869,1470,0,0,0,0,0,0,59.12
臺北縣,中和市,秀義里,1412,3,707,12,719,1225,0,0,0,0,0,0,58.69
臺北縣,中和市,秀義里,1413,3,609,17,626,989,0,0,0,0,0,0,63.30
臺北縣,中和市,秀福里,1414,3,966,14,980,1596,0,0,0,0,0,0,61.40
臺北縣,中和市,秀福里,1415,3,732,7,739,1141,0,0,0,0,0,0,64.77
臺北縣,中和市,秀福里,1416,3,654,3,657,1025,0,0,0,0,0,0,64.10
臺北縣,中和市,秀景里,1417,3,943,8,951,1601,0,0,0,0,0,0,59.40
臺北縣,中和市,秀景里,1418,3,1156,19,1175,1968,0,0,0,0,0,0,59.71
臺北縣,中和市,秀景里,1419,3,560,9,569,944,0,0,0,0,0,0,60.28
臺北縣,中和市,秀明里,1420,3,917,10,927,1465,0,0,0,0,0,0,63.28
臺北縣,中和市,秀明里,1421,3,825,9,834,1375,0,0,0,0,0,0,60.65
臺北縣,中和市,秀峰里,1422,3,811,5,816,1304,0,0,0,0,0,0,62.58
臺北縣,中和市,秀峰里,1423,3,747,9,756,1368,0,0,0,0,0,0,55.26
臺北縣,中和市,秀士里,1424,3,522,6,528,877,0,0,0,0,0,0,60.21
臺北縣,中和市,秀士里,1425,3,749,24,773,1200,0,0,0,0,0,0,64.42
臺北縣,中和市,秀水里,1426,3,607,9,616,1066,0,0,0,0,0,0,57.79
臺北縣,中和市,秀水里,1427,3,692,9,701,1114,0,0,0,0,0,0,62.93
臺北縣,中和市,秀水里,1428,3,696,12,708,1180,0,0,0,0,0,0,60.00
臺北縣,中和市,秀仁里,1429,3,708,15,723,1150,0,0,0,0,0,0,62.87
臺北縣,中和市,秀仁里,1430,3,680,8,688,1155,0,0,0,0,0,0,59.57
臺北縣,中和市,正南里,1431,3,625,11,636,1107,0,0,0,0,0,0,57.45
臺北縣,中和市,正南里,1432,3,519,8,527,912,0,0,0,0,0,0,57.79
臺北縣,中和市,正南里,1433,3,630,17,647,1136,0,0,0,0,0,0,56.95
臺北縣,中和市,頂南里,1434,3,717,12,729,1168,0,0,0,0,0,0,62.41
臺北縣,中和市,頂南里,1435,3,757,10,767,1265,0,0,0,0,0,0,60.63
臺北縣,中和市,華新里,1436,3,657,10,667,1265,0,0,0,0,0,0,52.73
臺北縣,中和市,華新里,1437,3,653,8,661,1214,0,0,0,0,0,0,54.45
臺北縣,中和市,華新里,1438,3,800,12,812,1530,0,0,0,0,0,0,53.07
臺北縣,中和市,東南里,1439,3,736,4,740,1144,0,0,0,0,0,0,64.69
臺北縣,中和市,東南里,1440,3,850,14,864,1441,0,0,0,0,0,0,59.96
臺北縣,中和市,東南里,1441,3,975,21,996,1538,0,0,0,0,0,0,64.76
臺北縣,中和市,華南里,1442,3,930,11,941,1604,0,0,0,0,0,0,58.67
臺北縣,中和市,華南里,1443,3,719,14,733,1292,0,0,0,0,0,0,56.73
臺北縣,中和市,忠孝里,1444,3,484,4,488,865,0,0,0,0,0,0,56.42
臺北縣,中和市,忠孝里,1445,3,512,11,523,905,0,0,0,0,0,0,57.79
臺北縣,中和市,忠孝里,1446,3,551,10,561,978,0,0,0,0,0,0,57.36
臺北縣,中和市,忠孝里,1447,3,659,13,672,1268,0,0,0,0,0,0,53.00
臺北縣,中和市,崇南里,1448,3,659,16,675,1139,0,0,0,0,0,0,59.26
臺北縣,中和市,崇南里,1449,3,1055,11,1066,1634,0,0,0,0,0,0,65.24
臺北縣,中和市,興南里,1450,3,828,15,843,1410,0,0,0,0,0,0,59.79
臺北縣,中和市,興南里,1451,3,907,16,923,1515,0,0,0,0,0,0,60.92
臺北縣,中和市,景南里,1452,3,722,10,732,1162,0,0,0,0,0,0,62.99
臺北縣,中和市,景南里,1453,3,926,12,938,1596,0,0,0,0,0,0,58.77
臺北縣,中和市,景本里,1454,3,552,9,561,914,0,0,0,0,0,0,61.38
臺北縣,中和市,景本里,1455,3,571,7,578,952,0,0,0,0,0,0,60.71
臺北縣,中和市,橫路里,1456,3,200,3,203,305,0,0,0,0,0,0,66.56
臺北縣,中和市,內南里,1457,3,788,15,803,1336,0,0,0,0,0,0,60.10
臺北縣,中和市,內南里,1458,3,781,12,793,1308,0,0,0,0,0,0,60.63
臺北縣,中和市,內南里,1459,3,853,8,861,1401,0,0,0,0,0,0,61.46
臺北縣,中和市,壽南里,1460,3,846,12,858,1371,0,0,0,0,0,0,62.58
臺北縣,中和市,壽南里,1461,3,508,10,518,879,0,0,0,0,0,0,58.93
臺北縣,中和市,福南里,1462,3,953,18,971,1682,0,0,0,0,0,0,57.73
臺北縣,中和市,福南里,1463,3,859,28,887,1464,0,0,0,0,0,0,60.59
臺北縣,中和市,外南里,1464,3,900,15,915,1556,0,0,0,0,0,0,58.80
臺北縣,中和市,外南里,1465,3,889,8,897,1511,0,0,0,0,0,0,59.36
臺北縣,中和市,中興里,1466,3,1019,15,1034,1776,0,0,0,0,0,0,58.22
臺北縣,中和市,中興里,1467,3,946,18,964,1612,0,0,0,0,0,0,59.80
臺北縣,中和市,吉興里,1468,3,501,7,508,911,0,0,0,0,0,0,55.76
臺北縣,中和市,吉興里,1469,3,567,10,577,981,0,0,0,0,0,0,58.82
臺北縣,中和市,復興里,1470,3,977,9,986,1570,0,0,0,0,0,0,62.80
臺北縣,中和市,復興里,1471,3,747,9,756,1309,0,0,0,0,0,0,57.75
臺北縣,中和市,復興里,1472,3,929,11,940,1533,0,0,0,0,0,0,61.32
臺北縣,中和市,和興里,1473,3,691,11,702,1089,0,0,0,0,0,0,64.46
臺北縣,中和市,和興里,1474,3,934,15,949,1647,0,0,0,0,0,0,57.62
臺北縣,中和市,景平里,1475,3,948,11,959,1682,0,0,0,0,0,0,57.02
臺北縣,中和市,景平里,1476,3,1036,11,1047,1808,0,0,0,0,0,0,57.91
臺北縣,中和市,景新里,1477,3,985,9,994,1563,0,0,0,0,0,0,63.60
臺北縣,中和市,景新里,1478,3,806,6,812,1343,0,0,0,0,0,0,60.46
臺北縣,中和市,景福里,1479,3,845,13,858,1572,0,0,0,0,0,0,54.58
臺北縣,中和市,景福里,1480,3,699,7,706,1132,0,0,0,0,0,0,62.37
臺北縣,中和市,景福里,1481,3,750,16,766,1388,0,0,0,0,0,0,55.19
臺北縣,中和市,景安里,1482,3,387,5,392,600,0,0,0,0,0,0,65.33
臺北縣,中和市,景安里,1483,3,796,11,807,1271,0,0,0,0,0,0,63.49
臺北縣,中和市,景安里,1484,3,781,10,791,1261,0,0,0,0,0,0,62.73
臺北縣,中和市,景安里,1485,3,477,7,484,781,0,0,0,0,0,0,61.97
臺北縣,中和市,景文里,1486,3,749,12,761,1225,0,0,0,0,0,0,62.12
臺北縣,中和市,景文里,1487,3,706,11,717,1181,0,0,0,0,0,0,60.71
臺北縣,中和市,錦和里,1488,3,700,10,710,1174,0,0,0,0,0,0,60.48
臺北縣,中和市,錦和里,1489,3,584,5,589,985,0,0,0,0,0,0,59.80
臺北縣,中和市,錦中里,1490,3,888,13,901,1553,0,0,0,0,0,0,58.02
臺北縣,中和市,錦中里,1491,3,663,4,667,1090,0,0,0,0,0,0,61.19
臺北縣,中和市,錦昌里,1492,3,842,8,850,1407,0,0,0,0,0,0,60.41
臺北縣,中和市,錦盛里,1493,3,767,10,777,1338,0,0,0,0,0,0,58.07
臺北縣,中和市,錦盛里,1494,3,745,12,757,1296,0,0,0,0,0,0,58.41
臺北縣,中和市,灰窯里,1495,3,300,1,301,483,0,0,0,0,0,0,62.32
臺北縣,中和市,積穗里,1496,3,975,11,986,1731,0,0,0,0,0,0,56.96
臺北縣,中和市,積穗里,1497,3,338,3,341,539,0,0,0,0,0,0,63.27
臺北縣,中和市,積穗里,1498,3,927,9,936,1565,0,0,0,0,0,0,59.81
臺北縣,中和市,民享里,1499,3,675,7,682,1005,0,0,0,0,0,0,67.86
臺北縣,中和市,民享里,1500,3,693,9,702,1021,0,0,0,0,0,0,68.76
臺北縣,中和市,民有里,1501,3,858,11,869,1397,0,0,0,0,0,0,62.20
臺北縣,中和市,民有里,1502,3,678,11,689,1155,0,0,0,0,0,0,59.65
臺北縣,中和市,員山里,1503,3,749,8,757,1225,0,0,0,0,0,0,61.80
臺北縣,中和市,員山里,1504,3,1056,16,1072,1984,0,0,0,0,0,0,54.03
臺北縣,中和市,員富里,1505,3,238,4,242,514,0,0,0,0,0,0,47.08
臺北縣,中和市,員富里,1506,3,681,20,701,1307,0,0,0,0,0,0,53.63
臺北縣,中和市,嘉穗里,1507,3,730,11,741,1177,0,0,0,0,0,0,62.96
臺北縣,中和市,嘉穗里,1508,3,527,6,533,972,0,0,0,0,0,0,54.84
臺北縣,中和市,嘉慶里,1509,3,691,9,700,1345,0,0,0,0,0,0,52.04
臺北縣,中和市,嘉慶里,1510,3,758,9,767,1526,0,0,0,0,0,0,50.26
臺北縣,中和市,文元里,1511,3,648,8,656,1221,0,0,0,0,0,0,53.73
臺北縣,中和市,文元里,1512,3,795,11,806,1478,0,0,0,0,0,0,54.53
臺北縣,中和市,文元里,1513,3,896,11,907,1567,0,0,0,0,0,0,57.88
臺北縣,中和市,嘉新里,1514,3,769,10,779,1425,0,0,0,0,0,0,54.67
臺北縣,中和市,嘉新里,1515,3,779,17,796,1413,0,0,0,0,0,0,56.33
臺北縣,中和市,民安里,1516,3,753,12,765,1263,0,0,0,0,0,0,60.57
臺北縣,中和市,民安里,1517,3,630,7,637,1141,0,0,0,0,0,0,55.83
臺北縣,中和市,民安里,1518,3,635,9,644,1136,0,0,0,0,0,0,56.69
臺北縣,中和市,安穗里,1519,3,804,11,815,1403,0,0,0,0,0,0,58.09
臺北縣,中和市,安穗里,1520,3,767,9,776,1411,0,0,0,0,0,0,55.00
臺北縣,中和市,瑞穗里,1521,3,558,6,564,935,0,0,0,0,0,0,60.32
臺北縣,中和市,瑞穗里,1522,3,534,4,538,862,0,0,0,0,0,0,62.41
臺北縣,中和市,冠穗里,1523,3,893,7,900,1499,0,0,0,0,0,0,60.04
臺北縣,中和市,冠穗里,1524,3,729,6,735,1213,0,0,0,0,0,0,60.59
臺北縣,中和市,明穗里,1525,3,868,11,879,1478,0,0,0,0,0,0,59.47
臺北縣,中和市,明穗里,1526,3,860,14,874,1555,0,0,0,0,0,0,56.21
臺北縣,中和市,清穗里,1527,3,731,19,750,1263,0,0,0,0,0,0,59.38
臺北縣,中和市,清穗里,1528,3,683,21,704,1225,0,0,0,0,0,0,57.47
臺北縣,中和市,自強里,1529,3,577,9,586,1057,0,0,0,0,0,0,55.44
臺北縣,中和市,自強里,1530,3,640,8,648,1069,0,0,0,0,0,0,60.62
臺北縣,中和市,自強里,1531,3,706,13,719,1342,0,0,0,0,0,0,53.58
臺北縣,中和市,德穗里,1532,3,791,9,800,1337,0,0,0,0,0,0,59.84
臺北縣,中和市,德穗里,1533,3,651,11,662,1161,0,0,0,0,0,0,57.02
臺北縣,中和市,德穗里,1534,3,765,13,778,1249,0,0,0,0,0,0,62.29
臺北縣,中和市,民生里,1535,3,788,13,801,1311,0,0,0,0,0,0,61.10
臺北縣,中和市,民生里,1536,3,856,10,866,1486,0,0,0,0,0,0,58.28
臺北縣,中和市,國光里,1537,3,603,3,606,1082,0,0,0,0,0,0,56.01
臺北縣,中和市,國光里,1538,3,1018,7,1025,1797,0,0,0,0,0,0,57.04
臺北縣,中和市,國華里,1539,3,547,11,558,965,0,0,0,0,0,0,57.82
臺北縣,中和市,國華里,1540,3,708,8,716,1404,0,0,0,0,0,0,51.00
臺北縣,中和市,壽德里,1541,3,1007,11,1018,1638,0,0,0,0,0,0,62.15
臺北縣,中和市,明德里,1542,3,912,12,924,1670,0,0,0,0,0,0,55.33
臺北縣,中和市,明德里,1543,3,843,8,851,1419,0,0,0,0,0,0,59.97
臺北縣,永和市,光復里,1544,3,912,19,931,1546,0,0,0,0,0,0,60.22
臺北縣,永和市,網溪里,1545,3,554,11,565,1045,0,0,0,0,0,0,54.07
臺北縣,永和市,復興里,1546,3,494,7,501,893,0,0,0,0,0,0,56.10
臺北縣,永和市,復興里,1547,3,623,7,630,1117,0,0,0,0,0,0,56.40
臺北縣,永和市,竹林里,1548,3,937,13,950,1706,0,0,0,0,0,0,55.69
臺北縣,永和市,竹林里,1549,3,923,15,938,1667,0,0,0,0,0,0,56.27
臺北縣,永和市,桂林里,1550,3,1004,11,1015,1652,0,0,0,0,0,0,61.44
臺北縣,永和市,桂林里,1551,3,700,9,709,1360,0,0,0,0,0,0,52.13
臺北縣,永和市,上林里,1552,3,912,10,922,1608,0,0,0,0,0,0,57.34
臺北縣,永和市,上林里,1553,3,950,7,957,1619,0,0,0,0,0,0,59.11
臺北縣,永和市,福林里,1554,3,929,5,934,1604,0,0,0,0,0,0,58.23
臺北縣,永和市,福林里,1555,3,897,7,904,1560,0,0,0,0,0,0,57.95
臺北縣,永和市,勵行里,1556,3,689,12,701,1226,0,0,0,0,0,0,57.18
臺北縣,永和市,中興里,1557,3,656,6,662,1208,0,0,0,0,0,0,54.80
臺北縣,永和市,中興里,1558,3,821,6,827,1485,0,0,0,0,0,0,55.69
臺北縣,永和市,永興里,1559,3,874,15,889,1568,0,0,0,0,0,0,56.70
臺北縣,永和市,永興里,1560,3,823,5,828,1561,0,0,0,0,0,0,53.04
臺北縣,永和市,正興里,1561,3,620,7,627,1121,0,0,0,0,0,0,55.93
臺北縣,永和市,正興里,1562,3,518,6,524,927,0,0,0,0,0,0,56.53
臺北縣,永和市,豫溪里,1563,3,851,7,858,1483,0,0,0,0,0,0,57.86
臺北縣,永和市,豫溪里,1564,3,807,5,812,1435,0,0,0,0,0,0,56.59
臺北縣,永和市,光明里,1565,3,785,8,793,1264,0,0,0,0,0,0,62.74
臺北縣,永和市,光明里,1566,3,775,4,779,1336,0,0,0,0,0,0,58.31
臺北縣,永和市,福和里,1567,3,580,6,586,1079,0,0,0,0,0,0,54.31
臺北縣,永和市,福和里,1568,3,807,10,817,1497,0,0,0,0,0,0,54.58
臺北縣,永和市,福和里,1569,3,648,6,654,1094,0,0,0,0,0,0,59.78
臺北縣,永和市,得和里,1570,3,796,5,801,1280,0,0,0,0,0,0,62.58
臺北縣,永和市,得和里,1571,3,673,3,676,1142,0,0,0,0,0,0,59.19
臺北縣,永和市,得和里,1572,3,656,7,663,1068,0,0,0,0,0,0,62.08
臺北縣,永和市,永貞里,1573,3,878,12,890,1560,0,0,0,0,0,0,57.05
臺北縣,永和市,永貞里,1574,3,870,10,880,1477,0,0,0,0,0,0,59.58
臺北縣,永和市,永福里,1575,3,756,7,763,1242,0,0,0,0,0,0,61.43
臺北縣,永和市,永福里,1576,3,731,9,740,1214,0,0,0,0,0,0,60.96
臺北縣,永和市,河濱里,1577,3,755,7,762,1267,0,0,0,0,0,0,60.14
臺北縣,永和市,河濱里,1578,3,721,11,732,1208,0,0,0,0,0,0,60.60
臺北縣,永和市,秀和里,1579,3,1060,17,1077,1670,0,0,0,0,0,0,64.49
臺北縣,永和市,秀和里,1580,3,921,4,925,1684,0,0,0,0,0,0,54.93
臺北縣,永和市,永元里,1581,3,663,5,668,1222,0,0,0,0,0,0,54.66
臺北縣,永和市,永元里,1582,3,723,8,731,1202,0,0,0,0,0,0,60.82
臺北縣,永和市,永元里,1583,3,840,6,846,1377,0,0,0,0,0,0,61.44
臺北縣,永和市,民權里,1584,3,779,9,788,1256,0,0,0,0,0,0,62.74
臺北縣,永和市,民權里,1585,3,735,9,744,1271,0,0,0,0,0,0,58.54
臺北縣,永和市,民權里,1586,3,637,6,643,1029,0,0,0,0,0,0,62.49
臺北縣,永和市,民族里,1587,3,697,7,704,1191,0,0,0,0,0,0,59.11
臺北縣,永和市,民族里,1588,3,724,3,727,1150,0,0,0,0,0,0,63.22
臺北縣,永和市,民族里,1589,3,756,5,761,1150,0,0,0,0,0,0,66.17
臺北縣,永和市,秀朗里,1590,3,861,11,872,1449,0,0,0,0,0,0,60.18
臺北縣,永和市,秀朗里,1591,3,992,13,1005,1758,0,0,0,0,0,0,57.17
臺北縣,永和市,秀成里,1592,3,602,7,609,969,0,0,0,0,0,0,62.85
臺北縣,永和市,秀成里,1593,3,787,11,798,1282,0,0,0,0,0,0,62.25
臺北縣,永和市,秀林里,1594,3,941,6,947,1499,0,0,0,0,0,0,63.18
臺北縣,永和市,秀林里,1595,3,777,3,780,1272,0,0,0,0,0,0,61.32
臺北縣,永和市,秀得里,1596,3,506,3,509,854,0,0,0,0,0,0,59.60
臺北縣,永和市,秀得里,1597,3,637,7,644,1105,0,0,0,0,0,0,58.28
臺北縣,永和市,秀元里,1598,3,834,10,844,1371,0,0,0,0,0,0,61.56
臺北縣,永和市,秀元里,1599,3,718,9,727,1256,0,0,0,0,0,0,57.88
臺北縣,永和市,民生里,1600,3,638,9,647,1124,0,0,0,0,0,0,57.56
臺北縣,永和市,民生里,1601,3,756,12,768,1264,0,0,0,0,0,0,60.76
臺北縣,永和市,民生里,1602,3,612,3,615,1014,0,0,0,0,0,0,60.65
臺北縣,永和市,民本里,1603,3,690,7,697,1127,0,0,0,0,0,0,61.85
臺北縣,永和市,民本里,1604,3,699,10,709,1167,0,0,0,0,0,0,60.75
臺北縣,永和市,民富里,1605,3,792,8,800,1370,0,0,0,0,0,0,58.39
臺北縣,永和市,民富里,1606,3,557,10,567,914,0,0,0,0,0,0,62.04
臺北縣,永和市,民樂里,1607,3,899,15,914,1512,0,0,0,0,0,0,60.45
臺北縣,永和市,民樂里,1608,3,1005,13,1018,1690,0,0,0,0,0,0,60.24
臺北縣,永和市,民治里,1609,3,750,9,759,1312,0,0,0,0,0,0,57.85
臺北縣,永和市,民治里,1610,3,693,4,697,1237,0,0,0,0,0,0,56.35
臺北縣,永和市,智光里,1611,3,890,7,897,1529,0,0,0,0,0,0,58.67
臺北縣,永和市,智光里,1612,3,958,12,970,1531,0,0,0,0,0,0,63.36
臺北縣,永和市,潭安里,1613,3,726,6,732,1269,0,0,0,0,0,0,57.68
臺北縣,永和市,潭安里,1614,3,639,8,647,1117,0,0,0,0,0,0,57.92
臺北縣,永和市,潭安里,1615,3,588,8,596,1078,0,0,0,0,0,0,55.29
臺北縣,永和市,潭墘里,1616,3,586,4,590,1033,0,0,0,0,0,0,57.12
臺北縣,永和市,潭墘里,1617,3,687,4,691,1122,0,0,0,0,0,0,61.59
臺北縣,永和市,潭墘里,1618,3,656,9,665,1182,0,0,0,0,0,0,56.26
臺北縣,永和市,店街里,1619,3,839,9,848,1425,0,0,0,0,0,0,59.51
臺北縣,永和市,店街里,1620,3,864,12,876,1631,0,0,0,0,0,0,53.71
臺北縣,永和市,大新里,1621,3,514,11,525,861,0,0,0,0,0,0,60.98
臺北縣,永和市,大新里,1622,3,566,7,573,965,0,0,0,0,0,0,59.38
臺北縣,永和市,永安里,1623,3,864,7,871,1482,0,0,0,0,0,0,58.77
臺北縣,永和市,永安里,1624,3,907,12,919,1592,0,0,0,0,0,0,57.73
臺北縣,永和市,永樂里,1625,3,570,4,574,976,0,0,0,0,0,0,58.81
臺北縣,永和市,永樂里,1626,3,528,3,531,958,0,0,0,0,0,0,55.43
臺北縣,永和市,水源里,1627,3,1026,14,1040,1675,0,0,0,0,0,0,62.09
臺北縣,永和市,水源里,1628,3,953,12,965,1583,0,0,0,0,0,0,60.96
臺北縣,永和市,協和里,1629,3,737,12,749,1321,0,0,0,0,0,0,56.70
臺北縣,永和市,協和里,1630,3,798,5,803,1292,0,0,0,0,0,0,62.15
臺北縣,永和市,雙和里,1631,3,975,13,988,1631,0,0,0,0,0,0,60.58
臺北縣,永和市,雙和里,1632,3,800,10,810,1325,0,0,0,0,0,0,61.13
臺北縣,永和市,安和里,1633,3,820,11,831,1382,0,0,0,0,0,0,60.13
臺北縣,永和市,安和里,1634,3,936,16,952,1510,0,0,0,0,0,0,63.05
臺北縣,永和市,前溪里,1635,3,983,12,995,1675,0,0,0,0,0,0,59.40
臺北縣,永和市,和平里,1636,3,896,10,906,1564,0,0,0,0,0,0,57.93
臺北縣,永和市,和平里,1637,3,976,14,990,1696,0,0,0,0,0,0,58.37
臺北縣,永和市,保平里,1638,3,1091,8,1099,1773,0,0,0,0,0,0,61.99
臺北縣,永和市,保平里,1639,3,920,15,935,1414,0,0,0,0,0,0,66.12
臺北縣,永和市,中溪里,1640,3,656,5,661,1103,0,0,0,0,0,0,59.93
臺北縣,永和市,中溪里,1641,3,685,5,690,1166,0,0,0,0,0,0,59.18
臺北縣,永和市,中溪里,1642,3,742,12,754,1245,0,0,0,0,0,0,60.56
臺北縣,永和市,保安里,1643,3,942,11,953,1648,0,0,0,0,0,0,57.83
臺北縣,永和市,保安里,1644,3,618,2,620,1040,0,0,0,0,0,0,59.62
臺北縣,永和市,保安里,1645,3,649,13,662,1168,0,0,0,0,0,0,56.68
臺北縣,永和市,保順里,1646,3,549,7,556,1018,0,0,0,0,0,0,54.62
臺北縣,永和市,保順里,1647,3,930,9,939,1616,0,0,0,0,0,0,58.11
臺北縣,永和市,下溪里,1648,3,935,18,953,1542,0,0,0,0,0,0,61.80
臺北縣,永和市,下溪里,1649,3,749,10,759,1343,0,0,0,0,0,0,56.52
臺北縣,永和市,大同里,1650,3,701,15,716,1000,0,0,0,0,0,0,71.60
臺北縣,永和市,新生里,1651,3,520,19,539,825,0,0,0,0,0,0,65.33
臺北縣,永和市,永成里,1652,3,612,15,627,1006,0,0,0,0,0,0,62.33
臺北縣,永和市,忠義里,1653,3,472,13,485,732,0,0,0,0,0,0,66.26
臺北縣,永和市,文化里,1654,3,712,11,723,1137,0,0,0,0,0,0,63.59
臺北縣,永和市,文化里,1655,3,814,22,836,1354,0,0,0,0,0,0,61.74
臺北縣,永和市,仁愛里,1656,3,556,10,566,936,0,0,0,0,0,0,60.47
臺北縣,永和市,仁愛里,1657,3,598,6,604,1124,0,0,0,0,0,0,53.74
臺北縣,永和市,信義里,1658,3,551,6,557,988,0,0,0,0,0,0,56.38
臺北縣,永和市,信義里,1659,3,605,8,613,986,0,0,0,0,0,0,62.17
臺北縣,永和市,後溪里,1660,3,896,13,909,1522,0,0,0,0,0,0,59.72
臺北縣,永和市,上溪里,1661,3,469,4,473,817,0,0,0,0,0,0,57.89
臺北縣,永和市,上溪里,1662,3,638,4,642,1086,0,0,0,0,0,0,59.12
臺北縣,永和市,頂溪里,1663,3,588,10,598,1025,0,0,0,0,0,0,58.34
臺北縣,永和市,頂溪里,1664,3,610,9,619,1000,0,0,0,0,0,0,61.90
臺北縣,永和市,河堤里,1665,3,596,7,603,949,0,0,0,0,0,0,63.54
臺北縣,永和市,河堤里,1666,3,506,3,509,896,0,0,0,0,0,0,56.81
臺北縣,永和市,新部里,1667,3,584,5,589,994,0,0,0,0,0,0,59.26
臺北縣,永和市,新部里,1668,3,789,7,796,1214,0,0,0,0,0,0,65.57
臺北縣,新店市,新店里,1669,3,917,9,926,1440,0,0,0,0,0,0,64.31
臺北縣,新店市,張南里,1670,3,697,13,710,1146,0,0,0,0,0,0,61.95
臺北縣,新店市,國校里,1671,3,477,4,481,831,0,0,0,0,0,0,57.88
臺北縣,新店市,國校里,1672,3,673,8,681,1181,0,0,0,0,0,0,57.66
臺北縣,新店市,文中里,1673,3,763,16,779,1334,0,0,0,0,0,0,58.40
臺北縣,新店市,廣明里,1674,3,510,6,516,792,0,0,0,0,0,0,65.15
臺北縣,新店市,文明里,1675,3,704,12,716,1029,0,0,0,0,0,0,69.58
臺北縣,新店市,文明里,1676,3,673,6,679,1044,0,0,0,0,0,0,65.04
臺北縣,新店市,中興里,1677,3,788,10,798,1343,0,0,0,0,0,0,59.42
臺北縣,新店市,中興里,1678,3,636,3,639,1096,0,0,0,0,0,0,58.30
臺北縣,新店市,中興里,1679,3,707,9,716,1275,0,0,0,0,0,0,56.16
臺北縣,新店市,新生里,1680,3,719,7,726,1166,0,0,0,0,0,0,62.26
臺北縣,新店市,新生里,1681,3,847,11,858,1338,0,0,0,0,0,0,64.13
臺北縣,新店市,新生里,1682,3,775,10,785,1281,0,0,0,0,0,0,61.28
臺北縣,新店市,新德里,1683,3,749,7,756,1236,0,0,0,0,0,0,61.17
臺北縣,新店市,新德里,1684,3,695,12,707,1155,0,0,0,0,0,0,61.21
臺北縣,新店市,張北里,1685,3,764,9,773,1269,0,0,0,0,0,0,60.91
臺北縣,新店市,張北里,1686,3,705,5,710,1154,0,0,0,0,0,0,61.53
臺北縣,新店市,張北里,1687,3,792,7,799,1383,0,0,0,0,0,0,57.77
臺北縣,新店市,張北里,1688,3,769,11,780,1380,0,0,0,0,0,0,56.52
臺北縣,新店市,五峰里,1689,3,793,7,800,1343,0,0,0,0,0,0,59.57
臺北縣,新店市,五峰里,1690,3,729,10,739,1284,0,0,0,0,0,0,57.55
臺北縣,新店市,五峰里,1691,3,696,9,705,1211,0,0,0,0,0,0,58.22
臺北縣,新店市,五峰里,1692,3,846,8,854,1529,0,0,0,0,0,0,55.85
臺北縣,新店市,長春里,1693,3,974,6,980,1619,0,0,0,0,0,0,60.53
臺北縣,新店市,新安里,1694,3,622,4,626,1095,0,0,0,0,0,0,57.17
臺北縣,新店市,新安里,1695,3,603,6,609,998,0,0,0,0,0,0,61.02
臺北縣,新店市,新安里,1696,3,522,9,531,946,0,0,0,0,0,0,56.13
臺北縣,新店市,忠誠里,1697,3,659,9,668,1107,0,0,0,0,0,0,60.34
臺北縣,新店市,忠誠里,1698,3,637,14,651,1075,0,0,0,0,0,0,60.56
臺北縣,新店市,中正里,1699,3,792,7,799,1273,0,0,0,0,0,0,62.77
臺北縣,新店市,中正里,1700,3,690,9,699,1159,0,0,0,0,0,0,60.31
臺北縣,新店市,中正里,1701,3,892,11,903,1548,0,0,0,0,0,0,58.33
臺北縣,新店市,中正里,1702,3,787,10,797,1285,0,0,0,0,0,0,62.02
臺北縣,新店市,中華里,1703,3,657,10,667,1149,0,0,0,0,0,0,58.05
臺北縣,新店市,中華里,1704,3,725,7,732,1216,0,0,0,0,0,0,60.20
臺北縣,新店市,中華里,1705,3,615,2,617,1025,0,0,0,0,0,0,60.20
臺北縣,新店市,仁愛里,1706,3,702,8,710,1163,0,0,0,0,0,0,61.05
臺北縣,新店市,仁愛里,1707,3,660,5,665,1090,0,0,0,0,0,0,61.01
臺北縣,新店市,建國里,1708,3,707,6,713,1153,0,0,0,0,0,0,61.84
臺北縣,新店市,建國里,1709,3,879,6,885,1544,0,0,0,0,0,0,57.32
臺北縣,新店市,百忍里,1710,3,606,8,614,1025,0,0,0,0,0,0,59.90
臺北縣,新店市,百忍里,1711,3,728,4,732,1144,0,0,0,0,0,0,63.99
臺北縣,新店市,百忍里,1712,3,803,14,817,1406,0,0,0,0,0,0,58.11
臺北縣,新店市,百和里,1713,3,701,10,711,1222,0,0,0,0,0,0,58.18
臺北縣,新店市,百和里,1714,3,746,10,756,1294,0,0,0,0,0,0,58.42
臺北縣,新店市,福德里,1715,3,878,12,890,1376,0,0,0,0,0,0,64.68
臺北縣,新店市,福德里,1716,3,518,9,527,910,0,0,0,0,0,0,57.91
臺北縣,新店市,福德里,1717,3,592,3,595,1010,0,0,0,0,0,0,58.91
臺北縣,新店市,百福里,1718,3,743,4,747,1172,0,0,0,0,0,0,63.74
臺北縣,新店市,百福里,1719,3,772,9,781,1297,0,0,0,0,0,0,60.22
臺北縣,新店市,福民里,1720,3,887,7,894,1432,0,0,0,0,0,0,62.43
臺北縣,新店市,福民里,1721,3,897,12,909,1574,0,0,0,0,0,0,57.75
臺北縣,新店市,中山里,1722,3,310,6,316,508,0,0,0,0,0,0,62.20
臺北縣,新店市,中山里,1723,3,383,7,390,690,0,0,0,0,0,0,56.52
臺北縣,新店市,和平里,1724,3,570,11,581,869,0,0,0,0,0,0,66.86
臺北縣,新店市,中央里,1725,3,696,4,700,1186,0,0,0,0,0,0,59.02
臺北縣,新店市,中央里,1726,3,734,6,740,1232,0,0,0,0,0,0,60.06
臺北縣,新店市,國豐里,1727,3,662,12,674,1052,0,0,0,0,0,0,64.07
臺北縣,新店市,國豐里,1728,3,555,4,559,981,0,0,0,0,0,0,56.98
臺北縣,新店市,國豐里,1729,3,636,9,645,1067,0,0,0,0,0,0,60.45
臺北縣,新店市,明德里,1730,3,666,4,670,1147,0,0,0,0,0,0,58.41
臺北縣,新店市,明德里,1731,3,671,7,678,1127,0,0,0,0,0,0,60.16
臺北縣,新店市,明德里,1732,3,642,3,645,1083,0,0,0,0,0,0,59.56
臺北縣,新店市,大豐里,1733,3,934,8,942,1511,0,0,0,0,0,0,62.34
臺北縣,新店市,大豐里,1734,3,882,6,888,1431,0,0,0,0,0,0,62.05
臺北縣,新店市,大同里,1735,3,938,9,947,1525,0,0,0,0,0,0,62.10
臺北縣,新店市,大同里,1736,3,966,6,972,1552,0,0,0,0,0,0,62.63
臺北縣,新店市,江陵里,1737,3,588,6,594,1073,0,0,0,0,0,0,55.36
臺北縣,新店市,江陵里,1738,3,781,10,791,1240,0,0,0,0,0,0,63.79
臺北縣,新店市,江陵里,1739,3,654,8,662,1169,0,0,0,0,0,0,56.63
臺北縣,新店市,復興里,1740,3,618,7,625,1118,0,0,0,0,0,0,55.90
臺北縣,新店市,復興里,1741,3,697,17,714,1273,0,0,0,0,0,0,56.09
臺北縣,新店市,寶興里,1742,3,695,7,702,1121,0,0,0,0,0,0,62.62
臺北縣,新店市,寶興里,1743,3,709,7,716,1206,0,0,0,0,0,0,59.37
臺北縣,新店市,寶興里,1744,3,657,6,663,1135,0,0,0,0,0,0,58.41
臺北縣,新店市,寶福里,1745,3,598,11,609,1067,0,0,0,0,0,0,57.08
臺北縣,新店市,寶福里,1746,3,813,10,823,1423,0,0,0,0,0,0,57.84
臺北縣,新店市,寶福里,1747,3,749,11,760,1178,0,0,0,0,0,0,64.52
臺北縣,新店市,寶安里,1748,3,964,6,970,1695,0,0,0,0,0,0,57.23
臺北縣,新店市,寶安里,1749,3,902,8,910,1499,0,0,0,0,0,0,60.71
臺北縣,新店市,寶安里,1750,3,741,3,744,1241,0,0,0,0,0,0,59.95
臺北縣,新店市,信義里,1751,3,858,10,868,1494,0,0,0,0,0,0,58.10
臺北縣,新店市,信義里,1752,3,756,4,760,1288,0,0,0,0,0,0,59.01
臺北縣,新店市,信義里,1753,3,834,11,845,1460,0,0,0,0,0,0,57.88
臺北縣,新店市,忠孝里,1754,3,973,11,984,1663,0,0,0,0,0,0,59.17
臺北縣,新店市,忠孝里,1755,3,528,12,540,850,0,0,0,0,0,0,63.53
臺北縣,新店市,大鵬里,1756,3,202,6,208,339,0,0,0,0,0,0,61.36
臺北縣,新店市,太平里,1757,3,767,14,781,1236,0,0,0,0,0,0,63.19
臺北縣,新店市,太平里,1758,3,597,8,605,898,0,0,0,0,0,0,67.37
臺北縣,新店市,美城里,1759,3,539,9,548,848,0,0,0,0,0,0,64.62
臺北縣,新店市,美城里,1760,3,697,6,703,1190,0,0,0,0,0,0,59.08
臺北縣,新店市,頂城里,1761,3,822,13,835,1405,0,0,0,0,0,0,59.43
臺北縣,新店市,下城里,1762,3,1025,13,1038,1697,0,0,0,0,0,0,61.17
臺北縣,新店市,柴埕里,1763,3,891,5,896,1586,0,0,0,0,0,0,56.49
臺北縣,新店市,柴埕里,1764,3,923,11,934,1574,0,0,0,0,0,0,59.34
臺北縣,新店市,柴埕里,1765,3,842,12,854,1540,0,0,0,0,0,0,55.45
臺北縣,新店市,安和里,1766,3,794,14,808,1285,0,0,0,0,0,0,62.88
臺北縣,新店市,安和里,1767,3,670,9,679,1204,0,0,0,0,0,0,56.40
臺北縣,新店市,安和里,1768,3,705,9,714,1240,0,0,0,0,0,0,57.58
臺北縣,新店市,永安里,1769,3,734,8,742,1307,0,0,0,0,0,0,56.77
臺北縣,新店市,永安里,1770,3,659,7,666,1143,0,0,0,0,0,0,58.27
臺北縣,新店市,永安里,1771,3,730,4,734,1201,0,0,0,0,0,0,61.12
臺北縣,新店市,新和里,1772,3,819,5,824,1436,0,0,0,0,0,0,57.38
臺北縣,新店市,新和里,1773,3,859,8,867,1527,0,0,0,0,0,0,56.78
臺北縣,新店市,永平里,1774,3,994,18,1012,1684,0,0,0,0,0,0,60.10
臺北縣,新店市,永平里,1775,3,744,8,752,1322,0,0,0,0,0,0,56.88
臺北縣,新店市,公崙里,1776,3,756,10,766,1353,0,0,0,0,0,0,56.61
臺北縣,新店市,公崙里,1777,3,816,16,832,1400,0,0,0,0,0,0,59.43
臺北縣,新店市,公崙里,1778,3,704,6,710,1248,0,0,0,0,0,0,56.89
臺北縣,新店市,公崙里,1779,3,761,9,770,1306,0,0,0,0,0,0,58.96
臺北縣,新店市,安昌里,1780,3,705,4,709,1200,0,0,0,0,0,0,59.08
臺北縣,新店市,安昌里,1781,3,694,2,696,1185,0,0,0,0,0,0,58.73
臺北縣,新店市,德安里,1782,3,807,10,817,1344,0,0,0,0,0,0,60.79
臺北縣,新店市,德安里,1783,3,450,6,456,698,0,0,0,0,0,0,65.33
臺北縣,新店市,德安里,1784,3,245,5,250,349,0,0,0,0,0,0,71.63
臺北縣,新店市,德安里,1785,3,810,4,814,1513,0,0,0,0,0,0,53.80
臺北縣,新店市,德安里,1786,3,758,13,771,1240,0,0,0,0,0,0,62.18
臺北縣,新店市,明城里,1787,3,752,0,752,1196,0,0,0,0,0,0,62.88
臺北縣,新店市,明城里,1788,3,567,4,571,972,0,0,0,0,0,0,58.74
臺北縣,新店市,小城里,1789,3,666,5,671,1077,0,0,0,0,0,0,62.30
臺北縣,新店市,小城里,1790,3,976,14,990,1615,0,0,0,0,0,0,61.30
臺北縣,新店市,雙城里,1791,3,555,6,561,929,0,0,0,0,0,0,60.39
臺北縣,新店市,雙城里,1792,3,542,1,543,815,0,0,0,0,0,0,66.63
臺北縣,新店市,雙城里,1793,3,716,4,720,1278,0,0,0,0,0,0,56.34
臺北縣,新店市,雙城里,1794,3,883,7,890,1499,0,0,0,0,0,0,59.37
臺北縣,新店市,香坡里,1795,3,419,1,420,782,0,0,0,0,0,0,53.71
臺北縣,新店市,香坡里,1796,3,636,7,643,1263,0,0,0,0,0,0,50.91
臺北縣,新店市,香坡里,1797,3,599,9,608,1222,0,0,0,0,0,0,49.75
臺北縣,新店市,日興里,1798,3,873,12,885,1520,0,0,0,0,0,0,58.22
臺北縣,新店市,日興里,1799,3,663,5,668,1224,0,0,0,0,0,0,54.58
臺北縣,新店市,日興里,1800,3,762,7,769,1272,0,0,0,0,0,0,60.46
臺北縣,新店市,玫瑰里,1801,3,827,9,836,1347,0,0,0,0,0,0,62.06
臺北縣,新店市,玫瑰里,1802,3,759,12,771,1223,0,0,0,0,0,0,63.04
臺北縣,新店市,玫瑰里,1803,3,759,4,763,1233,0,0,0,0,0,0,61.88
臺北縣,新店市,吉祥里,1804,3,943,7,950,1677,0,0,0,0,0,0,56.65
臺北縣,新店市,吉祥里,1805,3,848,8,856,1490,0,0,0,0,0,0,57.45
臺北縣,新店市,塗潭里,1806,3,399,4,403,667,0,0,0,0,0,0,60.42
臺北縣,新店市,塗潭里,1807,3,334,1,335,646,0,0,0,0,0,0,51.86
臺北縣,新店市,青潭里,1808,3,945,10,955,1644,0,0,0,0,0,0,58.09
臺北縣,新店市,青潭里,1809,3,642,7,649,1151,0,0,0,0,0,0,56.39
臺北縣,新店市,美潭里,1810,3,843,13,856,1388,0,0,0,0,0,0,61.67
臺北縣,新店市,美潭里,1811,3,661,13,674,1123,0,0,0,0,0,0,60.02
臺北縣,新店市,美潭里,1812,3,583,2,585,919,0,0,0,0,0,0,63.66
臺北縣,新店市,員潭里,1813,3,739,6,745,1208,0,0,0,0,0,0,61.67
臺北縣,新店市,員潭里,1814,3,757,23,780,1246,0,0,0,0,0,0,62.60
臺北縣,新店市,雙坑里,1815,3,417,4,421,828,0,0,0,0,0,0,50.85
臺北縣,新店市,粗坑里,1816,3,227,3,230,361,0,0,0,0,0,0,63.71
臺北縣,新店市,粗坑里,1817,3,908,11,919,1729,0,0,0,0,0,0,53.15
臺北縣,新店市,屈尺里,1818,3,569,7,576,930,0,0,0,0,0,0,61.94
臺北縣,新店市,屈尺里,1819,3,763,16,779,1217,0,0,0,0,0,0,64.01
臺北縣,新店市,龜山里,1820,3,807,13,820,1353,0,0,0,0,0,0,60.61
臺北縣,新店市,廣興里,1821,3,624,12,636,1046,0,0,0,0,0,0,60.80
臺北縣,新店市,直潭里,1822,3,281,2,283,430,0,0,0,0,0,0,65.81
臺北縣,新店市,直潭里,1823,3,146,0,146,267,0,0,0,0,0,0,54.68
臺北縣,深坑鄉,萬順村,1824,3,866,14,880,1651,0,0,0,0,0,0,53.30
臺北縣,深坑鄉,萬福村,1825,3,553,10,563,946,0,0,0,0,0,0,59.51
臺北縣,深坑鄉,萬福村,1826,3,444,9,453,789,0,0,0,0,0,0,57.41
臺北縣,深坑鄉,土庫村,1827,3,542,10,552,880,0,0,0,0,0,0,62.73
臺北縣,深坑鄉,土庫村,1828,3,485,5,490,813,0,0,0,0,0,0,60.27
臺北縣,深坑鄉,賴仲村,1829,3,636,10,646,1180,0,0,0,0,0,0,54.75
臺北縣,深坑鄉,深坑村,1830,3,685,11,696,1116,0,0,0,0,0,0,62.37
臺北縣,深坑鄉,深坑村,1831,3,597,8,605,1098,0,0,0,0,0,0,55.10
臺北縣,深坑鄉,埔新村,1832,3,947,11,958,1660,0,0,0,0,0,0,57.71
臺北縣,深坑鄉,埔新村,1833,3,872,7,879,1594,0,0,0,0,0,0,55.14
臺北縣,深坑鄉,昇高村,1834,3,803,15,818,1376,0,0,0,0,0,0,59.45
臺北縣,深坑鄉,阿柔村,1835,3,304,4,308,446,0,0,0,0,0,0,69.06
臺北縣,石碇鄉,石碇村,1836,3,293,1,294,389,0,0,0,0,0,0,75.58
臺北縣,石碇鄉,潭邊村,1837,3,381,4,385,656,0,0,0,0,0,0,58.69
臺北縣,石碇鄉,烏塗村,1838,3,371,10,381,614,0,0,0,0,0,0,62.05
臺北縣,石碇鄉,彭山村,1839,3,173,2,175,259,0,0,0,0,0,0,67.57
臺北縣,石碇鄉,豐田村,1840,3,178,1,179,293,0,0,0,0,0,0,61.09
臺北縣,石碇鄉,豐田村,1841,3,89,0,89,139,0,0,0,0,0,0,64.03
臺北縣,石碇鄉,隆盛村,1842,3,448,8,456,730,0,0,0,0,0,0,62.47
臺北縣,石碇鄉,豐林村,1843,3,178,1,179,246,0,0,0,0,0,0,72.76
臺北縣,石碇鄉,中民村,1844,3,569,8,577,776,0,0,0,0,0,0,74.36
臺北縣,石碇鄉,永定村,1845,3,380,7,387,571,0,0,0,0,0,0,67.78
臺北縣,石碇鄉,光明村,1846,3,144,2,146,225,0,0,0,0,0,0,64.89
臺北縣,石碇鄉,永安村,1847,3,250,1,251,429,0,0,0,0,0,0,58.51
臺北縣,石碇鄉,格頭村,1848,3,413,5,418,604,0,0,0,0,0,0,69.21
臺北縣,坪林鄉,坪林村,1849,3,655,7,662,979,0,0,0,0,0,0,67.62
臺北縣,坪林鄉,水德村,1850,3,331,5,336,534,0,0,0,0,0,0,62.92
臺北縣,坪林鄉,大林村,1851,3,491,4,495,935,0,0,0,0,0,0,52.94
臺北縣,坪林鄉,石曹村,1852,3,238,2,240,374,0,0,0,0,0,0,64.17
臺北縣,坪林鄉,上德村,1853,3,186,3,189,318,0,0,0,0,0,0,59.43
臺北縣,坪林鄉,上德村,1854,3,242,4,246,375,0,0,0,0,0,0,65.60
臺北縣,坪林鄉,漁光村,1855,3,179,2,181,318,0,0,0,0,0,0,56.92
臺北縣,坪林鄉,漁光村,1856,3,168,5,173,356,0,0,0,0,0,0,48.60
臺北縣,坪林鄉,粗窟村,1857,3,315,6,321,492,0,0,0,0,0,0,65.24
臺北縣,坪林鄉,粗窟村,1858,3,105,1,106,204,0,0,0,0,0,0,51.96
臺北縣,烏來鄉,忠治村,1859,3,253,0,253,407,0,0,0,0,0,0,62.16
臺北縣,烏來鄉,烏來村,1860,3,539,6,545,898,0,0,0,0,0,0,60.69
臺北縣,烏來鄉,孝義村,1861,3,63,0,63,93,0,0,0,0,0,0,67.74
臺北縣,烏來鄉,信賢村,1862,3,89,2,91,152,0,0,0,0,0,0,59.87
臺北縣,烏來鄉,福山村,1863,3,27,0,27,60,0,0,0,0,0,0,45.00
臺北縣,汐止鎮,仁德里,1864,3,912,7,919,1448,0,0,0,0,0,0,63.47
臺北縣,汐止鎮,義民里,1865,3,708,7,715,1237,0,0,0,0,0,0,57.80
臺北縣,汐止鎮,禮門里,1866,3,562,5,567,985,0,0,0,0,0,0,57.56
臺北縣,汐止鎮,智慧里,1867,3,636,5,641,1265,0,0,0,0,0,0,50.67
臺北縣,汐止鎮,智慧里,1868,3,756,5,761,1411,0,0,0,0,0,0,53.93
臺北縣,汐止鎮,大同里,1869,3,462,4,466,781,0,0,0,0,0,0,59.67
臺北縣,汐止鎮,大同里,1870,3,471,8,479,868,0,0,0,0,0,0,55.18
臺北縣,汐止鎮,信望里,1871,3,297,2,299,527,0,0,0,0,0,0,56.74
臺北縣,汐止鎮,新昌里,1872,3,794,13,807,1329,0,0,0,0,0,0,60.72
臺北縣,汐止鎮,新昌里,1873,3,786,7,793,1380,0,0,0,0,0,0,57.46
臺北縣,汐止鎮,新昌里,1874,3,692,12,704,1237,0,0,0,0,0,0,56.91
臺北縣,汐止鎮,福安里,1875,3,804,15,819,1396,0,0,0,0,0,0,58.67
臺北縣,汐止鎮,秀峰里,1876,3,516,6,522,870,0,0,0,0,0,0,60.00
臺北縣,汐止鎮,秀峰里,1877,3,542,5,547,945,0,0,0,0,0,0,57.88
臺北縣,汐止鎮,秀峰里,1878,3,575,10,585,968,0,0,0,0,0,0,60.43
臺北縣,汐止鎮,秀山里,1879,3,592,5,597,1005,0,0,0,0,0,0,59.40
臺北縣,汐止鎮,秀山里,1880,3,641,4,645,1131,0,0,0,0,0,0,57.03
臺北縣,汐止鎮,復興里,1881,3,987,7,994,1819,0,0,0,0,0,0,54.65
臺北縣,汐止鎮,復興里,1882,3,695,5,700,1227,0,0,0,0,0,0,57.05
臺北縣,汐止鎮,自強里,1883,3,884,14,898,1484,0,0,0,0,0,0,60.51
臺北縣,汐止鎮,自強里,1884,3,834,14,848,1392,0,0,0,0,0,0,60.92
臺北縣,汐止鎮,文化里,1885,3,699,11,710,1269,0,0,0,0,0,0,55.95
臺北縣,汐止鎮,文化里,1886,3,722,11,733,1209,0,0,0,0,0,0,60.63
臺北縣,汐止鎮,白雲里,1887,3,594,4,598,1056,0,0,0,0,0,0,56.63
臺北縣,汐止鎮,白雲里,1888,3,602,9,611,977,0,0,0,0,0,0,62.54
臺北縣,汐止鎮,茄苳里,1889,3,754,11,765,1301,0,0,0,0,0,0,58.80
臺北縣,汐止鎮,茄苳里,1890,3,748,12,760,1374,0,0,0,0,0,0,55.31
臺北縣,汐止鎮,崇德里,1891,3,747,5,752,1294,0,0,0,0,0,0,58.11
臺北縣,汐止鎮,崇德里,1892,3,628,12,640,1210,0,0,0,0,0,0,52.89
臺北縣,汐止鎮,橋東里,1893,3,936,9,945,1747,0,0,0,0,0,0,54.09
臺北縣,汐止鎮,橋東里,1894,3,693,9,702,1335,0,0,0,0,0,0,52.58
臺北縣,汐止鎮,橋東里,1895,3,782,8,790,1458,0,0,0,0,0,0,54.18
臺北縣,汐止鎮,長安里,1896,3,813,7,820,1447,0,0,0,0,0,0,56.67
臺北縣,汐止鎮,保安里,1897,3,789,5,794,1250,0,0,0,0,0,0,63.52
臺北縣,汐止鎮,東山里,1898,3,267,3,270,454,0,0,0,0,0,0,59.47
臺北縣,汐止鎮,保長里,1899,3,647,7,654,1109,0,0,0,0,0,0,58.97
臺北縣,汐止鎮,保長里,1900,3,571,6,577,932,0,0,0,0,0,0,61.91
臺北縣,汐止鎮,保長里,1901,3,354,5,359,573,0,0,0,0,0,0,62.65
臺北縣,汐止鎮,鄉長里,1902,3,1059,17,1076,1656,0,0,0,0,0,0,64.98
臺北縣,汐止鎮,江北里,1903,3,843,9,852,1409,0,0,0,0,0,0,60.47
臺北縣,汐止鎮,江北里,1904,3,620,10,630,1034,0,0,0,0,0,0,60.93
臺北縣,汐止鎮,江北里,1905,3,617,2,619,1107,0,0,0,0,0,0,55.92
臺北縣,汐止鎮,拱北里,1906,3,603,5,608,1191,0,0,0,0,0,0,51.05
臺北縣,汐止鎮,拱北里,1907,3,665,6,671,1466,0,0,0,0,0,0,45.77
臺北縣,汐止鎮,拱北里,1908,3,540,9,549,995,0,0,0,0,0,0,55.18
臺北縣,汐止鎮,烘內里,1909,3,639,6,645,1161,0,0,0,0,0,0,55.56
臺北縣,汐止鎮,八連里,1910,3,499,7,506,808,0,0,0,0,0,0,62.62
臺北縣,汐止鎮,長青里,1911,3,552,5,557,917,0,0,0,0,0,0,60.74
臺北縣,汐止鎮,北峰里,1912,3,792,7,799,1383,0,0,0,0,0,0,57.77
臺北縣,汐止鎮,北峰里,1913,3,807,4,811,1449,0,0,0,0,0,0,55.97
臺北縣,汐止鎮,金龍里,1914,3,628,3,631,1247,0,0,0,0,0,0,50.60
臺北縣,汐止鎮,金龍里,1915,3,700,6,706,1405,0,0,0,0,0,0,50.25
臺北縣,汐止鎮,樟樹里,1916,3,892,8,900,1521,0,0,0,0,0,0,59.17
臺北縣,汐止鎮,忠孝里,1917,3,690,5,695,1249,0,0,0,0,0,0,55.64
臺北縣,汐止鎮,忠孝里,1918,3,592,9,601,1019,0,0,0,0,0,0,58.98
臺北縣,汐止鎮,忠孝里,1919,3,674,7,681,1341,0,0,0,0,0,0,50.78
臺北縣,汐止鎮,厚德里,1920,3,662,10,672,1212,0,0,0,0,0,0,55.45
臺北縣,汐止鎮,厚德里,1921,3,593,7,600,1122,0,0,0,0,0,0,53.48
臺北縣,汐止鎮,山光里,1922,3,425,3,428,905,0,0,0,0,0,0,47.29
臺北縣,汐止鎮,中興里,1923,3,660,5,665,1347,0,0,0,0,0,0,49.37
臺北縣,汐止鎮,中興里,1924,3,721,3,724,1381,0,0,0,0,0,0,52.43
臺北縣,汐止鎮,中興里,1925,3,669,8,677,1281,0,0,0,0,0,0,52.85
臺北縣,汐止鎮,福德里,1926,3,474,3,477,960,0,0,0,0,0,0,49.69
臺北縣,汐止鎮,福德里,1927,3,467,7,474,1015,0,0,0,0,0,0,46.70
臺北縣,汐止鎮,興福里,1928,3,456,4,460,936,0,0,0,0,0,0,49.15
臺北縣,汐止鎮,興福里,1929,3,428,1,429,965,0,0,0,0,0,0,44.46
臺北縣,汐止鎮,康福里,1930,3,549,9,558,1106,0,0,0,0,0,0,50.45
臺北縣,汐止鎮,湖光里,1931,3,542,5,547,1159,0,0,0,0,0,0,47.20
臺北縣,汐止鎮,湖光里,1932,3,484,4,488,949,0,0,0,0,0,0,51.42
臺北縣,汐止鎮,湖興里,1933,3,672,4,676,1284,0,0,0,0,0,0,52.65
臺北縣,汐止鎮,湖興里,1934,3,853,4,857,1555,0,0,0,0,0,0,55.11
臺北縣,汐止鎮,北山里,1935,3,507,2,509,902,0,0,0,0,0,0,56.43
臺北縣,汐止鎮,北山里,1936,3,490,4,494,1033,0,0,0,0,0,0,47.82
臺北縣,汐止鎮,北山里,1937,3,983,12,995,1690,0,0,0,0,0,0,58.88
臺北縣,汐止鎮,忠山里,1938,3,654,8,662,1149,0,0,0,0,0,0,57.62
臺北縣,汐止鎮,忠山里,1939,3,613,2,615,1110,0,0,0,0,0,0,55.41
臺北縣,汐止鎮,環河里,1940,3,592,4,596,929,0,0,0,0,0,0,64.16
臺北縣,汐止鎮,橫科里,1941,3,835,8,843,1380,0,0,0,0,0,0,61.09
臺北縣,汐止鎮,橫科里,1942,3,742,8,750,1244,0,0,0,0,0,0,60.29
臺北縣,汐止鎮,橫科里,1943,3,795,15,810,1324,0,0,0,0,0,0,61.18
臺北縣,汐止鎮,福山里,1944,3,695,7,702,1146,0,0,0,0,0,0,61.26
臺北縣,汐止鎮,福山里,1945,3,691,3,694,1221,0,0,0,0,0,0,56.84
臺北縣,汐止鎮,宜興里,1946,3,699,6,705,1196,0,0,0,0,0,0,58.95
臺北縣,汐止鎮,宜興里,1947,3,644,10,654,1014,0,0,0,0,0,0,64.50
臺北縣,汐止鎮,東勢里,1948,3,968,12,980,1760,0,0,0,0,0,0,55.68
臺北縣,瑞芳鎮,龍潭里,1949,3,499,3,502,810,0,0,0,0,0,0,61.98
臺北縣,瑞芳鎮,龍興里,1950,3,485,5,490,821,0,0,0,0,0,0,59.68
臺北縣,瑞芳鎮,龍興里,1951,3,516,0,516,798,0,0,0,0,0,0,64.66
臺北縣,瑞芳鎮,龍鎮里,1952,3,842,17,859,1389,0,0,0,0,0,0,61.84
臺北縣,瑞芳鎮,龍安里,1953,3,363,9,372,607,0,0,0,0,0,0,61.29
臺北縣,瑞芳鎮,龍川里,1954,3,485,4,489,798,0,0,0,0,0,0,61.28
臺北縣,瑞芳鎮,龍川里,1955,3,472,5,477,786,0,0,0,0,0,0,60.69
臺北縣,瑞芳鎮,龍山里,1956,3,756,21,777,1327,0,0,0,0,0,0,58.55
臺北縣,瑞芳鎮,爪峰里,1957,3,866,9,875,1413,0,0,0,0,0,0,61.92
臺北縣,瑞芳鎮,爪峰里,1958,3,670,5,675,1207,0,0,0,0,0,0,55.92
臺北縣,瑞芳鎮,爪峰里,1959,3,623,6,629,1114,0,0,0,0,0,0,56.46
臺北縣,瑞芳鎮,新峰里,1960,3,634,9,643,1028,0,0,0,0,0,0,62.55
臺北縣,瑞芳鎮,新峰里,1961,3,602,7,609,984,0,0,0,0,0,0,61.89
臺北縣,瑞芳鎮,東和里,1962,3,761,15,776,1207,0,0,0,0,0,0,64.29
臺北縣,瑞芳鎮,東和里,1963,3,444,7,451,816,0,0,0,0,0,0,55.27
臺北縣,瑞芳鎮,柑坪里,1964,3,786,13,799,1207,0,0,0,0,0,0,66.20
臺北縣,瑞芳鎮,弓橋里,1965,3,171,1,172,329,0,0,0,0,0,0,52.28
臺北縣,瑞芳鎮,侯硐里,1966,3,375,5,380,555,0,0,0,0,0,0,68.47
臺北縣,瑞芳鎮,光復里,1967,3,225,2,227,397,0,0,0,0,0,0,57.18
臺北縣,瑞芳鎮,碩仁里,1968,3,123,0,123,181,0,0,0,0,0,0,67.96
臺北縣,瑞芳鎮,吉慶里,1969,3,548,17,565,893,0,0,0,0,0,0,63.27
臺北縣,瑞芳鎮,吉慶里,1970,3,410,6,416,816,0,0,0,0,0,0,50.98
臺北縣,瑞芳鎮,吉安里,1971,3,582,13,595,1000,0,0,0,0,0,0,59.50
臺北縣,瑞芳鎮,吉安里,1972,3,403,13,416,837,0,0,0,0,0,0,49.70
臺北縣,瑞芳鎮,吉安里,1973,3,606,19,625,1088,0,0,0,0,0,0,57.44
臺北縣,瑞芳鎮,上天里,1974,3,403,8,411,668,0,0,0,0,0,0,61.53
臺北縣,瑞芳鎮,上天里,1975,3,346,5,351,640,0,0,0,0,0,0,54.84
臺北縣,瑞芳鎮,傑魚里,1976,3,524,5,529,1024,0,0,0,0,0,0,51.66
臺北縣,瑞芳鎮,傑魚里,1977,3,507,13,520,872,0,0,0,0,0,0,59.63
臺北縣,瑞芳鎮,基山里,1978,3,379,4,383,611,0,0,0,0,0,0,62.68
臺北縣,瑞芳鎮,永慶里,1979,3,364,3,367,638,0,0,0,0,0,0,57.52
臺北縣,瑞芳鎮,崇文里,1980,3,252,6,258,488,0,0,0,0,0,0,52.87
臺北縣,瑞芳鎮,福住里,1981,3,152,2,154,296,0,0,0,0,0,0,52.03
臺北縣,瑞芳鎮,頌德里,1982,3,249,4,253,468,0,0,0,0,0,0,54.06
臺北縣,瑞芳鎮,瓜山里,1983,3,213,1,214,316,0,0,0,0,0,0,67.72
臺北縣,瑞芳鎮,銅山里,1984,3,195,2,197,311,0,0,0,0,0,0,63.34
臺北縣,瑞芳鎮,新山里,1985,3,287,4,291,455,0,0,0,0,0,0,63.96
臺北縣,瑞芳鎮,石山里,1986,3,262,4,266,474,0,0,0,0,0,0,56.12
臺北縣,瑞芳鎮,濂洞里,1987,3,454,8,462,672,0,0,0,0,0,0,68.75
臺北縣,瑞芳鎮,濂新里,1988,3,193,3,196,357,0,0,0,0,0,0,54.90
臺北縣,瑞芳鎮,南雅里,1989,3,135,0,135,207,0,0,0,0,0,0,65.22
臺北縣,瑞芳鎮,鼻頭里,1990,3,338,4,342,531,0,0,0,0,0,0,64.41
臺北縣,瑞芳鎮,海濱里,1991,3,566,11,577,897,0,0,0,0,0,0,64.33
臺北縣,瑞芳鎮,瑞濱里,1992,3,476,13,489,795,0,0,0,0,0,0,61.51
臺北縣,瑞芳鎮,瑞濱里,1993,3,539,5,544,816,0,0,0,0,0,0,66.67
臺北縣,瑞芳鎮,深澳里,1994,3,563,9,572,998,0,0,0,0,0,0,57.31
臺北縣,平溪鄉,薯榔村,1995,3,283,4,287,459,0,0,0,0,0,0,62.53
臺北縣,平溪鄉,菁桐村,1996,3,238,3,241,321,0,0,0,0,0,0,75.08
臺北縣,平溪鄉,白石村,1997,3,237,5,242,314,0,0,0,0,0,0,77.07
臺北縣,平溪鄉,石底村,1998,3,342,4,346,541,0,0,0,0,0,0,63.96
臺北縣,平溪鄉,平溪村,1999,3,189,2,191,286,0,0,0,0,0,0,66.78
臺北縣,平溪鄉,嶺腳村,2000,3,457,3,460,697,0,0,0,0,0,0,66.00
臺北縣,平溪鄉,東勢村,2001,3,231,0,231,378,0,0,0,0,0,0,61.11
臺北縣,平溪鄉,十分村,2002,3,647,3,650,1102,0,0,0,0,0,0,58.98
臺北縣,平溪鄉,望古村,2003,3,100,1,101,156,0,0,0,0,0,0,64.74
臺北縣,平溪鄉,南山村,2004,3,276,3,279,527,0,0,0,0,0,0,52.94
臺北縣,平溪鄉,新寮村,2005,3,108,5,113,164,0,0,0,0,0,0,68.90
臺北縣,平溪鄉,平湖村,2006,3,129,1,130,178,0,0,0,0,0,0,73.03
臺北縣,雙溪鄉,雙溪村,2007,3,396,2,398,600,0,0,0,0,0,0,66.33
臺北縣,雙溪鄉,新基村,2008,3,223,3,226,307,0,0,0,0,0,0,73.62
臺北縣,雙溪鄉,新基村,2009,3,458,2,460,657,0,0,0,0,0,0,70.02
臺北縣,雙溪鄉,三港村,2010,3,273,1,274,451,0,0,0,0,0,0,60.75
臺北縣,雙溪鄉,牡丹村,2011,3,700,7,707,1098,0,0,0,0,0,0,64.39
臺北縣,雙溪鄉,牡丹村,2012,3,548,8,556,784,0,0,0,0,0,0,70.92
臺北縣,雙溪鄉,三貂村,2013,3,207,0,207,312,0,0,0,0,0,0,66.35
臺北縣,雙溪鄉,平林村,2014,3,437,5,442,677,0,0,0,0,0,0,65.29
臺北縣,雙溪鄉,平林村,2015,3,169,4,173,297,0,0,0,0,0,0,58.25
臺北縣,雙溪鄉,上林村,2016,3,468,6,474,712,0,0,0,0,0,0,66.57
臺北縣,雙溪鄉,外柑村,2017,3,322,3,325,513,0,0,0,0,0,0,63.35
臺北縣,雙溪鄉,長源村,2018,3,276,2,278,403,0,0,0,0,0,0,68.98
臺北縣,雙溪鄉,共和村,2019,3,111,1,112,158,0,0,0,0,0,0,70.89
臺北縣,雙溪鄉,共和村,2020,3,240,2,242,354,0,0,0,0,0,0,68.36
臺北縣,雙溪鄉,魚行村,2021,3,226,3,229,318,0,0,0,0,0,0,72.01
臺北縣,雙溪鄉,魚行村,2022,3,239,0,239,333,0,0,0,0,0,0,71.77
臺北縣,雙溪鄉,泰平村,2023,3,173,0,173,278,0,0,0,0,0,0,62.23
臺北縣,雙溪鄉,泰平村,2024,3,90,0,90,135,0,0,0,0,0,0,66.67
臺北縣,貢寮鄉,貢寮村,2025,3,585,8,593,943,0,0,0,0,0,0,62.88
臺北縣,貢寮鄉,龍崗村,2026,3,249,2,251,434,0,0,0,0,0,0,57.83
臺北縣,貢寮鄉,吉林村,2027,3,266,7,273,422,0,0,0,0,0,0,64.69
臺北縣,貢寮鄉,雙玉村,2028,3,264,6,270,449,0,0,0,0,0,0,60.13
臺北縣,貢寮鄉,雙玉村,2029,3,223,2,225,350,0,0,0,0,0,0,64.29
臺北縣,貢寮鄉,福隆村,2030,3,540,5,545,897,0,0,0,0,0,0,60.76
臺北縣,貢寮鄉,福隆村,2031,3,357,3,360,617,0,0,0,0,0,0,58.35
臺北縣,貢寮鄉,福連村,2032,3,454,1,455,766,0,0,0,0,0,0,59.40
臺北縣,貢寮鄉,龍門村,2033,3,387,1,388,632,0,0,0,0,0,0,61.39
臺北縣,貢寮鄉,仁里村,2034,3,932,19,951,1524,0,0,0,0,0,0,62.40
臺北縣,貢寮鄉,真理村,2035,3,623,4,627,1052,0,0,0,0,0,0,59.60
臺北縣,貢寮鄉,真理村,2036,3,402,4,406,786,0,0,0,0,0,0,51.65
臺北縣,貢寮鄉,美豐村,2037,3,244,3,247,402,0,0,0,0,0,0,61.44
臺北縣,貢寮鄉,美豐村,2038,3,262,5,267,415,0,0,0,0,0,0,64.34
臺北縣,貢寮鄉,和美村,2039,3,256,4,260,453,0,0,0,0,0,0,57.40
臺北縣,貢寮鄉,和美村,2040,3,233,2,235,437,0,0,0,0,0,0,53.78
宜蘭縣,宜蘭市,南門里,1,1,437,4,441,726,0,0,0,0,0,0,60.74
宜蘭縣,宜蘭市,負郭里,2,1,715,8,723,1154,0,0,0,0,0,0,62.65
宜蘭縣,宜蘭市,負郭里,3,1,577,7,584,916,0,0,0,0,0,0,63.76
宜蘭縣,宜蘭市,民族里,4,1,677,7,684,1081,0,0,0,0,0,0,63.27
宜蘭縣,宜蘭市,民族里,5,1,707,9,716,1128,0,0,0,0,0,0,63.48
宜蘭縣,宜蘭市,建軍里,6,1,726,14,740,1250,0,0,0,0,0,0,59.20
宜蘭縣,宜蘭市,建軍里,7,1,610,7,617,1041,0,0,0,0,0,0,59.27
宜蘭縣,宜蘭市,復興里,8,1,617,9,626,962,0,0,0,0,0,0,65.07
宜蘭縣,宜蘭市,復興里,9,1,467,4,471,732,0,0,0,0,0,0,64.34
宜蘭縣,宜蘭市,復興里,10,1,619,6,625,1027,0,0,0,0,0,0,60.86
宜蘭縣,宜蘭市,思源里,11,1,1141,13,1154,1991,0,0,0,0,0,0,57.96
宜蘭縣,宜蘭市,思源里,12,1,782,6,788,1402,0,0,0,0,0,0,56.21
宜蘭縣,宜蘭市,文化里,13,1,725,7,732,1152,0,0,0,0,0,0,63.54
宜蘭縣,宜蘭市,文化里,14,1,739,6,745,1246,0,0,0,0,0,0,59.79
宜蘭縣,宜蘭市,神農里,15,1,452,3,455,743,0,0,0,0,0,0,61.24
宜蘭縣,宜蘭市,民生里,16,1,314,7,321,472,0,0,0,0,0,0,68.01
宜蘭縣,宜蘭市,昇平里,17,1,491,5,496,729,0,0,0,0,0,0,68.04
宜蘭縣,宜蘭市,大東里,18,1,321,5,326,569,0,0,0,0,0,0,57.29
宜蘭縣,宜蘭市,新興里,19,1,362,5,367,613,0,0,0,0,0,0,59.87
宜蘭縣,宜蘭市,和睦里,20,1,492,6,498,799,0,0,0,0,0,0,62.33
宜蘭縣,宜蘭市,和睦里,21,1,694,5,699,1204,0,0,0,0,0,0,58.06
宜蘭縣,宜蘭市,民權里,22,1,400,3,403,619,0,0,0,0,0,0,65.11
宜蘭縣,宜蘭市,民權里,23,1,443,7,450,741,0,0,0,0,0,0,60.73
宜蘭縣,宜蘭市,進士里,24,1,656,3,659,1035,0,0,0,0,0,0,63.67
宜蘭縣,宜蘭市,進士里,25,1,764,6,770,1277,0,0,0,0,0,0,60.30
宜蘭縣,宜蘭市,進士里,26,1,384,5,389,615,0,0,0,0,0,0,63.25
宜蘭縣,宜蘭市,進士里,27,1,744,11,755,1156,0,0,0,0,0,0,65.31
宜蘭縣,宜蘭市,南橋里,28,1,334,2,336,597,0,0,0,0,0,0,56.28
宜蘭縣,宜蘭市,建業里,29,1,715,4,719,1127,0,0,0,0,0,0,63.80
宜蘭縣,宜蘭市,南津里,30,1,444,5,449,757,0,0,0,0,0,0,59.31
宜蘭縣,宜蘭市,凱旋里,31,1,664,8,672,1140,0,0,0,0,0,0,58.95
宜蘭縣,宜蘭市,黎明里,32,1,677,5,682,1140,0,0,0,0,0,0,59.82
宜蘭縣,宜蘭市,東村里,33,1,609,3,612,968,0,0,0,0,0,0,63.22
宜蘭縣,宜蘭市,東村里,34,1,590,9,599,967,0,0,0,0,0,0,61.94
宜蘭縣,宜蘭市,東村里,35,1,693,7,700,1172,0,0,0,0,0,0,59.73
宜蘭縣,宜蘭市,延平里,36,1,647,7,654,1004,0,0,0,0,0,0,65.14
宜蘭縣,宜蘭市,延平里,37,1,740,10,750,1265,0,0,0,0,0,0,59.29
宜蘭縣,宜蘭市,延平里,38,1,599,8,607,1063,0,0,0,0,0,0,57.10
宜蘭縣,宜蘭市,七張里,39,1,686,6,692,1137,0,0,0,0,0,0,60.86
宜蘭縣,宜蘭市,慈安里,40,1,626,4,630,1188,0,0,0,0,0,0,53.03
宜蘭縣,宜蘭市,慈安里,41,1,756,8,764,1308,0,0,0,0,0,0,58.41
宜蘭縣,宜蘭市,慈安里,42,1,750,6,756,1372,0,0,0,0,0,0,55.10
宜蘭縣,宜蘭市,新民里,43,1,418,5,423,654,0,0,0,0,0,0,64.68
宜蘭縣,宜蘭市,東門里,44,1,361,3,364,582,0,0,0,0,0,0,62.54
宜蘭縣,宜蘭市,中正里,45,1,414,4,418,645,0,0,0,0,0,0,64.81
宜蘭縣,宜蘭市,小東里,46,1,768,8,776,1264,0,0,0,0,0,0,61.39
宜蘭縣,宜蘭市,菜園里,47,1,787,10,797,1336,0,0,0,0,0,0,59.66
宜蘭縣,宜蘭市,孝廉里,48,1,681,9,690,1070,0,0,0,0,0,0,64.49
宜蘭縣,宜蘭市,新生里,49,1,777,3,780,1270,0,0,0,0,0,0,61.42
宜蘭縣,宜蘭市,新生里,50,1,499,6,505,801,0,0,0,0,0,0,63.05
宜蘭縣,宜蘭市,茭白里,51,1,927,6,933,1671,0,0,0,0,0,0,55.83
宜蘭縣,宜蘭市,北津里,52,1,825,10,835,1308,0,0,0,0,0,0,63.84
宜蘭縣,宜蘭市,梅洲里,53,1,878,8,886,1336,0,0,0,0,0,0,66.32
宜蘭縣,宜蘭市,梅洲里,54,1,613,6,619,1015,0,0,0,0,0,0,60.99
宜蘭縣,宜蘭市,北門里,55,1,573,6,579,896,0,0,0,0,0,0,64.62
宜蘭縣,宜蘭市,慶和里,56,1,513,5,518,816,0,0,0,0,0,0,63.48
宜蘭縣,宜蘭市,鄂王里,57,1,498,2,500,812,0,0,0,0,0,0,61.58
宜蘭縣,宜蘭市,西門里,58,1,817,6,823,1241,0,0,0,0,0,0,66.32
宜蘭縣,宜蘭市,中山里,59,1,540,8,548,848,0,0,0,0,0,0,64.62
宜蘭縣,宜蘭市,大道里,60,1,777,8,785,1283,0,0,0,0,0,0,61.18
宜蘭縣,羅東鎮,開羅里,61,1,304,2,306,493,0,0,0,0,0,0,62.07
宜蘭縣,羅東鎮,開元里,62,1,366,0,366,539,0,0,0,0,0,0,67.90
宜蘭縣,羅東鎮,東明里,63,1,302,1,303,530,0,0,0,0,0,0,57.17
宜蘭縣,羅東鎮,大新里,64,1,633,4,637,1171,0,0,0,0,0,0,54.40
宜蘭縣,羅東鎮,東安里,65,1,468,7,475,792,0,0,0,0,0,0,59.97
宜蘭縣,羅東鎮,東安里,66,1,569,8,577,1066,0,0,0,0,0,0,54.13
宜蘭縣,羅東鎮,新群里,67,1,622,4,626,997,0,0,0,0,0,0,62.79
宜蘭縣,羅東鎮,新群里,68,1,502,6,508,883,0,0,0,0,0,0,57.53
宜蘭縣,羅東鎮,羅莊里,69,1,839,4,843,1605,0,0,0,0,0,0,52.52
宜蘭縣,羅東鎮,南昌里,70,1,634,6,640,1145,0,0,0,0,0,0,55.90
宜蘭縣,羅東鎮,南昌里,71,1,480,5,485,886,0,0,0,0,0,0,54.74
宜蘭縣,羅東鎮,南豪里,72,1,852,8,860,1355,0,0,0,0,0,0,63.47
宜蘭縣,羅東鎮,成功里,73,1,709,6,715,1202,0,0,0,0,0,0,59.48
宜蘭縣,羅東鎮,仁德里,74,1,520,1,521,838,0,0,0,0,0,0,62.17
宜蘭縣,羅東鎮,居仁里,75,1,405,5,410,685,0,0,0,0,0,0,59.85
宜蘭縣,羅東鎮,義和里,76,1,536,5,541,892,0,0,0,0,0,0,60.65
宜蘭縣,羅東鎮,羅東里,77,1,418,2,420,674,0,0,0,0,0,0,62.31
宜蘭縣,羅東鎮,浮崙里,78,1,445,3,448,741,0,0,0,0,0,0,60.46
宜蘭縣,羅東鎮,漢民里,79,1,618,7,625,1044,0,0,0,0,0,0,59.87
宜蘭縣,羅東鎮,漢民里,80,1,746,5,751,1345,0,0,0,0,0,0,55.84
宜蘭縣,羅東鎮,漢民里,81,1,598,7,605,1064,0,0,0,0,0,0,56.86
宜蘭縣,羅東鎮,西安里,82,1,487,2,489,890,0,0,0,0,0,0,54.94
宜蘭縣,羅東鎮,西安里,83,1,702,9,711,1236,0,0,0,0,0,0,57.52
宜蘭縣,羅東鎮,西安里,84,1,593,9,602,1013,0,0,0,0,0,0,59.43
宜蘭縣,羅東鎮,西安里,85,1,697,7,704,1223,0,0,0,0,0,0,57.56
宜蘭縣,羅東鎮,北成里,86,1,932,7,939,1573,0,0,0,0,0,0,59.69
宜蘭縣,羅東鎮,北成里,87,1,806,7,813,1366,0,0,0,0,0,0,59.52
宜蘭縣,羅東鎮,北成里,88,1,921,3,924,1584,0,0,0,0,0,0,58.33
宜蘭縣,羅東鎮,賢文里,89,1,721,6,727,1312,0,0,0,0,0,0,55.41
宜蘭縣,羅東鎮,賢文里,90,1,540,5,545,960,0,0,0,0,0,0,56.77
宜蘭縣,羅東鎮,賢文里,91,1,583,4,587,997,0,0,0,0,0,0,58.88
宜蘭縣,羅東鎮,公正里,92,1,535,6,541,934,0,0,0,0,0,0,57.92
宜蘭縣,羅東鎮,公正里,93,1,465,2,467,791,0,0,0,0,0,0,59.04
宜蘭縣,羅東鎮,集祥里,94,1,557,4,561,972,0,0,0,0,0,0,57.72
宜蘭縣,羅東鎮,信義里,95,1,787,12,799,1376,0,0,0,0,0,0,58.07
宜蘭縣,羅東鎮,信義里,96,1,739,5,744,1312,0,0,0,0,0,0,56.71
宜蘭縣,羅東鎮,樹林里,97,1,960,6,966,1588,0,0,0,0,0,0,60.83
宜蘭縣,羅東鎮,樹林里,98,1,811,5,816,1467,0,0,0,0,0,0,55.62
宜蘭縣,羅東鎮,竹林里,99,1,784,8,792,1289,0,0,0,0,0,0,61.44
宜蘭縣,羅東鎮,竹林里,100,1,680,7,687,1201,0,0,0,0,0,0,57.20
宜蘭縣,羅東鎮,仁愛里,101,1,668,8,676,1068,0,0,0,0,0,0,63.30
宜蘭縣,羅東鎮,仁愛里,102,1,635,5,640,1115,0,0,0,0,0,0,57.40
宜蘭縣,蘇澳鎮,龍德里,103,1,388,1,389,663,0,0,0,0,0,0,58.67
宜蘭縣,蘇澳鎮,龍德里,104,1,577,7,584,1120,0,0,0,0,0,0,52.14
宜蘭縣,蘇澳鎮,龍德里,105,1,629,3,632,1111,0,0,0,0,0,0,56.89
宜蘭縣,蘇澳鎮,頂寮里,106,1,448,3,451,718,0,0,0,0,0,0,62.81
宜蘭縣,蘇澳鎮,永榮里,107,1,898,6,904,1537,0,0,0,0,0,0,58.82
宜蘭縣,蘇澳鎮,永榮里,108,1,734,5,739,1241,0,0,0,0,0,0,59.55
宜蘭縣,蘇澳鎮,存仁里,109,1,415,1,416,649,0,0,0,0,0,0,64.10
宜蘭縣,蘇澳鎮,存仁里,110,1,286,3,289,419,0,0,0,0,0,0,68.97
宜蘭縣,蘇澳鎮,港邊里,111,1,450,7,457,824,0,0,0,0,0,0,55.46
宜蘭縣,蘇澳鎮,港邊里,112,1,280,1,281,454,0,0,0,0,0,0,61.89
宜蘭縣,蘇澳鎮,岳明里,113,1,135,5,140,342,0,0,0,0,0,0,40.94
宜蘭縣,蘇澳鎮,隘丁里,114,1,578,10,588,996,0,0,0,0,0,0,59.04
宜蘭縣,蘇澳鎮,隘丁里,115,1,550,5,555,999,0,0,0,0,0,0,55.56
宜蘭縣,蘇澳鎮,新城里,116,1,631,6,637,1070,0,0,0,0,0,0,59.53
宜蘭縣,蘇澳鎮,聖湖里,117,1,673,4,677,1277,0,0,0,0,0,0,53.01
宜蘭縣,蘇澳鎮,聖湖里,118,1,653,5,658,1175,0,0,0,0,0,0,56.00
宜蘭縣,蘇澳鎮,聖湖里,119,1,538,3,541,981,0,0,0,0,0,0,55.15
宜蘭縣,蘇澳鎮,聖湖里,120,1,653,5,658,1187,0,0,0,0,0,0,55.43
宜蘭縣,蘇澳鎮,蘇西里,121,1,606,5,611,1107,0,0,0,0,0,0,55.19
宜蘭縣,蘇澳鎮,蘇西里,122,1,643,3,646,1118,0,0,0,0,0,0,57.78
宜蘭縣,蘇澳鎮,蘇北里,123,1,713,9,722,1237,0,0,0,0,0,0,58.37
宜蘭縣,蘇澳鎮,蘇南里,124,1,347,4,351,601,0,0,0,0,0,0,58.40
宜蘭縣,蘇澳鎮,蘇東里,125,1,311,4,315,576,0,0,0,0,0,0,54.69
宜蘭縣,蘇澳鎮,長安里,126,1,347,3,350,621,0,0,0,0,0,0,56.36
宜蘭縣,蘇澳鎮,永光里,127,1,376,5,381,584,0,0,0,0,0,0,65.24
宜蘭縣,蘇澳鎮,永春里,128,1,360,5,365,668,0,0,0,0,0,0,54.64
宜蘭縣,蘇澳鎮,永樂里,129,1,342,2,344,545,0,0,0,0,0,0,63.12
宜蘭縣,蘇澳鎮,南安里,130,1,651,8,659,1141,0,0,0,0,0,0,57.76
宜蘭縣,蘇澳鎮,南正里,131,1,629,4,633,1115,0,0,0,0,0,0,56.77
宜蘭縣,蘇澳鎮,南成里,132,1,701,6,707,1260,0,0,0,0,0,0,56.11
宜蘭縣,蘇澳鎮,南興里,133,1,481,1,482,896,0,0,0,0,0,0,53.79
宜蘭縣,蘇澳鎮,南興里,134,1,386,6,392,811,0,0,0,0,0,0,48.34
宜蘭縣,蘇澳鎮,南寧里,135,1,650,7,657,1176,0,0,0,0,0,0,55.87
宜蘭縣,蘇澳鎮,南建里,136,1,674,8,682,1324,0,0,0,0,0,0,51.51
宜蘭縣,蘇澳鎮,東澳里,137,1,192,3,195,350,0,0,0,0,0,0,55.71
宜蘭縣,蘇澳鎮,南強里,138,1,435,13,448,836,0,0,0,0,0,0,53.59
宜蘭縣,蘇澳鎮,朝陽里,139,1,267,9,276,511,0,0,0,0,0,0,54.01
宜蘭縣,蘇澳鎮,朝陽里,140,1,165,5,170,274,0,0,0,0,0,0,62.04
宜蘭縣,頭城鎮,石城里,141,1,208,2,210,393,0,0,0,0,0,0,53.44
宜蘭縣,頭城鎮,大里里,142,1,294,1,295,694,0,0,0,0,0,0,42.51
宜蘭縣,頭城鎮,大溪里,143,1,658,9,667,1495,0,0,0,0,0,0,44.62
宜蘭縣,頭城鎮,合興里,144,1,207,6,213,392,0,0,0,0,0,0,54.34
宜蘭縣,頭城鎮,更新里,145,1,740,12,752,1350,0,0,0,0,0,0,55.70
宜蘭縣,頭城鎮,外澳里,146,1,476,3,479,829,0,0,0,0,0,0,57.78
宜蘭縣,頭城鎮,港口里,147,1,378,11,389,628,0,0,0,0,0,0,61.94
宜蘭縣,頭城鎮,武營里,148,1,863,12,875,1345,0,0,0,0,0,0,65.06
宜蘭縣,頭城鎮,大坑里,149,1,699,7,706,1091,0,0,0,0,0,0,64.71
宜蘭縣,頭城鎮,城東里,150,1,518,2,520,741,0,0,0,0,0,0,70.18
宜蘭縣,頭城鎮,城北里,151,1,358,4,362,590,0,0,0,0,0,0,61.36
宜蘭縣,頭城鎮,城西里,152,1,460,3,463,664,0,0,0,0,0,0,69.73
宜蘭縣,頭城鎮,城南里,153,1,408,2,410,596,0,0,0,0,0,0,68.79
宜蘭縣,頭城鎮,竹安里,154,1,518,4,522,927,0,0,0,0,0,0,56.31
宜蘭縣,頭城鎮,竹安里,155,1,586,5,591,978,0,0,0,0,0,0,60.43
宜蘭縣,頭城鎮,新建里,156,1,1086,8,1094,1754,0,0,0,0,0,0,62.37
宜蘭縣,頭城鎮,拔雅里,157,1,788,5,793,1291,0,0,0,0,0,0,61.43
宜蘭縣,頭城鎮,福成里,158,1,591,6,597,974,0,0,0,0,0,0,61.29
宜蘭縣,頭城鎮,金面里,159,1,977,6,983,1569,0,0,0,0,0,0,62.65
宜蘭縣,頭城鎮,金盈里,160,1,390,3,393,694,0,0,0,0,0,0,56.63
宜蘭縣,頭城鎮,頂埔里,161,1,863,10,873,1303,0,0,0,0,0,0,67.00
宜蘭縣,頭城鎮,下埔里,162,1,585,2,587,915,0,0,0,0,0,0,64.15
宜蘭縣,頭城鎮,中崙里,163,1,615,12,627,949,0,0,0,0,0,0,66.07
宜蘭縣,頭城鎮,二城里,164,1,648,10,658,1053,0,0,0,0,0,0,62.49
宜蘭縣,礁溪鄉,白雲村,165,1,815,6,821,1412,0,0,0,0,0,0,58.14
宜蘭縣,礁溪鄉,玉石村,166,1,1017,15,1032,1607,0,0,0,0,0,0,64.22
宜蘭縣,礁溪鄉,德陽村,167,1,1040,13,1053,1720,0,0,0,0,0,0,61.22
宜蘭縣,礁溪鄉,德陽村,168,1,967,10,977,1649,0,0,0,0,0,0,59.25
宜蘭縣,礁溪鄉,大忠村,169,1,761,11,772,1207,0,0,0,0,0,0,63.96
宜蘭縣,礁溪鄉,大忠村,170,1,497,1,498,744,0,0,0,0,0,0,66.94
宜蘭縣,礁溪鄉,大義村,171,1,444,3,447,664,0,0,0,0,0,0,67.32
宜蘭縣,礁溪鄉,六結村,172,1,869,9,878,1341,0,0,0,0,0,0,65.47
宜蘭縣,礁溪鄉,二龍村,173,1,705,5,710,1114,0,0,0,0,0,0,63.73
宜蘭縣,礁溪鄉,時潮村,174,1,826,8,834,1331,0,0,0,0,0,0,62.66
宜蘭縣,礁溪鄉,玉田村,175,1,515,7,522,822,0,0,0,0,0,0,63.50
宜蘭縣,礁溪鄉,玉田村,176,1,576,5,581,970,0,0,0,0,0,0,59.90
宜蘭縣,礁溪鄉,三民村,177,1,877,6,883,1368,0,0,0,0,0,0,64.55
宜蘭縣,礁溪鄉,三民村,178,1,502,6,508,869,0,0,0,0,0,0,58.46
宜蘭縣,礁溪鄉,林美村,179,1,632,11,643,1048,0,0,0,0,0,0,61.35
宜蘭縣,礁溪鄉,白鵝村,180,1,409,5,414,655,0,0,0,0,0,0,63.21
宜蘭縣,礁溪鄉,玉光村,181,1,532,9,541,893,0,0,0,0,0,0,60.58
宜蘭縣,礁溪鄉,光武村,182,1,640,7,647,1068,0,0,0,0,0,0,60.58
宜蘭縣,礁溪鄉,吳沙村,183,1,673,6,679,1002,0,0,0,0,0,0,67.76
宜蘭縣,礁溪鄉,吳沙村,184,1,725,3,728,1131,0,0,0,0,0,0,64.37
宜蘭縣,礁溪鄉,龍潭村,185,1,790,11,801,1347,0,0,0,0,0,0,59.47
宜蘭縣,礁溪鄉,龍潭村,186,1,759,7,766,1283,0,0,0,0,0,0,59.70
宜蘭縣,礁溪鄉,匏崙村,187,1,545,7,552,889,0,0,0,0,0,0,62.09
宜蘭縣,礁溪鄉,二結村,188,1,231,4,235,406,0,0,0,0,0,0,57.88
宜蘭縣,壯圍鄉,吉祥村,189,1,779,7,786,1329,0,0,0,0,0,0,59.14
宜蘭縣,壯圍鄉,吉祥村,190,1,764,6,770,1256,0,0,0,0,0,0,61.31
宜蘭縣,壯圍鄉,美福村,191,1,480,6,486,802,0,0,0,0,0,0,60.60
宜蘭縣,壯圍鄉,美福村,192,1,462,4,466,771,0,0,0,0,0,0,60.44
宜蘭縣,壯圍鄉,新南村,193,1,560,4,564,852,0,0,0,0,0,0,66.20
宜蘭縣,壯圍鄉,東港村,194,1,527,3,530,948,0,0,0,0,0,0,55.91
宜蘭縣,壯圍鄉,復興村,195,1,427,4,431,752,0,0,0,0,0,0,57.31
宜蘭縣,壯圍鄉,復興村,196,1,462,5,467,783,0,0,0,0,0,0,59.64
宜蘭縣,壯圍鄉,過嶺村,197,1,471,4,475,801,0,0,0,0,0,0,59.30
宜蘭縣,壯圍鄉,過嶺村,198,1,420,5,425,680,0,0,0,0,0,0,62.50
宜蘭縣,壯圍鄉,永鎮村,199,1,472,5,477,811,0,0,0,0,0,0,58.82
宜蘭縣,壯圍鄉,忠孝村,200,1,465,2,467,749,0,0,0,0,0,0,62.35
宜蘭縣,壯圍鄉,忠孝村,201,1,729,7,736,1146,0,0,0,0,0,0,64.22
宜蘭縣,壯圍鄉,古亭村,202,1,754,6,760,1211,0,0,0,0,0,0,62.76
宜蘭縣,壯圍鄉,功勞村,203,1,605,4,609,986,0,0,0,0,0,0,61.76
宜蘭縣,壯圍鄉,美城村,204,1,688,5,693,1112,0,0,0,0,0,0,62.32
宜蘭縣,壯圍鄉,美城村,205,1,514,6,520,760,0,0,0,0,0,0,68.42
宜蘭縣,壯圍鄉,新社村,206,1,620,2,622,1045,0,0,0,0,0,0,59.52
宜蘭縣,壯圍鄉,大福村,207,1,462,6,468,769,0,0,0,0,0,0,60.86
宜蘭縣,壯圍鄉,大福村,208,1,477,1,478,763,0,0,0,0,0,0,62.65
宜蘭縣,員山鄉,員山村,209,1,781,7,788,1431,0,0,0,0,0,0,55.07
宜蘭縣,員山鄉,員山村,210,1,738,6,744,1267,0,0,0,0,0,0,58.72
宜蘭縣,員山鄉,員山村,211,1,748,6,754,1332,0,0,0,0,0,0,56.61
宜蘭縣,員山鄉,尚德村,212,1,444,1,445,842,0,0,0,0,0,0,52.85
宜蘭縣,員山鄉,尚德村,213,1,559,9,568,990,0,0,0,0,0,0,57.37
宜蘭縣,員山鄉,惠好村,214,1,712,15,727,1157,0,0,0,0,0,0,62.83
宜蘭縣,員山鄉,七賢村,215,1,530,5,535,914,0,0,0,0,0,0,58.53
宜蘭縣,員山鄉,深溝村,216,1,743,12,755,1357,0,0,0,0,0,0,55.64
宜蘭縣,員山鄉,蓁巷村,217,1,527,11,538,1084,0,0,0,0,0,0,49.63
宜蘭縣,員山鄉,內城村,218,1,568,7,575,979,0,0,0,0,0,0,58.73
宜蘭縣,員山鄉,內城村,219,1,306,8,314,517,0,0,0,0,0,0,60.74
宜蘭縣,員山鄉,中華村,220,1,220,4,224,475,0,0,0,0,0,0,47.16
宜蘭縣,員山鄉,中華村,221,1,149,3,152,285,0,0,0,0,0,0,53.33
宜蘭縣,員山鄉,永和村,222,1,854,10,864,1560,0,0,0,0,0,0,55.38
宜蘭縣,員山鄉,頭分村,223,1,604,12,616,1046,0,0,0,0,0,0,58.89
宜蘭縣,員山鄉,枕山村,224,1,948,11,959,1536,0,0,0,0,0,0,62.43
宜蘭縣,員山鄉,枕山村,225,1,295,3,298,530,0,0,0,0,0,0,56.23
宜蘭縣,員山鄉,同樂村,226,1,819,16,835,1328,0,0,0,0,0,0,62.88
宜蘭縣,員山鄉,同樂村,227,1,530,7,537,968,0,0,0,0,0,0,55.48
宜蘭縣,員山鄉,湖東村,228,1,446,7,453,878,0,0,0,0,0,0,51.59
宜蘭縣,員山鄉,逸仙村,229,1,463,6,469,837,0,0,0,0,0,0,56.03
宜蘭縣,員山鄉,湖北村,230,1,554,7,561,954,0,0,0,0,0,0,58.81
宜蘭縣,員山鄉,湖西村,231,1,836,6,842,1525,0,0,0,0,0,0,55.21
宜蘭縣,冬山鄉,武淵村,232,1,670,2,672,1088,0,0,0,0,0,0,61.76
宜蘭縣,冬山鄉,珍珠村,233,1,693,8,701,1165,0,0,0,0,0,0,60.17
宜蘭縣,冬山鄉,補城村,234,1,544,5,549,946,0,0,0,0,0,0,58.03
宜蘭縣,冬山鄉,三奇村,235,1,465,6,471,804,0,0,0,0,0,0,58.58
宜蘭縣,冬山鄉,大興村,236,1,614,4,618,924,0,0,0,0,0,0,66.88
宜蘭縣,冬山鄉,東城村,237,1,678,3,681,1162,0,0,0,0,0,0,58.61
宜蘭縣,冬山鄉,香和村,238,1,623,4,627,999,0,0,0,0,0,0,62.76
宜蘭縣,冬山鄉,香和村,239,1,483,2,485,831,0,0,0,0,0,0,58.36
宜蘭縣,冬山鄉,南興村,240,1,520,6,526,813,0,0,0,0,0,0,64.70
宜蘭縣,冬山鄉,南興村,241,1,526,4,530,917,0,0,0,0,0,0,57.80
宜蘭縣,冬山鄉,冬山村,242,1,541,2,543,843,0,0,0,0,0,0,64.41
宜蘭縣,冬山鄉,安平村,243,1,423,4,427,712,0,0,0,0,0,0,59.97
宜蘭縣,冬山鄉,太和村,244,1,802,2,804,1290,0,0,0,0,0,0,62.33
宜蘭縣,冬山鄉,八寶村,245,1,497,1,498,813,0,0,0,0,0,0,61.25
宜蘭縣,冬山鄉,丸山村,246,1,758,6,764,1242,0,0,0,0,0,0,61.51
宜蘭縣,冬山鄉,中山村,247,1,250,1,251,424,0,0,0,0,0,0,59.20
宜蘭縣,冬山鄉,順安村,248,1,645,6,651,1235,0,0,0,0,0,0,52.71
宜蘭縣,冬山鄉,順安村,249,1,752,4,756,1422,0,0,0,0,0,0,53.16
宜蘭縣,冬山鄉,順安村,250,1,737,5,742,1415,0,0,0,0,0,0,52.44
宜蘭縣,冬山鄉,永美村,251,1,514,4,518,917,0,0,0,0,0,0,56.49
宜蘭縣,冬山鄉,永美村,252,1,545,3,548,996,0,0,0,0,0,0,55.02
宜蘭縣,冬山鄉,群英村,253,1,641,6,647,1152,0,0,0,0,0,0,56.16
宜蘭縣,冬山鄉,群英村,254,1,577,11,588,1062,0,0,0,0,0,0,55.37
宜蘭縣,冬山鄉,群英村,255,1,737,5,742,1231,0,0,0,0,0,0,60.28
宜蘭縣,冬山鄉,群英村,256,1,586,5,591,963,0,0,0,0,0,0,61.37
宜蘭縣,冬山鄉,清溝村,257,1,730,11,741,1260,0,0,0,0,0,0,58.81
宜蘭縣,冬山鄉,清溝村,258,1,745,6,751,1276,0,0,0,0,0,0,58.86
宜蘭縣,冬山鄉,鹿埔村,259,1,525,7,532,978,0,0,0,0,0,0,54.40
宜蘭縣,冬山鄉,鹿埔村,260,1,653,10,663,1152,0,0,0,0,0,0,57.55
宜蘭縣,冬山鄉,得安村,261,1,541,12,553,1033,0,0,0,0,0,0,53.53
宜蘭縣,冬山鄉,廣興村,262,1,583,2,585,1054,0,0,0,0,0,0,55.50
宜蘭縣,冬山鄉,廣興村,263,1,616,6,622,1109,0,0,0,0,0,0,56.09
宜蘭縣,冬山鄉,廣安村,264,1,670,8,678,1169,0,0,0,0,0,0,58.00
宜蘭縣,冬山鄉,柯林村,265,1,541,4,545,936,0,0,0,0,0,0,58.23
宜蘭縣,冬山鄉,大進村,266,1,443,3,446,795,0,0,0,0,0,0,56.10
宜蘭縣,五結鄉,三興村,267,1,982,7,989,1573,0,0,0,0,0,0,62.87
宜蘭縣,五結鄉,二結村,268,1,859,8,867,1380,0,0,0,0,0,0,62.83
宜蘭縣,五結鄉,鎮安村,269,1,557,4,561,931,0,0,0,0,0,0,60.26
宜蘭縣,五結鄉,鎮安村,270,1,615,9,624,983,0,0,0,0,0,0,63.48
宜蘭縣,五結鄉,上四村,271,1,859,10,869,1425,0,0,0,0,0,0,60.98
宜蘭縣,五結鄉,中興村,272,1,602,5,607,973,0,0,0,0,0,0,62.38
宜蘭縣,五結鄉,四結村,273,1,555,3,558,921,0,0,0,0,0,0,60.59
宜蘭縣,五結鄉,四結村,274,1,677,5,682,1150,0,0,0,0,0,0,59.30
宜蘭縣,五結鄉,福興村,275,1,926,5,931,1472,0,0,0,0,0,0,63.25
宜蘭縣,五結鄉,五結村,276,1,864,2,866,1346,0,0,0,0,0,0,64.34
宜蘭縣,五結鄉,五結村,277,1,618,3,621,1115,0,0,0,0,0,0,55.70
宜蘭縣,五結鄉,大吉村,278,1,951,7,958,1528,0,0,0,0,0,0,62.70
宜蘭縣,五結鄉,大吉村,279,1,695,3,698,1127,0,0,0,0,0,0,61.93
宜蘭縣,五結鄉,協和村,280,1,830,7,837,1305,0,0,0,0,0,0,64.14
宜蘭縣,五結鄉,協和村,281,1,446,7,453,828,0,0,0,0,0,0,54.71
宜蘭縣,五結鄉,孝威村,282,1,792,7,799,1267,0,0,0,0,0,0,63.06
宜蘭縣,五結鄉,錦眾村,283,1,881,10,891,1452,0,0,0,0,0,0,61.36
宜蘭縣,五結鄉,利澤村,284,1,616,3,619,1019,0,0,0,0,0,0,60.75
宜蘭縣,五結鄉,利澤村,285,1,566,3,569,976,0,0,0,0,0,0,58.30
宜蘭縣,五結鄉,成興村,286,1,872,12,884,1595,0,0,0,0,0,0,55.42
宜蘭縣,五結鄉,成興村,287,1,371,3,374,710,0,0,0,0,0,0,52.68
宜蘭縣,五結鄉,季新村,288,1,728,8,736,1307,0,0,0,0,0,0,56.31
宜蘭縣,五結鄉,季新村,289,1,471,2,473,767,0,0,0,0,0,0,61.67
宜蘭縣,三星鄉,員山村,290,1,126,1,127,230,0,0,0,0,0,0,55.22
宜蘭縣,三星鄉,天山村,291,1,363,2,365,645,0,0,0,0,0,0,56.59
宜蘭縣,三星鄉,天福村,292,1,411,9,420,821,0,0,0,0,0,0,51.16
宜蘭縣,三星鄉,雙賢村,293,1,371,4,375,663,0,0,0,0,0,0,56.56
宜蘭縣,三星鄉,人和村,294,1,248,6,254,467,0,0,0,0,0,0,54.39
宜蘭縣,三星鄉,義德村,295,1,670,3,673,1108,0,0,0,0,0,0,60.74
宜蘭縣,三星鄉,集慶村,296,1,647,10,657,1109,0,0,0,0,0,0,59.24
宜蘭縣,三星鄉,月眉村,297,1,497,7,504,840,0,0,0,0,0,0,60.00
宜蘭縣,三星鄉,拱照村,298,1,549,6,555,1060,0,0,0,0,0,0,52.36
宜蘭縣,三星鄉,大隱村,299,1,825,10,835,1473,0,0,0,0,0,0,56.69
宜蘭縣,三星鄉,大隱村,300,1,835,13,848,1429,0,0,0,0,0,0,59.34
宜蘭縣,三星鄉,行健村,301,1,369,4,373,657,0,0,0,0,0,0,56.77
宜蘭縣,三星鄉,萬德村,302,1,284,8,292,535,0,0,0,0,0,0,54.58
宜蘭縣,三星鄉,貴林村,303,1,247,4,251,488,0,0,0,0,0,0,51.43
宜蘭縣,三星鄉,萬富村,304,1,378,2,380,647,0,0,0,0,0,0,58.73
宜蘭縣,三星鄉,大義村,305,1,663,5,668,1048,0,0,0,0,0,0,63.74
宜蘭縣,三星鄉,尚武村,306,1,477,2,479,794,0,0,0,0,0,0,60.33
宜蘭縣,三星鄉,大洲村,307,1,857,7,864,1247,0,0,0,0,0,0,69.29
宜蘭縣,三星鄉,尾塹村,308,1,682,5,687,1124,0,0,0,0,0,0,61.12
宜蘭縣,大同鄉,寒溪村,309,1,40,0,40,113,0,0,0,0,0,0,35.40
宜蘭縣,大同鄉,崙埤村,310,1,47,0,47,101,0,0,0,0,0,0,46.53
宜蘭縣,大同鄉,松羅村,311,1,122,0,122,241,0,0,0,0,0,0,50.62
宜蘭縣,大同鄉,復興村,312,1,128,1,129,238,0,0,0,0,0,0,54.20
宜蘭縣,大同鄉,英士村,313,1,38,0,38,84,0,0,0,0,0,0,45.24
宜蘭縣,大同鄉,樂水村,314,1,21,0,21,61,0,0,0,0,0,0,34.43
宜蘭縣,大同鄉,太平村,315,1,31,1,32,54,0,0,0,0,0,0,59.26
宜蘭縣,大同鄉,茂安村,316,1,10,0,10,16,0,0,0,0,0,0,62.50
宜蘭縣,大同鄉,四季村,317,1,11,0,11,54,0,0,0,0,0,0,20.37
宜蘭縣,大同鄉,南山村,318,1,42,0,42,76,0,0,0,0,0,0,55.26
宜蘭縣,南澳鄉,東岳村,319,1,41,0,41,83,0,0,0,0,0,0,49.40
宜蘭縣,南澳鄉,南澳村,320,1,137,1,138,251,0,0,0,0,0,0,54.98
宜蘭縣,南澳鄉,碧候村,321,1,40,0,40,92,0,0,0,0,0,0,43.48
宜蘭縣,南澳鄉,金岳村,322,1,27,0,27,66,0,0,0,0,0,0,40.91
宜蘭縣,南澳鄉,武塔村,323,1,52,0,52,128,0,0,0,0,0,0,40.63
宜蘭縣,南澳鄉,金洋村,324,1,11,2,13,31,0,0,0,0,0,0,41.94
宜蘭縣,南澳鄉,澳花村,325,1,56,1,57,162,0,0,0,0,0,0,35.19
桃園縣,桃園市,大林里,1,1,581,8,589,851,0,0,0,0,0,0,69.21
桃園縣,桃園市,大林里,2,1,1215,13,1228,1916,0,0,0,0,0,0,64.09
桃園縣,桃園市,大林里,3,1,925,9,934,1668,0,0,0,0,0,0,56.00
桃園縣,桃園市,雲林里,4,1,978,13,991,1669,0,0,0,0,0,0,59.38
桃園縣,桃園市,雲林里,5,1,888,14,902,1467,0,0,0,0,0,0,61.49
桃園縣,桃園市,大豐里,6,1,765,10,775,1228,0,0,0,0,0,0,63.11
桃園縣,桃園市,大豐里,7,1,759,10,769,1264,0,0,0,0,0,0,60.84
桃園縣,桃園市,大豐里,8,1,626,9,635,1078,0,0,0,0,0,0,58.91
桃園縣,桃園市,福林里,9,1,881,12,893,1244,0,0,0,0,0,0,71.78
桃園縣,桃園市,福林里,10,1,975,10,985,1583,0,0,0,0,0,0,62.22
桃園縣,桃園市,福林里,11,1,827,12,839,1317,0,0,0,0,0,0,63.71
桃園縣,桃園市,福安里,12,1,886,14,900,1471,0,0,0,0,0,0,61.18
桃園縣,桃園市,福安里,13,1,1005,12,1017,1542,0,0,0,0,0,0,65.95
桃園縣,桃園市,豐林里,14,1,876,14,890,1416,0,0,0,0,0,0,62.85
桃園縣,桃園市,豐林里,15,1,882,13,895,1411,0,0,0,0,0,0,63.43
桃園縣,桃園市,豐林里,16,1,1147,12,1159,1830,0,0,0,0,0,0,63.33
桃園縣,桃園市,建國里,17,1,891,15,906,1496,0,0,0,0,0,0,60.56
桃園縣,桃園市,建國里,18,1,776,14,790,1290,0,0,0,0,0,0,61.24
桃園縣,桃園市,建國里,19,1,678,7,685,1138,0,0,0,0,0,0,60.19
桃園縣,桃園市,東門里,20,1,678,8,686,1088,0,0,0,0,0,0,63.05
桃園縣,桃園市,東門里,21,1,700,10,710,1181,0,0,0,0,0,0,60.12
桃園縣,桃園市,東山里,22,1,776,5,781,1190,0,0,0,0,0,0,65.63
桃園縣,桃園市,東山里,23,1,364,2,366,657,0,0,0,0,0,0,55.71
桃園縣,桃園市,萬壽里,24,1,594,8,602,917,0,0,0,0,0,0,65.65
桃園縣,桃園市,武陵里,25,1,841,9,850,1472,0,0,0,0,0,0,57.74
桃園縣,桃園市,民生里,26,1,899,9,908,1369,0,0,0,0,0,0,66.33
桃園縣,桃園市,文化里,27,1,495,1,496,843,0,0,0,0,0,0,58.84
桃園縣,桃園市,文明里,28,1,913,5,918,1470,0,0,0,0,0,0,62.45
桃園縣,桃園市,文昌里,29,1,668,15,683,1022,0,0,0,0,0,0,66.83
桃園縣,桃園市,南門里,30,1,710,8,718,1112,0,0,0,0,0,0,64.57
桃園縣,桃園市,南門里,31,1,667,10,677,1195,0,0,0,0,0,0,56.65
桃園縣,桃園市,南門里,32,1,639,6,645,1054,0,0,0,0,0,0,61.20
桃園縣,桃園市,南門里,33,1,636,9,645,1029,0,0,0,0,0,0,62.68
桃園縣,桃園市,南華里,34,1,944,7,951,1400,0,0,0,0,0,0,67.93
桃園縣,桃園市,西門里,35,1,892,19,911,1426,0,0,0,0,0,0,63.88
桃園縣,桃園市,西湖里,36,1,731,10,741,1182,0,0,0,0,0,0,62.69
桃園縣,桃園市,長美里,37,1,634,7,641,947,0,0,0,0,0,0,67.69
桃園縣,桃園市,永興里,38,1,552,3,555,805,0,0,0,0,0,0,68.94
桃園縣,桃園市,永興里,39,1,646,7,653,1005,0,0,0,0,0,0,64.98
桃園縣,桃園市,中興里,40,1,949,11,960,1450,0,0,0,0,0,0,66.21
桃園縣,桃園市,中興里,41,1,870,7,877,1356,0,0,0,0,0,0,64.68
桃園縣,桃園市,中興里,42,1,925,6,931,1500,0,0,0,0,0,0,62.07
桃園縣,桃園市,光興里,43,1,873,6,879,1355,0,0,0,0,0,0,64.87
桃園縣,桃園市,光興里,44,1,920,10,930,1445,0,0,0,0,0,0,64.36
桃園縣,桃園市,光興里,45,1,847,9,856,1370,0,0,0,0,0,0,62.48
桃園縣,桃園市,中路里,46,1,739,8,747,1209,0,0,0,0,0,0,61.79
桃園縣,桃園市,中路里,47,1,813,12,825,1456,0,0,0,0,0,0,56.66
桃園縣,桃園市,中信里,48,1,794,6,800,1347,0,0,0,0,0,0,59.39
桃園縣,桃園市,中信里,49,1,471,5,476,824,0,0,0,0,0,0,57.77
桃園縣,桃園市,中信里,50,1,586,9,595,1008,0,0,0,0,0,0,59.03
桃園縣,桃園市,中山里,51,1,802,14,816,1271,0,0,0,0,0,0,64.20
桃園縣,桃園市,中山里,52,1,709,8,717,1381,0,0,0,0,0,0,51.92
桃園縣,桃園市,中山里,53,1,444,8,452,780,0,0,0,0,0,0,57.95
桃園縣,桃園市,中平里,54,1,839,8,847,1521,0,0,0,0,0,0,55.69
桃園縣,桃園市,中平里,55,1,821,8,829,1420,0,0,0,0,0,0,58.38
桃園縣,桃園市,中原里,56,1,869,6,875,1431,0,0,0,0,0,0,61.15
桃園縣,桃園市,中泰里,57,1,729,12,741,1296,0,0,0,0,0,0,57.18
桃園縣,桃園市,中泰里,58,1,813,11,824,1491,0,0,0,0,0,0,55.26
桃園縣,桃園市,中德里,59,1,853,16,869,1379,0,0,0,0,0,0,63.02
桃園縣,桃園市,中德里,60,1,669,13,682,1126,0,0,0,0,0,0,60.57
桃園縣,桃園市,中德里,61,1,887,10,897,1268,0,0,0,0,0,0,70.74
桃園縣,桃園市,中正里,62,1,712,9,721,1185,0,0,0,0,0,0,60.84
桃園縣,桃園市,中正里,63,1,705,15,720,1165,0,0,0,0,0,0,61.80
桃園縣,桃園市,中正里,64,1,824,9,833,1329,0,0,0,0,0,0,62.68
桃園縣,桃園市,文中里,65,1,780,8,788,1278,0,0,0,0,0,0,61.66
桃園縣,桃園市,文中里,66,1,774,18,792,1246,0,0,0,0,0,0,63.56
桃園縣,桃園市,中成里,67,1,581,10,591,838,0,0,0,0,0,0,70.53
桃園縣,桃園市,中成里,68,1,805,8,813,1266,0,0,0,0,0,0,64.22
桃園縣,桃園市,中成里,69,1,298,3,301,534,0,0,0,0,0,0,56.37
桃園縣,桃園市,玉山里,70,1,733,11,744,1185,0,0,0,0,0,0,62.78
桃園縣,桃園市,玉山里,71,1,881,18,899,1454,0,0,0,0,0,0,61.83
桃園縣,桃園市,玉山里,72,1,793,15,808,1397,0,0,0,0,0,0,57.84
桃園縣,桃園市,泰山里,73,1,780,17,797,1245,0,0,0,0,0,0,64.02
桃園縣,桃園市,泰山里,74,1,1000,16,1016,1552,0,0,0,0,0,0,65.46
桃園縣,桃園市,龍岡里,75,1,1047,19,1066,1433,0,0,0,0,0,0,74.39
桃園縣,桃園市,龍岡里,76,1,783,7,790,1397,0,0,0,0,0,0,56.55
桃園縣,桃園市,龍安里,77,1,907,6,913,1521,0,0,0,0,0,0,60.03
桃園縣,桃園市,龍鳳里,78,1,674,3,677,1105,0,0,0,0,0,0,61.27
桃園縣,桃園市,龍鳳里,79,1,718,6,724,1254,0,0,0,0,0,0,57.74
桃園縣,桃園市,龍祥里,80,1,656,5,661,1103,0,0,0,0,0,0,59.93
桃園縣,桃園市,龍祥里,81,1,736,13,749,1220,0,0,0,0,0,0,61.39
桃園縣,桃園市,龍祥里,82,1,771,12,783,1280,0,0,0,0,0,0,61.17
桃園縣,桃園市,龍山里,83,1,562,4,566,841,0,0,0,0,0,0,67.30
桃園縣,桃園市,龍山里,84,1,508,10,518,888,0,0,0,0,0,0,58.33
桃園縣,桃園市,龍山里,85,1,435,7,442,594,0,0,0,0,0,0,74.41
桃園縣,桃園市,龍山里,86,1,574,5,579,909,0,0,0,0,0,0,63.70
桃園縣,桃園市,東埔里,87,1,791,18,809,1293,0,0,0,0,0,0,62.57
桃園縣,桃園市,東埔里,88,1,706,10,716,1263,0,0,0,0,0,0,56.69
桃園縣,桃園市,東埔里,89,1,750,9,759,1223,0,0,0,0,0,0,62.06
桃園縣,桃園市,信光里,90,1,739,8,747,1238,0,0,0,0,0,0,60.34
桃園縣,桃園市,信光里,91,1,665,19,684,1172,0,0,0,0,0,0,58.36
桃園縣,桃園市,信光里,92,1,652,7,659,1196,0,0,0,0,0,0,55.10
桃園縣,桃園市,永安里,93,1,749,9,758,1179,0,0,0,0,0,0,64.29
桃園縣,桃園市,永安里,94,1,779,3,782,1193,0,0,0,0,0,0,65.55
桃園縣,桃園市,永安里,95,1,861,9,870,1352,0,0,0,0,0,0,64.35
桃園縣,桃園市,中寧里,96,1,737,6,743,1480,0,0,0,0,0,0,50.20
桃園縣,桃園市,中寧里,97,1,777,7,784,1337,0,0,0,0,0,0,58.64
桃園縣,桃園市,中寧里,98,1,821,11,832,1427,0,0,0,0,0,0,58.30
桃園縣,桃園市,中埔里,99,1,602,14,616,913,0,0,0,0,0,0,67.47
桃園縣,桃園市,中埔里,100,1,659,6,665,907,0,0,0,0,0,0,73.32
桃園縣,桃園市,南埔里,101,1,662,5,667,1203,0,0,0,0,0,0,55.44
桃園縣,桃園市,南埔里,102,1,722,8,730,1167,0,0,0,0,0,0,62.55
桃園縣,桃園市,寶慶里,103,1,612,5,617,1127,0,0,0,0,0,0,54.75
桃園縣,桃園市,寶慶里,104,1,680,5,685,1304,0,0,0,0,0,0,52.53
桃園縣,桃園市,寶慶里,105,1,338,4,342,741,0,0,0,0,0,0,46.15
桃園縣,桃園市,北埔里,106,1,848,13,861,1709,0,0,0,0,0,0,50.38
桃園縣,桃園市,北埔里,107,1,882,10,892,1815,0,0,0,0,0,0,49.15
桃園縣,桃園市,西埔里,108,1,761,14,775,1088,0,0,0,0,0,0,71.23
桃園縣,桃園市,西埔里,109,1,637,13,650,896,0,0,0,0,0,0,72.54
桃園縣,桃園市,慈文里,110,1,724,18,742,1230,0,0,0,0,0,0,60.33
桃園縣,桃園市,慈文里,111,1,799,10,809,1269,0,0,0,0,0,0,63.75
桃園縣,桃園市,慈文里,112,1,734,10,744,1351,0,0,0,0,0,0,55.07
桃園縣,桃園市,新埔里,113,1,1049,15,1064,1885,0,0,0,0,0,0,56.45
桃園縣,桃園市,新埔里,114,1,579,6,585,852,0,0,0,0,0,0,68.66
桃園縣,桃園市,新埔里,115,1,602,11,613,887,0,0,0,0,0,0,69.11
桃園縣,桃園市,同安里,116,1,821,7,828,1402,0,0,0,0,0,0,59.06
桃園縣,桃園市,同安里,117,1,891,11,902,1610,0,0,0,0,0,0,56.02
桃園縣,桃園市,莊敬里,118,1,416,5,421,1024,0,0,0,0,0,0,41.11
桃園縣,桃園市,莊敬里,119,1,546,2,548,944,0,0,0,0,0,0,58.05
桃園縣,桃園市,莊敬里,120,1,418,1,419,825,0,0,0,0,0,0,50.79
桃園縣,桃園市,自強里,121,1,684,9,693,1157,0,0,0,0,0,0,59.90
桃園縣,桃園市,自強里,122,1,551,2,553,898,0,0,0,0,0,0,61.58
桃園縣,桃園市,自強里,123,1,535,5,540,1123,0,0,0,0,0,0,48.09
桃園縣,桃園市,長安里,124,1,772,6,778,1259,0,0,0,0,0,0,61.80
桃園縣,桃園市,長安里,125,1,702,12,714,1201,0,0,0,0,0,0,59.45
桃園縣,桃園市,長德里,126,1,858,12,870,1476,0,0,0,0,0,0,58.94
桃園縣,桃園市,長德里,127,1,856,14,870,1408,0,0,0,0,0,0,61.79
桃園縣,桃園市,中和里,128,1,949,6,955,1452,0,0,0,0,0,0,65.77
桃園縣,桃園市,北門里,129,1,1053,18,1071,1632,0,0,0,0,0,0,65.63
桃園縣,桃園市,朝陽里,130,1,950,12,962,1593,0,0,0,0,0,0,60.39
桃園縣,桃園市,青溪里,131,1,860,13,873,1436,0,0,0,0,0,0,60.79
桃園縣,桃園市,青溪里,132,1,746,13,759,1206,0,0,0,0,0,0,62.94
桃園縣,桃園市,青溪里,133,1,876,3,879,1572,0,0,0,0,0,0,55.92
桃園縣,桃園市,成功里,134,1,992,15,1007,1689,0,0,0,0,0,0,59.62
桃園縣,桃園市,成功里,135,1,839,4,843,1404,0,0,0,0,0,0,60.04
桃園縣,桃園市,三民里,136,1,979,8,987,1588,0,0,0,0,0,0,62.15
桃園縣,桃園市,三民里,137,1,926,10,936,1626,0,0,0,0,0,0,57.56
桃園縣,桃園市,忠義里,138,1,593,14,607,1091,0,0,0,0,0,0,55.64
桃園縣,桃園市,忠義里,139,1,632,22,654,1071,0,0,0,0,0,0,61.06
桃園縣,桃園市,忠義里,140,1,828,10,838,1443,0,0,0,0,0,0,58.07
桃園縣,桃園市,忠義里,141,1,518,11,529,928,0,0,0,0,0,0,57.00
桃園縣,桃園市,大興里,142,1,633,8,641,1131,0,0,0,0,0,0,56.68
桃園縣,桃園市,大興里,143,1,919,20,939,1624,0,0,0,0,0,0,57.82
桃園縣,桃園市,大興里,144,1,731,7,738,1299,0,0,0,0,0,0,56.81
桃園縣,桃園市,會稽里,145,1,764,12,776,1632,0,0,0,0,0,0,47.55
桃園縣,桃園市,會稽里,146,1,859,18,877,1616,0,0,0,0,0,0,54.27
桃園縣,桃園市,大有里,147,1,713,11,724,1614,0,0,0,0,0,0,44.86
桃園縣,桃園市,寶山里,148,1,634,8,642,1171,0,0,0,0,0,0,54.82
桃園縣,桃園市,寶山里,149,1,711,11,722,1214,0,0,0,0,0,0,59.47
桃園縣,桃園市,春日里,150,1,852,24,876,1408,0,0,0,0,0,0,62.22
桃園縣,桃園市,春日里,151,1,757,10,767,1557,0,0,0,0,0,0,49.26
桃園縣,桃園市,汴洲里,152,1,910,10,920,1396,0,0,0,0,0,0,65.90
桃園縣,桃園市,汴洲里,153,1,991,18,1009,1541,0,0,0,0,0,0,65.48
桃園縣,龜山鄉,龜山村,154,1,801,18,819,1273,0,0,0,0,0,0,64.34
桃園縣,龜山鄉,龜山村,155,1,905,18,923,1541,0,0,0,0,0,0,59.90
桃園縣,龜山鄉,龜山村,156,1,900,18,918,1552,0,0,0,0,0,0,59.15
桃園縣,龜山鄉,新路村,157,1,949,14,963,1399,0,0,0,0,0,0,68.83
桃園縣,龜山鄉,新路村,158,1,680,6,686,1052,0,0,0,0,0,0,65.21
桃園縣,龜山鄉,新路村,159,1,638,15,653,1181,0,0,0,0,0,0,55.29
桃園縣,龜山鄉,新路村,160,1,797,11,808,1271,0,0,0,0,0,0,63.57
桃園縣,龜山鄉,大同村,161,1,815,12,827,1405,0,0,0,0,0,0,58.86
桃園縣,龜山鄉,大同村,162,1,676,17,693,1241,0,0,0,0,0,0,55.84
桃園縣,龜山鄉,大同村,163,1,751,9,760,1148,0,0,0,0,0,0,66.20
桃園縣,龜山鄉,中興村,164,1,766,11,777,1352,0,0,0,0,0,0,57.47
桃園縣,龜山鄉,中興村,165,1,593,10,603,1003,0,0,0,0,0,0,60.12
桃園縣,龜山鄉,中興村,166,1,724,12,736,1201,0,0,0,0,0,0,61.28
桃園縣,龜山鄉,中興村,167,1,507,13,520,967,0,0,0,0,0,0,53.77
桃園縣,龜山鄉,陸光村,168,1,745,13,758,1078,0,0,0,0,0,0,70.32
桃園縣,龜山鄉,陸光村,169,1,801,11,812,1134,0,0,0,0,0,0,71.60
桃園縣,龜山鄉,精忠村,170,1,921,10,931,1348,0,0,0,0,0,0,69.07
桃園縣,龜山鄉,精忠村,171,1,389,1,390,561,0,0,0,0,0,0,69.52
桃園縣,龜山鄉,福源村,172,1,904,23,927,1600,0,0,0,0,0,0,57.94
桃園縣,龜山鄉,兔坑村,173,1,866,15,881,1722,0,0,0,0,0,0,51.16
桃園縣,龜山鄉,迴龍村,174,1,678,18,696,1356,0,0,0,0,0,0,51.33
桃園縣,龜山鄉,迴龍村,175,1,523,7,530,996,0,0,0,0,0,0,53.21
桃園縣,龜山鄉,迴龍村,176,1,475,5,480,1085,0,0,0,0,0,0,44.24
桃園縣,龜山鄉,龍華村,177,1,553,7,560,959,0,0,0,0,0,0,58.39
桃園縣,龜山鄉,龍華村,178,1,605,13,618,1026,0,0,0,0,0,0,60.23
桃園縣,龜山鄉,龍壽村,179,1,854,19,873,1486,0,0,0,0,0,0,58.75
桃園縣,龜山鄉,嶺頂村,180,1,677,15,692,1430,0,0,0,0,0,0,48.39
桃園縣,龜山鄉,嶺頂村,181,1,630,12,642,1340,0,0,0,0,0,0,47.91
桃園縣,龜山鄉,新嶺村,182,1,549,7,556,1115,0,0,0,0,0,0,49.87
桃園縣,龜山鄉,新嶺村,183,1,748,14,762,1420,0,0,0,0,0,0,53.66
桃園縣,龜山鄉,舊路村,184,1,1143,30,1173,1786,0,0,0,0,0,0,65.68
桃園縣,龜山鄉,山德村,185,1,902,11,913,1540,0,0,0,0,0,0,59.29
桃園縣,龜山鄉,山德村,186,1,829,13,842,1454,0,0,0,0,0,0,57.91
桃園縣,龜山鄉,山德村,187,1,965,17,982,1596,0,0,0,0,0,0,61.53
桃園縣,龜山鄉,山頂村,188,1,895,9,904,1471,0,0,0,0,0,0,61.45
桃園縣,龜山鄉,山頂村,189,1,1016,16,1032,2631,0,0,0,0,0,0,39.22
桃園縣,龜山鄉,山福村,190,1,797,11,808,1354,0,0,0,0,0,0,59.68
桃園縣,龜山鄉,山福村,191,1,723,6,729,1286,0,0,0,0,0,0,56.69
桃園縣,龜山鄉,幸福村,192,1,700,9,709,1269,0,0,0,0,0,0,55.87
桃園縣,龜山鄉,幸福村,193,1,673,7,680,1310,0,0,0,0,0,0,51.91
桃園縣,龜山鄉,幸福村,194,1,604,12,616,1202,0,0,0,0,0,0,51.25
桃園縣,龜山鄉,大崗村,195,1,600,5,605,1322,0,0,0,0,0,0,45.76
桃園縣,龜山鄉,大崗村,196,1,589,9,598,1491,0,0,0,0,0,0,40.11
桃園縣,龜山鄉,大崗村,197,1,817,10,827,1332,0,0,0,0,0,0,62.09
桃園縣,龜山鄉,大崗村,198,1,647,13,660,1073,0,0,0,0,0,0,61.51
桃園縣,龜山鄉,公西村,199,1,897,19,916,1538,0,0,0,0,0,0,59.56
桃園縣,龜山鄉,文化村,200,1,881,11,892,1735,0,0,0,0,0,0,51.41
桃園縣,龜山鄉,樂善村,201,1,584,3,587,1205,0,0,0,0,0,0,48.71
桃園縣,龜山鄉,樂善村,202,1,441,4,445,1096,0,0,0,0,0,0,40.60
桃園縣,龜山鄉,樂善村,203,1,622,6,628,1391,0,0,0,0,0,0,45.15
桃園縣,龜山鄉,大坑村,204,1,721,9,730,1167,0,0,0,0,0,0,62.55
桃園縣,龜山鄉,南上村,205,1,762,12,774,1160,0,0,0,0,0,0,66.72
桃園縣,龜山鄉,南美村,206,1,647,5,652,1062,0,0,0,0,0,0,61.39
桃園縣,龜山鄉,楓樹村,207,1,679,10,689,1160,0,0,0,0,0,0,59.40
桃園縣,龜山鄉,楓樹村,208,1,639,15,654,1061,0,0,0,0,0,0,61.64
桃園縣,八德市,興仁里,209,1,903,11,914,1370,0,0,0,0,0,0,66.72
桃園縣,八德市,興仁里,210,1,907,24,931,1517,0,0,0,0,0,0,61.37
桃園縣,八德市,福興里,211,1,985,12,997,1337,0,0,0,0,0,0,74.57
桃園縣,八德市,福興里,212,1,838,16,854,1180,0,0,0,0,0,0,72.37
桃園縣,八德市,瑞豐里,213,1,1028,19,1047,1556,0,0,0,0,0,0,67.29
桃園縣,八德市,瑞豐里,214,1,982,14,996,1386,0,0,0,0,0,0,71.86
桃園縣,八德市,瑞泰里,215,1,838,11,849,1369,0,0,0,0,0,0,62.02
桃園縣,八德市,瑞泰里,216,1,831,21,852,1299,0,0,0,0,0,0,65.59
桃園縣,八德市,瑞發里,217,1,965,20,985,1428,0,0,0,0,0,0,68.98
桃園縣,八德市,瑞發里,218,1,1021,17,1038,1565,0,0,0,0,0,0,66.33
桃園縣,八德市,瑞德里,219,1,993,22,1015,1417,0,0,0,0,0,0,71.63
桃園縣,八德市,瑞德里,220,1,1079,19,1098,1523,0,0,0,0,0,0,72.09
桃園縣,八德市,瑞祥里,221,1,905,9,914,1359,0,0,0,0,0,0,67.26
桃園縣,八德市,瑞祥里,222,1,939,15,954,1379,0,0,0,0,0,0,69.18
桃園縣,八德市,廣興里,223,1,1080,19,1099,1632,0,0,0,0,0,0,67.34
桃園縣,八德市,廣興里,224,1,1072,16,1088,1589,0,0,0,0,0,0,68.47
桃園縣,八德市,廣興里,225,1,635,17,652,935,0,0,0,0,0,0,69.73
桃園縣,八德市,廣隆里,226,1,1301,22,1323,1865,0,0,0,0,0,0,70.94
桃園縣,八德市,廣隆里,227,1,564,6,570,825,0,0,0,0,0,0,69.09
桃園縣,八德市,竹園里,228,1,838,22,860,1270,0,0,0,0,0,0,67.72
桃園縣,八德市,竹園里,229,1,687,15,702,1065,0,0,0,0,0,0,65.92
桃園縣,八德市,霄裡里,230,1,1094,28,1122,1585,0,0,0,0,0,0,70.79
桃園縣,八德市,霄裡里,231,1,693,21,714,1083,0,0,0,0,0,0,65.93
桃園縣,八德市,霄裡里,232,1,685,9,694,994,0,0,0,0,0,0,69.82
桃園縣,八德市,茄明里,233,1,794,17,811,1174,0,0,0,0,0,0,69.08
桃園縣,八德市,茄明里,234,1,558,16,574,1082,0,0,0,0,0,0,53.05
桃園縣,八德市,茄苳里,235,1,1113,17,1130,1649,0,0,0,0,0,0,68.53
桃園縣,八德市,茄苳里,236,1,1232,29,1261,1990,0,0,0,0,0,0,63.37
桃園縣,八德市,高明里,237,1,1009,25,1034,1581,0,0,0,0,0,0,65.40
桃園縣,八德市,高明里,238,1,704,16,720,1128,0,0,0,0,0,0,63.83
桃園縣,八德市,高城里,239,1,1204,28,1232,1833,0,0,0,0,0,0,67.21
桃園縣,八德市,白鷺里,240,1,1332,16,1348,1924,0,0,0,0,0,0,70.06
桃園縣,八德市,大湳里,241,1,690,12,702,1047,0,0,0,0,0,0,67.05
桃園縣,八德市,大湳里,242,1,771,19,790,1278,0,0,0,0,0,0,61.82
桃園縣,八德市,大發里,243,1,946,17,963,1337,0,0,0,0,0,0,72.03
桃園縣,八德市,大仁里,244,1,1043,10,1053,1573,0,0,0,0,0,0,66.94
桃園縣,八德市,大仁里,245,1,807,18,825,1210,0,0,0,0,0,0,68.18
桃園縣,八德市,大明里,246,1,1108,15,1123,1859,0,0,0,0,0,0,60.41
桃園縣,八德市,大安里,247,1,972,15,987,1538,0,0,0,0,0,0,64.17
桃園縣,八德市,大竹里,248,1,801,10,811,1245,0,0,0,0,0,0,65.14
桃園縣,八德市,大興里,249,1,649,14,663,1030,0,0,0,0,0,0,64.37
桃園縣,八德市,大興里,250,1,881,12,893,1335,0,0,0,0,0,0,66.89
桃園縣,八德市,大興里,251,1,728,8,736,1211,0,0,0,0,0,0,60.78
桃園縣,八德市,大華里,252,1,859,15,874,1344,0,0,0,0,0,0,65.03
桃園縣,八德市,大華里,253,1,684,13,697,1070,0,0,0,0,0,0,65.14
桃園縣,八德市,大華里,254,1,731,10,741,1173,0,0,0,0,0,0,63.17
桃園縣,八德市,大信里,255,1,680,7,687,1053,0,0,0,0,0,0,65.24
桃園縣,八德市,大信里,256,1,662,8,670,1049,0,0,0,0,0,0,63.87
桃園縣,八德市,大信里,257,1,544,17,561,1203,0,0,0,0,0,0,46.63
桃園縣,八德市,大信里,258,1,845,18,863,1194,0,0,0,0,0,0,72.28
桃園縣,八德市,大信里,259,1,726,30,756,1201,0,0,0,0,0,0,62.95
桃園縣,八德市,大和里,260,1,656,9,665,1067,0,0,0,0,0,0,62.32
桃園縣,八德市,大和里,261,1,474,7,481,748,0,0,0,0,0,0,64.30
桃園縣,八德市,大昌里,262,1,565,11,576,802,0,0,0,0,0,0,71.82
桃園縣,八德市,大昌里,263,1,1046,13,1059,1625,0,0,0,0,0,0,65.17
桃園縣,八德市,大同里,264,1,1066,14,1080,1592,0,0,0,0,0,0,67.84
桃園縣,八德市,大慶里,265,1,831,19,850,1314,0,0,0,0,0,0,64.69
桃園縣,八德市,大成里,266,1,1066,19,1085,1547,0,0,0,0,0,0,70.14
桃園縣,八德市,大成里,267,1,1146,16,1162,1747,0,0,0,0,0,0,66.51
桃園縣,八德市,大義里,268,1,780,10,790,1230,0,0,0,0,0,0,64.23
桃園縣,八德市,大義里,269,1,904,7,911,1437,0,0,0,0,0,0,63.40
桃園縣,八德市,大忠里,270,1,589,10,599,917,0,0,0,0,0,0,65.32
桃園縣,八德市,大忠里,271,1,541,14,555,872,0,0,0,0,0,0,63.65
桃園縣,八德市,大智里,272,1,882,12,894,1349,0,0,0,0,0,0,66.27
桃園縣,八德市,大智里,273,1,788,11,799,1199,0,0,0,0,0,0,66.64
桃園縣,八德市,大智里,274,1,1043,13,1056,1513,0,0,0,0,0,0,69.80
桃園縣,八德市,大正里,275,1,634,13,647,934,0,0,0,0,0,0,69.27
桃園縣,八德市,大正里,276,1,954,12,966,1546,0,0,0,0,0,0,62.48
桃園縣,八德市,大福里,277,1,1204,8,1212,2047,0,0,0,0,0,0,59.21
桃園縣,八德市,大福里,278,1,520,5,525,826,0,0,0,0,0,0,63.56
桃園縣,八德市,大強里,279,1,906,18,924,1360,0,0,0,0,0,0,67.94
桃園縣,八德市,大強里,280,1,542,6,548,817,0,0,0,0,0,0,67.07
桃園縣,八德市,大勇里,281,1,1114,18,1132,1750,0,0,0,0,0,0,64.69
桃園縣,八德市,大榮里,282,1,867,8,875,1428,0,0,0,0,0,0,61.27
桃園縣,八德市,大千里,283,1,894,16,910,1379,0,0,0,0,0,0,65.99
桃園縣,八德市,大千里,284,1,1015,18,1033,1934,0,0,0,0,0,0,53.41
桃園縣,蘆竹鄉,新興村,285,1,689,15,704,1057,0,0,0,0,0,0,66.60
桃園縣,蘆竹鄉,新興村,286,1,1103,12,1115,1691,0,0,0,0,0,0,65.94
桃園縣,蘆竹鄉,中福村,287,1,840,8,848,1279,0,0,0,0,0,0,66.30
桃園縣,蘆竹鄉,中福村,288,1,784,11,795,1153,0,0,0,0,0,0,68.95
桃園縣,蘆竹鄉,新莊村,289,1,942,14,956,1437,0,0,0,0,0,0,66.53
桃園縣,蘆竹鄉,新莊村,290,1,712,14,726,1099,0,0,0,0,0,0,66.06
桃園縣,蘆竹鄉,上竹村,291,1,1127,18,1145,1706,0,0,0,0,0,0,67.12
桃園縣,蘆竹鄉,宏竹村,292,1,1297,17,1314,1812,0,0,0,0,0,0,72.52
桃園縣,蘆竹鄉,大竹村,293,1,733,16,749,1160,0,0,0,0,0,0,64.57
桃園縣,蘆竹鄉,大竹村,294,1,560,9,569,889,0,0,0,0,0,0,64.00
桃園縣,蘆竹鄉,富竹村,295,1,637,6,643,833,0,0,0,0,0,0,77.19
桃園縣,蘆竹鄉,大華村,296,1,658,7,665,913,0,0,0,0,0,0,72.84
桃園縣,蘆竹鄉,大華村,297,1,573,11,584,833,0,0,0,0,0,0,70.11
桃園縣,蘆竹鄉,蘆竹村,298,1,953,15,968,1355,0,0,0,0,0,0,71.44
桃園縣,蘆竹鄉,蘆竹村,299,1,1018,16,1034,1420,0,0,0,0,0,0,72.82
桃園縣,蘆竹鄉,南崁村,300,1,600,9,609,931,0,0,0,0,0,0,65.41
桃園縣,蘆竹鄉,南崁村,301,1,730,8,738,1137,0,0,0,0,0,0,64.91
桃園縣,蘆竹鄉,南興村,302,1,628,10,638,859,0,0,0,0,0,0,74.27
桃園縣,蘆竹鄉,南興村,303,1,773,18,791,1782,0,0,0,0,0,0,44.39
桃園縣,蘆竹鄉,南興村,304,1,860,16,876,1520,0,0,0,0,0,0,57.63
桃園縣,蘆竹鄉,南榮村,305,1,506,6,512,870,0,0,0,0,0,0,58.85
桃園縣,蘆竹鄉,南榮村,306,1,685,14,699,1108,0,0,0,0,0,0,63.09
桃園縣,蘆竹鄉,錦中村,307,1,1043,12,1055,1648,0,0,0,0,0,0,64.02
桃園縣,蘆竹鄉,錦興村,308,1,734,13,747,1133,0,0,0,0,0,0,65.93
桃園縣,蘆竹鄉,錦興村,309,1,769,20,789,1171,0,0,0,0,0,0,67.38
桃園縣,蘆竹鄉,長興村,310,1,864,13,877,1341,0,0,0,0,0,0,65.40
桃園縣,蘆竹鄉,五福村,311,1,1096,15,1111,1813,0,0,0,0,0,0,61.28
桃園縣,蘆竹鄉,羊稠村,312,1,576,13,589,1033,0,0,0,0,0,0,57.02
桃園縣,蘆竹鄉,羊稠村,313,1,690,2,692,1386,0,0,0,0,0,0,49.93
桃園縣,蘆竹鄉,營盤村,314,1,615,5,620,1134,0,0,0,0,0,0,54.67
桃園縣,蘆竹鄉,營盤村,315,1,577,7,584,933,0,0,0,0,0,0,62.59
桃園縣,蘆竹鄉,瓦窯村,316,1,668,18,686,1253,0,0,0,0,0,0,54.75
桃園縣,蘆竹鄉,內厝村,317,1,1175,17,1192,1690,0,0,0,0,0,0,70.53
桃園縣,蘆竹鄉,山鼻村,318,1,911,15,926,1319,0,0,0,0,0,0,70.20
桃園縣,蘆竹鄉,坑子村,319,1,997,13,1010,1524,0,0,0,0,0,0,66.27
桃園縣,蘆竹鄉,外社村,320,1,819,16,835,1204,0,0,0,0,0,0,69.35
桃園縣,蘆竹鄉,山腳村,321,1,905,15,920,1264,0,0,0,0,0,0,72.78
桃園縣,蘆竹鄉,山腳村,322,1,1074,14,1088,1617,0,0,0,0,0,0,67.29
桃園縣,蘆竹鄉,坑口村,323,1,720,19,739,1032,0,0,0,0,0,0,71.61
桃園縣,蘆竹鄉,坑口村,324,1,681,10,691,958,0,0,0,0,0,0,72.13
桃園縣,蘆竹鄉,海湖村,325,1,979,18,997,1558,0,0,0,0,0,0,63.99
桃園縣,蘆竹鄉,海湖村,326,1,1004,22,1026,1587,0,0,0,0,0,0,64.65
桃園縣,大園鄉,大園村,327,1,1252,23,1275,1680,0,0,0,0,0,0,75.89
桃園縣,大園鄉,大園村,328,1,1129,16,1145,1541,0,0,0,0,0,0,74.30
桃園縣,大園鄉,大園村,329,1,1177,14,1191,1583,0,0,0,0,0,0,75.24
桃園縣,大園鄉,田心村,330,1,850,7,857,1182,0,0,0,0,0,0,72.50
桃園縣,大園鄉,田心村,331,1,847,7,854,1281,0,0,0,0,0,0,66.67
桃園縣,大園鄉,田心村,332,1,872,6,878,1248,0,0,0,0,0,0,70.35
桃園縣,大園鄉,溪海村,333,1,917,19,936,1357,0,0,0,0,0,0,68.98
桃園縣,大園鄉,溪海村,334,1,959,13,972,1410,0,0,0,0,0,0,68.94
桃園縣,大園鄉,和平村,335,1,970,15,985,1374,0,0,0,0,0,0,71.69
桃園縣,大園鄉,橫峰村,336,1,1106,15,1121,1545,0,0,0,0,0,0,72.56
桃園縣,大園鄉,橫峰村,337,1,1062,17,1079,1535,0,0,0,0,0,0,70.29
桃園縣,大園鄉,橫峰村,338,1,1146,14,1160,1525,0,0,0,0,0,0,76.07
桃園縣,大園鄉,五權村,339,1,1359,19,1378,1831,0,0,0,0,0,0,75.26
桃園縣,大園鄉,五權村,340,1,1102,13,1115,1425,0,0,0,0,0,0,78.25
桃園縣,大園鄉,埔心村,341,1,892,8,900,1139,0,0,0,0,0,0,79.02
桃園縣,大園鄉,埔心村,342,1,857,16,873,1215,0,0,0,0,0,0,71.85
桃園縣,大園鄉,埔心村,343,1,1146,17,1163,1553,0,0,0,0,0,0,74.89
桃園縣,大園鄉,大海村,344,1,950,21,971,1195,0,0,0,0,0,0,81.26
桃園縣,大園鄉,建華村,345,1,723,5,728,964,0,0,0,0,0,0,75.52
桃園縣,大園鄉,三石村,346,1,713,3,716,956,0,0,0,0,0,0,74.90
桃園縣,大園鄉,三石村,347,1,1018,26,1044,1355,0,0,0,0,0,0,77.05
桃園縣,大園鄉,果林村,348,1,1116,17,1133,1549,0,0,0,0,0,0,73.14
桃園縣,大園鄉,果林村,349,1,758,8,766,1115,0,0,0,0,0,0,68.70
桃園縣,大園鄉,果林村,350,1,756,11,767,1143,0,0,0,0,0,0,67.10
桃園縣,大園鄉,竹圍村,351,1,634,3,637,848,0,0,0,0,0,0,75.12
桃園縣,大園鄉,竹圍村,352,1,864,12,876,1229,0,0,0,0,0,0,71.28
桃園縣,大園鄉,海口村,353,1,870,12,882,1282,0,0,0,0,0,0,68.80
桃園縣,大園鄉,沙崙村,354,1,851,18,869,1267,0,0,0,0,0,0,68.59
桃園縣,大園鄉,沙崙村,355,1,927,12,939,1298,0,0,0,0,0,0,72.34
桃園縣,大園鄉,后厝村,356,1,1056,12,1068,1400,0,0,0,0,0,0,76.29
桃園縣,大園鄉,圳頭村,357,1,1292,20,1312,1849,0,0,0,0,0,0,70.96
桃園縣,大園鄉,內海村,358,1,1171,12,1183,1640,0,0,0,0,0,0,72.13
桃園縣,大園鄉,北港村,359,1,1075,8,1083,1575,0,0,0,0,0,0,68.76
桃園縣,大園鄉,南港村,360,1,700,7,707,1266,0,0,0,0,0,0,55.85
桃園縣,大園鄉,南港村,361,1,843,12,855,1180,0,0,0,0,0,0,72.46
桃園縣,大溪鎮,興和里,362,1,598,8,606,871,0,0,0,0,0,0,69.58
桃園縣,大溪鎮,興和里,363,1,570,7,577,796,0,0,0,0,0,0,72.49
桃園縣,大溪鎮,福仁里,364,1,774,10,784,1118,0,0,0,0,0,0,70.13
桃園縣,大溪鎮,田心里,365,1,746,13,759,1144,0,0,0,0,0,0,66.35
桃園縣,大溪鎮,田心里,366,1,662,12,674,1043,0,0,0,0,0,0,64.62
桃園縣,大溪鎮,田心里,367,1,677,9,686,1041,0,0,0,0,0,0,65.90
桃園縣,大溪鎮,一心里,368,1,554,7,561,912,0,0,0,0,0,0,61.51
桃園縣,大溪鎮,一心里,369,1,643,8,651,948,0,0,0,0,0,0,68.67
桃園縣,大溪鎮,一心里,370,1,652,9,661,955,0,0,0,0,0,0,69.21
桃園縣,大溪鎮,一德里,371,1,801,4,805,1268,0,0,0,0,0,0,63.49
桃園縣,大溪鎮,一德里,372,1,752,12,764,1148,0,0,0,0,0,0,66.55
桃園縣,大溪鎮,一德里,373,1,721,9,730,1136,0,0,0,0,0,0,64.26
桃園縣,大溪鎮,月眉里,374,1,712,7,719,1010,0,0,0,0,0,0,71.19
桃園縣,大溪鎮,永福里,375,1,622,9,631,888,0,0,0,0,0,0,71.06
桃園縣,大溪鎮,康安里,376,1,698,15,713,958,0,0,0,0,0,0,74.43
桃園縣,大溪鎮,義和里,377,1,694,8,702,966,0,0,0,0,0,0,72.67
桃園縣,大溪鎮,義和里,378,1,433,6,439,608,0,0,0,0,0,0,72.20
桃園縣,大溪鎮,美華里,379,1,521,6,527,856,0,0,0,0,0,0,61.57
桃園縣,大溪鎮,美華里,380,1,614,11,625,914,0,0,0,0,0,0,68.38
桃園縣,大溪鎮,美華里,381,1,483,11,494,697,0,0,0,0,0,0,70.88
桃園縣,大溪鎮,福安里,382,1,707,9,716,1104,0,0,0,0,0,0,64.86
桃園縣,大溪鎮,福安里,383,1,642,7,649,952,0,0,0,0,0,0,68.17
桃園縣,大溪鎮,復興里,384,1,610,7,617,931,0,0,0,0,0,0,66.27
桃園縣,大溪鎮,新峰里,385,1,462,7,469,680,0,0,0,0,0,0,68.97
桃園縣,大溪鎮,新峰里,386,1,182,3,185,294,0,0,0,0,0,0,62.93
桃園縣,大溪鎮,中新里,387,1,553,8,561,778,0,0,0,0,0,0,72.11
桃園縣,大溪鎮,中新里,388,1,497,12,509,752,0,0,0,0,0,0,67.69
桃園縣,大溪鎮,瑞興里,389,1,972,18,990,1361,0,0,0,0,0,0,72.74
桃園縣,大溪鎮,瑞興里,390,1,443,3,446,619,0,0,0,0,0,0,72.05
桃園縣,大溪鎮,仁善里,391,1,947,20,967,1407,0,0,0,0,0,0,68.73
桃園縣,大溪鎮,仁善里,392,1,613,8,621,859,0,0,0,0,0,0,72.29
桃園縣,大溪鎮,僑愛里,393,1,698,8,706,1086,0,0,0,0,0,0,65.01
桃園縣,大溪鎮,仁義里,394,1,629,12,641,914,0,0,0,0,0,0,70.13
桃園縣,大溪鎮,仁義里,395,1,603,15,618,861,0,0,0,0,0,0,71.78
桃園縣,大溪鎮,仁義里,396,1,607,12,619,894,0,0,0,0,0,0,69.24
桃園縣,大溪鎮,仁和里,397,1,470,9,479,746,0,0,0,0,0,0,64.21
桃園縣,大溪鎮,仁和里,398,1,665,10,675,1015,0,0,0,0,0,0,66.50
桃園縣,大溪鎮,仁愛里,399,1,733,8,741,985,0,0,0,0,0,0,75.23
桃園縣,大溪鎮,仁愛里,400,1,366,7,373,605,0,0,0,0,0,0,61.65
桃園縣,大溪鎮,仁武里,401,1,977,13,990,1401,0,0,0,0,0,0,70.66
桃園縣,大溪鎮,仁武里,402,1,826,13,839,1213,0,0,0,0,0,0,69.17
桃園縣,大溪鎮,仁文里,403,1,770,14,784,1203,0,0,0,0,0,0,65.17
桃園縣,大溪鎮,仁文里,404,1,630,7,637,960,0,0,0,0,0,0,66.35
桃園縣,大溪鎮,仁文里,405,1,454,7,461,620,0,0,0,0,0,0,74.35
桃園縣,大溪鎮,南興里,406,1,790,14,804,1135,0,0,0,0,0,0,70.84
桃園縣,大溪鎮,南興里,407,1,934,11,945,1266,0,0,0,0,0,0,74.64
桃園縣,大溪鎮,南興里,408,1,743,21,764,1081,0,0,0,0,0,0,70.68
桃園縣,大溪鎮,員林里,409,1,801,10,811,1118,0,0,0,0,0,0,72.54
桃園縣,大溪鎮,光明里,410,1,457,11,468,728,0,0,0,0,0,0,64.29
桃園縣,大溪鎮,光明里,411,1,608,12,620,878,0,0,0,0,0,0,70.62
桃園縣,大溪鎮,瑞源里,412,1,929,17,946,1455,0,0,0,0,0,0,65.02
桃園縣,大溪鎮,瑞源里,413,1,862,9,871,1286,0,0,0,0,0,0,67.73
桃園縣,大溪鎮,三元里,414,1,645,9,654,950,0,0,0,0,0,0,68.84
桃園縣,大溪鎮,三元里,415,1,529,8,537,809,0,0,0,0,0,0,66.38
桃園縣,大溪鎮,三元里,416,1,640,7,647,948,0,0,0,0,0,0,68.25
桃園縣,復興鄉,三民村,417,1,780,12,792,1202,0,0,0,0,0,0,65.89
桃園縣,復興鄉,澤仁村,418,1,423,4,427,652,0,0,0,0,0,0,65.49
桃園縣,復興鄉,霞雲村,419,1,28,1,29,48,0,0,0,0,0,0,60.42
桃園縣,復興鄉,義盛村,420,1,26,0,26,42,0,0,0,0,0,0,61.90
桃園縣,復興鄉,羅浮村,421,1,177,1,178,303,0,0,0,0,0,0,58.75
桃園縣,復興鄉,奎輝村,422,1,21,1,22,62,0,0,0,0,0,0,35.48
桃園縣,復興鄉,長興村,423,1,68,3,71,108,0,0,0,0,0,0,65.74
桃園縣,復興鄉,高義村,424,1,31,0,31,57,0,0,0,0,0,0,54.39
桃園縣,復興鄉,三光村,425,1,17,0,17,53,0,0,0,0,0,0,32.08
桃園縣,復興鄉,華陵村,426,1,109,1,110,331,0,0,0,0,0,0,33.23
桃園縣,中壢市,後寮里,427,1,702,17,719,1251,0,0,0,0,0,0,57.47
桃園縣,中壢市,後寮里,428,1,694,12,706,1160,0,0,0,0,0,0,60.86
桃園縣,中壢市,明德里,429,1,930,16,946,1477,0,0,0,0,0,0,64.05
桃園縣,中壢市,明德里,430,1,835,9,844,1356,0,0,0,0,0,0,62.24
桃園縣,中壢市,至善里,431,1,875,14,889,1469,0,0,0,0,0,0,60.52
桃園縣,中壢市,至善里,432,1,825,9,834,1647,0,0,0,0,0,0,50.64
桃園縣,中壢市,龍興里,433,1,1087,13,1100,1581,0,0,0,0,0,0,69.58
桃園縣,中壢市,龍興里,434,1,979,11,990,1644,0,0,0,0,0,0,60.22
桃園縣,中壢市,龍德里,435,1,709,15,724,1143,0,0,0,0,0,0,63.34
桃園縣,中壢市,龍德里,436,1,1006,11,1017,1550,0,0,0,0,0,0,65.61
桃園縣,中壢市,龍岡里,437,1,811,17,828,1242,0,0,0,0,0,0,66.67
桃園縣,中壢市,龍岡里,438,1,725,13,738,1076,0,0,0,0,0,0,68.59
桃園縣,中壢市,龍岡里,439,1,805,9,814,1215,0,0,0,0,0,0,67.00
桃園縣,中壢市,龍東里,440,1,880,11,891,1342,0,0,0,0,0,0,66.39
桃園縣,中壢市,龍東里,441,1,862,11,873,1321,0,0,0,0,0,0,66.09
桃園縣,中壢市,龍東里,442,1,909,18,927,1381,0,0,0,0,0,0,67.13
桃園縣,中壢市,龍昌里,443,1,846,14,860,1283,0,0,0,0,0,0,67.03
桃園縣,中壢市,龍昌里,444,1,923,19,942,1322,0,0,0,0,0,0,71.26
桃園縣,中壢市,龍昌里,445,1,758,12,770,1306,0,0,0,0,0,0,58.96
桃園縣,中壢市,龍平里,446,1,903,9,912,1376,0,0,0,0,0,0,66.28
桃園縣,中壢市,龍平里,447,1,996,21,1017,1538,0,0,0,0,0,0,66.12
桃園縣,中壢市,龍安里,448,1,791,15,806,1141,0,0,0,0,0,0,70.64
桃園縣,中壢市,龍安里,449,1,871,21,892,1348,0,0,0,0,0,0,66.17
桃園縣,中壢市,仁美里,450,1,687,5,692,1124,0,0,0,0,0,0,61.57
桃園縣,中壢市,仁美里,451,1,731,7,738,1181,0,0,0,0,0,0,62.49
桃園縣,中壢市,仁美里,452,1,496,8,504,761,0,0,0,0,0,0,66.23
桃園縣,中壢市,仁福里,453,1,1068,13,1081,1705,0,0,0,0,0,0,63.40
桃園縣,中壢市,仁福里,454,1,789,8,797,1279,0,0,0,0,0,0,62.31
桃園縣,中壢市,仁愛里,455,1,812,13,825,1302,0,0,0,0,0,0,63.36
桃園縣,中壢市,仁愛里,456,1,711,14,725,1188,0,0,0,0,0,0,61.03
桃園縣,中壢市,仁愛里,457,1,672,15,687,1066,0,0,0,0,0,0,64.45
桃園縣,中壢市,仁德里,458,1,887,7,894,1275,0,0,0,0,0,0,70.12
桃園縣,中壢市,仁德里,459,1,819,16,835,1332,0,0,0,0,0,0,62.69
桃園縣,中壢市,仁德里,460,1,746,10,756,1264,0,0,0,0,0,0,59.81
桃園縣,中壢市,仁祥里,461,1,736,17,753,1212,0,0,0,0,0,0,62.13
桃園縣,中壢市,仁祥里,462,1,799,16,815,1266,0,0,0,0,0,0,64.38
桃園縣,中壢市,華勛里,463,1,971,14,985,1448,0,0,0,0,0,0,68.02
桃園縣,中壢市,華勛里,464,1,855,20,875,1324,0,0,0,0,0,0,66.09
桃園縣,中壢市,中堅里,465,1,729,16,745,1067,0,0,0,0,0,0,69.82
桃園縣,中壢市,中堅里,466,1,547,11,558,826,0,0,0,0,0,0,67.55
桃園縣,中壢市,中堅里,467,1,609,14,623,900,0,0,0,0,0,0,69.22
桃園縣,中壢市,中堅里,468,1,602,7,609,920,0,0,0,0,0,0,66.20
桃園縣,中壢市,普仁里,469,1,631,13,644,1011,0,0,0,0,0,0,63.70
桃園縣,中壢市,普仁里,470,1,577,7,584,956,0,0,0,0,0,0,61.09
桃園縣,中壢市,普仁里,471,1,534,6,540,929,0,0,0,0,0,0,58.13
桃園縣,中壢市,普忠里,472,1,711,7,718,1168,0,0,0,0,0,0,61.47
桃園縣,中壢市,普忠里,473,1,500,6,506,1066,0,0,0,0,0,0,47.47
桃園縣,中壢市,普強里,474,1,926,6,932,1373,0,0,0,0,0,0,67.88
桃園縣,中壢市,普強里,475,1,741,3,744,1184,0,0,0,0,0,0,62.84
桃園縣,中壢市,信義里,476,1,749,5,754,1077,0,0,0,0,0,0,70.01
桃園縣,中壢市,信義里,477,1,837,8,845,1248,0,0,0,0,0,0,67.71
桃園縣,中壢市,正義里,478,1,951,4,955,1578,0,0,0,0,0,0,60.52
桃園縣,中壢市,正義里,479,1,859,8,867,1409,0,0,0,0,0,0,61.53
桃園縣,中壢市,普慶里,480,1,660,6,666,1015,0,0,0,0,0,0,65.62
桃園縣,中壢市,普慶里,481,1,690,10,700,1022,0,0,0,0,0,0,68.49
桃園縣,中壢市,普義里,482,1,1066,16,1082,1659,0,0,0,0,0,0,65.22
桃園縣,中壢市,德義里,483,1,687,12,699,992,0,0,0,0,0,0,70.46
桃園縣,中壢市,德義里,484,1,719,12,731,1186,0,0,0,0,0,0,61.64
桃園縣,中壢市,仁義里,485,1,765,6,771,1313,0,0,0,0,0,0,58.72
桃園縣,中壢市,仁義里,486,1,562,9,571,873,0,0,0,0,0,0,65.41
桃園縣,中壢市,忠義里,487,1,950,20,970,1473,0,0,0,0,0,0,65.85
桃園縣,中壢市,興仁里,488,1,855,12,867,1283,0,0,0,0,0,0,67.58
桃園縣,中壢市,興仁里,489,1,724,10,734,1200,0,0,0,0,0,0,61.17
桃園縣,中壢市,興仁里,490,1,754,10,764,1191,0,0,0,0,0,0,64.15
桃園縣,中壢市,中正里,491,1,860,12,872,1439,0,0,0,0,0,0,60.60
桃園縣,中壢市,中正里,492,1,990,15,1005,1514,0,0,0,0,0,0,66.38
桃園縣,中壢市,中山里,493,1,880,5,885,1647,0,0,0,0,0,0,53.73
桃園縣,中壢市,中山里,494,1,842,16,858,1605,0,0,0,0,0,0,53.46
桃園縣,中壢市,篤行里,495,1,1006,26,1032,1517,0,0,0,0,0,0,68.03
桃園縣,中壢市,自立里,496,1,693,4,697,1095,0,0,0,0,0,0,63.65
桃園縣,中壢市,自立里,497,1,632,7,639,1235,0,0,0,0,0,0,51.74
桃園縣,中壢市,自強里,498,1,843,11,854,1279,0,0,0,0,0,0,66.77
桃園縣,中壢市,自強里,499,1,745,9,754,1183,0,0,0,0,0,0,63.74
桃園縣,中壢市,自強里,500,1,620,5,625,1020,0,0,0,0,0,0,61.27
桃園縣,中壢市,內壢里,501,1,750,11,761,1183,0,0,0,0,0,0,64.33
桃園縣,中壢市,內壢里,502,1,821,21,842,1298,0,0,0,0,0,0,64.87
桃園縣,中壢市,成功里,503,1,873,14,887,1415,0,0,0,0,0,0,62.69
桃園縣,中壢市,成功里,504,1,573,9,582,894,0,0,0,0,0,0,65.10
桃園縣,中壢市,福德里,505,1,799,12,811,1242,0,0,0,0,0,0,65.30
桃園縣,中壢市,福德里,506,1,775,11,786,1217,0,0,0,0,0,0,64.59
桃園縣,中壢市,中原里,507,1,758,11,769,1098,0,0,0,0,0,0,70.04
桃園縣,中壢市,中原里,508,1,679,6,685,1047,0,0,0,0,0,0,65.43
桃園縣,中壢市,中原里,509,1,904,9,913,1439,0,0,0,0,0,0,63.45
桃園縣,中壢市,忠孝里,510,1,591,8,599,919,0,0,0,0,0,0,65.18
桃園縣,中壢市,忠孝里,511,1,569,15,584,924,0,0,0,0,0,0,63.20
桃園縣,中壢市,復興里,512,1,715,13,728,1129,0,0,0,0,0,0,64.48
桃園縣,中壢市,復興里,513,1,597,5,602,1010,0,0,0,0,0,0,59.60
桃園縣,中壢市,復興里,514,1,747,8,755,1226,0,0,0,0,0,0,61.58
桃園縣,中壢市,復華里,515,1,1054,15,1069,1596,0,0,0,0,0,0,66.98
桃園縣,中壢市,復華里,516,1,1007,11,1018,1566,0,0,0,0,0,0,65.01
桃園縣,中壢市,文化里,517,1,794,8,802,1265,0,0,0,0,0,0,63.40
桃園縣,中壢市,文化里,518,1,765,14,779,1229,0,0,0,0,0,0,63.38
桃園縣,中壢市,文化里,519,1,723,11,734,1188,0,0,0,0,0,0,61.78
桃園縣,中壢市,和平里,520,1,559,14,573,855,0,0,0,0,0,0,67.02
桃園縣,中壢市,和平里,521,1,620,7,627,947,0,0,0,0,0,0,66.21
桃園縣,中壢市,內定里,522,1,775,16,791,1220,0,0,0,0,0,0,64.84
桃園縣,中壢市,內定里,523,1,784,13,797,1241,0,0,0,0,0,0,64.22
桃園縣,中壢市,石頭里,524,1,637,7,644,1073,0,0,0,0,0,0,60.02
桃園縣,中壢市,石頭里,525,1,473,6,479,965,0,0,0,0,0,0,49.64
桃園縣,中壢市,中央里,526,1,819,9,828,1327,0,0,0,0,0,0,62.40
桃園縣,中壢市,中央里,527,1,590,6,596,967,0,0,0,0,0,0,61.63
桃園縣,中壢市,中央里,528,1,760,7,767,1098,0,0,0,0,0,0,69.85
桃園縣,中壢市,新興里,529,1,841,17,858,1387,0,0,0,0,0,0,61.86
桃園縣,中壢市,新興里,530,1,969,10,979,1625,0,0,0,0,0,0,60.25
桃園縣,中壢市,新興里,531,1,1039,14,1053,1691,0,0,0,0,0,0,62.27
桃園縣,中壢市,振興里,532,1,833,10,843,1388,0,0,0,0,0,0,60.73
桃園縣,中壢市,振興里,533,1,833,13,846,1279,0,0,0,0,0,0,66.15
桃園縣,中壢市,振興里,534,1,577,9,586,858,0,0,0,0,0,0,68.30
桃園縣,中壢市,東興里,535,1,809,7,816,1330,0,0,0,0,0,0,61.35
桃園縣,中壢市,東興里,536,1,879,5,884,1398,0,0,0,0,0,0,63.23
桃園縣,中壢市,東興里,537,1,707,5,712,1141,0,0,0,0,0,0,62.40
桃園縣,中壢市,東興里,538,1,719,16,735,1063,0,0,0,0,0,0,69.14
桃園縣,中壢市,水尾里,539,1,819,12,831,1185,0,0,0,0,0,0,70.13
桃園縣,中壢市,水尾里,540,1,808,10,818,1298,0,0,0,0,0,0,63.02
桃園縣,中壢市,水尾里,541,1,724,4,728,1217,0,0,0,0,0,0,59.82
桃園縣,中壢市,忠福里,542,1,698,9,707,1092,0,0,0,0,0,0,64.74
桃園縣,中壢市,忠福里,543,1,790,11,801,1083,0,0,0,0,0,0,73.96
桃園縣,中壢市,忠福里,544,1,808,11,819,1237,0,0,0,0,0,0,66.21
桃園縣,中壢市,忠福里,545,1,664,9,673,1265,0,0,0,0,0,0,53.20
桃園縣,中壢市,幸福里,546,1,728,12,740,1159,0,0,0,0,0,0,63.85
桃園縣,中壢市,幸福里,547,1,585,8,593,1128,0,0,0,0,0,0,52.57
桃園縣,中壢市,幸福里,548,1,604,2,606,1153,0,0,0,0,0,0,52.56
桃園縣,中壢市,永福里,549,1,464,9,473,837,0,0,0,0,0,0,56.51
桃園縣,中壢市,永福里,550,1,830,10,840,1354,0,0,0,0,0,0,62.04
桃園縣,中壢市,永福里,551,1,816,9,825,1395,0,0,0,0,0,0,59.14
桃園縣,中壢市,青埔里,552,1,1032,8,1040,1487,0,0,0,0,0,0,69.94
桃園縣,中壢市,新街里,553,1,1077,6,1083,1808,0,0,0,0,0,0,59.90
桃園縣,中壢市,興南里,554,1,1047,7,1054,1622,0,0,0,0,0,0,64.98
桃園縣,中壢市,興國里,555,1,832,12,844,1369,0,0,0,0,0,0,61.65
桃園縣,中壢市,興國里,556,1,962,13,975,1460,0,0,0,0,0,0,66.78
桃園縣,中壢市,興國里,557,1,1000,10,1010,1587,0,0,0,0,0,0,63.64
桃園縣,中壢市,興和里,558,1,668,11,679,978,0,0,0,0,0,0,69.43
桃園縣,中壢市,興和里,559,1,896,11,907,1333,0,0,0,0,0,0,68.04
桃園縣,中壢市,永興里,560,1,699,4,703,1015,0,0,0,0,0,0,69.26
桃園縣,中壢市,中壢里,561,1,590,5,595,927,0,0,0,0,0,0,64.19
桃園縣,中壢市,中榮里,562,1,656,5,661,1066,0,0,0,0,0,0,62.01
桃園縣,中壢市,中建里,563,1,722,5,727,1109,0,0,0,0,0,0,65.55
桃園縣,中壢市,舊明里,564,1,797,10,807,1199,0,0,0,0,0,0,67.31
桃園縣,中壢市,舊明里,565,1,663,6,669,932,0,0,0,0,0,0,71.78
桃園縣,中壢市,新明里,566,1,687,7,694,1021,0,0,0,0,0,0,67.97
桃園縣,中壢市,新明里,567,1,729,10,739,1126,0,0,0,0,0,0,65.63
桃園縣,中壢市,新明里,568,1,830,8,838,1337,0,0,0,0,0,0,62.68
桃園縣,中壢市,光明里,569,1,596,8,604,1118,0,0,0,0,0,0,54.03
桃園縣,中壢市,光明里,570,1,1017,10,1027,1600,0,0,0,0,0,0,64.19
桃園縣,中壢市,光明里,571,1,864,7,871,1458,0,0,0,0,0,0,59.74
桃園縣,中壢市,永光里,572,1,753,14,767,1174,0,0,0,0,0,0,65.33
桃園縣,中壢市,永光里,573,1,989,9,998,1693,0,0,0,0,0,0,58.95
桃園縣,中壢市,三民里,574,1,798,16,814,1193,0,0,0,0,0,0,68.23
桃園縣,中壢市,三民里,575,1,825,11,836,1239,0,0,0,0,0,0,67.47
桃園縣,中壢市,五權里,576,1,614,9,623,1092,0,0,0,0,0,0,57.05
桃園縣,中壢市,五權里,577,1,774,7,781,1201,0,0,0,0,0,0,65.03
桃園縣,中壢市,五權里,578,1,824,16,840,1278,0,0,0,0,0,0,65.73
桃園縣,中壢市,五福里,579,1,1034,20,1054,1631,0,0,0,0,0,0,64.62
桃園縣,中壢市,五福里,580,1,898,12,910,1484,0,0,0,0,0,0,61.32
桃園縣,中壢市,芝芭里,581,1,651,5,656,936,0,0,0,0,0,0,70.09
桃園縣,中壢市,芝芭里,582,1,715,7,722,1056,0,0,0,0,0,0,68.37
桃園縣,中壢市,洽溪里,583,1,884,15,899,1384,0,0,0,0,0,0,64.96
桃園縣,中壢市,內厝里,584,1,1037,10,1047,1604,0,0,0,0,0,0,65.27
桃園縣,中壢市,內厝里,585,1,949,12,961,1523,0,0,0,0,0,0,63.10
桃園縣,中壢市,月眉里,586,1,1078,12,1090,1484,0,0,0,0,0,0,73.45
桃園縣,中壢市,月眉里,587,1,799,14,813,1222,0,0,0,0,0,0,66.53
桃園縣,中壢市,山東里,588,1,850,18,868,1222,0,0,0,0,0,0,71.03
桃園縣,中壢市,山東里,589,1,990,13,1003,1362,0,0,0,0,0,0,73.64
桃園縣,中壢市,過嶺里,590,1,842,9,851,1162,0,0,0,0,0,0,73.24
桃園縣,中壢市,過嶺里,591,1,694,13,707,1000,0,0,0,0,0,0,70.70
桃園縣,平鎮市,新勢里,592,1,1003,12,1015,1538,0,0,0,0,0,0,65.99
桃園縣,平鎮市,新勢里,593,1,1043,16,1059,1586,0,0,0,0,0,0,66.77
桃園縣,平鎮市,新榮里,594,1,965,17,982,1490,0,0,0,0,0,0,65.91
桃園縣,平鎮市,新榮里,595,1,1072,16,1088,1828,0,0,0,0,0,0,59.52
桃園縣,平鎮市,新富里,596,1,638,7,645,1046,0,0,0,0,0,0,61.66
桃園縣,平鎮市,新富里,597,1,791,11,802,1516,0,0,0,0,0,0,52.90
桃園縣,平鎮市,新富里,598,1,760,7,767,1227,0,0,0,0,0,0,62.51
桃園縣,平鎮市,北華里,599,1,654,10,664,1033,0,0,0,0,0,0,64.28
桃園縣,平鎮市,北華里,600,1,554,14,568,795,0,0,0,0,0,0,71.45
桃園縣,平鎮市,北安里,601,1,1043,10,1053,1599,0,0,0,0,0,0,65.85
桃園縣,平鎮市,北勢里,602,1,744,9,753,1162,0,0,0,0,0,0,64.80
桃園縣,平鎮市,北勢里,603,1,641,8,649,1028,0,0,0,0,0,0,63.13
桃園縣,平鎮市,新貴里,604,1,804,17,821,1308,0,0,0,0,0,0,62.77
桃園縣,平鎮市,新貴里,605,1,665,3,668,969,0,0,0,0,0,0,68.94
桃園縣,平鎮市,金陵里,606,1,1055,13,1068,1500,0,0,0,0,0,0,71.20
桃園縣,平鎮市,北興里,607,1,1124,18,1142,1702,0,0,0,0,0,0,67.10
桃園縣,平鎮市,北興里,608,1,1002,12,1014,1585,0,0,0,0,0,0,63.97
桃園縣,平鎮市,北貴里,609,1,852,12,864,1324,0,0,0,0,0,0,65.26
桃園縣,平鎮市,北貴里,610,1,846,11,857,1310,0,0,0,0,0,0,65.42
桃園縣,平鎮市,北富里,611,1,902,6,908,1443,0,0,0,0,0,0,62.92
桃園縣,平鎮市,北富里,612,1,759,9,768,1180,0,0,0,0,0,0,65.08
桃園縣,平鎮市,龍恩里,613,1,813,23,836,1300,0,0,0,0,0,0,64.31
桃園縣,平鎮市,龍恩里,614,1,738,10,748,1122,0,0,0,0,0,0,66.67
桃園縣,平鎮市,東社里,615,1,941,17,958,1374,0,0,0,0,0,0,69.72
桃園縣,平鎮市,東社里,616,1,994,11,1005,1500,0,0,0,0,0,0,67.00
桃園縣,平鎮市,龍興里,617,1,680,14,694,1064,0,0,0,0,0,0,65.23
桃園縣,平鎮市,龍興里,618,1,706,16,722,1120,0,0,0,0,0,0,64.46
桃園縣,平鎮市,忠貞里,619,1,894,14,908,1305,0,0,0,0,0,0,69.58
桃園縣,平鎮市,中正里,620,1,812,12,824,1296,0,0,0,0,0,0,63.58
桃園縣,平鎮市,貿易里,621,1,938,17,955,1355,0,0,0,0,0,0,70.48
桃園縣,平鎮市,貿易里,622,1,677,14,691,985,0,0,0,0,0,0,70.15
桃園縣,平鎮市,建安里,623,1,898,19,917,1458,0,0,0,0,0,0,62.89
桃園縣,平鎮市,建安里,624,1,1019,16,1035,1507,0,0,0,0,0,0,68.68
桃園縣,平鎮市,華安里,625,1,936,18,954,1474,0,0,0,0,0,0,64.72
桃園縣,平鎮市,華安里,626,1,790,17,807,1227,0,0,0,0,0,0,65.77
桃園縣,平鎮市,東安里,627,1,732,16,748,1089,0,0,0,0,0,0,68.69
桃園縣,平鎮市,東安里,628,1,592,12,604,962,0,0,0,0,0,0,62.79
桃園縣,平鎮市,新安里,629,1,717,17,734,1221,0,0,0,0,0,0,60.11
桃園縣,平鎮市,新安里,630,1,791,16,807,1201,0,0,0,0,0,0,67.19
桃園縣,平鎮市,東勢里,631,1,826,10,836,1187,0,0,0,0,0,0,70.43
桃園縣,平鎮市,東勢里,632,1,701,10,711,1006,0,0,0,0,0,0,70.68
桃園縣,平鎮市,東勢里,633,1,614,5,619,1140,0,0,0,0,0,0,54.30
桃園縣,平鎮市,莊敬里,634,1,895,15,910,1303,0,0,0,0,0,0,69.84
桃園縣,平鎮市,莊敬里,635,1,828,15,843,1233,0,0,0,0,0,0,68.37
桃園縣,平鎮市,莊敬里,636,1,772,17,789,1274,0,0,0,0,0,0,61.93
桃園縣,平鎮市,湧豐里,637,1,881,13,894,1301,0,0,0,0,0,0,68.72
桃園縣,平鎮市,湧光里,638,1,946,8,954,1396,0,0,0,0,0,0,68.34
桃園縣,平鎮市,湧光里,639,1,941,15,956,1407,0,0,0,0,0,0,67.95
桃園縣,平鎮市,湧光里,640,1,907,19,926,1361,0,0,0,0,0,0,68.04
桃園縣,平鎮市,湧安里,641,1,722,16,738,1119,0,0,0,0,0,0,65.95
桃園縣,平鎮市,湧安里,642,1,885,13,898,1351,0,0,0,0,0,0,66.47
桃園縣,平鎮市,廣興里,643,1,976,9,985,1508,0,0,0,0,0,0,65.32
桃園縣,平鎮市,廣興里,644,1,1149,17,1166,1949,0,0,0,0,0,0,59.83
桃園縣,平鎮市,廣達里,645,1,1093,7,1100,1767,0,0,0,0,0,0,62.25
桃園縣,平鎮市,廣達里,646,1,740,12,752,1154,0,0,0,0,0,0,65.16
桃園縣,平鎮市,復旦里,647,1,696,10,706,1168,0,0,0,0,0,0,60.45
桃園縣,平鎮市,復旦里,648,1,835,11,846,1357,0,0,0,0,0,0,62.34
桃園縣,平鎮市,復旦里,649,1,774,11,785,1325,0,0,0,0,0,0,59.25
桃園縣,平鎮市,復旦里,650,1,696,10,706,1066,0,0,0,0,0,0,66.23
桃園縣,平鎮市,義興里,651,1,1059,13,1072,1569,0,0,0,0,0,0,68.32
桃園縣,平鎮市,義興里,652,1,919,10,929,1487,0,0,0,0,0,0,62.47
桃園縣,平鎮市,義興里,653,1,807,9,816,1253,0,0,0,0,0,0,65.12
桃園縣,平鎮市,義民里,654,1,878,16,894,1390,0,0,0,0,0,0,64.32
桃園縣,平鎮市,義民里,655,1,928,5,933,1586,0,0,0,0,0,0,58.83
桃園縣,平鎮市,宋屋里,656,1,1016,19,1035,1607,0,0,0,0,0,0,64.41
桃園縣,平鎮市,宋屋里,657,1,512,9,521,938,0,0,0,0,0,0,55.54
桃園縣,平鎮市,宋屋里,658,1,710,9,719,1309,0,0,0,0,0,0,54.93
桃園縣,平鎮市,廣仁里,659,1,643,10,653,1066,0,0,0,0,0,0,61.26
桃園縣,平鎮市,廣仁里,660,1,589,8,597,1017,0,0,0,0,0,0,58.70
桃園縣,平鎮市,廣仁里,661,1,603,8,611,1105,0,0,0,0,0,0,55.29
桃園縣,平鎮市,雙連里,662,1,802,15,817,1187,0,0,0,0,0,0,68.83
桃園縣,平鎮市,雙連里,663,1,676,4,680,1003,0,0,0,0,0,0,67.80
桃園縣,平鎮市,雙連里,664,1,641,5,646,1019,0,0,0,0,0,0,63.40
桃園縣,平鎮市,高雙里,665,1,713,8,721,1075,0,0,0,0,0,0,67.07
桃園縣,平鎮市,高雙里,666,1,799,7,806,1299,0,0,0,0,0,0,62.05
桃園縣,平鎮市,平鎮里,667,1,562,15,577,891,0,0,0,0,0,0,64.76
桃園縣,平鎮市,平鎮里,668,1,744,19,763,1094,0,0,0,0,0,0,69.74
桃園縣,平鎮市,平鎮里,669,1,644,15,659,946,0,0,0,0,0,0,69.66
桃園縣,平鎮市,鎮興里,670,1,716,12,728,1105,0,0,0,0,0,0,65.88
桃園縣,平鎮市,鎮興里,671,1,638,9,647,936,0,0,0,0,0,0,69.12
桃園縣,平鎮市,金星里,672,1,669,11,680,1136,0,0,0,0,0,0,59.86
桃園縣,平鎮市,金星里,673,1,689,21,710,1138,0,0,0,0,0,0,62.39
桃園縣,平鎮市,金星里,674,1,960,23,983,1558,0,0,0,0,0,0,63.09
桃園縣,平鎮市,金星里,675,1,869,9,878,1316,0,0,0,0,0,0,66.72
桃園縣,平鎮市,金星里,676,1,979,14,993,1546,0,0,0,0,0,0,64.23
桃園縣,平鎮市,南勢里,677,1,1011,17,1028,1511,0,0,0,0,0,0,68.03
桃園縣,平鎮市,南勢里,678,1,910,9,919,1522,0,0,0,0,0,0,60.38
桃園縣,平鎮市,福林里,679,1,560,4,564,794,0,0,0,0,0,0,71.03
桃園縣,平鎮市,福林里,680,1,752,8,760,1119,0,0,0,0,0,0,67.92
桃園縣,平鎮市,山峰里,681,1,657,11,668,1069,0,0,0,0,0,0,62.49
桃園縣,平鎮市,山峰里,682,1,767,9,776,1120,0,0,0,0,0,0,69.29
桃園縣,楊梅鎮,仁美里,683,1,712,14,726,1134,0,0,0,0,0,0,64.02
桃園縣,楊梅鎮,仁美里,684,1,994,17,1011,1481,0,0,0,0,0,0,68.26
桃園縣,楊梅鎮,仁美里,685,1,689,11,700,1069,0,0,0,0,0,0,65.48
桃園縣,楊梅鎮,埔心里,686,1,1083,13,1096,1530,0,0,0,0,0,0,71.63
桃園縣,楊梅鎮,光華里,687,1,825,12,837,1183,0,0,0,0,0,0,70.75
桃園縣,楊梅鎮,光華里,688,1,902,10,912,1381,0,0,0,0,0,0,66.04
桃園縣,楊梅鎮,金龍里,689,1,560,6,566,809,0,0,0,0,0,0,69.96
桃園縣,楊梅鎮,金龍里,690,1,435,4,439,608,0,0,0,0,0,0,72.20
桃園縣,楊梅鎮,四維里,691,1,550,5,555,779,0,0,0,0,0,0,71.25
桃園縣,楊梅鎮,四維里,692,1,643,3,646,916,0,0,0,0,0,0,70.52
桃園縣,楊梅鎮,永平里,693,1,661,10,671,1109,0,0,0,0,0,0,60.50
桃園縣,楊梅鎮,瑞塘里,694,1,1076,19,1095,1627,0,0,0,0,0,0,67.30
桃園縣,楊梅鎮,瑞塘里,695,1,946,13,959,1584,0,0,0,0,0,0,60.54
桃園縣,楊梅鎮,瑞坪里,696,1,1180,8,1188,2010,0,0,0,0,0,0,59.10
桃園縣,楊梅鎮,梅溪里,697,1,747,12,759,1062,0,0,0,0,0,0,71.47
桃園縣,楊梅鎮,梅溪里,698,1,550,7,557,1150,0,0,0,0,0,0,48.43
桃園縣,楊梅鎮,金溪里,699,1,932,6,938,1779,0,0,0,0,0,0,52.73
桃園縣,楊梅鎮,金溪里,700,1,416,3,419,827,0,0,0,0,0,0,50.67
桃園縣,楊梅鎮,楊明里,701,1,683,8,691,1137,0,0,0,0,0,0,60.77
桃園縣,楊梅鎮,楊明里,702,1,695,14,709,1234,0,0,0,0,0,0,57.46
桃園縣,楊梅鎮,裕成里,703,1,1035,15,1050,2143,0,0,0,0,0,0,49.00
桃園縣,楊梅鎮,大同里,704,1,869,8,877,1270,0,0,0,0,0,0,69.06
桃園縣,楊梅鎮,大同里,705,1,889,8,897,1370,0,0,0,0,0,0,65.47
桃園縣,楊梅鎮,中山里,706,1,1022,14,1036,1760,0,0,0,0,0,0,58.86
桃園縣,楊梅鎮,楊梅里,707,1,935,7,942,1350,0,0,0,0,0,0,69.78
桃園縣,楊梅鎮,楊梅里,708,1,876,7,883,1265,0,0,0,0,0,0,69.80
桃園縣,楊梅鎮,楊江里,709,1,771,9,780,1122,0,0,0,0,0,0,69.52
桃園縣,楊梅鎮,梅新里,710,1,926,20,946,1581,0,0,0,0,0,0,59.84
桃園縣,楊梅鎮,紅梅里,711,1,590,6,596,948,0,0,0,0,0,0,62.87
桃園縣,楊梅鎮,紅梅里,712,1,777,5,782,1095,0,0,0,0,0,0,71.42
桃園縣,楊梅鎮,永寧里,713,1,990,15,1005,1459,0,0,0,0,0,0,68.88
桃園縣,楊梅鎮,永寧里,714,1,1080,19,1099,1705,0,0,0,0,0,0,64.46
桃園縣,楊梅鎮,大平里,715,1,911,24,935,1399,0,0,0,0,0,0,66.83
桃園縣,楊梅鎮,大平里,716,1,928,18,946,1383,0,0,0,0,0,0,68.40
桃園縣,楊梅鎮,秀才里,717,1,919,16,935,1281,0,0,0,0,0,0,72.99
桃園縣,楊梅鎮,秀才里,718,1,732,10,742,1206,0,0,0,0,0,0,61.53
桃園縣,楊梅鎮,東流里,719,1,1051,12,1063,1635,0,0,0,0,0,0,65.02
桃園縣,楊梅鎮,豐野里,720,1,1034,20,1054,1519,0,0,0,0,0,0,69.39
桃園縣,楊梅鎮,豐野里,721,1,884,13,897,1253,0,0,0,0,0,0,71.59
桃園縣,楊梅鎮,富岡里,722,1,960,10,970,1299,0,0,0,0,0,0,74.67
桃園縣,楊梅鎮,富岡里,723,1,838,12,850,1203,0,0,0,0,0,0,70.66
桃園縣,楊梅鎮,富岡里,724,1,894,16,910,1353,0,0,0,0,0,0,67.26
桃園縣,楊梅鎮,員本里,725,1,1190,11,1201,1729,0,0,0,0,0,0,69.46
桃園縣,楊梅鎮,三湖里,726,1,599,7,606,1244,0,0,0,0,0,0,48.71
桃園縣,楊梅鎮,三湖里,727,1,811,17,828,1247,0,0,0,0,0,0,66.40
桃園縣,楊梅鎮,上湖里,728,1,844,22,866,1412,0,0,0,0,0,0,61.33
桃園縣,楊梅鎮,上湖里,729,1,762,12,774,1357,0,0,0,0,0,0,57.04
桃園縣,楊梅鎮,上田里,730,1,727,6,733,1058,0,0,0,0,0,0,69.28
桃園縣,楊梅鎮,上田里,731,1,652,5,657,1000,0,0,0,0,0,0,65.70
桃園縣,楊梅鎮,高山里,732,1,670,6,676,1044,0,0,0,0,0,0,64.75
桃園縣,楊梅鎮,高山里,733,1,663,18,681,1117,0,0,0,0,0,0,60.97
桃園縣,楊梅鎮,高山里,734,1,689,19,708,1041,0,0,0,0,0,0,68.01
桃園縣,楊梅鎮,青山里,735,1,639,7,646,1214,0,0,0,0,0,0,53.21
桃園縣,楊梅鎮,高榮里,736,1,866,17,883,1278,0,0,0,0,0,0,69.09
桃園縣,楊梅鎮,高榮里,737,1,448,4,452,733,0,0,0,0,0,0,61.66
桃園縣,楊梅鎮,雙榮里,738,1,810,15,825,1205,0,0,0,0,0,0,68.46
桃園縣,楊梅鎮,新榮里,739,1,985,22,1007,1675,0,0,0,0,0,0,60.12
桃園縣,楊梅鎮,水美里,740,1,966,11,977,1447,0,0,0,0,0,0,67.52
桃園縣,楊梅鎮,水美里,741,1,865,11,876,1355,0,0,0,0,0,0,64.65
桃園縣,楊梅鎮,瑞原里,742,1,943,14,957,1324,0,0,0,0,0,0,72.28
桃園縣,楊梅鎮,瑞原里,743,1,825,13,838,1450,0,0,0,0,0,0,57.79
桃園縣,龍潭鄉,黃唐村,744,1,1090,15,1105,1799,0,0,0,0,0,0,61.42
桃園縣,龍潭鄉,黃唐村,745,1,1197,24,1221,1873,0,0,0,0,0,0,65.19
桃園縣,龍潭鄉,黃唐村,746,1,974,12,986,1533,0,0,0,0,0,0,64.32
桃園縣,龍潭鄉,中山村,747,1,1305,17,1322,1902,0,0,0,0,0,0,69.51
桃園縣,龍潭鄉,中山村,748,1,993,12,1005,1466,0,0,0,0,0,0,68.55
桃園縣,龍潭鄉,烏林村,749,1,929,20,949,1489,0,0,0,0,0,0,63.73
桃園縣,龍潭鄉,烏林村,750,1,631,8,639,1143,0,0,0,0,0,0,55.91
桃園縣,龍潭鄉,烏林村,751,1,821,15,836,1292,0,0,0,0,0,0,64.71
桃園縣,龍潭鄉,烏林村,752,1,937,19,956,1499,0,0,0,0,0,0,63.78
桃園縣,龍潭鄉,干城村,753,1,511,9,520,720,0,0,0,0,0,0,72.22
桃園縣,龍潭鄉,凌雲村,754,1,1188,23,1211,1703,0,0,0,0,0,0,71.11
桃園縣,龍潭鄉,凌雲村,755,1,1045,24,1069,1692,0,0,0,0,0,0,63.18
桃園縣,龍潭鄉,凌雲村,756,1,900,12,912,1350,0,0,0,0,0,0,67.56
桃園縣,龍潭鄉,八德村,757,1,740,12,752,1196,0,0,0,0,0,0,62.88
桃園縣,龍潭鄉,八德村,758,1,607,12,619,975,0,0,0,0,0,0,63.49
桃園縣,龍潭鄉,八德村,759,1,736,14,750,1233,0,0,0,0,0,0,60.83
桃園縣,龍潭鄉,八德村,760,1,849,11,860,1417,0,0,0,0,0,0,60.69
桃園縣,龍潭鄉,上林村,761,1,663,13,676,1014,0,0,0,0,0,0,66.67
桃園縣,龍潭鄉,上林村,762,1,861,8,869,1376,0,0,0,0,0,0,63.15
桃園縣,龍潭鄉,龍潭村,763,1,767,5,772,1083,0,0,0,0,0,0,71.28
桃園縣,龍潭鄉,龍潭村,764,1,678,1,679,926,0,0,0,0,0,0,73.33
桃園縣,龍潭鄉,中正村,765,1,1041,17,1058,1504,0,0,0,0,0,0,70.35
桃園縣,龍潭鄉,中正村,766,1,1127,18,1145,1766,0,0,0,0,0,0,64.84
桃園縣,龍潭鄉,中正村,767,1,914,19,933,1415,0,0,0,0,0,0,65.94
桃園縣,龍潭鄉,中正村,768,1,929,9,938,1554,0,0,0,0,0,0,60.36
桃園縣,龍潭鄉,九龍村,769,1,589,8,597,997,0,0,0,0,0,0,59.88
桃園縣,龍潭鄉,九龍村,770,1,906,13,919,1448,0,0,0,0,0,0,63.47
桃園縣,龍潭鄉,九龍村,771,1,873,17,890,1596,0,0,0,0,0,0,55.76
桃園縣,龍潭鄉,中興村,772,1,811,11,822,1293,0,0,0,0,0,0,63.57
桃園縣,龍潭鄉,中興村,773,1,800,9,809,1310,0,0,0,0,0,0,61.76
桃園縣,龍潭鄉,中興村,774,1,906,17,923,1406,0,0,0,0,0,0,65.65
桃園縣,龍潭鄉,中興村,775,1,1012,21,1033,1651,0,0,0,0,0,0,62.57
桃園縣,龍潭鄉,中興村,776,1,925,21,946,1682,0,0,0,0,0,0,56.24
桃園縣,龍潭鄉,佳安村,777,1,1095,12,1107,1722,0,0,0,0,0,0,64.29
桃園縣,龍潭鄉,佳安村,778,1,841,6,847,1256,0,0,0,0,0,0,67.44
桃園縣,龍潭鄉,三坑村,779,1,863,20,883,1290,0,0,0,0,0,0,68.45
桃園縣,龍潭鄉,大平村,780,1,498,9,507,782,0,0,0,0,0,0,64.83
桃園縣,龍潭鄉,三林村,781,1,895,8,903,1318,0,0,0,0,0,0,68.51
桃園縣,龍潭鄉,三林村,782,1,813,9,822,1262,0,0,0,0,0,0,65.13
桃園縣,龍潭鄉,三林村,783,1,863,7,870,1338,0,0,0,0,0,0,65.02
桃園縣,龍潭鄉,三林村,784,1,912,8,920,1388,0,0,0,0,0,0,66.28
桃園縣,龍潭鄉,三林村,785,1,799,16,815,1342,0,0,0,0,0,0,60.73
桃園縣,龍潭鄉,高平村,786,1,731,8,739,1109,0,0,0,0,0,0,66.64
桃園縣,龍潭鄉,高平村,787,1,622,14,636,1088,0,0,0,0,0,0,58.46
桃園縣,龍潭鄉,高原村,788,1,656,12,668,1018,0,0,0,0,0,0,65.62
桃園縣,龍潭鄉,高原村,789,1,703,12,715,1181,0,0,0,0,0,0,60.54
桃園縣,龍潭鄉,三和村,790,1,563,12,575,802,0,0,0,0,0,0,71.70
桃園縣,龍潭鄉,三水村,791,1,507,3,510,672,0,0,0,0,0,0,75.89
桃園縣,新屋鄉,新屋村,792,1,865,10,875,1158,0,0,0,0,0,0,75.56
桃園縣,新屋鄉,新屋村,793,1,821,2,823,1110,0,0,0,0,0,0,74.14
桃園縣,新屋鄉,新生村,794,1,949,9,958,1221,0,0,0,0,0,0,78.46
桃園縣,新屋鄉,新生村,795,1,1123,7,1130,1534,0,0,0,0,0,0,73.66
桃園縣,新屋鄉,後湖村,796,1,861,10,871,1168,0,0,0,0,0,0,74.57
桃園縣,新屋鄉,清華村,797,1,1001,17,1018,1398,0,0,0,0,0,0,72.82
桃園縣,新屋鄉,清華村,798,1,904,17,921,1294,0,0,0,0,0,0,71.17
桃園縣,新屋鄉,石磊村,799,1,1213,13,1226,1617,0,0,0,0,0,0,75.82
桃園縣,新屋鄉,東明村,800,1,789,7,796,1052,0,0,0,0,0,0,75.67
桃園縣,新屋鄉,社子村,801,1,1042,15,1057,1345,0,0,0,0,0,0,78.59
桃園縣,新屋鄉,埔頂村,802,1,1385,17,1402,1853,0,0,0,0,0,0,75.66
桃園縣,新屋鄉,九斗村,803,1,1213,15,1228,1686,0,0,0,0,0,0,72.84
桃園縣,新屋鄉,頭洲村,804,1,1123,14,1137,1588,0,0,0,0,0,0,71.60
桃園縣,新屋鄉,頭洲村,805,1,739,6,745,1042,0,0,0,0,0,0,71.50
桃園縣,新屋鄉,大坡村,806,1,950,12,962,1328,0,0,0,0,0,0,72.44
桃園縣,新屋鄉,望間村,807,1,1123,8,1131,1498,0,0,0,0,0,0,75.50
桃園縣,新屋鄉,後庄村,808,1,756,12,768,1144,0,0,0,0,0,0,67.13
桃園縣,新屋鄉,蚵間村,809,1,561,8,569,802,0,0,0,0,0,0,70.95
桃園縣,新屋鄉,深圳村,810,1,462,5,467,672,0,0,0,0,0,0,69.49
桃園縣,新屋鄉,康榔村,811,1,798,14,812,1082,0,0,0,0,0,0,75.05
桃園縣,新屋鄉,笨港村,812,1,791,17,808,1096,0,0,0,0,0,0,73.72
桃園縣,新屋鄉,永安村,813,1,634,5,639,881,0,0,0,0,0,0,72.53
桃園縣,新屋鄉,永安村,814,1,881,9,890,1244,0,0,0,0,0,0,71.54
桃園縣,新屋鄉,永興村,815,1,611,7,618,913,0,0,0,0,0,0,67.69
桃園縣,新屋鄉,下埔村,816,1,518,3,521,732,0,0,0,0,0,0,71.17
桃園縣,新屋鄉,石牌村,817,1,571,8,579,820,0,0,0,0,0,0,70.61
桃園縣,新屋鄉,下田村,818,1,1065,12,1077,1482,0,0,0,0,0,0,72.67
桃園縣,新屋鄉,赤欄村,819,1,772,15,787,1054,0,0,0,0,0,0,74.67
桃園縣,觀音鄉,觀音村,820,1,792,13,805,1106,0,0,0,0,0,0,72.78
桃園縣,觀音鄉,觀音村,821,1,818,9,827,1137,0,0,0,0,0,0,72.74
桃園縣,觀音鄉,白玉村,822,1,846,15,861,1133,0,0,0,0,0,0,75.99
桃園縣,觀音鄉,廣興村,823,1,876,13,889,1270,0,0,0,0,0,0,70.00
桃園縣,觀音鄉,大潭村,824,1,774,8,782,1072,0,0,0,0,0,0,72.95
桃園縣,觀音鄉,保生村,825,1,1011,13,1024,1440,0,0,0,0,0,0,71.11
桃園縣,觀音鄉,武威村,826,1,482,4,486,667,0,0,0,0,0,0,72.86
桃園縣,觀音鄉,三和村,827,1,553,2,555,723,0,0,0,0,0,0,76.76
桃園縣,觀音鄉,新興村,828,1,522,5,527,691,0,0,0,0,0,0,76.27
桃園縣,觀音鄉,坑尾村,829,1,788,15,803,1146,0,0,0,0,0,0,70.07
桃園縣,觀音鄉,金湖村,830,1,1113,15,1128,1682,0,0,0,0,0,0,67.06
桃園縣,觀音鄉,藍埔村,831,1,1186,14,1200,1674,0,0,0,0,0,0,71.68
桃園縣,觀音鄉,大同村,832,1,1052,22,1074,1546,0,0,0,0,0,0,69.47
桃園縣,觀音鄉,大堀村,833,1,630,5,635,955,0,0,0,0,0,0,66.49
桃園縣,觀音鄉,崙坪村,834,1,1004,14,1018,1537,0,0,0,0,0,0,66.23
桃園縣,觀音鄉,崙坪村,835,1,1129,30,1159,1651,0,0,0,0,0,0,70.20
桃園縣,觀音鄉,富源村,836,1,1020,18,1038,1669,0,0,0,0,0,0,62.19
桃園縣,觀音鄉,上大村,837,1,1023,16,1039,1523,0,0,0,0,0,0,68.22
桃園縣,觀音鄉,新坡村,838,1,846,10,856,1216,0,0,0,0,0,0,70.39
桃園縣,觀音鄉,新坡村,839,1,805,18,823,1244,0,0,0,0,0,0,66.16
桃園縣,觀音鄉,廣福村,840,1,1156,16,1172,1664,0,0,0,0,0,0,70.43
桃園縣,觀音鄉,塔腳村,841,1,724,9,733,963,0,0,0,0,0,0,76.12
桃園縣,觀音鄉,保障村,842,1,1122,13,1135,1623,0,0,0,0,0,0,69.93
桃園縣,觀音鄉,草漯村,843,1,1034,13,1047,1426,0,0,0,0,0,0,73.42
桃園縣,觀音鄉,草漯村,844,1,833,19,852,1413,0,0,0,0,0,0,60.30
桃園縣,觀音鄉,樹林村,845,1,882,11,893,1446,0,0,0,0,0,0,61.76
桃園縣,觀音鄉,富林村,846,1,828,12,840,1269,0,0,0,0,0,0,66.19
新竹縣,竹北市,鹿場里,1,1,643,9,652,979,0,0,0,0,0,0,66.60
新竹縣,竹北市,東平里,2,1,297,5,302,455,0,0,0,0,0,0,66.37
新竹縣,竹北市,中興里,3,1,800,9,809,1423,0,0,0,0,0,0,56.85
新竹縣,竹北市,隘口里,4,1,490,5,495,812,0,0,0,0,0,0,60.96
新竹縣,竹北市,東海里,5,1,709,12,721,1214,0,0,0,0,0,0,59.39
新竹縣,竹北市,東海里,6,1,653,5,658,1030,0,0,0,0,0,0,63.88
新竹縣,竹北市,十興里,7,1,584,6,590,1021,0,0,0,0,0,0,57.79
新竹縣,竹北市,十興里,8,1,682,12,694,1079,0,0,0,0,0,0,64.32
新竹縣,竹北市,十興里,9,1,467,11,478,881,0,0,0,0,0,0,54.26
新竹縣,竹北市,十興里,10,1,511,12,523,907,0,0,0,0,0,0,57.66
新竹縣,竹北市,斗崙里,11,1,708,6,714,1345,0,0,0,0,0,0,53.09
新竹縣,竹北市,斗崙里,12,1,763,11,774,1447,0,0,0,0,0,0,53.49
新竹縣,竹北市,斗崙里,13,1,713,5,718,1361,0,0,0,0,0,0,52.76
新竹縣,竹北市,斗崙里,14,1,683,8,691,1374,0,0,0,0,0,0,50.29
新竹縣,竹北市,斗崙里,15,1,535,5,540,969,0,0,0,0,0,0,55.73
新竹縣,竹北市,斗崙里,16,1,429,7,436,822,0,0,0,0,0,0,53.04
新竹縣,竹北市,竹北里,17,1,440,2,442,878,0,0,0,0,0,0,50.34
新竹縣,竹北市,竹北里,18,1,596,2,598,993,0,0,0,0,0,0,60.22
新竹縣,竹北市,竹北里,19,1,491,6,497,848,0,0,0,0,0,0,58.61
新竹縣,竹北市,竹仁里,20,1,539,8,547,1088,0,0,0,0,0,0,50.28
新竹縣,竹北市,竹仁里,21,1,580,7,587,1092,0,0,0,0,0,0,53.75
新竹縣,竹北市,竹仁里,22,1,522,4,526,1029,0,0,0,0,0,0,51.12
新竹縣,竹北市,竹仁里,23,1,474,7,481,985,0,0,0,0,0,0,48.83
新竹縣,竹北市,竹仁里,24,1,640,7,647,1061,0,0,0,0,0,0,60.98
新竹縣,竹北市,竹義里,25,1,525,6,531,939,0,0,0,0,0,0,56.55
新竹縣,竹北市,竹義里,26,1,555,6,561,990,0,0,0,0,0,0,56.67
新竹縣,竹北市,竹義里,27,1,524,6,530,1020,0,0,0,0,0,0,51.96
新竹縣,竹北市,竹義里,28,1,409,4,413,871,0,0,0,0,0,0,47.42
新竹縣,竹北市,竹義里,29,1,554,5,559,1025,0,0,0,0,0,0,54.54
新竹縣,竹北市,竹義里,30,1,485,8,493,1065,0,0,0,0,0,0,46.29
新竹縣,竹北市,泰和里,31,1,666,8,674,1098,0,0,0,0,0,0,61.38
新竹縣,竹北市,泰和里,32,1,549,5,554,1030,0,0,0,0,0,0,53.79
新竹縣,竹北市,泰和里,33,1,402,7,409,671,0,0,0,0,0,0,60.95
新竹縣,竹北市,新社里,34,1,549,6,555,1099,0,0,0,0,0,0,50.50
新竹縣,竹北市,新社里,35,1,508,8,516,1147,0,0,0,0,0,0,44.99
新竹縣,竹北市,新社里,36,1,512,14,526,1145,0,0,0,0,0,0,45.94
新竹縣,竹北市,新社里,37,1,498,7,505,1014,0,0,0,0,0,0,49.80
新竹縣,竹北市,新國里,38,1,519,9,528,1036,0,0,0,0,0,0,50.97
新竹縣,竹北市,新國里,39,1,527,6,533,1105,0,0,0,0,0,0,48.24
新竹縣,竹北市,新國里,40,1,456,5,461,872,0,0,0,0,0,0,52.87
新竹縣,竹北市,聯興里,41,1,469,13,482,902,0,0,0,0,0,0,53.44
新竹縣,竹北市,聯興里,42,1,454,3,457,765,0,0,0,0,0,0,59.74
新竹縣,竹北市,聯興里,43,1,529,10,539,882,0,0,0,0,0,0,61.11
新竹縣,竹北市,麻園里,44,1,604,7,611,1083,0,0,0,0,0,0,56.42
新竹縣,竹北市,溪州里,45,1,389,5,394,664,0,0,0,0,0,0,59.34
新竹縣,竹北市,溪州里,46,1,411,6,417,800,0,0,0,0,0,0,52.13
新竹縣,竹北市,新庄里,47,1,498,6,504,831,0,0,0,0,0,0,60.65
新竹縣,竹北市,白地里,48,1,364,10,374,625,0,0,0,0,0,0,59.84
新竹縣,竹北市,白地里,49,1,406,11,417,822,0,0,0,0,0,0,50.73
新竹縣,竹北市,新港里,50,1,486,11,497,988,0,0,0,0,0,0,50.30
新竹縣,竹北市,大眉里,51,1,615,13,628,1149,0,0,0,0,0,0,54.66
新竹縣,竹北市,大義里,52,1,426,6,432,749,0,0,0,0,0,0,57.68
新竹縣,竹北市,大義里,53,1,312,6,318,500,0,0,0,0,0,0,63.60
新竹縣,竹北市,尚義里,54,1,684,11,695,1255,0,0,0,0,0,0,55.38
新竹縣,竹北市,崇義里,55,1,405,2,407,776,0,0,0,0,0,0,52.45
新竹縣,竹北市,崇義里,56,1,354,6,360,671,0,0,0,0,0,0,53.65
新竹縣,竹東鎮,上坪里,57,1,295,5,300,417,0,0,0,0,0,0,71.94
新竹縣,竹東鎮,瑞峰里,58,1,217,5,222,353,0,0,0,0,0,0,62.89
新竹縣,竹東鎮,軟橋里,59,1,269,2,271,383,0,0,0,0,0,0,70.76
新竹縣,竹東鎮,員崠里,60,1,497,4,501,751,0,0,0,0,0,0,66.71
新竹縣,竹東鎮,員崠里,61,1,538,7,545,977,0,0,0,0,0,0,55.78
新竹縣,竹東鎮,上館里,62,1,632,9,641,1095,0,0,0,0,0,0,58.54
新竹縣,竹東鎮,上館里,63,1,632,6,638,1126,0,0,0,0,0,0,56.66
新竹縣,竹東鎮,上館里,64,1,620,9,629,1122,0,0,0,0,0,0,56.06
新竹縣,竹東鎮,上館里,65,1,641,10,651,1126,0,0,0,0,0,0,57.82
新竹縣,竹東鎮,上館里,66,1,580,15,595,993,0,0,0,0,0,0,59.92
新竹縣,竹東鎮,東寧里,67,1,564,7,571,889,0,0,0,0,0,0,64.23
新竹縣,竹東鎮,東寧里,68,1,530,2,532,846,0,0,0,0,0,0,62.88
新竹縣,竹東鎮,東寧里,69,1,589,5,594,897,0,0,0,0,0,0,66.22
新竹縣,竹東鎮,中正里,70,1,388,6,394,649,0,0,0,0,0,0,60.71
新竹縣,竹東鎮,中正里,71,1,473,9,482,724,0,0,0,0,0,0,66.57
新竹縣,竹東鎮,大鄉里,72,1,536,10,546,939,0,0,0,0,0,0,58.15
新竹縣,竹東鎮,大鄉里,73,1,662,11,673,1075,0,0,0,0,0,0,62.60
新竹縣,竹東鎮,大鄉里,74,1,558,8,566,895,0,0,0,0,0,0,63.24
新竹縣,竹東鎮,中山里,75,1,597,11,608,918,0,0,0,0,0,0,66.23
新竹縣,竹東鎮,中山里,76,1,604,2,606,920,0,0,0,0,0,0,65.87
新竹縣,竹東鎮,南華里,77,1,751,13,764,1202,0,0,0,0,0,0,63.56
新竹縣,竹東鎮,東華里,78,1,525,3,528,789,0,0,0,0,0,0,66.92
新竹縣,竹東鎮,商華里,79,1,650,6,656,1079,0,0,0,0,0,0,60.80
新竹縣,竹東鎮,商華里,80,1,667,13,680,1005,0,0,0,0,0,0,67.66
新竹縣,竹東鎮,雞林里,81,1,546,10,556,963,0,0,0,0,0,0,57.74
新竹縣,竹東鎮,雞林里,82,1,761,5,766,1240,0,0,0,0,0,0,61.77
新竹縣,竹東鎮,雞林里,83,1,630,10,640,1013,0,0,0,0,0,0,63.18
新竹縣,竹東鎮,仁愛里,84,1,826,10,836,1294,0,0,0,0,0,0,64.61
新竹縣,竹東鎮,仁愛里,85,1,822,5,827,1224,0,0,0,0,0,0,67.57
新竹縣,竹東鎮,竹東里,86,1,454,6,460,662,0,0,0,0,0,0,69.49
新竹縣,竹東鎮,竹東里,87,1,525,10,535,826,0,0,0,0,0,0,64.77
新竹縣,竹東鎮,忠孝里,88,1,744,11,755,1270,0,0,0,0,0,0,59.45
新竹縣,竹東鎮,榮樂里,89,1,466,4,470,709,0,0,0,0,0,0,66.29
新竹縣,竹東鎮,榮樂里,90,1,464,2,466,711,0,0,0,0,0,0,65.54
新竹縣,竹東鎮,榮華里,91,1,672,10,682,1065,0,0,0,0,0,0,64.04
新竹縣,竹東鎮,榮華里,92,1,702,7,709,1021,0,0,0,0,0,0,69.44
新竹縣,竹東鎮,榮華里,93,1,514,7,521,840,0,0,0,0,0,0,62.02
新竹縣,竹東鎮,榮華里,94,1,737,6,743,1161,0,0,0,0,0,0,64.00
新竹縣,竹東鎮,榮華里,95,1,588,10,598,951,0,0,0,0,0,0,62.88
新竹縣,竹東鎮,五豐里,96,1,701,6,707,1394,0,0,0,0,0,0,50.72
新竹縣,竹東鎮,五豐里,97,1,521,10,531,894,0,0,0,0,0,0,59.40
新竹縣,竹東鎮,五豐里,98,1,404,8,412,681,0,0,0,0,0,0,60.50
新竹縣,竹東鎮,五豐里,99,1,481,6,487,847,0,0,0,0,0,0,57.50
新竹縣,竹東鎮,五豐里,100,1,447,9,456,736,0,0,0,0,0,0,61.96
新竹縣,竹東鎮,陸豐里,101,1,317,2,319,464,0,0,0,0,0,0,68.75
新竹縣,竹東鎮,三重里,102,1,454,9,463,782,0,0,0,0,0,0,59.21
新竹縣,竹東鎮,三重里,103,1,358,5,363,652,0,0,0,0,0,0,55.67
新竹縣,竹東鎮,三重里,104,1,472,4,476,876,0,0,0,0,0,0,54.34
新竹縣,竹東鎮,三重里,105,1,378,9,387,654,0,0,0,0,0,0,59.17
新竹縣,竹東鎮,三重里,106,1,584,9,593,1031,0,0,0,0,0,0,57.52
新竹縣,竹東鎮,二重里,107,1,772,10,782,1270,0,0,0,0,0,0,61.57
新竹縣,竹東鎮,二重里,108,1,476,8,484,748,0,0,0,0,0,0,64.71
新竹縣,竹東鎮,二重里,109,1,655,7,662,1175,0,0,0,0,0,0,56.34
新竹縣,竹東鎮,二重里,110,1,668,10,678,1163,0,0,0,0,0,0,58.30
新竹縣,竹東鎮,二重里,111,1,496,8,504,879,0,0,0,0,0,0,57.34
新竹縣,竹東鎮,頭重里,112,1,580,10,590,1023,0,0,0,0,0,0,57.67
新竹縣,竹東鎮,頭重里,113,1,587,6,593,1006,0,0,0,0,0,0,58.95
新竹縣,竹東鎮,頭重里,114,1,737,13,750,1216,0,0,0,0,0,0,61.68
新竹縣,竹東鎮,員山里,115,1,839,12,851,1332,0,0,0,0,0,0,63.89
新竹縣,竹東鎮,柯湖里,116,1,394,7,401,695,0,0,0,0,0,0,57.70
新竹縣,新埔鎮,新埔里,117,1,630,15,645,992,0,0,0,0,0,0,65.02
新竹縣,新埔鎮,新生里,118,1,431,6,437,670,0,0,0,0,0,0,65.22
新竹縣,新埔鎮,新民里,119,1,632,4,636,1010,0,0,0,0,0,0,62.97
新竹縣,新埔鎮,田新里,120,1,941,17,958,1480,0,0,0,0,0,0,64.73
新竹縣,新埔鎮,田新里,121,1,534,4,538,812,0,0,0,0,0,0,66.26
新竹縣,新埔鎮,旱坑里,122,1,501,7,508,857,0,0,0,0,0,0,59.28
新竹縣,新埔鎮,旱坑里,123,1,463,3,466,764,0,0,0,0,0,0,60.99
新竹縣,新埔鎮,五埔里,124,1,549,9,558,853,0,0,0,0,0,0,65.42
新竹縣,新埔鎮,五埔里,125,1,586,5,591,888,0,0,0,0,0,0,66.55
新竹縣,新埔鎮,四座里,126,1,925,14,939,1491,0,0,0,0,0,0,62.98
新竹縣,新埔鎮,四座里,127,1,728,7,735,1174,0,0,0,0,0,0,62.61
新竹縣,新埔鎮,照門里,128,1,929,12,941,1394,0,0,0,0,0,0,67.50
新竹縣,新埔鎮,清水里,129,1,303,3,306,440,0,0,0,0,0,0,69.55
新竹縣,新埔鎮,鹿鳴里,130,1,439,8,447,692,0,0,0,0,0,0,64.60
新竹縣,新埔鎮,新北里,131,1,422,9,431,613,0,0,0,0,0,0,70.31
新竹縣,新埔鎮,巨埔里,132,1,776,11,787,1084,0,0,0,0,0,0,72.60
新竹縣,新埔鎮,內立里,133,1,709,12,721,1074,0,0,0,0,0,0,67.13
新竹縣,新埔鎮,寶石里,134,1,457,3,460,701,0,0,0,0,0,0,65.62
新竹縣,新埔鎮,文山里,135,1,767,16,783,1246,0,0,0,0,0,0,62.84
新竹縣,新埔鎮,文山里,136,1,617,11,628,988,0,0,0,0,0,0,63.56
新竹縣,新埔鎮,文山里,137,1,673,12,685,1211,0,0,0,0,0,0,56.56
新竹縣,新埔鎮,上寮里,138,1,929,8,937,1524,0,0,0,0,0,0,61.48
新竹縣,新埔鎮,下寮里,139,1,570,10,580,874,0,0,0,0,0,0,66.36
新竹縣,新埔鎮,下寮里,140,1,470,7,477,790,0,0,0,0,0,0,60.38
新竹縣,新埔鎮,南平里,141,1,635,10,645,978,0,0,0,0,0,0,65.95
新竹縣,新埔鎮,北平里,142,1,453,3,456,657,0,0,0,0,0,0,69.41
新竹縣,關西鎮,東興里,143,1,422,4,426,600,0,0,0,0,0,0,71.00
新竹縣,關西鎮,西安里,144,1,1023,21,1044,1564,0,0,0,0,0,0,66.75
新竹縣,關西鎮,南雄里,145,1,490,6,496,745,0,0,0,0,0,0,66.58
新竹縣,關西鎮,北斗里,146,1,543,5,548,862,0,0,0,0,0,0,63.57
新竹縣,關西鎮,北斗里,147,1,719,6,725,1089,0,0,0,0,0,0,66.57
新竹縣,關西鎮,北斗里,148,1,845,13,858,1413,0,0,0,0,0,0,60.72
新竹縣,關西鎮,北山里,149,1,507,4,511,741,0,0,0,0,0,0,68.96
新竹縣,關西鎮,仁安里,150,1,577,8,585,898,0,0,0,0,0,0,65.14
新竹縣,關西鎮,南山里,151,1,634,9,643,1019,0,0,0,0,0,0,63.10
新竹縣,關西鎮,東安里,152,1,791,10,801,1275,0,0,0,0,0,0,62.82
新竹縣,關西鎮,東安里,153,1,798,14,812,1333,0,0,0,0,0,0,60.92
新竹縣,關西鎮,東山里,154,1,456,7,463,719,0,0,0,0,0,0,64.39
新竹縣,關西鎮,東光里,155,1,671,11,682,1104,0,0,0,0,0,0,61.78
新竹縣,關西鎮,南新里,156,1,668,9,677,975,0,0,0,0,0,0,69.44
新竹縣,關西鎮,新富里,157,1,400,12,412,610,0,0,0,0,0,0,67.54
新竹縣,關西鎮,玉山里,158,1,342,7,349,529,0,0,0,0,0,0,65.97
新竹縣,關西鎮,金山里,159,1,404,5,409,639,0,0,0,0,0,0,64.01
新竹縣,關西鎮,錦山里,160,1,527,5,532,918,0,0,0,0,0,0,57.95
新竹縣,關西鎮,大同里,161,1,474,3,477,699,0,0,0,0,0,0,68.24
新竹縣,關西鎮,石光里,162,1,614,7,621,869,0,0,0,0,0,0,71.46
新竹縣,關西鎮,石光里,163,1,589,8,597,900,0,0,0,0,0,0,66.33
新竹縣,關西鎮,東平里,164,1,612,8,620,947,0,0,0,0,0,0,65.47
新竹縣,關西鎮,上林里,165,1,596,7,603,821,0,0,0,0,0,0,73.45
新竹縣,關西鎮,新力里,166,1,457,4,461,634,0,0,0,0,0,0,72.71
新竹縣,關西鎮,南和里,167,1,546,4,550,761,0,0,0,0,0,0,72.27
新竹縣,湖口鄉,和興村,168,1,787,8,795,1191,0,0,0,0,0,0,66.75
新竹縣,湖口鄉,和興村,169,1,758,13,771,1287,0,0,0,0,0,0,59.91
新竹縣,湖口鄉,和興村,170,1,566,13,579,1013,0,0,0,0,0,0,57.16
新竹縣,湖口鄉,和興村,171,1,612,12,624,962,0,0,0,0,0,0,64.86
新竹縣,湖口鄉,德盛村,172,1,633,12,645,981,0,0,0,0,0,0,65.75
新竹縣,湖口鄉,德盛村,173,1,579,6,585,1009,0,0,0,0,0,0,57.98
新竹縣,湖口鄉,德盛村,174,1,555,10,565,953,0,0,0,0,0,0,59.29
新竹縣,湖口鄉,愛勢村,175,1,710,13,723,1095,0,0,0,0,0,0,66.03
新竹縣,湖口鄉,愛勢村,176,1,737,13,750,1227,0,0,0,0,0,0,61.12
新竹縣,湖口鄉,愛勢村,177,1,656,16,672,1171,0,0,0,0,0,0,57.39
新竹縣,湖口鄉,仁勢村,178,1,551,4,555,825,0,0,0,0,0,0,67.27
新竹縣,湖口鄉,孝勢村,179,1,733,10,743,1137,0,0,0,0,0,0,65.35
新竹縣,湖口鄉,中勢村,180,1,520,8,528,833,0,0,0,0,0,0,63.39
新竹縣,湖口鄉,中勢村,181,1,774,10,784,1260,0,0,0,0,0,0,62.22
新竹縣,湖口鄉,中勢村,182,1,718,7,725,1147,0,0,0,0,0,0,63.21
新竹縣,湖口鄉,中勢村,183,1,625,13,638,859,0,0,0,0,0,0,74.27
新竹縣,湖口鄉,信勢村,184,1,603,11,614,944,0,0,0,0,0,0,65.04
新竹縣,湖口鄉,信勢村,185,1,635,11,646,1019,0,0,0,0,0,0,63.40
新竹縣,湖口鄉,信勢村,186,1,593,10,603,1010,0,0,0,0,0,0,59.70
新竹縣,湖口鄉,信勢村,187,1,570,10,580,927,0,0,0,0,0,0,62.57
新竹縣,湖口鄉,信勢村,188,1,578,12,590,1005,0,0,0,0,0,0,58.71
新竹縣,湖口鄉,波羅村,189,1,594,13,607,1000,0,0,0,0,0,0,60.70
新竹縣,湖口鄉,長嶺村,190,1,614,18,632,984,0,0,0,0,0,0,64.23
新竹縣,湖口鄉,長嶺村,191,1,807,15,822,1335,0,0,0,0,0,0,61.57
新竹縣,湖口鄉,長安村,192,1,627,2,629,997,0,0,0,0,0,0,63.09
新竹縣,湖口鄉,湖口村,193,1,691,8,699,1143,0,0,0,0,0,0,61.15
新竹縣,湖口鄉,湖口村,194,1,641,4,645,999,0,0,0,0,0,0,64.56
新竹縣,湖口鄉,湖鏡村,195,1,784,13,797,1158,0,0,0,0,0,0,68.83
新竹縣,湖口鄉,湖鏡村,196,1,540,10,550,875,0,0,0,0,0,0,62.86
新竹縣,湖口鄉,湖南村,197,1,769,14,783,1264,0,0,0,0,0,0,61.95
新竹縣,湖口鄉,中興村,198,1,702,14,716,1014,0,0,0,0,0,0,70.61
新竹縣,湖口鄉,中興村,199,1,705,27,732,1070,0,0,0,0,0,0,68.41
新竹縣,湖口鄉,中興村,200,1,546,5,551,1039,0,0,0,0,0,0,53.03
新竹縣,湖口鄉,鳳凰村,201,1,471,7,478,865,0,0,0,0,0,0,55.26
新竹縣,湖口鄉,鳳凰村,202,1,588,11,599,1012,0,0,0,0,0,0,59.19
新竹縣,湖口鄉,鳳凰村,203,1,442,6,448,815,0,0,0,0,0,0,54.97
新竹縣,湖口鄉,鳳凰村,204,1,601,9,610,1097,0,0,0,0,0,0,55.61
新竹縣,湖口鄉,鳳凰村,205,1,511,8,519,806,0,0,0,0,0,0,64.39
新竹縣,湖口鄉,鳳山村,206,1,675,12,687,1226,0,0,0,0,0,0,56.04
新竹縣,湖口鄉,鳳山村,207,1,710,18,728,1163,0,0,0,0,0,0,62.60
新竹縣,新豐鄉,福興村,208,1,545,9,554,794,0,0,0,0,0,0,69.77
新竹縣,新豐鄉,後湖村,209,1,969,16,985,1578,0,0,0,0,0,0,62.42
新竹縣,新豐鄉,青埔村,210,1,821,12,833,1281,0,0,0,0,0,0,65.03
新竹縣,新豐鄉,埔和村,211,1,613,4,617,1190,0,0,0,0,0,0,51.85
新竹縣,新豐鄉,埔和村,212,1,395,4,399,835,0,0,0,0,0,0,47.78
新竹縣,新豐鄉,坡頭村,213,1,482,7,489,755,0,0,0,0,0,0,64.77
新竹縣,新豐鄉,新豐村,214,1,544,13,557,987,0,0,0,0,0,0,56.43
新竹縣,新豐鄉,新豐村,215,1,509,13,522,970,0,0,0,0,0,0,53.81
新竹縣,新豐鄉,瑞興村,216,1,735,14,749,1269,0,0,0,0,0,0,59.02
新竹縣,新豐鄉,中崙村,217,1,1028,14,1042,1795,0,0,0,0,0,0,58.05
新竹縣,新豐鄉,重興村,218,1,775,6,781,1340,0,0,0,0,0,0,58.28
新竹縣,新豐鄉,重興村,219,1,764,6,770,1284,0,0,0,0,0,0,59.97
新竹縣,新豐鄉,重興村,220,1,775,13,788,1528,0,0,0,0,0,0,51.57
新竹縣,新豐鄉,重興村,221,1,495,13,508,1011,0,0,0,0,0,0,50.25
新竹縣,新豐鄉,上坑村,222,1,701,11,712,1176,0,0,0,0,0,0,60.54
新竹縣,新豐鄉,鳳坑村,223,1,563,7,570,903,0,0,0,0,0,0,63.12
新竹縣,新豐鄉,員山村,224,1,751,11,762,1307,0,0,0,0,0,0,58.30
新竹縣,新豐鄉,員山村,225,1,893,16,909,1627,0,0,0,0,0,0,55.87
新竹縣,新豐鄉,員山村,226,1,826,15,841,1400,0,0,0,0,0,0,60.07
新竹縣,新豐鄉,員山村,227,1,838,16,854,1477,0,0,0,0,0,0,57.82
新竹縣,新豐鄉,松林村,228,1,626,10,636,1147,0,0,0,0,0,0,55.45
新竹縣,新豐鄉,松林村,229,1,621,12,633,1296,0,0,0,0,0,0,48.84
新竹縣,新豐鄉,松林村,230,1,701,18,719,1330,0,0,0,0,0,0,54.06
新竹縣,芎林鄉,華龍村,231,1,314,2,316,431,0,0,0,0,0,0,73.32
新竹縣,芎林鄉,五龍村,232,1,370,6,376,508,0,0,0,0,0,0,74.02
新竹縣,芎林鄉,秀湖村,233,1,513,3,516,760,0,0,0,0,0,0,67.89
新竹縣,芎林鄉,永興村,234,1,276,2,278,379,0,0,0,0,0,0,73.35
新竹縣,芎林鄉,石潭村,235,1,620,3,623,912,0,0,0,0,0,0,68.31
新竹縣,芎林鄉,石潭村,236,1,840,11,851,1291,0,0,0,0,0,0,65.92
新竹縣,芎林鄉,新鳳村,237,1,974,14,988,1397,0,0,0,0,0,0,70.72
新竹縣,芎林鄉,中坑村,238,1,383,4,387,533,0,0,0,0,0,0,72.61
新竹縣,芎林鄉,水坑村,239,1,380,5,385,577,0,0,0,0,0,0,66.72
新竹縣,芎林鄉,文林村,240,1,725,8,733,1079,0,0,0,0,0,0,67.93
新竹縣,芎林鄉,文林村,241,1,527,10,537,765,0,0,0,0,0,0,70.20
新竹縣,芎林鄉,芎林村,242,1,966,16,982,1397,0,0,0,0,0,0,70.29
新竹縣,芎林鄉,上山村,243,1,797,5,802,1202,0,0,0,0,0,0,66.72
新竹縣,芎林鄉,上山村,244,1,756,7,763,1243,0,0,0,0,0,0,61.38
新竹縣,芎林鄉,下山村,245,1,722,9,731,1018,0,0,0,0,0,0,71.81
新竹縣,橫山鄉,橫山村,246,1,773,5,778,1147,0,0,0,0,0,0,67.83
新竹縣,橫山鄉,橫山村,247,1,586,2,588,919,0,0,0,0,0,0,63.98
新竹縣,橫山鄉,橫山村,248,1,685,12,697,1102,0,0,0,0,0,0,63.25
新竹縣,橫山鄉,田寮村,249,1,560,5,565,812,0,0,0,0,0,0,69.58
新竹縣,橫山鄉,南昌村,250,1,102,1,103,145,0,0,0,0,0,0,71.03
新竹縣,橫山鄉,豐鄉村,251,1,90,2,92,135,0,0,0,0,0,0,68.15
新竹縣,橫山鄉,豐田村,252,1,214,1,215,327,0,0,0,0,0,0,65.75
新竹縣,橫山鄉,內灣村,253,1,705,8,713,1103,0,0,0,0,0,0,64.64
新竹縣,橫山鄉,力行村,254,1,415,3,418,597,0,0,0,0,0,0,70.02
新竹縣,橫山鄉,力行村,255,1,184,3,187,262,0,0,0,0,0,0,71.37
新竹縣,橫山鄉,福興村,256,1,323,4,327,481,0,0,0,0,0,0,67.98
新竹縣,橫山鄉,沙坑村,257,1,511,11,522,760,0,0,0,0,0,0,68.68
新竹縣,橫山鄉,沙坑村,258,1,260,2,262,371,0,0,0,0,0,0,70.62
新竹縣,橫山鄉,新興村,259,1,508,8,516,718,0,0,0,0,0,0,71.87
新竹縣,橫山鄉,新興村,260,1,580,7,587,804,0,0,0,0,0,0,73.01
新竹縣,橫山鄉,大肚村,261,1,893,12,905,1283,0,0,0,0,0,0,70.54
新竹縣,北埔鄉,北埔村,262,1,723,2,725,1127,0,0,0,0,0,0,64.33
新竹縣,北埔鄉,南興村,263,1,822,7,829,1275,0,0,0,0,0,0,65.02
新竹縣,北埔鄉,大湖村,264,1,327,5,332,482,0,0,0,0,0,0,68.88
新竹縣,北埔鄉,埔尾村,265,1,597,6,603,879,0,0,0,0,0,0,68.60
新竹縣,北埔鄉,埔尾村,266,1,892,14,906,1419,0,0,0,0,0,0,63.85
新竹縣,北埔鄉,水際村,267,1,467,8,475,762,0,0,0,0,0,0,62.34
新竹縣,北埔鄉,南埔村,268,1,218,5,223,327,0,0,0,0,0,0,68.20
新竹縣,北埔鄉,大林村,269,1,413,8,421,620,0,0,0,0,0,0,67.90
新竹縣,北埔鄉,南坑村,270,1,227,3,230,347,0,0,0,0,0,0,66.28
新竹縣,北埔鄉,外坪村,271,1,182,3,185,310,0,0,0,0,0,0,59.68
新竹縣,寶山鄉,雙溪村,272,1,989,14,1003,1682,0,0,0,0,0,0,59.63
新竹縣,寶山鄉,雙溪村,273,1,770,13,783,1635,0,0,0,0,0,0,47.89
新竹縣,寶山鄉,大崎村,274,1,487,2,489,902,0,0,0,0,0,0,54.21
新竹縣,寶山鄉,三峰村,275,1,529,4,533,763,0,0,0,0,0,0,69.86
新竹縣,寶山鄉,新城村,276,1,707,5,712,1131,0,0,0,0,0,0,62.95
新竹縣,寶山鄉,寶斗村,277,1,453,5,458,633,0,0,0,0,0,0,72.35
新竹縣,寶山鄉,深井村,278,1,467,3,470,703,0,0,0,0,0,0,66.86
新竹縣,寶山鄉,寶山村,279,1,452,1,453,627,0,0,0,0,0,0,72.25
新竹縣,寶山鄉,油田村,280,1,397,3,400,558,0,0,0,0,0,0,71.68
新竹縣,寶山鄉,山湖村,281,1,347,6,353,550,0,0,0,0,0,0,64.18
新竹縣,峨眉鄉,峨眉村,282,1,632,2,634,892,0,0,0,0,0,0,71.08
新竹縣,峨眉鄉,中盛村,283,1,448,4,452,677,0,0,0,0,0,0,66.77
新竹縣,峨眉鄉,石井村,284,1,439,4,443,631,0,0,0,0,0,0,70.21
新竹縣,峨眉鄉,七星村,285,1,234,1,235,332,0,0,0,0,0,0,70.78
新竹縣,峨眉鄉,七星村,286,1,202,4,206,313,0,0,0,0,0,0,65.81
新竹縣,峨眉鄉,富興村,287,1,811,13,824,1197,0,0,0,0,0,0,68.84
新竹縣,峨眉鄉,湖光村,288,1,315,1,316,514,0,0,0,0,0,0,61.48
新竹縣,峨眉鄉,湖光村,289,1,244,1,245,365,0,0,0,0,0,0,67.12
新竹縣,尖石鄉,嘉樂村,290,1,272,8,280,418,0,0,0,0,0,0,66.99
新竹縣,尖石鄉,義興村,291,1,15,1,16,41,0,0,0,0,0,0,39.02
新竹縣,尖石鄉,嘉樂村,292,1,75,1,76,139,0,0,0,0,0,0,54.68
新竹縣,尖石鄉,新樂村,293,1,90,4,94,183,0,0,0,0,0,0,51.37
新竹縣,尖石鄉,錦屏村,294,1,34,2,36,73,0,0,0,0,0,0,49.32
新竹縣,尖石鄉,錦屏村,295,1,36,2,38,70,0,0,0,0,0,0,54.29
新竹縣,尖石鄉,梅花村,296,1,19,0,19,46,0,0,0,0,0,0,41.30
新竹縣,尖石鄉,玉峰村,297,1,14,1,15,25,0,0,0,0,0,0,60.00
新竹縣,尖石鄉,玉峰村,298,1,4,1,5,10,0,0,0,0,0,0,50.00
新竹縣,尖石鄉,秀巒村,299,1,7,0,7,15,0,0,0,0,0,0,46.67
新竹縣,尖石鄉,秀巒村,300,1,17,0,17,37,0,0,0,0,0,0,45.95
新竹縣,尖石鄉,秀巒村,301,1,5,0,5,13,0,0,0,0,0,0,38.46
新竹縣,五峰鄉,大隘村,302,1,74,0,74,120,0,0,0,0,0,0,61.67
新竹縣,五峰鄉,大隘村,303,1,11,0,11,32,0,0,0,0,0,0,34.38
新竹縣,五峰鄉,花園村,304,1,40,0,40,74,0,0,0,0,0,0,54.05
新竹縣,五峰鄉,竹林村,305,1,7,0,7,11,0,0,0,0,0,0,63.64
新竹縣,五峰鄉,桃山村,306,1,21,1,22,43,0,0,0,0,0,0,51.16
新竹縣,五峰鄉,桃山村,307,1,32,0,32,84,0,0,0,0,0,0,38.10
苗栗縣,苗栗市,中苗里,1,1,567,17,584,865,0,0,0,0,0,0,67.51
苗栗縣,苗栗市,青苗里,2,1,680,8,688,1019,0,0,0,0,0,0,67.52
苗栗縣,苗栗市,維祥里,3,1,909,18,927,1470,0,0,0,0,0,0,63.06
苗栗縣,苗栗市,維祥里,4,1,930,22,952,1454,0,0,0,0,0,0,65.47
苗栗縣,苗栗市,維新里,5,1,772,6,778,1171,0,0,0,0,0,0,66.44
苗栗縣,苗栗市,維新里,6,1,828,13,841,1252,0,0,0,0,0,0,67.17
苗栗縣,苗栗市,維新里,7,1,764,9,773,1183,0,0,0,0,0,0,65.34
苗栗縣,苗栗市,玉清里,8,1,684,8,692,1034,0,0,0,0,0,0,66.92
苗栗縣,苗栗市,玉清里,9,1,693,6,699,1089,0,0,0,0,0,0,64.19
苗栗縣,苗栗市,玉華里,10,1,740,14,754,1121,0,0,0,0,0,0,67.26
苗栗縣,苗栗市,玉華里,11,1,680,13,693,1068,0,0,0,0,0,0,64.89
苗栗縣,苗栗市,玉華里,12,1,692,22,714,1016,0,0,0,0,0,0,70.28
苗栗縣,苗栗市,綠苗里,13,1,605,9,614,924,0,0,0,0,0,0,66.45
苗栗縣,苗栗市,高苗里,14,1,674,56,730,1134,0,0,0,0,0,0,64.37
苗栗縣,苗栗市,高苗里,15,1,763,8,771,1280,0,0,0,0,0,0,60.23
苗栗縣,苗栗市,新苗里,16,1,667,9,676,973,0,0,0,0,0,0,69.48
苗栗縣,苗栗市,玉苗里,17,1,744,13,757,1101,0,0,0,0,0,0,68.76
苗栗縣,苗栗市,大同里,18,1,389,7,396,652,0,0,0,0,0,0,60.74
苗栗縣,苗栗市,恭敬里,19,1,1054,21,1075,1542,0,0,0,0,0,0,69.71
苗栗縣,苗栗市,水源里,20,1,889,23,912,1329,0,0,0,0,0,0,68.62
苗栗縣,苗栗市,水源里,21,1,633,5,638,862,0,0,0,0,0,0,74.01
苗栗縣,苗栗市,勝利里,22,1,834,13,847,1266,0,0,0,0,0,0,66.90
苗栗縣,苗栗市,勝利里,23,1,869,16,885,1314,0,0,0,0,0,0,67.35
苗栗縣,苗栗市,勝利里,24,1,570,11,581,819,0,0,0,0,0,0,70.94
苗栗縣,苗栗市,清華里,25,1,564,6,570,837,0,0,0,0,0,0,68.10
苗栗縣,苗栗市,清華里,26,1,816,12,828,1192,0,0,0,0,0,0,69.46
苗栗縣,苗栗市,清華里,27,1,641,5,646,924,0,0,0,0,0,0,69.91
苗栗縣,苗栗市,上苗里,28,1,569,9,578,834,0,0,0,0,0,0,69.30
苗栗縣,苗栗市,上苗里,29,1,653,11,664,940,0,0,0,0,0,0,70.64
苗栗縣,苗栗市,北苗里,30,1,798,15,813,1187,0,0,0,0,0,0,68.49
苗栗縣,苗栗市,北苗里,31,1,807,11,818,1252,0,0,0,0,0,0,65.34
苗栗縣,苗栗市,北苗里,32,1,809,6,815,1251,0,0,0,0,0,0,65.15
苗栗縣,苗栗市,嘉盛里,33,1,1021,8,1029,1537,0,0,0,0,0,0,66.95
苗栗縣,苗栗市,嘉盛里,34,1,806,7,813,1156,0,0,0,0,0,0,70.33
苗栗縣,苗栗市,嘉盛里,35,1,882,21,903,1274,0,0,0,0,0,0,70.88
苗栗縣,苗栗市,嘉盛里,36,1,903,16,919,1285,0,0,0,0,0,0,71.52
苗栗縣,苗栗市,福星里,37,1,1140,10,1150,1665,0,0,0,0,0,0,69.07
苗栗縣,苗栗市,福星里,38,1,1238,25,1263,1874,0,0,0,0,0,0,67.40
苗栗縣,苗栗市,福星里,39,1,946,21,967,1489,0,0,0,0,0,0,64.94
苗栗縣,苗栗市,建功里,40,1,578,11,589,868,0,0,0,0,0,0,67.86
苗栗縣,苗栗市,建功里,41,1,815,27,842,1199,0,0,0,0,0,0,70.23
苗栗縣,苗栗市,建功里,42,1,772,8,780,1217,0,0,0,0,0,0,64.09
苗栗縣,苗栗市,福麗里,43,1,803,12,815,1249,0,0,0,0,0,0,65.25
苗栗縣,苗栗市,福麗里,44,1,874,10,884,1377,0,0,0,0,0,0,64.20
苗栗縣,苗栗市,福麗里,45,1,823,17,840,1287,0,0,0,0,0,0,65.27
苗栗縣,苗栗市,文山里,46,1,984,15,999,1431,0,0,0,0,0,0,69.81
苗栗縣,苗栗市,文山里,47,1,756,21,777,1210,0,0,0,0,0,0,64.21
苗栗縣,苗栗市,文山里,48,1,1021,26,1047,1548,0,0,0,0,0,0,67.64
苗栗縣,苗栗市,新川里,49,1,740,8,748,1067,0,0,0,0,0,0,70.10
苗栗縣,苗栗市,新英里,50,1,765,14,779,1250,0,0,0,0,0,0,62.32
苗栗縣,苗栗市,新英里,51,1,481,8,489,765,0,0,0,0,0,0,63.92
苗栗縣,苗栗市,新英里,52,1,595,9,604,883,0,0,0,0,0,0,68.40
苗栗縣,苑裡鎮,苑東里,53,1,495,5,500,701,0,0,0,0,0,0,71.33
苗栗縣,苑裡鎮,苑東里,54,1,638,3,641,966,0,0,0,0,0,0,66.36
苗栗縣,苑裡鎮,苑南里,55,1,587,6,593,871,0,0,0,0,0,0,68.08
苗栗縣,苑裡鎮,苑南里,56,1,458,8,466,707,0,0,0,0,0,0,65.91
苗栗縣,苑裡鎮,苑北里,57,1,596,10,606,890,0,0,0,0,0,0,68.09
苗栗縣,苑裡鎮,西平里,58,1,857,5,862,1302,0,0,0,0,0,0,66.21
苗栗縣,苑裡鎮,苑港里,59,1,774,13,787,1106,0,0,0,0,0,0,71.16
苗栗縣,苑裡鎮,西勢里,60,1,516,9,525,805,0,0,0,0,0,0,65.22
苗栗縣,苑裡鎮,西勢里,61,1,495,10,505,694,0,0,0,0,0,0,72.77
苗栗縣,苑裡鎮,海岸里,62,1,643,4,647,955,0,0,0,0,0,0,67.75
苗栗縣,苑裡鎮,房裡里,63,1,686,7,693,966,0,0,0,0,0,0,71.74
苗栗縣,苑裡鎮,房裡里,64,1,644,11,655,1024,0,0,0,0,0,0,63.96
苗栗縣,苑裡鎮,客庄里,65,1,642,5,647,968,0,0,0,0,0,0,66.84
苗栗縣,苑裡鎮,客庄里,66,1,643,5,648,953,0,0,0,0,0,0,68.00
苗栗縣,苑裡鎮,客庄里,67,1,659,4,663,978,0,0,0,0,0,0,67.79
苗栗縣,苑裡鎮,中正里,68,1,595,9,604,904,0,0,0,0,0,0,66.81
苗栗縣,苑裡鎮,中正里,69,1,555,3,558,821,0,0,0,0,0,0,67.97
苗栗縣,苑裡鎮,苑坑里,70,1,615,4,619,976,0,0,0,0,0,0,63.42
苗栗縣,苑裡鎮,水坡里,71,1,404,3,407,611,0,0,0,0,0,0,66.61
苗栗縣,苑裡鎮,新復里,72,1,746,1,747,1087,0,0,0,0,0,0,68.72
苗栗縣,苑裡鎮,山腳里,73,1,539,8,547,826,0,0,0,0,0,0,66.22
苗栗縣,苑裡鎮,山腳里,74,1,499,10,509,761,0,0,0,0,0,0,66.89
苗栗縣,苑裡鎮,舊社里,75,1,578,7,585,830,0,0,0,0,0,0,70.48
苗栗縣,苑裡鎮,舊社里,76,1,495,8,503,708,0,0,0,0,0,0,71.05
苗栗縣,苑裡鎮,福田里,77,1,860,13,873,1252,0,0,0,0,0,0,69.73
苗栗縣,苑裡鎮,石鎮里,78,1,486,3,489,630,0,0,0,0,0,0,77.62
苗栗縣,苑裡鎮,蕉埔里,79,1,687,12,699,945,0,0,0,0,0,0,73.97
苗栗縣,苑裡鎮,南勢里,80,1,483,7,490,737,0,0,0,0,0,0,66.49
苗栗縣,苑裡鎮,泰田里,81,1,981,10,991,1383,0,0,0,0,0,0,71.66
苗栗縣,苑裡鎮,上館里,82,1,1025,14,1039,1503,0,0,0,0,0,0,69.13
苗栗縣,苑裡鎮,玉田里,83,1,964,11,975,1398,0,0,0,0,0,0,69.74
苗栗縣,苑裡鎮,社苓里,84,1,663,10,673,981,0,0,0,0,0,0,68.60
苗栗縣,苑裡鎮,社苓里,85,1,626,8,634,944,0,0,0,0,0,0,67.16
苗栗縣,苑裡鎮,山柑里,86,1,761,9,770,1091,0,0,0,0,0,0,70.58
苗栗縣,苑裡鎮,田心里,87,1,852,11,863,1197,0,0,0,0,0,0,72.10
苗栗縣,通霄鎮,通東里,88,1,851,9,860,1259,0,0,0,0,0,0,68.31
苗栗縣,通霄鎮,通西里,89,1,851,10,861,1206,0,0,0,0,0,0,71.39
苗栗縣,通霄鎮,通西里,90,1,714,1,715,953,0,0,0,0,0,0,75.03
苗栗縣,通霄鎮,平元里,91,1,881,11,892,1283,0,0,0,0,0,0,69.52
苗栗縣,通霄鎮,平元里,92,1,705,10,715,1017,0,0,0,0,0,0,70.30
苗栗縣,通霄鎮,平元里,93,1,725,3,728,1057,0,0,0,0,0,0,68.87
苗栗縣,通霄鎮,五南里,94,1,904,8,912,1234,0,0,0,0,0,0,73.91
苗栗縣,通霄鎮,五北里,95,1,489,5,494,642,0,0,0,0,0,0,76.95
苗栗縣,通霄鎮,五北里,96,1,587,8,595,759,0,0,0,0,0,0,78.39
苗栗縣,通霄鎮,梅南里,97,1,556,9,565,764,0,0,0,0,0,0,73.95
苗栗縣,通霄鎮,梅南里,98,1,510,4,514,669,0,0,0,0,0,0,76.83
苗栗縣,通霄鎮,通南里,99,1,795,10,805,1119,0,0,0,0,0,0,71.94
苗栗縣,通霄鎮,通南里,100,1,833,15,848,1204,0,0,0,0,0,0,70.43
苗栗縣,通霄鎮,坪頂里,101,1,872,37,909,1211,0,0,0,0,0,0,75.06
苗栗縣,通霄鎮,福興里,102,1,466,3,469,663,0,0,0,0,0,0,70.74
苗栗縣,通霄鎮,南和里,103,1,641,12,653,843,0,0,0,0,0,0,77.46
苗栗縣,通霄鎮,城南里,104,1,727,16,743,1046,0,0,0,0,0,0,71.03
苗栗縣,通霄鎮,城北里,105,1,497,8,505,708,0,0,0,0,0,0,71.33
苗栗縣,通霄鎮,圳頭里,106,1,591,6,597,770,0,0,0,0,0,0,77.53
苗栗縣,通霄鎮,內湖里,107,1,764,6,770,980,0,0,0,0,0,0,78.57
苗栗縣,通霄鎮,內湖里,108,1,567,2,569,728,0,0,0,0,0,0,78.16
苗栗縣,通霄鎮,楓樹里,109,1,426,2,428,578,0,0,0,0,0,0,74.05
苗栗縣,通霄鎮,烏眉里,110,1,713,6,719,947,0,0,0,0,0,0,75.92
苗栗縣,通霄鎮,福龍里,111,1,374,2,376,542,0,0,0,0,0,0,69.37
苗栗縣,通霄鎮,福源里,112,1,465,8,473,727,0,0,0,0,0,0,65.06
苗栗縣,通霄鎮,通灣里,113,1,777,11,788,1072,0,0,0,0,0,0,73.51
苗栗縣,通霄鎮,通灣里,114,1,714,8,722,998,0,0,0,0,0,0,72.34
苗栗縣,通霄鎮,新埔里,115,1,924,11,935,1240,0,0,0,0,0,0,75.40
苗栗縣,通霄鎮,內島里,116,1,572,11,583,768,0,0,0,0,0,0,75.91
苗栗縣,通霄鎮,白東里,117,1,889,8,897,1304,0,0,0,0,0,0,68.79
苗栗縣,通霄鎮,白西里,118,1,599,3,602,828,0,0,0,0,0,0,72.71
苗栗縣,竹南鎮,竹南里,119,1,598,3,601,858,0,0,0,0,0,0,70.05
苗栗縣,竹南鎮,竹南里,120,1,558,11,569,829,0,0,0,0,0,0,68.64
苗栗縣,竹南鎮,照南里,121,1,858,16,874,1210,0,0,0,0,0,0,72.23
苗栗縣,竹南鎮,照南里,122,1,789,16,805,1090,0,0,0,0,0,0,73.85
苗栗縣,竹南鎮,正南里,123,1,632,11,643,951,0,0,0,0,0,0,67.61
苗栗縣,竹南鎮,正南里,124,1,776,12,788,1180,0,0,0,0,0,0,66.78
苗栗縣,竹南鎮,新南里,125,1,1008,8,1016,1426,0,0,0,0,0,0,71.25
苗栗縣,竹南鎮,新南里,126,1,764,11,775,1071,0,0,0,0,0,0,72.36
苗栗縣,竹南鎮,大厝里,127,1,875,9,884,1174,0,0,0,0,0,0,75.30
苗栗縣,竹南鎮,大厝里,128,1,667,7,674,1001,0,0,0,0,0,0,67.33
苗栗縣,竹南鎮,大厝里,129,1,556,7,563,845,0,0,0,0,0,0,66.63
苗栗縣,竹南鎮,營盤里,130,1,773,15,788,1074,0,0,0,0,0,0,73.37
苗栗縣,竹南鎮,營盤里,131,1,890,7,897,1199,0,0,0,0,0,0,74.81
苗栗縣,竹南鎮,聖福里,132,1,684,8,692,992,0,0,0,0,0,0,69.76
苗栗縣,竹南鎮,聖福里,133,1,748,8,756,1097,0,0,0,0,0,0,68.92
苗栗縣,竹南鎮,竹興里,134,1,553,11,564,839,0,0,0,0,0,0,67.22
苗栗縣,竹南鎮,竹興里,135,1,565,15,580,858,0,0,0,0,0,0,67.60
苗栗縣,竹南鎮,竹興里,136,1,636,14,650,925,0,0,0,0,0,0,70.27
苗栗縣,竹南鎮,龍鳳里,137,1,972,14,986,1374,0,0,0,0,0,0,71.76
苗栗縣,竹南鎮,龍鳳里,138,1,896,14,910,1220,0,0,0,0,0,0,74.59
苗栗縣,竹南鎮,龍鳳里,139,1,857,6,863,1112,0,0,0,0,0,0,77.61
苗栗縣,竹南鎮,山佳里,140,1,803,9,812,1187,0,0,0,0,0,0,68.41
苗栗縣,竹南鎮,山佳里,141,1,740,7,747,1168,0,0,0,0,0,0,63.96
苗栗縣,竹南鎮,山佳里,142,1,726,10,736,1031,0,0,0,0,0,0,71.39
苗栗縣,竹南鎮,山佳里,143,1,724,9,733,1014,0,0,0,0,0,0,72.29
苗栗縣,竹南鎮,中港里,144,1,651,3,654,871,0,0,0,0,0,0,75.09
苗栗縣,竹南鎮,中華里,145,1,579,7,586,833,0,0,0,0,0,0,70.35
苗栗縣,竹南鎮,中華里,146,1,781,9,790,1148,0,0,0,0,0,0,68.82
苗栗縣,竹南鎮,中英里,147,1,735,10,745,1040,0,0,0,0,0,0,71.63
苗栗縣,竹南鎮,中美里,148,1,998,19,1017,1374,0,0,0,0,0,0,74.02
苗栗縣,竹南鎮,開元里,149,1,381,4,385,486,0,0,0,0,0,0,79.22
苗栗縣,竹南鎮,海口里,150,1,620,5,625,856,0,0,0,0,0,0,73.01
苗栗縣,竹南鎮,海口里,151,1,680,10,690,954,0,0,0,0,0,0,72.33
苗栗縣,竹南鎮,港墘里,152,1,991,9,1000,1277,0,0,0,0,0,0,78.31
苗栗縣,竹南鎮,公館里,153,1,701,11,712,1043,0,0,0,0,0,0,68.26
苗栗縣,竹南鎮,大埔里,154,1,574,15,589,783,0,0,0,0,0,0,75.22
苗栗縣,竹南鎮,大埔里,155,1,794,32,826,1181,0,0,0,0,0,0,69.94
苗栗縣,竹南鎮,大埔里,156,1,619,9,628,868,0,0,0,0,0,0,72.35
苗栗縣,竹南鎮,頂埔里,157,1,839,11,850,1118,0,0,0,0,0,0,76.03
苗栗縣,竹南鎮,頂埔里,158,1,721,10,731,972,0,0,0,0,0,0,75.21
苗栗縣,竹南鎮,崎頂里,159,1,806,23,829,1111,0,0,0,0,0,0,74.62
苗栗縣,竹南鎮,崎頂里,160,1,754,4,758,1045,0,0,0,0,0,0,72.54
苗栗縣,竹南鎮,公義里,161,1,629,11,640,895,0,0,0,0,0,0,71.51
苗栗縣,頭份鎮,流東里,162,1,545,3,548,730,0,0,0,0,0,0,75.07
苗栗縣,頭份鎮,流東里,163,1,798,16,814,1171,0,0,0,0,0,0,69.51
苗栗縣,頭份鎮,珊湖里,164,1,654,9,663,936,0,0,0,0,0,0,70.83
苗栗縣,頭份鎮,珊湖里,165,1,611,7,618,865,0,0,0,0,0,0,71.45
苗栗縣,頭份鎮,斗煥里,166,1,679,4,683,923,0,0,0,0,0,0,74.00
苗栗縣,頭份鎮,斗煥里,167,1,614,15,629,834,0,0,0,0,0,0,75.42
苗栗縣,頭份鎮,斗煥里,168,1,597,8,605,873,0,0,0,0,0,0,69.30
苗栗縣,頭份鎮,新華里,169,1,716,14,730,982,0,0,0,0,0,0,74.34
苗栗縣,頭份鎮,新華里,170,1,710,9,719,1081,0,0,0,0,0,0,66.51
苗栗縣,頭份鎮,新華里,171,1,809,20,829,1276,0,0,0,0,0,0,64.97
苗栗縣,頭份鎮,興隆里,172,1,959,14,973,1545,0,0,0,0,0,0,62.98
苗栗縣,頭份鎮,興隆里,173,1,713,11,724,1148,0,0,0,0,0,0,63.07
苗栗縣,頭份鎮,上埔里,174,1,871,13,884,1253,0,0,0,0,0,0,70.55
苗栗縣,頭份鎮,上埔里,175,1,606,5,611,938,0,0,0,0,0,0,65.14
苗栗縣,頭份鎮,土牛里,176,1,499,10,509,787,0,0,0,0,0,0,64.68
苗栗縣,頭份鎮,頭份里,177,1,697,17,714,1183,0,0,0,0,0,0,60.36
苗栗縣,頭份鎮,頭份里,178,1,749,11,760,1174,0,0,0,0,0,0,64.74
苗栗縣,頭份鎮,忠孝里,179,1,814,5,819,1320,0,0,0,0,0,0,62.05
苗栗縣,頭份鎮,忠孝里,180,1,927,13,940,1408,0,0,0,0,0,0,66.76
苗栗縣,頭份鎮,忠孝里,181,1,831,6,837,1288,0,0,0,0,0,0,64.98
苗栗縣,頭份鎮,信義里,182,1,521,10,531,727,0,0,0,0,0,0,73.04
苗栗縣,頭份鎮,仁愛里,183,1,984,7,991,1440,0,0,0,0,0,0,68.82
苗栗縣,頭份鎮,上興里,184,1,735,6,741,995,0,0,0,0,0,0,74.47
苗栗縣,頭份鎮,下興里,185,1,535,9,544,941,0,0,0,0,0,0,57.81
苗栗縣,頭份鎮,下興里,186,1,686,7,693,983,0,0,0,0,0,0,70.50
苗栗縣,頭份鎮,山下里,187,1,794,8,802,1145,0,0,0,0,0,0,70.04
苗栗縣,頭份鎮,山下里,188,1,590,6,596,876,0,0,0,0,0,0,68.04
苗栗縣,頭份鎮,後庄里,189,1,889,11,900,1389,0,0,0,0,0,0,64.79
苗栗縣,頭份鎮,後庄里,190,1,774,6,780,1240,0,0,0,0,0,0,62.90
苗栗縣,頭份鎮,後庄里,191,1,791,17,808,1125,0,0,0,0,0,0,71.82
苗栗縣,頭份鎮,建國里,192,1,693,11,704,1099,0,0,0,0,0,0,64.06
苗栗縣,頭份鎮,建國里,193,1,717,11,728,1127,0,0,0,0,0,0,64.60
苗栗縣,頭份鎮,成功里,194,1,687,9,696,1163,0,0,0,0,0,0,59.85
苗栗縣,頭份鎮,成功里,195,1,704,10,714,1112,0,0,0,0,0,0,64.21
苗栗縣,頭份鎮,蟠桃里,196,1,506,7,513,783,0,0,0,0,0,0,65.52
苗栗縣,頭份鎮,蟠桃里,197,1,543,10,553,913,0,0,0,0,0,0,60.57
苗栗縣,頭份鎮,東庄里,198,1,660,4,664,1004,0,0,0,0,0,0,66.14
苗栗縣,頭份鎮,東庄里,199,1,667,8,675,1065,0,0,0,0,0,0,63.38
苗栗縣,頭份鎮,和平里,200,1,724,11,735,1022,0,0,0,0,0,0,71.92
苗栗縣,頭份鎮,民族里,201,1,918,14,932,1449,0,0,0,0,0,0,64.32
苗栗縣,頭份鎮,民權里,202,1,566,4,570,862,0,0,0,0,0,0,66.13
苗栗縣,頭份鎮,民權里,203,1,473,4,477,742,0,0,0,0,0,0,64.29
苗栗縣,頭份鎮,民生里,204,1,506,11,517,841,0,0,0,0,0,0,61.47
苗栗縣,頭份鎮,民生里,205,1,550,13,563,901,0,0,0,0,0,0,62.49
苗栗縣,頭份鎮,田寮里,206,1,847,8,855,1258,0,0,0,0,0,0,67.97
苗栗縣,頭份鎮,田寮里,207,1,795,14,809,1281,0,0,0,0,0,0,63.15
苗栗縣,頭份鎮,蘆竹里,208,1,953,13,966,1292,0,0,0,0,0,0,74.77
苗栗縣,頭份鎮,尖山里,209,1,913,7,920,1270,0,0,0,0,0,0,72.44
苗栗縣,頭份鎮,廣興里,210,1,621,9,630,847,0,0,0,0,0,0,74.38
苗栗縣,頭份鎮,尖下里,211,1,718,8,726,1080,0,0,0,0,0,0,67.22
苗栗縣,頭份鎮,尖下里,212,1,757,12,769,1255,0,0,0,0,0,0,61.27
苗栗縣,頭份鎮,濫坑里,213,1,640,6,646,1000,0,0,0,0,0,0,64.60
苗栗縣,頭份鎮,濫坑里,214,1,541,8,549,848,0,0,0,0,0,0,64.74
苗栗縣,後龍鎮,南龍里,215,1,478,7,485,645,0,0,0,0,0,0,75.19
苗栗縣,後龍鎮,南龍里,216,1,626,5,631,823,0,0,0,0,0,0,76.67
苗栗縣,後龍鎮,中龍里,217,1,750,0,750,945,0,0,0,0,0,0,79.37
苗栗縣,後龍鎮,北龍里,218,1,1006,19,1025,1391,0,0,0,0,0,0,73.69
苗栗縣,後龍鎮,大庄里,219,1,860,10,870,1101,0,0,0,0,0,0,79.02
苗栗縣,後龍鎮,大庄里,220,1,844,8,852,1103,0,0,0,0,0,0,77.24
苗栗縣,後龍鎮,大庄里,221,1,683,6,689,894,0,0,0,0,0,0,77.07
苗栗縣,後龍鎮,溪洲里,222,1,737,11,748,983,0,0,0,0,0,0,76.09
苗栗縣,後龍鎮,溪洲里,223,1,794,5,799,1085,0,0,0,0,0,0,73.64
苗栗縣,後龍鎮,豐富里,224,1,965,13,978,1250,0,0,0,0,0,0,78.24
苗栗縣,後龍鎮,校椅里,225,1,922,6,928,1184,0,0,0,0,0,0,78.38
苗栗縣,後龍鎮,埔頂里,226,1,843,7,850,1044,0,0,0,0,0,0,81.42
苗栗縣,後龍鎮,埔頂里,227,1,807,7,814,1017,0,0,0,0,0,0,80.04
苗栗縣,後龍鎮,新民里,228,1,1048,11,1059,1307,0,0,0,0,0,0,81.03
苗栗縣,後龍鎮,復興里,229,1,485,8,493,632,0,0,0,0,0,0,78.01
苗栗縣,後龍鎮,東明里,230,1,1005,7,1012,1401,0,0,0,0,0,0,72.23
苗栗縣,後龍鎮,大山里,231,1,577,10,587,799,0,0,0,0,0,0,73.47
苗栗縣,後龍鎮,大山里,232,1,591,3,594,830,0,0,0,0,0,0,71.57
苗栗縣,後龍鎮,灣寶里,233,1,997,8,1005,1380,0,0,0,0,0,0,72.83
苗栗縣,後龍鎮,海寶里,234,1,725,9,734,1008,0,0,0,0,0,0,72.82
苗栗縣,後龍鎮,外埔里,235,1,858,11,869,1258,0,0,0,0,0,0,69.08
苗栗縣,後龍鎮,海埔里,236,1,722,7,729,1062,0,0,0,0,0,0,68.64
苗栗縣,後龍鎮,秀水里,237,1,549,1,550,755,0,0,0,0,0,0,72.85
苗栗縣,後龍鎮,水尾里,238,1,791,6,797,1115,0,0,0,0,0,0,71.48
苗栗縣,後龍鎮,龍津里,239,1,490,10,500,658,0,0,0,0,0,0,75.99
苗栗縣,後龍鎮,龍坑里,240,1,927,14,941,1256,0,0,0,0,0,0,74.92
苗栗縣,後龍鎮,福寧里,241,1,601,3,604,836,0,0,0,0,0,0,72.25
苗栗縣,後龍鎮,中和里,242,1,810,6,816,1274,0,0,0,0,0,0,64.05
苗栗縣,後龍鎮,南港里,243,1,863,12,875,1318,0,0,0,0,0,0,66.39
苗栗縣,卓蘭鎮,老庄里,244,1,826,14,840,1054,0,0,0,0,0,0,79.70
苗栗縣,卓蘭鎮,老庄里,245,1,793,10,803,1052,0,0,0,0,0,0,76.33
苗栗縣,卓蘭鎮,新榮里,246,1,870,12,882,1134,0,0,0,0,0,0,77.78
苗栗縣,卓蘭鎮,中街里,247,1,605,9,614,798,0,0,0,0,0,0,76.94
苗栗縣,卓蘭鎮,新厝里,248,1,571,7,578,791,0,0,0,0,0,0,73.07
苗栗縣,卓蘭鎮,新厝里,249,1,586,7,593,755,0,0,0,0,0,0,78.54
苗栗縣,卓蘭鎮,豐田里,250,1,801,23,824,986,0,0,0,0,0,0,83.57
苗栗縣,卓蘭鎮,西坪里,251,1,424,7,431,572,0,0,0,0,0,0,75.35
苗栗縣,卓蘭鎮,苗豐里,252,1,586,3,589,722,0,0,0,0,0,0,81.58
苗栗縣,卓蘭鎮,上新里,253,1,1086,17,1103,1485,0,0,0,0,0,0,74.28
苗栗縣,卓蘭鎮,上新里,254,1,320,12,332,427,0,0,0,0,0,0,77.75
苗栗縣,卓蘭鎮,內灣里,255,1,1092,24,1116,1395,0,0,0,0,0,0,80.00
苗栗縣,卓蘭鎮,內灣里,256,1,477,13,490,630,0,0,0,0,0,0,77.78
苗栗縣,卓蘭鎮,坪林里,257,1,705,12,717,948,0,0,0,0,0,0,75.63
苗栗縣,卓蘭鎮,坪林里,258,1,407,7,414,492,0,0,0,0,0,0,84.15
苗栗縣,卓蘭鎮,景山里,259,1,530,7,537,718,0,0,0,0,0,0,74.79
苗栗縣,大湖鄉,大湖村,260,1,581,3,584,813,0,0,0,0,0,0,71.83
苗栗縣,大湖鄉,大湖村,261,1,653,8,661,889,0,0,0,0,0,0,74.35
苗栗縣,大湖鄉,明湖村,262,1,562,4,566,702,0,0,0,0,0,0,80.63
苗栗縣,大湖鄉,靜湖村,263,1,626,6,632,840,0,0,0,0,0,0,75.24
苗栗縣,大湖鄉,靜湖村,264,1,574,8,582,766,0,0,0,0,0,0,75.98
苗栗縣,大湖鄉,富興村,265,1,1019,10,1029,1369,0,0,0,0,0,0,75.16
苗栗縣,大湖鄉,大南村,266,1,474,7,481,705,0,0,0,0,0,0,68.23
苗栗縣,大湖鄉,大寮村,267,1,929,8,937,1256,0,0,0,0,0,0,74.60
苗栗縣,大湖鄉,南湖村,268,1,559,10,569,749,0,0,0,0,0,0,75.97
苗栗縣,大湖鄉,義和村,269,1,498,12,510,698,0,0,0,0,0,0,73.07
苗栗縣,大湖鄉,義和村,270,1,619,7,626,831,0,0,0,0,0,0,75.33
苗栗縣,大湖鄉,東興村,271,1,588,2,590,777,0,0,0,0,0,0,75.93
苗栗縣,大湖鄉,武榮村,272,1,425,6,431,562,0,0,0,0,0,0,76.69
苗栗縣,大湖鄉,栗林村,273,1,695,12,707,982,0,0,0,0,0,0,72.00
苗栗縣,大湖鄉,新開村,274,1,700,7,707,928,0,0,0,0,0,0,76.19
苗栗縣,公館鄉,館中村,275,1,595,10,605,823,0,0,0,0,0,0,73.51
苗栗縣,公館鄉,館中村,276,1,517,7,524,694,0,0,0,0,0,0,75.50
苗栗縣,公館鄉,館東村,277,1,738,6,744,1052,0,0,0,0,0,0,70.72
苗栗縣,公館鄉,館東村,278,1,780,18,798,1087,0,0,0,0,0,0,73.41
苗栗縣,公館鄉,館南村,279,1,798,11,809,1158,0,0,0,0,0,0,69.86
苗栗縣,公館鄉,館南村,280,1,924,13,937,1326,0,0,0,0,0,0,70.66
苗栗縣,公館鄉,中義村,281,1,669,13,682,969,0,0,0,0,0,0,70.38
苗栗縣,公館鄉,中義村,282,1,659,2,661,904,0,0,0,0,0,0,73.12
苗栗縣,公館鄉,玉泉村,283,1,602,13,615,832,0,0,0,0,0,0,73.92
苗栗縣,公館鄉,玉泉村,284,1,486,10,496,716,0,0,0,0,0,0,69.27
苗栗縣,公館鄉,大坑村,285,1,655,7,662,934,0,0,0,0,0,0,70.88
苗栗縣,公館鄉,福基村,286,1,795,7,802,1046,0,0,0,0,0,0,76.67
苗栗縣,公館鄉,福德村,287,1,302,3,305,412,0,0,0,0,0,0,74.03
苗栗縣,公館鄉,福星村,288,1,1029,15,1044,1456,0,0,0,0,0,0,71.70
苗栗縣,公館鄉,石墻村,289,1,508,7,515,667,0,0,0,0,0,0,77.21
苗栗縣,公館鄉,石墻村,290,1,521,5,526,685,0,0,0,0,0,0,76.79
苗栗縣,公館鄉,開礦村,291,1,263,2,265,332,0,0,0,0,0,0,79.82
苗栗縣,公館鄉,五谷村,292,1,633,10,643,889,0,0,0,0,0,0,72.33
苗栗縣,公館鄉,五谷村,293,1,623,9,632,850,0,0,0,0,0,0,74.35
苗栗縣,公館鄉,玉谷村,294,1,751,8,759,1014,0,0,0,0,0,0,74.85
苗栗縣,公館鄉,鶴岡村,295,1,991,12,1003,1343,0,0,0,0,0,0,74.68
苗栗縣,公館鄉,鶴山村,296,1,954,9,963,1292,0,0,0,0,0,0,74.54
苗栗縣,公館鄉,尖山村,297,1,992,9,1001,1330,0,0,0,0,0,0,75.26
苗栗縣,公館鄉,仁安村,298,1,886,10,896,1141,0,0,0,0,0,0,78.53
苗栗縣,公館鄉,南河村,299,1,157,4,161,215,0,0,0,0,0,0,74.88
苗栗縣,公館鄉,北河村,300,1,253,1,254,322,0,0,0,0,0,0,78.88
苗栗縣,銅鑼鄉,福興村,301,1,761,10,771,1034,0,0,0,0,0,0,74.56
苗栗縣,銅鑼鄉,朝陽村,302,1,647,8,655,904,0,0,0,0,0,0,72.46
苗栗縣,銅鑼鄉,朝陽村,303,1,551,12,563,755,0,0,0,0,0,0,74.57
苗栗縣,銅鑼鄉,竹森村,304,1,744,11,755,1069,0,0,0,0,0,0,70.63
苗栗縣,銅鑼鄉,銅鑼村,305,1,1079,18,1097,1431,0,0,0,0,0,0,76.66
苗栗縣,銅鑼鄉,銅鑼村,306,1,1275,18,1293,1689,0,0,0,0,0,0,76.55
苗栗縣,銅鑼鄉,銅鑼村,307,1,580,12,592,822,0,0,0,0,0,0,72.02
苗栗縣,銅鑼鄉,九湖村,308,1,938,18,956,1292,0,0,0,0,0,0,73.99
苗栗縣,銅鑼鄉,樟樹村,309,1,964,12,976,1264,0,0,0,0,0,0,77.22
苗栗縣,銅鑼鄉,中平村,310,1,881,10,891,1189,0,0,0,0,0,0,74.94
苗栗縣,銅鑼鄉,中平村,311,1,1002,20,1022,1417,0,0,0,0,0,0,72.12
苗栗縣,銅鑼鄉,興隆村,312,1,478,3,481,630,0,0,0,0,0,0,76.35
苗栗縣,銅鑼鄉,盛隆村,313,1,378,3,381,551,0,0,0,0,0,0,69.15
苗栗縣,銅鑼鄉,新隆村,314,1,433,8,441,611,0,0,0,0,0,0,72.18
苗栗縣,南庄鄉,東村,315,1,362,4,366,537,0,0,0,0,0,0,68.16
苗栗縣,南庄鄉,東村,316,1,502,9,511,772,0,0,0,0,0,0,66.19
苗栗縣,南庄鄉,西村,317,1,499,3,502,719,0,0,0,0,0,0,69.82
苗栗縣,南庄鄉,南江村,318,1,457,5,462,698,0,0,0,0,0,0,66.19
苗栗縣,南庄鄉,南江村,319,1,279,1,280,423,0,0,0,0,0,0,66.19
苗栗縣,南庄鄉,田美村,320,1,586,8,594,910,0,0,0,0,0,0,65.27
苗栗縣,南庄鄉,獅山村,321,1,411,4,415,623,0,0,0,0,0,0,66.61
苗栗縣,南庄鄉,獅山村,322,1,251,11,262,418,0,0,0,0,0,0,62.68
苗栗縣,南庄鄉,南富村,323,1,721,17,738,1117,0,0,0,0,0,0,66.07
苗栗縣,南庄鄉,員林村,324,1,734,5,739,1091,0,0,0,0,0,0,67.74
苗栗縣,南庄鄉,蓬萊村,325,1,297,6,303,468,0,0,0,0,0,0,64.74
苗栗縣,南庄鄉,東河村,326,1,180,4,184,290,0,0,0,0,0,0,63.45
苗栗縣,頭屋鄉,頭屋村,327,1,897,8,905,1224,0,0,0,0,0,0,73.94
苗栗縣,頭屋鄉,頭屋村,328,1,849,7,856,1086,0,0,0,0,0,0,78.82
苗栗縣,頭屋鄉,獅潭村,329,1,552,6,558,751,0,0,0,0,0,0,74.30
苗栗縣,頭屋鄉,獅潭村,330,1,625,3,628,753,0,0,0,0,0,0,83.40
苗栗縣,頭屋鄉,北坑村,331,1,484,4,488,636,0,0,0,0,0,0,76.73
苗栗縣,頭屋鄉,曲洞村,332,1,675,10,685,877,0,0,0,0,0,0,78.11
苗栗縣,頭屋鄉,飛鳳村,333,1,258,1,259,352,0,0,0,0,0,0,73.58
苗栗縣,頭屋鄉,象山村,334,1,666,6,672,882,0,0,0,0,0,0,76.19
苗栗縣,頭屋鄉,象山村,335,1,703,9,712,952,0,0,0,0,0,0,74.79
苗栗縣,頭屋鄉,明德村,336,1,715,5,720,929,0,0,0,0,0,0,77.50
苗栗縣,頭屋鄉,明德村,337,1,170,2,172,218,0,0,0,0,0,0,78.90
苗栗縣,頭屋鄉,鳴鳳村,338,1,282,2,284,372,0,0,0,0,0,0,76.34
苗栗縣,三義鄉,廣盛村,339,1,734,11,745,978,0,0,0,0,0,0,76.18
苗栗縣,三義鄉,廣盛村,340,1,765,11,776,1027,0,0,0,0,0,0,75.56
苗栗縣,三義鄉,廣盛村,341,1,721,11,732,982,0,0,0,0,0,0,74.54
苗栗縣,三義鄉,廣盛村,342,1,614,8,622,840,0,0,0,0,0,0,74.05
苗栗縣,三義鄉,勝興村,343,1,695,8,703,915,0,0,0,0,0,0,76.83
苗栗縣,三義鄉,勝興村,344,1,530,5,535,704,0,0,0,0,0,0,75.99
苗栗縣,三義鄉,勝興村,345,1,730,7,737,1044,0,0,0,0,0,0,70.59
苗栗縣,三義鄉,雙湖村,346,1,707,9,716,888,0,0,0,0,0,0,80.63
苗栗縣,三義鄉,雙湖村,347,1,534,11,545,723,0,0,0,0,0,0,75.38
苗栗縣,三義鄉,雙潭村,348,1,536,5,541,695,0,0,0,0,0,0,77.84
苗栗縣,三義鄉,雙潭村,349,1,499,13,512,641,0,0,0,0,0,0,79.88
苗栗縣,三義鄉,西湖村,350,1,937,11,948,1227,0,0,0,0,0,0,77.26
苗栗縣,三義鄉,龍騰村,351,1,310,7,317,384,0,0,0,0,0,0,82.55
苗栗縣,三義鄉,鯉魚潭村,352,1,901,13,914,1150,0,0,0,0,0,0,79.48
苗栗縣,西湖鄉,高埔村,353,1,462,6,468,623,0,0,0,0,0,0,75.12
苗栗縣,西湖鄉,下埔村,354,1,410,7,417,571,0,0,0,0,0,0,73.03
苗栗縣,西湖鄉,五湖村,355,1,642,10,652,915,0,0,0,0,0,0,71.26
苗栗縣,西湖鄉,四湖村,356,1,502,5,507,666,0,0,0,0,0,0,76.13
苗栗縣,西湖鄉,三湖村,357,1,691,9,700,998,0,0,0,0,0,0,70.14
苗栗縣,西湖鄉,龍洞村,358,1,402,3,405,538,0,0,0,0,0,0,75.28
苗栗縣,西湖鄉,金獅村,359,1,387,5,392,544,0,0,0,0,0,0,72.06
苗栗縣,西湖鄉,湖東村,360,1,806,9,815,1171,0,0,0,0,0,0,69.60
苗栗縣,西湖鄉,二湖村,361,1,448,3,451,694,0,0,0,0,0,0,64.99
苗栗縣,造橋鄉,造橋村,362,1,1215,17,1232,1608,0,0,0,0,0,0,76.62
苗栗縣,造橋鄉,平興村,363,1,420,3,423,530,0,0,0,0,0,0,79.81
苗栗縣,造橋鄉,豐湖村,364,1,701,7,708,946,0,0,0,0,0,0,74.84
苗栗縣,造橋鄉,大西村,365,1,1176,17,1193,1516,0,0,0,0,0,0,78.69
苗栗縣,造橋鄉,大西村,366,1,988,12,1000,1280,0,0,0,0,0,0,78.13
苗栗縣,造橋鄉,錦水村,367,1,445,3,448,556,0,0,0,0,0,0,80.58
苗栗縣,造橋鄉,大龍村,368,1,442,3,445,538,0,0,0,0,0,0,82.71
苗栗縣,造橋鄉,朝陽村,369,1,1038,19,1057,1356,0,0,0,0,0,0,77.95
苗栗縣,造橋鄉,談文村,370,1,574,10,584,731,0,0,0,0,0,0,79.89
苗栗縣,造橋鄉,龍昇村,371,1,776,7,783,995,0,0,0,0,0,0,78.69
苗栗縣,三灣鄉,三灣村,372,1,748,8,756,1019,0,0,0,0,0,0,74.19
苗栗縣,三灣鄉,三灣村,373,1,740,10,750,1059,0,0,0,0,0,0,70.82
苗栗縣,三灣鄉,內灣村,374,1,477,8,485,609,0,0,0,0,0,0,79.64
苗栗縣,三灣鄉,銅鏡村,375,1,588,4,592,862,0,0,0,0,0,0,68.68
苗栗縣,三灣鄉,頂寮村,376,1,189,7,196,247,0,0,0,0,0,0,79.35
苗栗縣,三灣鄉,北埔村,377,1,421,4,425,592,0,0,0,0,0,0,71.79
苗栗縣,三灣鄉,大河村,378,1,466,5,471,672,0,0,0,0,0,0,70.09
苗栗縣,三灣鄉,大坪村,379,1,381,4,385,520,0,0,0,0,0,0,74.04
苗栗縣,三灣鄉,永和村,380,1,255,4,259,335,0,0,0,0,0,0,77.31
苗栗縣,獅潭鄉,百壽村,381,1,208,0,208,293,0,0,0,0,0,0,70.99
苗栗縣,獅潭鄉,永興村,382,1,490,7,497,668,0,0,0,0,0,0,74.40
苗栗縣,獅潭鄉,新店村,383,1,762,6,768,980,0,0,0,0,0,0,78.37
苗栗縣,獅潭鄉,和興村,384,1,451,4,455,638,0,0,0,0,0,0,71.32
苗栗縣,獅潭鄉,豐林村,385,1,471,4,475,676,0,0,0,0,0,0,70.27
苗栗縣,獅潭鄉,新豐村,386,1,284,6,290,376,0,0,0,0,0,0,77.13
苗栗縣,獅潭鄉,竹木村,387,1,566,10,576,778,0,0,0,0,0,0,74.04
苗栗縣,泰安鄉,八卦村,388,1,108,1,109,132,0,0,0,0,0,0,82.58
苗栗縣,泰安鄉,錦水村,389,1,213,3,216,353,0,0,0,0,0,0,61.19
苗栗縣,泰安鄉,清安村,390,1,227,4,231,314,0,0,0,0,0,0,73.57
苗栗縣,泰安鄉,清安村,391,1,269,7,276,367,0,0,0,0,0,0,75.20
苗栗縣,泰安鄉,大興村,392,1,69,1,70,102,0,0,0,0,0,0,68.63
苗栗縣,泰安鄉,中興村,393,1,95,1,96,128,0,0,0,0,0,0,75.00
苗栗縣,泰安鄉,梅園村,394,1,18,0,18,27,0,0,0,0,0,0,66.67
苗栗縣,泰安鄉,象鼻村,395,1,39,0,39,53,0,0,0,0,0,0,73.58
苗栗縣,泰安鄉,士林村,396,1,19,0,19,32,0,0,0,0,0,0,59.38
臺中縣,豐原市,豐原里,1,1,684,17,701,967,0,0,0,0,0,0,72.49
臺中縣,豐原市,豐原里,2,1,692,11,703,974,0,0,0,0,0,0,72.18
臺中縣,豐原市,豐榮里,3,1,665,7,672,959,0,0,0,0,0,0,70.07
臺中縣,豐原市,頂街里,4,1,536,11,547,850,0,0,0,0,0,0,64.35
臺中縣,豐原市,中山里,5,1,677,6,683,924,0,0,0,0,0,0,73.92
臺中縣,豐原市,下街里,6,1,606,11,617,842,0,0,0,0,0,0,73.28
臺中縣,豐原市,中陽里,7,1,880,16,896,1358,0,0,0,0,0,0,65.98
臺中縣,豐原市,中陽里,8,1,884,12,896,1322,0,0,0,0,0,0,67.78
臺中縣,豐原市,中陽里,9,1,1099,18,1117,1578,0,0,0,0,0,0,70.79
臺中縣,豐原市,大湳里,10,1,670,14,684,980,0,0,0,0,0,0,69.80
臺中縣,豐原市,大湳里,11,1,710,6,716,1014,0,0,0,0,0,0,70.61
臺中縣,豐原市,北湳里,12,1,806,9,815,1147,0,0,0,0,0,0,71.05
臺中縣,豐原市,北湳里,13,1,743,14,757,1036,0,0,0,0,0,0,73.07
臺中縣,豐原市,東湳里,14,1,840,15,855,1140,0,0,0,0,0,0,75.00
臺中縣,豐原市,東湳里,15,1,834,29,863,1253,0,0,0,0,0,0,68.87
臺中縣,豐原市,東湳里,16,1,755,12,767,1026,0,0,0,0,0,0,74.76
臺中縣,豐原市,西湳里,17,1,1097,28,1125,1645,0,0,0,0,0,0,68.39
臺中縣,豐原市,西湳里,18,1,1052,29,1081,1658,0,0,0,0,0,0,65.20
臺中縣,豐原市,西湳里,19,1,727,14,741,1172,0,0,0,0,0,0,63.23
臺中縣,豐原市,西湳里,20,1,570,14,584,971,0,0,0,0,0,0,60.14
臺中縣,豐原市,豐西里,21,1,1153,23,1176,1700,0,0,0,0,0,0,69.18
臺中縣,豐原市,圳寮里,22,1,800,14,814,1093,0,0,0,0,0,0,74.47
臺中縣,豐原市,豐圳里,23,1,828,7,835,1234,0,0,0,0,0,0,67.67
臺中縣,豐原市,豐圳里,24,1,939,21,960,1377,0,0,0,0,0,0,69.72
臺中縣,豐原市,富春里,25,1,704,11,715,881,0,0,0,0,0,0,81.16
臺中縣,豐原市,葫蘆里,26,1,602,5,607,880,0,0,0,0,0,0,68.98
臺中縣,豐原市,西安里,27,1,1010,21,1031,1437,0,0,0,0,0,0,71.75
臺中縣,豐原市,西安里,28,1,1039,19,1058,1623,0,0,0,0,0,0,65.19
臺中縣,豐原市,西安里,29,1,954,10,964,1497,0,0,0,0,0,0,64.40
臺中縣,豐原市,西勢里,30,1,725,5,730,1050,0,0,0,0,0,0,69.52
臺中縣,豐原市,西勢里,31,1,707,12,719,981,0,0,0,0,0,0,73.29
臺中縣,豐原市,中興里,32,1,875,10,885,1255,0,0,0,0,0,0,70.52
臺中縣,豐原市,中興里,33,1,935,5,940,1382,0,0,0,0,0,0,68.02
臺中縣,豐原市,社皮里,34,1,852,15,867,1347,0,0,0,0,0,0,64.37
臺中縣,豐原市,社皮里,35,1,940,26,966,1377,0,0,0,0,0,0,70.15
臺中縣,豐原市,社皮里,36,1,881,25,906,1424,0,0,0,0,0,0,63.62
臺中縣,豐原市,社皮里,37,1,749,5,754,1408,0,0,0,0,0,0,53.55
臺中縣,豐原市,社皮里,38,1,863,18,881,1366,0,0,0,0,0,0,64.49
臺中縣,豐原市,三村里,39,1,921,27,948,1413,0,0,0,0,0,0,67.09
臺中縣,豐原市,三村里,40,1,880,9,889,1337,0,0,0,0,0,0,66.49
臺中縣,豐原市,三村里,41,1,951,21,972,1348,0,0,0,0,0,0,72.11
臺中縣,豐原市,東勢里,42,1,931,21,952,1451,0,0,0,0,0,0,65.61
臺中縣,豐原市,民生里,43,1,731,6,737,1070,0,0,0,0,0,0,68.88
臺中縣,豐原市,田心里,44,1,969,28,997,1525,0,0,0,0,0,0,65.38
臺中縣,豐原市,田心里,45,1,924,9,933,1435,0,0,0,0,0,0,65.02
臺中縣,豐原市,田心里,46,1,857,13,870,1365,0,0,0,0,0,0,63.74
臺中縣,豐原市,豐田里,47,1,991,26,1017,1582,0,0,0,0,0,0,64.29
臺中縣,豐原市,豐田里,48,1,1043,29,1072,1708,0,0,0,0,0,0,62.76
臺中縣,豐原市,豐田里,49,1,947,20,967,1508,0,0,0,0,0,0,64.12
臺中縣,豐原市,豐田里,50,1,1003,25,1028,1525,0,0,0,0,0,0,67.41
臺中縣,豐原市,豐田里,51,1,1039,22,1061,1500,0,0,0,0,0,0,70.73
臺中縣,豐原市,鐮村里,52,1,1173,24,1197,1659,0,0,0,0,0,0,72.15
臺中縣,豐原市,鐮村里,53,1,1087,18,1105,1550,0,0,0,0,0,0,71.29
臺中縣,豐原市,陽明里,54,1,807,12,819,1154,0,0,0,0,0,0,70.97
臺中縣,豐原市,陽明里,55,1,819,10,829,1206,0,0,0,0,0,0,68.74
臺中縣,豐原市,南陽里,56,1,979,22,1001,1410,0,0,0,0,0,0,70.99
臺中縣,豐原市,南陽里,57,1,924,8,932,1446,0,0,0,0,0,0,64.45
臺中縣,豐原市,南陽里,58,1,900,14,914,1326,0,0,0,0,0,0,68.93
臺中縣,豐原市,南陽里,59,1,913,12,925,1384,0,0,0,0,0,0,66.84
臺中縣,豐原市,北陽里,60,1,908,12,920,1458,0,0,0,0,0,0,63.10
臺中縣,豐原市,北陽里,61,1,1135,13,1148,1707,0,0,0,0,0,0,67.25
臺中縣,豐原市,北陽里,62,1,1142,18,1160,1690,0,0,0,0,0,0,68.64
臺中縣,豐原市,北陽里,63,1,951,6,957,1441,0,0,0,0,0,0,66.41
臺中縣,豐原市,北陽里,64,1,950,13,963,1428,0,0,0,0,0,0,67.44
臺中縣,豐原市,北陽里,65,1,1024,20,1044,1555,0,0,0,0,0,0,67.14
臺中縣,豐原市,東陽里,66,1,1129,22,1151,1556,0,0,0,0,0,0,73.97
臺中縣,豐原市,南村里,67,1,763,11,774,1122,0,0,0,0,0,0,68.98
臺中縣,豐原市,南村里,68,1,807,10,817,1293,0,0,0,0,0,0,63.19
臺中縣,豐原市,南村里,69,1,750,7,757,1165,0,0,0,0,0,0,64.98
臺中縣,豐原市,南田里,70,1,1307,31,1338,1743,0,0,0,0,0,0,76.76
臺中縣,豐原市,南田里,71,1,961,18,979,1310,0,0,0,0,0,0,74.73
臺中縣,豐原市,南嵩里,72,1,974,25,999,1401,0,0,0,0,0,0,71.31
臺中縣,豐原市,南嵩里,73,1,1019,13,1032,1371,0,0,0,0,0,0,75.27
臺中縣,豐原市,翁明里,74,1,1100,27,1127,1529,0,0,0,0,0,0,73.71
臺中縣,豐原市,翁子里,75,1,884,16,900,1286,0,0,0,0,0,0,69.98
臺中縣,豐原市,翁子里,76,1,596,6,602,915,0,0,0,0,0,0,65.79
臺中縣,豐原市,翁社里,77,1,584,16,600,791,0,0,0,0,0,0,75.85
臺中縣,豐原市,翁社里,78,1,710,31,741,999,0,0,0,0,0,0,74.17
臺中縣,豐原市,朴子里,79,1,1095,36,1131,1476,0,0,0,0,0,0,76.63
臺中縣,豐原市,朴子里,80,1,856,20,876,1253,0,0,0,0,0,0,69.91
臺中縣,東勢鎮,北興里,81,1,862,27,889,1179,0,0,0,0,0,0,75.40
臺中縣,東勢鎮,中寧里,82,1,661,13,674,879,0,0,0,0,0,0,76.68
臺中縣,東勢鎮,東安里,83,1,1057,31,1088,1502,0,0,0,0,0,0,72.44
臺中縣,東勢鎮,南平里,84,1,668,14,682,861,0,0,0,0,0,0,79.21
臺中縣,東勢鎮,南平里,85,1,790,21,811,1065,0,0,0,0,0,0,76.15
臺中縣,東勢鎮,延平里,86,1,868,19,887,1226,0,0,0,0,0,0,72.35
臺中縣,東勢鎮,延平里,87,1,801,17,818,1124,0,0,0,0,0,0,72.78
臺中縣,東勢鎮,上新里,88,1,763,20,783,1014,0,0,0,0,0,0,77.22
臺中縣,東勢鎮,廣興里,89,1,1108,15,1123,1556,0,0,0,0,0,0,72.17
臺中縣,東勢鎮,泰昌里,90,1,881,20,901,1259,0,0,0,0,0,0,71.56
臺中縣,東勢鎮,泰昌里,91,1,760,13,773,1142,0,0,0,0,0,0,67.69
臺中縣,東勢鎮,泰昌里,92,1,571,9,580,854,0,0,0,0,0,0,67.92
臺中縣,東勢鎮,中嵙里,93,1,659,10,669,901,0,0,0,0,0,0,74.25
臺中縣,東勢鎮,中嵙里,94,1,641,6,647,941,0,0,0,0,0,0,68.76
臺中縣,東勢鎮,福隆里,95,1,899,16,915,1221,0,0,0,0,0,0,74.94
臺中縣,東勢鎮,福隆里,96,1,1194,34,1228,1637,0,0,0,0,0,0,75.02
臺中縣,東勢鎮,隆興里,97,1,1021,11,1032,1405,0,0,0,0,0,0,73.45
臺中縣,東勢鎮,新盛里,98,1,884,17,901,1209,0,0,0,0,0,0,74.52
臺中縣,東勢鎮,新盛里,99,1,1125,19,1144,1492,0,0,0,0,0,0,76.68
臺中縣,東勢鎮,新盛里,100,1,1220,19,1239,1594,0,0,0,0,0,0,77.73
臺中縣,東勢鎮,詒福里,101,1,1052,24,1076,1443,0,0,0,0,0,0,74.57
臺中縣,東勢鎮,上城里,102,1,733,10,743,984,0,0,0,0,0,0,75.51
臺中縣,東勢鎮,下城里,103,1,714,14,728,896,0,0,0,0,0,0,81.25
臺中縣,東勢鎮,慶東里,104,1,811,14,825,1057,0,0,0,0,0,0,78.05
臺中縣,東勢鎮,慶東里,105,1,678,7,685,872,0,0,0,0,0,0,78.56
臺中縣,東勢鎮,慶福里,106,1,997,13,1010,1364,0,0,0,0,0,0,74.05
臺中縣,東勢鎮,東新里,107,1,721,14,735,1072,0,0,0,0,0,0,68.56
臺中縣,東勢鎮,東新里,108,1,544,16,560,781,0,0,0,0,0,0,71.70
臺中縣,東勢鎮,粵寧里,109,1,917,13,930,1173,0,0,0,0,0,0,79.28
臺中縣,東勢鎮,粵寧里,110,1,439,14,453,665,0,0,0,0,0,0,68.12
臺中縣,東勢鎮,下新里,111,1,1182,23,1205,1519,0,0,0,0,0,0,79.33
臺中縣,東勢鎮,興隆里,112,1,851,15,866,1224,0,0,0,0,0,0,70.75
臺中縣,東勢鎮,茂興里,113,1,1115,21,1136,1595,0,0,0,0,0,0,71.22
臺中縣,東勢鎮,泰興里,114,1,561,14,575,741,0,0,0,0,0,0,77.60
臺中縣,東勢鎮,埤頭里,115,1,554,8,562,662,0,0,0,0,0,0,84.89
臺中縣,東勢鎮,明正里,116,1,1018,25,1043,1382,0,0,0,0,0,0,75.47
臺中縣,大甲鎮,朝陽里,117,1,869,14,883,1211,0,0,0,0,0,0,72.91
臺中縣,大甲鎮,大甲里,118,1,841,14,855,1165,0,0,0,0,0,0,73.39
臺中縣,大甲鎮,順天里,119,1,602,13,615,820,0,0,0,0,0,0,75.00
臺中縣,大甲鎮,順天里,120,1,559,12,571,820,0,0,0,0,0,0,69.63
臺中縣,大甲鎮,孔門里,121,1,544,11,555,732,0,0,0,0,0,0,75.82
臺中縣,大甲鎮,平安里,122,1,609,13,622,824,0,0,0,0,0,0,75.49
臺中縣,大甲鎮,平安里,123,1,710,11,721,939,0,0,0,0,0,0,76.78
臺中縣,大甲鎮,庄美里,124,1,671,10,681,913,0,0,0,0,0,0,74.59
臺中縣,大甲鎮,庄美里,125,1,659,15,674,948,0,0,0,0,0,0,71.10
臺中縣,大甲鎮,新美里,126,1,715,17,732,990,0,0,0,0,0,0,73.94
臺中縣,大甲鎮,新美里,127,1,727,10,737,1027,0,0,0,0,0,0,71.76
臺中縣,大甲鎮,新美里,128,1,705,16,721,979,0,0,0,0,0,0,73.65
臺中縣,大甲鎮,岷山里,129,1,555,7,562,763,0,0,0,0,0,0,73.66
臺中縣,大甲鎮,岷山里,130,1,619,11,630,809,0,0,0,0,0,0,77.87
臺中縣,大甲鎮,中山里,131,1,641,21,662,948,0,0,0,0,0,0,69.83
臺中縣,大甲鎮,中山里,132,1,671,10,681,965,0,0,0,0,0,0,70.57
臺中縣,大甲鎮,中山里,133,1,717,21,738,1050,0,0,0,0,0,0,70.29
臺中縣,大甲鎮,南陽里,134,1,659,17,676,880,0,0,0,0,0,0,76.82
臺中縣,大甲鎮,薰風里,135,1,622,11,633,880,0,0,0,0,0,0,71.93
臺中縣,大甲鎮,義和里,136,1,820,22,842,1153,0,0,0,0,0,0,73.03
臺中縣,大甲鎮,義和里,137,1,883,16,899,1248,0,0,0,0,0,0,72.04
臺中縣,大甲鎮,武陵里,138,1,819,22,841,991,0,0,0,0,0,0,84.86
臺中縣,大甲鎮,文曲里,139,1,830,15,845,1031,0,0,0,0,0,0,81.96
臺中縣,大甲鎮,武曲里,140,1,1052,14,1066,1390,0,0,0,0,0,0,76.69
臺中縣,大甲鎮,文武里,141,1,768,14,782,1085,0,0,0,0,0,0,72.07
臺中縣,大甲鎮,文武里,142,1,706,15,721,980,0,0,0,0,0,0,73.57
臺中縣,大甲鎮,文武里,143,1,732,9,741,1026,0,0,0,0,0,0,72.22
臺中縣,大甲鎮,文武里,144,1,667,6,673,982,0,0,0,0,0,0,68.53
臺中縣,大甲鎮,奉化里,145,1,824,22,846,1089,0,0,0,0,0,0,77.69
臺中縣,大甲鎮,德化里,146,1,894,11,905,1433,0,0,0,0,0,0,63.15
臺中縣,大甲鎮,江南里,147,1,728,14,742,942,0,0,0,0,0,0,78.77
臺中縣,大甲鎮,頂店里,148,1,669,18,687,898,0,0,0,0,0,0,76.50
臺中縣,大甲鎮,頂店里,149,1,784,22,806,1011,0,0,0,0,0,0,79.72
臺中縣,大甲鎮,頂店里,150,1,779,23,802,1086,0,0,0,0,0,0,73.85
臺中縣,大甲鎮,太白里,151,1,880,23,903,1179,0,0,0,0,0,0,76.59
臺中縣,大甲鎮,孟春里,152,1,755,7,762,1011,0,0,0,0,0,0,75.37
臺中縣,大甲鎮,孟春里,153,1,681,19,700,913,0,0,0,0,0,0,76.67
臺中縣,大甲鎮,孟春里,154,1,607,20,627,874,0,0,0,0,0,0,71.74
臺中縣,大甲鎮,幸福里,155,1,810,10,820,1099,0,0,0,0,0,0,74.61
臺中縣,大甲鎮,幸福里,156,1,815,14,829,1160,0,0,0,0,0,0,71.47
臺中縣,大甲鎮,日南里,157,1,940,8,948,1355,0,0,0,0,0,0,69.96
臺中縣,大甲鎮,日南里,158,1,844,17,861,1163,0,0,0,0,0,0,74.03
臺中縣,大甲鎮,日南里,159,1,672,9,681,948,0,0,0,0,0,0,71.84
臺中縣,大甲鎮,龍泉里,160,1,1025,21,1046,1320,0,0,0,0,0,0,79.24
臺中縣,大甲鎮,西岐里,161,1,551,5,556,721,0,0,0,0,0,0,77.12
臺中縣,大甲鎮,西岐里,162,1,553,18,571,720,0,0,0,0,0,0,79.31
臺中縣,大甲鎮,銅安里,163,1,863,13,876,1135,0,0,0,0,0,0,77.18
臺中縣,大甲鎮,福德里,164,1,840,12,852,1025,0,0,0,0,0,0,83.12
臺中縣,大甲鎮,建興里,165,1,979,7,986,1230,0,0,0,0,0,0,80.16
臺中縣,清水鎮,鰲峰里,166,1,813,24,837,1229,0,0,0,0,0,0,68.10
臺中縣,清水鎮,靈泉里,167,1,790,10,800,1055,0,0,0,0,0,0,75.83
臺中縣,清水鎮,清水里,168,1,665,6,671,996,0,0,0,0,0,0,67.37
臺中縣,清水鎮,清水里,169,1,665,23,688,1029,0,0,0,0,0,0,66.86
臺中縣,清水鎮,文昌里,170,1,539,4,543,741,0,0,0,0,0,0,73.28
臺中縣,清水鎮,南寧里,171,1,685,6,691,969,0,0,0,0,0,0,71.31
臺中縣,清水鎮,南寧里,172,1,688,10,698,996,0,0,0,0,0,0,70.08
臺中縣,清水鎮,西寧里,173,1,1006,19,1025,1364,0,0,0,0,0,0,75.15
臺中縣,清水鎮,北寧里,174,1,520,6,526,701,0,0,0,0,0,0,75.04
臺中縣,清水鎮,中興里,175,1,332,7,339,465,0,0,0,0,0,0,72.90
臺中縣,清水鎮,西社里,176,1,1030,16,1046,1397,0,0,0,0,0,0,74.87
臺中縣,清水鎮,西社里,177,1,707,11,718,945,0,0,0,0,0,0,75.98
臺中縣,清水鎮,南社里,178,1,681,10,691,1001,0,0,0,0,0,0,69.03
臺中縣,清水鎮,南社里,179,1,1000,11,1011,1303,0,0,0,0,0,0,77.59
臺中縣,清水鎮,南社里,180,1,1032,15,1047,1458,0,0,0,0,0,0,71.81
臺中縣,清水鎮,裕嘉里,181,1,809,21,830,1092,0,0,0,0,0,0,76.01
臺中縣,清水鎮,臨江里,182,1,1067,22,1089,1370,0,0,0,0,0,0,79.49
臺中縣,清水鎮,秀水里,183,1,800,13,813,1101,0,0,0,0,0,0,73.84
臺中縣,清水鎮,秀水里,184,1,780,19,799,1139,0,0,0,0,0,0,70.15
臺中縣,清水鎮,秀水里,185,1,617,11,628,826,0,0,0,0,0,0,76.03
臺中縣,清水鎮,武鹿里,186,1,993,8,1001,1278,0,0,0,0,0,0,78.33
臺中縣,清水鎮,武鹿里,187,1,940,21,961,1243,0,0,0,0,0,0,77.31
臺中縣,清水鎮,海濱里,188,1,804,10,814,1024,0,0,0,0,0,0,79.49
臺中縣,清水鎮,海濱里,189,1,545,15,560,726,0,0,0,0,0,0,77.13
臺中縣,清水鎮,康榔里,190,1,1020,15,1035,1463,0,0,0,0,0,0,70.75
臺中縣,清水鎮,康榔里,191,1,1077,25,1102,1544,0,0,0,0,0,0,71.37
臺中縣,清水鎮,中社里,192,1,943,13,956,1269,0,0,0,0,0,0,75.33
臺中縣,清水鎮,中社里,193,1,447,9,456,665,0,0,0,0,0,0,68.57
臺中縣,清水鎮,高西里,194,1,982,11,993,1274,0,0,0,0,0,0,77.94
臺中縣,清水鎮,高南里,195,1,953,20,973,1243,0,0,0,0,0,0,78.28
臺中縣,清水鎮,高東里,196,1,909,30,939,1253,0,0,0,0,0,0,74.94
臺中縣,清水鎮,高北里,197,1,757,15,772,987,0,0,0,0,0,0,78.22
臺中縣,清水鎮,高美里,198,1,981,14,995,1232,0,0,0,0,0,0,80.76
臺中縣,清水鎮,國姓里,199,1,706,10,716,1067,0,0,0,0,0,0,67.10
臺中縣,清水鎮,國姓里,200,1,608,7,615,855,0,0,0,0,0,0,71.93
臺中縣,清水鎮,菁埔里,201,1,806,16,822,1018,0,0,0,0,0,0,80.75
臺中縣,清水鎮,菁埔里,202,1,749,7,756,1061,0,0,0,0,0,0,71.25
臺中縣,清水鎮,頂湳里,203,1,569,9,578,818,0,0,0,0,0,0,70.66
臺中縣,清水鎮,頂湳里,204,1,685,11,696,889,0,0,0,0,0,0,78.29
臺中縣,清水鎮,田寮里,205,1,773,16,789,1089,0,0,0,0,0,0,72.45
臺中縣,清水鎮,田寮里,206,1,595,7,602,917,0,0,0,0,0,0,65.65
臺中縣,清水鎮,橋頭里,207,1,999,19,1018,1429,0,0,0,0,0,0,71.24
臺中縣,清水鎮,橋頭里,208,1,967,22,989,1382,0,0,0,0,0,0,71.56
臺中縣,清水鎮,橋頭里,209,1,549,17,566,782,0,0,0,0,0,0,72.38
臺中縣,清水鎮,橋頭里,210,1,988,14,1002,1385,0,0,0,0,0,0,72.35
臺中縣,清水鎮,下湳里,211,1,563,7,570,796,0,0,0,0,0,0,71.61
臺中縣,清水鎮,下湳里,212,1,591,10,601,793,0,0,0,0,0,0,75.79
臺中縣,清水鎮,下湳里,213,1,913,11,924,1272,0,0,0,0,0,0,72.64
臺中縣,清水鎮,東山里,214,1,835,23,858,1085,0,0,0,0,0,0,79.08
臺中縣,清水鎮,吳厝里,215,1,865,17,882,1101,0,0,0,0,0,0,80.11
臺中縣,清水鎮,楊厝里,216,1,770,5,775,964,0,0,0,0,0,0,80.39
臺中縣,清水鎮,海風里,217,1,833,14,847,1132,0,0,0,0,0,0,74.82
臺中縣,沙鹿鎮,居仁里,218,1,1032,12,1044,1328,0,0,0,0,0,0,78.61
臺中縣,沙鹿鎮,洛泉里,219,1,759,6,765,1012,0,0,0,0,0,0,75.59
臺中縣,沙鹿鎮,洛泉里,220,1,973,14,987,1224,0,0,0,0,0,0,80.64
臺中縣,沙鹿鎮,沙鹿里,221,1,843,16,859,1152,0,0,0,0,0,0,74.57
臺中縣,沙鹿鎮,美仁里,222,1,451,9,460,578,0,0,0,0,0,0,79.58
臺中縣,沙鹿鎮,興仁里,223,1,887,16,903,1234,0,0,0,0,0,0,73.18
臺中縣,沙鹿鎮,興仁里,224,1,710,10,720,955,0,0,0,0,0,0,75.39
臺中縣,沙鹿鎮,興安里,225,1,698,9,707,913,0,0,0,0,0,0,77.44
臺中縣,沙鹿鎮,興安里,226,1,1066,19,1085,1524,0,0,0,0,0,0,71.19
臺中縣,沙鹿鎮,斗抵里,227,1,772,15,787,1017,0,0,0,0,0,0,77.38
臺中縣,沙鹿鎮,斗抵里,228,1,843,19,862,1141,0,0,0,0,0,0,75.55
臺中縣,沙鹿鎮,斗抵里,229,1,913,11,924,1167,0,0,0,0,0,0,79.18
臺中縣,沙鹿鎮,鹿峰里,230,1,927,14,941,1230,0,0,0,0,0,0,76.50
臺中縣,沙鹿鎮,鹿峰里,231,1,831,13,844,1083,0,0,0,0,0,0,77.93
臺中縣,沙鹿鎮,鹿峰里,232,1,903,11,914,1158,0,0,0,0,0,0,78.93
臺中縣,沙鹿鎮,鹿寮里,233,1,1079,9,1088,1442,0,0,0,0,0,0,75.45
臺中縣,沙鹿鎮,鹿寮里,234,1,741,6,747,1035,0,0,0,0,0,0,72.17
臺中縣,沙鹿鎮,鹿寮里,235,1,741,10,751,1032,0,0,0,0,0,0,72.77
臺中縣,沙鹿鎮,鹿寮里,236,1,834,12,846,1129,0,0,0,0,0,0,74.93
臺中縣,沙鹿鎮,竹林里,237,1,896,11,907,1156,0,0,0,0,0,0,78.46
臺中縣,沙鹿鎮,竹林里,238,1,888,16,904,1308,0,0,0,0,0,0,69.11
臺中縣,沙鹿鎮,竹林里,239,1,922,25,947,1347,0,0,0,0,0,0,70.30
臺中縣,沙鹿鎮,竹林里,240,1,680,8,688,981,0,0,0,0,0,0,70.13
臺中縣,沙鹿鎮,犁分里,241,1,650,14,664,831,0,0,0,0,0,0,79.90
臺中縣,沙鹿鎮,福興里,242,1,811,11,822,1177,0,0,0,0,0,0,69.84
臺中縣,沙鹿鎮,福興里,243,1,586,9,595,784,0,0,0,0,0,0,75.89
臺中縣,沙鹿鎮,北勢里,244,1,1098,19,1117,1531,0,0,0,0,0,0,72.96
臺中縣,沙鹿鎮,北勢里,245,1,933,22,955,1267,0,0,0,0,0,0,75.37
臺中縣,沙鹿鎮,晉江里,246,1,889,10,899,1129,0,0,0,0,0,0,79.63
臺中縣,沙鹿鎮,六路里,247,1,1060,24,1084,1528,0,0,0,0,0,0,70.94
臺中縣,沙鹿鎮,南勢里,248,1,1210,16,1226,1580,0,0,0,0,0,0,77.59
臺中縣,沙鹿鎮,埔子里,249,1,1161,27,1188,1618,0,0,0,0,0,0,73.42
臺中縣,沙鹿鎮,埔子里,250,1,1127,30,1157,1641,0,0,0,0,0,0,70.51
臺中縣,沙鹿鎮,公明里,251,1,869,20,889,1175,0,0,0,0,0,0,75.66
臺中縣,沙鹿鎮,公明里,252,1,650,8,658,927,0,0,0,0,0,0,70.98
臺中縣,沙鹿鎮,公明里,253,1,933,13,946,1213,0,0,0,0,0,0,77.99
臺中縣,沙鹿鎮,清泉里,254,1,1217,27,1244,1594,0,0,0,0,0,0,78.04
臺中縣,沙鹿鎮,西勢里,255,1,764,27,791,1040,0,0,0,0,0,0,76.06
臺中縣,沙鹿鎮,西勢里,256,1,717,10,727,912,0,0,0,0,0,0,79.71
臺中縣,梧棲鎮,頂寮里,257,1,645,5,650,883,0,0,0,0,0,0,73.61
臺中縣,梧棲鎮,頂寮里,258,1,888,14,902,1265,0,0,0,0,0,0,71.30
臺中縣,梧棲鎮,下寮里,259,1,742,16,758,1002,0,0,0,0,0,0,75.65
臺中縣,梧棲鎮,下寮里,260,1,697,16,713,970,0,0,0,0,0,0,73.51
臺中縣,梧棲鎮,中正里,261,1,806,9,815,1054,0,0,0,0,0,0,77.32
臺中縣,梧棲鎮,中正里,262,1,635,9,644,942,0,0,0,0,0,0,68.37
臺中縣,梧棲鎮,中正里,263,1,686,8,694,1030,0,0,0,0,0,0,67.38
臺中縣,梧棲鎮,中和里,264,1,391,8,399,540,0,0,0,0,0,0,73.89
臺中縣,梧棲鎮,文化里,265,1,813,16,829,1101,0,0,0,0,0,0,75.30
臺中縣,梧棲鎮,安仁里,266,1,522,5,527,719,0,0,0,0,0,0,73.30
臺中縣,梧棲鎮,草湳里,267,1,1104,30,1134,1633,0,0,0,0,0,0,69.44
臺中縣,梧棲鎮,草湳里,268,1,1070,19,1089,1512,0,0,0,0,0,0,72.02
臺中縣,梧棲鎮,草湳里,269,1,919,15,934,1211,0,0,0,0,0,0,77.13
臺中縣,梧棲鎮,南簡里,270,1,853,19,872,1132,0,0,0,0,0,0,77.03
臺中縣,梧棲鎮,南簡里,271,1,616,7,623,906,0,0,0,0,0,0,68.76
臺中縣,梧棲鎮,福德里,272,1,917,20,937,1248,0,0,0,0,0,0,75.08
臺中縣,梧棲鎮,福德里,273,1,776,12,788,1101,0,0,0,0,0,0,71.57
臺中縣,梧棲鎮,大庄里,274,1,758,17,775,1026,0,0,0,0,0,0,75.54
臺中縣,梧棲鎮,大庄里,275,1,564,14,578,810,0,0,0,0,0,0,71.36
臺中縣,梧棲鎮,大庄里,276,1,849,12,861,1179,0,0,0,0,0,0,73.03
臺中縣,梧棲鎮,大庄里,277,1,962,20,982,1366,0,0,0,0,0,0,71.89
臺中縣,梧棲鎮,大村里,278,1,870,17,887,1178,0,0,0,0,0,0,75.30
臺中縣,梧棲鎮,大村里,279,1,696,15,711,1018,0,0,0,0,0,0,69.84
臺中縣,梧棲鎮,大村里,280,1,671,8,679,885,0,0,0,0,0,0,76.72
臺中縣,梧棲鎮,興農里,281,1,764,13,777,981,0,0,0,0,0,0,79.20
臺中縣,梧棲鎮,興農里,282,1,502,9,511,661,0,0,0,0,0,0,77.31
臺中縣,梧棲鎮,永寧里,283,1,704,10,714,914,0,0,0,0,0,0,78.12
臺中縣,梧棲鎮,永寧里,284,1,748,21,769,1012,0,0,0,0,0,0,75.99
臺中縣,梧棲鎮,永安里,285,1,820,8,828,1028,0,0,0,0,0,0,80.54
臺中縣,梧棲鎮,永安里,286,1,741,17,758,968,0,0,0,0,0,0,78.31
臺中縣,后里鄉,廣福村,287,1,681,13,694,871,0,0,0,0,0,0,79.68
臺中縣,后里鄉,廣福村,288,1,678,9,687,942,0,0,0,0,0,0,72.93
臺中縣,后里鄉,仁里村,289,1,693,19,712,905,0,0,0,0,0,0,78.67
臺中縣,后里鄉,仁里村,290,1,1051,22,1073,1377,0,0,0,0,0,0,77.92
臺中縣,后里鄉,義里村,291,1,727,22,749,1034,0,0,0,0,0,0,72.44
臺中縣,后里鄉,義里村,292,1,909,20,929,1266,0,0,0,0,0,0,73.38
臺中縣,后里鄉,義里村,293,1,850,20,870,1187,0,0,0,0,0,0,73.29
臺中縣,后里鄉,義里村,294,1,934,21,955,1333,0,0,0,0,0,0,71.64
臺中縣,后里鄉,后里村,295,1,770,14,784,989,0,0,0,0,0,0,79.27
臺中縣,后里鄉,后里村,296,1,904,15,919,1179,0,0,0,0,0,0,77.95
臺中縣,后里鄉,后里村,297,1,750,16,766,973,0,0,0,0,0,0,78.73
臺中縣,后里鄉,厚里村,298,1,1292,21,1313,1693,0,0,0,0,0,0,77.55
臺中縣,后里鄉,墩東村,299,1,908,19,927,1241,0,0,0,0,0,0,74.70
臺中縣,后里鄉,墩東村,300,1,850,19,869,1191,0,0,0,0,0,0,72.96
臺中縣,后里鄉,墩東村,301,1,930,19,949,1207,0,0,0,0,0,0,78.62
臺中縣,后里鄉,墩西村,302,1,705,9,714,881,0,0,0,0,0,0,81.04
臺中縣,后里鄉,墩西村,303,1,719,15,734,914,0,0,0,0,0,0,80.31
臺中縣,后里鄉,墩南村,304,1,774,22,796,1033,0,0,0,0,0,0,77.06
臺中縣,后里鄉,墩南村,305,1,982,19,1001,1238,0,0,0,0,0,0,80.86
臺中縣,后里鄉,墩北村,306,1,937,7,944,1230,0,0,0,0,0,0,76.75
臺中縣,后里鄉,墩北村,307,1,1083,17,1100,1406,0,0,0,0,0,0,78.24
臺中縣,后里鄉,中和村,308,1,1398,38,1436,1765,0,0,0,0,0,0,81.36
臺中縣,后里鄉,舊社村,309,1,909,27,936,1151,0,0,0,0,0,0,81.32
臺中縣,后里鄉,聯合村,310,1,1124,35,1159,1423,0,0,0,0,0,0,81.45
臺中縣,后里鄉,太平村,311,1,676,20,696,848,0,0,0,0,0,0,82.08
臺中縣,后里鄉,太平村,312,1,773,20,793,972,0,0,0,0,0,0,81.58
臺中縣,后里鄉,眉山村,313,1,869,20,889,1123,0,0,0,0,0,0,79.16
臺中縣,后里鄉,眉山村,314,1,790,14,804,1069,0,0,0,0,0,0,75.21
臺中縣,后里鄉,樂業村,315,1,261,6,267,329,0,0,0,0,0,0,81.16
臺中縣,后里鄉,月眉村,316,1,1169,20,1189,1477,0,0,0,0,0,0,80.50
臺中縣,后里鄉,公館村,317,1,1255,32,1287,1682,0,0,0,0,0,0,76.52
臺中縣,后里鄉,泰安村,318,1,928,19,947,1197,0,0,0,0,0,0,79.11
臺中縣,神岡鄉,神岡村,319,1,834,18,852,1208,0,0,0,0,0,0,70.53
臺中縣,神岡鄉,神岡村,320,1,675,11,686,1001,0,0,0,0,0,0,68.53
臺中縣,神岡鄉,庄前村,321,1,1001,22,1023,1374,0,0,0,0,0,0,74.45
臺中縣,神岡鄉,北庄村,322,1,597,6,603,832,0,0,0,0,0,0,72.48
臺中縣,神岡鄉,北庄村,323,1,765,19,784,1095,0,0,0,0,0,0,71.60
臺中縣,神岡鄉,庄後村,324,1,713,14,727,1016,0,0,0,0,0,0,71.56
臺中縣,神岡鄉,庄後村,325,1,628,11,639,805,0,0,0,0,0,0,79.38
臺中縣,神岡鄉,圳前村,326,1,819,18,837,1082,0,0,0,0,0,0,77.36
臺中縣,神岡鄉,圳前村,327,1,642,16,658,968,0,0,0,0,0,0,67.98
臺中縣,神岡鄉,圳堵村,328,1,737,9,746,884,0,0,0,0,0,0,84.39
臺中縣,神岡鄉,圳堵村,329,1,783,22,805,1034,0,0,0,0,0,0,77.85
臺中縣,神岡鄉,新庄村,330,1,852,9,861,1085,0,0,0,0,0,0,79.35
臺中縣,神岡鄉,新庄村,331,1,804,10,814,1104,0,0,0,0,0,0,73.73
臺中縣,神岡鄉,新庄村,332,1,803,16,819,1109,0,0,0,0,0,0,73.85
臺中縣,神岡鄉,山皮村,333,1,660,10,670,873,0,0,0,0,0,0,76.75
臺中縣,神岡鄉,社口村,334,1,820,15,835,1062,0,0,0,0,0,0,78.63
臺中縣,神岡鄉,社口村,335,1,890,17,907,1242,0,0,0,0,0,0,73.03
臺中縣,神岡鄉,社口村,336,1,785,12,797,1022,0,0,0,0,0,0,77.98
臺中縣,神岡鄉,社口村,337,1,872,13,885,1194,0,0,0,0,0,0,74.12
臺中縣,神岡鄉,社南村,338,1,819,27,846,1185,0,0,0,0,0,0,71.39
臺中縣,神岡鄉,社南村,339,1,797,17,814,1154,0,0,0,0,0,0,70.54
臺中縣,神岡鄉,社南村,340,1,669,21,690,1034,0,0,0,0,0,0,66.73
臺中縣,神岡鄉,三角村,341,1,822,14,836,1166,0,0,0,0,0,0,71.70
臺中縣,神岡鄉,三角村,342,1,503,6,509,762,0,0,0,0,0,0,66.80
臺中縣,神岡鄉,大社村,343,1,773,17,790,1064,0,0,0,0,0,0,74.25
臺中縣,神岡鄉,大社村,344,1,849,15,864,1350,0,0,0,0,0,0,64.00
臺中縣,神岡鄉,岸裡村,345,1,747,9,756,1038,0,0,0,0,0,0,72.83
臺中縣,神岡鄉,岸裡村,346,1,798,17,815,1141,0,0,0,0,0,0,71.43
臺中縣,神岡鄉,豐洲村,347,1,929,20,949,1406,0,0,0,0,0,0,67.50
臺中縣,神岡鄉,豐洲村,348,1,959,21,980,1377,0,0,0,0,0,0,71.17
臺中縣,神岡鄉,豐洲村,349,1,987,23,1010,1383,0,0,0,0,0,0,73.03
臺中縣,神岡鄉,豐洲村,350,1,947,19,966,1443,0,0,0,0,0,0,66.94
臺中縣,神岡鄉,神洲村,351,1,765,13,778,1020,0,0,0,0,0,0,76.27
臺中縣,神岡鄉,神洲村,352,1,808,15,823,1077,0,0,0,0,0,0,76.42
臺中縣,神岡鄉,溪洲村,353,1,918,27,945,1148,0,0,0,0,0,0,82.32
臺中縣,神岡鄉,溪洲村,354,1,863,19,882,1116,0,0,0,0,0,0,79.03
臺中縣,潭子鄉,潭秀村,355,1,975,18,993,1412,0,0,0,0,0,0,70.33
臺中縣,潭子鄉,潭北村,356,1,1271,18,1289,1969,0,0,0,0,0,0,65.46
臺中縣,潭子鄉,潭陽村,357,1,883,21,904,1384,0,0,0,0,0,0,65.32
臺中縣,潭子鄉,潭陽村,358,1,1097,21,1118,1748,0,0,0,0,0,0,63.96
臺中縣,潭子鄉,潭陽村,359,1,732,9,741,1216,0,0,0,0,0,0,60.94
臺中縣,潭子鄉,潭陽村,360,1,1054,20,1074,1587,0,0,0,0,0,0,67.67
臺中縣,潭子鄉,潭陽村,361,1,934,28,962,1448,0,0,0,0,0,0,66.44
臺中縣,潭子鄉,福仁村,362,1,1070,17,1087,1580,0,0,0,0,0,0,68.80
臺中縣,潭子鄉,福仁村,363,1,1073,17,1090,1961,0,0,0,0,0,0,55.58
臺中縣,潭子鄉,福仁村,364,1,1297,32,1329,2178,0,0,0,0,0,0,61.02
臺中縣,潭子鄉,頭家村,365,1,1080,15,1095,2193,0,0,0,0,0,0,49.93
臺中縣,潭子鄉,頭家村,366,1,745,17,762,1174,0,0,0,0,0,0,64.91
臺中縣,潭子鄉,頭家村,367,1,1198,15,1213,1734,0,0,0,0,0,0,69.95
臺中縣,潭子鄉,頭家村,368,1,1235,25,1260,1929,0,0,0,0,0,0,65.32
臺中縣,潭子鄉,頭家村,369,1,918,16,934,1415,0,0,0,0,0,0,66.01
臺中縣,潭子鄉,頭家村,370,1,925,11,936,1621,0,0,0,0,0,0,57.74
臺中縣,潭子鄉,頭家村,371,1,531,14,545,850,0,0,0,0,0,0,64.12
臺中縣,潭子鄉,甘蔗村,372,1,1121,15,1136,1683,0,0,0,0,0,0,67.50
臺中縣,潭子鄉,甘蔗村,373,1,904,19,923,1337,0,0,0,0,0,0,69.04
臺中縣,潭子鄉,甘蔗村,374,1,990,8,998,1709,0,0,0,0,0,0,58.40
臺中縣,潭子鄉,東寶村,375,1,740,15,755,990,0,0,0,0,0,0,76.26
臺中縣,潭子鄉,東寶村,376,1,1289,25,1314,2023,0,0,0,0,0,0,64.95
臺中縣,潭子鄉,東寶村,377,1,1022,11,1033,1549,0,0,0,0,0,0,66.69
臺中縣,潭子鄉,東寶村,378,1,1276,27,1303,1787,0,0,0,0,0,0,72.92
臺中縣,潭子鄉,東寶村,379,1,842,19,861,1251,0,0,0,0,0,0,68.82
臺中縣,潭子鄉,大富村,380,1,1013,13,1026,1296,0,0,0,0,0,0,79.17
臺中縣,潭子鄉,大豐村,381,1,660,7,667,898,0,0,0,0,0,0,74.28
臺中縣,潭子鄉,大豐村,382,1,1040,18,1058,1563,0,0,0,0,0,0,67.69
臺中縣,潭子鄉,栗林村,383,1,1075,20,1095,1542,0,0,0,0,0,0,71.01
臺中縣,潭子鄉,栗林村,384,1,924,20,944,1240,0,0,0,0,0,0,76.13
臺中縣,潭子鄉,栗林村,385,1,772,12,784,1040,0,0,0,0,0,0,75.38
臺中縣,潭子鄉,嘉仁村,386,1,1152,27,1179,1669,0,0,0,0,0,0,70.64
臺中縣,潭子鄉,嘉仁村,387,1,1043,14,1057,1415,0,0,0,0,0,0,74.70
臺中縣,潭子鄉,新田村,388,1,965,11,976,1424,0,0,0,0,0,0,68.54
臺中縣,潭子鄉,聚興村,389,1,910,9,919,1374,0,0,0,0,0,0,66.89
臺中縣,潭子鄉,聚興村,390,1,834,17,851,1335,0,0,0,0,0,0,63.75
臺中縣,大雅鄉,上雅村,391,1,1087,19,1106,1556,0,0,0,0,0,0,71.08
臺中縣,大雅鄉,上雅村,392,1,1125,26,1151,1612,0,0,0,0,0,0,71.40
臺中縣,大雅鄉,大雅村,393,1,1288,38,1326,1827,0,0,0,0,0,0,72.58
臺中縣,大雅鄉,大雅村,394,1,1147,22,1169,1628,0,0,0,0,0,0,71.81
臺中縣,大雅鄉,文雅村,395,1,944,18,962,1482,0,0,0,0,0,0,64.91
臺中縣,大雅鄉,文雅村,396,1,923,15,938,1287,0,0,0,0,0,0,72.88
臺中縣,大雅鄉,文雅村,397,1,753,17,770,1096,0,0,0,0,0,0,70.26
臺中縣,大雅鄉,三和村,398,1,1015,22,1037,1445,0,0,0,0,0,0,71.76
臺中縣,大雅鄉,三和村,399,1,981,25,1006,1409,0,0,0,0,0,0,71.40
臺中縣,大雅鄉,二和村,400,1,910,15,925,1312,0,0,0,0,0,0,70.50
臺中縣,大雅鄉,二和村,401,1,1024,14,1038,1449,0,0,0,0,0,0,71.64
臺中縣,大雅鄉,四德村,402,1,836,13,849,1260,0,0,0,0,0,0,67.38
臺中縣,大雅鄉,四德村,403,1,832,17,849,1230,0,0,0,0,0,0,69.02
臺中縣,大雅鄉,西寶村,404,1,678,17,695,946,0,0,0,0,0,0,73.47
臺中縣,大雅鄉,西寶村,405,1,1175,27,1202,1650,0,0,0,0,0,0,72.85
臺中縣,大雅鄉,上楓村,406,1,964,26,990,1395,0,0,0,0,0,0,70.97
臺中縣,大雅鄉,上楓村,407,1,875,13,888,1387,0,0,0,0,0,0,64.02
臺中縣,大雅鄉,上楓村,408,1,639,18,657,1036,0,0,0,0,0,0,63.42
臺中縣,大雅鄉,上楓村,409,1,886,24,910,1267,0,0,0,0,0,0,71.82
臺中縣,大雅鄉,上楓村,410,1,861,19,880,1166,0,0,0,0,0,0,75.47
臺中縣,大雅鄉,上楓村,411,1,687,15,702,979,0,0,0,0,0,0,71.71
臺中縣,大雅鄉,上楓村,412,1,578,20,598,1029,0,0,0,0,0,0,58.11
臺中縣,大雅鄉,員林村,413,1,1141,34,1175,1464,0,0,0,0,0,0,80.26
臺中縣,大雅鄉,員林村,414,1,1143,32,1175,1666,0,0,0,0,0,0,70.53
臺中縣,大雅鄉,員林村,415,1,1206,42,1248,1718,0,0,0,0,0,0,72.64
臺中縣,大雅鄉,六寶村,416,1,1378,29,1407,1832,0,0,0,0,0,0,76.80
臺中縣,大雅鄉,六寶村,417,1,1172,29,1201,1665,0,0,0,0,0,0,72.13
臺中縣,大雅鄉,六寶村,418,1,936,26,962,1369,0,0,0,0,0,0,70.27
臺中縣,大雅鄉,秀山村,419,1,1140,20,1160,1459,0,0,0,0,0,0,79.51
臺中縣,大雅鄉,秀山村,420,1,796,12,808,1012,0,0,0,0,0,0,79.84
臺中縣,大雅鄉,橫山村,421,1,1156,23,1179,1536,0,0,0,0,0,0,76.76
臺中縣,大雅鄉,橫山村,422,1,939,14,953,1250,0,0,0,0,0,0,76.24
臺中縣,大雅鄉,忠義村,423,1,972,22,994,1408,0,0,0,0,0,0,70.60
臺中縣,大雅鄉,忠義村,424,1,1195,28,1223,1799,0,0,0,0,0,0,67.98
臺中縣,新社鄉,新社村,425,1,969,21,990,1267,0,0,0,0,0,0,78.14
臺中縣,新社鄉,新社村,426,1,936,18,954,1214,0,0,0,0,0,0,78.58
臺中縣,新社鄉,復盛村,427,1,1255,22,1277,1647,0,0,0,0,0,0,77.53
臺中縣,新社鄉,中正村,428,1,952,11,963,1223,0,0,0,0,0,0,78.74
臺中縣,新社鄉,月湖村,429,1,699,14,713,913,0,0,0,0,0,0,78.09
臺中縣,新社鄉,崑山村,430,1,910,21,931,1220,0,0,0,0,0,0,76.31
臺中縣,新社鄉,大南村,431,1,1513,24,1537,1955,0,0,0,0,0,0,78.62
臺中縣,新社鄉,永源村,432,1,1393,48,1441,1807,0,0,0,0,0,0,79.75
臺中縣,新社鄉,永源村,433,1,558,6,564,674,0,0,0,0,0,0,83.68
臺中縣,新社鄉,中興村,434,1,628,9,637,818,0,0,0,0,0,0,77.87
臺中縣,新社鄉,協成村,435,1,920,9,929,1182,0,0,0,0,0,0,78.60
臺中縣,新社鄉,協成村,436,1,1008,21,1029,1325,0,0,0,0,0,0,77.66
臺中縣,新社鄉,東興村,437,1,1026,5,1031,1272,0,0,0,0,0,0,81.05
臺中縣,新社鄉,慶西村,438,1,227,0,227,273,0,0,0,0,0,0,83.15
臺中縣,新社鄉,慶西村,439,1,484,8,492,636,0,0,0,0,0,0,77.36
臺中縣,新社鄉,中和村,440,1,452,8,460,618,0,0,0,0,0,0,74.43
臺中縣,新社鄉,福興村,441,1,776,16,792,1065,0,0,0,0,0,0,74.37
臺中縣,新社鄉,福興村,442,1,182,4,186,278,0,0,0,0,0,0,66.91
臺中縣,石岡鄉,石岡村,443,1,673,10,683,919,0,0,0,0,0,0,74.32
臺中縣,石岡鄉,萬安村,444,1,853,14,867,1099,0,0,0,0,0,0,78.89
臺中縣,石岡鄉,九房村,445,1,727,24,751,957,0,0,0,0,0,0,78.47
臺中縣,石岡鄉,金星村,446,1,770,13,783,1102,0,0,0,0,0,0,71.05
臺中縣,石岡鄉,龍興村,447,1,514,4,518,647,0,0,0,0,0,0,80.06
臺中縣,石岡鄉,萬興村,448,1,970,15,985,1226,0,0,0,0,0,0,80.34
臺中縣,石岡鄉,梅子村,449,1,1239,21,1260,1651,0,0,0,0,0,0,76.32
臺中縣,石岡鄉,土牛村,450,1,717,15,732,952,0,0,0,0,0,0,76.89
臺中縣,石岡鄉,德興村,451,1,975,20,995,1303,0,0,0,0,0,0,76.36
臺中縣,石岡鄉,和盛村,452,1,968,24,992,1309,0,0,0,0,0,0,75.78
臺中縣,外埔鄉,永豐村,453,1,785,10,795,945,0,0,0,0,0,0,84.13
臺中縣,外埔鄉,六分村,454,1,1032,25,1057,1347,0,0,0,0,0,0,78.47
臺中縣,外埔鄉,三崁村,455,1,1255,27,1282,1599,0,0,0,0,0,0,80.18
臺中縣,外埔鄉,大同村,456,1,1348,12,1360,1682,0,0,0,0,0,0,80.86
臺中縣,外埔鄉,大同村,457,1,1260,12,1272,1575,0,0,0,0,0,0,80.76
臺中縣,外埔鄉,水美村,458,1,945,16,961,1247,0,0,0,0,0,0,77.06
臺中縣,外埔鄉,水美村,459,1,882,17,899,1108,0,0,0,0,0,0,81.14
臺中縣,外埔鄉,大東村,460,1,982,34,1016,1303,0,0,0,0,0,0,77.97
臺中縣,外埔鄉,大東村,461,1,1052,19,1071,1438,0,0,0,0,0,0,74.48
臺中縣,外埔鄉,大東村,462,1,964,21,985,1307,0,0,0,0,0,0,75.36
臺中縣,外埔鄉,馬鳴村,463,1,1004,21,1025,1281,0,0,0,0,0,0,80.02
臺中縣,外埔鄉,中山村,464,1,777,10,787,932,0,0,0,0,0,0,84.44
臺中縣,外埔鄉,鐵山村,465,1,804,16,820,1028,0,0,0,0,0,0,79.77
臺中縣,外埔鄉,鐵山村,466,1,730,8,738,899,0,0,0,0,0,0,82.09
臺中縣,外埔鄉,土城村,467,1,1198,22,1220,1440,0,0,0,0,0,0,84.72
臺中縣,外埔鄉,部子村,468,1,900,16,916,1109,0,0,0,0,0,0,82.60
臺中縣,大安鄉,南埔村,469,1,830,14,844,1040,0,0,0,0,0,0,81.15
臺中縣,大安鄉,南庄村,470,1,894,11,905,1126,0,0,0,0,0,0,80.37
臺中縣,大安鄉,中庄村,471,1,845,10,855,1108,0,0,0,0,0,0,77.17
臺中縣,大安鄉,中庄村,472,1,791,20,811,1091,0,0,0,0,0,0,74.34
臺中縣,大安鄉,東安村,473,1,967,9,976,1180,0,0,0,0,0,0,82.71
臺中縣,大安鄉,福興村,474,1,817,16,833,1054,0,0,0,0,0,0,79.03
臺中縣,大安鄉,龜殼村,475,1,627,12,639,779,0,0,0,0,0,0,82.03
臺中縣,大安鄉,龜殼村,476,1,610,7,617,778,0,0,0,0,0,0,79.31
臺中縣,大安鄉,頂安村,477,1,623,4,627,832,0,0,0,0,0,0,75.36
臺中縣,大安鄉,永安村,478,1,1195,11,1206,1542,0,0,0,0,0,0,78.21
臺中縣,大安鄉,福住村,479,1,729,15,744,961,0,0,0,0,0,0,77.42
臺中縣,大安鄉,海墘村,480,1,1032,14,1046,1332,0,0,0,0,0,0,78.53
臺中縣,大安鄉,西安村,481,1,910,12,922,1249,0,0,0,0,0,0,73.82
臺中縣,大安鄉,松雅村,482,1,562,12,574,686,0,0,0,0,0,0,83.67
臺中縣,烏日鄉,烏日村,483,1,1208,24,1232,1696,0,0,0,0,0,0,72.64
臺中縣,烏日鄉,烏日村,484,1,1114,10,1124,1554,0,0,0,0,0,0,72.33
臺中縣,烏日鄉,烏日村,485,1,1204,24,1228,1660,0,0,0,0,0,0,73.98
臺中縣,烏日鄉,湖日村,486,1,860,17,877,1182,0,0,0,0,0,0,74.20
臺中縣,烏日鄉,湖日村,487,1,640,7,647,1049,0,0,0,0,0,0,61.68
臺中縣,烏日鄉,三和村,488,1,739,17,756,1059,0,0,0,0,0,0,71.39
臺中縣,烏日鄉,三和村,489,1,648,24,672,1003,0,0,0,0,0,0,67.00
臺中縣,烏日鄉,三和村,490,1,1158,31,1189,1589,0,0,0,0,0,0,74.83
臺中縣,烏日鄉,榮泉村,491,1,1173,21,1194,1495,0,0,0,0,0,0,79.87
臺中縣,烏日鄉,榮泉村,492,1,789,15,804,1064,0,0,0,0,0,0,75.56
臺中縣,烏日鄉,學田村,493,1,1464,34,1498,1975,0,0,0,0,0,0,75.85
臺中縣,烏日鄉,九德村,494,1,1001,17,1018,1567,0,0,0,0,0,0,64.96
臺中縣,烏日鄉,九德村,495,1,973,26,999,1467,0,0,0,0,0,0,68.10
臺中縣,烏日鄉,九德村,496,1,1126,17,1143,1840,0,0,0,0,0,0,62.12
臺中縣,烏日鄉,九德村,497,1,1041,22,1063,1667,0,0,0,0,0,0,63.77
臺中縣,烏日鄉,九德村,498,1,901,17,918,1471,0,0,0,0,0,0,62.41
臺中縣,烏日鄉,仁德村,499,1,975,15,990,1455,0,0,0,0,0,0,68.04
臺中縣,烏日鄉,仁德村,500,1,808,20,828,1232,0,0,0,0,0,0,67.21
臺中縣,烏日鄉,仁德村,501,1,1018,19,1037,1533,0,0,0,0,0,0,67.65
臺中縣,烏日鄉,前竹村,502,1,1407,29,1436,1939,0,0,0,0,0,0,74.06
臺中縣,烏日鄉,五光村,503,1,1042,17,1059,1368,0,0,0,0,0,0,77.41
臺中縣,烏日鄉,光明村,504,1,1408,16,1424,1935,0,0,0,0,0,0,73.59
臺中縣,烏日鄉,東園村,505,1,1111,6,1117,1450,0,0,0,0,0,0,77.03
臺中縣,烏日鄉,溪埧村,506,1,1246,18,1264,1609,0,0,0,0,0,0,78.56
臺中縣,烏日鄉,溪埧村,507,1,1060,16,1076,1539,0,0,0,0,0,0,69.92
臺中縣,烏日鄉,螺潭村,508,1,1052,17,1069,1409,0,0,0,0,0,0,75.87
臺中縣,烏日鄉,北里村,509,1,883,22,905,1207,0,0,0,0,0,0,74.98
臺中縣,烏日鄉,南里村,510,1,732,21,753,973,0,0,0,0,0,0,77.39
臺中縣,烏日鄉,溪尾村,511,1,569,22,591,797,0,0,0,0,0,0,74.15
臺中縣,大肚鄉,王田村,512,1,1219,26,1245,1624,0,0,0,0,0,0,76.66
臺中縣,大肚鄉,王田村,513,1,1132,38,1170,1664,0,0,0,0,0,0,70.31
臺中縣,大肚鄉,中和村,514,1,624,9,633,740,0,0,0,0,0,0,85.54
臺中縣,大肚鄉,福山村,515,1,1053,18,1071,1386,0,0,0,0,0,0,77.27
臺中縣,大肚鄉,福山村,516,1,1164,19,1183,1548,0,0,0,0,0,0,76.42
臺中縣,大肚鄉,營埔村,517,1,965,20,985,1191,0,0,0,0,0,0,82.70
臺中縣,大肚鄉,社腳村,518,1,798,17,815,1019,0,0,0,0,0,0,79.98
臺中縣,大肚鄉,社腳村,519,1,770,22,792,1028,0,0,0,0,0,0,77.04
臺中縣,大肚鄉,新興村,520,1,769,10,779,1009,0,0,0,0,0,0,77.21
臺中縣,大肚鄉,新興村,521,1,620,21,641,923,0,0,0,0,0,0,69.45
臺中縣,大肚鄉,大東村,522,1,834,8,842,1098,0,0,0,0,0,0,76.68
臺中縣,大肚鄉,大東村,523,1,950,16,966,1225,0,0,0,0,0,0,78.86
臺中縣,大肚鄉,大肚村,524,1,607,11,618,820,0,0,0,0,0,0,75.37
臺中縣,大肚鄉,大肚村,525,1,683,8,691,909,0,0,0,0,0,0,76.02
臺中縣,大肚鄉,永和村,526,1,650,14,664,820,0,0,0,0,0,0,80.98
臺中縣,大肚鄉,磺溪村,527,1,1007,19,1026,1225,0,0,0,0,0,0,83.76
臺中縣,大肚鄉,永順村,528,1,1160,19,1179,1461,0,0,0,0,0,0,80.70
臺中縣,大肚鄉,成功村,529,1,693,5,698,798,0,0,0,0,0,0,87.47
臺中縣,大肚鄉,山陽村,530,1,1021,37,1058,1316,0,0,0,0,0,0,80.40
臺中縣,大肚鄉,頂街村,531,1,1032,15,1047,1386,0,0,0,0,0,0,75.54
臺中縣,大肚鄉,頂街村,532,1,1020,21,1041,1369,0,0,0,0,0,0,76.04
臺中縣,大肚鄉,頂街村,533,1,499,11,510,742,0,0,0,0,0,0,68.73
臺中縣,大肚鄉,瑞井村,534,1,831,10,841,1154,0,0,0,0,0,0,72.88
臺中縣,大肚鄉,瑞井村,535,1,814,21,835,1168,0,0,0,0,0,0,71.49
臺中縣,大肚鄉,瑞井村,536,1,679,23,702,1069,0,0,0,0,0,0,65.67
臺中縣,大肚鄉,蔗部村,537,1,1020,15,1035,1526,0,0,0,0,0,0,67.82
臺中縣,大肚鄉,蔗部村,538,1,899,22,921,1305,0,0,0,0,0,0,70.57
臺中縣,大肚鄉,蔗部村,539,1,787,20,807,1327,0,0,0,0,0,0,60.81
臺中縣,大肚鄉,蔗部村,540,1,1096,27,1123,1559,0,0,0,0,0,0,72.03
臺中縣,龍井鄉,竹坑村,541,1,850,10,860,1131,0,0,0,0,0,0,76.04
臺中縣,龍井鄉,竹坑村,542,1,510,10,520,635,0,0,0,0,0,0,81.89
臺中縣,龍井鄉,龍東村,543,1,851,15,866,1110,0,0,0,0,0,0,78.02
臺中縣,龍井鄉,龍東村,544,1,699,14,713,919,0,0,0,0,0,0,77.58
臺中縣,龍井鄉,龍西村,545,1,1088,15,1103,1357,0,0,0,0,0,0,81.28
臺中縣,龍井鄉,田中村,546,1,925,16,941,1197,0,0,0,0,0,0,78.61
臺中縣,龍井鄉,田中村,547,1,740,17,757,996,0,0,0,0,0,0,76.00
臺中縣,龍井鄉,福田村,548,1,692,16,708,943,0,0,0,0,0,0,75.08
臺中縣,龍井鄉,麗水村,549,1,894,9,903,1061,0,0,0,0,0,0,85.11
臺中縣,龍井鄉,麗水村,550,1,653,7,660,761,0,0,0,0,0,0,86.73
臺中縣,龍井鄉,龍津村,551,1,891,22,913,1191,0,0,0,0,0,0,76.66
臺中縣,龍井鄉,龍津村,552,1,944,16,960,1160,0,0,0,0,0,0,82.76
臺中縣,龍井鄉,龍津村,553,1,574,7,581,752,0,0,0,0,0,0,77.26
臺中縣,龍井鄉,龍津村,554,1,559,6,565,758,0,0,0,0,0,0,74.54
臺中縣,龍井鄉,三德村,555,1,926,11,937,1192,0,0,0,0,0,0,78.61
臺中縣,龍井鄉,三德村,556,1,733,11,744,947,0,0,0,0,0,0,78.56
臺中縣,龍井鄉,忠和村,557,1,826,14,840,1091,0,0,0,0,0,0,76.99
臺中縣,龍井鄉,忠和村,558,1,844,22,866,1145,0,0,0,0,0,0,75.63
臺中縣,龍井鄉,忠和村,559,1,837,11,848,1101,0,0,0,0,0,0,77.02
臺中縣,龍井鄉,山腳村,560,1,579,6,585,752,0,0,0,0,0,0,77.79
臺中縣,龍井鄉,山腳村,561,1,900,18,918,1218,0,0,0,0,0,0,75.37
臺中縣,龍井鄉,山腳村,562,1,856,17,873,1179,0,0,0,0,0,0,74.05
臺中縣,龍井鄉,龍泉村,563,1,681,15,696,972,0,0,0,0,0,0,71.60
臺中縣,龍井鄉,龍泉村,564,1,833,15,848,1152,0,0,0,0,0,0,73.61
臺中縣,龍井鄉,龍泉村,565,1,727,18,745,962,0,0,0,0,0,0,77.44
臺中縣,龍井鄉,龍泉村,566,1,366,10,376,564,0,0,0,0,0,0,66.67
臺中縣,龍井鄉,龍崗村,567,1,684,10,694,977,0,0,0,0,0,0,71.03
臺中縣,龍井鄉,龍崗村,568,1,568,13,581,725,0,0,0,0,0,0,80.14
臺中縣,龍井鄉,新庄村,569,1,825,12,837,1187,0,0,0,0,0,0,70.51
臺中縣,龍井鄉,新庄村,570,1,930,17,947,1322,0,0,0,0,0,0,71.63
臺中縣,龍井鄉,新庄村,571,1,764,13,777,1261,0,0,0,0,0,0,61.62
臺中縣,龍井鄉,南寮村,572,1,896,10,906,1236,0,0,0,0,0,0,73.30
臺中縣,龍井鄉,東海村,573,1,653,13,666,1273,0,0,0,0,0,0,52.32
臺中縣,龍井鄉,東海村,574,1,641,16,657,1023,0,0,0,0,0,0,64.22
臺中縣,龍井鄉,東海村,575,1,704,13,717,1221,0,0,0,0,0,0,58.72
臺中縣,龍井鄉,東海村,576,1,494,9,503,804,0,0,0,0,0,0,62.56
臺中縣,龍井鄉,新東村,577,1,907,26,933,1401,0,0,0,0,0,0,66.60
臺中縣,龍井鄉,新東村,578,1,859,21,880,1360,0,0,0,0,0,0,64.71
臺中縣,霧峰鄉,桐林村,579,1,824,10,834,1138,0,0,0,0,0,0,73.29
臺中縣,霧峰鄉,吉峰村,580,1,1316,20,1336,1936,0,0,0,0,0,0,69.01
臺中縣,霧峰鄉,吉峰村,581,1,1178,27,1205,1836,0,0,0,0,0,0,65.63
臺中縣,霧峰鄉,吉峰村,582,1,793,7,800,1179,0,0,0,0,0,0,67.85
臺中縣,霧峰鄉,吉峰村,583,1,1019,23,1042,1539,0,0,0,0,0,0,67.71
臺中縣,霧峰鄉,甲寅村,584,1,1012,21,1033,1363,0,0,0,0,0,0,75.79
臺中縣,霧峰鄉,甲寅村,585,1,949,15,964,1486,0,0,0,0,0,0,64.87
臺中縣,霧峰鄉,甲寅村,586,1,816,20,836,1303,0,0,0,0,0,0,64.16
臺中縣,霧峰鄉,本鄉村,587,1,1231,29,1260,1838,0,0,0,0,0,0,68.55
臺中縣,霧峰鄉,中正村,588,1,1183,24,1207,1649,0,0,0,0,0,0,73.20
臺中縣,霧峰鄉,錦榮村,589,1,650,20,670,920,0,0,0,0,0,0,72.83
臺中縣,霧峰鄉,萊園村,590,1,774,21,795,1120,0,0,0,0,0,0,70.98
臺中縣,霧峰鄉,本堂村,591,1,1141,21,1162,1713,0,0,0,0,0,0,67.83
臺中縣,霧峰鄉,本堂村,592,1,1163,30,1193,1713,0,0,0,0,0,0,69.64
臺中縣,霧峰鄉,本堂村,593,1,1122,24,1146,1658,0,0,0,0,0,0,69.12
臺中縣,霧峰鄉,北柳村,594,1,1025,17,1042,1410,0,0,0,0,0,0,73.90
臺中縣,霧峰鄉,北柳村,595,1,971,11,982,1321,0,0,0,0,0,0,74.34
臺中縣,霧峰鄉,南柳村,596,1,985,15,1000,1259,0,0,0,0,0,0,79.43
臺中縣,霧峰鄉,四德村,597,1,1440,26,1466,1919,0,0,0,0,0,0,76.39
臺中縣,霧峰鄉,五福村,598,1,889,18,907,1087,0,0,0,0,0,0,83.44
臺中縣,霧峰鄉,五福村,599,1,828,16,844,1118,0,0,0,0,0,0,75.49
臺中縣,霧峰鄉,丁台村,600,1,1329,21,1350,1708,0,0,0,0,0,0,79.04
臺中縣,霧峰鄉,北勢村,601,1,1129,26,1155,1446,0,0,0,0,0,0,79.88
臺中縣,霧峰鄉,南勢村,602,1,795,12,807,1054,0,0,0,0,0,0,76.57
臺中縣,霧峰鄉,萬豐村,603,1,887,12,899,1187,0,0,0,0,0,0,75.74
臺中縣,霧峰鄉,萬豐村,604,1,863,25,888,1285,0,0,0,0,0,0,69.11
臺中縣,霧峰鄉,舊正村,605,1,1444,22,1466,1961,0,0,0,0,0,0,74.76
臺中縣,霧峰鄉,坑口村,606,1,844,20,864,1096,0,0,0,0,0,0,78.83
臺中縣,霧峰鄉,坑口村,607,1,795,22,817,1160,0,0,0,0,0,0,70.43
臺中縣,霧峰鄉,坑口村,608,1,465,6,471,666,0,0,0,0,0,0,70.72
臺中縣,霧峰鄉,峰谷村,609,1,741,16,757,1061,0,0,0,0,0,0,71.35
臺中縣,霧峰鄉,六股村,610,1,863,25,888,1132,0,0,0,0,0,0,78.45
臺中縣,霧峰鄉,六股村,611,1,677,5,682,904,0,0,0,0,0,0,75.44
臺中縣,太平市,太平里,612,1,1198,28,1226,1791,0,0,0,0,0,0,68.45
臺中縣,太平市,太平里,613,1,1100,22,1122,1574,0,0,0,0,0,0,71.28
臺中縣,太平市,太平里,614,1,1003,20,1023,1438,0,0,0,0,0,0,71.14
臺中縣,太平市,長億里,615,1,980,21,1001,1480,0,0,0,0,0,0,67.64
臺中縣,太平市,長億里,616,1,773,24,797,1243,0,0,0,0,0,0,64.12
臺中縣,太平市,長億里,617,1,621,15,636,978,0,0,0,0,0,0,65.03
臺中縣,太平市,長億里,618,1,928,19,947,1504,0,0,0,0,0,0,62.97
臺中縣,太平市,長億里,619,1,861,27,888,1305,0,0,0,0,0,0,68.05
臺中縣,太平市,中平里,620,1,991,17,1008,1582,0,0,0,0,0,0,63.72
臺中縣,太平市,中平里,621,1,857,27,884,1296,0,0,0,0,0,0,68.21
臺中縣,太平市,中平里,622,1,850,20,870,1471,0,0,0,0,0,0,59.14
臺中縣,太平市,中平里,623,1,867,20,887,1365,0,0,0,0,0,0,64.98
臺中縣,太平市,中興里,624,1,926,11,937,1540,0,0,0,0,0,0,60.84
臺中縣,太平市,中興里,625,1,970,18,988,1610,0,0,0,0,0,0,61.37
臺中縣,太平市,中興里,626,1,692,10,702,1028,0,0,0,0,0,0,68.29
臺中縣,太平市,中興里,627,1,997,16,1013,1447,0,0,0,0,0,0,70.01
臺中縣,太平市,東平里,628,1,1127,22,1149,1595,0,0,0,0,0,0,72.04
臺中縣,太平市,東平里,629,1,1226,30,1256,1644,0,0,0,0,0,0,76.40
臺中縣,太平市,東平里,630,1,1088,18,1106,1554,0,0,0,0,0,0,71.17
臺中縣,太平市,東平里,631,1,1028,25,1053,1521,0,0,0,0,0,0,69.23
臺中縣,太平市,東平里,632,1,1183,25,1208,1741,0,0,0,0,0,0,69.39
臺中縣,太平市,建國里,633,1,856,23,879,1439,0,0,0,0,0,0,61.08
臺中縣,太平市,建國里,634,1,904,16,920,1369,0,0,0,0,0,0,67.20
臺中縣,太平市,建國里,635,1,982,23,1005,1542,0,0,0,0,0,0,65.18
臺中縣,太平市,坪林里,636,1,775,12,787,1035,0,0,0,0,0,0,76.04
臺中縣,太平市,坪林里,637,1,541,10,551,857,0,0,0,0,0,0,64.29
臺中縣,太平市,坪林里,638,1,779,15,794,1142,0,0,0,0,0,0,69.53
臺中縣,太平市,坪林里,639,1,828,15,843,1212,0,0,0,0,0,0,69.55
臺中縣,太平市,坪林里,640,1,879,18,897,1206,0,0,0,0,0,0,74.38
臺中縣,太平市,坪林里,641,1,1079,21,1100,1646,0,0,0,0,0,0,66.83
臺中縣,太平市,光華里,642,1,950,23,973,1474,0,0,0,0,0,0,66.01
臺中縣,太平市,光華里,643,1,1146,27,1173,1852,0,0,0,0,0,0,63.34
臺中縣,太平市,光華里,644,1,1103,25,1128,1729,0,0,0,0,0,0,65.24
臺中縣,太平市,光華里,645,1,1028,27,1055,1649,0,0,0,0,0,0,63.98
臺中縣,太平市,中山里,646,1,990,29,1019,1521,0,0,0,0,0,0,67.00
臺中縣,太平市,中山里,647,1,782,22,804,1207,0,0,0,0,0,0,66.61
臺中縣,太平市,中山里,648,1,914,18,932,1435,0,0,0,0,0,0,64.95
臺中縣,太平市,中山里,649,1,1114,19,1133,1742,0,0,0,0,0,0,65.04
臺中縣,太平市,宜欣里,650,1,787,16,803,1344,0,0,0,0,0,0,59.75
臺中縣,太平市,宜欣里,651,1,962,25,987,1633,0,0,0,0,0,0,60.44
臺中縣,太平市,宜欣里,652,1,807,21,828,1618,0,0,0,0,0,0,51.17
臺中縣,太平市,宜欣里,653,1,917,12,929,1636,0,0,0,0,0,0,56.78
臺中縣,太平市,宜欣里,654,1,1046,18,1064,1592,0,0,0,0,0,0,66.83
臺中縣,太平市,宜欣里,655,1,878,23,901,1350,0,0,0,0,0,0,66.74
臺中縣,太平市,宜欣里,656,1,853,18,871,1478,0,0,0,0,0,0,58.93
臺中縣,太平市,新坪里,657,1,1047,23,1070,1781,0,0,0,0,0,0,60.08
臺中縣,太平市,新坪里,658,1,872,21,893,1535,0,0,0,0,0,0,58.18
臺中縣,太平市,新坪里,659,1,725,13,738,1355,0,0,0,0,0,0,54.46
臺中縣,太平市,新坪里,660,1,642,18,660,1298,0,0,0,0,0,0,50.85
臺中縣,太平市,新坪里,661,1,1010,16,1026,1623,0,0,0,0,0,0,63.22
臺中縣,太平市,新坪里,662,1,945,29,974,1489,0,0,0,0,0,0,65.41
臺中縣,太平市,新光里,663,1,965,16,981,1599,0,0,0,0,0,0,61.35
臺中縣,太平市,新光里,664,1,1010,24,1034,1669,0,0,0,0,0,0,61.95
臺中縣,太平市,新光里,665,1,638,22,660,1078,0,0,0,0,0,0,61.22
臺中縣,太平市,新光里,666,1,872,21,893,1463,0,0,0,0,0,0,61.04
臺中縣,太平市,新光里,667,1,813,18,831,1425,0,0,0,0,0,0,58.32
臺中縣,太平市,新福里,668,1,1181,19,1200,1638,0,0,0,0,0,0,73.26
臺中縣,太平市,新福里,669,1,1117,24,1141,1881,0,0,0,0,0,0,60.66
臺中縣,太平市,頭汴里,670,1,812,14,826,1163,0,0,0,0,0,0,71.02
臺中縣,太平市,頭汴里,671,1,858,14,872,1302,0,0,0,0,0,0,66.97
臺中縣,太平市,頭汴里,672,1,765,19,784,1066,0,0,0,0,0,0,73.55
臺中縣,太平市,東汴里,673,1,898,11,909,1238,0,0,0,0,0,0,73.42
臺中縣,太平市,興隆里,674,1,1060,26,1086,1487,0,0,0,0,0,0,73.03
臺中縣,太平市,興隆里,675,1,981,27,1008,1527,0,0,0,0,0,0,66.01
臺中縣,太平市,興隆里,676,1,683,14,697,1028,0,0,0,0,0,0,67.80
臺中縣,太平市,興隆里,677,1,715,22,737,1040,0,0,0,0,0,0,70.87
臺中縣,太平市,黃竹里,678,1,685,7,692,895,0,0,0,0,0,0,77.32
臺中縣,太平市,光隆里,679,1,1043,19,1062,1452,0,0,0,0,0,0,73.14
臺中縣,太平市,光隆里,680,1,972,17,989,1544,0,0,0,0,0,0,64.05
臺中縣,太平市,光隆里,681,1,870,15,885,1245,0,0,0,0,0,0,71.08
臺中縣,太平市,德隆里,682,1,1019,16,1035,1567,0,0,0,0,0,0,66.05
臺中縣,太平市,德隆里,683,1,895,25,920,1432,0,0,0,0,0,0,64.25
臺中縣,大里市,大里里,684,1,993,25,1018,1405,0,0,0,0,0,0,72.46
臺中縣,大里市,大里里,685,1,847,12,859,1142,0,0,0,0,0,0,75.22
臺中縣,大里市,新里里,686,1,1097,14,1111,1642,0,0,0,0,0,0,67.66
臺中縣,大里市,新里里,687,1,1172,9,1181,1920,0,0,0,0,0,0,61.51
臺中縣,大里市,新里里,688,1,836,18,854,1199,0,0,0,0,0,0,71.23
臺中縣,大里市,新里里,689,1,543,17,560,792,0,0,0,0,0,0,70.71
臺中縣,大里市,新里里,690,1,706,13,719,1086,0,0,0,0,0,0,66.21
臺中縣,大里市,樹王里,691,1,901,13,914,1253,0,0,0,0,0,0,72.94
臺中縣,大里市,樹王里,692,1,931,24,955,1286,0,0,0,0,0,0,74.26
臺中縣,大里市,祥興里,693,1,490,12,502,858,0,0,0,0,0,0,58.51
臺中縣,大里市,祥興里,694,1,753,13,766,1210,0,0,0,0,0,0,63.31
臺中縣,大里市,祥興里,695,1,716,14,730,1169,0,0,0,0,0,0,62.45
臺中縣,大里市,祥興里,696,1,582,9,591,1106,0,0,0,0,0,0,53.44
臺中縣,大里市,祥興里,697,1,540,16,556,832,0,0,0,0,0,0,66.83
臺中縣,大里市,內新里,698,1,863,22,885,1488,0,0,0,0,0,0,59.48
臺中縣,大里市,內新里,699,1,763,14,777,1313,0,0,0,0,0,0,59.18
臺中縣,大里市,內新里,700,1,844,14,858,1386,0,0,0,0,0,0,61.90
臺中縣,大里市,內新里,701,1,778,11,789,1307,0,0,0,0,0,0,60.37
臺中縣,大里市,內新里,702,1,748,12,760,1253,0,0,0,0,0,0,60.65
臺中縣,大里市,內新里,703,1,791,10,801,1452,0,0,0,0,0,0,55.17
臺中縣,大里市,東昇里,704,1,780,23,803,1176,0,0,0,0,0,0,68.28
臺中縣,大里市,東昇里,705,1,855,23,878,1381,0,0,0,0,0,0,63.58
臺中縣,大里市,大元里,706,1,1221,30,1251,1736,0,0,0,0,0,0,72.06
臺中縣,大里市,大元里,707,1,832,11,843,1213,0,0,0,0,0,0,69.50
臺中縣,大里市,西湖里,708,1,1233,18,1251,1713,0,0,0,0,0,0,73.03
臺中縣,大里市,夏田里,709,1,720,12,732,944,0,0,0,0,0,0,77.54
臺中縣,大里市,仁化里,710,1,1053,24,1077,1636,0,0,0,0,0,0,65.83
臺中縣,大里市,仁化里,711,1,1072,22,1094,1758,0,0,0,0,0,0,62.23
臺中縣,大里市,仁化里,712,1,1100,15,1115,1692,0,0,0,0,0,0,65.90
臺中縣,大里市,仁化里,713,1,993,20,1013,1563,0,0,0,0,0,0,64.81
臺中縣,大里市,仁化里,714,1,888,23,911,1500,0,0,0,0,0,0,60.73
臺中縣,大里市,健民里,715,1,967,22,989,1393,0,0,0,0,0,0,71.00
臺中縣,大里市,健民里,716,1,903,18,921,1307,0,0,0,0,0,0,70.47
臺中縣,大里市,健民里,717,1,741,12,753,1186,0,0,0,0,0,0,63.49
臺中縣,大里市,塗城里,718,1,857,18,875,1356,0,0,0,0,0,0,64.53
臺中縣,大里市,塗城里,719,1,888,16,904,1235,0,0,0,0,0,0,73.20
臺中縣,大里市,塗城里,720,1,1014,22,1036,1642,0,0,0,0,0,0,63.09
臺中縣,大里市,塗城里,721,1,949,17,966,1485,0,0,0,0,0,0,65.05
臺中縣,大里市,東湖里,722,1,734,17,751,1245,0,0,0,0,0,0,60.32
臺中縣,大里市,東湖里,723,1,673,18,691,1200,0,0,0,0,0,0,57.58
臺中縣,大里市,東湖里,724,1,680,8,688,1051,0,0,0,0,0,0,65.46
臺中縣,大里市,東湖里,725,1,706,13,719,1090,0,0,0,0,0,0,65.96
臺中縣,大里市,東湖里,726,1,704,13,717,1284,0,0,0,0,0,0,55.84
臺中縣,大里市,東興里,727,1,537,13,550,843,0,0,0,0,0,0,65.24
臺中縣,大里市,東興里,728,1,804,7,811,1350,0,0,0,0,0,0,60.07
臺中縣,大里市,東興里,729,1,1032,19,1051,1611,0,0,0,0,0,0,65.24
臺中縣,大里市,東興里,730,1,1065,25,1090,1587,0,0,0,0,0,0,68.68
臺中縣,大里市,東興里,731,1,980,16,996,1545,0,0,0,0,0,0,64.47
臺中縣,大里市,東興里,732,1,695,9,704,1061,0,0,0,0,0,0,66.35
臺中縣,大里市,日新里,733,1,922,21,943,1500,0,0,0,0,0,0,62.87
臺中縣,大里市,日新里,734,1,942,33,975,1439,0,0,0,0,0,0,67.76
臺中縣,大里市,西榮里,735,1,1067,21,1088,1741,0,0,0,0,0,0,62.49
臺中縣,大里市,西榮里,736,1,1127,16,1143,1774,0,0,0,0,0,0,64.43
臺中縣,大里市,西榮里,737,1,1089,28,1117,1800,0,0,0,0,0,0,62.06
臺中縣,大里市,西榮里,738,1,1007,10,1017,1579,0,0,0,0,0,0,64.41
臺中縣,大里市,西榮里,739,1,966,15,981,1554,0,0,0,0,0,0,63.13
臺中縣,大里市,西榮里,740,1,1063,21,1084,1811,0,0,0,0,0,0,59.86
臺中縣,大里市,金城里,741,1,1074,27,1101,1529,0,0,0,0,0,0,72.01
臺中縣,大里市,金城里,742,1,895,18,913,1421,0,0,0,0,0,0,64.25
臺中縣,大里市,金城里,743,1,1100,12,1112,1631,0,0,0,0,0,0,68.18
臺中縣,大里市,金城里,744,1,1038,17,1055,1549,0,0,0,0,0,0,68.11
臺中縣,大里市,金城里,745,1,1124,14,1138,1827,0,0,0,0,0,0,62.29
臺中縣,大里市,立仁里,746,1,822,19,841,1274,0,0,0,0,0,0,66.01
臺中縣,大里市,立仁里,747,1,919,20,939,1622,0,0,0,0,0,0,57.89
臺中縣,大里市,立仁里,748,1,817,12,829,1384,0,0,0,0,0,0,59.90
臺中縣,大里市,立仁里,749,1,655,12,667,1084,0,0,0,0,0,0,61.53
臺中縣,大里市,立仁里,750,1,716,20,736,1182,0,0,0,0,0,0,62.27
臺中縣,大里市,新仁里,751,1,811,14,825,1272,0,0,0,0,0,0,64.86
臺中縣,大里市,新仁里,752,1,858,22,880,1436,0,0,0,0,0,0,61.28
臺中縣,大里市,新仁里,753,1,890,16,906,1365,0,0,0,0,0,0,66.37
臺中縣,大里市,新仁里,754,1,785,15,800,1282,0,0,0,0,0,0,62.40
臺中縣,大里市,瑞城里,755,1,921,21,942,1358,0,0,0,0,0,0,69.37
臺中縣,大里市,瑞城里,756,1,979,24,1003,1440,0,0,0,0,0,0,69.65
臺中縣,大里市,瑞城里,757,1,917,15,932,1368,0,0,0,0,0,0,68.13
臺中縣,大里市,瑞城里,758,1,915,10,925,1376,0,0,0,0,0,0,67.22
臺中縣,大里市,瑞城里,759,1,971,19,990,1674,0,0,0,0,0,0,59.14
臺中縣,和平鄉,南勢村,760,1,84,2,86,145,0,0,0,0,0,0,59.31
臺中縣,和平鄉,南勢村,761,1,511,2,513,706,0,0,0,0,0,0,72.66
臺中縣,和平鄉,南勢村,762,1,360,3,363,519,0,0,0,0,0,0,69.94
臺中縣,和平鄉,天輪村,763,1,292,3,295,436,0,0,0,0,0,0,67.66
臺中縣,和平鄉,博愛村,764,1,377,6,383,621,0,0,0,0,0,0,61.67
臺中縣,和平鄉,博愛村,765,1,325,3,328,468,0,0,0,0,0,0,70.09
臺中縣,和平鄉,自由村,766,1,65,3,68,82,0,0,0,0,0,0,82.93
臺中縣,和平鄉,自由村,767,1,86,1,87,136,0,0,0,0,0,0,63.97
臺中縣,和平鄉,自由村,768,1,194,5,199,273,0,0,0,0,0,0,72.89
臺中縣,和平鄉,達觀村,769,1,242,5,247,370,0,0,0,0,0,0,66.76
臺中縣,和平鄉,達觀村,770,1,61,0,61,98,0,0,0,0,0,0,62.24
臺中縣,和平鄉,中坑村,771,1,192,3,195,256,0,0,0,0,0,0,76.17
臺中縣,和平鄉,梨山村,772,1,99,5,104,205,0,0,0,0,0,0,50.73
臺中縣,和平鄉,梨山村,773,1,472,8,480,831,0,0,0,0,0,0,57.76
臺中縣,和平鄉,梨山村,774,1,118,1,119,285,0,0,0,0,0,0,41.75
臺中縣,和平鄉,梨山村,775,1,38,1,39,93,0,0,0,0,0,0,41.94
臺中縣,和平鄉,平等村,776,1,127,0,127,223,0,0,0,0,0,0,56.95
臺中縣,和平鄉,平等村,777,1,98,3,101,182,0,0,0,0,0,0,55.49
彰化縣,彰化市,桃源里,1,1,905,18,923,1219,0,0,0,0,0,0,75.72
彰化縣,彰化市,桃源里,2,1,1113,25,1138,1561,0,0,0,0,0,0,72.90
彰化縣,彰化市,卦山里,3,1,799,7,806,1056,0,0,0,0,0,0,76.33
彰化縣,彰化市,卦山里,4,1,767,24,791,1114,0,0,0,0,0,0,71.01
彰化縣,彰化市,東興里,5,1,1119,17,1136,1490,0,0,0,0,0,0,76.24
彰化縣,彰化市,華北里,6,1,1176,20,1196,1590,0,0,0,0,0,0,75.22
彰化縣,彰化市,華陽里,7,1,761,14,775,1033,0,0,0,0,0,0,75.02
彰化縣,彰化市,華陽里,8,1,796,11,807,1068,0,0,0,0,0,0,75.56
彰化縣,彰化市,建寶里,9,1,836,11,847,1096,0,0,0,0,0,0,77.28
彰化縣,彰化市,建寶里,10,1,938,10,948,1261,0,0,0,0,0,0,75.18
彰化縣,彰化市,光南里,11,1,1028,20,1048,1318,0,0,0,0,0,0,79.51
彰化縣,彰化市,介壽里,12,1,821,10,831,1075,0,0,0,0,0,0,77.30
彰化縣,彰化市,介壽里,13,1,566,10,576,803,0,0,0,0,0,0,71.73
彰化縣,彰化市,延平里,14,1,1128,13,1141,1668,0,0,0,0,0,0,68.41
彰化縣,彰化市,延平里,15,1,1169,16,1185,1612,0,0,0,0,0,0,73.51
彰化縣,彰化市,延平里,16,1,1128,23,1151,1551,0,0,0,0,0,0,74.21
彰化縣,彰化市,延和里,17,1,1125,26,1151,1520,0,0,0,0,0,0,75.72
彰化縣,彰化市,延和里,18,1,1174,23,1197,1497,0,0,0,0,0,0,79.96
彰化縣,彰化市,南興里,19,1,1061,26,1087,1521,0,0,0,0,0,0,71.47
彰化縣,彰化市,南興里,20,1,966,18,984,1312,0,0,0,0,0,0,75.00
彰化縣,彰化市,南興里,21,1,1068,16,1084,1425,0,0,0,0,0,0,76.07
彰化縣,彰化市,南瑤里,22,1,1235,21,1256,1646,0,0,0,0,0,0,76.31
彰化縣,彰化市,南瑤里,23,1,1049,16,1065,1416,0,0,0,0,0,0,75.21
彰化縣,彰化市,南瑤里,24,1,1000,16,1016,1387,0,0,0,0,0,0,73.25
彰化縣,彰化市,南瑤里,25,1,1020,14,1034,1420,0,0,0,0,0,0,72.82
彰化縣,彰化市,成功里,26,1,1063,14,1077,1419,0,0,0,0,0,0,75.90
彰化縣,彰化市,大同里,27,1,886,10,896,1177,0,0,0,0,0,0,76.13
彰化縣,彰化市,永生里,28,1,1128,18,1146,1467,0,0,0,0,0,0,78.12
彰化縣,彰化市,福安里,29,1,828,16,844,1080,0,0,0,0,0,0,78.15
彰化縣,彰化市,西安里,30,1,911,14,925,1242,0,0,0,0,0,0,74.48
彰化縣,彰化市,西安里,31,1,844,10,854,1171,0,0,0,0,0,0,72.93
彰化縣,彰化市,彰安里,32,1,1063,17,1080,1408,0,0,0,0,0,0,76.70
彰化縣,彰化市,彰安里,33,1,1124,15,1139,1518,0,0,0,0,0,0,75.03
彰化縣,彰化市,中央里,34,1,700,10,710,927,0,0,0,0,0,0,76.59
彰化縣,彰化市,富貴里,35,1,779,22,801,1044,0,0,0,0,0,0,76.72
彰化縣,彰化市,民權里,36,1,973,16,989,1278,0,0,0,0,0,0,77.39
彰化縣,彰化市,長樂里,37,1,949,16,965,1264,0,0,0,0,0,0,76.34
彰化縣,彰化市,萬壽里,38,1,772,10,782,1015,0,0,0,0,0,0,77.04
彰化縣,彰化市,西興里,39,1,641,13,654,821,0,0,0,0,0,0,79.66
彰化縣,彰化市,西興里,40,1,820,15,835,1196,0,0,0,0,0,0,69.82
彰化縣,彰化市,平和里,41,1,1219,14,1233,1586,0,0,0,0,0,0,77.74
彰化縣,彰化市,平和里,42,1,1114,17,1131,1604,0,0,0,0,0,0,70.51
彰化縣,彰化市,崙平里,43,1,1425,25,1450,1932,0,0,0,0,0,0,75.05
彰化縣,彰化市,崙平里,44,1,1381,32,1413,1904,0,0,0,0,0,0,74.21
彰化縣,彰化市,向陽里,45,1,1482,19,1501,1967,0,0,0,0,0,0,76.31
彰化縣,彰化市,莿桐里,46,1,769,15,784,1044,0,0,0,0,0,0,75.10
彰化縣,彰化市,莿桐里,47,1,864,6,870,1097,0,0,0,0,0,0,79.31
彰化縣,彰化市,南美里,48,1,1115,17,1132,1394,0,0,0,0,0,0,81.21
彰化縣,彰化市,南安里,49,1,1278,25,1303,1560,0,0,0,0,0,0,83.53
彰化縣,彰化市,東芳里,50,1,927,12,939,1176,0,0,0,0,0,0,79.85
彰化縣,彰化市,東芳里,51,1,1098,9,1107,1380,0,0,0,0,0,0,80.22
彰化縣,彰化市,磚窯里,52,1,833,13,846,1095,0,0,0,0,0,0,77.26
彰化縣,彰化市,磚窯里,53,1,1063,28,1091,1344,0,0,0,0,0,0,81.18
彰化縣,彰化市,西勢里,54,1,837,17,854,1130,0,0,0,0,0,0,75.58
彰化縣,彰化市,西勢里,55,1,851,15,866,1102,0,0,0,0,0,0,78.58
彰化縣,彰化市,忠權里,56,1,856,15,871,1179,0,0,0,0,0,0,73.88
彰化縣,彰化市,忠權里,57,1,817,18,835,1089,0,0,0,0,0,0,76.68
彰化縣,彰化市,忠孝里,58,1,842,14,856,1161,0,0,0,0,0,0,73.73
彰化縣,彰化市,五權里,59,1,1013,18,1031,1449,0,0,0,0,0,0,71.15
彰化縣,彰化市,五權里,60,1,944,28,972,1417,0,0,0,0,0,0,68.60
彰化縣,彰化市,新興里,61,1,1373,25,1398,1878,0,0,0,0,0,0,74.44
彰化縣,彰化市,新興里,62,1,1291,18,1309,1738,0,0,0,0,0,0,75.32
彰化縣,彰化市,新華里,63,1,672,16,688,908,0,0,0,0,0,0,75.77
彰化縣,彰化市,新華里,64,1,707,17,724,916,0,0,0,0,0,0,79.04
彰化縣,彰化市,興北里,65,1,1048,12,1060,1440,0,0,0,0,0,0,73.61
彰化縣,彰化市,信義里,66,1,716,13,729,965,0,0,0,0,0,0,75.54
彰化縣,彰化市,民生里,67,1,1011,19,1030,1379,0,0,0,0,0,0,74.69
彰化縣,彰化市,光復里,68,1,605,8,613,797,0,0,0,0,0,0,76.91
彰化縣,彰化市,永福里,69,1,764,8,772,979,0,0,0,0,0,0,78.86
彰化縣,彰化市,光華里,70,1,688,10,698,920,0,0,0,0,0,0,75.87
彰化縣,彰化市,中正里,71,1,973,6,979,1314,0,0,0,0,0,0,74.51
彰化縣,彰化市,中山里,72,1,623,13,636,827,0,0,0,0,0,0,76.90
彰化縣,彰化市,龍山里,73,1,817,7,824,1097,0,0,0,0,0,0,75.11
彰化縣,彰化市,龍山里,74,1,764,12,776,1019,0,0,0,0,0,0,76.15
彰化縣,彰化市,文化里,75,1,1060,14,1074,1427,0,0,0,0,0,0,75.26
彰化縣,彰化市,陽明里,76,1,642,12,654,862,0,0,0,0,0,0,75.87
彰化縣,彰化市,陽明里,77,1,675,18,693,950,0,0,0,0,0,0,72.95
彰化縣,彰化市,萬安里,78,1,1202,25,1227,1623,0,0,0,0,0,0,75.60
彰化縣,彰化市,萬安里,79,1,1277,16,1293,1760,0,0,0,0,0,0,73.47
彰化縣,彰化市,下部里,80,1,1279,19,1298,1585,0,0,0,0,0,0,81.89
彰化縣,彰化市,下部里,81,1,1185,26,1211,1556,0,0,0,0,0,0,77.83
彰化縣,彰化市,茄苳里,82,1,639,14,653,748,0,0,0,0,0,0,87.30
彰化縣,彰化市,茄南里,83,1,1528,25,1553,1911,0,0,0,0,0,0,81.27
彰化縣,彰化市,寶部里,84,1,825,15,840,1006,0,0,0,0,0,0,83.50
彰化縣,彰化市,古夷里,85,1,1535,25,1560,1968,0,0,0,0,0,0,79.27
彰化縣,彰化市,阿夷里,86,1,983,23,1006,1316,0,0,0,0,0,0,76.44
彰化縣,彰化市,阿夷里,87,1,971,18,989,1282,0,0,0,0,0,0,77.15
彰化縣,彰化市,阿夷里,88,1,1060,23,1083,1371,0,0,0,0,0,0,78.99
彰化縣,彰化市,和調里,89,1,758,18,776,1077,0,0,0,0,0,0,72.05
彰化縣,彰化市,和調里,90,1,751,10,761,1049,0,0,0,0,0,0,72.55
彰化縣,彰化市,復興里,91,1,1367,24,1391,1855,0,0,0,0,0,0,74.99
彰化縣,彰化市,復興里,92,1,1316,24,1340,1840,0,0,0,0,0,0,72.83
彰化縣,彰化市,中庄里,93,1,742,12,754,1005,0,0,0,0,0,0,75.02
彰化縣,彰化市,中庄里,94,1,628,15,643,875,0,0,0,0,0,0,73.49
彰化縣,彰化市,國聖里,95,1,1051,14,1065,1364,0,0,0,0,0,0,78.08
彰化縣,彰化市,國聖里,96,1,609,9,618,786,0,0,0,0,0,0,78.63
彰化縣,彰化市,福山里,97,1,1318,38,1356,1692,0,0,0,0,0,0,80.14
彰化縣,彰化市,福山里,98,1,1208,19,1227,1596,0,0,0,0,0,0,76.88
彰化縣,彰化市,福山里,99,1,1413,23,1436,1883,0,0,0,0,0,0,76.26
彰化縣,彰化市,安溪里,100,1,647,14,661,816,0,0,0,0,0,0,81.00
彰化縣,彰化市,竹中里,101,1,1127,29,1156,1533,0,0,0,0,0,0,75.41
彰化縣,彰化市,三村里,102,1,801,8,809,953,0,0,0,0,0,0,84.89
彰化縣,彰化市,大竹里,103,1,878,18,896,1137,0,0,0,0,0,0,78.80
彰化縣,彰化市,大竹里,104,1,856,22,878,1155,0,0,0,0,0,0,76.02
彰化縣,彰化市,香山里,105,1,843,17,860,1156,0,0,0,0,0,0,74.39
彰化縣,彰化市,香山里,106,1,893,12,905,1072,0,0,0,0,0,0,84.42
彰化縣,彰化市,牛埔里,107,1,1136,14,1150,1443,0,0,0,0,0,0,79.70
彰化縣,彰化市,牛埔里,108,1,858,13,871,1129,0,0,0,0,0,0,77.15
彰化縣,彰化市,台鳳里,109,1,1048,20,1068,1483,0,0,0,0,0,0,72.02
彰化縣,彰化市,台鳳里,110,1,994,16,1010,1371,0,0,0,0,0,0,73.67
彰化縣,彰化市,田中里,111,1,679,7,686,789,0,0,0,0,0,0,86.95
彰化縣,彰化市,快官里,112,1,727,7,734,927,0,0,0,0,0,0,79.18
彰化縣,彰化市,竹巷里,113,1,600,7,607,735,0,0,0,0,0,0,82.59
彰化縣,彰化市,福田里,114,1,864,9,873,1087,0,0,0,0,0,0,80.31
彰化縣,彰化市,石牌里,115,1,833,10,843,1077,0,0,0,0,0,0,78.27
彰化縣,花壇鄉,花壇村,116,1,798,10,808,1042,0,0,0,0,0,0,77.54
彰化縣,花壇鄉,花壇村,117,1,1247,24,1271,1626,0,0,0,0,0,0,78.17
彰化縣,花壇鄉,金墩村,118,1,1207,16,1223,1521,0,0,0,0,0,0,80.41
彰化縣,花壇鄉,中庄村,119,1,668,14,682,865,0,0,0,0,0,0,78.84
彰化縣,花壇鄉,中庄村,120,1,918,23,941,1198,0,0,0,0,0,0,78.55
彰化縣,花壇鄉,劉厝村,121,1,800,8,808,974,0,0,0,0,0,0,82.96
彰化縣,花壇鄉,崙雅村,122,1,1030,12,1042,1247,0,0,0,0,0,0,83.56
彰化縣,花壇鄉,南口村,123,1,1050,12,1062,1297,0,0,0,0,0,0,81.88
彰化縣,花壇鄉,中口村,124,1,546,9,555,656,0,0,0,0,0,0,84.60
彰化縣,花壇鄉,北口村,125,1,679,3,682,795,0,0,0,0,0,0,85.79
彰化縣,花壇鄉,北口村,126,1,559,14,573,692,0,0,0,0,0,0,82.80
彰化縣,花壇鄉,長沙村,127,1,941,17,958,1225,0,0,0,0,0,0,78.20
彰化縣,花壇鄉,長沙村,128,1,986,11,997,1230,0,0,0,0,0,0,81.06
彰化縣,花壇鄉,長沙村,129,1,643,11,654,868,0,0,0,0,0,0,75.35
彰化縣,花壇鄉,文德村,130,1,852,8,860,1083,0,0,0,0,0,0,79.41
彰化縣,花壇鄉,文德村,131,1,747,16,763,939,0,0,0,0,0,0,81.26
彰化縣,花壇鄉,白沙村,132,1,1099,12,1111,1459,0,0,0,0,0,0,76.15
彰化縣,花壇鄉,白沙村,133,1,1030,22,1052,1506,0,0,0,0,0,0,69.85
彰化縣,花壇鄉,岩竹村,134,1,999,11,1010,1290,0,0,0,0,0,0,78.29
彰化縣,花壇鄉,橋頭村,135,1,1221,32,1253,1637,0,0,0,0,0,0,76.54
彰化縣,花壇鄉,橋頭村,136,1,806,15,821,1003,0,0,0,0,0,0,81.85
彰化縣,花壇鄉,灣雅村,137,1,634,7,641,794,0,0,0,0,0,0,80.73
彰化縣,花壇鄉,灣東村,138,1,738,9,747,958,0,0,0,0,0,0,77.97
彰化縣,花壇鄉,三春村,139,1,1129,12,1141,1520,0,0,0,0,0,0,75.07
彰化縣,花壇鄉,永春村,140,1,986,17,1003,1317,0,0,0,0,0,0,76.16
彰化縣,花壇鄉,長春村,141,1,1001,12,1013,1306,0,0,0,0,0,0,77.57
彰化縣,芬園鄉,舊社村,142,1,1251,15,1266,1607,0,0,0,0,0,0,78.78
彰化縣,芬園鄉,大埔村,143,1,1001,16,1017,1286,0,0,0,0,0,0,79.08
彰化縣,芬園鄉,竹林村,144,1,1239,17,1256,1538,0,0,0,0,0,0,81.66
彰化縣,芬園鄉,楓坑村,145,1,452,5,457,563,0,0,0,0,0,0,81.17
彰化縣,芬園鄉,社口村,146,1,693,17,710,895,0,0,0,0,0,0,79.33
彰化縣,芬園鄉,社口村,147,1,870,19,889,1181,0,0,0,0,0,0,75.28
彰化縣,芬園鄉,茄荖村,148,1,803,14,817,1077,0,0,0,0,0,0,75.86
彰化縣,芬園鄉,茄荖村,149,1,711,21,732,923,0,0,0,0,0,0,79.31
彰化縣,芬園鄉,嘉興村,150,1,1085,22,1107,1388,0,0,0,0,0,0,79.76
彰化縣,芬園鄉,芬園村,151,1,693,10,703,855,0,0,0,0,0,0,82.22
彰化縣,芬園鄉,進芬村,152,1,715,13,728,903,0,0,0,0,0,0,80.62
彰化縣,芬園鄉,縣庄村,153,1,812,11,823,1031,0,0,0,0,0,0,79.83
彰化縣,芬園鄉,圳墘村,154,1,581,8,589,704,0,0,0,0,0,0,83.66
彰化縣,芬園鄉,溪頭村,155,1,1127,14,1141,1441,0,0,0,0,0,0,79.18
彰化縣,芬園鄉,同安村,156,1,940,10,950,1266,0,0,0,0,0,0,75.04
彰化縣,芬園鄉,中崙村,157,1,740,10,750,980,0,0,0,0,0,0,76.53
彰化縣,芬園鄉,大竹村,158,1,780,12,792,1059,0,0,0,0,0,0,74.79
彰化縣,鹿港鎮,大有里,159,1,928,15,943,1184,0,0,0,0,0,0,79.65
彰化縣,鹿港鎮,中興里,160,1,466,4,470,593,0,0,0,0,0,0,79.26
彰化縣,鹿港鎮,洛津里,161,1,861,13,874,1111,0,0,0,0,0,0,78.67
彰化縣,鹿港鎮,順興里,162,1,769,9,778,942,0,0,0,0,0,0,82.59
彰化縣,鹿港鎮,菜園里,163,1,826,8,834,1061,0,0,0,0,0,0,78.61
彰化縣,鹿港鎮,街尾里,164,1,1402,23,1425,1854,0,0,0,0,0,0,76.86
彰化縣,鹿港鎮,泰興里,165,1,938,18,956,1260,0,0,0,0,0,0,75.87
彰化縣,鹿港鎮,長興里,166,1,246,4,250,324,0,0,0,0,0,0,77.16
彰化縣,鹿港鎮,興化里,167,1,579,8,587,727,0,0,0,0,0,0,80.74
彰化縣,鹿港鎮,龍山里,168,1,627,6,633,810,0,0,0,0,0,0,78.15
彰化縣,鹿港鎮,景福里,169,1,914,16,930,1163,0,0,0,0,0,0,79.97
彰化縣,鹿港鎮,郭厝里,170,1,447,2,449,584,0,0,0,0,0,0,76.88
彰化縣,鹿港鎮,新宮里,171,1,770,14,784,971,0,0,0,0,0,0,80.74
彰化縣,鹿港鎮,玉順里,172,1,1023,15,1038,1279,0,0,0,0,0,0,81.16
彰化縣,鹿港鎮,東石里,173,1,989,16,1005,1315,0,0,0,0,0,0,76.43
彰化縣,鹿港鎮,東石里,174,1,1136,16,1152,1468,0,0,0,0,0,0,78.47
彰化縣,鹿港鎮,永安里,175,1,1291,29,1320,1694,0,0,0,0,0,0,77.92
彰化縣,鹿港鎮,永安里,176,1,1239,15,1254,1607,0,0,0,0,0,0,78.03
彰化縣,鹿港鎮,埔崙里,177,1,1089,24,1113,1380,0,0,0,0,0,0,80.65
彰化縣,鹿港鎮,埔崙里,178,1,1017,20,1037,1319,0,0,0,0,0,0,78.62
彰化縣,鹿港鎮,頂厝里,179,1,1193,23,1216,1538,0,0,0,0,0,0,79.06
彰化縣,鹿港鎮,頂厝里,180,1,952,20,972,1249,0,0,0,0,0,0,77.82
彰化縣,鹿港鎮,頂厝里,181,1,1259,17,1276,1611,0,0,0,0,0,0,79.21
彰化縣,鹿港鎮,東崎里,182,1,1384,22,1406,1781,0,0,0,0,0,0,78.94
彰化縣,鹿港鎮,東崎里,183,1,954,18,972,1215,0,0,0,0,0,0,80.00
彰化縣,鹿港鎮,廖厝里,184,1,995,24,1019,1295,0,0,0,0,0,0,78.69
彰化縣,鹿港鎮,廖厝里,185,1,1227,13,1240,1487,0,0,0,0,0,0,83.39
彰化縣,鹿港鎮,詔安里,186,1,1160,16,1176,1497,0,0,0,0,0,0,78.56
彰化縣,鹿港鎮,海埔里,187,1,1079,16,1095,1381,0,0,0,0,0,0,79.29
彰化縣,鹿港鎮,海埔里,188,1,934,13,947,1183,0,0,0,0,0,0,80.05
彰化縣,鹿港鎮,洋厝里,189,1,640,4,644,810,0,0,0,0,0,0,79.51
彰化縣,鹿港鎮,洋厝里,190,1,1066,15,1081,1379,0,0,0,0,0,0,78.39
彰化縣,鹿港鎮,草中里,191,1,1022,15,1037,1311,0,0,0,0,0,0,79.10
彰化縣,鹿港鎮,草中里,192,1,1129,24,1153,1401,0,0,0,0,0,0,82.30
彰化縣,鹿港鎮,山崙里,193,1,868,13,881,1116,0,0,0,0,0,0,78.94
彰化縣,鹿港鎮,山崙里,194,1,1263,19,1282,1549,0,0,0,0,0,0,82.76
彰化縣,鹿港鎮,頭南里,195,1,1347,23,1370,1648,0,0,0,0,0,0,83.13
彰化縣,鹿港鎮,頭崙里,196,1,1018,16,1034,1265,0,0,0,0,0,0,81.74
彰化縣,鹿港鎮,頭崙里,197,1,634,9,643,755,0,0,0,0,0,0,85.17
彰化縣,鹿港鎮,頂番里,198,1,1013,15,1028,1256,0,0,0,0,0,0,81.85
彰化縣,鹿港鎮,頂番里,199,1,1269,23,1292,1570,0,0,0,0,0,0,82.29
彰化縣,鹿港鎮,溝墘里,200,1,952,9,961,1161,0,0,0,0,0,0,82.77
彰化縣,鹿港鎮,溝墘里,201,1,893,20,913,1132,0,0,0,0,0,0,80.65
彰化縣,鹿港鎮,溝墘里,202,1,592,3,595,717,0,0,0,0,0,0,82.98
彰化縣,福興鄉,番婆村,203,1,802,6,808,1016,0,0,0,0,0,0,79.53
彰化縣,福興鄉,番婆村,204,1,671,11,682,847,0,0,0,0,0,0,80.52
彰化縣,福興鄉,大崙村,205,1,837,17,854,1063,0,0,0,0,0,0,80.34
彰化縣,福興鄉,外埔村,206,1,756,16,772,939,0,0,0,0,0,0,82.22
彰化縣,福興鄉,三汴村,207,1,892,10,902,1121,0,0,0,0,0,0,80.46
彰化縣,福興鄉,萬豐村,208,1,534,4,538,649,0,0,0,0,0,0,82.90
彰化縣,福興鄉,外中村,209,1,908,7,915,1120,0,0,0,0,0,0,81.70
彰化縣,福興鄉,元中村,210,1,814,18,832,1054,0,0,0,0,0,0,78.94
彰化縣,福興鄉,橋頭村,211,1,734,7,741,899,0,0,0,0,0,0,82.42
彰化縣,福興鄉,橋頭村,212,1,758,10,768,987,0,0,0,0,0,0,77.81
彰化縣,福興鄉,社尾村,213,1,1037,19,1056,1271,0,0,0,0,0,0,83.08
彰化縣,福興鄉,番社村,214,1,985,9,994,1205,0,0,0,0,0,0,82.49
彰化縣,福興鄉,同安村,215,1,767,9,776,920,0,0,0,0,0,0,84.35
彰化縣,福興鄉,同安村,216,1,701,9,710,886,0,0,0,0,0,0,80.14
彰化縣,福興鄉,西勢村,217,1,717,12,729,901,0,0,0,0,0,0,80.91
彰化縣,福興鄉,西勢村,218,1,505,7,512,640,0,0,0,0,0,0,80.00
彰化縣,福興鄉,秀厝村,219,1,623,3,626,800,0,0,0,0,0,0,78.25
彰化縣,福興鄉,秀厝村,220,1,811,4,815,1010,0,0,0,0,0,0,80.69
彰化縣,福興鄉,鎮平村,221,1,761,12,773,997,0,0,0,0,0,0,77.53
彰化縣,福興鄉,三和村,222,1,760,1,761,998,0,0,0,0,0,0,76.25
彰化縣,福興鄉,麥厝村,223,1,738,14,752,947,0,0,0,0,0,0,79.41
彰化縣,福興鄉,麥厝村,224,1,697,15,712,951,0,0,0,0,0,0,74.87
彰化縣,福興鄉,廈粘村,225,1,627,11,638,807,0,0,0,0,0,0,79.06
彰化縣,福興鄉,廈粘村,226,1,664,9,673,866,0,0,0,0,0,0,77.71
彰化縣,福興鄉,頂粘村,227,1,718,9,727,861,0,0,0,0,0,0,84.44
彰化縣,福興鄉,頂粘村,228,1,848,9,857,1040,0,0,0,0,0,0,82.40
彰化縣,福興鄉,福寶村,229,1,848,11,859,1075,0,0,0,0,0,0,79.91
彰化縣,福興鄉,二港村,230,1,933,11,944,1199,0,0,0,0,0,0,78.73
彰化縣,福興鄉,福興村,231,1,1084,23,1107,1427,0,0,0,0,0,0,77.58
彰化縣,福興鄉,福興村,232,1,834,5,839,1061,0,0,0,0,0,0,79.08
彰化縣,福興鄉,福南村,233,1,727,5,732,920,0,0,0,0,0,0,79.57
彰化縣,福興鄉,福南村,234,1,748,13,761,974,0,0,0,0,0,0,78.13
彰化縣,秀水鄉,秀水村,235,1,747,8,755,920,0,0,0,0,0,0,82.07
彰化縣,秀水鄉,秀水村,236,1,462,3,465,556,0,0,0,0,0,0,83.63
彰化縣,秀水鄉,安溪村,237,1,1062,22,1084,1364,0,0,0,0,0,0,79.47
彰化縣,秀水鄉,莊雅村,238,1,875,16,891,1073,0,0,0,0,0,0,83.04
彰化縣,秀水鄉,莊雅村,239,1,572,9,581,748,0,0,0,0,0,0,77.67
彰化縣,秀水鄉,陝西村,240,1,904,12,916,1083,0,0,0,0,0,0,84.58
彰化縣,秀水鄉,金興村,241,1,667,7,674,800,0,0,0,0,0,0,84.25
彰化縣,秀水鄉,金興村,242,1,605,5,610,730,0,0,0,0,0,0,83.56
彰化縣,秀水鄉,安東村,243,1,843,14,857,1106,0,0,0,0,0,0,77.49
彰化縣,秀水鄉,安東村,244,1,631,14,645,775,0,0,0,0,0,0,83.23
彰化縣,秀水鄉,安東村,245,1,832,15,847,1036,0,0,0,0,0,0,81.76
彰化縣,秀水鄉,鶴鳴村,246,1,1120,16,1136,1377,0,0,0,0,0,0,82.50
彰化縣,秀水鄉,鶴鳴村,247,1,851,17,868,1009,0,0,0,0,0,0,86.03
彰化縣,秀水鄉,馬興村,248,1,868,11,879,1028,0,0,0,0,0,0,85.51
彰化縣,秀水鄉,馬興村,249,1,623,9,632,768,0,0,0,0,0,0,82.29
彰化縣,秀水鄉,義興村,250,1,849,21,870,1052,0,0,0,0,0,0,82.70
彰化縣,秀水鄉,福安村,251,1,1072,25,1097,1365,0,0,0,0,0,0,80.37
彰化縣,秀水鄉,福安村,252,1,1208,16,1224,1529,0,0,0,0,0,0,80.05
彰化縣,秀水鄉,埔崙村,253,1,486,8,494,580,0,0,0,0,0,0,85.17
彰化縣,秀水鄉,埔崙村,254,1,808,20,828,1004,0,0,0,0,0,0,82.47
彰化縣,秀水鄉,曾厝村,255,1,975,18,993,1192,0,0,0,0,0,0,83.31
彰化縣,秀水鄉,金陵村,256,1,1080,13,1093,1319,0,0,0,0,0,0,82.87
彰化縣,秀水鄉,下崙村,257,1,928,12,940,1080,0,0,0,0,0,0,87.04
彰化縣,秀水鄉,下崙村,258,1,543,6,549,674,0,0,0,0,0,0,81.45
彰化縣,和美鎮,竹營里,259,1,1232,25,1257,1565,0,0,0,0,0,0,80.32
彰化縣,和美鎮,竹營里,260,1,1421,21,1442,1818,0,0,0,0,0,0,79.32
彰化縣,和美鎮,和東里,261,1,1292,28,1320,1655,0,0,0,0,0,0,79.76
彰化縣,和美鎮,和東里,262,1,984,21,1005,1366,0,0,0,0,0,0,73.57
彰化縣,和美鎮,和南里,263,1,398,2,400,453,0,0,0,0,0,0,88.30
彰化縣,和美鎮,和北里,264,1,951,21,972,1264,0,0,0,0,0,0,76.90
彰化縣,和美鎮,和西里,265,1,1064,10,1074,1391,0,0,0,0,0,0,77.21
彰化縣,和美鎮,和西里,266,1,1182,24,1206,1537,0,0,0,0,0,0,78.46
彰化縣,和美鎮,四張里,267,1,649,10,659,847,0,0,0,0,0,0,77.80
彰化縣,和美鎮,四張里,268,1,874,11,885,1123,0,0,0,0,0,0,78.81
彰化縣,和美鎮,頭前里,269,1,951,18,969,1141,0,0,0,0,0,0,84.93
彰化縣,和美鎮,還社里,270,1,623,12,635,735,0,0,0,0,0,0,86.39
彰化縣,和美鎮,面前里,271,1,402,4,406,503,0,0,0,0,0,0,80.72
彰化縣,和美鎮,面前里,272,1,821,9,830,1011,0,0,0,0,0,0,82.10
彰化縣,和美鎮,鎮平里,273,1,850,12,862,1041,0,0,0,0,0,0,82.80
彰化縣,和美鎮,鎮平里,274,1,895,11,906,1097,0,0,0,0,0,0,82.59
彰化縣,和美鎮,大霞里,275,1,1012,8,1020,1191,0,0,0,0,0,0,85.64
彰化縣,和美鎮,源埤里,276,1,1186,19,1205,1461,0,0,0,0,0,0,82.48
彰化縣,和美鎮,南佃里,277,1,1159,16,1175,1411,0,0,0,0,0,0,83.27
彰化縣,和美鎮,雅溝里,278,1,963,15,978,1166,0,0,0,0,0,0,83.88
彰化縣,和美鎮,山犁里,279,1,1269,18,1287,1606,0,0,0,0,0,0,80.14
彰化縣,和美鎮,山犁里,280,1,1322,28,1350,1677,0,0,0,0,0,0,80.50
彰化縣,和美鎮,山犁里,281,1,850,10,860,1130,0,0,0,0,0,0,76.11
彰化縣,和美鎮,嘉犁里,282,1,1061,20,1081,1377,0,0,0,0,0,0,78.50
彰化縣,和美鎮,詔安里,283,1,1088,25,1113,1472,0,0,0,0,0,0,75.61
彰化縣,和美鎮,鐵山里,284,1,853,15,868,1083,0,0,0,0,0,0,80.15
彰化縣,和美鎮,鐵山里,285,1,767,19,786,1035,0,0,0,0,0,0,75.94
彰化縣,和美鎮,柑井里,286,1,1013,25,1038,1252,0,0,0,0,0,0,82.91
彰化縣,和美鎮,柑井里,287,1,972,22,994,1218,0,0,0,0,0,0,81.61
彰化縣,和美鎮,竹園里,288,1,637,6,643,726,0,0,0,0,0,0,88.57
彰化縣,和美鎮,新庄里,289,1,858,23,881,1104,0,0,0,0,0,0,79.80
彰化縣,和美鎮,新庄里,290,1,761,15,776,963,0,0,0,0,0,0,80.58
彰化縣,和美鎮,犁盛里,291,1,822,20,842,1013,0,0,0,0,0,0,83.12
彰化縣,和美鎮,犁盛里,292,1,784,20,804,968,0,0,0,0,0,0,83.06
彰化縣,和美鎮,中寮里,293,1,809,11,820,1035,0,0,0,0,0,0,79.23
彰化縣,和美鎮,中圍里,294,1,761,17,778,958,0,0,0,0,0,0,81.21
彰化縣,和美鎮,中圍里,295,1,1099,27,1126,1419,0,0,0,0,0,0,79.35
彰化縣,和美鎮,糖友里,296,1,1022,13,1035,1351,0,0,0,0,0,0,76.61
彰化縣,和美鎮,塗厝里,297,1,1308,23,1331,1578,0,0,0,0,0,0,84.35
彰化縣,和美鎮,地潭里,298,1,697,12,709,832,0,0,0,0,0,0,85.22
彰化縣,和美鎮,湖內里,299,1,931,10,941,1210,0,0,0,0,0,0,77.77
彰化縣,和美鎮,嘉寶里,300,1,1328,24,1352,1655,0,0,0,0,0,0,81.69
彰化縣,和美鎮,月眉里,301,1,1199,29,1228,1500,0,0,0,0,0,0,81.87
彰化縣,和美鎮,月眉里,302,1,917,11,928,1156,0,0,0,0,0,0,80.28
彰化縣,和美鎮,好修里,303,1,557,5,562,669,0,0,0,0,0,0,84.01
彰化縣,和美鎮,好修里,304,1,736,11,747,888,0,0,0,0,0,0,84.12
彰化縣,線西鄉,線西村,305,1,1434,21,1455,1767,0,0,0,0,0,0,82.34
彰化縣,線西鄉,頂庄村,306,1,859,17,876,1080,0,0,0,0,0,0,81.11
彰化縣,線西鄉,寓埔村,307,1,1313,20,1333,1720,0,0,0,0,0,0,77.50
彰化縣,線西鄉,塭仔村,308,1,910,9,919,1109,0,0,0,0,0,0,82.87
彰化縣,線西鄉,溝內村,309,1,755,16,771,956,0,0,0,0,0,0,80.65
彰化縣,線西鄉,下犁村,310,1,1211,16,1227,1520,0,0,0,0,0,0,80.72
彰化縣,線西鄉,頂犁村,311,1,1552,24,1576,1938,0,0,0,0,0,0,81.32
彰化縣,線西鄉,德興村,312,1,820,17,837,952,0,0,0,0,0,0,87.92
彰化縣,伸港鄉,新港村,313,1,858,9,867,1117,0,0,0,0,0,0,77.62
彰化縣,伸港鄉,新港村,314,1,928,14,942,1214,0,0,0,0,0,0,77.59
彰化縣,伸港鄉,新港村,315,1,996,12,1008,1337,0,0,0,0,0,0,75.39
彰化縣,伸港鄉,什股村,316,1,1127,20,1147,1396,0,0,0,0,0,0,82.16
彰化縣,伸港鄉,大同村,317,1,924,10,934,1127,0,0,0,0,0,0,82.87
彰化縣,伸港鄉,海尾村,318,1,1254,12,1266,1480,0,0,0,0,0,0,85.54
彰化縣,伸港鄉,全興村,319,1,1074,12,1086,1330,0,0,0,0,0,0,81.65
彰化縣,伸港鄉,溪底村,320,1,1157,19,1176,1461,0,0,0,0,0,0,80.49
彰化縣,伸港鄉,定興村,321,1,1432,24,1456,1867,0,0,0,0,0,0,77.99
彰化縣,伸港鄉,泉州村,322,1,1153,15,1168,1462,0,0,0,0,0,0,79.89
彰化縣,伸港鄉,泉厝村,323,1,810,17,827,1016,0,0,0,0,0,0,81.40
彰化縣,伸港鄉,曾家村,324,1,1126,16,1142,1428,0,0,0,0,0,0,79.97
彰化縣,伸港鄉,蚵寮村,325,1,853,6,859,1085,0,0,0,0,0,0,79.17
彰化縣,伸港鄉,埤墘村,326,1,651,5,656,785,0,0,0,0,0,0,83.57
彰化縣,伸港鄉,七嘉村,327,1,1260,17,1277,1542,0,0,0,0,0,0,82.81
彰化縣,伸港鄉,汴頭村,328,1,1408,13,1421,1740,0,0,0,0,0,0,81.67
彰化縣,員林鎮,東和里,329,1,792,10,802,1069,0,0,0,0,0,0,75.02
彰化縣,員林鎮,民生里,330,1,704,11,715,1029,0,0,0,0,0,0,69.48
彰化縣,員林鎮,民生里,331,1,1050,23,1073,1454,0,0,0,0,0,0,73.80
彰化縣,員林鎮,中正里,332,1,790,12,802,1146,0,0,0,0,0,0,69.98
彰化縣,員林鎮,中正里,333,1,949,11,960,1543,0,0,0,0,0,0,62.22
彰化縣,員林鎮,仁美里,334,1,790,5,795,1128,0,0,0,0,0,0,70.48
彰化縣,員林鎮,仁美里,335,1,1079,22,1101,1539,0,0,0,0,0,0,71.54
彰化縣,員林鎮,新興里,336,1,615,8,623,809,0,0,0,0,0,0,77.01
彰化縣,員林鎮,和平里,337,1,721,11,732,1052,0,0,0,0,0,0,69.58
彰化縣,員林鎮,和平里,338,1,1048,15,1063,1459,0,0,0,0,0,0,72.86
彰化縣,員林鎮,光明里,339,1,743,6,749,968,0,0,0,0,0,0,77.38
彰化縣,員林鎮,中山里,340,1,563,9,572,780,0,0,0,0,0,0,73.33
彰化縣,員林鎮,黎明里,341,1,689,16,705,892,0,0,0,0,0,0,79.04
彰化縣,員林鎮,黎明里,342,1,607,13,620,864,0,0,0,0,0,0,71.76
彰化縣,員林鎮,惠來里,343,1,885,17,902,1316,0,0,0,0,0,0,68.54
彰化縣,員林鎮,惠來里,344,1,865,6,871,1234,0,0,0,0,0,0,70.58
彰化縣,員林鎮,惠來里,345,1,961,23,984,1318,0,0,0,0,0,0,74.66
彰化縣,員林鎮,三義里,346,1,709,15,724,1007,0,0,0,0,0,0,71.90
彰化縣,員林鎮,三義里,347,1,826,20,846,1223,0,0,0,0,0,0,69.17
彰化縣,員林鎮,新生里,348,1,721,17,738,1011,0,0,0,0,0,0,73.00
彰化縣,員林鎮,新生里,349,1,1128,15,1143,1560,0,0,0,0,0,0,73.27
彰化縣,員林鎮,新生里,350,1,692,11,703,975,0,0,0,0,0,0,72.10
彰化縣,員林鎮,南平里,351,1,613,8,621,832,0,0,0,0,0,0,74.64
彰化縣,員林鎮,南平里,352,1,671,13,684,986,0,0,0,0,0,0,69.37
彰化縣,員林鎮,南平里,353,1,948,15,963,1292,0,0,0,0,0,0,74.54
彰化縣,員林鎮,南興里,354,1,1012,19,1031,1422,0,0,0,0,0,0,72.50
彰化縣,員林鎮,南興里,355,1,927,16,943,1252,0,0,0,0,0,0,75.32
彰化縣,員林鎮,南興里,356,1,877,10,887,1206,0,0,0,0,0,0,73.55
彰化縣,員林鎮,源潭里,357,1,1049,17,1066,1331,0,0,0,0,0,0,80.09
彰化縣,員林鎮,大埔里,358,1,1243,11,1254,1598,0,0,0,0,0,0,78.47
彰化縣,員林鎮,三條里,359,1,721,18,739,1068,0,0,0,0,0,0,69.19
彰化縣,員林鎮,三條里,360,1,892,10,902,1259,0,0,0,0,0,0,71.64
彰化縣,員林鎮,三條里,361,1,821,9,830,1161,0,0,0,0,0,0,71.49
彰化縣,員林鎮,三條里,362,1,921,15,936,1388,0,0,0,0,0,0,67.44
彰化縣,員林鎮,三和里,363,1,941,15,956,1343,0,0,0,0,0,0,71.18
彰化縣,員林鎮,三和里,364,1,986,14,1000,1382,0,0,0,0,0,0,72.36
彰化縣,員林鎮,三和里,365,1,1173,19,1192,1683,0,0,0,0,0,0,70.83
彰化縣,員林鎮,三橋里,366,1,761,19,780,1104,0,0,0,0,0,0,70.65
彰化縣,員林鎮,三橋里,367,1,903,13,916,1260,0,0,0,0,0,0,72.70
彰化縣,員林鎮,三愛里,368,1,760,13,773,1097,0,0,0,0,0,0,70.46
彰化縣,員林鎮,三愛里,369,1,662,13,675,994,0,0,0,0,0,0,67.91
彰化縣,員林鎮,三信里,370,1,604,4,608,856,0,0,0,0,0,0,71.03
彰化縣,員林鎮,三信里,371,1,655,9,664,929,0,0,0,0,0,0,71.47
彰化縣,員林鎮,三多里,372,1,672,11,683,996,0,0,0,0,0,0,68.57
彰化縣,員林鎮,三多里,373,1,577,9,586,819,0,0,0,0,0,0,71.55
彰化縣,員林鎮,中央里,374,1,1017,18,1035,1370,0,0,0,0,0,0,75.55
彰化縣,員林鎮,溝皂里,375,1,664,9,673,886,0,0,0,0,0,0,75.96
彰化縣,員林鎮,溝皂里,376,1,709,9,718,955,0,0,0,0,0,0,75.18
彰化縣,員林鎮,大饒里,377,1,784,19,803,1024,0,0,0,0,0,0,78.42
彰化縣,員林鎮,大饒里,378,1,819,12,831,1192,0,0,0,0,0,0,69.71
彰化縣,員林鎮,大明里,379,1,725,15,740,996,0,0,0,0,0,0,74.30
彰化縣,員林鎮,大明里,380,1,607,13,620,827,0,0,0,0,0,0,74.97
彰化縣,員林鎮,萬年里,381,1,721,16,737,1016,0,0,0,0,0,0,72.54
彰化縣,員林鎮,萬年里,382,1,546,7,553,761,0,0,0,0,0,0,72.67
彰化縣,員林鎮,萬年里,383,1,653,15,668,905,0,0,0,0,0,0,73.81
彰化縣,員林鎮,崙雅里,384,1,759,15,774,1038,0,0,0,0,0,0,74.57
彰化縣,員林鎮,崙雅里,385,1,827,16,843,1086,0,0,0,0,0,0,77.62
彰化縣,員林鎮,振興里,386,1,721,10,731,1000,0,0,0,0,0,0,73.10
彰化縣,員林鎮,振興里,387,1,733,11,744,966,0,0,0,0,0,0,77.02
彰化縣,員林鎮,林厝里,388,1,652,13,665,894,0,0,0,0,0,0,74.38
彰化縣,員林鎮,林厝里,389,1,813,18,831,1165,0,0,0,0,0,0,71.33
彰化縣,員林鎮,出水里,390,1,1157,29,1186,1593,0,0,0,0,0,0,74.45
彰化縣,員林鎮,湖水里,391,1,962,11,973,1285,0,0,0,0,0,0,75.72
彰化縣,員林鎮,大峰里,392,1,537,13,550,743,0,0,0,0,0,0,74.02
彰化縣,員林鎮,鎮興里,393,1,706,11,717,911,0,0,0,0,0,0,78.70
彰化縣,員林鎮,鎮興里,394,1,650,9,659,820,0,0,0,0,0,0,80.37
彰化縣,員林鎮,浮圳里,395,1,782,18,800,1057,0,0,0,0,0,0,75.69
彰化縣,員林鎮,浮圳里,396,1,601,11,612,859,0,0,0,0,0,0,71.25
彰化縣,員林鎮,西東里,397,1,1071,11,1082,1470,0,0,0,0,0,0,73.61
彰化縣,員林鎮,南東里,398,1,1127,23,1150,1604,0,0,0,0,0,0,71.70
彰化縣,員林鎮,中東里,399,1,1008,14,1022,1342,0,0,0,0,0,0,76.15
彰化縣,員林鎮,東北里,400,1,781,18,799,992,0,0,0,0,0,0,80.54
彰化縣,員林鎮,東北里,401,1,679,20,699,898,0,0,0,0,0,0,77.84
彰化縣,大村鄉,大村村,402,1,1287,26,1313,1728,0,0,0,0,0,0,75.98
彰化縣,大村鄉,茄苳村,403,1,1243,19,1262,1501,0,0,0,0,0,0,84.08
彰化縣,大村鄉,田洋村,404,1,673,5,678,838,0,0,0,0,0,0,80.91
彰化縣,大村鄉,貢旗村,405,1,960,11,971,1214,0,0,0,0,0,0,79.98
彰化縣,大村鄉,加錫村,406,1,935,8,943,1192,0,0,0,0,0,0,79.11
彰化縣,大村鄉,大崙村,407,1,1120,8,1128,1420,0,0,0,0,0,0,79.44
彰化縣,大村鄉,新興村,408,1,791,17,808,1087,0,0,0,0,0,0,74.33
彰化縣,大村鄉,南勢村,409,1,813,16,829,1078,0,0,0,0,0,0,76.90
彰化縣,大村鄉,擺塘村,410,1,1453,28,1481,1950,0,0,0,0,0,0,75.95
彰化縣,大村鄉,過溝村,411,1,1142,4,1146,1395,0,0,0,0,0,0,82.15
彰化縣,大村鄉,大橋村,412,1,1287,14,1301,1725,0,0,0,0,0,0,75.42
彰化縣,大村鄉,村上村,413,1,893,15,908,1127,0,0,0,0,0,0,80.57
彰化縣,大村鄉,美港村,414,1,1020,11,1031,1343,0,0,0,0,0,0,76.77
彰化縣,大村鄉,美港村,415,1,735,14,749,986,0,0,0,0,0,0,75.96
彰化縣,大村鄉,黃厝村,416,1,1212,20,1232,1572,0,0,0,0,0,0,78.37
彰化縣,大村鄉,福興村,417,1,1219,26,1245,1624,0,0,0,0,0,0,76.66
彰化縣,大村鄉,平和村,418,1,1413,26,1439,1861,0,0,0,0,0,0,77.32
彰化縣,永靖鄉,永東村,419,1,642,10,652,800,0,0,0,0,0,0,81.50
彰化縣,永靖鄉,永西村,420,1,983,19,1002,1352,0,0,0,0,0,0,74.11
彰化縣,永靖鄉,永南村,421,1,1208,26,1234,1673,0,0,0,0,0,0,73.76
彰化縣,永靖鄉,永北村,422,1,1196,22,1218,1630,0,0,0,0,0,0,74.72
彰化縣,永靖鄉,港西村,423,1,1145,29,1174,1563,0,0,0,0,0,0,75.11
彰化縣,永靖鄉,五福村,424,1,902,19,921,1221,0,0,0,0,0,0,75.43
彰化縣,永靖鄉,湳港村,425,1,655,12,667,853,0,0,0,0,0,0,78.19
彰化縣,永靖鄉,新莊村,426,1,589,7,596,778,0,0,0,0,0,0,76.61
彰化縣,永靖鄉,瑚璉村,427,1,1343,23,1366,1868,0,0,0,0,0,0,73.13
彰化縣,永靖鄉,五汴村,428,1,921,19,940,1210,0,0,0,0,0,0,77.69
彰化縣,永靖鄉,浮圳村,429,1,786,14,800,1000,0,0,0,0,0,0,80.00
彰化縣,永靖鄉,光雲村,430,1,1068,22,1090,1368,0,0,0,0,0,0,79.68
彰化縣,永靖鄉,東寧村,431,1,1139,26,1165,1489,0,0,0,0,0,0,78.24
彰化縣,永靖鄉,永興村,432,1,1128,11,1139,1420,0,0,0,0,0,0,80.21
彰化縣,永靖鄉,崙子村,433,1,818,26,844,1081,0,0,0,0,0,0,78.08
彰化縣,永靖鄉,獨鰲村,434,1,609,22,631,857,0,0,0,0,0,0,73.63
彰化縣,永靖鄉,敦厚村,435,1,471,4,475,620,0,0,0,0,0,0,76.61
彰化縣,永靖鄉,崙美村,436,1,555,13,568,723,0,0,0,0,0,0,78.56
彰化縣,永靖鄉,同安村,437,1,480,11,491,617,0,0,0,0,0,0,79.58
彰化縣,永靖鄉,同仁村,438,1,687,9,696,909,0,0,0,0,0,0,76.57
彰化縣,永靖鄉,湳墘村,439,1,641,11,652,828,0,0,0,0,0,0,78.74
彰化縣,永靖鄉,四芳村,440,1,520,11,531,678,0,0,0,0,0,0,78.32
彰化縣,永靖鄉,福興村,441,1,886,26,912,1137,0,0,0,0,0,0,80.21
彰化縣,永靖鄉,竹子村,442,1,1010,11,1021,1340,0,0,0,0,0,0,76.19
彰化縣,溪湖鎮,光平里,443,1,922,12,934,1149,0,0,0,0,0,0,81.29
彰化縣,溪湖鎮,平和里,444,1,568,6,574,736,0,0,0,0,0,0,77.99
彰化縣,溪湖鎮,太平里,445,1,941,18,959,1244,0,0,0,0,0,0,77.09
彰化縣,溪湖鎮,光華里,446,1,411,4,415,525,0,0,0,0,0,0,79.05
彰化縣,溪湖鎮,東寮里,447,1,963,6,969,1291,0,0,0,0,0,0,75.06
彰化縣,溪湖鎮,東寮里,448,1,989,11,1000,1342,0,0,0,0,0,0,74.52
彰化縣,溪湖鎮,西寮里,449,1,1320,11,1331,1684,0,0,0,0,0,0,79.04
彰化縣,溪湖鎮,大突里,450,1,677,7,684,918,0,0,0,0,0,0,74.51
彰化縣,溪湖鎮,大突里,451,1,680,10,690,902,0,0,0,0,0,0,76.50
彰化縣,溪湖鎮,北勢里,452,1,952,17,969,1197,0,0,0,0,0,0,80.95
彰化縣,溪湖鎮,汴頭里,453,1,888,9,897,1072,0,0,0,0,0,0,83.68
彰化縣,溪湖鎮,汴頭里,454,1,643,9,652,829,0,0,0,0,0,0,78.65
彰化縣,溪湖鎮,大竹里,455,1,768,14,782,1012,0,0,0,0,0,0,77.27
彰化縣,溪湖鎮,大竹里,456,1,832,8,840,1092,0,0,0,0,0,0,76.92
彰化縣,溪湖鎮,湖西里,457,1,1332,12,1344,1747,0,0,0,0,0,0,76.93
彰化縣,溪湖鎮,田中里,458,1,610,1,611,732,0,0,0,0,0,0,83.47
彰化縣,溪湖鎮,河東里,459,1,1206,19,1225,1515,0,0,0,0,0,0,80.86
彰化縣,溪湖鎮,中山里,460,1,879,12,891,1098,0,0,0,0,0,0,81.15
彰化縣,溪湖鎮,中山里,461,1,833,14,847,1064,0,0,0,0,0,0,79.61
彰化縣,溪湖鎮,中竹里,462,1,605,3,608,730,0,0,0,0,0,0,83.29
彰化縣,溪湖鎮,東溪里,463,1,910,21,931,1160,0,0,0,0,0,0,80.26
彰化縣,溪湖鎮,西溪里,464,1,1026,22,1048,1352,0,0,0,0,0,0,77.51
彰化縣,溪湖鎮,湖東里,465,1,1263,20,1283,1632,0,0,0,0,0,0,78.62
彰化縣,溪湖鎮,湖東里,466,1,1266,19,1285,1632,0,0,0,0,0,0,78.74
彰化縣,溪湖鎮,頂庄里,467,1,501,14,515,647,0,0,0,0,0,0,79.60
彰化縣,溪湖鎮,忠覺里,468,1,915,13,928,1107,0,0,0,0,0,0,83.83
彰化縣,溪湖鎮,湳底里,469,1,560,4,564,679,0,0,0,0,0,0,83.06
彰化縣,溪湖鎮,大庭里,470,1,901,12,913,1140,0,0,0,0,0,0,80.09
彰化縣,溪湖鎮,媽厝里,471,1,1007,12,1019,1338,0,0,0,0,0,0,76.16
彰化縣,溪湖鎮,西勢里,472,1,598,8,606,751,0,0,0,0,0,0,80.69
彰化縣,溪湖鎮,西勢里,473,1,749,9,758,974,0,0,0,0,0,0,77.82
彰化縣,溪湖鎮,番婆里,474,1,1049,14,1063,1423,0,0,0,0,0,0,74.70
彰化縣,埔鹽鄉,埔鹽村,475,1,1127,24,1151,1410,0,0,0,0,0,0,81.63
彰化縣,埔鹽鄉,埔南村,476,1,1069,22,1091,1362,0,0,0,0,0,0,80.10
彰化縣,埔鹽鄉,部子村,477,1,904,9,913,1070,0,0,0,0,0,0,85.33
彰化縣,埔鹽鄉,出水村,478,1,633,6,639,758,0,0,0,0,0,0,84.30
彰化縣,埔鹽鄉,南港村,479,1,1286,21,1307,1536,0,0,0,0,0,0,85.09
彰化縣,埔鹽鄉,打廉村,480,1,761,4,765,896,0,0,0,0,0,0,85.38
彰化縣,埔鹽鄉,豐澤村,481,1,918,16,934,1201,0,0,0,0,0,0,77.77
彰化縣,埔鹽鄉,崑崙村,482,1,785,0,785,964,0,0,0,0,0,0,81.43
彰化縣,埔鹽鄉,角樹村,483,1,542,5,547,668,0,0,0,0,0,0,81.89
彰化縣,埔鹽鄉,瓦窯村,484,1,891,12,903,1066,0,0,0,0,0,0,84.71
彰化縣,埔鹽鄉,好修村,485,1,964,17,981,1169,0,0,0,0,0,0,83.92
彰化縣,埔鹽鄉,西湖村,486,1,1534,23,1557,1899,0,0,0,0,0,0,81.99
彰化縣,埔鹽鄉,大有村,487,1,1037,7,1044,1212,0,0,0,0,0,0,86.14
彰化縣,埔鹽鄉,新興村,488,1,308,0,308,385,0,0,0,0,0,0,80.00
彰化縣,埔鹽鄉,永平村,489,1,779,7,786,985,0,0,0,0,0,0,79.80
彰化縣,埔鹽鄉,永樂村,490,1,628,6,634,743,0,0,0,0,0,0,85.33
彰化縣,埔鹽鄉,石埤村,491,1,1024,18,1042,1271,0,0,0,0,0,0,81.98
彰化縣,埔鹽鄉,天盛村,492,1,641,7,648,802,0,0,0,0,0,0,80.80
彰化縣,埔鹽鄉,太平村,493,1,1107,13,1120,1420,0,0,0,0,0,0,78.87
彰化縣,埔鹽鄉,新水村,494,1,1026,17,1043,1273,0,0,0,0,0,0,81.93
彰化縣,埔鹽鄉,三省村,495,1,995,7,1002,1228,0,0,0,0,0,0,81.60
彰化縣,埔鹽鄉,南新村,496,1,978,17,995,1225,0,0,0,0,0,0,81.22
彰化縣,埔心鄉,東門村,497,1,862,9,871,1122,0,0,0,0,0,0,77.63
彰化縣,埔心鄉,東門村,498,1,860,7,867,1182,0,0,0,0,0,0,73.35
彰化縣,埔心鄉,埔心村,499,1,888,5,893,1171,0,0,0,0,0,0,76.26
彰化縣,埔心鄉,義民村,500,1,1039,15,1054,1347,0,0,0,0,0,0,78.25
彰化縣,埔心鄉,油車村,501,1,824,15,839,1036,0,0,0,0,0,0,80.98
彰化縣,埔心鄉,瓦北村,502,1,1125,18,1143,1510,0,0,0,0,0,0,75.70
彰化縣,埔心鄉,瓦中村,503,1,1147,34,1181,1475,0,0,0,0,0,0,80.07
彰化縣,埔心鄉,瓦南村,504,1,978,14,992,1276,0,0,0,0,0,0,77.74
彰化縣,埔心鄉,經口村,505,1,969,12,981,1348,0,0,0,0,0,0,72.77
彰化縣,埔心鄉,太平村,506,1,1262,26,1288,1622,0,0,0,0,0,0,79.41
彰化縣,埔心鄉,大華村,507,1,460,5,465,580,0,0,0,0,0,0,80.17
彰化縣,埔心鄉,仁里村,508,1,700,15,715,925,0,0,0,0,0,0,77.30
彰化縣,埔心鄉,舊館村,509,1,777,16,793,1025,0,0,0,0,0,0,77.37
彰化縣,埔心鄉,南館村,510,1,519,11,530,689,0,0,0,0,0,0,76.92
彰化縣,埔心鄉,新館村,511,1,608,10,618,782,0,0,0,0,0,0,79.03
彰化縣,埔心鄉,芎蕉村,512,1,1111,23,1134,1527,0,0,0,0,0,0,74.26
彰化縣,埔心鄉,羅厝村,513,1,983,11,994,1274,0,0,0,0,0,0,78.02
彰化縣,埔心鄉,梧鳳村,514,1,673,10,683,852,0,0,0,0,0,0,80.16
彰化縣,埔心鄉,二重村,515,1,899,15,914,1136,0,0,0,0,0,0,80.46
彰化縣,埔心鄉,埤霞村,516,1,601,12,613,713,0,0,0,0,0,0,85.97
彰化縣,埔心鄉,埤腳村,517,1,668,20,688,842,0,0,0,0,0,0,81.71
彰化縣,田中鎮,香山里,518,1,639,10,649,863,0,0,0,0,0,0,75.20
彰化縣,田中鎮,碧峰里,519,1,684,27,711,1034,0,0,0,0,0,0,68.76
彰化縣,田中鎮,碧峰里,520,1,382,19,401,753,0,0,0,0,0,0,53.25
彰化縣,田中鎮,碧峰里,521,1,482,20,502,750,0,0,0,0,0,0,66.93
彰化縣,田中鎮,東源里,522,1,450,10,460,627,0,0,0,0,0,0,73.37
彰化縣,田中鎮,復興里,523,1,1039,18,1057,1485,0,0,0,0,0,0,71.18
彰化縣,田中鎮,平和里,524,1,1026,19,1045,1436,0,0,0,0,0,0,72.77
彰化縣,田中鎮,頂潭里,525,1,857,17,874,1154,0,0,0,0,0,0,75.74
彰化縣,田中鎮,中潭里,526,1,1137,19,1156,1606,0,0,0,0,0,0,71.98
彰化縣,田中鎮,龍潭里,527,1,491,4,495,642,0,0,0,0,0,0,77.10
彰化縣,田中鎮,北路里,528,1,1037,20,1057,1476,0,0,0,0,0,0,71.61
彰化縣,田中鎮,北路里,529,1,751,8,759,1053,0,0,0,0,0,0,72.08
彰化縣,田中鎮,西路里,530,1,640,6,646,892,0,0,0,0,0,0,72.42
彰化縣,田中鎮,西路里,531,1,769,17,786,1082,0,0,0,0,0,0,72.64
彰化縣,田中鎮,東路里,532,1,785,10,795,1056,0,0,0,0,0,0,75.28
彰化縣,田中鎮,南路里,533,1,911,13,924,1269,0,0,0,0,0,0,72.81
彰化縣,田中鎮,中路里,534,1,647,8,655,917,0,0,0,0,0,0,71.43
彰化縣,田中鎮,中路里,535,1,785,13,798,1067,0,0,0,0,0,0,74.79
彰化縣,田中鎮,新庄里,536,1,1327,37,1364,1872,0,0,0,0,0,0,72.86
彰化縣,田中鎮,三安里,537,1,1157,31,1188,1592,0,0,0,0,0,0,74.62
彰化縣,田中鎮,大崙里,538,1,872,13,885,1247,0,0,0,0,0,0,70.97
彰化縣,田中鎮,沙崙里,539,1,1070,24,1094,1469,0,0,0,0,0,0,74.47
彰化縣,田中鎮,新民里,540,1,1094,24,1118,1548,0,0,0,0,0,0,72.22
彰化縣,田中鎮,新民里,541,1,993,16,1009,1465,0,0,0,0,0,0,68.87
彰化縣,田中鎮,梅州里,542,1,865,18,883,1284,0,0,0,0,0,0,68.77
彰化縣,田中鎮,三民里,543,1,1039,22,1061,1433,0,0,0,0,0,0,74.04
彰化縣,田中鎮,三光里,544,1,684,17,701,908,0,0,0,0,0,0,77.20
彰化縣,田中鎮,大社里,545,1,560,10,570,744,0,0,0,0,0,0,76.61
彰化縣,社頭鄉,社頭村,546,1,816,13,829,1157,0,0,0,0,0,0,71.65
彰化縣,社頭鄉,社頭村,547,1,940,13,953,1279,0,0,0,0,0,0,74.51
彰化縣,社頭鄉,廣興村,548,1,737,8,745,946,0,0,0,0,0,0,78.75
彰化縣,社頭鄉,廣興村,549,1,917,17,934,1224,0,0,0,0,0,0,76.31
彰化縣,社頭鄉,廣興村,550,1,780,11,791,1032,0,0,0,0,0,0,76.65
彰化縣,社頭鄉,仁雅村,551,1,703,10,713,953,0,0,0,0,0,0,74.82
彰化縣,社頭鄉,仁雅村,552,1,948,13,961,1352,0,0,0,0,0,0,71.08
彰化縣,社頭鄉,崙雅村,553,1,555,9,564,751,0,0,0,0,0,0,75.10
彰化縣,社頭鄉,美雅村,554,1,735,13,748,938,0,0,0,0,0,0,79.74
彰化縣,社頭鄉,里仁村,555,1,772,19,791,997,0,0,0,0,0,0,79.34
彰化縣,社頭鄉,舊社村,556,1,962,11,973,1283,0,0,0,0,0,0,75.84
彰化縣,社頭鄉,松竹村,557,1,658,13,671,851,0,0,0,0,0,0,78.85
彰化縣,社頭鄉,東興村,558,1,888,12,900,1214,0,0,0,0,0,0,74.14
彰化縣,社頭鄉,廣福村,559,1,599,7,606,769,0,0,0,0,0,0,78.80
彰化縣,社頭鄉,橋頭村,560,1,1311,19,1330,1752,0,0,0,0,0,0,75.91
彰化縣,社頭鄉,湳底村,561,1,1014,24,1038,1337,0,0,0,0,0,0,77.64
彰化縣,社頭鄉,新厝村,562,1,1022,16,1038,1357,0,0,0,0,0,0,76.49
彰化縣,社頭鄉,張厝村,563,1,829,5,834,1028,0,0,0,0,0,0,81.13
彰化縣,社頭鄉,埤斗村,564,1,792,19,811,977,0,0,0,0,0,0,83.01
彰化縣,社頭鄉,清水村,565,1,810,10,820,1025,0,0,0,0,0,0,80.00
彰化縣,社頭鄉,山湖村,566,1,682,11,693,889,0,0,0,0,0,0,77.95
彰化縣,社頭鄉,朝興村,567,1,716,13,729,925,0,0,0,0,0,0,78.81
彰化縣,社頭鄉,仁和村,568,1,482,30,512,668,0,0,0,0,0,0,76.65
彰化縣,社頭鄉,泰安村,569,1,610,9,619,794,0,0,0,0,0,0,77.96
彰化縣,社頭鄉,平和村,570,1,690,6,696,856,0,0,0,0,0,0,81.31
彰化縣,社頭鄉,龍井村,571,1,583,11,594,763,0,0,0,0,0,0,77.85
彰化縣,社頭鄉,湳雅村,572,1,986,20,1006,1287,0,0,0,0,0,0,78.17
彰化縣,社頭鄉,協和村,573,1,1301,28,1329,1773,0,0,0,0,0,0,74.96
彰化縣,二水鄉,復興村,574,1,800,6,806,1039,0,0,0,0,0,0,77.57
彰化縣,二水鄉,十五村,575,1,529,7,536,700,0,0,0,0,0,0,76.57
彰化縣,二水鄉,合和村,576,1,638,9,647,837,0,0,0,0,0,0,77.30
彰化縣,二水鄉,上豐村,577,1,786,24,810,1040,0,0,0,0,0,0,77.88
彰化縣,二水鄉,過圳村,578,1,518,3,521,652,0,0,0,0,0,0,79.91
彰化縣,二水鄉,五伯村,579,1,543,5,548,692,0,0,0,0,0,0,79.19
彰化縣,二水鄉,光化村,580,1,745,13,758,936,0,0,0,0,0,0,80.98
彰化縣,二水鄉,文化村,581,1,735,8,743,957,0,0,0,0,0,0,77.64
彰化縣,二水鄉,二水村,582,1,701,8,709,877,0,0,0,0,0,0,80.84
彰化縣,二水鄉,聖化村,583,1,402,3,405,519,0,0,0,0,0,0,78.03
彰化縣,二水鄉,裕民村,584,1,648,7,655,867,0,0,0,0,0,0,75.55
彰化縣,二水鄉,惠民村,585,1,646,14,660,859,0,0,0,0,0,0,76.83
彰化縣,二水鄉,大園村,586,1,582,5,587,721,0,0,0,0,0,0,81.41
彰化縣,二水鄉,修仁村,587,1,632,10,642,815,0,0,0,0,0,0,78.77
彰化縣,二水鄉,合興村,588,1,625,8,633,792,0,0,0,0,0,0,79.92
彰化縣,二水鄉,源泉村,589,1,542,5,547,684,0,0,0,0,0,0,79.97
彰化縣,二水鄉,倡和村,590,1,496,9,505,628,0,0,0,0,0,0,80.41
彰化縣,北斗鎮,中寮里,591,1,810,12,822,1084,0,0,0,0,0,0,75.83
彰化縣,北斗鎮,中寮里,592,1,822,10,832,1090,0,0,0,0,0,0,76.33
彰化縣,北斗鎮,大道里,593,1,1239,15,1254,1604,0,0,0,0,0,0,78.18
彰化縣,北斗鎮,西德里,594,1,907,13,920,1173,0,0,0,0,0,0,78.43
彰化縣,北斗鎮,西德里,595,1,820,5,825,1068,0,0,0,0,0,0,77.25
彰化縣,北斗鎮,西德里,596,1,995,21,1016,1286,0,0,0,0,0,0,79.00
彰化縣,北斗鎮,西安里,597,1,1110,13,1123,1515,0,0,0,0,0,0,74.13
彰化縣,北斗鎮,光復里,598,1,957,10,967,1278,0,0,0,0,0,0,75.67
彰化縣,北斗鎮,新政里,599,1,630,10,640,817,0,0,0,0,0,0,78.34
彰化縣,北斗鎮,重慶里,600,1,486,7,493,646,0,0,0,0,0,0,76.32
彰化縣,北斗鎮,五權里,601,1,640,7,647,804,0,0,0,0,0,0,80.47
彰化縣,北斗鎮,七星里,602,1,987,18,1005,1369,0,0,0,0,0,0,73.41
彰化縣,北斗鎮,居仁里,603,1,1039,10,1049,1299,0,0,0,0,0,0,80.75
彰化縣,北斗鎮,東光里,604,1,1182,20,1202,1583,0,0,0,0,0,0,75.93
彰化縣,北斗鎮,文昌里,605,1,750,19,769,980,0,0,0,0,0,0,78.47
彰化縣,北斗鎮,文昌里,606,1,745,6,751,1000,0,0,0,0,0,0,75.10
彰化縣,北斗鎮,中和里,607,1,795,13,808,1058,0,0,0,0,0,0,76.37
彰化縣,北斗鎮,新生里,608,1,1189,32,1221,1579,0,0,0,0,0,0,77.33
彰化縣,北斗鎮,大新里,609,1,940,31,971,1343,0,0,0,0,0,0,72.30
彰化縣,溪州鄉,溪厝村,610,1,532,16,548,801,0,0,0,0,0,0,68.41
彰化縣,溪州鄉,溪厝村,611,1,616,15,631,927,0,0,0,0,0,0,68.07
彰化縣,溪州鄉,坑厝村,612,1,460,14,474,652,0,0,0,0,0,0,72.70
彰化縣,溪州鄉,瓦厝村,613,1,678,4,682,916,0,0,0,0,0,0,74.45
彰化縣,溪州鄉,溪州村,614,1,597,13,610,770,0,0,0,0,0,0,79.22
彰化縣,溪州鄉,溪州村,615,1,637,9,646,849,0,0,0,0,0,0,76.09
彰化縣,溪州鄉,尾厝村,616,1,978,24,1002,1283,0,0,0,0,0,0,78.10
彰化縣,溪州鄉,東州村,617,1,625,4,629,821,0,0,0,0,0,0,76.61
彰化縣,溪州鄉,東州村,618,1,665,10,675,897,0,0,0,0,0,0,75.25
彰化縣,溪州鄉,舊眉村,619,1,955,11,966,1223,0,0,0,0,0,0,78.99
彰化縣,溪州鄉,圳寮村,620,1,973,15,988,1375,0,0,0,0,0,0,71.85
彰化縣,溪州鄉,西畔村,621,1,774,12,786,1084,0,0,0,0,0,0,72.51
彰化縣,溪州鄉,西畔村,622,1,667,16,683,901,0,0,0,0,0,0,75.80
彰化縣,溪州鄉,成功村,623,1,655,18,673,900,0,0,0,0,0,0,74.78
彰化縣,溪州鄉,成功村,624,1,599,13,612,842,0,0,0,0,0,0,72.68
彰化縣,溪州鄉,大庄村,625,1,675,5,680,923,0,0,0,0,0,0,73.67
彰化縣,溪州鄉,大庄村,626,1,641,14,655,967,0,0,0,0,0,0,67.74
彰化縣,溪州鄉,榮光村,627,1,538,17,555,760,0,0,0,0,0,0,73.03
彰化縣,溪州鄉,柑園村,628,1,808,10,818,1080,0,0,0,0,0,0,75.74
彰化縣,溪州鄉,潮洋村,629,1,642,11,653,945,0,0,0,0,0,0,69.10
彰化縣,溪州鄉,張厝村,630,1,508,7,515,749,0,0,0,0,0,0,68.76
彰化縣,溪州鄉,菜公村,631,1,620,12,632,840,0,0,0,0,0,0,75.24
彰化縣,溪州鄉,三圳村,632,1,861,21,882,1163,0,0,0,0,0,0,75.84
彰化縣,溪州鄉,三條村,633,1,662,8,670,881,0,0,0,0,0,0,76.05
彰化縣,溪州鄉,水尾村,634,1,809,12,821,1171,0,0,0,0,0,0,70.11
彰化縣,田尾鄉,田尾村,635,1,896,12,908,1201,0,0,0,0,0,0,75.60
彰化縣,田尾鄉,豐田村,636,1,495,7,502,628,0,0,0,0,0,0,79.94
彰化縣,田尾鄉,饒平村,637,1,1271,26,1297,1691,0,0,0,0,0,0,76.70
彰化縣,田尾鄉,北曾村,638,1,841,14,855,1094,0,0,0,0,0,0,78.15
彰化縣,田尾鄉,南曾村,639,1,847,14,861,1087,0,0,0,0,0,0,79.21
彰化縣,田尾鄉,睦宜村,640,1,779,25,804,1012,0,0,0,0,0,0,79.45
彰化縣,田尾鄉,新生村,641,1,871,12,883,1120,0,0,0,0,0,0,78.84
彰化縣,田尾鄉,北鎮村,642,1,696,12,708,860,0,0,0,0,0,0,82.33
彰化縣,田尾鄉,南鎮村,643,1,519,16,535,648,0,0,0,0,0,0,82.56
彰化縣,田尾鄉,福田村,644,1,635,17,652,842,0,0,0,0,0,0,77.43
彰化縣,田尾鄉,新興村,645,1,810,12,822,981,0,0,0,0,0,0,83.79
彰化縣,田尾鄉,溪畔村,646,1,855,18,873,1168,0,0,0,0,0,0,74.74
彰化縣,田尾鄉,打簾村,647,1,1290,18,1308,1662,0,0,0,0,0,0,78.70
彰化縣,田尾鄉,柳鳳村,648,1,653,5,658,779,0,0,0,0,0,0,84.47
彰化縣,田尾鄉,陸豐村,649,1,647,5,652,839,0,0,0,0,0,0,77.71
彰化縣,田尾鄉,海豐村,650,1,1057,18,1075,1464,0,0,0,0,0,0,73.43
彰化縣,田尾鄉,仁里村,651,1,1130,18,1148,1474,0,0,0,0,0,0,77.88
彰化縣,田尾鄉,新厝村,652,1,253,2,255,315,0,0,0,0,0,0,80.95
彰化縣,田尾鄉,溪頂村,653,1,468,5,473,643,0,0,0,0,0,0,73.56
彰化縣,田尾鄉,正義村,654,1,500,8,508,651,0,0,0,0,0,0,78.03
彰化縣,埤頭鄉,和豐村,655,1,701,14,715,943,0,0,0,0,0,0,75.82
彰化縣,埤頭鄉,和豐村,656,1,921,34,955,1226,0,0,0,0,0,0,77.90
彰化縣,埤頭鄉,興農村,657,1,1061,34,1095,1442,0,0,0,0,0,0,75.94
彰化縣,埤頭鄉,埤頭村,658,1,1157,27,1184,1518,0,0,0,0,0,0,78.00
彰化縣,埤頭鄉,豐崙村,659,1,717,12,729,945,0,0,0,0,0,0,77.14
彰化縣,埤頭鄉,豐崙村,660,1,827,11,838,1078,0,0,0,0,0,0,77.74
彰化縣,埤頭鄉,崙子村,661,1,802,8,810,1085,0,0,0,0,0,0,74.65
彰化縣,埤頭鄉,永豐村,662,1,1077,22,1099,1443,0,0,0,0,0,0,76.16
彰化縣,埤頭鄉,合興村,663,1,1075,18,1093,1360,0,0,0,0,0,0,80.37
彰化縣,埤頭鄉,合興村,664,1,1105,25,1130,1461,0,0,0,0,0,0,77.34
彰化縣,埤頭鄉,平原村,665,1,1153,25,1178,1557,0,0,0,0,0,0,75.66
彰化縣,埤頭鄉,崙腳村,666,1,488,7,495,662,0,0,0,0,0,0,74.77
彰化縣,埤頭鄉,元埔村,667,1,463,7,470,601,0,0,0,0,0,0,78.20
彰化縣,埤頭鄉,芙朝村,668,1,1171,19,1190,1566,0,0,0,0,0,0,75.99
彰化縣,埤頭鄉,新庄村,669,1,844,19,863,1173,0,0,0,0,0,0,73.57
彰化縣,埤頭鄉,陸嘉村,670,1,613,7,620,829,0,0,0,0,0,0,74.79
彰化縣,埤頭鄉,竹圍村,671,1,580,10,590,788,0,0,0,0,0,0,74.87
彰化縣,埤頭鄉,中和村,672,1,891,19,910,1230,0,0,0,0,0,0,73.98
彰化縣,埤頭鄉,庄內村,673,1,638,14,652,927,0,0,0,0,0,0,70.33
彰化縣,埤頭鄉,大湖村,674,1,702,19,721,961,0,0,0,0,0,0,75.03
彰化縣,二林鎮,東和里,675,1,626,5,631,789,0,0,0,0,0,0,79.97
彰化縣,二林鎮,東和里,676,1,872,13,885,1203,0,0,0,0,0,0,73.57
彰化縣,二林鎮,南光里,677,1,839,16,855,1108,0,0,0,0,0,0,77.17
彰化縣,二林鎮,南光里,678,1,1137,15,1152,1502,0,0,0,0,0,0,76.70
彰化縣,二林鎮,西平里,679,1,1001,19,1020,1327,0,0,0,0,0,0,76.87
彰化縣,二林鎮,北平里,680,1,746,10,756,1022,0,0,0,0,0,0,73.97
彰化縣,二林鎮,北平里,681,1,978,19,997,1306,0,0,0,0,0,0,76.34
彰化縣,二林鎮,中西里,682,1,1188,12,1200,1607,0,0,0,0,0,0,74.67
彰化縣,二林鎮,廣興里,683,1,1043,12,1055,1461,0,0,0,0,0,0,72.21
彰化縣,二林鎮,香田里,684,1,855,15,870,1218,0,0,0,0,0,0,71.43
彰化縣,二林鎮,外竹里,685,1,861,14,875,1095,0,0,0,0,0,0,79.91
彰化縣,二林鎮,興華里,686,1,851,16,867,1057,0,0,0,0,0,0,82.02
彰化縣,二林鎮,東興里,687,1,879,10,889,1181,0,0,0,0,0,0,75.28
彰化縣,二林鎮,後厝里,688,1,836,19,855,1138,0,0,0,0,0,0,75.13
彰化縣,二林鎮,後厝里,689,1,809,10,819,1017,0,0,0,0,0,0,80.53
彰化縣,二林鎮,豐田里,690,1,504,14,518,728,0,0,0,0,0,0,71.15
彰化縣,二林鎮,豐田里,691,1,982,18,1000,1367,0,0,0,0,0,0,73.15
彰化縣,二林鎮,頂厝里,692,1,945,13,958,1293,0,0,0,0,0,0,74.09
彰化縣,二林鎮,趙甲里,693,1,1251,27,1278,1621,0,0,0,0,0,0,78.84
彰化縣,二林鎮,振興里,694,1,1012,11,1023,1253,0,0,0,0,0,0,81.64
彰化縣,二林鎮,萬興里,695,1,609,10,619,769,0,0,0,0,0,0,80.49
彰化縣,二林鎮,永興里,696,1,1150,14,1164,1439,0,0,0,0,0,0,80.89
彰化縣,二林鎮,西庄里,697,1,868,8,876,1119,0,0,0,0,0,0,78.28
彰化縣,二林鎮,梅芳里,698,1,796,19,815,1043,0,0,0,0,0,0,78.14
彰化縣,二林鎮,華崙里,699,1,882,19,901,1126,0,0,0,0,0,0,80.02
彰化縣,二林鎮,華崙里,700,1,801,18,819,1043,0,0,0,0,0,0,78.52
彰化縣,二林鎮,華崙里,701,1,962,17,979,1217,0,0,0,0,0,0,80.44
彰化縣,二林鎮,萬合里,702,1,998,8,1006,1349,0,0,0,0,0,0,74.57
彰化縣,二林鎮,東勢里,703,1,748,15,763,992,0,0,0,0,0,0,76.92
彰化縣,二林鎮,大永里,704,1,676,6,682,876,0,0,0,0,0,0,77.85
彰化縣,二林鎮,原斗里,705,1,850,7,857,1146,0,0,0,0,0,0,74.78
彰化縣,二林鎮,西斗里,706,1,766,10,776,999,0,0,0,0,0,0,77.68
彰化縣,二林鎮,東華里,707,1,782,8,790,1002,0,0,0,0,0,0,78.84
彰化縣,二林鎮,復豐里,708,1,624,7,631,781,0,0,0,0,0,0,80.79
彰化縣,芳苑鄉,芳苑村,709,1,695,11,706,1112,0,0,0,0,0,0,63.49
彰化縣,芳苑鄉,芳中村,710,1,360,1,361,545,0,0,0,0,0,0,66.24
彰化縣,芳苑鄉,仁愛村,711,1,601,12,613,941,0,0,0,0,0,0,65.14
彰化縣,芳苑鄉,信義村,712,1,425,7,432,703,0,0,0,0,0,0,61.45
彰化縣,芳苑鄉,後寮村,713,1,672,7,679,938,0,0,0,0,0,0,72.39
彰化縣,芳苑鄉,三合村,714,1,1318,15,1333,1720,0,0,0,0,0,0,77.50
彰化縣,芳苑鄉,永興村,715,1,994,13,1007,1427,0,0,0,0,0,0,70.57
彰化縣,芳苑鄉,新街村,716,1,666,8,674,1123,0,0,0,0,0,0,60.02
彰化縣,芳苑鄉,路上村,717,1,516,7,523,784,0,0,0,0,0,0,66.71
彰化縣,芳苑鄉,路平村,718,1,620,12,632,810,0,0,0,0,0,0,78.02
彰化縣,芳苑鄉,三成村,719,1,756,11,767,999,0,0,0,0,0,0,76.78
彰化縣,芳苑鄉,福榮村,720,1,503,2,505,712,0,0,0,0,0,0,70.93
彰化縣,芳苑鄉,頂部村,721,1,468,3,471,683,0,0,0,0,0,0,68.96
彰化縣,芳苑鄉,王功村,722,1,782,11,793,1129,0,0,0,0,0,0,70.24
彰化縣,芳苑鄉,王功村,723,1,611,12,623,886,0,0,0,0,0,0,70.32
彰化縣,芳苑鄉,博愛村,724,1,588,5,593,805,0,0,0,0,0,0,73.66
彰化縣,芳苑鄉,和平村,725,1,523,11,534,816,0,0,0,0,0,0,65.44
彰化縣,芳苑鄉,興仁村,726,1,916,11,927,1344,0,0,0,0,0,0,68.97
彰化縣,芳苑鄉,民生村,727,1,531,4,535,782,0,0,0,0,0,0,68.41
彰化縣,芳苑鄉,新寶村,728,1,1023,14,1037,1327,0,0,0,0,0,0,78.15
彰化縣,芳苑鄉,五俊村,729,1,387,5,392,622,0,0,0,0,0,0,63.02
彰化縣,芳苑鄉,草湖村,730,1,1010,17,1027,1339,0,0,0,0,0,0,76.70
彰化縣,芳苑鄉,建平村,731,1,742,15,757,998,0,0,0,0,0,0,75.85
彰化縣,芳苑鄉,建平村,732,1,746,21,767,1015,0,0,0,0,0,0,75.57
彰化縣,芳苑鄉,崙腳村,733,1,575,6,581,749,0,0,0,0,0,0,77.57
彰化縣,芳苑鄉,文津村,734,1,743,9,752,991,0,0,0,0,0,0,75.88
彰化縣,芳苑鄉,新生村,735,1,934,17,951,1326,0,0,0,0,0,0,71.72
彰化縣,芳苑鄉,漢寶村,736,1,1035,21,1056,1395,0,0,0,0,0,0,75.70
彰化縣,芳苑鄉,漢寶村,737,1,894,13,907,1248,0,0,0,0,0,0,72.68
彰化縣,大城鄉,潭墘村,738,1,951,13,964,1438,0,0,0,0,0,0,67.04
彰化縣,大城鄉,山腳村,739,1,943,18,961,1427,0,0,0,0,0,0,67.34
彰化縣,大城鄉,西城村,740,1,636,7,643,901,0,0,0,0,0,0,71.37
彰化縣,大城鄉,東城村,741,1,898,11,909,1247,0,0,0,0,0,0,72.89
彰化縣,大城鄉,大城村,742,1,751,7,758,1075,0,0,0,0,0,0,70.51
彰化縣,大城鄉,上山村,743,1,434,1,435,650,0,0,0,0,0,0,66.92
彰化縣,大城鄉,上山村,744,1,394,13,407,552,0,0,0,0,0,0,73.73
彰化縣,大城鄉,永和村,745,1,516,7,523,773,0,0,0,0,0,0,67.66
彰化縣,大城鄉,公館村,746,1,349,1,350,507,0,0,0,0,0,0,69.03
彰化縣,大城鄉,公館村,747,1,526,1,527,782,0,0,0,0,0,0,67.39
彰化縣,大城鄉,豐美村,748,1,627,10,637,884,0,0,0,0,0,0,72.06
彰化縣,大城鄉,三豐村,749,1,481,8,489,788,0,0,0,0,0,0,62.06
彰化縣,大城鄉,菜寮村,750,1,887,21,908,1191,0,0,0,0,0,0,76.24
彰化縣,大城鄉,東港村,751,1,884,13,897,1327,0,0,0,0,0,0,67.60
彰化縣,大城鄉,西港村,752,1,695,7,702,1093,0,0,0,0,0,0,64.23
彰化縣,大城鄉,頂庄村,753,1,574,5,579,846,0,0,0,0,0,0,68.44
彰化縣,大城鄉,台西村,754,1,667,8,675,1049,0,0,0,0,0,0,64.35
彰化縣,竹塘鄉,竹元村,755,1,790,12,802,1050,0,0,0,0,0,0,76.38
彰化縣,竹塘鄉,竹塘村,756,1,1282,10,1292,1589,0,0,0,0,0,0,81.31
彰化縣,竹塘鄉,小西村,757,1,633,2,635,824,0,0,0,0,0,0,77.06
彰化縣,竹塘鄉,民靖村,758,1,584,6,590,778,0,0,0,0,0,0,75.84
彰化縣,竹塘鄉,五庄村,759,1,1095,23,1118,1477,0,0,0,0,0,0,75.69
彰化縣,竹塘鄉,樹腳村,760,1,461,6,467,630,0,0,0,0,0,0,74.13
彰化縣,竹塘鄉,田頭村,761,1,707,9,716,937,0,0,0,0,0,0,76.41
彰化縣,竹塘鄉,新廣村,762,1,904,11,915,1211,0,0,0,0,0,0,75.56
彰化縣,竹塘鄉,溪墘村,763,1,395,3,398,567,0,0,0,0,0,0,70.19
彰化縣,竹塘鄉,竹林村,764,1,634,5,639,882,0,0,0,0,0,0,72.45
彰化縣,竹塘鄉,土庫村,765,1,539,6,545,720,0,0,0,0,0,0,75.69
彰化縣,竹塘鄉,內新村,766,1,472,2,474,668,0,0,0,0,0,0,70.96
彰化縣,竹塘鄉,長安村,767,1,567,4,571,759,0,0,0,0,0,0,75.23
彰化縣,竹塘鄉,永安村,768,1,505,7,512,732,0,0,0,0,0,0,69.95
南投縣,南投市,龍泉里,1,1,589,2,591,949,0,0,0,0,0,0,62.28
南投縣,南投市,康壽里,2,1,891,6,897,1359,0,0,0,0,0,0,66.00
南投縣,南投市,三民里,3,1,499,1,500,703,0,0,0,0,0,0,71.12
南投縣,南投市,仁和里,4,1,386,2,388,545,0,0,0,0,0,0,71.19
南投縣,南投市,南投里,5,1,535,4,539,737,0,0,0,0,0,0,73.13
南投縣,南投市,彰仁里,6,1,295,1,296,432,0,0,0,0,0,0,68.52
南投縣,南投市,崇文里,7,1,696,5,701,1022,0,0,0,0,0,0,68.59
南投縣,南投市,三興里,8,1,674,5,679,1082,0,0,0,0,0,0,62.75
南投縣,南投市,三興里,9,1,862,6,868,1415,0,0,0,0,0,0,61.34
南投縣,南投市,三興里,10,1,825,6,831,1329,0,0,0,0,0,0,62.53
南投縣,南投市,三和里,11,1,884,6,890,1302,0,0,0,0,0,0,68.36
南投縣,南投市,三和里,12,1,987,7,994,1465,0,0,0,0,0,0,67.85
南投縣,南投市,嘉興里,13,1,1136,9,1145,1616,0,0,0,0,0,0,70.85
南投縣,南投市,嘉和里,14,1,1099,16,1115,1501,0,0,0,0,0,0,74.28
南投縣,南投市,嘉和里,15,1,684,7,691,983,0,0,0,0,0,0,70.30
南投縣,南投市,平和里,16,1,781,2,783,1238,0,0,0,0,0,0,63.25
南投縣,南投市,平和里,17,1,877,13,890,1307,0,0,0,0,0,0,68.09
南投縣,南投市,平和里,18,1,902,4,906,1285,0,0,0,0,0,0,70.51
南投縣,南投市,平和里,19,1,748,6,754,1194,0,0,0,0,0,0,63.15
南投縣,南投市,振興里,20,1,359,1,360,552,0,0,0,0,0,0,65.22
南投縣,南投市,振興里,21,1,981,6,987,1387,0,0,0,0,0,0,71.16
南投縣,南投市,千秋里,22,1,561,7,568,799,0,0,0,0,0,0,71.09
南投縣,南投市,軍功里,23,1,1129,21,1150,1663,0,0,0,0,0,0,69.15
南投縣,南投市,軍功里,24,1,1018,12,1030,1605,0,0,0,0,0,0,64.17
南投縣,南投市,軍功里,25,1,248,4,252,326,0,0,0,0,0,0,77.30
南投縣,南投市,東山里,26,1,298,1,299,464,0,0,0,0,0,0,64.44
南投縣,南投市,營南里,27,1,670,8,678,981,0,0,0,0,0,0,69.11
南投縣,南投市,營南里,28,1,632,4,636,870,0,0,0,0,0,0,73.10
南投縣,南投市,營北里,29,1,1024,9,1033,1504,0,0,0,0,0,0,68.68
南投縣,南投市,營北里,30,1,952,8,960,1419,0,0,0,0,0,0,67.65
南投縣,南投市,營北里,31,1,913,13,926,1369,0,0,0,0,0,0,67.64
南投縣,南投市,內興里,32,1,889,14,903,1159,0,0,0,0,0,0,77.91
南投縣,南投市,內興里,33,1,849,11,860,1271,0,0,0,0,0,0,67.66
南投縣,南投市,內興里,34,1,866,9,875,1406,0,0,0,0,0,0,62.23
南投縣,南投市,內興里,35,1,368,2,370,502,0,0,0,0,0,0,73.71
南投縣,南投市,內新里,36,1,1001,10,1011,1250,0,0,0,0,0,0,80.88
南投縣,南投市,光輝里,37,1,391,3,394,576,0,0,0,0,0,0,68.40
南投縣,南投市,光榮里,38,1,511,4,515,804,0,0,0,0,0,0,64.05
南投縣,南投市,光榮里,39,1,707,12,719,1120,0,0,0,0,0,0,64.20
南投縣,南投市,光明里,40,1,685,13,698,1003,0,0,0,0,0,0,69.59
南投縣,南投市,光明里,41,1,730,8,738,1096,0,0,0,0,0,0,67.34
南投縣,南投市,光華里,42,1,504,4,508,765,0,0,0,0,0,0,66.41
南投縣,南投市,光華里,43,1,613,8,621,867,0,0,0,0,0,0,71.63
南投縣,南投市,漳興里,44,1,707,8,715,1108,0,0,0,0,0,0,64.53
南投縣,南投市,漳興里,45,1,753,5,758,1109,0,0,0,0,0,0,68.35
南投縣,南投市,漳和里,46,1,721,4,725,1066,0,0,0,0,0,0,68.01
南投縣,南投市,漳和里,47,1,860,2,862,1289,0,0,0,0,0,0,66.87
南投縣,南投市,漳和里,48,1,826,8,834,1211,0,0,0,0,0,0,68.87
南投縣,南投市,漳和里,49,1,1091,8,1099,1667,0,0,0,0,0,0,65.93
南投縣,南投市,平山里,50,1,958,20,978,1366,0,0,0,0,0,0,71.60
南投縣,南投市,平山里,51,1,868,6,874,1195,0,0,0,0,0,0,73.14
南投縣,南投市,平山里,52,1,661,6,667,980,0,0,0,0,0,0,68.06
南投縣,南投市,新興里,53,1,939,8,947,1389,0,0,0,0,0,0,68.18
南投縣,南投市,新興里,54,1,1132,9,1141,1577,0,0,0,0,0,0,72.35
南投縣,南投市,永豐里,55,1,735,10,745,1101,0,0,0,0,0,0,67.67
南投縣,南投市,永豐里,56,1,611,10,621,1085,0,0,0,0,0,0,57.24
南投縣,南投市,福興里,57,1,944,11,955,1278,0,0,0,0,0,0,74.73
南投縣,南投市,福興里,58,1,741,7,748,1125,0,0,0,0,0,0,66.49
南投縣,南投市,鳳山里,59,1,819,8,827,1236,0,0,0,0,0,0,66.91
南投縣,南投市,永興里,60,1,565,5,570,738,0,0,0,0,0,0,77.24
南投縣,南投市,鳳鳴里,61,1,567,1,568,769,0,0,0,0,0,0,73.86
南投縣,南投市,福山里,62,1,1222,10,1232,1620,0,0,0,0,0,0,76.05
南投縣,埔里鎮,東門里,63,1,590,8,598,942,0,0,0,0,0,0,63.48
南投縣,埔里鎮,東門里,64,1,704,6,710,1100,0,0,0,0,0,0,64.55
南投縣,埔里鎮,東門里,65,1,626,8,634,935,0,0,0,0,0,0,67.81
南投縣,埔里鎮,西門里,66,1,597,5,602,999,0,0,0,0,0,0,60.26
南投縣,埔里鎮,西門里,67,1,638,3,641,1100,0,0,0,0,0,0,58.27
南投縣,埔里鎮,西門里,68,1,647,4,651,1016,0,0,0,0,0,0,64.07
南投縣,埔里鎮,南門里,69,1,652,5,657,1021,0,0,0,0,0,0,64.35
南投縣,埔里鎮,北門里,70,1,771,7,778,1207,0,0,0,0,0,0,64.46
南投縣,埔里鎮,北門里,71,1,683,7,690,1117,0,0,0,0,0,0,61.77
南投縣,埔里鎮,北安里,72,1,967,9,976,1544,0,0,0,0,0,0,63.21
南投縣,埔里鎮,北安里,73,1,923,8,931,1450,0,0,0,0,0,0,64.21
南投縣,埔里鎮,泰安里,74,1,573,9,582,866,0,0,0,0,0,0,67.21
南投縣,埔里鎮,泰安里,75,1,665,7,672,1022,0,0,0,0,0,0,65.75
南投縣,埔里鎮,北梅里,76,1,647,2,649,1037,0,0,0,0,0,0,62.58
南投縣,埔里鎮,北梅里,77,1,617,4,621,1039,0,0,0,0,0,0,59.77
南投縣,埔里鎮,同聲里,78,1,734,15,749,1080,0,0,0,0,0,0,69.35
南投縣,埔里鎮,同聲里,79,1,710,11,721,1067,0,0,0,0,0,0,67.57
南投縣,埔里鎮,清新里,80,1,665,7,672,1059,0,0,0,0,0,0,63.46
南投縣,埔里鎮,清新里,81,1,623,1,624,1017,0,0,0,0,0,0,61.36
南投縣,埔里鎮,清新里,82,1,815,8,823,1366,0,0,0,0,0,0,60.25
南投縣,埔里鎮,薰化里,83,1,903,9,912,1313,0,0,0,0,0,0,69.46
南投縣,埔里鎮,大城里,84,1,814,9,823,1366,0,0,0,0,0,0,60.25
南投縣,埔里鎮,大城里,85,1,793,13,806,1209,0,0,0,0,0,0,66.67
南投縣,埔里鎮,大城里,86,1,773,5,778,1232,0,0,0,0,0,0,63.15
南投縣,埔里鎮,大城里,87,1,865,7,872,1468,0,0,0,0,0,0,59.40
南投縣,埔里鎮,籃城里,88,1,545,3,548,753,0,0,0,0,0,0,72.78
南投縣,埔里鎮,杷城里,89,1,698,6,704,1048,0,0,0,0,0,0,67.18
南投縣,埔里鎮,杷城里,90,1,737,3,740,1146,0,0,0,0,0,0,64.57
南投縣,埔里鎮,枇杷里,91,1,852,10,862,1312,0,0,0,0,0,0,65.70
南投縣,埔里鎮,枇杷里,92,1,424,11,435,673,0,0,0,0,0,0,64.64
南投縣,埔里鎮,枇杷里,93,1,732,14,746,1163,0,0,0,0,0,0,64.14
南投縣,埔里鎮,枇杷里,94,1,596,12,608,947,0,0,0,0,0,0,64.20
南投縣,埔里鎮,枇杷里,95,1,575,7,582,959,0,0,0,0,0,0,60.69
南投縣,埔里鎮,水頭里,96,1,985,12,997,1657,0,0,0,0,0,0,60.17
南投縣,埔里鎮,水頭里,97,1,658,13,671,1040,0,0,0,0,0,0,64.52
南投縣,埔里鎮,麒麟里,98,1,621,6,627,927,0,0,0,0,0,0,67.64
南投縣,埔里鎮,珠格里,99,1,639,11,650,920,0,0,0,0,0,0,70.65
南投縣,埔里鎮,溪南里,100,1,451,9,460,698,0,0,0,0,0,0,65.90
南投縣,埔里鎮,桃米里,101,1,577,6,583,932,0,0,0,0,0,0,62.55
南投縣,埔里鎮,成功里,102,1,201,2,203,358,0,0,0,0,0,0,56.70
南投縣,埔里鎮,南村里,103,1,782,7,789,1297,0,0,0,0,0,0,60.83
南投縣,埔里鎮,愛蘭里,104,1,790,9,799,1259,0,0,0,0,0,0,63.46
南投縣,埔里鎮,鐵山里,105,1,921,5,926,1466,0,0,0,0,0,0,63.17
南投縣,埔里鎮,房里里,106,1,543,11,554,858,0,0,0,0,0,0,64.57
南投縣,埔里鎮,房里里,107,1,199,2,201,322,0,0,0,0,0,0,62.42
南投縣,埔里鎮,向善里,108,1,468,6,474,667,0,0,0,0,0,0,71.06
南投縣,埔里鎮,一新里,109,1,662,9,671,998,0,0,0,0,0,0,67.23
南投縣,埔里鎮,合成里,110,1,840,1,841,1233,0,0,0,0,0,0,68.21
南投縣,埔里鎮,合成里,111,1,151,0,151,262,0,0,0,0,0,0,57.63
南投縣,埔里鎮,廣成里,112,1,676,6,682,1090,0,0,0,0,0,0,62.57
南投縣,埔里鎮,史港里,113,1,400,2,402,620,0,0,0,0,0,0,64.84
南投縣,埔里鎮,福興里,114,1,610,6,616,945,0,0,0,0,0,0,65.19
南投縣,埔里鎮,牛眠里,115,1,695,11,706,1052,0,0,0,0,0,0,67.11
南投縣,埔里鎮,牛眠里,116,1,878,10,888,1305,0,0,0,0,0,0,68.05
南投縣,埔里鎮,大湳里,117,1,756,7,763,1116,0,0,0,0,0,0,68.37
南投縣,埔里鎮,蜈蚣里,118,1,599,6,605,942,0,0,0,0,0,0,64.23
南投縣,埔里鎮,蜈蚣里,119,1,578,2,580,893,0,0,0,0,0,0,64.95
南投縣,埔里鎮,蜈蚣里,120,1,368,3,371,576,0,0,0,0,0,0,64.41
南投縣,草屯鎮,玉峰里,121,1,553,11,564,837,0,0,0,0,0,0,67.38
南投縣,草屯鎮,玉峰里,122,1,673,12,685,954,0,0,0,0,0,0,71.80
南投縣,草屯鎮,明正里,123,1,946,13,959,1462,0,0,0,0,0,0,65.60
南投縣,草屯鎮,明正里,124,1,993,9,1002,1601,0,0,0,0,0,0,62.59
南投縣,草屯鎮,炎峰里,125,1,642,6,648,937,0,0,0,0,0,0,69.16
南投縣,草屯鎮,炎峰里,126,1,681,10,691,1052,0,0,0,0,0,0,65.68
南投縣,草屯鎮,中正里,127,1,545,3,548,721,0,0,0,0,0,0,76.01
南投縣,草屯鎮,和平里,128,1,957,7,964,1372,0,0,0,0,0,0,70.26
南投縣,草屯鎮,中山里,129,1,632,5,637,974,0,0,0,0,0,0,65.40
南投縣,草屯鎮,中山里,130,1,850,16,866,1253,0,0,0,0,0,0,69.11
南投縣,草屯鎮,敦和里,131,1,733,6,739,1120,0,0,0,0,0,0,65.98
南投縣,草屯鎮,敦和里,132,1,716,11,727,1187,0,0,0,0,0,0,61.25
南投縣,草屯鎮,敦和里,133,1,783,6,789,1231,0,0,0,0,0,0,64.09
南投縣,草屯鎮,敦和里,134,1,837,13,850,1310,0,0,0,0,0,0,64.89
南投縣,草屯鎮,山腳里,135,1,1004,13,1017,1439,0,0,0,0,0,0,70.67
南投縣,草屯鎮,山腳里,136,1,894,9,903,1332,0,0,0,0,0,0,67.79
南投縣,草屯鎮,山腳里,137,1,801,9,810,1201,0,0,0,0,0,0,67.44
南投縣,草屯鎮,山腳里,138,1,918,14,932,1354,0,0,0,0,0,0,68.83
南投縣,草屯鎮,新厝里,139,1,931,13,944,1357,0,0,0,0,0,0,69.57
南投縣,草屯鎮,新厝里,140,1,855,11,866,1328,0,0,0,0,0,0,65.21
南投縣,草屯鎮,上林里,141,1,914,15,929,1264,0,0,0,0,0,0,73.50
南投縣,草屯鎮,上林里,142,1,653,10,663,899,0,0,0,0,0,0,73.75
南投縣,草屯鎮,碧峰里,143,1,699,15,714,1062,0,0,0,0,0,0,67.23
南投縣,草屯鎮,碧峰里,144,1,707,9,716,1085,0,0,0,0,0,0,65.99
南投縣,草屯鎮,碧峰里,145,1,459,4,463,776,0,0,0,0,0,0,59.66
南投縣,草屯鎮,碧洲里,146,1,671,8,679,908,0,0,0,0,0,0,74.78
南投縣,草屯鎮,碧洲里,147,1,393,1,394,588,0,0,0,0,0,0,67.01
南投縣,草屯鎮,復興里,148,1,877,8,885,1298,0,0,0,0,0,0,68.18
南投縣,草屯鎮,復興里,149,1,934,11,945,1353,0,0,0,0,0,0,69.84
南投縣,草屯鎮,御史里,150,1,1038,8,1046,1522,0,0,0,0,0,0,68.73
南投縣,草屯鎮,御史里,151,1,732,9,741,1175,0,0,0,0,0,0,63.06
南投縣,草屯鎮,御史里,152,1,510,7,517,837,0,0,0,0,0,0,61.77
南投縣,草屯鎮,御史里,153,1,710,8,718,1089,0,0,0,0,0,0,65.93
南投縣,草屯鎮,新豐里,154,1,990,8,998,1465,0,0,0,0,0,0,68.12
南投縣,草屯鎮,新豐里,155,1,1074,13,1087,1695,0,0,0,0,0,0,64.13
南投縣,草屯鎮,新庄里,156,1,899,13,912,1273,0,0,0,0,0,0,71.64
南投縣,草屯鎮,新庄里,157,1,917,12,929,1325,0,0,0,0,0,0,70.11
南投縣,草屯鎮,加老里,158,1,448,5,453,633,0,0,0,0,0,0,71.56
南投縣,草屯鎮,加老里,159,1,804,6,810,1136,0,0,0,0,0,0,71.30
南投縣,草屯鎮,石川里,160,1,798,7,805,1096,0,0,0,0,0,0,73.45
南投縣,草屯鎮,北投里,161,1,770,3,773,1055,0,0,0,0,0,0,73.27
南投縣,草屯鎮,北投里,162,1,740,8,748,1090,0,0,0,0,0,0,68.62
南投縣,草屯鎮,富寮里,163,1,961,11,972,1566,0,0,0,0,0,0,62.07
南投縣,草屯鎮,富寮里,164,1,837,10,847,1161,0,0,0,0,0,0,72.95
南投縣,草屯鎮,富寮里,165,1,349,5,354,525,0,0,0,0,0,0,67.43
南投縣,草屯鎮,富寮里,166,1,539,7,546,811,0,0,0,0,0,0,67.32
南投縣,草屯鎮,北勢里,167,1,904,7,911,1310,0,0,0,0,0,0,69.54
南投縣,草屯鎮,北勢里,168,1,332,1,333,481,0,0,0,0,0,0,69.23
南投縣,草屯鎮,中原里,169,1,688,8,696,938,0,0,0,0,0,0,74.20
南投縣,草屯鎮,中原里,170,1,524,4,528,779,0,0,0,0,0,0,67.78
南投縣,草屯鎮,南埔里,171,1,829,13,842,1231,0,0,0,0,0,0,68.40
南投縣,草屯鎮,南埔里,172,1,585,8,593,908,0,0,0,0,0,0,65.31
南投縣,草屯鎮,南埔里,173,1,558,7,565,782,0,0,0,0,0,0,72.25
南投縣,草屯鎮,坪頂里,174,1,658,6,664,937,0,0,0,0,0,0,70.86
南投縣,草屯鎮,土城里,175,1,419,6,425,637,0,0,0,0,0,0,66.72
南投縣,草屯鎮,土城里,176,1,606,7,613,931,0,0,0,0,0,0,65.84
南投縣,草屯鎮,平林里,177,1,739,6,745,966,0,0,0,0,0,0,77.12
南投縣,草屯鎮,雙冬里,178,1,717,8,725,1120,0,0,0,0,0,0,64.73
南投縣,草屯鎮,雙冬里,179,1,800,6,806,1172,0,0,0,0,0,0,68.77
南投縣,竹山鎮,竹山里,180,1,879,6,885,1275,0,0,0,0,0,0,69.41
南投縣,竹山鎮,竹山里,181,1,687,9,696,965,0,0,0,0,0,0,72.12
南投縣,竹山鎮,中正里,182,1,554,8,562,749,0,0,0,0,0,0,75.03
南投縣,竹山鎮,中山里,183,1,776,10,786,1121,0,0,0,0,0,0,70.12
南投縣,竹山鎮,中山里,184,1,1013,8,1021,1506,0,0,0,0,0,0,67.80
南投縣,竹山鎮,中山里,185,1,1167,14,1181,1704,0,0,0,0,0,0,69.31
南投縣,竹山鎮,雲林里,186,1,1019,9,1028,1464,0,0,0,0,0,0,70.22
南投縣,竹山鎮,雲林里,187,1,1100,12,1112,1669,0,0,0,0,0,0,66.63
南投縣,竹山鎮,竹圍里,188,1,522,9,531,738,0,0,0,0,0,0,71.95
南投縣,竹山鎮,竹圍里,189,1,811,14,825,1261,0,0,0,0,0,0,65.42
南投縣,竹山鎮,桂林里,190,1,1097,7,1104,1673,0,0,0,0,0,0,65.99
南投縣,竹山鎮,桂林里,191,1,1111,13,1124,1600,0,0,0,0,0,0,70.25
南投縣,竹山鎮,下坪里,192,1,357,2,359,495,0,0,0,0,0,0,72.53
南投縣,竹山鎮,下坪里,193,1,313,7,320,476,0,0,0,0,0,0,67.23
南投縣,竹山鎮,中和里,194,1,647,6,653,956,0,0,0,0,0,0,68.31
南投縣,竹山鎮,中崎里,195,1,848,3,851,1206,0,0,0,0,0,0,70.56
南投縣,竹山鎮,秀林里,196,1,230,0,230,306,0,0,0,0,0,0,75.16
南投縣,竹山鎮,秀林里,197,1,351,0,351,505,0,0,0,0,0,0,69.50
南投縣,竹山鎮,大鞍里,198,1,133,0,133,182,0,0,0,0,0,0,73.08
南投縣,竹山鎮,延和里,199,1,887,8,895,1356,0,0,0,0,0,0,66.00
南投縣,竹山鎮,延和里,200,1,853,13,866,1307,0,0,0,0,0,0,66.26
南投縣,竹山鎮,延和里,201,1,805,9,814,1226,0,0,0,0,0,0,66.39
南投縣,竹山鎮,延祥里,202,1,993,11,1004,1624,0,0,0,0,0,0,61.82
南投縣,竹山鎮,延祥里,203,1,877,22,899,1382,0,0,0,0,0,0,65.05
南投縣,竹山鎮,延正里,204,1,477,5,482,657,0,0,0,0,0,0,73.36
南投縣,竹山鎮,延正里,205,1,645,7,652,954,0,0,0,0,0,0,68.34
南投縣,竹山鎮,延平里,206,1,817,7,824,1196,0,0,0,0,0,0,68.90
南投縣,竹山鎮,延平里,207,1,651,7,658,886,0,0,0,0,0,0,74.27
南投縣,竹山鎮,延平里,208,1,435,3,438,573,0,0,0,0,0,0,76.44
南投縣,竹山鎮,延山里,209,1,434,6,440,646,0,0,0,0,0,0,68.11
南投縣,竹山鎮,山崇里,210,1,817,8,825,1228,0,0,0,0,0,0,67.18
南投縣,竹山鎮,山崇里,211,1,457,8,465,696,0,0,0,0,0,0,66.81
南投縣,竹山鎮,社寮里,212,1,623,2,625,869,0,0,0,0,0,0,71.92
南投縣,竹山鎮,中央里,213,1,1042,7,1049,1413,0,0,0,0,0,0,74.24
南投縣,竹山鎮,富州里,214,1,497,3,500,719,0,0,0,0,0,0,69.54
南投縣,竹山鎮,田子里,215,1,293,6,299,442,0,0,0,0,0,0,67.65
南投縣,竹山鎮,田子里,216,1,139,0,139,204,0,0,0,0,0,0,68.14
南投縣,竹山鎮,回窯里,217,1,819,13,832,1239,0,0,0,0,0,0,67.15
南投縣,竹山鎮,德興里,218,1,274,4,278,399,0,0,0,0,0,0,69.67
南投縣,竹山鎮,德興里,219,1,368,2,370,504,0,0,0,0,0,0,73.41
南投縣,竹山鎮,福興里,220,1,151,0,151,211,0,0,0,0,0,0,71.56
南投縣,竹山鎮,福興里,221,1,277,2,279,366,0,0,0,0,0,0,76.23
南投縣,竹山鎮,鯉魚里,222,1,397,5,402,577,0,0,0,0,0,0,69.67
南投縣,竹山鎮,鯉魚里,223,1,243,2,245,366,0,0,0,0,0,0,66.94
南投縣,竹山鎮,坪頂里,224,1,428,3,431,616,0,0,0,0,0,0,69.97
南投縣,竹山鎮,瑞竹里,225,1,540,10,550,771,0,0,0,0,0,0,71.34
南投縣,竹山鎮,桶頭里,226,1,417,5,422,620,0,0,0,0,0,0,68.06
南投縣,竹山鎮,桶頭里,227,1,308,8,316,462,0,0,0,0,0,0,68.40
南投縣,集集鎮,集集里,228,1,608,4,612,879,0,0,0,0,0,0,69.62
南投縣,集集鎮,和平里,229,1,619,4,623,976,0,0,0,0,0,0,63.83
南投縣,集集鎮,林尾里,230,1,393,5,398,584,0,0,0,0,0,0,68.15
南投縣,集集鎮,田寮里,231,1,780,6,786,1091,0,0,0,0,0,0,72.04
南投縣,集集鎮,隘寮里,232,1,392,0,392,542,0,0,0,0,0,0,72.32
南投縣,集集鎮,玉映里,233,1,290,2,292,440,0,0,0,0,0,0,66.36
南投縣,集集鎮,吳厝里,234,1,659,5,664,917,0,0,0,0,0,0,72.41
南投縣,集集鎮,八張里,235,1,861,11,872,1290,0,0,0,0,0,0,67.60
南投縣,集集鎮,永昌里,236,1,588,3,591,872,0,0,0,0,0,0,67.78
南投縣,集集鎮,廣明里,237,1,410,6,416,594,0,0,0,0,0,0,70.03
南投縣,集集鎮,富山里,238,1,263,2,265,404,0,0,0,0,0,0,65.59
南投縣,集集鎮,富山里,239,1,291,1,292,433,0,0,0,0,0,0,67.44
南投縣,名間鄉,南雅村,240,1,671,8,679,1001,0,0,0,0,0,0,67.83
南投縣,名間鄉,中正村,241,1,771,6,777,1201,0,0,0,0,0,0,64.70
南投縣,名間鄉,中正村,242,1,994,10,1004,1513,0,0,0,0,0,0,66.36
南投縣,名間鄉,中山村,243,1,486,5,491,687,0,0,0,0,0,0,71.47
南投縣,名間鄉,中山村,244,1,837,7,844,1170,0,0,0,0,0,0,72.14
南投縣,名間鄉,濁水村,245,1,1022,6,1028,1548,0,0,0,0,0,0,66.41
南投縣,名間鄉,新民村,246,1,685,10,695,1015,0,0,0,0,0,0,68.47
南投縣,名間鄉,炭寮村,247,1,710,4,714,979,0,0,0,0,0,0,72.93
南投縣,名間鄉,新街村,248,1,1103,12,1115,1456,0,0,0,0,0,0,76.58
南投縣,名間鄉,新街村,249,1,601,8,609,872,0,0,0,0,0,0,69.84
南投縣,名間鄉,新街村,250,1,550,6,556,860,0,0,0,0,0,0,64.65
南投縣,名間鄉,東湖村,251,1,545,8,553,767,0,0,0,0,0,0,72.10
南投縣,名間鄉,東湖村,252,1,622,4,626,826,0,0,0,0,0,0,75.79
南投縣,名間鄉,仁和村,253,1,590,7,597,801,0,0,0,0,0,0,74.53
南投縣,名間鄉,萬丹村,254,1,799,14,813,1022,0,0,0,0,0,0,79.55
南投縣,名間鄉,田仔村,255,1,731,5,736,1001,0,0,0,0,0,0,73.53
南投縣,名間鄉,田仔村,256,1,597,7,604,854,0,0,0,0,0,0,70.73
南投縣,名間鄉,大庄村,257,1,781,9,790,1123,0,0,0,0,0,0,70.35
南投縣,名間鄉,大庄村,258,1,580,12,592,803,0,0,0,0,0,0,73.72
南投縣,名間鄉,部下村,259,1,508,6,514,748,0,0,0,0,0,0,68.72
南投縣,名間鄉,赤水村,260,1,503,6,509,691,0,0,0,0,0,0,73.66
南投縣,名間鄉,赤水村,261,1,376,1,377,565,0,0,0,0,0,0,66.73
南投縣,名間鄉,竹圍村,262,1,623,9,632,880,0,0,0,0,0,0,71.82
南投縣,名間鄉,三崙村,263,1,664,19,683,976,0,0,0,0,0,0,69.98
南投縣,名間鄉,三崙村,264,1,324,4,328,452,0,0,0,0,0,0,72.57
南投縣,名間鄉,松山村,265,1,863,10,873,1337,0,0,0,0,0,0,65.30
南投縣,名間鄉,松柏村,266,1,734,15,749,1027,0,0,0,0,0,0,72.93
南投縣,名間鄉,崁腳村,267,1,554,5,559,769,0,0,0,0,0,0,72.69
南投縣,名間鄉,埔中村,268,1,587,7,594,845,0,0,0,0,0,0,70.30
南投縣,名間鄉,新厝村,269,1,572,6,578,811,0,0,0,0,0,0,71.27
南投縣,名間鄉,新光村,270,1,498,4,502,745,0,0,0,0,0,0,67.38
南投縣,名間鄉,新光村,271,1,575,12,587,821,0,0,0,0,0,0,71.50
南投縣,鹿谷鄉,初鄉村,272,1,1000,13,1013,1497,0,0,0,0,0,0,67.67
南投縣,鹿谷鄉,鹿谷村,273,1,1121,11,1132,1637,0,0,0,0,0,0,69.15
南投縣,鹿谷鄉,彰雅村,274,1,534,5,539,718,0,0,0,0,0,0,75.07
南投縣,鹿谷鄉,彰雅村,275,1,286,1,287,400,0,0,0,0,0,0,71.75
南投縣,鹿谷鄉,廣興村,276,1,561,5,566,768,0,0,0,0,0,0,73.70
南投縣,鹿谷鄉,廣興村,277,1,719,2,721,987,0,0,0,0,0,0,73.05
南投縣,鹿谷鄉,內湖村,278,1,393,6,399,616,0,0,0,0,0,0,64.77
南投縣,鹿谷鄉,內湖村,279,1,312,0,312,438,0,0,0,0,0,0,71.23
南投縣,鹿谷鄉,和雅村,280,1,438,3,441,636,0,0,0,0,0,0,69.34
南投縣,鹿谷鄉,竹林村,281,1,1017,4,1021,1564,0,0,0,0,0,0,65.28
南投縣,鹿谷鄉,竹豐村,282,1,599,6,605,898,0,0,0,0,0,0,67.37
南投縣,鹿谷鄉,鳳凰村,283,1,97,1,98,116,0,0,0,0,0,0,84.48
南投縣,鹿谷鄉,鳳凰村,284,1,881,7,888,1190,0,0,0,0,0,0,74.62
南投縣,鹿谷鄉,永隆村,285,1,876,5,881,1235,0,0,0,0,0,0,71.34
南投縣,鹿谷鄉,秀峰村,286,1,272,2,274,457,0,0,0,0,0,0,59.96
南投縣,鹿谷鄉,秀峰村,287,1,410,2,412,684,0,0,0,0,0,0,60.23
南投縣,鹿谷鄉,清水村,288,1,443,7,450,753,0,0,0,0,0,0,59.76
南投縣,鹿谷鄉,瑞田村,289,1,440,4,444,804,0,0,0,0,0,0,55.22
南投縣,中寮鄉,廣興村,290,1,573,5,578,880,0,0,0,0,0,0,65.68
南投縣,中寮鄉,崁頂村,291,1,215,3,218,282,0,0,0,0,0,0,77.30
南投縣,中寮鄉,崁頂村,292,1,160,1,161,230,0,0,0,0,0,0,70.00
南投縣,中寮鄉,八仙村,293,1,269,0,269,390,0,0,0,0,0,0,68.97
南投縣,中寮鄉,八仙村,294,1,278,4,282,392,0,0,0,0,0,0,71.94
南投縣,中寮鄉,福盛村,295,1,310,0,310,474,0,0,0,0,0,0,65.40
南投縣,中寮鄉,福盛村,296,1,213,5,218,396,0,0,0,0,0,0,55.05
南投縣,中寮鄉,和興村,297,1,444,4,448,712,0,0,0,0,0,0,62.92
南投縣,中寮鄉,復興村,298,1,188,1,189,294,0,0,0,0,0,0,64.29
南投縣,中寮鄉,永平村,299,1,754,5,759,1021,0,0,0,0,0,0,74.34
南投縣,中寮鄉,永平村,300,1,619,5,624,847,0,0,0,0,0,0,73.67
南投縣,中寮鄉,中寮村,301,1,533,2,535,731,0,0,0,0,0,0,73.19
南投縣,中寮鄉,廣福村,302,1,390,0,390,550,0,0,0,0,0,0,70.91
南投縣,中寮鄉,永福村,303,1,258,1,259,365,0,0,0,0,0,0,70.96
南投縣,中寮鄉,永福村,304,1,431,2,433,647,0,0,0,0,0,0,66.92
南投縣,中寮鄉,義和村,305,1,380,4,384,470,0,0,0,0,0,0,81.70
南投縣,中寮鄉,義和村,306,1,456,4,460,644,0,0,0,0,0,0,71.43
南投縣,中寮鄉,清水村,307,1,638,8,646,991,0,0,0,0,0,0,65.19
南投縣,中寮鄉,內城村,308,1,344,3,347,472,0,0,0,0,0,0,73.52
南投縣,中寮鄉,龍安村,309,1,531,6,537,720,0,0,0,0,0,0,74.58
南投縣,中寮鄉,爽文村,310,1,399,3,402,601,0,0,0,0,0,0,66.89
南投縣,中寮鄉,龍岩村,311,1,464,5,469,683,0,0,0,0,0,0,68.67
南投縣,中寮鄉,永芳村,312,1,310,1,311,439,0,0,0,0,0,0,70.84
南投縣,中寮鄉,永和村,313,1,408,3,411,587,0,0,0,0,0,0,70.02
南投縣,魚池鄉,魚池村,314,1,1038,8,1046,1812,0,0,0,0,0,0,57.73
南投縣,魚池鄉,東池村,315,1,889,10,899,1519,0,0,0,0,0,0,59.18
南投縣,魚池鄉,大林村,316,1,280,2,282,495,0,0,0,0,0,0,56.97
南投縣,魚池鄉,大林村,317,1,341,4,345,528,0,0,0,0,0,0,65.34
南投縣,魚池鄉,東光村,318,1,677,10,687,1185,0,0,0,0,0,0,57.97
南投縣,魚池鄉,共和村,319,1,151,0,151,226,0,0,0,0,0,0,66.81
南投縣,魚池鄉,共和村,320,1,346,4,350,529,0,0,0,0,0,0,66.16
南投縣,魚池鄉,共和村,321,1,139,0,139,221,0,0,0,0,0,0,62.90
南投縣,魚池鄉,新城村,322,1,430,3,433,685,0,0,0,0,0,0,63.21
南投縣,魚池鄉,新城村,323,1,172,1,173,287,0,0,0,0,0,0,60.28
南投縣,魚池鄉,新城村,324,1,157,0,157,256,0,0,0,0,0,0,61.33
南投縣,魚池鄉,大雁村,325,1,169,0,169,250,0,0,0,0,0,0,67.60
南投縣,魚池鄉,大雁村,326,1,219,1,220,356,0,0,0,0,0,0,61.80
南投縣,魚池鄉,五城村,327,1,361,2,363,559,0,0,0,0,0,0,64.94
南投縣,魚池鄉,五城村,328,1,111,0,111,164,0,0,0,0,0,0,67.68
南投縣,魚池鄉,中明村,329,1,390,5,395,632,0,0,0,0,0,0,62.50
南投縣,魚池鄉,中明村,330,1,207,2,209,346,0,0,0,0,0,0,60.40
南投縣,魚池鄉,水社村,331,1,450,5,455,745,0,0,0,0,0,0,61.07
南投縣,魚池鄉,日月村,332,1,332,0,332,534,0,0,0,0,0,0,62.17
南投縣,魚池鄉,頭社村,333,1,231,0,231,431,0,0,0,0,0,0,53.60
南投縣,魚池鄉,頭社村,334,1,302,3,305,566,0,0,0,0,0,0,53.89
南投縣,魚池鄉,武登村,335,1,242,0,242,481,0,0,0,0,0,0,50.31
南投縣,魚池鄉,武登村,336,1,188,2,190,317,0,0,0,0,0,0,59.94
南投縣,國姓鄉,國姓村,337,1,1030,11,1041,1693,0,0,0,0,0,0,61.49
南投縣,國姓鄉,石門村,338,1,1002,5,1007,1635,0,0,0,0,0,0,61.59
南投縣,國姓鄉,大旗村,339,1,518,8,526,793,0,0,0,0,0,0,66.33
南投縣,國姓鄉,長流村,340,1,938,17,955,1552,0,0,0,0,0,0,61.53
南投縣,國姓鄉,長福村,341,1,493,5,498,772,0,0,0,0,0,0,64.51
南投縣,國姓鄉,長豐村,342,1,544,10,554,912,0,0,0,0,0,0,60.75
南投縣,國姓鄉,北港村,343,1,711,7,718,1173,0,0,0,0,0,0,61.21
南投縣,國姓鄉,北港村,344,1,526,6,532,940,0,0,0,0,0,0,56.60
南投縣,國姓鄉,福龜村,345,1,658,7,665,948,0,0,0,0,0,0,70.15
南投縣,國姓鄉,福龜村,346,1,693,9,702,988,0,0,0,0,0,0,71.05
南投縣,國姓鄉,乾溝村,347,1,621,6,627,915,0,0,0,0,0,0,68.52
南投縣,國姓鄉,柑林村,348,1,820,10,830,1206,0,0,0,0,0,0,68.82
南投縣,國姓鄉,大石村,349,1,505,3,508,784,0,0,0,0,0,0,64.80
南投縣,國姓鄉,北山村,350,1,743,12,755,1141,0,0,0,0,0,0,66.17
南投縣,國姓鄉,北山村,351,1,333,2,335,496,0,0,0,0,0,0,67.54
南投縣,國姓鄉,南港村,352,1,824,23,847,1472,0,0,0,0,0,0,57.54
南投縣,國姓鄉,南港村,353,1,333,8,341,560,0,0,0,0,0,0,60.89
南投縣,水里鄉,水里村,354,1,550,5,555,916,0,0,0,0,0,0,60.59
南投縣,水里鄉,新城村,355,1,370,4,374,589,0,0,0,0,0,0,63.50
南投縣,水里鄉,新城村,356,1,693,4,697,1104,0,0,0,0,0,0,63.13
南投縣,水里鄉,中央村,357,1,505,6,511,718,0,0,0,0,0,0,71.17
南投縣,水里鄉,城中村,358,1,674,8,682,1049,0,0,0,0,0,0,65.01
南投縣,水里鄉,農富村,359,1,356,2,358,531,0,0,0,0,0,0,67.42
南投縣,水里鄉,北埔村,360,1,683,5,688,1075,0,0,0,0,0,0,64.00
南投縣,水里鄉,南光村,361,1,772,7,779,1224,0,0,0,0,0,0,63.64
南投縣,水里鄉,鉅工村,362,1,727,5,732,1070,0,0,0,0,0,0,68.41
南投縣,水里鄉,永豐村,363,1,963,8,971,1329,0,0,0,0,0,0,73.06
南投縣,水里鄉,民和村,364,1,656,8,664,1056,0,0,0,0,0,0,62.88
南投縣,水里鄉,頂崁村,365,1,721,7,728,1111,0,0,0,0,0,0,65.53
南投縣,水里鄉,新山村,366,1,271,3,274,407,0,0,0,0,0,0,67.32
南投縣,水里鄉,郡坑村,367,1,266,3,269,397,0,0,0,0,0,0,67.76
南投縣,水里鄉,上安村,368,1,811,6,817,1231,0,0,0,0,0,0,66.37
南投縣,水里鄉,興隆村,369,1,213,5,218,351,0,0,0,0,0,0,62.11
南投縣,水里鄉,永興村,370,1,264,0,264,398,0,0,0,0,0,0,66.33
南投縣,水里鄉,玉峰村,371,1,669,3,672,916,0,0,0,0,0,0,73.36
南投縣,水里鄉,車埕村,372,1,378,9,387,584,0,0,0,0,0,0,66.27
南投縣,水里鄉,新興村,373,1,438,4,442,698,0,0,0,0,0,0,63.32
南投縣,信義鄉,明德村,374,1,474,6,480,696,0,0,0,0,0,0,68.97
南投縣,信義鄉,明德村,375,1,264,2,266,386,0,0,0,0,0,0,68.91
南投縣,信義鄉,愛國村,376,1,378,2,380,548,0,0,0,0,0,0,69.34
南投縣,信義鄉,自強村,377,1,288,6,294,413,0,0,0,0,0,0,71.19
南投縣,信義鄉,自強村,378,1,231,1,232,327,0,0,0,0,0,0,70.95
南投縣,信義鄉,豐丘村,379,1,235,4,239,335,0,0,0,0,0,0,71.34
南投縣,信義鄉,新鄉村,380,1,49,1,50,77,0,0,0,0,0,0,64.94
南投縣,信義鄉,羅娜村,381,1,137,0,137,220,0,0,0,0,0,0,62.27
南投縣,信義鄉,望美村,382,1,12,0,12,26,0,0,0,0,0,0,46.15
南投縣,信義鄉,望美村,383,1,159,1,160,268,0,0,0,0,0,0,59.70
南投縣,信義鄉,東埔村,384,1,152,5,157,247,0,0,0,0,0,0,63.56
南投縣,信義鄉,神木村,385,1,293,5,298,467,0,0,0,0,0,0,63.81
南投縣,信義鄉,神木村,386,1,165,0,165,274,0,0,0,0,0,0,60.22
南投縣,信義鄉,同富村,387,1,564,2,566,886,0,0,0,0,0,0,63.88
南投縣,信義鄉,同富村,388,1,274,1,275,438,0,0,0,0,0,0,62.79
南投縣,信義鄉,人和村,389,1,29,1,30,67,0,0,0,0,0,0,44.78
南投縣,信義鄉,人和村,390,1,87,2,89,175,0,0,0,0,0,0,50.86
南投縣,信義鄉,雙龍村,391,1,10,0,10,16,0,0,0,0,0,0,62.50
南投縣,信義鄉,地利村,392,1,56,0,56,104,0,0,0,0,0,0,53.85
南投縣,信義鄉,潭南村,393,1,18,0,18,40,0,0,0,0,0,0,45.00
南投縣,仁愛鄉,南豐村,394,1,117,1,118,229,0,0,0,0,0,0,51.53
南投縣,仁愛鄉,南豐村,395,1,168,1,169,305,0,0,0,0,0,0,55.41
南投縣,仁愛鄉,大同村,396,1,337,4,341,559,0,0,0,0,0,0,61.00
南投縣,仁愛鄉,大同村,397,1,195,3,198,303,0,0,0,0,0,0,65.35
南投縣,仁愛鄉,大同村,398,1,124,1,125,216,0,0,0,0,0,0,57.87
南投縣,仁愛鄉,榮興村,399,1,58,0,58,86,0,0,0,0,0,0,67.44
南投縣,仁愛鄉,春陽村,400,1,29,0,29,58,0,0,0,0,0,0,50.00
南投縣,仁愛鄉,精英村,401,1,56,1,57,112,0,0,0,0,0,0,50.89
南投縣,仁愛鄉,精英村,402,1,16,1,17,31,0,0,0,0,0,0,54.84
南投縣,仁愛鄉,合作村,403,1,17,0,17,27,0,0,0,0,0,0,62.96
南投縣,仁愛鄉,力行村,404,1,11,1,12,22,0,0,0,0,0,0,54.55
南投縣,仁愛鄉,力行村,405,1,4,1,5,17,0,0,0,0,0,0,29.41
南投縣,仁愛鄉,力行村,406,1,131,2,133,218,0,0,0,0,0,0,61.01
南投縣,仁愛鄉,發祥村,407,1,13,0,13,22,0,0,0,0,0,0,59.09
南投縣,仁愛鄉,發祥村,408,1,4,0,4,16,0,0,0,0,0,0,25.00
南投縣,仁愛鄉,發祥村,409,1,13,1,14,35,0,0,0,0,0,0,40.00
南投縣,仁愛鄉,親愛村,410,1,13,1,14,34,0,0,0,0,0,0,41.18
南投縣,仁愛鄉,親愛村,411,1,7,0,7,10,0,0,0,0,0,0,70.00
南投縣,仁愛鄉,親愛村,412,1,21,1,22,37,0,0,0,0,0,0,59.46
南投縣,仁愛鄉,萬豐村,413,1,34,1,35,64,0,0,0,0,0,0,54.69
南投縣,仁愛鄉,法治村,414,1,15,0,15,43,0,0,0,0,0,0,34.88
南投縣,仁愛鄉,中正村,415,1,40,1,41,85,0,0,0,0,0,0,48.24
南投縣,仁愛鄉,互助村,416,1,30,0,30,86,0,0,0,0,0,0,34.88
南投縣,仁愛鄉,互助村,417,1,13,1,14,26,0,0,0,0,0,0,53.85
南投縣,仁愛鄉,新生村,418,1,27,0,27,57,0,0,0,0,0,0,47.37
雲林縣,斗六市,信義里,1,1,658,8,666,977,0,0,0,0,0,0,68.17
雲林縣,斗六市,四維里,2,1,487,8,495,682,0,0,0,0,0,0,72.58
雲林縣,斗六市,太平里,3,1,539,12,551,739,0,0,0,0,0,0,74.56
雲林縣,斗六市,中和里,4,1,443,10,453,622,0,0,0,0,0,0,72.83
雲林縣,斗六市,光興里,5,1,626,11,637,924,0,0,0,0,0,0,68.94
雲林縣,斗六市,鎮西里,6,1,769,14,783,1157,0,0,0,0,0,0,67.68
雲林縣,斗六市,鎮西里,7,1,884,24,908,1291,0,0,0,0,0,0,70.33
雲林縣,斗六市,鎮東里,8,1,626,11,637,888,0,0,0,0,0,0,71.73
雲林縣,斗六市,鎮東里,9,1,711,13,724,1069,0,0,0,0,0,0,67.73
雲林縣,斗六市,鎮東里,10,1,876,18,894,1255,0,0,0,0,0,0,71.24
雲林縣,斗六市,三平里,11,1,1108,14,1122,1573,0,0,0,0,0,0,71.33
雲林縣,斗六市,三平里,12,1,1033,14,1047,1446,0,0,0,0,0,0,72.41
雲林縣,斗六市,鎮北里,13,1,1030,18,1048,1609,0,0,0,0,0,0,65.13
雲林縣,斗六市,鎮北里,14,1,777,9,786,1146,0,0,0,0,0,0,68.59
雲林縣,斗六市,鎮北里,15,1,960,30,990,1405,0,0,0,0,0,0,70.46
雲林縣,斗六市,鎮北里,16,1,835,14,849,1283,0,0,0,0,0,0,66.17
雲林縣,斗六市,忠孝里,17,1,562,12,574,819,0,0,0,0,0,0,70.09
雲林縣,斗六市,忠孝里,18,1,502,9,511,708,0,0,0,0,0,0,72.18
雲林縣,斗六市,仁愛里,19,1,803,15,818,1142,0,0,0,0,0,0,71.63
雲林縣,斗六市,八德里,20,1,762,13,775,1017,0,0,0,0,0,0,76.20
雲林縣,斗六市,八德里,21,1,863,20,883,1309,0,0,0,0,0,0,67.46
雲林縣,斗六市,公正里,22,1,667,12,679,1019,0,0,0,0,0,0,66.63
雲林縣,斗六市,公正里,23,1,762,23,785,1087,0,0,0,0,0,0,72.22
雲林縣,斗六市,重光里,24,1,667,7,674,905,0,0,0,0,0,0,74.48
雲林縣,斗六市,重光里,25,1,678,18,696,1000,0,0,0,0,0,0,69.60
雲林縣,斗六市,林頭里,26,1,1004,19,1023,1483,0,0,0,0,0,0,68.98
雲林縣,斗六市,林頭里,27,1,795,10,805,1170,0,0,0,0,0,0,68.80
雲林縣,斗六市,林頭里,28,1,852,18,870,1338,0,0,0,0,0,0,65.02
雲林縣,斗六市,林頭里,29,1,759,12,771,1053,0,0,0,0,0,0,73.22
雲林縣,斗六市,鎮南里,30,1,876,14,890,1338,0,0,0,0,0,0,66.52
雲林縣,斗六市,鎮南里,31,1,1012,14,1026,1636,0,0,0,0,0,0,62.71
雲林縣,斗六市,社口里,32,1,675,15,690,971,0,0,0,0,0,0,71.06
雲林縣,斗六市,社口里,33,1,769,15,784,1113,0,0,0,0,0,0,70.44
雲林縣,斗六市,龍潭里,34,1,680,12,692,946,0,0,0,0,0,0,73.15
雲林縣,斗六市,嘉東里,35,1,478,4,482,636,0,0,0,0,0,0,75.79
雲林縣,斗六市,崙峰里,36,1,671,15,686,933,0,0,0,0,0,0,73.53
雲林縣,斗六市,崙峰里,37,1,477,6,483,653,0,0,0,0,0,0,73.97
雲林縣,斗六市,溝埧里,38,1,390,5,395,527,0,0,0,0,0,0,74.95
雲林縣,斗六市,江厝里,39,1,771,14,785,1083,0,0,0,0,0,0,72.48
雲林縣,斗六市,三光里,40,1,441,6,447,608,0,0,0,0,0,0,73.52
雲林縣,斗六市,久安里,41,1,843,16,859,1137,0,0,0,0,0,0,75.55
雲林縣,斗六市,久安里,42,1,400,12,412,575,0,0,0,0,0,0,71.65
雲林縣,斗六市,虎溪里,43,1,775,15,790,1127,0,0,0,0,0,0,70.10
雲林縣,斗六市,虎溪里,44,1,1070,26,1096,1593,0,0,0,0,0,0,68.80
雲林縣,斗六市,虎溪里,45,1,857,9,866,1179,0,0,0,0,0,0,73.45
雲林縣,斗六市,保庄里,46,1,1121,20,1141,1509,0,0,0,0,0,0,75.61
雲林縣,斗六市,保庄里,47,1,842,12,854,1204,0,0,0,0,0,0,70.93
雲林縣,斗六市,長平里,48,1,1044,17,1061,1458,0,0,0,0,0,0,72.77
雲林縣,斗六市,榴中里,49,1,879,13,892,1128,0,0,0,0,0,0,79.08
雲林縣,斗六市,榴中里,50,1,778,14,792,1077,0,0,0,0,0,0,73.54
雲林縣,斗六市,榴中里,51,1,880,24,904,1229,0,0,0,0,0,0,73.56
雲林縣,斗六市,榴北里,52,1,631,8,639,838,0,0,0,0,0,0,76.25
雲林縣,斗六市,榴南里,53,1,561,8,569,738,0,0,0,0,0,0,77.10
雲林縣,斗六市,梅林里,54,1,595,15,610,769,0,0,0,0,0,0,79.32
雲林縣,斗六市,梅林里,55,1,696,18,714,951,0,0,0,0,0,0,75.08
雲林縣,斗六市,湖山里,56,1,919,18,937,1272,0,0,0,0,0,0,73.66
雲林縣,斗六市,長安里,57,1,726,11,737,976,0,0,0,0,0,0,75.51
雲林縣,斗六市,長安里,58,1,866,16,882,1274,0,0,0,0,0,0,69.23
雲林縣,斗六市,溪洲里,59,1,636,8,644,899,0,0,0,0,0,0,71.64
雲林縣,斗六市,溪洲里,60,1,858,22,880,1279,0,0,0,0,0,0,68.80
雲林縣,斗六市,十三里,61,1,823,9,832,1092,0,0,0,0,0,0,76.19
雲林縣,斗南鎮,東仁里,62,1,813,18,831,1114,0,0,0,0,0,0,74.60
雲林縣,斗南鎮,西岐里,63,1,991,16,1007,1386,0,0,0,0,0,0,72.66
雲林縣,斗南鎮,西岐里,64,1,900,15,915,1269,0,0,0,0,0,0,72.10
雲林縣,斗南鎮,西岐里,65,1,790,14,804,1137,0,0,0,0,0,0,70.71
雲林縣,斗南鎮,南昌里,66,1,677,9,686,1005,0,0,0,0,0,0,68.26
雲林縣,斗南鎮,南昌里,67,1,604,7,611,887,0,0,0,0,0,0,68.88
雲林縣,斗南鎮,北銘里,68,1,960,11,971,1225,0,0,0,0,0,0,79.27
雲林縣,斗南鎮,中天里,69,1,934,13,947,1280,0,0,0,0,0,0,73.98
雲林縣,斗南鎮,林子里,70,1,823,14,837,1136,0,0,0,0,0,0,73.68
雲林縣,斗南鎮,石龜里,71,1,637,6,643,857,0,0,0,0,0,0,75.03
雲林縣,斗南鎮,石溪里,72,1,611,9,620,892,0,0,0,0,0,0,69.51
雲林縣,斗南鎮,靖興里,73,1,673,5,678,893,0,0,0,0,0,0,75.92
雲林縣,斗南鎮,新南里,74,1,507,9,516,729,0,0,0,0,0,0,70.78
雲林縣,斗南鎮,阿丹里,75,1,927,7,934,1164,0,0,0,0,0,0,80.24
雲林縣,斗南鎮,將軍里,76,1,1030,15,1045,1350,0,0,0,0,0,0,77.41
雲林縣,斗南鎮,舊社里,77,1,1153,21,1174,1557,0,0,0,0,0,0,75.40
雲林縣,斗南鎮,明昌里,78,1,974,11,985,1352,0,0,0,0,0,0,72.86
雲林縣,斗南鎮,明昌里,79,1,1014,10,1024,1349,0,0,0,0,0,0,75.91
雲林縣,斗南鎮,明昌里,80,1,946,11,957,1334,0,0,0,0,0,0,71.74
雲林縣,斗南鎮,大東里,81,1,787,11,798,1020,0,0,0,0,0,0,78.24
雲林縣,斗南鎮,埤麻里,82,1,652,10,662,859,0,0,0,0,0,0,77.07
雲林縣,斗南鎮,西伯里,83,1,701,5,706,937,0,0,0,0,0,0,75.35
雲林縣,斗南鎮,新崙里,84,1,609,7,616,799,0,0,0,0,0,0,77.10
雲林縣,斗南鎮,新崙里,85,1,557,6,563,777,0,0,0,0,0,0,72.46
雲林縣,斗南鎮,東明里,86,1,695,12,707,968,0,0,0,0,0,0,73.04
雲林縣,斗南鎮,新光里,87,1,675,5,680,927,0,0,0,0,0,0,73.35
雲林縣,斗南鎮,新光里,88,1,897,10,907,1296,0,0,0,0,0,0,69.98
雲林縣,斗南鎮,田頭里,89,1,780,15,795,1038,0,0,0,0,0,0,76.59
雲林縣,斗南鎮,田頭里,90,1,734,11,745,979,0,0,0,0,0,0,76.10
雲林縣,斗南鎮,小東里,91,1,1107,13,1120,1529,0,0,0,0,0,0,73.25
雲林縣,虎尾鎮,東仁里,92,1,740,11,751,1057,0,0,0,0,0,0,71.05
雲林縣,虎尾鎮,東仁里,93,1,818,17,835,1199,0,0,0,0,0,0,69.64
雲林縣,虎尾鎮,新興里,94,1,491,4,495,703,0,0,0,0,0,0,70.41
雲林縣,虎尾鎮,新興里,95,1,650,11,661,959,0,0,0,0,0,0,68.93
雲林縣,虎尾鎮,公安里,96,1,714,13,727,1109,0,0,0,0,0,0,65.55
雲林縣,虎尾鎮,公安里,97,1,991,13,1004,1485,0,0,0,0,0,0,67.61
雲林縣,虎尾鎮,德興里,98,1,629,12,641,983,0,0,0,0,0,0,65.21
雲林縣,虎尾鎮,德興里,99,1,840,19,859,1380,0,0,0,0,0,0,62.25
雲林縣,虎尾鎮,中山里,100,1,799,12,811,1145,0,0,0,0,0,0,70.83
雲林縣,虎尾鎮,西安里,101,1,845,19,864,1346,0,0,0,0,0,0,64.19
雲林縣,虎尾鎮,西安里,102,1,936,8,944,1460,0,0,0,0,0,0,64.66
雲林縣,虎尾鎮,立仁里,103,1,1052,14,1066,1515,0,0,0,0,0,0,70.36
雲林縣,虎尾鎮,立仁里,104,1,975,21,996,1561,0,0,0,0,0,0,63.81
雲林縣,虎尾鎮,安慶里,105,1,907,11,918,1263,0,0,0,0,0,0,72.68
雲林縣,虎尾鎮,平和里,106,1,726,15,741,1047,0,0,0,0,0,0,70.77
雲林縣,虎尾鎮,興南里,107,1,970,16,986,1476,0,0,0,0,0,0,66.80
雲林縣,虎尾鎮,新吉里,108,1,1113,20,1133,1691,0,0,0,0,0,0,67.00
雲林縣,虎尾鎮,穎川里,109,1,1107,17,1124,1574,0,0,0,0,0,0,71.41
雲林縣,虎尾鎮,延平里,110,1,629,11,640,849,0,0,0,0,0,0,75.38
雲林縣,虎尾鎮,建國里,111,1,470,9,479,716,0,0,0,0,0,0,66.90
雲林縣,虎尾鎮,埒內里,112,1,791,17,808,1131,0,0,0,0,0,0,71.44
雲林縣,虎尾鎮,埒內里,113,1,760,18,778,1043,0,0,0,0,0,0,74.59
雲林縣,虎尾鎮,堀頭里,114,1,568,9,577,741,0,0,0,0,0,0,77.87
雲林縣,虎尾鎮,安溪里,115,1,1081,29,1110,1542,0,0,0,0,0,0,71.98
雲林縣,虎尾鎮,興中里,116,1,1071,16,1087,1474,0,0,0,0,0,0,73.74
雲林縣,虎尾鎮,廉使里,117,1,882,63,945,1305,0,0,0,0,0,0,72.41
雲林縣,虎尾鎮,廉使里,118,1,987,21,1008,1417,0,0,0,0,0,0,71.14
雲林縣,虎尾鎮,惠來里,119,1,769,29,798,1169,0,0,0,0,0,0,68.26
雲林縣,虎尾鎮,惠來里,120,1,723,6,729,975,0,0,0,0,0,0,74.77
雲林縣,虎尾鎮,頂溪里,121,1,776,8,784,1095,0,0,0,0,0,0,71.60
雲林縣,虎尾鎮,頂溪里,122,1,755,17,772,1123,0,0,0,0,0,0,68.74
雲林縣,虎尾鎮,中溪里,123,1,833,23,856,1153,0,0,0,0,0,0,74.24
雲林縣,虎尾鎮,下溪里,124,1,918,17,935,1262,0,0,0,0,0,0,74.09
雲林縣,虎尾鎮,東屯里,125,1,795,21,816,1088,0,0,0,0,0,0,75.00
雲林縣,虎尾鎮,西屯里,126,1,1037,11,1048,1433,0,0,0,0,0,0,73.13
雲林縣,虎尾鎮,芳草里,127,1,523,13,536,848,0,0,0,0,0,0,63.21
雲林縣,虎尾鎮,墾地里,128,1,605,14,619,951,0,0,0,0,0,0,65.09
雲林縣,虎尾鎮,北溪里,129,1,545,9,554,737,0,0,0,0,0,0,75.17
雲林縣,虎尾鎮,三合里,130,1,682,6,688,964,0,0,0,0,0,0,71.37
雲林縣,西螺鎮,振興里,131,1,1025,9,1034,1502,0,0,0,0,0,0,68.84
雲林縣,西螺鎮,大園里,132,1,930,18,948,1332,0,0,0,0,0,0,71.17
雲林縣,西螺鎮,廣福里,133,1,1083,18,1101,1561,0,0,0,0,0,0,70.53
雲林縣,西螺鎮,正興里,134,1,973,12,985,1485,0,0,0,0,0,0,66.33
雲林縣,西螺鎮,正興里,135,1,863,8,871,1270,0,0,0,0,0,0,68.58
雲林縣,西螺鎮,永安里,136,1,337,5,342,469,0,0,0,0,0,0,72.92
雲林縣,西螺鎮,中和里,137,1,531,11,542,761,0,0,0,0,0,0,71.22
雲林縣,西螺鎮,福興里,138,1,440,8,448,705,0,0,0,0,0,0,63.55
雲林縣,西螺鎮,光華里,139,1,684,7,691,1019,0,0,0,0,0,0,67.81
雲林縣,西螺鎮,中興里,140,1,799,13,812,1161,0,0,0,0,0,0,69.94
雲林縣,西螺鎮,中興里,141,1,579,6,585,891,0,0,0,0,0,0,65.66
雲林縣,西螺鎮,漢光里,142,1,1014,11,1025,1587,0,0,0,0,0,0,64.59
雲林縣,西螺鎮,漢光里,143,1,1004,15,1019,1558,0,0,0,0,0,0,65.40
雲林縣,西螺鎮,新安里,144,1,803,4,807,1231,0,0,0,0,0,0,65.56
雲林縣,西螺鎮,新豐里,145,1,901,14,915,1347,0,0,0,0,0,0,67.93
雲林縣,西螺鎮,大新里,146,1,667,6,673,1014,0,0,0,0,0,0,66.37
雲林縣,西螺鎮,大新里,147,1,482,7,489,723,0,0,0,0,0,0,67.63
雲林縣,西螺鎮,埤頭里,148,1,603,10,613,891,0,0,0,0,0,0,68.80
雲林縣,西螺鎮,東興里,149,1,730,9,739,1136,0,0,0,0,0,0,65.05
雲林縣,西螺鎮,鹿場里,150,1,974,16,990,1459,0,0,0,0,0,0,67.85
雲林縣,西螺鎮,廣興里,151,1,596,8,604,863,0,0,0,0,0,0,69.99
雲林縣,西螺鎮,頂湳里,152,1,724,7,731,1000,0,0,0,0,0,0,73.10
雲林縣,西螺鎮,吳厝里,153,1,884,11,895,1351,0,0,0,0,0,0,66.25
雲林縣,西螺鎮,九隆里,154,1,505,12,517,734,0,0,0,0,0,0,70.44
雲林縣,西螺鎮,下湳里,155,1,592,9,601,802,0,0,0,0,0,0,74.94
雲林縣,西螺鎮,七座里,156,1,681,11,692,1005,0,0,0,0,0,0,68.86
雲林縣,西螺鎮,公館里,157,1,925,11,936,1351,0,0,0,0,0,0,69.28
雲林縣,西螺鎮,詔安里,158,1,616,10,626,935,0,0,0,0,0,0,66.95
雲林縣,西螺鎮,河南里,159,1,592,3,595,949,0,0,0,0,0,0,62.70
雲林縣,西螺鎮,安定里,160,1,526,10,536,911,0,0,0,0,0,0,58.84
雲林縣,西螺鎮,安定里,161,1,526,6,532,850,0,0,0,0,0,0,62.59
雲林縣,西螺鎮,福田里,162,1,905,10,915,1354,0,0,0,0,0,0,67.58
雲林縣,土庫鎮,忠正里,163,1,628,16,644,913,0,0,0,0,0,0,70.54
雲林縣,土庫鎮,順天里,164,1,737,15,752,1025,0,0,0,0,0,0,73.37
雲林縣,土庫鎮,宮北里,165,1,898,16,914,1310,0,0,0,0,0,0,69.77
雲林縣,土庫鎮,越港里,166,1,602,10,612,817,0,0,0,0,0,0,74.91
雲林縣,土庫鎮,溪邊里,167,1,500,3,503,697,0,0,0,0,0,0,72.17
雲林縣,土庫鎮,溪邊里,168,1,302,3,305,421,0,0,0,0,0,0,72.45
雲林縣,土庫鎮,石廟里,169,1,982,19,1001,1431,0,0,0,0,0,0,69.95
雲林縣,土庫鎮,興新里,170,1,397,5,402,590,0,0,0,0,0,0,68.14
雲林縣,土庫鎮,興新里,171,1,363,2,365,614,0,0,0,0,0,0,59.45
雲林縣,土庫鎮,奮起里,172,1,506,7,513,829,0,0,0,0,0,0,61.88
雲林縣,土庫鎮,奮起里,173,1,382,4,386,624,0,0,0,0,0,0,61.86
雲林縣,土庫鎮,埤腳里,174,1,587,9,596,908,0,0,0,0,0,0,65.64
雲林縣,土庫鎮,埤腳里,175,1,388,11,399,574,0,0,0,0,0,0,69.51
雲林縣,土庫鎮,後埔里,176,1,859,8,867,1279,0,0,0,0,0,0,67.79
雲林縣,土庫鎮,後埔里,177,1,656,5,661,971,0,0,0,0,0,0,68.07
雲林縣,土庫鎮,崙內里,178,1,534,3,537,769,0,0,0,0,0,0,69.83
雲林縣,土庫鎮,崙內里,179,1,433,5,438,686,0,0,0,0,0,0,63.85
雲林縣,土庫鎮,大荖里,180,1,564,7,571,821,0,0,0,0,0,0,69.55
雲林縣,土庫鎮,東平里,181,1,645,8,653,1000,0,0,0,0,0,0,65.30
雲林縣,土庫鎮,東平里,182,1,485,2,487,782,0,0,0,0,0,0,62.28
雲林縣,土庫鎮,南平里,183,1,667,3,670,936,0,0,0,0,0,0,71.58
雲林縣,土庫鎮,南平里,184,1,554,12,566,788,0,0,0,0,0,0,71.83
雲林縣,土庫鎮,西平里,185,1,643,7,650,948,0,0,0,0,0,0,68.57
雲林縣,土庫鎮,西平里,186,1,549,6,555,859,0,0,0,0,0,0,64.61
雲林縣,土庫鎮,北平里,187,1,641,5,646,972,0,0,0,0,0,0,66.46
雲林縣,土庫鎮,新庄里,188,1,952,11,963,1435,0,0,0,0,0,0,67.11
雲林縣,北港鎮,東陽里,189,1,630,24,654,857,0,0,0,0,0,0,76.31
雲林縣,北港鎮,光民里,190,1,598,9,607,811,0,0,0,0,0,0,74.85
雲林縣,北港鎮,東華里,191,1,385,3,388,524,0,0,0,0,0,0,74.05
雲林縣,北港鎮,南安里,192,1,731,19,750,1032,0,0,0,0,0,0,72.67
雲林縣,北港鎮,中和里,193,1,308,6,314,417,0,0,0,0,0,0,75.30
雲林縣,北港鎮,義民里,194,1,333,8,341,467,0,0,0,0,0,0,73.02
雲林縣,北港鎮,共榮里,195,1,356,5,361,487,0,0,0,0,0,0,74.13
雲林縣,北港鎮,西勢里,196,1,617,7,624,885,0,0,0,0,0,0,70.51
雲林縣,北港鎮,仁和里,197,1,396,8,404,556,0,0,0,0,0,0,72.66
雲林縣,北港鎮,賜福里,198,1,319,2,321,426,0,0,0,0,0,0,75.35
雲林縣,北港鎮,公館里,199,1,476,14,490,666,0,0,0,0,0,0,73.57
雲林縣,北港鎮,大同里,200,1,390,3,393,544,0,0,0,0,0,0,72.24
雲林縣,北港鎮,大同里,201,1,539,12,551,804,0,0,0,0,0,0,68.53
雲林縣,北港鎮,仁安里,202,1,328,6,334,474,0,0,0,0,0,0,70.46
雲林縣,北港鎮,華勝里,203,1,782,12,794,1084,0,0,0,0,0,0,73.25
雲林縣,北港鎮,華勝里,204,1,924,14,938,1396,0,0,0,0,0,0,67.19
雲林縣,北港鎮,華勝里,205,1,712,16,728,1022,0,0,0,0,0,0,71.23
雲林縣,北港鎮,華勝里,206,1,861,18,879,1290,0,0,0,0,0,0,68.14
雲林縣,北港鎮,光復里,207,1,793,13,806,1169,0,0,0,0,0,0,68.95
雲林縣,北港鎮,新街里,208,1,656,15,671,989,0,0,0,0,0,0,67.85
雲林縣,北港鎮,新街里,209,1,833,11,844,1225,0,0,0,0,0,0,68.90
雲林縣,北港鎮,新街里,210,1,809,27,836,1191,0,0,0,0,0,0,70.19
雲林縣,北港鎮,新街里,211,1,788,20,808,1146,0,0,0,0,0,0,70.51
雲林縣,北港鎮,劉厝里,212,1,772,16,788,1142,0,0,0,0,0,0,69.00
雲林縣,北港鎮,後溝里,213,1,379,6,385,602,0,0,0,0,0,0,63.95
雲林縣,北港鎮,後溝里,214,1,232,3,235,374,0,0,0,0,0,0,62.83
雲林縣,北港鎮,新厝里,215,1,294,6,300,437,0,0,0,0,0,0,68.65
雲林縣,北港鎮,府番里,216,1,569,12,581,870,0,0,0,0,0,0,66.78
雲林縣,北港鎮,草湖里,217,1,928,27,955,1411,0,0,0,0,0,0,67.68
雲林縣,北港鎮,溝皂里,218,1,733,13,746,1235,0,0,0,0,0,0,60.40
雲林縣,北港鎮,番溝里,219,1,617,11,628,1087,0,0,0,0,0,0,57.77
雲林縣,北港鎮,大北里,220,1,394,9,403,667,0,0,0,0,0,0,60.42
雲林縣,北港鎮,好收里,221,1,738,10,748,1010,0,0,0,0,0,0,74.06
雲林縣,北港鎮,好收里,222,1,431,13,444,616,0,0,0,0,0,0,72.08
雲林縣,北港鎮,樹腳里,223,1,783,15,798,1242,0,0,0,0,0,0,64.25
雲林縣,北港鎮,樹腳里,224,1,955,17,972,1418,0,0,0,0,0,0,68.55
雲林縣,北港鎮,扶朝里,225,1,703,11,714,1092,0,0,0,0,0,0,65.38
雲林縣,北港鎮,水埔里,226,1,389,5,394,601,0,0,0,0,0,0,65.56
雲林縣,古坑鄉,棋盤村,227,1,813,15,828,1133,0,0,0,0,0,0,73.08
雲林縣,古坑鄉,棋盤村,228,1,692,6,698,912,0,0,0,0,0,0,76.54
雲林縣,古坑鄉,新庄村,229,1,1079,22,1101,1507,0,0,0,0,0,0,73.06
雲林縣,古坑鄉,東和村,230,1,907,18,925,1263,0,0,0,0,0,0,73.24
雲林縣,古坑鄉,東和村,231,1,1001,17,1018,1428,0,0,0,0,0,0,71.29
雲林縣,古坑鄉,荷苞村,232,1,829,10,839,1128,0,0,0,0,0,0,74.38
雲林縣,古坑鄉,荷苞村,233,1,208,0,208,297,0,0,0,0,0,0,70.03
雲林縣,古坑鄉,高林村,234,1,840,12,852,1113,0,0,0,0,0,0,76.55
雲林縣,古坑鄉,水碓村,235,1,861,18,879,1223,0,0,0,0,0,0,71.87
雲林縣,古坑鄉,田心村,236,1,682,6,688,890,0,0,0,0,0,0,77.30
雲林縣,古坑鄉,古坑村,237,1,721,13,734,954,0,0,0,0,0,0,76.94
雲林縣,古坑鄉,古坑村,238,1,735,9,744,1015,0,0,0,0,0,0,73.30
雲林縣,古坑鄉,朝陽村,239,1,647,10,657,898,0,0,0,0,0,0,73.16
雲林縣,古坑鄉,朝陽村,240,1,708,10,718,982,0,0,0,0,0,0,73.12
雲林縣,古坑鄉,西平村,241,1,1023,12,1035,1353,0,0,0,0,0,0,76.50
雲林縣,古坑鄉,湳仔村,242,1,565,6,571,716,0,0,0,0,0,0,79.75
雲林縣,古坑鄉,永光村,243,1,687,9,696,921,0,0,0,0,0,0,75.57
雲林縣,古坑鄉,永光村,244,1,652,8,660,916,0,0,0,0,0,0,72.05
雲林縣,古坑鄉,永昌村,245,1,748,12,760,1007,0,0,0,0,0,0,75.47
雲林縣,古坑鄉,永昌村,246,1,701,11,712,942,0,0,0,0,0,0,75.58
雲林縣,古坑鄉,麻園村,247,1,522,5,527,651,0,0,0,0,0,0,80.95
雲林縣,古坑鄉,崁腳村,248,1,974,20,994,1339,0,0,0,0,0,0,74.23
雲林縣,古坑鄉,華南村,249,1,259,2,261,341,0,0,0,0,0,0,76.54
雲林縣,古坑鄉,華山村,250,1,751,16,767,1057,0,0,0,0,0,0,72.56
雲林縣,古坑鄉,桂林村,251,1,674,8,682,929,0,0,0,0,0,0,73.41
雲林縣,古坑鄉,樟湖村,252,1,385,3,388,550,0,0,0,0,0,0,70.55
雲林縣,古坑鄉,草嶺村,253,1,526,4,530,692,0,0,0,0,0,0,76.59
雲林縣,大埤鄉,北和村,254,1,540,10,550,808,0,0,0,0,0,0,68.07
雲林縣,大埤鄉,南和村,255,1,1040,9,1049,1443,0,0,0,0,0,0,72.70
雲林縣,大埤鄉,南和村,256,1,444,8,452,557,0,0,0,0,0,0,81.15
雲林縣,大埤鄉,大德村,257,1,785,15,800,1156,0,0,0,0,0,0,69.20
雲林縣,大埤鄉,松竹村,258,1,734,17,751,1084,0,0,0,0,0,0,69.28
雲林縣,大埤鄉,尚義村,259,1,901,9,910,1273,0,0,0,0,0,0,71.48
雲林縣,大埤鄉,尚義村,260,1,343,4,347,489,0,0,0,0,0,0,70.96
雲林縣,大埤鄉,嘉興村,261,1,963,19,982,1330,0,0,0,0,0,0,73.83
雲林縣,大埤鄉,嘉興村,262,1,371,7,378,484,0,0,0,0,0,0,78.10
雲林縣,大埤鄉,豐田村,263,1,844,13,857,1137,0,0,0,0,0,0,75.37
雲林縣,大埤鄉,三結村,264,1,895,10,905,1228,0,0,0,0,0,0,73.70
雲林縣,大埤鄉,吉田村,265,1,536,4,540,807,0,0,0,0,0,0,66.91
雲林縣,大埤鄉,豐岡村,266,1,516,7,523,715,0,0,0,0,0,0,73.15
雲林縣,大埤鄉,聯美村,267,1,793,9,802,1244,0,0,0,0,0,0,64.47
雲林縣,大埤鄉,怡然村,268,1,588,4,592,853,0,0,0,0,0,0,69.40
雲林縣,大埤鄉,北鎮村,269,1,483,6,489,730,0,0,0,0,0,0,66.99
雲林縣,大埤鄉,興安村,270,1,574,5,579,865,0,0,0,0,0,0,66.94
雲林縣,大埤鄉,西鎮村,271,1,619,6,625,846,0,0,0,0,0,0,73.88
雲林縣,莿桐鄉,莿桐村,272,1,1069,20,1089,1477,0,0,0,0,0,0,73.73
雲林縣,莿桐鄉,莿桐村,273,1,1231,19,1250,1741,0,0,0,0,0,0,71.80
雲林縣,莿桐鄉,甘厝村,274,1,646,7,653,907,0,0,0,0,0,0,72.00
雲林縣,莿桐鄉,甘西村,275,1,1055,11,1066,1565,0,0,0,0,0,0,68.12
雲林縣,莿桐鄉,興桐村,276,1,398,3,401,565,0,0,0,0,0,0,70.97
雲林縣,莿桐鄉,興桐村,277,1,535,7,542,722,0,0,0,0,0,0,75.07
雲林縣,莿桐鄉,義和村,278,1,798,6,804,1112,0,0,0,0,0,0,72.30
雲林縣,莿桐鄉,埔子村,279,1,1198,23,1221,1723,0,0,0,0,0,0,70.86
雲林縣,莿桐鄉,大美村,280,1,897,13,910,1188,0,0,0,0,0,0,76.60
雲林縣,莿桐鄉,大美村,281,1,751,17,768,1021,0,0,0,0,0,0,75.22
雲林縣,莿桐鄉,埔尾村,282,1,936,13,949,1165,0,0,0,0,0,0,81.46
雲林縣,莿桐鄉,興貴村,283,1,639,9,648,894,0,0,0,0,0,0,72.48
雲林縣,莿桐鄉,興貴村,284,1,700,10,710,929,0,0,0,0,0,0,76.43
雲林縣,莿桐鄉,饒平村,285,1,829,15,844,1128,0,0,0,0,0,0,74.82
雲林縣,莿桐鄉,四合村,286,1,1142,17,1159,1715,0,0,0,0,0,0,67.58
雲林縣,莿桐鄉,麻園村,287,1,1070,12,1082,1533,0,0,0,0,0,0,70.58
雲林縣,莿桐鄉,五華村,288,1,878,17,895,1290,0,0,0,0,0,0,69.38
雲林縣,莿桐鄉,六合村,289,1,1127,8,1135,1652,0,0,0,0,0,0,68.70
雲林縣,林內鄉,林南村,290,1,749,14,763,1033,0,0,0,0,0,0,73.86
雲林縣,林內鄉,林中村,291,1,1009,18,1027,1437,0,0,0,0,0,0,71.47
雲林縣,林內鄉,林中村,292,1,1124,30,1154,1657,0,0,0,0,0,0,69.64
雲林縣,林內鄉,林北村,293,1,976,20,996,1356,0,0,0,0,0,0,73.45
雲林縣,林內鄉,林北村,294,1,468,8,476,696,0,0,0,0,0,0,68.39
雲林縣,林內鄉,坪頂村,295,1,479,5,484,633,0,0,0,0,0,0,76.46
雲林縣,林內鄉,林茂村,296,1,721,13,734,997,0,0,0,0,0,0,73.62
雲林縣,林內鄉,九芎村,297,1,748,22,770,1003,0,0,0,0,0,0,76.77
雲林縣,林內鄉,九芎村,298,1,996,23,1019,1464,0,0,0,0,0,0,69.60
雲林縣,林內鄉,湖本村,299,1,463,4,467,629,0,0,0,0,0,0,74.24
雲林縣,林內鄉,烏塗村,300,1,846,13,859,1122,0,0,0,0,0,0,76.56
雲林縣,林內鄉,烏麻村,301,1,745,24,769,1057,0,0,0,0,0,0,72.75
雲林縣,林內鄉,重興村,302,1,619,13,632,843,0,0,0,0,0,0,74.97
雲林縣,林內鄉,重興村,303,1,608,7,615,827,0,0,0,0,0,0,74.37
雲林縣,二崙鄉,崙東村,304,1,883,11,894,1346,0,0,0,0,0,0,66.42
雲林縣,二崙鄉,崙西村,305,1,1042,16,1058,1560,0,0,0,0,0,0,67.82
雲林縣,二崙鄉,來惠村,306,1,472,7,479,754,0,0,0,0,0,0,63.53
雲林縣,二崙鄉,來惠村,307,1,694,6,700,1083,0,0,0,0,0,0,64.64
雲林縣,二崙鄉,三和村,308,1,347,0,347,506,0,0,0,0,0,0,68.58
雲林縣,二崙鄉,三和村,309,1,800,12,812,1186,0,0,0,0,0,0,68.47
雲林縣,二崙鄉,湳仔村,310,1,845,17,862,1223,0,0,0,0,0,0,70.48
雲林縣,二崙鄉,田尾村,311,1,654,12,666,984,0,0,0,0,0,0,67.68
雲林縣,二崙鄉,田尾村,312,1,675,13,688,964,0,0,0,0,0,0,71.37
雲林縣,二崙鄉,定安村,313,1,623,5,628,930,0,0,0,0,0,0,67.53
雲林縣,二崙鄉,永定村,314,1,853,11,864,1329,0,0,0,0,0,0,65.01
雲林縣,二崙鄉,大華村,315,1,593,11,604,949,0,0,0,0,0,0,63.65
雲林縣,二崙鄉,義庄村,316,1,490,3,493,799,0,0,0,0,0,0,61.70
雲林縣,二崙鄉,楊賢村,317,1,983,15,998,1491,0,0,0,0,0,0,66.93
雲林縣,二崙鄉,港後村,318,1,749,9,758,1231,0,0,0,0,0,0,61.58
雲林縣,二崙鄉,港後村,319,1,493,6,499,730,0,0,0,0,0,0,68.36
雲林縣,二崙鄉,大義村,320,1,564,5,569,899,0,0,0,0,0,0,63.29
雲林縣,二崙鄉,油車村,321,1,777,9,786,1103,0,0,0,0,0,0,71.26
雲林縣,二崙鄉,油車村,322,1,400,4,404,677,0,0,0,0,0,0,59.68
雲林縣,二崙鄉,大庄村,323,1,887,7,894,1403,0,0,0,0,0,0,63.72
雲林縣,二崙鄉,庄西村,324,1,615,5,620,1034,0,0,0,0,0,0,59.96
雲林縣,二崙鄉,大同村,325,1,582,8,590,836,0,0,0,0,0,0,70.57
雲林縣,二崙鄉,復興村,326,1,710,5,715,1051,0,0,0,0,0,0,68.03
雲林縣,崙背鄉,東明村,327,1,921,17,938,1294,0,0,0,0,0,0,72.49
雲林縣,崙背鄉,西榮村,328,1,932,14,946,1317,0,0,0,0,0,0,71.83
雲林縣,崙背鄉,南陽村,329,1,694,14,708,979,0,0,0,0,0,0,72.32
雲林縣,崙背鄉,南陽村,330,1,880,22,902,1216,0,0,0,0,0,0,74.18
雲林縣,崙背鄉,崙前村,331,1,681,10,691,1002,0,0,0,0,0,0,68.96
雲林縣,崙背鄉,崙前村,332,1,563,14,577,926,0,0,0,0,0,0,62.31
雲林縣,崙背鄉,羅厝村,333,1,536,10,546,889,0,0,0,0,0,0,61.42
雲林縣,崙背鄉,羅厝村,334,1,688,4,692,984,0,0,0,0,0,0,70.33
雲林縣,崙背鄉,港尾村,335,1,877,16,893,1335,0,0,0,0,0,0,66.89
雲林縣,崙背鄉,阿勸村,336,1,730,6,736,1007,0,0,0,0,0,0,73.09
雲林縣,崙背鄉,阿勸村,337,1,615,6,621,902,0,0,0,0,0,0,68.85
雲林縣,崙背鄉,五魁村,338,1,576,7,583,876,0,0,0,0,0,0,66.55
雲林縣,崙背鄉,大有村,339,1,524,5,529,828,0,0,0,0,0,0,63.89
雲林縣,崙背鄉,大有村,340,1,602,4,606,939,0,0,0,0,0,0,64.54
雲林縣,崙背鄉,豐榮村,341,1,599,6,605,971,0,0,0,0,0,0,62.31
雲林縣,崙背鄉,豐榮村,342,1,602,8,610,1046,0,0,0,0,0,0,58.32
雲林縣,崙背鄉,草湖村,343,1,805,12,817,1446,0,0,0,0,0,0,56.50
雲林縣,崙背鄉,舊庄村,344,1,788,9,797,1144,0,0,0,0,0,0,69.67
雲林縣,崙背鄉,水尾村,345,1,817,7,824,1262,0,0,0,0,0,0,65.29
雲林縣,崙背鄉,枋南村,346,1,589,9,598,872,0,0,0,0,0,0,68.58
雲林縣,麥寮鄉,麥豐村,347,1,392,4,396,557,0,0,0,0,0,0,71.10
雲林縣,麥寮鄉,麥豐村,348,1,847,12,859,1278,0,0,0,0,0,0,67.21
雲林縣,麥寮鄉,麥豐村,349,1,736,6,742,1070,0,0,0,0,0,0,69.35
雲林縣,麥寮鄉,麥津村,350,1,743,4,747,1151,0,0,0,0,0,0,64.90
雲林縣,麥寮鄉,麥津村,351,1,777,14,791,1225,0,0,0,0,0,0,64.57
雲林縣,麥寮鄉,瓦窯村,352,1,346,3,349,495,0,0,0,0,0,0,70.51
雲林縣,麥寮鄉,瓦窯村,353,1,588,0,588,847,0,0,0,0,0,0,69.42
雲林縣,麥寮鄉,興華村,354,1,498,5,503,741,0,0,0,0,0,0,67.88
雲林縣,麥寮鄉,興華村,355,1,719,6,725,1101,0,0,0,0,0,0,65.85
雲林縣,麥寮鄉,海豐村,356,1,517,5,522,813,0,0,0,0,0,0,64.21
雲林縣,麥寮鄉,海豐村,357,1,391,4,395,621,0,0,0,0,0,0,63.61
雲林縣,麥寮鄉,後安村,358,1,655,8,663,1000,0,0,0,0,0,0,66.30
雲林縣,麥寮鄉,後安村,359,1,700,6,706,1059,0,0,0,0,0,0,66.67
雲林縣,麥寮鄉,三盛村,360,1,547,6,553,880,0,0,0,0,0,0,62.84
雲林縣,麥寮鄉,三盛村,361,1,768,8,776,1201,0,0,0,0,0,0,64.61
雲林縣,麥寮鄉,崙後村,362,1,649,11,660,1132,0,0,0,0,0,0,58.30
雲林縣,麥寮鄉,崙後村,363,1,428,8,436,695,0,0,0,0,0,0,62.73
雲林縣,麥寮鄉,橋頭村,364,1,572,10,582,951,0,0,0,0,0,0,61.20
雲林縣,麥寮鄉,橋頭村,365,1,904,15,919,1471,0,0,0,0,0,0,62.47
雲林縣,麥寮鄉,新吉村,366,1,500,10,510,804,0,0,0,0,0,0,63.43
雲林縣,麥寮鄉,施厝村,367,1,708,9,717,1124,0,0,0,0,0,0,63.79
雲林縣,麥寮鄉,施厝村,368,1,620,6,626,1010,0,0,0,0,0,0,61.98
雲林縣,麥寮鄉,雷厝村,369,1,848,12,860,1444,0,0,0,0,0,0,59.56
雲林縣,東勢鄉,月眉村,370,1,735,8,743,1321,0,0,0,0,0,0,56.25
雲林縣,東勢鄉,復興村,371,1,311,6,317,487,0,0,0,0,0,0,65.09
雲林縣,東勢鄉,嘉隆村,372,1,643,7,650,1017,0,0,0,0,0,0,63.91
雲林縣,東勢鄉,嘉隆村,373,1,478,11,489,775,0,0,0,0,0,0,63.10
雲林縣,東勢鄉,東南村,374,1,974,14,988,1431,0,0,0,0,0,0,69.04
雲林縣,東勢鄉,東北村,375,1,753,8,761,1161,0,0,0,0,0,0,65.55
雲林縣,東勢鄉,昌南村,376,1,627,5,632,1021,0,0,0,0,0,0,61.90
雲林縣,東勢鄉,同安村,377,1,685,9,694,1091,0,0,0,0,0,0,63.61
雲林縣,東勢鄉,同安村,378,1,707,14,721,1124,0,0,0,0,0,0,64.15
雲林縣,東勢鄉,四美村,379,1,472,7,479,832,0,0,0,0,0,0,57.57
雲林縣,東勢鄉,四美村,380,1,276,1,277,453,0,0,0,0,0,0,61.15
雲林縣,東勢鄉,新坤村,381,1,727,9,736,1269,0,0,0,0,0,0,58.00
雲林縣,東勢鄉,安南村,382,1,496,8,504,971,0,0,0,0,0,0,51.91
雲林縣,東勢鄉,龍潭村,383,1,628,6,634,1044,0,0,0,0,0,0,60.73
雲林縣,東勢鄉,程海村,384,1,366,10,376,592,0,0,0,0,0,0,63.51
雲林縣,褒忠鄉,中民村,385,1,697,12,709,954,0,0,0,0,0,0,74.32
雲林縣,褒忠鄉,中民村,386,1,593,8,601,853,0,0,0,0,0,0,70.46
雲林縣,褒忠鄉,埔姜村,387,1,943,8,951,1353,0,0,0,0,0,0,70.29
雲林縣,褒忠鄉,中勝村,388,1,940,12,952,1311,0,0,0,0,0,0,72.62
雲林縣,褒忠鄉,馬鳴村,389,1,302,1,303,410,0,0,0,0,0,0,73.90
雲林縣,褒忠鄉,馬鳴村,390,1,655,9,664,937,0,0,0,0,0,0,70.86
雲林縣,褒忠鄉,新湖村,391,1,352,0,352,519,0,0,0,0,0,0,67.82
雲林縣,褒忠鄉,新湖村,392,1,543,1,544,769,0,0,0,0,0,0,70.74
雲林縣,褒忠鄉,有才村,393,1,634,5,639,909,0,0,0,0,0,0,70.30
雲林縣,褒忠鄉,田洋村,394,1,591,5,596,865,0,0,0,0,0,0,68.90
雲林縣,褒忠鄉,龍岩村,395,1,1001,21,1022,1274,0,0,0,0,0,0,80.22
雲林縣,褒忠鄉,潮厝村,396,1,614,9,623,991,0,0,0,0,0,0,62.87
雲林縣,台西鄉,台西村,397,1,887,3,890,1302,0,0,0,0,0,0,68.36
雲林縣,台西鄉,海南村,398,1,634,4,638,997,0,0,0,0,0,0,63.99
雲林縣,台西鄉,海北村,399,1,645,11,656,1023,0,0,0,0,0,0,64.13
雲林縣,台西鄉,海口村,400,1,632,6,638,978,0,0,0,0,0,0,65.24
雲林縣,台西鄉,海口村,401,1,556,15,571,897,0,0,0,0,0,0,63.66
雲林縣,台西鄉,山寮村,402,1,516,6,522,949,0,0,0,0,0,0,55.01
雲林縣,台西鄉,溪頂村,403,1,954,6,960,1534,0,0,0,0,0,0,62.58
雲林縣,台西鄉,牛厝村,404,1,807,5,812,1351,0,0,0,0,0,0,60.10
雲林縣,台西鄉,牛厝村,405,1,466,3,469,736,0,0,0,0,0,0,63.72
雲林縣,台西鄉,泉州村,406,1,421,5,426,661,0,0,0,0,0,0,64.45
雲林縣,台西鄉,五榔村,407,1,329,4,333,558,0,0,0,0,0,0,59.68
雲林縣,台西鄉,光華村,408,1,403,5,408,661,0,0,0,0,0,0,61.72
雲林縣,台西鄉,五港村,409,1,769,8,777,1168,0,0,0,0,0,0,66.52
雲林縣,台西鄉,五港村,410,1,444,3,447,646,0,0,0,0,0,0,69.20
雲林縣,台西鄉,富琦村,411,1,658,2,660,1033,0,0,0,0,0,0,63.89
雲林縣,台西鄉,富琦村,412,1,305,3,308,537,0,0,0,0,0,0,57.36
雲林縣,台西鄉,永豐村,413,1,945,14,959,1397,0,0,0,0,0,0,68.65
雲林縣,台西鄉,和豐村,414,1,735,9,744,1043,0,0,0,0,0,0,71.33
雲林縣,台西鄉,和豐村,415,1,699,7,706,1013,0,0,0,0,0,0,69.69
雲林縣,台西鄉,和豐村,416,1,725,7,732,1168,0,0,0,0,0,0,62.67
雲林縣,台西鄉,蚊港村,417,1,976,10,986,1287,0,0,0,0,0,0,76.61
雲林縣,台西鄉,蚊港村,418,1,632,4,636,730,0,0,0,0,0,0,87.12
雲林縣,元長鄉,長南村,419,1,1136,11,1147,1629,0,0,0,0,0,0,70.41
雲林縣,元長鄉,長南村,420,1,908,16,924,1329,0,0,0,0,0,0,69.53
雲林縣,元長鄉,長北村,421,1,588,3,591,809,0,0,0,0,0,0,73.05
雲林縣,元長鄉,長北村,422,1,536,7,543,781,0,0,0,0,0,0,69.53
雲林縣,元長鄉,子茂村,423,1,942,12,954,1478,0,0,0,0,0,0,64.55
雲林縣,元長鄉,後湖村,424,1,480,4,484,776,0,0,0,0,0,0,62.37
雲林縣,元長鄉,山內村,425,1,664,10,674,1048,0,0,0,0,0,0,64.31
雲林縣,元長鄉,合和村,426,1,689,9,698,1177,0,0,0,0,0,0,59.30
雲林縣,元長鄉,五塊村,427,1,575,7,582,1050,0,0,0,0,0,0,55.43
雲林縣,元長鄉,潭西村,428,1,517,9,526,968,0,0,0,0,0,0,54.34
雲林縣,元長鄉,潭東村,429,1,438,4,442,739,0,0,0,0,0,0,59.81
雲林縣,元長鄉,客厝村,430,1,505,3,508,853,0,0,0,0,0,0,59.55
雲林縣,元長鄉,卓運村,431,1,302,1,303,467,0,0,0,0,0,0,64.88
雲林縣,元長鄉,頂寮村,432,1,783,12,795,1285,0,0,0,0,0,0,61.87
雲林縣,元長鄉,下寮村,433,1,922,7,929,1544,0,0,0,0,0,0,60.17
雲林縣,元長鄉,龍岩村,434,1,823,4,827,1134,0,0,0,0,0,0,72.93
雲林縣,元長鄉,西莊村,435,1,575,5,580,926,0,0,0,0,0,0,62.63
雲林縣,元長鄉,鹿北村,436,1,898,8,906,1371,0,0,0,0,0,0,66.08
雲林縣,元長鄉,鹿南村,437,1,694,3,697,1086,0,0,0,0,0,0,64.18
雲林縣,元長鄉,瓦窯村,438,1,489,5,494,778,0,0,0,0,0,0,63.50
雲林縣,元長鄉,瓦窯村,439,1,611,7,618,913,0,0,0,0,0,0,67.69
雲林縣,元長鄉,內寮村,440,1,433,2,435,712,0,0,0,0,0,0,61.10
雲林縣,元長鄉,崙仔村,441,1,582,11,593,982,0,0,0,0,0,0,60.39
雲林縣,元長鄉,新吉村,442,1,513,3,516,772,0,0,0,0,0,0,66.84
雲林縣,四湖鄉,四湖村,443,1,594,12,606,1014,0,0,0,0,0,0,59.76
雲林縣,四湖鄉,四湖村,444,1,470,8,478,721,0,0,0,0,0,0,66.30
雲林縣,四湖鄉,湖西村,445,1,1003,16,1019,1504,0,0,0,0,0,0,67.75
雲林縣,四湖鄉,湖西村,446,1,356,4,360,611,0,0,0,0,0,0,58.92
雲林縣,四湖鄉,新庄村,447,1,447,5,452,720,0,0,0,0,0,0,62.78
雲林縣,四湖鄉,溪底村,448,1,723,11,734,1147,0,0,0,0,0,0,63.99
雲林縣,四湖鄉,鹿場村,449,1,662,9,671,1187,0,0,0,0,0,0,56.53
雲林縣,四湖鄉,蔡厝村,450,1,552,8,560,1021,0,0,0,0,0,0,54.85
雲林縣,四湖鄉,湖寮村,451,1,478,4,482,931,0,0,0,0,0,0,51.77
雲林縣,四湖鄉,施湖村,452,1,701,9,710,1284,0,0,0,0,0,0,55.30
雲林縣,四湖鄉,羊調村,453,1,614,6,620,1169,0,0,0,0,0,0,53.04
雲林縣,四湖鄉,內湖村,454,1,475,13,488,996,0,0,0,0,0,0,49.00
雲林縣,四湖鄉,飛東村,455,1,371,5,376,670,0,0,0,0,0,0,56.12
雲林縣,四湖鄉,飛沙村,456,1,533,5,538,1039,0,0,0,0,0,0,51.78
雲林縣,四湖鄉,三姓村,457,1,247,3,250,414,0,0,0,0,0,0,60.39
雲林縣,四湖鄉,崙北村,458,1,542,3,545,1006,0,0,0,0,0,0,54.17
雲林縣,四湖鄉,崙北村,459,1,507,5,512,810,0,0,0,0,0,0,63.21
雲林縣,四湖鄉,崙南村,460,1,538,9,547,915,0,0,0,0,0,0,59.78
雲林縣,四湖鄉,廣溝村,461,1,484,10,494,812,0,0,0,0,0,0,60.84
雲林縣,四湖鄉,箔子村,462,1,519,10,529,1023,0,0,0,0,0,0,51.71
雲林縣,四湖鄉,箔東村,463,1,635,12,647,1165,0,0,0,0,0,0,55.54
雲林縣,四湖鄉,林厝村,464,1,708,12,720,1351,0,0,0,0,0,0,53.29
雲林縣,四湖鄉,林東村,465,1,572,14,586,1095,0,0,0,0,0,0,53.52
雲林縣,四湖鄉,溪尾村,466,1,415,2,417,904,0,0,0,0,0,0,46.13
雲林縣,口湖鄉,口湖村,467,1,664,3,667,971,0,0,0,0,0,0,68.69
雲林縣,口湖鄉,湖東村,468,1,810,12,822,1252,0,0,0,0,0,0,65.65
雲林縣,口湖鄉,頂湖村,469,1,423,6,429,762,0,0,0,0,0,0,56.30
雲林縣,口湖鄉,埔南村,470,1,414,9,423,631,0,0,0,0,0,0,67.04
雲林縣,口湖鄉,埔北村,471,1,514,12,526,936,0,0,0,0,0,0,56.20
雲林縣,口湖鄉,謝厝村,472,1,642,4,646,972,0,0,0,0,0,0,66.46
雲林縣,口湖鄉,蚵寮村,473,1,916,14,930,1438,0,0,0,0,0,0,64.67
雲林縣,口湖鄉,下崙村,474,1,461,6,467,903,0,0,0,0,0,0,51.72
雲林縣,口湖鄉,下崙村,475,1,610,4,614,1109,0,0,0,0,0,0,55.37
雲林縣,口湖鄉,崙中村,476,1,467,3,470,855,0,0,0,0,0,0,54.97
雲林縣,口湖鄉,崙中村,477,1,496,5,501,855,0,0,0,0,0,0,58.60
雲林縣,口湖鄉,崙東村,478,1,911,4,915,1557,0,0,0,0,0,0,58.77
雲林縣,口湖鄉,青蚶村,479,1,347,1,348,573,0,0,0,0,0,0,60.73
雲林縣,口湖鄉,港東村,480,1,911,7,918,1344,0,0,0,0,0,0,68.30
雲林縣,口湖鄉,港西村,481,1,503,10,513,776,0,0,0,0,0,0,66.11
雲林縣,口湖鄉,台子村,482,1,221,3,224,339,0,0,0,0,0,0,66.08
雲林縣,口湖鄉,台子村,483,1,835,13,848,1200,0,0,0,0,0,0,70.67
雲林縣,口湖鄉,成龍村,484,1,670,4,674,1046,0,0,0,0,0,0,64.44
雲林縣,口湖鄉,梧南村,485,1,613,12,625,900,0,0,0,0,0,0,69.44
雲林縣,口湖鄉,梧南村,486,1,628,7,635,967,0,0,0,0,0,0,65.67
雲林縣,口湖鄉,梧北村,487,1,843,8,851,1314,0,0,0,0,0,0,64.76
雲林縣,口湖鄉,水井村,488,1,743,3,746,1085,0,0,0,0,0,0,68.76
雲林縣,口湖鄉,後厝村,489,1,533,9,542,798,0,0,0,0,0,0,67.92
雲林縣,口湖鄉,湖口村,490,1,602,4,606,1014,0,0,0,0,0,0,59.76
雲林縣,口湖鄉,過港村,491,1,456,6,462,746,0,0,0,0,0,0,61.93
雲林縣,水林鄉,水北村,492,1,923,23,946,1367,0,0,0,0,0,0,69.20
雲林縣,水林鄉,水北村,493,1,633,5,638,856,0,0,0,0,0,0,74.53
雲林縣,水林鄉,水南村,494,1,739,16,755,1045,0,0,0,0,0,0,72.25
雲林縣,水林鄉,水南村,495,1,587,11,598,804,0,0,0,0,0,0,74.38
雲林縣,水林鄉,萬興村,496,1,578,13,591,821,0,0,0,0,0,0,71.99
雲林縣,水林鄉,尖山村,497,1,512,6,518,751,0,0,0,0,0,0,68.97
雲林縣,水林鄉,大溝村,498,1,745,7,752,1122,0,0,0,0,0,0,67.02
雲林縣,水林鄉,順興村,499,1,601,20,621,941,0,0,0,0,0,0,65.99
雲林縣,水林鄉,大山村,500,1,787,9,796,1241,0,0,0,0,0,0,64.14
雲林縣,水林鄉,後寮村,501,1,528,4,532,815,0,0,0,0,0,0,65.28
雲林縣,水林鄉,春埔村,502,1,659,2,661,1087,0,0,0,0,0,0,60.81
雲林縣,水林鄉,西井村,503,1,458,11,469,753,0,0,0,0,0,0,62.28
雲林縣,水林鄉,車港村,504,1,403,7,410,716,0,0,0,0,0,0,57.26
雲林縣,水林鄉,蘇秦村,505,1,761,12,773,1301,0,0,0,0,0,0,59.42
雲林縣,水林鄉,灣東村,506,1,462,8,470,762,0,0,0,0,0,0,61.68
雲林縣,水林鄉,灣西村,507,1,682,10,692,1103,0,0,0,0,0,0,62.74
雲林縣,水林鄉,蕃薯村,508,1,735,14,749,1079,0,0,0,0,0,0,69.42
雲林縣,水林鄉,山腳村,509,1,614,8,622,926,0,0,0,0,0,0,67.17
雲林縣,水林鄉,松北村,510,1,793,11,804,1274,0,0,0,0,0,0,63.11
雲林縣,水林鄉,松中村,511,1,393,2,395,658,0,0,0,0,0,0,60.03
雲林縣,水林鄉,松西村,512,1,541,7,548,877,0,0,0,0,0,0,62.49
雲林縣,水林鄉,舊埔村,513,1,541,12,553,921,0,0,0,0,0,0,60.04
雲林縣,水林鄉,塭底村,514,1,492,6,498,822,0,0,0,0,0,0,60.58
雲林縣,水林鄉,海埔村,515,1,719,6,725,1133,0,0,0,0,0,0,63.99
雲林縣,水林鄉,土厝村,516,1,818,13,831,1292,0,0,0,0,0,0,64.32
雲林縣,水林鄉,溪墘村,517,1,571,7,578,849,0,0,0,0,0,0,68.08
嘉義縣,太保市,太保里,1,1,1174,26,1200,1608,0,0,0,0,0,0,74.63
嘉義縣,太保市,後庄里,2,1,335,4,339,457,0,0,0,0,0,0,74.18
嘉義縣,太保市,前潭里,3,1,1009,12,1021,1352,0,0,0,0,0,0,75.52
嘉義縣,太保市,後潭里,4,1,1097,21,1118,1451,0,0,0,0,0,0,77.05
嘉義縣,太保市,梅埔里,5,1,532,6,538,704,0,0,0,0,0,0,76.42
嘉義縣,太保市,梅埔里,6,1,294,4,298,374,0,0,0,0,0,0,79.68
嘉義縣,太保市,春珠里,7,1,577,10,587,776,0,0,0,0,0,0,75.64
嘉義縣,太保市,崙頂里,8,1,574,12,586,768,0,0,0,0,0,0,76.30
嘉義縣,太保市,安仁里,9,1,167,0,167,223,0,0,0,0,0,0,74.89
嘉義縣,太保市,安仁里,10,1,413,3,416,546,0,0,0,0,0,0,76.19
嘉義縣,太保市,東勢里,11,1,635,10,645,863,0,0,0,0,0,0,74.74
嘉義縣,太保市,新埤里,12,1,866,19,885,1183,0,0,0,0,0,0,74.81
嘉義縣,太保市,舊埤里,13,1,643,9,652,947,0,0,0,0,0,0,68.85
嘉義縣,太保市,田尾里,14,1,356,9,365,501,0,0,0,0,0,0,72.85
嘉義縣,太保市,田尾里,15,1,159,2,161,225,0,0,0,0,0,0,71.56
嘉義縣,太保市,港尾里,16,1,233,2,235,301,0,0,0,0,0,0,78.07
嘉義縣,太保市,港尾里,17,1,209,0,209,260,0,0,0,0,0,0,80.38
嘉義縣,太保市,過溝里,18,1,448,9,457,580,0,0,0,0,0,0,78.79
嘉義縣,太保市,過溝里,19,1,849,11,860,1216,0,0,0,0,0,0,70.72
嘉義縣,太保市,麻寮里,20,1,1130,19,1149,1580,0,0,0,0,0,0,72.72
嘉義縣,太保市,麻寮里,21,1,585,7,592,839,0,0,0,0,0,0,70.56
嘉義縣,太保市,南新里,22,1,1237,30,1267,1670,0,0,0,0,0,0,75.87
嘉義縣,太保市,北新里,23,1,1512,18,1530,2052,0,0,0,0,0,0,74.56
嘉義縣,太保市,埤鄉里,24,1,568,14,582,715,0,0,0,0,0,0,81.40
嘉義縣,朴子市,安福里,25,1,510,4,514,853,0,0,0,0,0,0,60.26
嘉義縣,朴子市,安福里,26,1,616,5,621,886,0,0,0,0,0,0,70.09
嘉義縣,朴子市,平和里,27,1,1149,14,1163,1789,0,0,0,0,0,0,65.01
嘉義縣,朴子市,內厝里,28,1,729,12,741,1103,0,0,0,0,0,0,67.18
嘉義縣,朴子市,開元里,29,1,383,4,387,537,0,0,0,0,0,0,72.07
嘉義縣,朴子市,順天里,30,1,476,8,484,773,0,0,0,0,0,0,62.61
嘉義縣,朴子市,中正里,31,1,562,2,564,777,0,0,0,0,0,0,72.59
嘉義縣,朴子市,博厚里,32,1,497,7,504,785,0,0,0,0,0,0,64.20
嘉義縣,朴子市,文化里,33,1,582,7,589,850,0,0,0,0,0,0,69.29
嘉義縣,朴子市,文化里,34,1,592,9,601,947,0,0,0,0,0,0,63.46
嘉義縣,朴子市,永和里,35,1,596,13,609,915,0,0,0,0,0,0,66.56
嘉義縣,朴子市,永和里,36,1,983,13,996,1416,0,0,0,0,0,0,70.34
嘉義縣,朴子市,竹圍里,37,1,1214,16,1230,1866,0,0,0,0,0,0,65.92
嘉義縣,朴子市,竹圍里,38,1,1018,12,1030,1543,0,0,0,0,0,0,66.75
嘉義縣,朴子市,新寮里,39,1,461,4,465,634,0,0,0,0,0,0,73.34
嘉義縣,朴子市,雙溪里,40,1,463,7,470,729,0,0,0,0,0,0,64.47
嘉義縣,朴子市,溪口里,41,1,569,2,571,816,0,0,0,0,0,0,69.98
嘉義縣,朴子市,德興里,42,1,711,5,716,987,0,0,0,0,0,0,72.54
嘉義縣,朴子市,仁和里,43,1,335,9,344,468,0,0,0,0,0,0,73.50
嘉義縣,朴子市,大鄉里,44,1,859,11,870,1239,0,0,0,0,0,0,70.22
嘉義縣,朴子市,大鄉里,45,1,903,14,917,1246,0,0,0,0,0,0,73.60
嘉義縣,朴子市,大葛里,46,1,1060,30,1090,1554,0,0,0,0,0,0,70.14
嘉義縣,朴子市,佳禾里,47,1,408,8,416,566,0,0,0,0,0,0,73.50
嘉義縣,朴子市,竹村里,48,1,565,8,573,955,0,0,0,0,0,0,60.00
嘉義縣,朴子市,崁前里,49,1,703,14,717,1019,0,0,0,0,0,0,70.36
嘉義縣,朴子市,崁後里,50,1,542,13,555,865,0,0,0,0,0,0,64.16
嘉義縣,朴子市,順安里,51,1,191,1,192,295,0,0,0,0,0,0,65.08
嘉義縣,朴子市,德家里,52,1,498,6,504,798,0,0,0,0,0,0,63.16
嘉義縣,朴子市,新庄里,53,1,394,5,399,569,0,0,0,0,0,0,70.12
嘉義縣,朴子市,梅華里,54,1,780,14,794,1184,0,0,0,0,0,0,67.06
嘉義縣,朴子市,松華里,55,1,943,15,958,1475,0,0,0,0,0,0,64.95
嘉義縣,朴子市,南竹里,56,1,360,5,365,560,0,0,0,0,0,0,65.18
嘉義縣,布袋鎮,岱江里,57,1,518,12,530,747,0,0,0,0,0,0,70.95
嘉義縣,布袋鎮,九龍里,58,1,299,5,304,435,0,0,0,0,0,0,69.89
嘉義縣,布袋鎮,岑海里,59,1,934,13,947,1353,0,0,0,0,0,0,69.99
嘉義縣,布袋鎮,興中里,60,1,799,17,816,1205,0,0,0,0,0,0,67.72
嘉義縣,布袋鎮,光復里,61,1,756,9,765,1095,0,0,0,0,0,0,69.86
嘉義縣,布袋鎮,光復里,62,1,503,8,511,709,0,0,0,0,0,0,72.07
嘉義縣,布袋鎮,見龍里,63,1,645,5,650,931,0,0,0,0,0,0,69.82
嘉義縣,布袋鎮,新厝里,64,1,588,16,604,815,0,0,0,0,0,0,74.11
嘉義縣,布袋鎮,龍江里,65,1,633,15,648,917,0,0,0,0,0,0,70.67
嘉義縣,布袋鎮,西安里,66,1,955,11,966,1437,0,0,0,0,0,0,67.22
嘉義縣,布袋鎮,中安里,67,1,988,22,1010,1616,0,0,0,0,0,0,62.50
嘉義縣,布袋鎮,東安里,68,1,1039,14,1053,1604,0,0,0,0,0,0,65.65
嘉義縣,布袋鎮,樹林里,69,1,226,3,229,331,0,0,0,0,0,0,69.18
嘉義縣,布袋鎮,樹林里,70,1,184,1,185,287,0,0,0,0,0,0,64.46
嘉義縣,布袋鎮,貴舍里,71,1,351,2,353,508,0,0,0,0,0,0,69.49
嘉義縣,布袋鎮,貴舍里,72,1,215,3,218,285,0,0,0,0,0,0,76.49
嘉義縣,布袋鎮,永安里,73,1,824,23,847,1219,0,0,0,0,0,0,69.48
嘉義縣,布袋鎮,東港里,74,1,618,12,630,952,0,0,0,0,0,0,66.18
嘉義縣,布袋鎮,東港里,75,1,645,14,659,999,0,0,0,0,0,0,65.97
嘉義縣,布袋鎮,江山里,76,1,256,6,262,381,0,0,0,0,0,0,68.77
嘉義縣,布袋鎮,菜舖里,77,1,137,4,141,225,0,0,0,0,0,0,62.67
嘉義縣,布袋鎮,菜舖里,78,1,167,3,170,258,0,0,0,0,0,0,65.89
嘉義縣,布袋鎮,考試里,79,1,95,0,95,149,0,0,0,0,0,0,63.76
嘉義縣,布袋鎮,考試里,80,1,137,1,138,226,0,0,0,0,0,0,61.06
嘉義縣,布袋鎮,振寮里,81,1,605,5,610,845,0,0,0,0,0,0,72.19
嘉義縣,布袋鎮,新岑里,82,1,727,8,735,995,0,0,0,0,0,0,73.87
嘉義縣,布袋鎮,新民里,83,1,765,12,777,1186,0,0,0,0,0,0,65.51
嘉義縣,布袋鎮,復興里,84,1,689,10,699,1084,0,0,0,0,0,0,64.48
嘉義縣,布袋鎮,復興里,85,1,783,13,796,1234,0,0,0,0,0,0,64.51
嘉義縣,布袋鎮,好美里,86,1,711,19,730,1038,0,0,0,0,0,0,70.33
嘉義縣,大林鎮,東林里,87,1,361,13,374,523,0,0,0,0,0,0,71.51
嘉義縣,大林鎮,西林里,88,1,1170,21,1191,1837,0,0,0,0,0,0,64.83
嘉義縣,大林鎮,吉林里,89,1,667,10,677,958,0,0,0,0,0,0,70.67
嘉義縣,大林鎮,平林里,90,1,992,17,1009,1507,0,0,0,0,0,0,66.95
嘉義縣,大林鎮,平林里,91,1,797,17,814,1313,0,0,0,0,0,0,62.00
嘉義縣,大林鎮,平林里,92,1,994,20,1014,1619,0,0,0,0,0,0,62.63
嘉義縣,大林鎮,明華里,93,1,813,13,826,1156,0,0,0,0,0,0,71.45
嘉義縣,大林鎮,明和里,94,1,909,15,924,1285,0,0,0,0,0,0,71.91
嘉義縣,大林鎮,排路里,95,1,440,5,445,694,0,0,0,0,0,0,64.12
嘉義縣,大林鎮,西結里,96,1,528,2,530,838,0,0,0,0,0,0,63.25
嘉義縣,大林鎮,湖北里,97,1,518,7,525,715,0,0,0,0,0,0,73.43
嘉義縣,大林鎮,大糖里,98,1,249,1,250,354,0,0,0,0,0,0,70.62
嘉義縣,大林鎮,大美里,99,1,1169,19,1188,1784,0,0,0,0,0,0,66.59
嘉義縣,大林鎮,過溪里,100,1,1084,20,1104,1474,0,0,0,0,0,0,74.90
嘉義縣,大林鎮,中坑里,101,1,848,11,859,1157,0,0,0,0,0,0,74.24
嘉義縣,大林鎮,中坑里,102,1,278,2,280,433,0,0,0,0,0,0,64.67
嘉義縣,大林鎮,上林里,103,1,646,10,656,897,0,0,0,0,0,0,73.13
嘉義縣,大林鎮,中林里,104,1,1025,15,1040,1505,0,0,0,0,0,0,69.10
嘉義縣,大林鎮,三和里,105,1,1202,22,1224,1831,0,0,0,0,0,0,66.85
嘉義縣,大林鎮,溝背里,106,1,696,2,698,1002,0,0,0,0,0,0,69.66
嘉義縣,大林鎮,義和里,107,1,513,9,522,678,0,0,0,0,0,0,76.99
嘉義縣,大林鎮,內林里,108,1,608,6,614,804,0,0,0,0,0,0,76.37
嘉義縣,大林鎮,三角里,109,1,803,9,812,1153,0,0,0,0,0,0,70.42
嘉義縣,大林鎮,三村里,110,1,522,7,529,721,0,0,0,0,0,0,73.37
嘉義縣,民雄鄉,東榮村,111,1,761,12,773,1066,0,0,0,0,0,0,72.51
嘉義縣,民雄鄉,東榮村,112,1,623,8,631,897,0,0,0,0,0,0,70.35
嘉義縣,民雄鄉,中樂村,113,1,1156,12,1168,1572,0,0,0,0,0,0,74.30
嘉義縣,民雄鄉,西安村,114,1,934,10,944,1396,0,0,0,0,0,0,67.62
嘉義縣,民雄鄉,西安村,115,1,1023,7,1030,1465,0,0,0,0,0,0,70.31
嘉義縣,民雄鄉,寮頂村,116,1,1324,14,1338,1906,0,0,0,0,0,0,70.20
嘉義縣,民雄鄉,福權村,117,1,759,7,766,1060,0,0,0,0,0,0,72.26
嘉義縣,民雄鄉,東湖村,118,1,1400,15,1415,1796,0,0,0,0,0,0,78.79
嘉義縣,民雄鄉,頂崙村,119,1,919,18,937,1356,0,0,0,0,0,0,69.10
嘉義縣,民雄鄉,菁埔村,120,1,1287,9,1296,1665,0,0,0,0,0,0,77.84
嘉義縣,民雄鄉,中和村,121,1,494,3,497,669,0,0,0,0,0,0,74.29
嘉義縣,民雄鄉,平和村,122,1,512,5,517,693,0,0,0,0,0,0,74.60
嘉義縣,民雄鄉,西昌村,123,1,547,13,560,716,0,0,0,0,0,0,78.21
嘉義縣,民雄鄉,豐收村,124,1,1010,26,1036,1413,0,0,0,0,0,0,73.32
嘉義縣,民雄鄉,豐收村,125,1,310,2,312,399,0,0,0,0,0,0,78.20
嘉義縣,民雄鄉,三興村,126,1,545,7,552,798,0,0,0,0,0,0,69.17
嘉義縣,民雄鄉,東興村,127,1,399,7,406,611,0,0,0,0,0,0,66.45
嘉義縣,民雄鄉,鎮北村,128,1,545,5,550,793,0,0,0,0,0,0,69.36
嘉義縣,民雄鄉,北斗村,129,1,1231,17,1248,1790,0,0,0,0,0,0,69.72
嘉義縣,民雄鄉,北斗村,130,1,496,6,502,719,0,0,0,0,0,0,69.82
嘉義縣,民雄鄉,北斗村,131,1,351,7,358,461,0,0,0,0,0,0,77.66
嘉義縣,民雄鄉,雙福村,132,1,1082,17,1099,1588,0,0,0,0,0,0,69.21
嘉義縣,民雄鄉,福樂村,133,1,1375,21,1396,2024,0,0,0,0,0,0,68.97
嘉義縣,民雄鄉,福樂村,134,1,869,17,886,1226,0,0,0,0,0,0,72.27
嘉義縣,民雄鄉,大崎村,135,1,585,11,596,920,0,0,0,0,0,0,64.78
嘉義縣,民雄鄉,大崎村,136,1,662,12,674,917,0,0,0,0,0,0,73.50
嘉義縣,民雄鄉,秀林村,137,1,1321,35,1356,1976,0,0,0,0,0,0,68.62
嘉義縣,民雄鄉,松山村,138,1,964,5,969,1559,0,0,0,0,0,0,62.16
嘉義縣,民雄鄉,興中村,139,1,1201,23,1224,1604,0,0,0,0,0,0,76.31
嘉義縣,民雄鄉,興南村,140,1,783,11,794,1097,0,0,0,0,0,0,72.38
嘉義縣,民雄鄉,興南村,141,1,566,10,576,910,0,0,0,0,0,0,63.30
嘉義縣,民雄鄉,金興村,142,1,1556,49,1605,2289,0,0,0,0,0,0,70.12
嘉義縣,民雄鄉,福興村,143,1,1139,15,1154,1607,0,0,0,0,0,0,71.81
嘉義縣,民雄鄉,文隆村,144,1,1268,17,1285,1871,0,0,0,0,0,0,68.68
嘉義縣,民雄鄉,山中村,145,1,1291,17,1308,1681,0,0,0,0,0,0,77.81
嘉義縣,民雄鄉,山中村,146,1,921,22,943,1296,0,0,0,0,0,0,72.76
嘉義縣,民雄鄉,中央村,147,1,877,6,883,1172,0,0,0,0,0,0,75.34
嘉義縣,溪口鄉,溪東村,148,1,902,21,923,1371,0,0,0,0,0,0,67.32
嘉義縣,溪口鄉,溪西村,149,1,502,9,511,783,0,0,0,0,0,0,65.26
嘉義縣,溪口鄉,溪北村,150,1,262,4,266,406,0,0,0,0,0,0,65.52
嘉義縣,溪口鄉,溪北村,151,1,189,3,192,321,0,0,0,0,0,0,59.81
嘉義縣,溪口鄉,柴林村,152,1,522,4,526,877,0,0,0,0,0,0,59.98
嘉義縣,溪口鄉,林腳村,153,1,570,4,574,916,0,0,0,0,0,0,62.66
嘉義縣,溪口鄉,美南村,154,1,737,11,748,1248,0,0,0,0,0,0,59.94
嘉義縣,溪口鄉,美北村,155,1,621,7,628,1016,0,0,0,0,0,0,61.81
嘉義縣,溪口鄉,本厝村,156,1,408,7,415,592,0,0,0,0,0,0,70.10
嘉義縣,溪口鄉,本厝村,157,1,265,3,268,394,0,0,0,0,0,0,68.02
嘉義縣,溪口鄉,游東村,158,1,671,9,680,1090,0,0,0,0,0,0,62.39
嘉義縣,溪口鄉,游西村,159,1,488,11,499,782,0,0,0,0,0,0,63.81
嘉義縣,溪口鄉,柳溝村,160,1,627,12,639,906,0,0,0,0,0,0,70.53
嘉義縣,溪口鄉,柳溝村,161,1,268,2,270,374,0,0,0,0,0,0,72.19
嘉義縣,溪口鄉,疊溪村,162,1,630,9,639,965,0,0,0,0,0,0,66.22
嘉義縣,溪口鄉,妙崙村,163,1,475,7,482,728,0,0,0,0,0,0,66.21
嘉義縣,溪口鄉,坪頂村,164,1,624,12,636,903,0,0,0,0,0,0,70.43
嘉義縣,新港鄉,宮前村,165,1,1099,10,1109,1645,0,0,0,0,0,0,67.42
嘉義縣,新港鄉,宮後村,166,1,1024,9,1033,1672,0,0,0,0,0,0,61.78
嘉義縣,新港鄉,大興村,167,1,886,13,899,1380,0,0,0,0,0,0,65.14
嘉義縣,新港鄉,福德村,168,1,891,13,904,1447,0,0,0,0,0,0,62.47
嘉義縣,新港鄉,古民村,169,1,721,11,732,1167,0,0,0,0,0,0,62.72
嘉義縣,新港鄉,中庄村,170,1,931,11,942,1501,0,0,0,0,0,0,62.76
嘉義縣,新港鄉,大潭村,171,1,1077,14,1091,1616,0,0,0,0,0,0,67.51
嘉義縣,新港鄉,西庄村,172,1,603,6,609,941,0,0,0,0,0,0,64.72
嘉義縣,新港鄉,月眉村,173,1,1115,26,1141,1630,0,0,0,0,0,0,70.00
嘉義縣,新港鄉,月潭村,174,1,967,16,983,1432,0,0,0,0,0,0,68.65
嘉義縣,新港鄉,溪北村,175,1,963,22,985,1393,0,0,0,0,0,0,70.71
嘉義縣,新港鄉,菜公村,176,1,560,5,565,854,0,0,0,0,0,0,66.16
嘉義縣,新港鄉,中洋村,177,1,671,21,692,968,0,0,0,0,0,0,71.49
嘉義縣,新港鄉,三間村,178,1,509,9,518,755,0,0,0,0,0,0,68.61
嘉義縣,新港鄉,安和村,179,1,804,12,816,1156,0,0,0,0,0,0,70.59
嘉義縣,新港鄉,潭大村,180,1,708,10,718,1117,0,0,0,0,0,0,64.28
嘉義縣,新港鄉,南港村,181,1,674,27,701,1090,0,0,0,0,0,0,64.31
嘉義縣,新港鄉,板頭村,182,1,432,6,438,627,0,0,0,0,0,0,69.86
嘉義縣,新港鄉,共和村,183,1,493,8,501,793,0,0,0,0,0,0,63.18
嘉義縣,新港鄉,埤子村,184,1,408,3,411,600,0,0,0,0,0,0,68.50
嘉義縣,新港鄉,南崙村,185,1,648,3,651,969,0,0,0,0,0,0,67.18
嘉義縣,新港鄉,北崙村,186,1,397,3,400,611,0,0,0,0,0,0,65.47
嘉義縣,新港鄉,海瀛村,187,1,342,9,351,513,0,0,0,0,0,0,68.42
嘉義縣,六腳鄉,蒜頭村,188,1,888,16,904,1273,0,0,0,0,0,0,71.01
嘉義縣,六腳鄉,蒜東村,189,1,584,9,593,936,0,0,0,0,0,0,63.35
嘉義縣,六腳鄉,蒜南村,190,1,580,11,591,881,0,0,0,0,0,0,67.08
嘉義縣,六腳鄉,工廠村,191,1,274,5,279,374,0,0,0,0,0,0,74.60
嘉義縣,六腳鄉,灣南村,192,1,848,10,858,1251,0,0,0,0,0,0,68.59
嘉義縣,六腳鄉,灣北村,193,1,851,20,871,1365,0,0,0,0,0,0,63.81
嘉義縣,六腳鄉,雙涵村,194,1,571,11,582,902,0,0,0,0,0,0,64.52
嘉義縣,六腳鄉,塗師村,195,1,472,5,477,752,0,0,0,0,0,0,63.43
嘉義縣,六腳鄉,三義村,196,1,375,9,384,622,0,0,0,0,0,0,61.74
嘉義縣,六腳鄉,三義村,197,1,132,1,133,190,0,0,0,0,0,0,70.00
嘉義縣,六腳鄉,正義村,198,1,166,3,169,265,0,0,0,0,0,0,63.77
嘉義縣,六腳鄉,正義村,199,1,214,5,219,325,0,0,0,0,0,0,67.38
嘉義縣,六腳鄉,正義村,200,1,268,3,271,417,0,0,0,0,0,0,64.99
嘉義縣,六腳鄉,正義村,201,1,336,5,341,450,0,0,0,0,0,0,75.78
嘉義縣,六腳鄉,溪厝村,202,1,394,5,399,666,0,0,0,0,0,0,59.91
嘉義縣,六腳鄉,港美村,203,1,529,6,535,788,0,0,0,0,0,0,67.89
嘉義縣,六腳鄉,豐美村,204,1,708,2,710,1106,0,0,0,0,0,0,64.20
嘉義縣,六腳鄉,六斗村,205,1,583,8,591,851,0,0,0,0,0,0,69.45
嘉義縣,六腳鄉,崙陽村,206,1,678,14,692,1065,0,0,0,0,0,0,64.98
嘉義縣,六腳鄉,蘇厝村,207,1,935,8,943,1394,0,0,0,0,0,0,67.65
嘉義縣,六腳鄉,竹本村,208,1,449,4,453,748,0,0,0,0,0,0,60.56
嘉義縣,六腳鄉,永賢村,209,1,361,5,366,608,0,0,0,0,0,0,60.20
嘉義縣,六腳鄉,魚寮村,210,1,481,2,483,845,0,0,0,0,0,0,57.16
嘉義縣,六腳鄉,潭墘村,211,1,591,17,608,964,0,0,0,0,0,0,63.07
嘉義縣,六腳鄉,六腳村,212,1,608,9,617,939,0,0,0,0,0,0,65.71
嘉義縣,六腳鄉,六南村,213,1,442,9,451,694,0,0,0,0,0,0,64.99
嘉義縣,六腳鄉,崩山村,214,1,520,9,529,836,0,0,0,0,0,0,63.28
嘉義縣,六腳鄉,古林村,215,1,599,4,603,929,0,0,0,0,0,0,64.91
嘉義縣,六腳鄉,更寮村,216,1,249,4,253,410,0,0,0,0,0,0,61.71
嘉義縣,六腳鄉,更寮村,217,1,174,1,175,270,0,0,0,0,0,0,64.81
嘉義縣,東石鄉,東石村,218,1,1176,18,1194,1658,0,0,0,0,0,0,72.01
嘉義縣,東石鄉,猿樹村,219,1,672,17,689,1009,0,0,0,0,0,0,68.29
嘉義縣,東石鄉,塭港村,220,1,1013,20,1033,1518,0,0,0,0,0,0,68.05
嘉義縣,東石鄉,型厝村,221,1,1125,16,1141,1486,0,0,0,0,0,0,76.78
嘉義縣,東石鄉,三家村,222,1,776,10,786,1250,0,0,0,0,0,0,62.88
嘉義縣,東石鄉,永屯村,223,1,447,9,456,732,0,0,0,0,0,0,62.30
嘉義縣,東石鄉,海埔村,224,1,309,1,310,482,0,0,0,0,0,0,64.32
嘉義縣,東石鄉,龍港村,225,1,633,5,638,1035,0,0,0,0,0,0,61.64
嘉義縣,東石鄉,副瀨村,226,1,768,10,778,1138,0,0,0,0,0,0,68.37
嘉義縣,東石鄉,下揖村,227,1,574,5,579,928,0,0,0,0,0,0,62.39
嘉義縣,東石鄉,頂揖村,228,1,114,0,114,196,0,0,0,0,0,0,58.16
嘉義縣,東石鄉,頂揖村,229,1,143,0,143,252,0,0,0,0,0,0,56.75
嘉義縣,東石鄉,溪下村,230,1,700,3,703,1107,0,0,0,0,0,0,63.50
嘉義縣,東石鄉,港口村,231,1,258,1,259,400,0,0,0,0,0,0,64.75
嘉義縣,東石鄉,鰲鼓村,232,1,707,9,716,1067,0,0,0,0,0,0,67.10
嘉義縣,東石鄉,鰲鼓村,233,1,182,5,187,303,0,0,0,0,0,0,61.72
嘉義縣,東石鄉,港墘村,234,1,898,11,909,1289,0,0,0,0,0,0,70.52
嘉義縣,東石鄉,蔦松村,235,1,618,13,631,924,0,0,0,0,0,0,68.29
嘉義縣,東石鄉,圍潭村,236,1,508,4,512,791,0,0,0,0,0,0,64.73
嘉義縣,東石鄉,洲仔村,237,1,605,6,611,947,0,0,0,0,0,0,64.52
嘉義縣,東石鄉,東崙村,238,1,247,4,251,408,0,0,0,0,0,0,61.52
嘉義縣,東石鄉,東崙村,239,1,259,4,263,409,0,0,0,0,0,0,64.30
嘉義縣,東石鄉,西崙村,240,1,690,15,705,1024,0,0,0,0,0,0,68.85
嘉義縣,東石鄉,塭仔村,241,1,676,9,685,993,0,0,0,0,0,0,68.98
嘉義縣,東石鄉,網寮村,242,1,862,15,877,1236,0,0,0,0,0,0,70.95
嘉義縣,東石鄉,掌潭村,243,1,292,4,296,470,0,0,0,0,0,0,62.98
嘉義縣,東石鄉,掌潭村,244,1,272,2,274,366,0,0,0,0,0,0,74.86
嘉義縣,義竹鄉,岸腳村,245,1,616,15,631,872,0,0,0,0,0,0,72.36
嘉義縣,義竹鄉,義竹村,246,1,1137,9,1146,1568,0,0,0,0,0,0,73.09
嘉義縣,義竹鄉,六桂村,247,1,1007,18,1025,1393,0,0,0,0,0,0,73.58
嘉義縣,義竹鄉,仁里村,248,1,705,6,711,909,0,0,0,0,0,0,78.22
嘉義縣,義竹鄉,傳芳村,249,1,504,11,515,703,0,0,0,0,0,0,73.26
嘉義縣,義竹鄉,頭竹村,250,1,952,12,964,1291,0,0,0,0,0,0,74.67
嘉義縣,義竹鄉,五厝村,251,1,290,2,292,434,0,0,0,0,0,0,67.28
嘉義縣,義竹鄉,中平村,252,1,269,2,271,392,0,0,0,0,0,0,69.13
嘉義縣,義竹鄉,中平村,253,1,96,0,96,131,0,0,0,0,0,0,73.28
嘉義縣,義竹鄉,埤前村,254,1,594,6,600,833,0,0,0,0,0,0,72.03
嘉義縣,義竹鄉,平溪村,255,1,303,3,306,433,0,0,0,0,0,0,70.67
嘉義縣,義竹鄉,後鎮村,256,1,380,3,383,510,0,0,0,0,0,0,75.10
嘉義縣,義竹鄉,北華村,257,1,407,5,412,580,0,0,0,0,0,0,71.03
嘉義縣,義竹鄉,新店村,258,1,1153,6,1159,1507,0,0,0,0,0,0,76.91
嘉義縣,義竹鄉,東過村,259,1,617,7,624,882,0,0,0,0,0,0,70.75
嘉義縣,義竹鄉,西過村,260,1,632,6,638,947,0,0,0,0,0,0,67.37
嘉義縣,義竹鄉,官和村,261,1,623,2,625,849,0,0,0,0,0,0,73.62
嘉義縣,義竹鄉,官順村,262,1,377,9,386,554,0,0,0,0,0,0,69.68
嘉義縣,義竹鄉,新富村,263,1,439,10,449,572,0,0,0,0,0,0,78.50
嘉義縣,義竹鄉,東光村,264,1,543,2,545,746,0,0,0,0,0,0,73.06
嘉義縣,義竹鄉,東光村,265,1,116,0,116,173,0,0,0,0,0,0,67.05
嘉義縣,義竹鄉,東榮村,266,1,359,3,362,526,0,0,0,0,0,0,68.82
嘉義縣,義竹鄉,龍蛟村,267,1,515,4,519,761,0,0,0,0,0,0,68.20
嘉義縣,義竹鄉,溪洲村,268,1,552,6,558,797,0,0,0,0,0,0,70.01
嘉義縣,鹿草鄉,後寮村,269,1,364,9,373,497,0,0,0,0,0,0,75.05
嘉義縣,鹿草鄉,鹿東村,270,1,471,7,478,641,0,0,0,0,0,0,74.57
嘉義縣,鹿草鄉,鹿草村,271,1,902,21,923,1269,0,0,0,0,0,0,72.73
嘉義縣,鹿草鄉,西井村,272,1,806,23,829,1166,0,0,0,0,0,0,71.10
嘉義縣,鹿草鄉,豐稠村,273,1,190,1,191,283,0,0,0,0,0,0,67.49
嘉義縣,鹿草鄉,豐稠村,274,1,82,3,85,129,0,0,0,0,0,0,65.89
嘉義縣,鹿草鄉,重寮村,275,1,773,11,784,1149,0,0,0,0,0,0,68.23
嘉義縣,鹿草鄉,施家村,276,1,369,2,371,553,0,0,0,0,0,0,67.09
嘉義縣,鹿草鄉,下潭村,277,1,615,15,630,955,0,0,0,0,0,0,65.97
嘉義縣,鹿草鄉,光潭村,278,1,793,16,809,1162,0,0,0,0,0,0,69.62
嘉義縣,鹿草鄉,碧潭村,279,1,713,12,725,1113,0,0,0,0,0,0,65.14
嘉義縣,鹿草鄉,松竹村,280,1,676,14,690,941,0,0,0,0,0,0,73.33
嘉義縣,鹿草鄉,竹山村,281,1,466,5,471,684,0,0,0,0,0,0,68.86
嘉義縣,鹿草鄉,竹山村,282,1,165,3,168,236,0,0,0,0,0,0,71.19
嘉義縣,鹿草鄉,後堀村,283,1,735,16,751,1009,0,0,0,0,0,0,74.43
嘉義縣,鹿草鄉,後堀村,284,1,241,2,243,328,0,0,0,0,0,0,74.09
嘉義縣,鹿草鄉,三角村,285,1,817,19,836,1166,0,0,0,0,0,0,71.70
嘉義縣,鹿草鄉,三角村,286,1,281,4,285,381,0,0,0,0,0,0,74.80
嘉義縣,鹿草鄉,下麻村,287,1,218,2,220,296,0,0,0,0,0,0,74.32
嘉義縣,鹿草鄉,下麻村,288,1,210,3,213,293,0,0,0,0,0,0,72.70
嘉義縣,水上鄉,水上村,289,1,384,10,394,553,0,0,0,0,0,0,71.25
嘉義縣,水上鄉,水上村,290,1,521,10,531,705,0,0,0,0,0,0,75.32
嘉義縣,水上鄉,水上村,291,1,964,20,984,1474,0,0,0,0,0,0,66.76
嘉義縣,水上鄉,水頭村,292,1,973,17,990,1388,0,0,0,0,0,0,71.33
嘉義縣,水上鄉,水頭村,293,1,359,7,366,498,0,0,0,0,0,0,73.49
嘉義縣,水上鄉,粗溪村,294,1,731,13,744,1049,0,0,0,0,0,0,70.92
嘉義縣,水上鄉,粗溪村,295,1,278,7,285,378,0,0,0,0,0,0,75.40
嘉義縣,水上鄉,下寮村,296,1,337,8,345,461,0,0,0,0,0,0,74.84
嘉義縣,水上鄉,下寮村,297,1,778,18,796,1101,0,0,0,0,0,0,72.30
嘉義縣,水上鄉,三和村,298,1,776,19,795,1107,0,0,0,0,0,0,71.82
嘉義縣,水上鄉,三和村,299,1,466,7,473,622,0,0,0,0,0,0,76.05
嘉義縣,水上鄉,回歸村,300,1,508,14,522,682,0,0,0,0,0,0,76.54
嘉義縣,水上鄉,大堀村,301,1,378,5,383,479,0,0,0,0,0,0,79.96
嘉義縣,水上鄉,大堀村,302,1,393,5,398,533,0,0,0,0,0,0,74.67
嘉義縣,水上鄉,大堀村,303,1,262,2,264,343,0,0,0,0,0,0,76.97
嘉義縣,水上鄉,大崙村,304,1,1286,18,1304,1828,0,0,0,0,0,0,71.33
嘉義縣,水上鄉,塗溝村,305,1,641,7,648,797,0,0,0,0,0,0,81.30
嘉義縣,水上鄉,龍德村,306,1,1282,25,1307,1680,0,0,0,0,0,0,77.80
嘉義縣,水上鄉,溪洲村,307,1,741,8,749,1030,0,0,0,0,0,0,72.72
嘉義縣,水上鄉,三鎮村,308,1,489,7,496,635,0,0,0,0,0,0,78.11
嘉義縣,水上鄉,靖和村,309,1,441,5,446,558,0,0,0,0,0,0,79.93
嘉義縣,水上鄉,南和村,310,1,615,10,625,813,0,0,0,0,0,0,76.88
嘉義縣,水上鄉,南和村,311,1,278,7,285,397,0,0,0,0,0,0,71.79
嘉義縣,水上鄉,柳新村,312,1,954,22,976,1390,0,0,0,0,0,0,70.22
嘉義縣,水上鄉,柳新村,313,1,575,10,585,759,0,0,0,0,0,0,77.08
嘉義縣,水上鄉,柳林村,314,1,1120,28,1148,1704,0,0,0,0,0,0,67.37
嘉義縣,水上鄉,柳鄉村,315,1,1181,33,1214,1739,0,0,0,0,0,0,69.81
嘉義縣,水上鄉,內溪村,316,1,693,12,705,974,0,0,0,0,0,0,72.38
嘉義縣,水上鄉,寬士村,317,1,1097,24,1121,1622,0,0,0,0,0,0,69.11
嘉義縣,水上鄉,寬士村,318,1,932,23,955,1586,0,0,0,0,0,0,60.21
嘉義縣,水上鄉,民生村,319,1,841,15,856,1286,0,0,0,0,0,0,66.56
嘉義縣,水上鄉,民生村,320,1,1032,28,1060,1540,0,0,0,0,0,0,68.83
嘉義縣,水上鄉,義興村,321,1,547,15,562,759,0,0,0,0,0,0,74.04
嘉義縣,水上鄉,中庄村,322,1,1228,30,1258,1755,0,0,0,0,0,0,71.68
嘉義縣,水上鄉,忠和村,323,1,1243,30,1273,1772,0,0,0,0,0,0,71.84
嘉義縣,水上鄉,南鄉村,324,1,583,19,602,805,0,0,0,0,0,0,74.78
嘉義縣,水上鄉,三界村,325,1,746,14,760,1040,0,0,0,0,0,0,73.08
嘉義縣,水上鄉,國姓村,326,1,854,23,877,1307,0,0,0,0,0,0,67.10
嘉義縣,中埔鄉,中埔村,327,1,1136,18,1154,1580,0,0,0,0,0,0,73.04
嘉義縣,中埔鄉,鹽館村,328,1,525,7,532,758,0,0,0,0,0,0,70.18
嘉義縣,中埔鄉,龍門村,329,1,509,13,522,729,0,0,0,0,0,0,71.60
嘉義縣,中埔鄉,裕民村,330,1,534,6,540,844,0,0,0,0,0,0,63.98
嘉義縣,中埔鄉,金蘭村,331,1,836,10,846,1317,0,0,0,0,0,0,64.24
嘉義縣,中埔鄉,富收村,332,1,614,9,623,1037,0,0,0,0,0,0,60.08
嘉義縣,中埔鄉,富收村,333,1,823,15,838,1372,0,0,0,0,0,0,61.08
嘉義縣,中埔鄉,和睦村,334,1,548,12,560,992,0,0,0,0,0,0,56.45
嘉義縣,中埔鄉,和睦村,335,1,813,24,837,1252,0,0,0,0,0,0,66.85
嘉義縣,中埔鄉,和美村,336,1,1038,21,1059,1633,0,0,0,0,0,0,64.85
嘉義縣,中埔鄉,和美村,337,1,903,24,927,1606,0,0,0,0,0,0,57.72
嘉義縣,中埔鄉,和美村,338,1,1084,27,1111,1762,0,0,0,0,0,0,63.05
嘉義縣,中埔鄉,和興村,339,1,1211,38,1249,2052,0,0,0,0,0,0,60.87
嘉義縣,中埔鄉,和興村,340,1,825,19,844,1438,0,0,0,0,0,0,58.69
嘉義縣,中埔鄉,和興村,341,1,640,14,654,1076,0,0,0,0,0,0,60.78
嘉義縣,中埔鄉,隆興村,342,1,1121,15,1136,1653,0,0,0,0,0,0,68.72
嘉義縣,中埔鄉,義仁村,343,1,866,10,876,1240,0,0,0,0,0,0,70.65
嘉義縣,中埔鄉,社口村,344,1,993,20,1013,1558,0,0,0,0,0,0,65.02
嘉義縣,中埔鄉,社口村,345,1,326,5,331,473,0,0,0,0,0,0,69.98
嘉義縣,中埔鄉,灣潭村,346,1,824,11,835,1099,0,0,0,0,0,0,75.98
嘉義縣,中埔鄉,石弄村,347,1,659,4,663,852,0,0,0,0,0,0,77.82
嘉義縣,中埔鄉,石弄村,348,1,224,2,226,312,0,0,0,0,0,0,72.44
嘉義縣,中埔鄉,頂埔村,349,1,672,17,689,910,0,0,0,0,0,0,75.71
嘉義縣,中埔鄉,同仁村,350,1,829,13,842,1203,0,0,0,0,0,0,69.99
嘉義縣,中埔鄉,同仁村,351,1,435,8,443,658,0,0,0,0,0,0,67.33
嘉義縣,中埔鄉,深坑村,352,1,542,11,553,738,0,0,0,0,0,0,74.93
嘉義縣,中埔鄉,三層村,353,1,445,10,455,612,0,0,0,0,0,0,74.35
嘉義縣,中埔鄉,瑞豐村,354,1,519,7,526,687,0,0,0,0,0,0,76.56
嘉義縣,中埔鄉,沄水村,355,1,376,6,382,521,0,0,0,0,0,0,73.32
嘉義縣,中埔鄉,沄水村,356,1,378,6,384,583,0,0,0,0,0,0,65.87
嘉義縣,中埔鄉,東興村,357,1,185,2,187,336,0,0,0,0,0,0,55.65
嘉義縣,中埔鄉,中崙村,358,1,233,8,241,319,0,0,0,0,0,0,75.55
嘉義縣,竹崎鄉,竹崎村,359,1,736,9,745,1110,0,0,0,0,0,0,67.12
嘉義縣,竹崎鄉,竹崎村,360,1,684,10,694,985,0,0,0,0,0,0,70.46
嘉義縣,竹崎鄉,和平村,361,1,1261,18,1279,1765,0,0,0,0,0,0,72.46
嘉義縣,竹崎鄉,坑頭村,362,1,555,11,566,741,0,0,0,0,0,0,76.38
嘉義縣,竹崎鄉,沙坑村,363,1,632,7,639,851,0,0,0,0,0,0,75.09
嘉義縣,竹崎鄉,獅埜村,364,1,908,16,924,1261,0,0,0,0,0,0,73.28
嘉義縣,竹崎鄉,義和村,365,1,428,5,433,566,0,0,0,0,0,0,76.50
嘉義縣,竹崎鄉,義仁村,366,1,740,11,751,1061,0,0,0,0,0,0,70.78
嘉義縣,竹崎鄉,灣橋村,367,1,705,10,715,1111,0,0,0,0,0,0,64.36
嘉義縣,竹崎鄉,灣橋村,368,1,1114,19,1133,1638,0,0,0,0,0,0,69.17
嘉義縣,竹崎鄉,灣橋村,369,1,888,16,904,1547,0,0,0,0,0,0,58.44
嘉義縣,竹崎鄉,鹿滿村,370,1,821,12,833,1224,0,0,0,0,0,0,68.06
嘉義縣,竹崎鄉,紫雲村,371,1,862,13,875,1298,0,0,0,0,0,0,67.41
嘉義縣,竹崎鄉,內埔村,372,1,1129,16,1145,1633,0,0,0,0,0,0,70.12
嘉義縣,竹崎鄉,昇平村,373,1,505,7,512,678,0,0,0,0,0,0,75.52
嘉義縣,竹崎鄉,昇平村,374,1,738,15,753,1008,0,0,0,0,0,0,74.70
嘉義縣,竹崎鄉,桃源村,375,1,493,6,499,702,0,0,0,0,0,0,71.08
嘉義縣,竹崎鄉,桃源村,376,1,244,3,247,364,0,0,0,0,0,0,67.86
嘉義縣,竹崎鄉,白杞村,377,1,468,4,472,762,0,0,0,0,0,0,61.94
嘉義縣,竹崎鄉,塘興村,378,1,354,9,363,509,0,0,0,0,0,0,71.32
嘉義縣,竹崎鄉,塘興村,379,1,288,7,295,369,0,0,0,0,0,0,79.95
嘉義縣,竹崎鄉,義隆村,380,1,421,3,424,558,0,0,0,0,0,0,75.99
嘉義縣,竹崎鄉,龍山村,381,1,166,4,170,239,0,0,0,0,0,0,71.13
嘉義縣,竹崎鄉,龍山村,382,1,993,20,1013,1372,0,0,0,0,0,0,73.83
嘉義縣,竹崎鄉,文峰村,383,1,533,10,543,783,0,0,0,0,0,0,69.35
嘉義縣,竹崎鄉,金獅村,384,1,328,3,331,501,0,0,0,0,0,0,66.07
嘉義縣,竹崎鄉,復金村,385,1,632,8,640,911,0,0,0,0,0,0,70.25
嘉義縣,竹崎鄉,復金村,386,1,626,7,633,890,0,0,0,0,0,0,71.12
嘉義縣,竹崎鄉,緞繻村,387,1,586,6,592,934,0,0,0,0,0,0,63.38
嘉義縣,竹崎鄉,緞繻村,388,1,71,1,72,150,0,0,0,0,0,0,48.00
嘉義縣,竹崎鄉,仁壽村,389,1,171,1,172,312,0,0,0,0,0,0,55.13
嘉義縣,竹崎鄉,中和村,390,1,219,0,219,402,0,0,0,0,0,0,54.48
嘉義縣,竹崎鄉,中和村,391,1,233,2,235,388,0,0,0,0,0,0,60.57
嘉義縣,竹崎鄉,光華村,392,1,316,4,320,440,0,0,0,0,0,0,72.73
嘉義縣,竹崎鄉,光華村,393,1,183,2,185,315,0,0,0,0,0,0,58.73
嘉義縣,梅山鄉,梅東村,394,1,816,17,833,1193,0,0,0,0,0,0,69.82
嘉義縣,梅山鄉,梅東村,395,1,851,17,868,1231,0,0,0,0,0,0,70.51
嘉義縣,梅山鄉,梅南村,396,1,741,9,750,1005,0,0,0,0,0,0,74.63
嘉義縣,梅山鄉,梅北村,397,1,814,13,827,1176,0,0,0,0,0,0,70.32
嘉義縣,梅山鄉,梅北村,398,1,788,17,805,1188,0,0,0,0,0,0,67.76
嘉義縣,梅山鄉,梅北村,399,1,761,18,779,1132,0,0,0,0,0,0,68.82
嘉義縣,梅山鄉,過山村,400,1,447,5,452,601,0,0,0,0,0,0,75.21
嘉義縣,梅山鄉,圳南村,401,1,385,6,391,525,0,0,0,0,0,0,74.48
嘉義縣,梅山鄉,圳北村,402,1,461,6,467,679,0,0,0,0,0,0,68.78
嘉義縣,梅山鄉,雙溪村,403,1,460,3,463,573,0,0,0,0,0,0,80.80
嘉義縣,梅山鄉,大南村,404,1,1130,15,1145,1662,0,0,0,0,0,0,68.89
嘉義縣,梅山鄉,安靖村,405,1,685,6,691,960,0,0,0,0,0,0,71.98
嘉義縣,梅山鄉,永興村,406,1,358,3,361,527,0,0,0,0,0,0,68.50
嘉義縣,梅山鄉,半天村,407,1,378,12,390,500,0,0,0,0,0,0,78.00
嘉義縣,梅山鄉,太平村,408,1,353,8,361,505,0,0,0,0,0,0,71.49
嘉義縣,梅山鄉,太興村,409,1,296,3,299,424,0,0,0,0,0,0,70.52
嘉義縣,梅山鄉,龍眼村,410,1,316,6,322,485,0,0,0,0,0,0,66.39
嘉義縣,梅山鄉,碧湖村,411,1,198,1,199,322,0,0,0,0,0,0,61.80
嘉義縣,梅山鄉,瑞峰村,412,1,520,5,525,732,0,0,0,0,0,0,71.72
嘉義縣,梅山鄉,瑞里村,413,1,556,15,571,754,0,0,0,0,0,0,75.73
嘉義縣,梅山鄉,太和村,414,1,381,8,389,575,0,0,0,0,0,0,67.65
嘉義縣,梅山鄉,太和村,415,1,325,3,328,459,0,0,0,0,0,0,71.46
嘉義縣,番路鄉,江西村,416,1,695,11,706,962,0,0,0,0,0,0,73.39
嘉義縣,番路鄉,內甕村,417,1,239,3,242,362,0,0,0,0,0,0,66.85
嘉義縣,番路鄉,新福村,418,1,560,4,564,782,0,0,0,0,0,0,72.12
嘉義縣,番路鄉,下坑村,419,1,976,14,990,1569,0,0,0,0,0,0,63.10
嘉義縣,番路鄉,番路村,420,1,597,7,604,799,0,0,0,0,0,0,75.59
嘉義縣,番路鄉,民和村,421,1,555,4,559,786,0,0,0,0,0,0,71.12
嘉義縣,番路鄉,觸口村,422,1,571,8,579,856,0,0,0,0,0,0,67.64
嘉義縣,番路鄉,大湖村,423,1,455,5,460,865,0,0,0,0,0,0,53.18
嘉義縣,番路鄉,公田村,424,1,239,1,240,420,0,0,0,0,0,0,57.14
嘉義縣,番路鄉,公田村,425,1,315,8,323,501,0,0,0,0,0,0,64.47
嘉義縣,番路鄉,公興村,426,1,331,2,333,617,0,0,0,0,0,0,53.97
嘉義縣,番路鄉,草山村,427,1,116,0,116,168,0,0,0,0,0,0,69.05
嘉義縣,番路鄉,草山村,428,1,112,1,113,223,0,0,0,0,0,0,50.67
嘉義縣,大埔鄉,大埔村,429,1,544,4,548,992,0,0,0,0,0,0,55.24
嘉義縣,大埔鄉,和平村,430,1,125,1,126,243,0,0,0,0,0,0,51.85
嘉義縣,大埔鄉,和平村,431,1,132,1,133,231,0,0,0,0,0,0,57.58
嘉義縣,大埔鄉,永樂村,432,1,98,2,100,160,0,0,0,0,0,0,62.50
嘉義縣,大埔鄉,永樂村,433,1,90,1,91,134,0,0,0,0,0,0,67.91
嘉義縣,大埔鄉,茄苳村,434,1,191,3,194,354,0,0,0,0,0,0,54.80
嘉義縣,大埔鄉,茄苳村,435,1,86,2,88,137,0,0,0,0,0,0,64.23
嘉義縣,大埔鄉,茄苳村,436,1,109,2,111,238,0,0,0,0,0,0,46.64
嘉義縣,大埔鄉,西興村,437,1,205,2,207,382,0,0,0,0,0,0,54.19
嘉義縣,阿里山鄉,中山村,438,1,198,3,201,362,0,0,0,0,0,0,55.52
嘉義縣,阿里山鄉,中正村,439,1,97,0,97,186,0,0,0,0,0,0,52.15
嘉義縣,阿里山鄉,香林村,440,1,125,0,125,221,0,0,0,0,0,0,56.56
嘉義縣,阿里山鄉,十字村,441,1,106,0,106,232,0,0,0,0,0,0,45.69
嘉義縣,阿里山鄉,十字村,442,1,29,0,29,68,0,0,0,0,0,0,42.65
嘉義縣,阿里山鄉,豐山村,443,1,178,4,182,263,0,0,0,0,0,0,69.20
嘉義縣,阿里山鄉,達邦村,444,1,69,1,70,141,0,0,0,0,0,0,49.65
嘉義縣,阿里山鄉,樂野村,445,1,165,6,171,260,0,0,0,0,0,0,65.77
嘉義縣,阿里山鄉,來吉村,446,1,16,0,16,22,0,0,0,0,0,0,72.73
嘉義縣,阿里山鄉,里佳村,447,1,12,0,12,23,0,0,0,0,0,0,52.17
嘉義縣,阿里山鄉,山美村,448,1,10,1,11,27,0,0,0,0,0,0,40.74
嘉義縣,阿里山鄉,新美村,449,1,11,0,11,20,0,0,0,0,0,0,55.00
嘉義縣,阿里山鄉,茶山村,450,1,53,0,53,95,0,0,0,0,0,0,55.79
臺南縣,新營市,忠政里,1,1,744,14,758,1281,0,0,0,0,0,0,59.17
臺南縣,新營市,忠政里,2,1,770,6,776,1293,0,0,0,0,0,0,60.02
臺南縣,新營市,忠政里,3,1,838,8,846,1431,0,0,0,0,0,0,59.12
臺南縣,新營市,民權里,4,1,729,4,733,1219,0,0,0,0,0,0,60.13
臺南縣,新營市,民權里,5,1,724,12,736,1215,0,0,0,0,0,0,60.58
臺南縣,新營市,三仙里,6,1,841,14,855,1383,0,0,0,0,0,0,61.82
臺南縣,新營市,三仙里,7,1,746,9,755,1312,0,0,0,0,0,0,57.55
臺南縣,新營市,好平里,8,1,523,8,531,915,0,0,0,0,0,0,58.03
臺南縣,新營市,延平里,9,1,766,12,778,1316,0,0,0,0,0,0,59.12
臺南縣,新營市,永生里,10,1,668,6,674,1019,0,0,0,0,0,0,66.14
臺南縣,新營市,大宏里,11,1,587,7,594,1071,0,0,0,0,0,0,55.46
臺南縣,新營市,大宏里,12,1,585,6,591,1005,0,0,0,0,0,0,58.81
臺南縣,新營市,大宏里,13,1,615,9,624,1108,0,0,0,0,0,0,56.32
臺南縣,新營市,王公里,14,1,663,12,675,1143,0,0,0,0,0,0,59.06
臺南縣,新營市,王公里,15,1,651,9,660,1182,0,0,0,0,0,0,55.84
臺南縣,新營市,王公里,16,1,590,9,599,1060,0,0,0,0,0,0,56.51
臺南縣,新營市,王公里,17,1,493,10,503,856,0,0,0,0,0,0,58.76
臺南縣,新營市,王公里,18,1,541,5,546,893,0,0,0,0,0,0,61.14
臺南縣,新營市,中營里,19,1,483,7,490,825,0,0,0,0,0,0,59.39
臺南縣,新營市,土庫里,20,1,837,13,850,1387,0,0,0,0,0,0,61.28
臺南縣,新營市,興安里,21,1,339,3,342,553,0,0,0,0,0,0,61.84
臺南縣,新營市,南興里,22,1,751,6,757,1179,0,0,0,0,0,0,64.21
臺南縣,新營市,南興里,23,1,680,7,687,1227,0,0,0,0,0,0,55.99
臺南縣,新營市,興業里,24,1,931,10,941,1426,0,0,0,0,0,0,65.99
臺南縣,新營市,民生里,25,1,844,9,853,1488,0,0,0,0,0,0,57.33
臺南縣,新營市,民生里,26,1,753,9,762,1427,0,0,0,0,0,0,53.40
臺南縣,新營市,新北里,27,1,837,12,849,1407,0,0,0,0,0,0,60.34
臺南縣,新營市,新北里,28,1,775,9,784,1406,0,0,0,0,0,0,55.76
臺南縣,新營市,新南里,29,1,644,12,656,1088,0,0,0,0,0,0,60.29
臺南縣,新營市,新南里,30,1,567,6,573,1089,0,0,0,0,0,0,52.62
臺南縣,新營市,民榮里,31,1,618,9,627,1061,0,0,0,0,0,0,59.10
臺南縣,新營市,民榮里,32,1,633,5,638,1153,0,0,0,0,0,0,55.33
臺南縣,新營市,民榮里,33,1,845,12,857,1470,0,0,0,0,0,0,58.30
臺南縣,新營市,埤寮里,34,1,967,6,973,1488,0,0,0,0,0,0,65.39
臺南縣,新營市,護鎮里,35,1,742,6,748,1210,0,0,0,0,0,0,61.82
臺南縣,新營市,太南里,36,1,822,14,836,1380,0,0,0,0,0,0,60.58
臺南縣,新營市,太北里,37,1,928,9,937,1481,0,0,0,0,0,0,63.27
臺南縣,新營市,南紙里,38,1,862,14,876,1326,0,0,0,0,0,0,66.06
臺南縣,新營市,南紙里,39,1,659,8,667,1164,0,0,0,0,0,0,57.30
臺南縣,新營市,嘉芳里,40,1,865,22,887,1369,0,0,0,0,0,0,64.79
臺南縣,新營市,舊埔里,41,1,241,2,243,362,0,0,0,0,0,0,67.13
臺南縣,新營市,角帶里,42,1,344,4,348,453,0,0,0,0,0,0,76.82
臺南縣,新營市,鐵線里,43,1,508,11,519,746,0,0,0,0,0,0,69.57
臺南縣,新營市,五興里,44,1,657,13,670,970,0,0,0,0,0,0,69.07
臺南縣,新營市,姑爺里,45,1,397,3,400,572,0,0,0,0,0,0,69.93
臺南縣,鹽水鎮,水秀里,46,1,516,5,521,830,0,0,0,0,0,0,62.77
臺南縣,鹽水鎮,水秀里,47,1,314,3,317,487,0,0,0,0,0,0,65.09
臺南縣,鹽水鎮,福得里,48,1,365,5,370,528,0,0,0,0,0,0,70.08
臺南縣,鹽水鎮,三生里,49,1,265,2,267,388,0,0,0,0,0,0,68.81
臺南縣,鹽水鎮,武廟里,50,1,384,3,387,598,0,0,0,0,0,0,64.72
臺南縣,鹽水鎮,中境里,51,1,372,4,376,545,0,0,0,0,0,0,68.99
臺南縣,鹽水鎮,水仙里,52,1,286,1,287,418,0,0,0,0,0,0,68.66
臺南縣,鹽水鎮,水正里,53,1,500,8,508,772,0,0,0,0,0,0,65.80
臺南縣,鹽水鎮,橋南里,54,1,363,9,372,632,0,0,0,0,0,0,58.86
臺南縣,鹽水鎮,橋南里,55,1,694,10,704,1186,0,0,0,0,0,0,59.36
臺南縣,鹽水鎮,橋南里,56,1,640,11,651,1153,0,0,0,0,0,0,56.46
臺南縣,鹽水鎮,舊營里,57,1,422,8,430,729,0,0,0,0,0,0,58.98
臺南縣,鹽水鎮,汫水里,58,1,637,8,645,996,0,0,0,0,0,0,64.76
臺南縣,鹽水鎮,岸內里,59,1,510,6,516,837,0,0,0,0,0,0,61.65
臺南縣,鹽水鎮,岸內里,60,1,802,15,817,1206,0,0,0,0,0,0,67.74
臺南縣,鹽水鎮,岸內里,61,1,699,3,702,1019,0,0,0,0,0,0,68.89
臺南縣,鹽水鎮,義稠里,62,1,457,6,463,619,0,0,0,0,0,0,74.80
臺南縣,鹽水鎮,下中里,63,1,477,1,478,774,0,0,0,0,0,0,61.76
臺南縣,鹽水鎮,歡雅里,64,1,523,9,532,815,0,0,0,0,0,0,65.28
臺南縣,鹽水鎮,歡雅里,65,1,479,5,484,759,0,0,0,0,0,0,63.77
臺南縣,鹽水鎮,大莊里,66,1,327,7,334,543,0,0,0,0,0,0,61.51
臺南縣,鹽水鎮,桐寮里,67,1,204,3,207,292,0,0,0,0,0,0,70.89
臺南縣,鹽水鎮,後宅里,68,1,439,5,444,695,0,0,0,0,0,0,63.88
臺南縣,鹽水鎮,孫厝里,69,1,290,6,296,480,0,0,0,0,0,0,61.67
臺南縣,鹽水鎮,竹埔里,70,1,588,10,598,855,0,0,0,0,0,0,69.94
臺南縣,鹽水鎮,下林里,71,1,275,6,281,424,0,0,0,0,0,0,66.27
臺南縣,鹽水鎮,田寮里,72,1,181,2,183,290,0,0,0,0,0,0,63.10
臺南縣,鹽水鎮,大豐里,73,1,287,3,290,382,0,0,0,0,0,0,75.92
臺南縣,鹽水鎮,飯店里,74,1,299,2,301,437,0,0,0,0,0,0,68.88
臺南縣,鹽水鎮,河南里,75,1,396,7,403,628,0,0,0,0,0,0,64.17
臺南縣,鹽水鎮,南港里,76,1,676,10,686,944,0,0,0,0,0,0,72.67
臺南縣,白河鎮,白河里,77,1,710,7,717,1283,0,0,0,0,0,0,55.88
臺南縣,白河鎮,白河里,78,1,373,4,377,599,0,0,0,0,0,0,62.94
臺南縣,白河鎮,永安里,79,1,846,12,858,1521,0,0,0,0,0,0,56.41
臺南縣,白河鎮,永安里,80,1,642,6,648,1144,0,0,0,0,0,0,56.64
臺南縣,白河鎮,外角里,81,1,887,15,902,1426,0,0,0,0,0,0,63.25
臺南縣,白河鎮,庄內里,82,1,904,9,913,1460,0,0,0,0,0,0,62.53
臺南縣,白河鎮,秀祐里,83,1,516,6,522,850,0,0,0,0,0,0,61.41
臺南縣,白河鎮,河東里,84,1,790,15,805,1347,0,0,0,0,0,0,59.76
臺南縣,白河鎮,虎山里,85,1,270,3,273,478,0,0,0,0,0,0,57.11
臺南縣,白河鎮,大林里,86,1,385,2,387,636,0,0,0,0,0,0,60.85
臺南縣,白河鎮,崁頭里,87,1,336,5,341,504,0,0,0,0,0,0,67.66
臺南縣,白河鎮,六溪里,88,1,352,4,356,667,0,0,0,0,0,0,53.37
臺南縣,白河鎮,關嶺里,89,1,718,8,726,1284,0,0,0,0,0,0,56.54
臺南縣,白河鎮,仙草里,90,1,462,9,471,798,0,0,0,0,0,0,59.02
臺南縣,白河鎮,仙草里,91,1,317,6,323,592,0,0,0,0,0,0,54.56
臺南縣,白河鎮,仙草里,92,1,643,9,652,918,0,0,0,0,0,0,71.02
臺南縣,白河鎮,玉豐里,93,1,796,9,805,1193,0,0,0,0,0,0,67.48
臺南縣,白河鎮,大竹里,94,1,879,6,885,1345,0,0,0,0,0,0,65.80
臺南縣,白河鎮,詔安里,95,1,578,11,589,889,0,0,0,0,0,0,66.25
臺南縣,白河鎮,廣安里,96,1,419,6,425,693,0,0,0,0,0,0,61.33
臺南縣,白河鎮,蓮潭里,97,1,622,8,630,922,0,0,0,0,0,0,68.33
臺南縣,白河鎮,竹門里,98,1,607,6,613,958,0,0,0,0,0,0,63.99
臺南縣,白河鎮,崎內里,99,1,515,2,517,822,0,0,0,0,0,0,62.90
臺南縣,白河鎮,昇安里,100,1,816,8,824,1282,0,0,0,0,0,0,64.27
臺南縣,白河鎮,汴頭里,101,1,465,6,471,771,0,0,0,0,0,0,61.09
臺南縣,白河鎮,內角里,102,1,515,7,522,792,0,0,0,0,0,0,65.91
臺南縣,白河鎮,草店里,103,1,585,7,592,932,0,0,0,0,0,0,63.52
臺南縣,白河鎮,甘宅里,104,1,425,5,430,719,0,0,0,0,0,0,59.81
臺南縣,柳營鄉,士林村,105,1,940,11,951,1424,0,0,0,0,0,0,66.78
臺南縣,柳營鄉,光福村,106,1,557,8,565,823,0,0,0,0,0,0,68.65
臺南縣,柳營鄉,光福村,107,1,614,11,625,930,0,0,0,0,0,0,67.20
臺南縣,柳營鄉,中埕村,108,1,500,5,505,704,0,0,0,0,0,0,71.73
臺南縣,柳營鄉,東昇村,109,1,823,13,836,1195,0,0,0,0,0,0,69.96
臺南縣,柳營鄉,東昇村,110,1,780,12,792,1200,0,0,0,0,0,0,66.00
臺南縣,柳營鄉,八翁村,111,1,851,11,862,1203,0,0,0,0,0,0,71.65
臺南縣,柳營鄉,人和村,112,1,310,2,312,457,0,0,0,0,0,0,68.27
臺南縣,柳營鄉,人和村,113,1,201,3,204,297,0,0,0,0,0,0,68.69
臺南縣,柳營鄉,太康村,114,1,550,7,557,769,0,0,0,0,0,0,72.43
臺南縣,柳營鄉,太康村,115,1,525,6,531,746,0,0,0,0,0,0,71.18
臺南縣,柳營鄉,重溪村,116,1,996,12,1008,1461,0,0,0,0,0,0,68.99
臺南縣,柳營鄉,重溪村,117,1,208,2,210,307,0,0,0,0,0,0,68.40
臺南縣,柳營鄉,篤農村,118,1,911,19,930,1395,0,0,0,0,0,0,66.67
臺南縣,柳營鄉,大農村,119,1,468,11,479,650,0,0,0,0,0,0,73.69
臺南縣,柳營鄉,神農村,120,1,733,11,744,1165,0,0,0,0,0,0,63.86
臺南縣,柳營鄉,神農村,121,1,159,2,161,224,0,0,0,0,0,0,71.88
臺南縣,柳營鄉,果毅村,122,1,727,9,736,1093,0,0,0,0,0,0,67.34
臺南縣,柳營鄉,果毅村,123,1,121,0,121,154,0,0,0,0,0,0,78.57
臺南縣,柳營鄉,旭山村,124,1,598,6,604,995,0,0,0,0,0,0,60.70
臺南縣,柳營鄉,旭山村,125,1,344,4,348,481,0,0,0,0,0,0,72.35
臺南縣,柳營鄉,旭山村,126,1,140,2,142,197,0,0,0,0,0,0,72.08
臺南縣,後壁鄉,後壁村,127,1,456,4,460,698,0,0,0,0,0,0,65.90
臺南縣,後壁鄉,後壁村,128,1,503,6,509,764,0,0,0,0,0,0,66.62
臺南縣,後壁鄉,侯伯村,129,1,469,2,471,731,0,0,0,0,0,0,64.43
臺南縣,後壁鄉,侯伯村,130,1,347,2,349,521,0,0,0,0,0,0,66.99
臺南縣,後壁鄉,嘉苳村,131,1,656,15,671,1058,0,0,0,0,0,0,63.42
臺南縣,後壁鄉,嘉苳村,132,1,164,1,165,251,0,0,0,0,0,0,65.74
臺南縣,後壁鄉,土溝村,133,1,401,4,405,605,0,0,0,0,0,0,66.94
臺南縣,後壁鄉,土溝村,134,1,479,6,485,706,0,0,0,0,0,0,68.70
臺南縣,後壁鄉,嘉田村,135,1,739,12,751,1186,0,0,0,0,0,0,63.32
臺南縣,後壁鄉,嘉民村,136,1,756,8,764,1239,0,0,0,0,0,0,61.66
臺南縣,後壁鄉,菁豐村,137,1,523,7,530,817,0,0,0,0,0,0,64.87
臺南縣,後壁鄉,崁頂村,138,1,356,8,364,527,0,0,0,0,0,0,69.07
臺南縣,後壁鄉,後部村,139,1,324,10,334,604,0,0,0,0,0,0,55.30
臺南縣,後壁鄉,墨林村,140,1,540,8,548,839,0,0,0,0,0,0,65.32
臺南縣,後壁鄉,菁寮村,141,1,337,2,339,468,0,0,0,0,0,0,72.44
臺南縣,後壁鄉,新嘉村,142,1,403,3,406,591,0,0,0,0,0,0,68.70
臺南縣,後壁鄉,新嘉村,143,1,347,2,349,548,0,0,0,0,0,0,63.69
臺南縣,後壁鄉,頂長村,144,1,376,4,380,546,0,0,0,0,0,0,69.60
臺南縣,後壁鄉,平安村,145,1,696,7,703,1066,0,0,0,0,0,0,65.95
臺南縣,後壁鄉,仕安村,146,1,383,3,386,584,0,0,0,0,0,0,66.10
臺南縣,後壁鄉,竹新村,147,1,717,9,726,1027,0,0,0,0,0,0,70.69
臺南縣,後壁鄉,竹新村,148,1,285,2,287,430,0,0,0,0,0,0,66.74
臺南縣,後壁鄉,新東村,149,1,494,4,498,715,0,0,0,0,0,0,69.65
臺南縣,後壁鄉,新東村,150,1,476,4,480,792,0,0,0,0,0,0,60.61
臺南縣,後壁鄉,頂安村,151,1,744,10,754,1146,0,0,0,0,0,0,65.79
臺南縣,後壁鄉,長安村,152,1,508,4,512,704,0,0,0,0,0,0,72.73
臺南縣,後壁鄉,長安村,153,1,450,7,457,661,0,0,0,0,0,0,69.14
臺南縣,後壁鄉,福安村,154,1,760,1,761,1150,0,0,0,0,0,0,66.17
臺南縣,後壁鄉,烏樹村,155,1,423,11,434,698,0,0,0,0,0,0,62.18
臺南縣,後壁鄉,烏林村,156,1,127,1,128,187,0,0,0,0,0,0,68.45
臺南縣,東山鄉,東山村,157,1,821,5,826,1423,0,0,0,0,0,0,58.05
臺南縣,東山鄉,東中村,158,1,697,13,710,1172,0,0,0,0,0,0,60.58
臺南縣,東山鄉,東中村,159,1,690,2,692,1114,0,0,0,0,0,0,62.12
臺南縣,東山鄉,東正村,160,1,910,11,921,1549,0,0,0,0,0,0,59.46
臺南縣,東山鄉,三榮村,161,1,567,5,572,970,0,0,0,0,0,0,58.97
臺南縣,東山鄉,大客村,162,1,691,10,701,1206,0,0,0,0,0,0,58.13
臺南縣,東山鄉,科里村,163,1,501,11,512,783,0,0,0,0,0,0,65.39
臺南縣,東山鄉,科里村,164,1,460,4,464,633,0,0,0,0,0,0,73.30
臺南縣,東山鄉,東河村,165,1,538,5,543,933,0,0,0,0,0,0,58.20
臺南縣,東山鄉,聖賢村,166,1,539,6,545,821,0,0,0,0,0,0,66.38
臺南縣,東山鄉,聖賢村,167,1,677,4,681,1057,0,0,0,0,0,0,64.43
臺南縣,東山鄉,南溪村,168,1,384,5,389,561,0,0,0,0,0,0,69.34
臺南縣,東山鄉,水雲村,169,1,319,1,320,513,0,0,0,0,0,0,62.38
臺南縣,東山鄉,林安村,170,1,265,1,266,400,0,0,0,0,0,0,66.50
臺南縣,東山鄉,東原村,171,1,639,5,644,997,0,0,0,0,0,0,64.59
臺南縣,東山鄉,東原村,172,1,772,11,783,1273,0,0,0,0,0,0,61.51
臺南縣,東山鄉,嶺南村,173,1,414,8,422,777,0,0,0,0,0,0,54.31
臺南縣,東山鄉,南勢村,174,1,706,9,715,1137,0,0,0,0,0,0,62.88
臺南縣,東山鄉,青山村,175,1,673,4,677,1133,0,0,0,0,0,0,59.75
臺南縣,東山鄉,高原村,176,1,547,5,552,974,0,0,0,0,0,0,56.67
臺南縣,麻豆鎮,穀興里,177,1,461,4,465,641,0,0,0,0,0,0,72.54
臺南縣,麻豆鎮,保安里,178,1,435,5,440,617,0,0,0,0,0,0,71.31
臺南縣,麻豆鎮,東角里,179,1,694,8,702,1047,0,0,0,0,0,0,67.05
臺南縣,麻豆鎮,東角里,180,1,558,4,562,841,0,0,0,0,0,0,66.83
臺南縣,麻豆鎮,晉江里,181,1,760,8,768,1094,0,0,0,0,0,0,70.20
臺南縣,麻豆鎮,晉江里,182,1,743,6,749,1160,0,0,0,0,0,0,64.57
臺南縣,麻豆鎮,巷口里,183,1,914,11,925,1355,0,0,0,0,0,0,68.27
臺南縣,麻豆鎮,中興里,184,1,617,4,621,898,0,0,0,0,0,0,69.15
臺南縣,麻豆鎮,中興里,185,1,593,3,596,866,0,0,0,0,0,0,68.82
臺南縣,麻豆鎮,興農里,186,1,834,12,846,1251,0,0,0,0,0,0,67.63
臺南縣,麻豆鎮,新建里,187,1,726,5,731,964,0,0,0,0,0,0,75.83
臺南縣,麻豆鎮,油車里,188,1,896,9,905,1343,0,0,0,0,0,0,67.39
臺南縣,麻豆鎮,油車里,189,1,951,9,960,1414,0,0,0,0,0,0,67.89
臺南縣,麻豆鎮,北勢里,190,1,809,3,812,1128,0,0,0,0,0,0,71.99
臺南縣,麻豆鎮,大埕里,191,1,821,5,826,1276,0,0,0,0,0,0,64.73
臺南縣,麻豆鎮,大埕里,192,1,750,17,767,1103,0,0,0,0,0,0,69.54
臺南縣,麻豆鎮,總榮里,193,1,479,9,488,632,0,0,0,0,0,0,77.22
臺南縣,麻豆鎮,龍泉里,194,1,537,9,546,729,0,0,0,0,0,0,74.90
臺南縣,麻豆鎮,南勢里,195,1,466,8,474,673,0,0,0,0,0,0,70.43
臺南縣,麻豆鎮,南勢里,196,1,1065,15,1080,1515,0,0,0,0,0,0,71.29
臺南縣,麻豆鎮,寮部里,197,1,991,15,1006,1392,0,0,0,0,0,0,72.27
臺南縣,麻豆鎮,小埤里,198,1,602,3,605,837,0,0,0,0,0,0,72.28
臺南縣,麻豆鎮,埤頭里,199,1,929,11,940,1263,0,0,0,0,0,0,74.43
臺南縣,麻豆鎮,大山里,200,1,408,3,411,517,0,0,0,0,0,0,79.50
臺南縣,麻豆鎮,海埔里,201,1,698,7,705,984,0,0,0,0,0,0,71.65
臺南縣,麻豆鎮,莊禮里,202,1,429,4,433,540,0,0,0,0,0,0,80.19
臺南縣,麻豆鎮,港尾里,203,1,763,10,773,1138,0,0,0,0,0,0,67.93
臺南縣,麻豆鎮,麻口里,204,1,763,7,770,1016,0,0,0,0,0,0,75.79
臺南縣,麻豆鎮,安東里,205,1,408,4,412,584,0,0,0,0,0,0,70.55
臺南縣,麻豆鎮,安業里,206,1,461,6,467,645,0,0,0,0,0,0,72.40
臺南縣,麻豆鎮,安西里,207,1,513,6,519,687,0,0,0,0,0,0,75.55
臺南縣,麻豆鎮,謝安里,208,1,654,11,665,868,0,0,0,0,0,0,76.61
臺南縣,麻豆鎮,中民里,209,1,594,3,597,805,0,0,0,0,0,0,74.16
臺南縣,麻豆鎮,安正里,210,1,604,4,608,809,0,0,0,0,0,0,75.15
臺南縣,麻豆鎮,磚井里,211,1,830,6,836,1122,0,0,0,0,0,0,74.51
臺南縣,下營鄉,下營村,212,1,672,8,680,1012,0,0,0,0,0,0,67.19
臺南縣,下營鄉,仁里村,213,1,841,9,850,1258,0,0,0,0,0,0,67.57
臺南縣,下營鄉,仁里村,214,1,822,7,829,1227,0,0,0,0,0,0,67.56
臺南縣,下營鄉,宅內村,215,1,814,4,818,1150,0,0,0,0,0,0,71.13
臺南縣,下營鄉,後街村,216,1,1058,10,1068,1498,0,0,0,0,0,0,71.30
臺南縣,下營鄉,新興村,217,1,711,8,719,1016,0,0,0,0,0,0,70.77
臺南縣,下營鄉,新興村,218,1,662,4,666,1017,0,0,0,0,0,0,65.49
臺南縣,下營鄉,營前村,219,1,694,7,701,1040,0,0,0,0,0,0,67.40
臺南縣,下營鄉,營前村,220,1,702,6,708,1016,0,0,0,0,0,0,69.69
臺南縣,下營鄉,大屯村,221,1,585,6,591,783,0,0,0,0,0,0,75.48
臺南縣,下營鄉,大埤村,222,1,579,2,581,799,0,0,0,0,0,0,72.72
臺南縣,下營鄉,茅港村,223,1,788,12,800,1164,0,0,0,0,0,0,68.73
臺南縣,下營鄉,中營村,224,1,743,5,748,1057,0,0,0,0,0,0,70.77
臺南縣,下營鄉,開化村,225,1,663,6,669,947,0,0,0,0,0,0,70.64
臺南縣,下營鄉,開化村,226,1,530,5,535,822,0,0,0,0,0,0,65.09
臺南縣,下營鄉,西連村,227,1,666,7,673,893,0,0,0,0,0,0,75.36
臺南縣,下營鄉,賀建村,228,1,946,14,960,1293,0,0,0,0,0,0,74.25
臺南縣,下營鄉,甲中村,229,1,805,8,813,1187,0,0,0,0,0,0,68.49
臺南縣,下營鄉,紅厝村,230,1,902,10,912,1213,0,0,0,0,0,0,75.19
臺南縣,六甲鄉,六甲村,231,1,916,14,930,1388,0,0,0,0,0,0,67.00
臺南縣,六甲鄉,六甲村,232,1,831,11,842,1259,0,0,0,0,0,0,66.88
臺南縣,六甲鄉,甲東村,233,1,826,10,836,1284,0,0,0,0,0,0,65.11
臺南縣,六甲鄉,甲東村,234,1,740,11,751,1181,0,0,0,0,0,0,63.59
臺南縣,六甲鄉,甲南村,235,1,849,3,852,1291,0,0,0,0,0,0,66.00
臺南縣,六甲鄉,龍湖村,236,1,706,6,712,1051,0,0,0,0,0,0,67.75
臺南縣,六甲鄉,七甲村,237,1,549,10,559,829,0,0,0,0,0,0,67.43
臺南縣,六甲鄉,二甲村,238,1,812,10,822,1280,0,0,0,0,0,0,64.22
臺南縣,六甲鄉,二甲村,239,1,926,12,938,1434,0,0,0,0,0,0,65.41
臺南縣,六甲鄉,水林村,240,1,627,9,636,922,0,0,0,0,0,0,68.98
臺南縣,六甲鄉,水林村,241,1,564,9,573,833,0,0,0,0,0,0,68.79
臺南縣,六甲鄉,中社村,242,1,530,3,533,747,0,0,0,0,0,0,71.35
臺南縣,六甲鄉,中社村,243,1,496,8,504,791,0,0,0,0,0,0,63.72
臺南縣,六甲鄉,龜港村,244,1,708,4,712,1047,0,0,0,0,0,0,68.00
臺南縣,六甲鄉,菁埔村,245,1,409,1,410,575,0,0,0,0,0,0,71.30
臺南縣,六甲鄉,王爺村,246,1,564,5,569,898,0,0,0,0,0,0,63.36
臺南縣,六甲鄉,大丘村,247,1,477,3,480,764,0,0,0,0,0,0,62.83
臺南縣,官田鄉,官田村,248,1,671,6,677,982,0,0,0,0,0,0,68.94
臺南縣,官田鄉,官田村,249,1,647,7,654,941,0,0,0,0,0,0,69.50
臺南縣,官田鄉,二鎮村,250,1,834,10,844,1135,0,0,0,0,0,0,74.36
臺南縣,官田鄉,二鎮村,251,1,699,8,707,1043,0,0,0,0,0,0,67.79
臺南縣,官田鄉,湖山村,252,1,759,11,770,1045,0,0,0,0,0,0,73.68
臺南縣,官田鄉,嘉南村,253,1,492,3,495,635,0,0,0,0,0,0,77.95
臺南縣,官田鄉,大崎村,254,1,329,1,330,496,0,0,0,0,0,0,66.53
臺南縣,官田鄉,隆田村,255,1,629,6,635,907,0,0,0,0,0,0,70.01
臺南縣,官田鄉,隆田村,256,1,618,9,627,896,0,0,0,0,0,0,69.98
臺南縣,官田鄉,隆本村,257,1,518,6,524,783,0,0,0,0,0,0,66.92
臺南縣,官田鄉,隆本村,258,1,698,8,706,994,0,0,0,0,0,0,71.03
臺南縣,官田鄉,隆本村,259,1,676,6,682,933,0,0,0,0,0,0,73.10
臺南縣,官田鄉,南部村,260,1,648,12,660,1021,0,0,0,0,0,0,64.64
臺南縣,官田鄉,東庄村,261,1,942,6,948,1380,0,0,0,0,0,0,68.70
臺南縣,官田鄉,西庄村,262,1,455,5,460,696,0,0,0,0,0,0,66.09
臺南縣,官田鄉,拔林村,263,1,476,3,479,607,0,0,0,0,0,0,78.91
臺南縣,官田鄉,渡頭村,264,1,601,6,607,820,0,0,0,0,0,0,74.02
臺南縣,官田鄉,渡頭村,265,1,642,7,649,843,0,0,0,0,0,0,76.99
臺南縣,官田鄉,渡頭村,266,1,364,8,372,572,0,0,0,0,0,0,65.03
臺南縣,官田鄉,社子村,267,1,615,6,621,916,0,0,0,0,0,0,67.79
臺南縣,大內鄉,石湖村,268,1,721,7,728,1145,0,0,0,0,0,0,63.58
臺南縣,大內鄉,石林村,269,1,509,8,517,781,0,0,0,0,0,0,66.20
臺南縣,大內鄉,石城村,270,1,933,9,942,1464,0,0,0,0,0,0,64.34
臺南縣,大內鄉,內江村,271,1,716,7,723,1111,0,0,0,0,0,0,65.08
臺南縣,大內鄉,大內村,272,1,576,4,580,838,0,0,0,0,0,0,69.21
臺南縣,大內鄉,內郭村,273,1,452,13,465,698,0,0,0,0,0,0,66.62
臺南縣,大內鄉,頭社村,274,1,614,14,628,1062,0,0,0,0,0,0,59.13
臺南縣,大內鄉,環湖村,275,1,616,5,621,934,0,0,0,0,0,0,66.49
臺南縣,大內鄉,二溪村,276,1,585,4,589,959,0,0,0,0,0,0,61.42
臺南縣,大內鄉,曲溪村,277,1,430,6,436,646,0,0,0,0,0,0,67.49
臺南縣,佳里鎮,東寧里,278,1,588,4,592,882,0,0,0,0,0,0,67.12
臺南縣,佳里鎮,東寧里,279,1,575,7,582,841,0,0,0,0,0,0,69.20
臺南縣,佳里鎮,忠仁里,280,1,756,7,763,1142,0,0,0,0,0,0,66.81
臺南縣,佳里鎮,忠仁里,281,1,904,13,917,1352,0,0,0,0,0,0,67.83
臺南縣,佳里鎮,鎮山里,282,1,719,2,721,1002,0,0,0,0,0,0,71.96
臺南縣,佳里鎮,鎮山里,283,1,694,4,698,1036,0,0,0,0,0,0,67.37
臺南縣,佳里鎮,鎮山里,284,1,693,8,701,987,0,0,0,0,0,0,71.02
臺南縣,佳里鎮,鎮山里,285,1,781,6,787,1146,0,0,0,0,0,0,68.67
臺南縣,佳里鎮,建南里,286,1,808,10,818,1250,0,0,0,0,0,0,65.44
臺南縣,佳里鎮,建南里,287,1,835,7,842,1284,0,0,0,0,0,0,65.58
臺南縣,佳里鎮,建南里,288,1,713,5,718,1119,0,0,0,0,0,0,64.16
臺南縣,佳里鎮,建南里,289,1,1007,11,1018,1572,0,0,0,0,0,0,64.76
臺南縣,佳里鎮,安西里,290,1,715,4,719,1218,0,0,0,0,0,0,59.03
臺南縣,佳里鎮,安西里,291,1,708,5,713,1138,0,0,0,0,0,0,62.65
臺南縣,佳里鎮,安西里,292,1,757,10,767,1218,0,0,0,0,0,0,62.97
臺南縣,佳里鎮,安西里,293,1,828,7,835,1307,0,0,0,0,0,0,63.89
臺南縣,佳里鎮,安西里,294,1,756,5,761,1098,0,0,0,0,0,0,69.31
臺南縣,佳里鎮,安西里,295,1,826,2,828,1324,0,0,0,0,0,0,62.54
臺南縣,佳里鎮,六安里,296,1,655,5,660,948,0,0,0,0,0,0,69.62
臺南縣,佳里鎮,六安里,297,1,645,6,651,977,0,0,0,0,0,0,66.63
臺南縣,佳里鎮,六安里,298,1,626,4,630,1019,0,0,0,0,0,0,61.83
臺南縣,佳里鎮,佳化里,299,1,627,4,631,866,0,0,0,0,0,0,72.86
臺南縣,佳里鎮,佳化里,300,1,631,8,639,883,0,0,0,0,0,0,72.37
臺南縣,佳里鎮,禮化里,301,1,603,7,610,837,0,0,0,0,0,0,72.88
臺南縣,佳里鎮,興化里,302,1,928,7,935,1355,0,0,0,0,0,0,69.00
臺南縣,佳里鎮,營頂里,303,1,473,3,476,656,0,0,0,0,0,0,72.56
臺南縣,佳里鎮,溪洲里,304,1,279,1,280,370,0,0,0,0,0,0,75.68
臺南縣,佳里鎮,海澄里,305,1,783,9,792,1218,0,0,0,0,0,0,65.02
臺南縣,佳里鎮,漳洲里,306,1,417,4,421,596,0,0,0,0,0,0,70.64
臺南縣,佳里鎮,頂部里,307,1,516,6,522,758,0,0,0,0,0,0,68.87
臺南縣,佳里鎮,嘉福里,308,1,664,6,670,939,0,0,0,0,0,0,71.35
臺南縣,佳里鎮,通興里,309,1,733,13,746,1108,0,0,0,0,0,0,67.33
臺南縣,佳里鎮,蚶寮里,310,1,596,3,599,827,0,0,0,0,0,0,72.43
臺南縣,佳里鎮,龍安里,311,1,741,5,746,979,0,0,0,0,0,0,76.20
臺南縣,佳里鎮,民安里,312,1,845,14,859,1232,0,0,0,0,0,0,69.72
臺南縣,佳里鎮,子龍里,313,1,544,8,552,778,0,0,0,0,0,0,70.95
臺南縣,佳里鎮,子龍里,314,1,492,3,495,719,0,0,0,0,0,0,68.85
臺南縣,佳里鎮,三協里,315,1,566,5,571,816,0,0,0,0,0,0,69.98
臺南縣,學甲鎮,一秀里,316,1,465,5,470,678,0,0,0,0,0,0,69.32
臺南縣,學甲鎮,一秀里,317,1,311,0,311,446,0,0,0,0,0,0,69.73
臺南縣,學甲鎮,西明里,318,1,849,6,855,1225,0,0,0,0,0,0,69.80
臺南縣,學甲鎮,宜民里,319,1,348,2,350,515,0,0,0,0,0,0,67.96
臺南縣,學甲鎮,煥昌里,320,1,624,2,626,859,0,0,0,0,0,0,72.88
臺南縣,學甲鎮,慈生里,321,1,412,0,412,585,0,0,0,0,0,0,70.43
臺南縣,學甲鎮,仁得里,322,1,788,8,796,1122,0,0,0,0,0,0,70.94
臺南縣,學甲鎮,仁得里,323,1,661,4,665,938,0,0,0,0,0,0,70.90
臺南縣,學甲鎮,仁得里,324,1,885,5,890,1255,0,0,0,0,0,0,70.92
臺南縣,學甲鎮,新生里,325,1,955,5,960,1405,0,0,0,0,0,0,68.33
臺南縣,學甲鎮,百福里,326,1,535,3,538,730,0,0,0,0,0,0,73.70
臺南縣,學甲鎮,百福里,327,1,359,3,362,534,0,0,0,0,0,0,67.79
臺南縣,學甲鎮,新榮里,328,1,403,3,406,599,0,0,0,0,0,0,67.78
臺南縣,學甲鎮,新榮里,329,1,504,5,509,721,0,0,0,0,0,0,70.60
臺南縣,學甲鎮,文化里,330,1,358,3,361,551,0,0,0,0,0,0,65.52
臺南縣,學甲鎮,大安里,331,1,377,2,379,543,0,0,0,0,0,0,69.80
臺南縣,學甲鎮,美豐里,332,1,534,6,540,815,0,0,0,0,0,0,66.26
臺南縣,學甲鎮,美和里,333,1,257,1,258,353,0,0,0,0,0,0,73.09
臺南縣,學甲鎮,達明里,334,1,472,4,476,684,0,0,0,0,0,0,69.59
臺南縣,學甲鎮,光明里,335,1,222,0,222,335,0,0,0,0,0,0,66.27
臺南縣,學甲鎮,民吉里,336,1,292,5,297,435,0,0,0,0,0,0,68.28
臺南縣,學甲鎮,西進里,337,1,330,4,334,524,0,0,0,0,0,0,63.74
臺南縣,學甲鎮,白渚里,338,1,228,1,229,341,0,0,0,0,0,0,67.16
臺南縣,學甲鎮,光華里,339,1,388,5,393,547,0,0,0,0,0,0,71.85
臺南縣,學甲鎮,光華里,340,1,212,0,212,287,0,0,0,0,0,0,73.87
臺南縣,學甲鎮,頭港里,341,1,301,1,302,492,0,0,0,0,0,0,61.38
臺南縣,學甲鎮,宅港里,342,1,727,9,736,1142,0,0,0,0,0,0,64.45
臺南縣,學甲鎮,平東里,343,1,353,2,355,516,0,0,0,0,0,0,68.80
臺南縣,學甲鎮,平西里,344,1,451,5,456,722,0,0,0,0,0,0,63.16
臺南縣,學甲鎮,頂洲里,345,1,518,3,521,692,0,0,0,0,0,0,75.29
臺南縣,學甲鎮,紅茄里,346,1,325,2,327,518,0,0,0,0,0,0,63.13
臺南縣,學甲鎮,新芳里,347,1,340,1,341,479,0,0,0,0,0,0,71.19
臺南縣,西港鄉,西港村,348,1,521,12,533,764,0,0,0,0,0,0,69.76
臺南縣,西港鄉,西港村,349,1,546,10,556,771,0,0,0,0,0,0,72.11
臺南縣,西港鄉,西港村,350,1,679,7,686,985,0,0,0,0,0,0,69.64
臺南縣,西港鄉,慶安村,351,1,724,4,728,1047,0,0,0,0,0,0,69.53
臺南縣,西港鄉,慶安村,352,1,674,6,680,929,0,0,0,0,0,0,73.20
臺南縣,西港鄉,慶安村,353,1,771,6,777,1115,0,0,0,0,0,0,69.69
臺南縣,西港鄉,南海村,354,1,839,17,856,1240,0,0,0,0,0,0,69.03
臺南縣,西港鄉,南海村,355,1,468,6,474,613,0,0,0,0,0,0,77.32
臺南縣,西港鄉,港東村,356,1,640,8,648,858,0,0,0,0,0,0,75.52
臺南縣,西港鄉,港東村,357,1,276,0,276,390,0,0,0,0,0,0,70.77
臺南縣,西港鄉,檨林村,358,1,518,7,525,740,0,0,0,0,0,0,70.95
臺南縣,西港鄉,檨林村,359,1,539,10,549,788,0,0,0,0,0,0,69.67
臺南縣,西港鄉,後營村,360,1,935,10,945,1282,0,0,0,0,0,0,73.71
臺南縣,西港鄉,營西村,361,1,860,6,866,1276,0,0,0,0,0,0,67.87
臺南縣,西港鄉,金砂村,362,1,598,8,606,836,0,0,0,0,0,0,72.49
臺南縣,西港鄉,劉厝村,363,1,798,8,806,1131,0,0,0,0,0,0,71.26
臺南縣,西港鄉,竹林村,364,1,839,9,848,1160,0,0,0,0,0,0,73.10
臺南縣,西港鄉,永樂村,365,1,626,2,628,845,0,0,0,0,0,0,74.32
臺南縣,西港鄉,新復村,366,1,313,11,324,412,0,0,0,0,0,0,78.64
臺南縣,西港鄉,新復村,367,1,520,3,523,738,0,0,0,0,0,0,70.87
臺南縣,七股鄉,後港村,368,1,390,5,395,539,0,0,0,0,0,0,73.28
臺南縣,七股鄉,大潭村,369,1,489,5,494,749,0,0,0,0,0,0,65.95
臺南縣,七股鄉,城內村,370,1,392,5,397,496,0,0,0,0,0,0,80.04
臺南縣,七股鄉,篤加村,371,1,577,6,583,822,0,0,0,0,0,0,70.92
臺南縣,七股鄉,頂山村,372,1,700,5,705,951,0,0,0,0,0,0,74.13
臺南縣,七股鄉,西寮村,373,1,418,2,420,580,0,0,0,0,0,0,72.41
臺南縣,七股鄉,鹽埕村,374,1,323,4,327,461,0,0,0,0,0,0,70.93
臺南縣,七股鄉,中寮村,375,1,529,3,532,776,0,0,0,0,0,0,68.56
臺南縣,七股鄉,龍山村,376,1,555,7,562,810,0,0,0,0,0,0,69.38
臺南縣,七股鄉,龍山村,377,1,598,4,602,836,0,0,0,0,0,0,72.01
臺南縣,七股鄉,溪南村,378,1,274,0,274,347,0,0,0,0,0,0,78.96
臺南縣,七股鄉,七股村,379,1,577,9,586,884,0,0,0,0,0,0,66.29
臺南縣,七股鄉,玉成村,380,1,554,2,556,780,0,0,0,0,0,0,71.28
臺南縣,七股鄉,大埕村,381,1,876,11,887,1284,0,0,0,0,0,0,69.08
臺南縣,七股鄉,大寮村,382,1,711,7,718,967,0,0,0,0,0,0,74.25
臺南縣,七股鄉,看坪村,383,1,409,5,414,590,0,0,0,0,0,0,70.17
臺南縣,七股鄉,樹林村,384,1,715,7,722,1005,0,0,0,0,0,0,71.84
臺南縣,七股鄉,竹港村,385,1,437,0,437,571,0,0,0,0,0,0,76.53
臺南縣,七股鄉,竹橋村,386,1,571,2,573,741,0,0,0,0,0,0,77.33
臺南縣,七股鄉,義合村,387,1,699,3,702,943,0,0,0,0,0,0,74.44
臺南縣,七股鄉,康榔村,388,1,467,7,474,640,0,0,0,0,0,0,74.06
臺南縣,七股鄉,永吉村,389,1,576,2,578,809,0,0,0,0,0,0,71.45
臺南縣,七股鄉,三股村,390,1,858,9,867,1148,0,0,0,0,0,0,75.52
臺南縣,七股鄉,三股村,391,1,676,6,682,864,0,0,0,0,0,0,78.94
臺南縣,七股鄉,十份村,392,1,935,5,940,1320,0,0,0,0,0,0,71.21
臺南縣,將軍鄉,長榮村,393,1,620,7,627,856,0,0,0,0,0,0,73.25
臺南縣,將軍鄉,西華村,394,1,891,6,897,1260,0,0,0,0,0,0,71.19
臺南縣,將軍鄉,西和村,395,1,764,6,770,1091,0,0,0,0,0,0,70.58
臺南縣,將軍鄉,忠興村,396,1,367,0,367,501,0,0,0,0,0,0,73.25
臺南縣,將軍鄉,忠興村,397,1,654,2,656,938,0,0,0,0,0,0,69.94
臺南縣,將軍鄉,嘉昌村,398,1,412,4,416,562,0,0,0,0,0,0,74.02
臺南縣,將軍鄉,嘉昌村,399,1,257,0,257,341,0,0,0,0,0,0,75.37
臺南縣,將軍鄉,保源村,400,1,425,0,425,594,0,0,0,0,0,0,71.55
臺南縣,將軍鄉,保源村,401,1,348,1,349,455,0,0,0,0,0,0,76.70
臺南縣,將軍鄉,苓和村,402,1,430,3,433,659,0,0,0,0,0,0,65.71
臺南縣,將軍鄉,苓和村,403,1,249,1,250,385,0,0,0,0,0,0,64.94
臺南縣,將軍鄉,仁和村,404,1,501,3,504,806,0,0,0,0,0,0,62.53
臺南縣,將軍鄉,北埔村,405,1,447,7,454,662,0,0,0,0,0,0,68.58
臺南縣,將軍鄉,將富村,406,1,472,3,475,748,0,0,0,0,0,0,63.50
臺南縣,將軍鄉,將貴村,407,1,287,0,287,431,0,0,0,0,0,0,66.59
臺南縣,將軍鄉,將貴村,408,1,169,0,169,215,0,0,0,0,0,0,78.60
臺南縣,將軍鄉,三吉村,409,1,273,0,273,437,0,0,0,0,0,0,62.47
臺南縣,將軍鄉,玉山村,410,1,604,1,605,915,0,0,0,0,0,0,66.12
臺南縣,將軍鄉,廣山村,411,1,472,4,476,754,0,0,0,0,0,0,63.13
臺南縣,將軍鄉,長沙村,412,1,489,3,492,748,0,0,0,0,0,0,65.78
臺南縣,將軍鄉,長沙村,413,1,421,3,424,668,0,0,0,0,0,0,63.47
臺南縣,將軍鄉,平沙村,414,1,807,7,814,1207,0,0,0,0,0,0,67.44
臺南縣,將軍鄉,鯤鯓村,415,1,504,2,506,828,0,0,0,0,0,0,61.11
臺南縣,將軍鄉,鯤鯓村,416,1,699,5,704,1094,0,0,0,0,0,0,64.35
臺南縣,將軍鄉,鯤溟村,417,1,543,5,548,988,0,0,0,0,0,0,55.47
臺南縣,北門鄉,北門村,418,1,365,1,366,531,0,0,0,0,0,0,68.93
臺南縣,北門鄉,北門村,419,1,306,6,312,402,0,0,0,0,0,0,77.61
臺南縣,北門鄉,永隆村,420,1,355,2,357,502,0,0,0,0,0,0,71.12
臺南縣,北門鄉,永華村,421,1,285,2,287,423,0,0,0,0,0,0,67.85
臺南縣,北門鄉,玉港村,422,1,333,6,339,497,0,0,0,0,0,0,68.21
臺南縣,北門鄉,玉港村,423,1,231,0,231,331,0,0,0,0,0,0,69.79
臺南縣,北門鄉,保吉村,424,1,500,7,507,778,0,0,0,0,0,0,65.17
臺南縣,北門鄉,保吉村,425,1,352,4,356,508,0,0,0,0,0,0,70.08
臺南縣,北門鄉,東壁村,426,1,438,4,442,691,0,0,0,0,0,0,63.97
臺南縣,北門鄉,鯤江村,427,1,272,3,275,424,0,0,0,0,0,0,64.86
臺南縣,北門鄉,鯤江村,428,1,242,1,243,349,0,0,0,0,0,0,69.63
臺南縣,北門鄉,雙春村,429,1,356,0,356,595,0,0,0,0,0,0,59.83
臺南縣,北門鄉,錦湖村,430,1,748,8,756,1122,0,0,0,0,0,0,67.38
臺南縣,北門鄉,慈安村,431,1,457,4,461,635,0,0,0,0,0,0,72.60
臺南縣,北門鄉,三光村,432,1,475,2,477,664,0,0,0,0,0,0,71.84
臺南縣,北門鄉,三光村,433,1,349,1,350,490,0,0,0,0,0,0,71.43
臺南縣,北門鄉,中樞村,434,1,499,4,503,728,0,0,0,0,0,0,69.09
臺南縣,北門鄉,仁里村,435,1,484,4,488,722,0,0,0,0,0,0,67.59
臺南縣,新化鎮,武安里,436,1,467,11,478,714,0,0,0,0,0,0,66.95
臺南縣,新化鎮,武安里,437,1,565,9,574,852,0,0,0,0,0,0,67.37
臺南縣,新化鎮,東榮里,438,1,797,10,807,1303,0,0,0,0,0,0,61.93
臺南縣,新化鎮,東榮里,439,1,791,7,798,1227,0,0,0,0,0,0,65.04
臺南縣,新化鎮,東榮里,440,1,698,8,706,1064,0,0,0,0,0,0,66.35
臺南縣,新化鎮,護國里,441,1,525,8,533,762,0,0,0,0,0,0,69.95
臺南縣,新化鎮,護國里,442,1,425,7,432,784,0,0,0,0,0,0,55.10
臺南縣,新化鎮,太平里,443,1,630,13,643,931,0,0,0,0,0,0,69.07
臺南縣,新化鎮,太平里,444,1,561,11,572,810,0,0,0,0,0,0,70.62
臺南縣,新化鎮,太平里,445,1,590,4,594,829,0,0,0,0,0,0,71.65
臺南縣,新化鎮,太平里,446,1,551,9,560,800,0,0,0,0,0,0,70.00
臺南縣,新化鎮,中央里,447,1,291,4,295,429,0,0,0,0,0,0,68.76
臺南縣,新化鎮,觀音里,448,1,421,8,429,632,0,0,0,0,0,0,67.88
臺南縣,新化鎮,竹林里,449,1,351,11,362,462,0,0,0,0,0,0,78.35
臺南縣,新化鎮,清水里,450,1,662,5,667,960,0,0,0,0,0,0,69.48
臺南縣,新化鎮,協興里,451,1,564,6,570,840,0,0,0,0,0,0,67.86
臺南縣,新化鎮,協興里,452,1,634,10,644,1027,0,0,0,0,0,0,62.71
臺南縣,新化鎮,協興里,453,1,569,10,579,928,0,0,0,0,0,0,62.39
臺南縣,新化鎮,唪口里,454,1,471,12,483,733,0,0,0,0,0,0,65.89
臺南縣,新化鎮,唪口里,455,1,486,9,495,754,0,0,0,0,0,0,65.65
臺南縣,新化鎮,北勢里,456,1,747,5,752,1041,0,0,0,0,0,0,72.24
臺南縣,新化鎮,豐榮里,457,1,810,15,825,1188,0,0,0,0,0,0,69.44
臺南縣,新化鎮,豐榮里,458,1,725,8,733,989,0,0,0,0,0,0,74.12
臺南縣,新化鎮,全興里,459,1,599,6,605,791,0,0,0,0,0,0,76.49
臺南縣,新化鎮,全興里,460,1,519,5,524,919,0,0,0,0,0,0,57.02
臺南縣,新化鎮,崙頂里,461,1,674,13,687,904,0,0,0,0,0,0,76.00
臺南縣,新化鎮,崙頂里,462,1,550,9,559,758,0,0,0,0,0,0,73.75
臺南縣,新化鎮,知義里,463,1,723,7,730,981,0,0,0,0,0,0,74.41
臺南縣,新化鎮,知義里,464,1,623,17,640,1069,0,0,0,0,0,0,59.87
臺南縣,新化鎮,山腳里,465,1,870,14,884,1200,0,0,0,0,0,0,73.67
臺南縣,新化鎮,大坑里,466,1,379,7,386,529,0,0,0,0,0,0,72.97
臺南縣,新化鎮,那拔里,467,1,637,15,652,956,0,0,0,0,0,0,68.20
臺南縣,新化鎮,那拔里,468,1,709,11,720,1008,0,0,0,0,0,0,71.43
臺南縣,新化鎮,羊林里,469,1,574,11,585,859,0,0,0,0,0,0,68.10
臺南縣,新化鎮,礁坑里,470,1,687,10,697,1077,0,0,0,0,0,0,64.72
臺南縣,善化鎮,東關里,471,1,567,4,571,954,0,0,0,0,0,0,59.85
臺南縣,善化鎮,坐駕里,472,1,721,10,731,1164,0,0,0,0,0,0,62.80
臺南縣,善化鎮,坐駕里,473,1,829,12,841,1289,0,0,0,0,0,0,65.24
臺南縣,善化鎮,光文里,474,1,663,20,683,1045,0,0,0,0,0,0,65.36
臺南縣,善化鎮,光文里,475,1,768,6,774,1338,0,0,0,0,0,0,57.85
臺南縣,善化鎮,光文里,476,1,854,9,863,1359,0,0,0,0,0,0,63.50
臺南縣,善化鎮,文昌里,477,1,554,7,561,876,0,0,0,0,0,0,64.04
臺南縣,善化鎮,文昌里,478,1,631,5,636,1051,0,0,0,0,0,0,60.51
臺南縣,善化鎮,南關里,479,1,809,12,821,1272,0,0,0,0,0,0,64.54
臺南縣,善化鎮,西關里,480,1,406,5,411,654,0,0,0,0,0,0,62.84
臺南縣,善化鎮,北關里,481,1,328,4,332,486,0,0,0,0,0,0,68.31
臺南縣,善化鎮,文正里,482,1,664,6,670,1075,0,0,0,0,0,0,62.33
臺南縣,善化鎮,胡家里,483,1,837,10,847,1263,0,0,0,0,0,0,67.06
臺南縣,善化鎮,胡厝里,484,1,853,11,864,1221,0,0,0,0,0,0,70.76
臺南縣,善化鎮,胡厝里,485,1,467,8,475,702,0,0,0,0,0,0,67.66
臺南縣,善化鎮,什乃里,486,1,551,6,557,851,0,0,0,0,0,0,65.45
臺南縣,善化鎮,溪美里,487,1,581,15,596,871,0,0,0,0,0,0,68.43
臺南縣,善化鎮,溪美里,488,1,495,1,496,729,0,0,0,0,0,0,68.04
臺南縣,善化鎮,六分里,489,1,441,4,445,659,0,0,0,0,0,0,67.53
臺南縣,善化鎮,六德里,490,1,718,12,730,1047,0,0,0,0,0,0,69.72
臺南縣,善化鎮,田寮里,491,1,486,5,491,684,0,0,0,0,0,0,71.78
臺南縣,善化鎮,田寮里,492,1,678,6,684,970,0,0,0,0,0,0,70.52
臺南縣,善化鎮,東隆里,493,1,577,6,583,809,0,0,0,0,0,0,72.06
臺南縣,善化鎮,東昌里,494,1,671,8,679,980,0,0,0,0,0,0,69.29
臺南縣,善化鎮,牛庄里,495,1,934,5,939,1382,0,0,0,0,0,0,67.95
臺南縣,善化鎮,嘉北里,496,1,902,15,917,1352,0,0,0,0,0,0,67.83
臺南縣,善化鎮,嘉南里,497,1,645,7,652,988,0,0,0,0,0,0,65.99
臺南縣,善化鎮,小新里,498,1,726,9,735,1139,0,0,0,0,0,0,64.53
臺南縣,善化鎮,小新里,499,1,775,8,783,1308,0,0,0,0,0,0,59.86
臺南縣,新市鄉,新市村,500,1,542,7,549,857,0,0,0,0,0,0,64.06
臺南縣,新市鄉,新市村,501,1,847,12,859,1381,0,0,0,0,0,0,62.20
臺南縣,新市鄉,新和村,502,1,599,8,607,1005,0,0,0,0,0,0,60.40
臺南縣,新市鄉,新和村,503,1,600,9,609,956,0,0,0,0,0,0,63.70
臺南縣,新市鄉,新和村,504,1,429,6,435,706,0,0,0,0,0,0,61.61
臺南縣,新市鄉,新和村,505,1,590,7,597,1024,0,0,0,0,0,0,58.30
臺南縣,新市鄉,新和村,506,1,693,6,699,1105,0,0,0,0,0,0,63.26
臺南縣,新市鄉,社內村,507,1,507,7,514,774,0,0,0,0,0,0,66.41
臺南縣,新市鄉,社內村,508,1,695,5,700,983,0,0,0,0,0,0,71.21
臺南縣,新市鄉,大洲村,509,1,437,5,442,597,0,0,0,0,0,0,74.04
臺南縣,新市鄉,豐華村,510,1,502,4,506,829,0,0,0,0,0,0,61.04
臺南縣,新市鄉,三舍村,511,1,604,12,616,913,0,0,0,0,0,0,67.47
臺南縣,新市鄉,大營村,512,1,640,9,649,940,0,0,0,0,0,0,69.04
臺南縣,新市鄉,大營村,513,1,436,3,439,592,0,0,0,0,0,0,74.16
臺南縣,新市鄉,大營村,514,1,431,6,437,603,0,0,0,0,0,0,72.47
臺南縣,新市鄉,大社村,515,1,594,11,605,905,0,0,0,0,0,0,66.85
臺南縣,新市鄉,大社村,516,1,680,10,690,994,0,0,0,0,0,0,69.42
臺南縣,新市鄉,大社村,517,1,727,11,738,1095,0,0,0,0,0,0,67.40
臺南縣,新市鄉,潭頂村,518,1,911,15,926,1394,0,0,0,0,0,0,66.43
臺南縣,新市鄉,港墘村,519,1,418,5,423,694,0,0,0,0,0,0,60.95
臺南縣,新市鄉,港墘村,520,1,587,4,591,896,0,0,0,0,0,0,65.96
臺南縣,新市鄉,港墘村,521,1,658,11,669,1041,0,0,0,0,0,0,64.27
臺南縣,新市鄉,永就村,522,1,318,6,324,446,0,0,0,0,0,0,72.65
臺南縣,新市鄉,永就村,523,1,862,3,865,1410,0,0,0,0,0,0,61.35
臺南縣,安定鄉,蘇林村,524,1,769,6,775,1120,0,0,0,0,0,0,69.20
臺南縣,安定鄉,蘇林村,525,1,595,6,601,872,0,0,0,0,0,0,68.92
臺南縣,安定鄉,蘇厝村,526,1,585,9,594,950,0,0,0,0,0,0,62.53
臺南縣,安定鄉,蘇厝村,527,1,493,9,502,768,0,0,0,0,0,0,65.36
臺南縣,安定鄉,安定村,528,1,851,15,866,1322,0,0,0,0,0,0,65.51
臺南縣,安定鄉,安加村,529,1,777,8,785,1110,0,0,0,0,0,0,70.72
臺南縣,安定鄉,保西村,530,1,506,5,511,722,0,0,0,0,0,0,70.78
臺南縣,安定鄉,港尾村,531,1,972,8,980,1424,0,0,0,0,0,0,68.82
臺南縣,安定鄉,中榮村,532,1,666,7,673,977,0,0,0,0,0,0,68.88
臺南縣,安定鄉,港口村,533,1,683,7,690,981,0,0,0,0,0,0,70.34
臺南縣,安定鄉,港口村,534,1,713,7,720,1010,0,0,0,0,0,0,71.29
臺南縣,安定鄉,港南村,535,1,754,9,763,1147,0,0,0,0,0,0,66.52
臺南縣,安定鄉,港南村,536,1,626,10,636,920,0,0,0,0,0,0,69.13
臺南縣,安定鄉,大同村,537,1,481,5,486,617,0,0,0,0,0,0,78.77
臺南縣,安定鄉,六嘉村,538,1,891,11,902,1289,0,0,0,0,0,0,69.98
臺南縣,安定鄉,中沙村,539,1,491,7,498,694,0,0,0,0,0,0,71.76
臺南縣,安定鄉,新吉村,540,1,536,5,541,787,0,0,0,0,0,0,68.74
臺南縣,安定鄉,新吉村,541,1,525,3,528,747,0,0,0,0,0,0,70.68
臺南縣,安定鄉,海寮村,542,1,804,6,810,1007,0,0,0,0,0,0,80.44
臺南縣,安定鄉,海寮村,543,1,776,5,781,1075,0,0,0,0,0,0,72.65
臺南縣,安定鄉,管寮村,544,1,614,6,620,891,0,0,0,0,0,0,69.58
臺南縣,安定鄉,南安村,545,1,353,6,359,449,0,0,0,0,0,0,79.96
臺南縣,山上鄉,明和村,546,1,563,5,568,851,0,0,0,0,0,0,66.75
臺南縣,山上鄉,明和村,547,1,511,10,521,821,0,0,0,0,0,0,63.46
臺南縣,山上鄉,南洲村,548,1,525,2,527,717,0,0,0,0,0,0,73.50
臺南縣,山上鄉,南洲村,549,1,556,5,561,773,0,0,0,0,0,0,72.57
臺南縣,山上鄉,山上村,550,1,567,9,576,839,0,0,0,0,0,0,68.65
臺南縣,山上鄉,新莊村,551,1,479,7,486,736,0,0,0,0,0,0,66.03
臺南縣,山上鄉,玉峰村,552,1,368,7,375,574,0,0,0,0,0,0,65.33
臺南縣,山上鄉,平陽村,553,1,268,6,274,369,0,0,0,0,0,0,74.25
臺南縣,山上鄉,豐德村,554,1,211,3,214,323,0,0,0,0,0,0,66.25
臺南縣,玉井鄉,玉井村,555,1,685,7,692,976,0,0,0,0,0,0,70.90
臺南縣,玉井鄉,玉田村,556,1,974,9,983,1377,0,0,0,0,0,0,71.39
臺南縣,玉井鄉,玉田村,557,1,882,7,889,1243,0,0,0,0,0,0,71.52
臺南縣,玉井鄉,玉田村,558,1,949,9,958,1345,0,0,0,0,0,0,71.23
臺南縣,玉井鄉,中正村,559,1,942,10,952,1288,0,0,0,0,0,0,73.91
臺南縣,玉井鄉,竹圍村,560,1,835,9,844,1319,0,0,0,0,0,0,63.99
臺南縣,玉井鄉,沙田村,561,1,324,5,329,481,0,0,0,0,0,0,68.40
臺南縣,玉井鄉,三埔村,562,1,314,3,317,512,0,0,0,0,0,0,61.91
臺南縣,玉井鄉,三和村,563,1,551,2,553,766,0,0,0,0,0,0,72.19
臺南縣,玉井鄉,望明村,564,1,1069,13,1082,1543,0,0,0,0,0,0,70.12
臺南縣,玉井鄉,層林村,565,1,562,4,566,727,0,0,0,0,0,0,77.85
臺南縣,玉井鄉,豐里村,566,1,731,4,735,1037,0,0,0,0,0,0,70.88
臺南縣,楠西鄉,楠西村,567,1,665,4,669,1004,0,0,0,0,0,0,66.63
臺南縣,楠西鄉,楠西村,568,1,638,11,649,946,0,0,0,0,0,0,68.60
臺南縣,楠西鄉,灣丘村,569,1,882,6,888,1298,0,0,0,0,0,0,68.41
臺南縣,楠西鄉,密枝村,570,1,610,10,620,899,0,0,0,0,0,0,68.97
臺南縣,楠西鄉,照興村,571,1,705,14,719,1062,0,0,0,0,0,0,67.70
臺南縣,楠西鄉,鹿田村,572,1,776,6,782,1082,0,0,0,0,0,0,72.27
臺南縣,楠西鄉,龜丹村,573,1,542,3,545,730,0,0,0,0,0,0,74.66
臺南縣,楠西鄉,東勢村,574,1,756,8,764,1045,0,0,0,0,0,0,73.11
臺南縣,楠西鄉,東勢村,575,1,888,6,894,1220,0,0,0,0,0,0,73.28
臺南縣,南化鄉,南化村,576,1,525,4,529,716,0,0,0,0,0,0,73.88
臺南縣,南化鄉,南化村,577,1,480,3,483,690,0,0,0,0,0,0,70.00
臺南縣,南化鄉,小崙村,578,1,578,7,585,809,0,0,0,0,0,0,72.31
臺南縣,南化鄉,東和村,579,1,473,3,476,690,0,0,0,0,0,0,68.99
臺南縣,南化鄉,中坑村,580,1,389,2,391,514,0,0,0,0,0,0,76.07
臺南縣,南化鄉,北平村,581,1,463,3,466,582,0,0,0,0,0,0,80.07
臺南縣,南化鄉,西埔村,582,1,618,9,627,836,0,0,0,0,0,0,75.00
臺南縣,南化鄉,北寮村,583,1,875,6,881,1237,0,0,0,0,0,0,71.22
臺南縣,南化鄉,玉山村,584,1,676,6,682,942,0,0,0,0,0,0,72.40
臺南縣,南化鄉,關山村,585,1,300,4,304,534,0,0,0,0,0,0,56.93
臺南縣,左鎮鄉,光和村,586,1,322,1,323,457,0,0,0,0,0,0,70.68
臺南縣,左鎮鄉,榮和村,587,1,530,4,534,719,0,0,0,0,0,0,74.27
臺南縣,左鎮鄉,左鎮村,588,1,408,7,415,557,0,0,0,0,0,0,74.51
臺南縣,左鎮鄉,中正村,589,1,689,6,695,916,0,0,0,0,0,0,75.87
臺南縣,左鎮鄉,睦光村,590,1,277,2,279,354,0,0,0,0,0,0,78.81
臺南縣,左鎮鄉,內庄村,591,1,361,3,364,475,0,0,0,0,0,0,76.63
臺南縣,左鎮鄉,岡林村,592,1,305,7,312,433,0,0,0,0,0,0,72.06
臺南縣,左鎮鄉,草山村,593,1,209,1,210,295,0,0,0,0,0,0,71.19
臺南縣,左鎮鄉,二寮村,594,1,180,4,184,238,0,0,0,0,0,0,77.31
臺南縣,左鎮鄉,澄山村,595,1,414,7,421,593,0,0,0,0,0,0,70.99
臺南縣,仁德鄉,太子村,596,1,874,10,884,1410,0,0,0,0,0,0,62.70
臺南縣,仁德鄉,太子村,597,1,745,15,760,1173,0,0,0,0,0,0,64.79
臺南縣,仁德鄉,太子村,598,1,653,8,661,1135,0,0,0,0,0,0,58.24
臺南縣,仁德鄉,土庫村,599,1,589,5,594,972,0,0,0,0,0,0,61.11
臺南縣,仁德鄉,土庫村,600,1,668,5,673,1134,0,0,0,0,0,0,59.35
臺南縣,仁德鄉,一甲村,601,1,538,3,541,817,0,0,0,0,0,0,66.22
臺南縣,仁德鄉,一甲村,602,1,496,5,501,846,0,0,0,0,0,0,59.22
臺南縣,仁德鄉,仁德村,603,1,789,9,798,1271,0,0,0,0,0,0,62.79
臺南縣,仁德鄉,仁德村,604,1,531,11,542,1015,0,0,0,0,0,0,53.40
臺南縣,仁德鄉,仁德村,605,1,660,17,677,1133,0,0,0,0,0,0,59.75
臺南縣,仁德鄉,仁義村,606,1,801,6,807,1189,0,0,0,0,0,0,67.87
臺南縣,仁德鄉,仁義村,607,1,667,12,679,1057,0,0,0,0,0,0,64.24
臺南縣,仁德鄉,仁義村,608,1,909,10,919,1594,0,0,0,0,0,0,57.65
臺南縣,仁德鄉,仁義村,609,1,471,7,478,774,0,0,0,0,0,0,61.76
臺南縣,仁德鄉,仁義村,610,1,801,10,811,1193,0,0,0,0,0,0,67.98
臺南縣,仁德鄉,新田村,611,1,919,15,934,1524,0,0,0,0,0,0,61.29
臺南縣,仁德鄉,新田村,612,1,509,6,515,813,0,0,0,0,0,0,63.35
臺南縣,仁德鄉,後壁村,613,1,676,9,685,1118,0,0,0,0,0,0,61.27
臺南縣,仁德鄉,後壁村,614,1,1001,8,1009,1666,0,0,0,0,0,0,60.56
臺南縣,仁德鄉,後壁村,615,1,802,9,811,1288,0,0,0,0,0,0,62.97
臺南縣,仁德鄉,後壁村,616,1,733,11,744,1404,0,0,0,0,0,0,52.99
臺南縣,仁德鄉,上崙村,617,1,778,9,787,1368,0,0,0,0,0,0,57.53
臺南縣,仁德鄉,上崙村,618,1,963,17,980,1593,0,0,0,0,0,0,61.52
臺南縣,仁德鄉,上崙村,619,1,444,5,449,713,0,0,0,0,0,0,62.97
臺南縣,仁德鄉,田厝村,620,1,938,10,948,1249,0,0,0,0,0,0,75.90
臺南縣,仁德鄉,三甲村,621,1,531,5,536,662,0,0,0,0,0,0,80.97
臺南縣,仁德鄉,保安村,622,1,461,5,466,786,0,0,0,0,0,0,59.29
臺南縣,仁德鄉,保安村,623,1,781,10,791,1267,0,0,0,0,0,0,62.43
臺南縣,仁德鄉,成功村,624,1,736,17,753,1184,0,0,0,0,0,0,63.60
臺南縣,仁德鄉,成功村,625,1,626,12,638,952,0,0,0,0,0,0,67.02
臺南縣,仁德鄉,成功村,626,1,702,10,712,1020,0,0,0,0,0,0,69.80
臺南縣,仁德鄉,成功村,627,1,195,2,197,311,0,0,0,0,0,0,63.34
臺南縣,仁德鄉,仁和村,628,1,826,23,849,1197,0,0,0,0,0,0,70.93
臺南縣,仁德鄉,仁愛村,629,1,654,11,665,938,0,0,0,0,0,0,70.90
臺南縣,仁德鄉,仁愛村,630,1,638,9,647,1009,0,0,0,0,0,0,64.12
臺南縣,仁德鄉,二行村,631,1,839,20,859,1172,0,0,0,0,0,0,73.29
臺南縣,仁德鄉,二行村,632,1,611,9,620,793,0,0,0,0,0,0,78.18
臺南縣,仁德鄉,大甲村,633,1,618,11,629,817,0,0,0,0,0,0,76.99
臺南縣,仁德鄉,大甲村,634,1,764,11,775,1033,0,0,0,0,0,0,75.02
臺南縣,仁德鄉,中洲村,635,1,828,10,838,1193,0,0,0,0,0,0,70.24
臺南縣,仁德鄉,中生村,636,1,978,16,994,1373,0,0,0,0,0,0,72.40
臺南縣,歸仁鄉,南保村,637,1,923,10,933,1445,0,0,0,0,0,0,64.57
臺南縣,歸仁鄉,南保村,638,1,839,7,846,1306,0,0,0,0,0,0,64.78
臺南縣,歸仁鄉,南保村,639,1,877,9,886,1340,0,0,0,0,0,0,66.12
臺南縣,歸仁鄉,南興村,640,1,834,8,842,1357,0,0,0,0,0,0,62.05
臺南縣,歸仁鄉,南興村,641,1,729,4,733,1101,0,0,0,0,0,0,66.58
臺南縣,歸仁鄉,六甲村,642,1,654,10,664,1014,0,0,0,0,0,0,65.48
臺南縣,歸仁鄉,六甲村,643,1,686,10,696,1110,0,0,0,0,0,0,62.70
臺南縣,歸仁鄉,六甲村,644,1,726,7,733,1134,0,0,0,0,0,0,64.64
臺南縣,歸仁鄉,六甲村,645,1,803,8,811,1289,0,0,0,0,0,0,62.92
臺南縣,歸仁鄉,後市村,646,1,856,5,861,1250,0,0,0,0,0,0,68.88
臺南縣,歸仁鄉,後市村,647,1,728,7,735,1210,0,0,0,0,0,0,60.74
臺南縣,歸仁鄉,後市村,648,1,742,6,748,1130,0,0,0,0,0,0,66.19
臺南縣,歸仁鄉,後市村,649,1,738,6,744,1123,0,0,0,0,0,0,66.25
臺南縣,歸仁鄉,辜厝村,650,1,979,8,987,1452,0,0,0,0,0,0,67.98
臺南縣,歸仁鄉,辜厝村,651,1,889,6,895,1418,0,0,0,0,0,0,63.12
臺南縣,歸仁鄉,辜厝村,652,1,874,9,883,1276,0,0,0,0,0,0,69.20
臺南縣,歸仁鄉,許厝村,653,1,895,10,905,1385,0,0,0,0,0,0,65.34
臺南縣,歸仁鄉,許厝村,654,1,848,7,855,1192,0,0,0,0,0,0,71.73
臺南縣,歸仁鄉,看西村,655,1,909,9,918,1258,0,0,0,0,0,0,72.97
臺南縣,歸仁鄉,看東村,656,1,866,12,878,1258,0,0,0,0,0,0,69.79
臺南縣,歸仁鄉,崙頂村,657,1,539,5,544,763,0,0,0,0,0,0,71.30
臺南縣,歸仁鄉,崙頂村,658,1,737,6,743,1022,0,0,0,0,0,0,72.70
臺南縣,歸仁鄉,沙崙村,659,1,380,4,384,533,0,0,0,0,0,0,72.05
臺南縣,歸仁鄉,大潭村,660,1,599,2,601,853,0,0,0,0,0,0,70.46
臺南縣,歸仁鄉,大潭村,661,1,568,2,570,767,0,0,0,0,0,0,74.32
臺南縣,歸仁鄉,武東村,662,1,814,16,830,1247,0,0,0,0,0,0,66.56
臺南縣,歸仁鄉,歸仁村,663,1,643,4,647,883,0,0,0,0,0,0,73.27
臺南縣,歸仁鄉,歸仁村,664,1,560,3,563,897,0,0,0,0,0,0,62.76
臺南縣,歸仁鄉,八甲村,665,1,662,6,668,1011,0,0,0,0,0,0,66.07
臺南縣,歸仁鄉,八甲村,666,1,567,12,579,849,0,0,0,0,0,0,68.20
臺南縣,歸仁鄉,七甲村,667,1,659,7,666,916,0,0,0,0,0,0,72.71
臺南縣,歸仁鄉,七甲村,668,1,484,6,490,860,0,0,0,0,0,0,56.98
臺南縣,歸仁鄉,媽廟村,669,1,655,6,661,932,0,0,0,0,0,0,70.92
臺南縣,歸仁鄉,媽廟村,670,1,576,7,583,860,0,0,0,0,0,0,67.79
臺南縣,歸仁鄉,西埔村,671,1,495,10,505,700,0,0,0,0,0,0,72.14
臺南縣,歸仁鄉,西埔村,672,1,404,7,411,578,0,0,0,0,0,0,71.11
臺南縣,歸仁鄉,大廟村,673,1,748,8,756,1250,0,0,0,0,0,0,60.48
臺南縣,歸仁鄉,大廟村,674,1,547,8,555,838,0,0,0,0,0,0,66.23
臺南縣,關廟鄉,關廟村,675,1,530,5,535,815,0,0,0,0,0,0,65.64
臺南縣,關廟鄉,關廟村,676,1,676,8,684,989,0,0,0,0,0,0,69.16
臺南縣,關廟鄉,山西村,677,1,486,5,491,733,0,0,0,0,0,0,66.98
臺南縣,關廟鄉,山西村,678,1,672,6,678,1023,0,0,0,0,0,0,66.28
臺南縣,關廟鄉,香洋村,679,1,692,4,696,1064,0,0,0,0,0,0,65.41
臺南縣,關廟鄉,香洋村,680,1,715,7,722,1082,0,0,0,0,0,0,66.73
臺南縣,關廟鄉,香洋村,681,1,781,3,784,1251,0,0,0,0,0,0,62.67
臺南縣,關廟鄉,北勢村,682,1,868,8,876,1235,0,0,0,0,0,0,70.93
臺南縣,關廟鄉,北勢村,683,1,794,6,800,1207,0,0,0,0,0,0,66.28
臺南縣,關廟鄉,新埔村,684,1,575,8,583,832,0,0,0,0,0,0,70.07
臺南縣,關廟鄉,新光村,685,1,525,3,528,748,0,0,0,0,0,0,70.59
臺南縣,關廟鄉,五甲村,686,1,818,16,834,1267,0,0,0,0,0,0,65.82
臺南縣,關廟鄉,五甲村,687,1,866,14,880,1233,0,0,0,0,0,0,71.37
臺南縣,關廟鄉,東勢村,688,1,1008,6,1014,1464,0,0,0,0,0,0,69.26
臺南縣,關廟鄉,東勢村,689,1,837,8,845,1311,0,0,0,0,0,0,64.45
臺南縣,關廟鄉,松腳村,690,1,599,5,604,876,0,0,0,0,0,0,68.95
臺南縣,關廟鄉,松腳村,691,1,735,5,740,1017,0,0,0,0,0,0,72.76
臺南縣,關廟鄉,南花村,692,1,890,7,897,1342,0,0,0,0,0,0,66.84
臺南縣,關廟鄉,北花村,693,1,590,4,594,874,0,0,0,0,0,0,67.96
臺南縣,關廟鄉,北花村,694,1,754,5,759,1192,0,0,0,0,0,0,63.67
臺南縣,關廟鄉,深坑村,695,1,994,13,1007,1454,0,0,0,0,0,0,69.26
臺南縣,關廟鄉,布袋村,696,1,786,9,795,1181,0,0,0,0,0,0,67.32
臺南縣,關廟鄉,田中村,697,1,542,6,548,746,0,0,0,0,0,0,73.46
臺南縣,關廟鄉,龜洞村,698,1,582,1,583,745,0,0,0,0,0,0,78.26
臺南縣,關廟鄉,埤頭村,699,1,941,10,951,1443,0,0,0,0,0,0,65.90
臺南縣,關廟鄉,下湖村,700,1,297,1,298,388,0,0,0,0,0,0,76.80
臺南縣,龍崎鄉,崎頂村,701,1,817,2,819,1175,0,0,0,0,0,0,69.70
臺南縣,龍崎鄉,土崎村,702,1,514,4,518,696,0,0,0,0,0,0,74.43
臺南縣,龍崎鄉,中坑村,703,1,102,0,102,212,0,0,0,0,0,0,48.11
臺南縣,龍崎鄉,楠坑村,704,1,235,3,238,301,0,0,0,0,0,0,79.07
臺南縣,龍崎鄉,牛埔村,705,1,217,1,218,285,0,0,0,0,0,0,76.49
臺南縣,龍崎鄉,大坪村,706,1,216,1,217,302,0,0,0,0,0,0,71.85
臺南縣,龍崎鄉,龍船村,707,1,331,1,332,455,0,0,0,0,0,0,72.97
臺南縣,龍崎鄉,石曹村,708,1,279,1,280,377,0,0,0,0,0,0,74.27
臺南縣,永康市,五王里,709,1,703,13,716,1300,0,0,0,0,0,0,55.08
臺南縣,永康市,五王里,710,1,553,4,557,1045,0,0,0,0,0,0,53.30
臺南縣,永康市,五王里,711,1,601,5,606,1220,0,0,0,0,0,0,49.67
臺南縣,永康市,三合里,712,1,707,8,715,1224,0,0,0,0,0,0,58.42
臺南縣,永康市,三合里,713,1,660,6,666,1256,0,0,0,0,0,0,53.03
臺南縣,永康市,六合里,714,1,709,14,723,1302,0,0,0,0,0,0,55.53
臺南縣,永康市,六合里,715,1,573,9,582,1325,0,0,0,0,0,0,43.92
臺南縣,永康市,網寮里,716,1,679,10,689,1193,0,0,0,0,0,0,57.75
臺南縣,永康市,網寮里,717,1,547,7,554,1082,0,0,0,0,0,0,51.20
臺南縣,永康市,網寮里,718,1,620,5,625,1120,0,0,0,0,0,0,55.80
臺南縣,永康市,二王里,719,1,612,4,616,1154,0,0,0,0,0,0,53.38
臺南縣,永康市,二王里,720,1,743,8,751,1438,0,0,0,0,0,0,52.23
臺南縣,永康市,二王里,721,1,686,9,695,1297,0,0,0,0,0,0,53.59
臺南縣,永康市,二王里,722,1,574,5,579,1229,0,0,0,0,0,0,47.11
臺南縣,永康市,永康里,723,1,701,14,715,1220,0,0,0,0,0,0,58.61
臺南縣,永康市,永康里,724,1,787,6,793,1222,0,0,0,0,0,0,64.89
臺南縣,永康市,永康里,725,1,749,2,751,1309,0,0,0,0,0,0,57.37
臺南縣,永康市,永康里,726,1,627,9,636,1325,0,0,0,0,0,0,48.00
臺南縣,永康市,埔園里,727,1,735,8,743,1176,0,0,0,0,0,0,63.18
臺南縣,永康市,埔園里,728,1,572,16,588,1110,0,0,0,0,0,0,52.97
臺南縣,永康市,埔園里,729,1,628,8,636,1162,0,0,0,0,0,0,54.73
臺南縣,永康市,埔園里,730,1,541,5,546,1057,0,0,0,0,0,0,51.66
臺南縣,永康市,正強里,731,1,730,9,739,1187,0,0,0,0,0,0,62.26
臺南縣,永康市,正強里,732,1,793,15,808,1391,0,0,0,0,0,0,58.09
臺南縣,永康市,正強里,733,1,734,11,745,1305,0,0,0,0,0,0,57.09
臺南縣,永康市,正強里,734,1,623,8,631,1275,0,0,0,0,0,0,49.49
臺南縣,永康市,大橋里,735,1,638,7,645,1334,0,0,0,0,0,0,48.35
臺南縣,永康市,大橋里,736,1,650,2,652,1237,0,0,0,0,0,0,52.71
臺南縣,永康市,大橋里,737,1,626,7,633,1172,0,0,0,0,0,0,54.01
臺南縣,永康市,東橋里,738,1,343,5,348,645,0,0,0,0,0,0,53.95
臺南縣,永康市,東橋里,739,1,436,3,439,774,0,0,0,0,0,0,56.72
臺南縣,永康市,東橋里,740,1,395,3,398,686,0,0,0,0,0,0,58.02
臺南縣,永康市,西橋里,741,1,612,12,624,1120,0,0,0,0,0,0,55.71
臺南縣,永康市,西橋里,742,1,570,7,577,1059,0,0,0,0,0,0,54.49
臺南縣,永康市,安康里,743,1,527,7,534,1037,0,0,0,0,0,0,51.49
臺南縣,永康市,安康里,744,1,598,7,605,1215,0,0,0,0,0,0,49.79
臺南縣,永康市,蔦松里,745,1,860,10,870,1325,0,0,0,0,0,0,65.66
臺南縣,永康市,三民里,746,1,704,5,709,1065,0,0,0,0,0,0,66.57
臺南縣,永康市,鹽行里,747,1,522,5,527,956,0,0,0,0,0,0,55.13
臺南縣,永康市,鹽行里,748,1,572,3,575,1027,0,0,0,0,0,0,55.99
臺南縣,永康市,鹽行里,749,1,583,9,592,1154,0,0,0,0,0,0,51.30
臺南縣,永康市,鹽行里,750,1,613,8,621,1292,0,0,0,0,0,0,48.07
臺南縣,永康市,鹽行里,751,1,503,9,512,985,0,0,0,0,0,0,51.98
臺南縣,永康市,鹽洲里,752,1,742,9,751,1347,0,0,0,0,0,0,55.75
臺南縣,永康市,鹽洲里,753,1,754,6,760,1384,0,0,0,0,0,0,54.91
臺南縣,永康市,鹽洲里,754,1,695,12,707,1186,0,0,0,0,0,0,59.61
臺南縣,永康市,甲頂里,755,1,450,4,454,630,0,0,0,0,0,0,72.06
臺南縣,永康市,甲頂里,756,1,406,6,412,666,0,0,0,0,0,0,61.86
臺南縣,永康市,甲頂里,757,1,606,8,614,883,0,0,0,0,0,0,69.54
臺南縣,永康市,尚頂里,758,1,610,1,611,1001,0,0,0,0,0,0,61.04
臺南縣,永康市,尚頂里,759,1,479,5,484,816,0,0,0,0,0,0,59.31
臺南縣,永康市,尚頂里,760,1,614,7,621,1174,0,0,0,0,0,0,52.90
臺南縣,永康市,龍潭里,761,1,807,9,816,1352,0,0,0,0,0,0,60.36
臺南縣,永康市,龍潭里,762,1,706,9,715,1262,0,0,0,0,0,0,56.66
臺南縣,永康市,龍潭里,763,1,755,4,759,1334,0,0,0,0,0,0,56.90
臺南縣,永康市,龍潭里,764,1,742,5,747,1630,0,0,0,0,0,0,45.83
臺南縣,永康市,王行里,765,1,716,4,720,1153,0,0,0,0,0,0,62.45
臺南縣,永康市,王行里,766,1,399,3,402,526,0,0,0,0,0,0,76.43
臺南縣,永康市,烏竹里,767,1,788,5,793,1306,0,0,0,0,0,0,60.72
臺南縣,永康市,西勢里,768,1,720,10,730,1146,0,0,0,0,0,0,63.70
臺南縣,永康市,西勢里,769,1,620,5,625,1058,0,0,0,0,0,0,59.07
臺南縣,永康市,西勢里,770,1,638,16,654,1180,0,0,0,0,0,0,55.42
臺南縣,永康市,新樹里,771,1,735,6,741,1186,0,0,0,0,0,0,62.48
臺南縣,永康市,大灣里,772,1,675,8,683,1009,0,0,0,0,0,0,67.69
臺南縣,永康市,大灣里,773,1,517,9,526,735,0,0,0,0,0,0,71.56
臺南縣,永康市,大灣里,774,1,713,6,719,1041,0,0,0,0,0,0,69.07
臺南縣,永康市,東灣里,775,1,535,8,543,817,0,0,0,0,0,0,66.46
臺南縣,永康市,東灣里,776,1,537,16,553,938,0,0,0,0,0,0,58.96
臺南縣,永康市,東灣里,777,1,661,5,666,1084,0,0,0,0,0,0,61.44
臺南縣,永康市,西灣里,778,1,702,9,711,1092,0,0,0,0,0,0,65.11
臺南縣,永康市,西灣里,779,1,612,9,621,1084,0,0,0,0,0,0,57.29
臺南縣,永康市,西灣里,780,1,660,15,675,1125,0,0,0,0,0,0,60.00
臺南縣,永康市,西灣里,781,1,630,5,635,1079,0,0,0,0,0,0,58.85
臺南縣,永康市,南灣里,782,1,695,4,699,1168,0,0,0,0,0,0,59.85
臺南縣,永康市,南灣里,783,1,765,2,767,1085,0,0,0,0,0,0,70.69
臺南縣,永康市,南灣里,784,1,676,6,682,1003,0,0,0,0,0,0,68.00
臺南縣,永康市,崑山里,785,1,719,11,730,1194,0,0,0,0,0,0,61.14
臺南縣,永康市,崑山里,786,1,763,3,766,1241,0,0,0,0,0,0,61.72
臺南縣,永康市,崑山里,787,1,728,7,735,1176,0,0,0,0,0,0,62.50
臺南縣,永康市,崑山里,788,1,708,12,720,1176,0,0,0,0,0,0,61.22
臺南縣,永康市,北灣里,789,1,712,11,723,1127,0,0,0,0,0,0,64.15
臺南縣,永康市,北灣里,790,1,678,4,682,1096,0,0,0,0,0,0,62.23
臺南縣,永康市,北灣里,791,1,677,8,685,1186,0,0,0,0,0,0,57.76
臺南縣,永康市,北灣里,792,1,659,17,676,1185,0,0,0,0,0,0,57.05
臺南縣,永康市,復興里,793,1,521,16,537,824,0,0,0,0,0,0,65.17
臺南縣,永康市,復興里,794,1,633,15,648,986,0,0,0,0,0,0,65.72
臺南縣,永康市,建國里,795,1,718,12,730,1116,0,0,0,0,0,0,65.41
臺南縣,永康市,建國里,796,1,595,9,604,875,0,0,0,0,0,0,69.03
臺南縣,永康市,復國里,797,1,636,6,642,1007,0,0,0,0,0,0,63.75
臺南縣,永康市,復國里,798,1,609,9,618,980,0,0,0,0,0,0,63.06
臺南縣,永康市,復華里,799,1,591,10,601,1388,0,0,0,0,0,0,43.30
臺南縣,永康市,復華里,800,1,674,9,683,1377,0,0,0,0,0,0,49.60
臺南縣,永康市,復華里,801,1,646,6,652,1121,0,0,0,0,0,0,58.16
臺南縣,永康市,復華里,802,1,669,11,680,1420,0,0,0,0,0,0,47.89
臺南縣,永康市,復華里,803,1,672,11,683,1363,0,0,0,0,0,0,50.11
臺南縣,永康市,復華里,804,1,581,6,587,1101,0,0,0,0,0,0,53.32
臺南縣,永康市,復華里,805,1,620,4,624,1096,0,0,0,0,0,0,56.93
臺南縣,永康市,光復里,806,1,786,6,792,1214,0,0,0,0,0,0,65.24
臺南縣,永康市,神洲里,807,1,628,8,636,931,0,0,0,0,0,0,68.31
臺南縣,永康市,神洲里,808,1,470,5,475,830,0,0,0,0,0,0,57.23
臺南縣,永康市,成功里,809,1,695,8,703,1015,0,0,0,0,0,0,69.26
臺南縣,永康市,成功里,810,1,655,13,668,1181,0,0,0,0,0,0,56.56
臺南縣,永康市,中華里,811,1,451,3,454,846,0,0,0,0,0,0,53.66
臺南縣,永康市,中華里,812,1,508,4,512,961,0,0,0,0,0,0,53.28
臺南縣,永康市,中興里,813,1,799,9,808,1309,0,0,0,0,0,0,61.73
臺南縣,永康市,中興里,814,1,806,9,815,1373,0,0,0,0,0,0,59.36
臺南縣,永康市,勝利里,815,1,548,12,560,912,0,0,0,0,0,0,61.40
臺南縣,永康市,勝利里,816,1,543,4,547,1208,0,0,0,0,0,0,45.28
臺南縣,永康市,勝利里,817,1,558,5,563,1040,0,0,0,0,0,0,54.13
臺南縣,永康市,勝利里,818,1,566,9,575,1008,0,0,0,0,0,0,57.04
高雄縣,鳳山市,鳳崗里,1,1,377,4,381,594,0,0,0,0,0,0,64.14
高雄縣,鳳山市,鳳崗里,2,1,439,5,444,706,0,0,0,0,0,0,62.89
高雄縣,鳳山市,縣衙里,3,1,573,3,576,870,0,0,0,0,0,0,66.21
高雄縣,鳳山市,曹公里,4,1,810,7,817,1227,0,0,0,0,0,0,66.59
高雄縣,鳳山市,曹公里,5,1,685,10,695,1100,0,0,0,0,0,0,63.18
高雄縣,鳳山市,鎮西里,6,1,894,9,903,1387,0,0,0,0,0,0,65.10
高雄縣,鳳山市,鎮西里,7,1,805,10,815,1237,0,0,0,0,0,0,65.89
高雄縣,鳳山市,鎮西里,8,1,744,11,755,1130,0,0,0,0,0,0,66.81
高雄縣,鳳山市,鎮西里,9,1,717,10,727,1151,0,0,0,0,0,0,63.16
高雄縣,鳳山市,北門里,10,1,671,8,679,1012,0,0,0,0,0,0,67.09
高雄縣,鳳山市,北門里,11,1,579,11,590,915,0,0,0,0,0,0,64.48
高雄縣,鳳山市,北門里,12,1,559,13,572,905,0,0,0,0,0,0,63.20
高雄縣,鳳山市,北門里,13,1,571,11,582,850,0,0,0,0,0,0,68.47
高雄縣,鳳山市,鎮北里,14,1,635,15,650,992,0,0,0,0,0,0,65.52
高雄縣,鳳山市,鎮北里,15,1,740,11,751,1139,0,0,0,0,0,0,65.94
高雄縣,鳳山市,鎮北里,16,1,417,5,422,670,0,0,0,0,0,0,62.99
高雄縣,鳳山市,鎮北里,17,1,729,11,740,1079,0,0,0,0,0,0,68.58
高雄縣,鳳山市,武松里,18,1,604,6,610,1105,0,0,0,0,0,0,55.20
高雄縣,鳳山市,武松里,19,1,712,9,721,1125,0,0,0,0,0,0,64.09
高雄縣,鳳山市,忠誠里,20,1,882,17,899,1362,0,0,0,0,0,0,66.01
高雄縣,鳳山市,忠誠里,21,1,951,13,964,1506,0,0,0,0,0,0,64.01
高雄縣,鳳山市,文英里,22,1,734,9,743,1087,0,0,0,0,0,0,68.35
高雄縣,鳳山市,文英里,23,1,680,14,694,1110,0,0,0,0,0,0,62.52
高雄縣,鳳山市,文華里,24,1,632,14,646,930,0,0,0,0,0,0,69.46
高雄縣,鳳山市,文華里,25,1,589,7,596,960,0,0,0,0,0,0,62.08
高雄縣,鳳山市,文華里,26,1,613,4,617,1049,0,0,0,0,0,0,58.82
高雄縣,鳳山市,文華里,27,1,715,6,721,1045,0,0,0,0,0,0,69.00
高雄縣,鳳山市,文山里,28,1,764,7,771,1210,0,0,0,0,0,0,63.72
高雄縣,鳳山市,文山里,29,1,752,13,765,1100,0,0,0,0,0,0,69.55
高雄縣,鳳山市,文山里,30,1,741,5,746,1124,0,0,0,0,0,0,66.37
高雄縣,鳳山市,文山里,31,1,760,15,775,1203,0,0,0,0,0,0,64.42
高雄縣,鳳山市,文德里,32,1,618,8,626,1122,0,0,0,0,0,0,55.79
高雄縣,鳳山市,文德里,33,1,520,9,529,854,0,0,0,0,0,0,61.94
高雄縣,鳳山市,文德里,34,1,555,3,558,1008,0,0,0,0,0,0,55.36
高雄縣,鳳山市,文德里,35,1,559,3,562,1093,0,0,0,0,0,0,51.42
高雄縣,鳳山市,文衡里,36,1,696,8,704,959,0,0,0,0,0,0,73.41
高雄縣,鳳山市,文衡里,37,1,654,3,657,1074,0,0,0,0,0,0,61.17
高雄縣,鳳山市,文福里,38,1,619,5,624,1034,0,0,0,0,0,0,60.35
高雄縣,鳳山市,文福里,39,1,721,11,732,1191,0,0,0,0,0,0,61.46
高雄縣,鳳山市,文福里,40,1,616,6,622,1136,0,0,0,0,0,0,54.75
高雄縣,鳳山市,文福里,41,1,706,12,718,1264,0,0,0,0,0,0,56.80
高雄縣,鳳山市,成功里,42,1,571,6,577,817,0,0,0,0,0,0,70.62
高雄縣,鳳山市,縣口里,43,1,362,4,366,525,0,0,0,0,0,0,69.71
高雄縣,鳳山市,光明里,44,1,396,6,402,588,0,0,0,0,0,0,68.37
高雄縣,鳳山市,光明里,45,1,554,3,557,786,0,0,0,0,0,0,70.87
高雄縣,鳳山市,和德里,46,1,527,6,533,811,0,0,0,0,0,0,65.72
高雄縣,鳳山市,和德里,47,1,526,7,533,785,0,0,0,0,0,0,67.90
高雄縣,鳳山市,和興里,48,1,742,7,749,1151,0,0,0,0,0,0,65.07
高雄縣,鳳山市,和興里,49,1,736,1,737,1088,0,0,0,0,0,0,67.74
高雄縣,鳳山市,和興里,50,1,690,4,694,1083,0,0,0,0,0,0,64.08
高雄縣,鳳山市,和興里,51,1,729,13,742,1090,0,0,0,0,0,0,68.07
高雄縣,鳳山市,南興里,52,1,644,11,655,1008,0,0,0,0,0,0,64.98
高雄縣,鳳山市,三民里,53,1,794,8,802,1099,0,0,0,0,0,0,72.98
高雄縣,鳳山市,新興里,54,1,850,9,859,1166,0,0,0,0,0,0,73.67
高雄縣,鳳山市,興仁里,55,1,683,9,692,999,0,0,0,0,0,0,69.27
高雄縣,鳳山市,興仁里,56,1,491,5,496,794,0,0,0,0,0,0,62.47
高雄縣,鳳山市,興仁里,57,1,587,5,592,893,0,0,0,0,0,0,66.29
高雄縣,鳳山市,興仁里,58,1,624,7,631,915,0,0,0,0,0,0,68.96
高雄縣,鳳山市,興中里,59,1,560,1,561,807,0,0,0,0,0,0,69.52
高雄縣,鳳山市,協和里,60,1,685,9,694,1121,0,0,0,0,0,0,61.91
高雄縣,鳳山市,協和里,61,1,843,9,852,1191,0,0,0,0,0,0,71.54
高雄縣,鳳山市,協和里,62,1,747,6,753,1042,0,0,0,0,0,0,72.26
高雄縣,鳳山市,忠義里,63,1,610,7,617,926,0,0,0,0,0,0,66.63
高雄縣,鳳山市,忠義里,64,1,876,2,878,1426,0,0,0,0,0,0,61.57
高雄縣,鳳山市,忠義里,65,1,801,10,811,1174,0,0,0,0,0,0,69.08
高雄縣,鳳山市,忠孝里,66,1,632,7,639,1019,0,0,0,0,0,0,62.71
高雄縣,鳳山市,忠孝里,67,1,635,7,642,1020,0,0,0,0,0,0,62.94
高雄縣,鳳山市,忠孝里,68,1,614,6,620,978,0,0,0,0,0,0,63.39
高雄縣,鳳山市,忠孝里,69,1,666,6,672,977,0,0,0,0,0,0,68.78
高雄縣,鳳山市,忠孝里,70,1,631,5,636,943,0,0,0,0,0,0,67.44
高雄縣,鳳山市,中和里,71,1,737,10,747,1081,0,0,0,0,0,0,69.10
高雄縣,鳳山市,中和里,72,1,670,4,674,1039,0,0,0,0,0,0,64.87
高雄縣,鳳山市,中和里,73,1,700,7,707,1057,0,0,0,0,0,0,66.89
高雄縣,鳳山市,誠正里,74,1,374,2,376,554,0,0,0,0,0,0,67.87
高雄縣,鳳山市,誠正里,75,1,361,5,366,509,0,0,0,0,0,0,71.91
高雄縣,鳳山市,誠義里,76,1,397,3,400,606,0,0,0,0,0,0,66.01
高雄縣,鳳山市,生明里,77,1,999,11,1010,1452,0,0,0,0,0,0,69.56
高雄縣,鳳山市,鎮東里,78,1,708,9,717,1144,0,0,0,0,0,0,62.67
高雄縣,鳳山市,鎮東里,79,1,691,12,703,1059,0,0,0,0,0,0,66.38
高雄縣,鳳山市,瑞竹里,80,1,730,8,738,1030,0,0,0,0,0,0,71.65
高雄縣,鳳山市,瑞竹里,81,1,555,8,563,825,0,0,0,0,0,0,68.24
高雄縣,鳳山市,瑞竹里,82,1,714,11,725,1068,0,0,0,0,0,0,67.88
高雄縣,鳳山市,瑞竹里,83,1,546,4,550,870,0,0,0,0,0,0,63.22
高雄縣,鳳山市,瑞竹里,84,1,615,9,624,1005,0,0,0,0,0,0,62.09
高雄縣,鳳山市,瑞興里,85,1,706,20,726,1140,0,0,0,0,0,0,63.68
高雄縣,鳳山市,瑞興里,86,1,782,5,787,1247,0,0,0,0,0,0,63.11
高雄縣,鳳山市,瑞興里,87,1,682,6,688,1048,0,0,0,0,0,0,65.65
高雄縣,鳳山市,東門里,88,1,884,11,895,1356,0,0,0,0,0,0,66.00
高雄縣,鳳山市,東門里,89,1,510,4,514,828,0,0,0,0,0,0,62.08
高雄縣,鳳山市,東門里,90,1,735,5,740,1158,0,0,0,0,0,0,63.90
高雄縣,鳳山市,誠德里,91,1,690,6,696,1002,0,0,0,0,0,0,69.46
高雄縣,鳳山市,誠德里,92,1,701,10,711,1057,0,0,0,0,0,0,67.27
高雄縣,鳳山市,誠信里,93,1,517,7,524,831,0,0,0,0,0,0,63.06
高雄縣,鳳山市,誠信里,94,1,402,3,405,746,0,0,0,0,0,0,54.29
高雄縣,鳳山市,誠智里,95,1,706,10,716,1178,0,0,0,0,0,0,60.78
高雄縣,鳳山市,誠智里,96,1,704,14,718,1016,0,0,0,0,0,0,70.67
高雄縣,鳳山市,鳳東里,97,1,839,10,849,1233,0,0,0,0,0,0,68.86
高雄縣,鳳山市,鳳東里,98,1,799,11,810,1231,0,0,0,0,0,0,65.80
高雄縣,鳳山市,鳳東里,99,1,741,10,751,1123,0,0,0,0,0,0,66.87
高雄縣,鳳山市,埤頂里,100,1,625,3,628,912,0,0,0,0,0,0,68.86
高雄縣,鳳山市,埤頂里,101,1,766,9,775,1102,0,0,0,0,0,0,70.33
高雄縣,鳳山市,埤頂里,102,1,601,5,606,911,0,0,0,0,0,0,66.52
高雄縣,鳳山市,埤頂里,103,1,862,10,872,1356,0,0,0,0,0,0,64.31
高雄縣,鳳山市,美齡里,104,1,666,7,673,902,0,0,0,0,0,0,74.61
高雄縣,鳳山市,中正里,105,1,656,6,662,972,0,0,0,0,0,0,68.11
高雄縣,鳳山市,中正里,106,1,710,7,717,1087,0,0,0,0,0,0,65.96
高雄縣,鳳山市,海光里,107,1,622,9,631,885,0,0,0,0,0,0,71.30
高雄縣,鳳山市,海光里,108,1,499,10,509,784,0,0,0,0,0,0,64.92
高雄縣,鳳山市,海光里,109,1,618,6,624,992,0,0,0,0,0,0,62.90
高雄縣,鳳山市,海光里,110,1,728,11,739,1269,0,0,0,0,0,0,58.23
高雄縣,鳳山市,海風里,111,1,495,6,501,716,0,0,0,0,0,0,69.97
高雄縣,鳳山市,海風里,112,1,607,7,614,817,0,0,0,0,0,0,75.15
高雄縣,鳳山市,海風里,113,1,688,7,695,944,0,0,0,0,0,0,73.62
高雄縣,鳳山市,國泰里,114,1,580,3,583,871,0,0,0,0,0,0,66.93
高雄縣,鳳山市,國泰里,115,1,520,6,526,780,0,0,0,0,0,0,67.44
高雄縣,鳳山市,國泰里,116,1,530,3,533,878,0,0,0,0,0,0,60.71
高雄縣,鳳山市,國泰里,117,1,743,12,755,1150,0,0,0,0,0,0,65.65
高雄縣,鳳山市,國光里,118,1,737,12,749,1155,0,0,0,0,0,0,64.85
高雄縣,鳳山市,國光里,119,1,700,12,712,1149,0,0,0,0,0,0,61.97
高雄縣,鳳山市,國光里,120,1,660,7,667,1012,0,0,0,0,0,0,65.91
高雄縣,鳳山市,國光里,121,1,575,8,583,978,0,0,0,0,0,0,59.61
高雄縣,鳳山市,國隆里,122,1,539,5,544,864,0,0,0,0,0,0,62.96
高雄縣,鳳山市,國隆里,123,1,400,5,405,657,0,0,0,0,0,0,61.64
高雄縣,鳳山市,國富里,124,1,600,7,607,929,0,0,0,0,0,0,65.34
高雄縣,鳳山市,國富里,125,1,564,6,570,961,0,0,0,0,0,0,59.31
高雄縣,鳳山市,武漢里,126,1,630,10,640,908,0,0,0,0,0,0,70.48
高雄縣,鳳山市,武慶里,127,1,666,10,676,1008,0,0,0,0,0,0,67.06
高雄縣,鳳山市,武漢里,128,1,598,13,611,868,0,0,0,0,0,0,70.39
高雄縣,鳳山市,武漢里,129,1,613,8,621,894,0,0,0,0,0,0,69.46
高雄縣,鳳山市,武漢里,130,1,524,7,531,803,0,0,0,0,0,0,66.13
高雄縣,鳳山市,武漢里,131,1,626,9,635,999,0,0,0,0,0,0,63.56
高雄縣,鳳山市,新甲里,132,1,404,11,415,680,0,0,0,0,0,0,61.03
高雄縣,鳳山市,新甲里,133,1,422,4,426,742,0,0,0,0,0,0,57.41
高雄縣,鳳山市,新甲里,134,1,336,2,338,575,0,0,0,0,0,0,58.78
高雄縣,鳳山市,新甲里,135,1,563,11,574,865,0,0,0,0,0,0,66.36
高雄縣,鳳山市,新武里,136,1,534,8,542,872,0,0,0,0,0,0,62.16
高雄縣,鳳山市,新泰里,137,1,528,9,537,793,0,0,0,0,0,0,67.72
高雄縣,鳳山市,新泰里,138,1,465,4,469,715,0,0,0,0,0,0,65.59
高雄縣,鳳山市,新泰里,139,1,481,5,486,797,0,0,0,0,0,0,60.98
高雄縣,鳳山市,新樂里,140,1,527,10,537,870,0,0,0,0,0,0,61.72
高雄縣,鳳山市,新樂里,141,1,495,7,502,775,0,0,0,0,0,0,64.77
高雄縣,鳳山市,新樂里,142,1,474,10,484,808,0,0,0,0,0,0,59.90
高雄縣,鳳山市,新強里,143,1,665,7,672,1021,0,0,0,0,0,0,65.82
高雄縣,鳳山市,新強里,144,1,759,3,762,1085,0,0,0,0,0,0,70.23
高雄縣,鳳山市,新強里,145,1,626,3,629,995,0,0,0,0,0,0,63.22
高雄縣,鳳山市,海洋里,146,1,610,6,616,830,0,0,0,0,0,0,74.22
高雄縣,鳳山市,海洋里,147,1,519,10,529,819,0,0,0,0,0,0,64.59
高雄縣,鳳山市,海洋里,148,1,592,10,602,903,0,0,0,0,0,0,66.67
高雄縣,鳳山市,新富里,149,1,619,6,625,1035,0,0,0,0,0,0,60.39
高雄縣,鳳山市,新富里,150,1,611,11,622,981,0,0,0,0,0,0,63.40
高雄縣,鳳山市,新富里,151,1,652,11,663,1049,0,0,0,0,0,0,63.20
高雄縣,鳳山市,老爺里,152,1,752,11,763,1189,0,0,0,0,0,0,64.17
高雄縣,鳳山市,老爺里,153,1,692,10,702,1082,0,0,0,0,0,0,64.88
高雄縣,鳳山市,老爺里,154,1,724,10,734,1148,0,0,0,0,0,0,63.94
高雄縣,鳳山市,老爺里,155,1,608,10,618,959,0,0,0,0,0,0,64.44
高雄縣,鳳山市,老爺里,156,1,574,7,581,986,0,0,0,0,0,0,58.92
高雄縣,鳳山市,中民里,157,1,910,8,918,1512,0,0,0,0,0,0,60.71
高雄縣,鳳山市,中民里,158,1,849,16,865,1445,0,0,0,0,0,0,59.86
高雄縣,鳳山市,中崙里,159,1,458,5,463,719,0,0,0,0,0,0,64.39
高雄縣,鳳山市,中崙里,160,1,658,6,664,983,0,0,0,0,0,0,67.55
高雄縣,鳳山市,中榮里,161,1,846,13,859,1357,0,0,0,0,0,0,63.30
高雄縣,鳳山市,中榮里,162,1,1128,11,1139,1875,0,0,0,0,0,0,60.75
高雄縣,鳳山市,過埤里,163,1,479,7,486,666,0,0,0,0,0,0,72.97
高雄縣,鳳山市,過埤里,164,1,407,8,415,716,0,0,0,0,0,0,57.96
高雄縣,鳳山市,過埤里,165,1,631,7,638,972,0,0,0,0,0,0,65.64
高雄縣,鳳山市,正義里,166,1,631,10,641,983,0,0,0,0,0,0,65.21
高雄縣,鳳山市,正義里,167,1,746,11,757,1096,0,0,0,0,0,0,69.07
高雄縣,鳳山市,正義里,168,1,700,5,705,1058,0,0,0,0,0,0,66.64
高雄縣,鳳山市,正義里,169,1,656,9,665,1080,0,0,0,0,0,0,61.57
高雄縣,鳳山市,正義里,170,1,685,14,699,1076,0,0,0,0,0,0,64.96
高雄縣,鳳山市,一甲里,171,1,715,8,723,1175,0,0,0,0,0,0,61.53
高雄縣,鳳山市,一甲里,172,1,669,9,678,971,0,0,0,0,0,0,69.82
高雄縣,鳳山市,一甲里,173,1,577,16,593,915,0,0,0,0,0,0,64.81
高雄縣,鳳山市,二甲里,174,1,897,15,912,1412,0,0,0,0,0,0,64.59
高雄縣,鳳山市,二甲里,175,1,1018,18,1036,1458,0,0,0,0,0,0,71.06
高雄縣,鳳山市,龍成里,176,1,675,11,686,1046,0,0,0,0,0,0,65.58
高雄縣,鳳山市,龍成里,177,1,741,6,747,1107,0,0,0,0,0,0,67.48
高雄縣,鳳山市,鎮南里,178,1,588,4,592,855,0,0,0,0,0,0,69.24
高雄縣,鳳山市,鎮南里,179,1,535,7,542,770,0,0,0,0,0,0,70.39
高雄縣,鳳山市,鎮南里,180,1,694,12,706,982,0,0,0,0,0,0,71.89
高雄縣,鳳山市,鎮南里,181,1,723,9,732,1017,0,0,0,0,0,0,71.98
高雄縣,鳳山市,富甲里,182,1,416,9,425,631,0,0,0,0,0,0,67.35
高雄縣,鳳山市,富甲里,183,1,462,6,468,671,0,0,0,0,0,0,69.75
高雄縣,鳳山市,富甲里,184,1,429,6,435,602,0,0,0,0,0,0,72.26
高雄縣,鳳山市,善美里,185,1,658,11,669,991,0,0,0,0,0,0,67.51
高雄縣,鳳山市,善美里,186,1,528,9,537,837,0,0,0,0,0,0,64.16
高雄縣,鳳山市,善美里,187,1,594,9,603,1020,0,0,0,0,0,0,59.12
高雄縣,鳳山市,善美里,188,1,542,8,550,969,0,0,0,0,0,0,56.76
高雄縣,鳳山市,富榮里,189,1,513,9,522,822,0,0,0,0,0,0,63.50
高雄縣,鳳山市,富榮里,190,1,608,6,614,955,0,0,0,0,0,0,64.29
高雄縣,鳳山市,南和里,191,1,492,5,497,734,0,0,0,0,0,0,67.71
高雄縣,鳳山市,南和里,192,1,570,5,575,862,0,0,0,0,0,0,66.71
高雄縣,鳳山市,南和里,193,1,589,4,593,898,0,0,0,0,0,0,66.04
高雄縣,鳳山市,南成里,194,1,678,8,686,1062,0,0,0,0,0,0,64.60
高雄縣,鳳山市,南成里,195,1,713,13,726,1079,0,0,0,0,0,0,67.28
高雄縣,鳳山市,南成里,196,1,746,11,757,1036,0,0,0,0,0,0,73.07
高雄縣,鳳山市,天興里,197,1,538,11,549,825,0,0,0,0,0,0,66.55
高雄縣,鳳山市,天興里,198,1,629,7,636,919,0,0,0,0,0,0,69.21
高雄縣,鳳山市,天興里,199,1,562,12,574,897,0,0,0,0,0,0,63.99
高雄縣,鳳山市,天興里,200,1,515,7,522,789,0,0,0,0,0,0,66.16
高雄縣,鳳山市,大德里,201,1,660,13,673,955,0,0,0,0,0,0,70.47
高雄縣,鳳山市,大德里,202,1,634,7,641,926,0,0,0,0,0,0,69.22
高雄縣,鳳山市,大德里,203,1,698,9,707,1015,0,0,0,0,0,0,69.66
高雄縣,鳳山市,五福里,204,1,678,12,690,990,0,0,0,0,0,0,69.70
高雄縣,鳳山市,五福里,205,1,659,6,665,1011,0,0,0,0,0,0,65.78
高雄縣,鳳山市,五福里,206,1,707,12,719,1108,0,0,0,0,0,0,64.89
高雄縣,鳳山市,福興里,207,1,746,8,754,1075,0,0,0,0,0,0,70.14
高雄縣,鳳山市,福興里,208,1,656,12,668,986,0,0,0,0,0,0,67.75
高雄縣,鳳山市,福興里,209,1,645,11,656,1077,0,0,0,0,0,0,60.91
高雄縣,鳳山市,福興里,210,1,645,6,651,953,0,0,0,0,0,0,68.31
高雄縣,鳳山市,福興里,211,1,685,14,699,1079,0,0,0,0,0,0,64.78
高雄縣,鳳山市,福祥里,212,1,669,16,685,1073,0,0,0,0,0,0,63.84
高雄縣,鳳山市,福祥里,213,1,655,12,667,1038,0,0,0,0,0,0,64.26
高雄縣,鳳山市,福誠里,214,1,522,8,530,844,0,0,0,0,0,0,62.80
高雄縣,鳳山市,福誠里,215,1,492,14,506,829,0,0,0,0,0,0,61.04
高雄縣,鳳山市,福誠里,216,1,535,5,540,971,0,0,0,0,0,0,55.61
高雄縣,林園鄉,仁愛村,217,1,826,11,837,1172,0,0,0,0,0,0,71.42
高雄縣,林園鄉,仁愛村,218,1,833,6,839,1221,0,0,0,0,0,0,68.71
高雄縣,林園鄉,林園村,219,1,693,8,701,976,0,0,0,0,0,0,71.82
高雄縣,林園鄉,林園村,220,1,628,6,634,922,0,0,0,0,0,0,68.76
高雄縣,林園鄉,林園村,221,1,621,11,632,865,0,0,0,0,0,0,73.06
高雄縣,林園鄉,文賢村,222,1,739,5,744,1059,0,0,0,0,0,0,70.25
高雄縣,林園鄉,文賢村,223,1,672,10,682,960,0,0,0,0,0,0,71.04
高雄縣,林園鄉,東林村,224,1,848,8,856,1205,0,0,0,0,0,0,71.04
高雄縣,林園鄉,東林村,225,1,785,7,792,1188,0,0,0,0,0,0,66.67
高雄縣,林園鄉,溪州村,226,1,808,11,819,1099,0,0,0,0,0,0,74.52
高雄縣,林園鄉,溪州村,227,1,690,3,693,997,0,0,0,0,0,0,69.51
高雄縣,林園鄉,溪州村,228,1,645,8,653,985,0,0,0,0,0,0,66.29
高雄縣,林園鄉,五福村,229,1,586,5,591,899,0,0,0,0,0,0,65.74
高雄縣,林園鄉,五福村,230,1,545,12,557,873,0,0,0,0,0,0,63.80
高雄縣,林園鄉,潭頭村,231,1,791,10,801,1126,0,0,0,0,0,0,71.14
高雄縣,林園鄉,潭頭村,232,1,767,10,777,1079,0,0,0,0,0,0,72.01
高雄縣,林園鄉,中厝村,233,1,944,15,959,1317,0,0,0,0,0,0,72.82
高雄縣,林園鄉,中厝村,234,1,867,13,880,1152,0,0,0,0,0,0,76.39
高雄縣,林園鄉,林內村,235,1,672,8,680,888,0,0,0,0,0,0,76.58
高雄縣,林園鄉,林內村,236,1,629,7,636,825,0,0,0,0,0,0,77.09
高雄縣,林園鄉,王公村,237,1,650,5,655,927,0,0,0,0,0,0,70.66
高雄縣,林園鄉,王公村,238,1,669,7,676,936,0,0,0,0,0,0,72.22
高雄縣,林園鄉,王公村,239,1,634,12,646,846,0,0,0,0,0,0,76.36
高雄縣,林園鄉,廣應村,240,1,608,2,610,803,0,0,0,0,0,0,75.97
高雄縣,林園鄉,廣應村,241,1,723,5,728,962,0,0,0,0,0,0,75.68
高雄縣,林園鄉,廣應村,242,1,566,9,575,800,0,0,0,0,0,0,71.88
高雄縣,林園鄉,林家村,243,1,968,5,973,1220,0,0,0,0,0,0,79.75
高雄縣,林園鄉,龔厝村,244,1,521,2,523,753,0,0,0,0,0,0,69.46
高雄縣,林園鄉,龔厝村,245,1,593,8,601,765,0,0,0,0,0,0,78.56
高雄縣,林園鄉,中門村,246,1,587,11,598,807,0,0,0,0,0,0,74.10
高雄縣,林園鄉,中門村,247,1,763,10,773,1071,0,0,0,0,0,0,72.18
高雄縣,林園鄉,頂厝村,248,1,603,5,608,873,0,0,0,0,0,0,69.64
高雄縣,林園鄉,頂厝村,249,1,754,6,760,1029,0,0,0,0,0,0,73.86
高雄縣,林園鄉,頂厝村,250,1,824,10,834,1154,0,0,0,0,0,0,72.27
高雄縣,林園鄉,港埔村,251,1,579,7,586,802,0,0,0,0,0,0,73.07
高雄縣,林園鄉,港埔村,252,1,565,5,570,757,0,0,0,0,0,0,75.30
高雄縣,林園鄉,港嘴村,253,1,869,10,879,1226,0,0,0,0,0,0,71.70
高雄縣,林園鄉,西溪村,254,1,891,12,903,1346,0,0,0,0,0,0,67.09
高雄縣,林園鄉,西溪村,255,1,850,11,861,1176,0,0,0,0,0,0,73.21
高雄縣,林園鄉,中芸村,256,1,645,7,652,920,0,0,0,0,0,0,70.87
高雄縣,林園鄉,中芸村,257,1,557,7,564,763,0,0,0,0,0,0,73.92
高雄縣,林園鄉,鳳芸村,258,1,613,8,621,778,0,0,0,0,0,0,79.82
高雄縣,林園鄉,鳳芸村,259,1,638,3,641,851,0,0,0,0,0,0,75.32
高雄縣,林園鄉,東汕村,260,1,640,6,646,904,0,0,0,0,0,0,71.46
高雄縣,林園鄉,西汕村,261,1,528,7,535,743,0,0,0,0,0,0,72.01
高雄縣,林園鄉,中汕村,262,1,761,4,765,1104,0,0,0,0,0,0,69.29
高雄縣,林園鄉,中汕村,263,1,649,7,656,1000,0,0,0,0,0,0,65.60
高雄縣,林園鄉,北汕村,264,1,398,6,404,615,0,0,0,0,0,0,65.69
高雄縣,林園鄉,北汕村,265,1,586,4,590,888,0,0,0,0,0,0,66.44
高雄縣,大寮鄉,義和村,266,1,713,10,723,923,0,0,0,0,0,0,78.33
高雄縣,大寮鄉,義和村,267,1,722,14,736,1038,0,0,0,0,0,0,70.91
高雄縣,大寮鄉,溪寮村,268,1,982,15,997,1283,0,0,0,0,0,0,77.71
高雄縣,大寮鄉,江山村,269,1,471,7,478,676,0,0,0,0,0,0,70.71
高雄縣,大寮鄉,江山村,270,1,591,12,603,808,0,0,0,0,0,0,74.63
高雄縣,大寮鄉,中庄村,271,1,649,17,666,1026,0,0,0,0,0,0,64.91
高雄縣,大寮鄉,中庄村,272,1,659,8,667,996,0,0,0,0,0,0,66.97
高雄縣,大寮鄉,中庄村,273,1,572,5,577,884,0,0,0,0,0,0,65.27
高雄縣,大寮鄉,中庄村,274,1,673,6,679,1038,0,0,0,0,0,0,65.41
高雄縣,大寮鄉,中庄村,275,1,592,6,598,908,0,0,0,0,0,0,65.86
高雄縣,大寮鄉,中庄村,276,1,656,4,660,967,0,0,0,0,0,0,68.25
高雄縣,大寮鄉,中庄村,277,1,685,7,692,992,0,0,0,0,0,0,69.76
高雄縣,大寮鄉,中庄村,278,1,663,3,666,1009,0,0,0,0,0,0,66.01
高雄縣,大寮鄉,後庄村,279,1,816,16,832,1222,0,0,0,0,0,0,68.09
高雄縣,大寮鄉,後庄村,280,1,747,7,754,1092,0,0,0,0,0,0,69.05
高雄縣,大寮鄉,後庄村,281,1,748,9,757,1154,0,0,0,0,0,0,65.60
高雄縣,大寮鄉,後庄村,282,1,721,7,728,1171,0,0,0,0,0,0,62.17
高雄縣,大寮鄉,前庄村,283,1,698,11,709,923,0,0,0,0,0,0,76.81
高雄縣,大寮鄉,前庄村,284,1,666,6,672,934,0,0,0,0,0,0,71.95
高雄縣,大寮鄉,中興村,285,1,942,21,963,1362,0,0,0,0,0,0,70.70
高雄縣,大寮鄉,中興村,286,1,833,9,842,1232,0,0,0,0,0,0,68.34
高雄縣,大寮鄉,中興村,287,1,1012,7,1019,1561,0,0,0,0,0,0,65.28
高雄縣,大寮鄉,中興村,288,1,927,10,937,1354,0,0,0,0,0,0,69.20
高雄縣,大寮鄉,忠義村,289,1,919,9,928,1281,0,0,0,0,0,0,72.44
高雄縣,大寮鄉,忠義村,290,1,824,12,836,1140,0,0,0,0,0,0,73.33
高雄縣,大寮鄉,光武村,291,1,774,9,783,1084,0,0,0,0,0,0,72.23
高雄縣,大寮鄉,光武村,292,1,778,12,790,1059,0,0,0,0,0,0,74.60
高雄縣,大寮鄉,復興村,293,1,632,3,635,858,0,0,0,0,0,0,74.01
高雄縣,大寮鄉,復興村,294,1,709,10,719,970,0,0,0,0,0,0,74.12
高雄縣,大寮鄉,復興村,295,1,770,4,774,1045,0,0,0,0,0,0,74.07
高雄縣,大寮鄉,復興村,296,1,701,6,707,925,0,0,0,0,0,0,76.43
高雄縣,大寮鄉,翁園村,297,1,906,11,917,1161,0,0,0,0,0,0,78.98
高雄縣,大寮鄉,翁園村,298,1,760,10,770,1044,0,0,0,0,0,0,73.75
高雄縣,大寮鄉,琉球村,299,1,566,7,573,827,0,0,0,0,0,0,69.29
高雄縣,大寮鄉,琉球村,300,1,578,3,581,813,0,0,0,0,0,0,71.46
高雄縣,大寮鄉,琉球村,301,1,897,8,905,1201,0,0,0,0,0,0,75.35
高雄縣,大寮鄉,永芳村,302,1,1144,9,1153,1674,0,0,0,0,0,0,68.88
高雄縣,大寮鄉,永芳村,303,1,596,10,606,862,0,0,0,0,0,0,70.30
高雄縣,大寮鄉,永芳村,304,1,972,9,981,1380,0,0,0,0,0,0,71.09
高雄縣,大寮鄉,永芳村,305,1,966,6,972,1428,0,0,0,0,0,0,68.07
高雄縣,大寮鄉,山頂村,306,1,843,14,857,1174,0,0,0,0,0,0,73.00
高雄縣,大寮鄉,山頂村,307,1,922,11,933,1379,0,0,0,0,0,0,67.66
高雄縣,大寮鄉,山頂村,308,1,727,13,740,1257,0,0,0,0,0,0,58.87
高雄縣,大寮鄉,山頂村,309,1,768,14,782,1223,0,0,0,0,0,0,63.94
高雄縣,大寮鄉,會社村,310,1,639,8,647,948,0,0,0,0,0,0,68.25
高雄縣,大寮鄉,會社村,311,1,716,9,725,1027,0,0,0,0,0,0,70.59
高雄縣,大寮鄉,會社村,312,1,891,11,902,1379,0,0,0,0,0,0,65.41
高雄縣,大寮鄉,會社村,313,1,687,7,694,944,0,0,0,0,0,0,73.52
高雄縣,大寮鄉,三隆村,314,1,895,9,904,1243,0,0,0,0,0,0,72.73
高雄縣,大寮鄉,三隆村,315,1,883,11,894,1230,0,0,0,0,0,0,72.68
高雄縣,大寮鄉,三隆村,316,1,810,8,818,1190,0,0,0,0,0,0,68.74
高雄縣,大寮鄉,上寮村,317,1,775,5,780,1043,0,0,0,0,0,0,74.78
高雄縣,大寮鄉,上寮村,318,1,640,4,644,876,0,0,0,0,0,0,73.52
高雄縣,大寮鄉,大寮村,319,1,781,12,793,1206,0,0,0,0,0,0,65.75
高雄縣,大寮鄉,大寮村,320,1,826,20,846,1356,0,0,0,0,0,0,62.39
高雄縣,大寮鄉,大寮村,321,1,830,4,834,1252,0,0,0,0,0,0,66.61
高雄縣,大寮鄉,大寮村,322,1,737,12,749,1189,0,0,0,0,0,0,62.99
高雄縣,大寮鄉,拷潭村,323,1,893,16,909,1198,0,0,0,0,0,0,75.88
高雄縣,大寮鄉,內坑村,324,1,799,19,818,1403,0,0,0,0,0,0,58.30
高雄縣,大寮鄉,內坑村,325,1,888,6,894,1277,0,0,0,0,0,0,70.01
高雄縣,大寮鄉,內坑村,326,1,312,5,317,449,0,0,0,0,0,0,70.60
高雄縣,大寮鄉,新厝村,327,1,1021,14,1035,1337,0,0,0,0,0,0,77.41
高雄縣,大寮鄉,過溪村,328,1,683,13,696,982,0,0,0,0,0,0,70.88
高雄縣,大寮鄉,過溪村,329,1,461,6,467,617,0,0,0,0,0,0,75.69
高雄縣,大寮鄉,潮寮村,330,1,982,13,995,1271,0,0,0,0,0,0,78.28
高雄縣,大寮鄉,潮寮村,331,1,922,8,930,1208,0,0,0,0,0,0,76.99
高雄縣,大寮鄉,會結村,332,1,940,13,953,1202,0,0,0,0,0,0,79.28
高雄縣,大寮鄉,昭明村,333,1,951,11,962,1376,0,0,0,0,0,0,69.91
高雄縣,大寮鄉,昭明村,334,1,915,6,921,1319,0,0,0,0,0,0,69.83
高雄縣,大寮鄉,義仁村,335,1,644,8,652,953,0,0,0,0,0,0,68.42
高雄縣,大寮鄉,義仁村,336,1,570,10,580,789,0,0,0,0,0,0,73.51
高雄縣,大樹鄉,小坪村,337,1,914,7,921,1192,0,0,0,0,0,0,77.27
高雄縣,大樹鄉,龍目村,338,1,546,4,550,724,0,0,0,0,0,0,75.97
高雄縣,大樹鄉,龍目村,339,1,591,5,596,796,0,0,0,0,0,0,74.87
高雄縣,大樹鄉,大樹村,340,1,789,3,792,1099,0,0,0,0,0,0,72.07
高雄縣,大樹鄉,大樹村,341,1,743,6,749,1047,0,0,0,0,0,0,71.54
高雄縣,大樹鄉,檨腳村,342,1,795,7,802,1124,0,0,0,0,0,0,71.35
高雄縣,大樹鄉,檨腳村,343,1,596,6,602,850,0,0,0,0,0,0,70.82
高雄縣,大樹鄉,檨腳村,344,1,739,9,748,1030,0,0,0,0,0,0,72.62
高雄縣,大樹鄉,興山村,345,1,777,8,785,1066,0,0,0,0,0,0,73.64
高雄縣,大樹鄉,和山村,346,1,695,3,698,950,0,0,0,0,0,0,73.47
高雄縣,大樹鄉,姑山村,347,1,771,8,779,1029,0,0,0,0,0,0,75.70
高雄縣,大樹鄉,三和村,348,1,628,4,632,866,0,0,0,0,0,0,72.98
高雄縣,大樹鄉,大坑村,349,1,883,5,888,1263,0,0,0,0,0,0,70.31
高雄縣,大樹鄉,溪埔村,350,1,633,8,641,822,0,0,0,0,0,0,77.98
高雄縣,大樹鄉,竹寮村,351,1,699,10,709,972,0,0,0,0,0,0,72.94
高雄縣,大樹鄉,竹寮村,352,1,662,9,671,1008,0,0,0,0,0,0,66.57
高雄縣,大樹鄉,九曲村,353,1,773,6,779,1137,0,0,0,0,0,0,68.51
高雄縣,大樹鄉,九曲村,354,1,846,13,859,1177,0,0,0,0,0,0,72.98
高雄縣,大樹鄉,九曲村,355,1,903,16,919,1393,0,0,0,0,0,0,65.97
高雄縣,大樹鄉,久堂村,356,1,1015,14,1029,1446,0,0,0,0,0,0,71.16
高雄縣,大樹鄉,久堂村,357,1,784,5,789,1093,0,0,0,0,0,0,72.19
高雄縣,大樹鄉,久堂村,358,1,1026,19,1045,1426,0,0,0,0,0,0,73.28
高雄縣,大樹鄉,水安村,359,1,803,6,809,1059,0,0,0,0,0,0,76.39
高雄縣,大樹鄉,水安村,360,1,702,8,710,1041,0,0,0,0,0,0,68.20
高雄縣,大樹鄉,水寮村,361,1,838,6,844,1108,0,0,0,0,0,0,76.17
高雄縣,大樹鄉,水寮村,362,1,841,6,847,1144,0,0,0,0,0,0,74.04
高雄縣,大樹鄉,井腳村,363,1,583,4,587,782,0,0,0,0,0,0,75.06
高雄縣,大樹鄉,井腳村,364,1,569,5,574,766,0,0,0,0,0,0,74.93
高雄縣,大樹鄉,溪埔村,365,1,757,7,764,1032,0,0,0,0,0,0,74.03
高雄縣,大樹鄉,興田村,366,1,712,10,722,952,0,0,0,0,0,0,75.84
高雄縣,大樹鄉,興田村,367,1,626,7,633,957,0,0,0,0,0,0,66.14
高雄縣,大樹鄉,鐘鈴村,368,1,491,5,496,686,0,0,0,0,0,0,72.30
高雄縣,大社鄉,嘉誠村,369,1,685,8,693,936,0,0,0,0,0,0,74.04
高雄縣,大社鄉,保社村,370,1,781,8,789,1026,0,0,0,0,0,0,76.90
高雄縣,大社鄉,保社村,371,1,466,3,469,731,0,0,0,0,0,0,64.16
高雄縣,大社鄉,大社村,372,1,617,13,630,949,0,0,0,0,0,0,66.39
高雄縣,大社鄉,大社村,373,1,625,6,631,884,0,0,0,0,0,0,71.38
高雄縣,大社鄉,大社村,374,1,690,11,701,1025,0,0,0,0,0,0,68.39
高雄縣,大社鄉,大社村,375,1,595,13,608,869,0,0,0,0,0,0,69.97
高雄縣,大社鄉,保安村,376,1,771,12,783,1127,0,0,0,0,0,0,69.48
高雄縣,大社鄉,保安村,377,1,886,14,900,1225,0,0,0,0,0,0,73.47
高雄縣,大社鄉,三奶村,378,1,1079,18,1097,1511,0,0,0,0,0,0,72.60
高雄縣,大社鄉,三奶村,379,1,704,13,717,1013,0,0,0,0,0,0,70.78
高雄縣,大社鄉,觀音村,380,1,655,8,663,938,0,0,0,0,0,0,70.68
高雄縣,大社鄉,觀音村,381,1,788,13,801,1201,0,0,0,0,0,0,66.69
高雄縣,大社鄉,觀音村,382,1,704,10,714,1052,0,0,0,0,0,0,67.87
高雄縣,大社鄉,觀音村,383,1,718,7,725,1085,0,0,0,0,0,0,66.82
高雄縣,大社鄉,神農村,384,1,712,18,730,1121,0,0,0,0,0,0,65.12
高雄縣,大社鄉,神農村,385,1,809,11,820,1202,0,0,0,0,0,0,68.22
高雄縣,大社鄉,神農村,386,1,669,8,677,1041,0,0,0,0,0,0,65.03
高雄縣,大社鄉,中里村,387,1,971,13,984,1303,0,0,0,0,0,0,75.52
高雄縣,大社鄉,中里村,388,1,753,15,768,1089,0,0,0,0,0,0,70.52
高雄縣,大社鄉,翠屏村,389,1,938,12,950,1286,0,0,0,0,0,0,73.87
高雄縣,仁武鄉,仁武村,390,1,904,7,911,1291,0,0,0,0,0,0,70.57
高雄縣,仁武鄉,仁武村,391,1,860,18,878,1232,0,0,0,0,0,0,71.27
高雄縣,仁武鄉,仁武村,392,1,958,11,969,1360,0,0,0,0,0,0,71.25
高雄縣,仁武鄉,文武村,393,1,739,14,753,1081,0,0,0,0,0,0,69.66
高雄縣,仁武鄉,文武村,394,1,836,16,852,1275,0,0,0,0,0,0,66.82
高雄縣,仁武鄉,文武村,395,1,657,8,665,872,0,0,0,0,0,0,76.26
高雄縣,仁武鄉,後安村,396,1,660,11,671,954,0,0,0,0,0,0,70.34
高雄縣,仁武鄉,後安村,397,1,664,7,671,978,0,0,0,0,0,0,68.61
高雄縣,仁武鄉,竹後村,398,1,724,7,731,1065,0,0,0,0,0,0,68.64
高雄縣,仁武鄉,竹後村,399,1,739,13,752,1049,0,0,0,0,0,0,71.69
高雄縣,仁武鄉,中華村,400,1,805,14,819,1269,0,0,0,0,0,0,64.54
高雄縣,仁武鄉,八卦村,401,1,857,12,869,1316,0,0,0,0,0,0,66.03
高雄縣,仁武鄉,八卦村,402,1,690,12,702,1080,0,0,0,0,0,0,65.00
高雄縣,仁武鄉,八卦村,403,1,750,21,771,1133,0,0,0,0,0,0,68.05
高雄縣,仁武鄉,五和村,404,1,602,10,612,927,0,0,0,0,0,0,66.02
高雄縣,仁武鄉,五和村,405,1,594,14,608,833,0,0,0,0,0,0,72.99
高雄縣,仁武鄉,高楠村,406,1,576,14,590,865,0,0,0,0,0,0,68.21
高雄縣,仁武鄉,高楠村,407,1,600,17,617,774,0,0,0,0,0,0,79.72
高雄縣,仁武鄉,大灣村,408,1,946,15,961,1427,0,0,0,0,0,0,67.34
高雄縣,仁武鄉,赤山村,409,1,915,13,928,1302,0,0,0,0,0,0,71.27
高雄縣,仁武鄉,仁和村,410,1,518,7,525,750,0,0,0,0,0,0,70.00
高雄縣,仁武鄉,仁和村,411,1,491,7,498,799,0,0,0,0,0,0,62.33
高雄縣,仁武鄉,灣內村,412,1,889,11,900,1323,0,0,0,0,0,0,68.03
高雄縣,仁武鄉,灣內村,413,1,815,22,837,1252,0,0,0,0,0,0,66.85
高雄縣,仁武鄉,仁慈村,414,1,708,10,718,1056,0,0,0,0,0,0,67.99
高雄縣,仁武鄉,考潭村,415,1,900,12,912,1315,0,0,0,0,0,0,69.35
高雄縣,仁武鄉,考潭村,416,1,786,8,794,1174,0,0,0,0,0,0,67.63
高雄縣,仁武鄉,烏林村,417,1,1102,10,1112,1466,0,0,0,0,0,0,75.85
高雄縣,仁武鄉,烏林村,418,1,656,17,673,1005,0,0,0,0,0,0,66.97
高雄縣,仁武鄉,仁福村,419,1,339,6,345,469,0,0,0,0,0,0,73.56
高雄縣,鳥松鄉,鳥松村,420,1,1046,13,1059,1612,0,0,0,0,0,0,65.69
高雄縣,鳥松鄉,鳥松村,421,1,1062,8,1070,1584,0,0,0,0,0,0,67.55
高雄縣,鳥松鄉,鳥松村,422,1,946,8,954,1737,0,0,0,0,0,0,54.92
高雄縣,鳥松鄉,鳥松村,423,1,950,17,967,1364,0,0,0,0,0,0,70.89
高雄縣,鳥松鄉,夢裡村,424,1,882,6,888,1092,0,0,0,0,0,0,81.32
高雄縣,鳥松鄉,夢裡村,425,1,686,9,695,941,0,0,0,0,0,0,73.86
高雄縣,鳥松鄉,大華村,426,1,847,9,856,1184,0,0,0,0,0,0,72.30
高雄縣,鳥松鄉,大華村,427,1,1205,18,1223,1917,0,0,0,0,0,0,63.80
高雄縣,鳥松鄉,大華村,428,1,1098,11,1109,1797,0,0,0,0,0,0,61.71
高雄縣,鳥松鄉,大華村,429,1,884,9,893,1419,0,0,0,0,0,0,62.93
高雄縣,鳥松鄉,濫埔村,430,1,935,8,943,1216,0,0,0,0,0,0,77.55
高雄縣,鳥松鄉,濫埔村,431,1,930,13,943,1252,0,0,0,0,0,0,75.32
高雄縣,鳥松鄉,仁美村,432,1,1040,10,1050,1392,0,0,0,0,0,0,75.43
高雄縣,鳥松鄉,仁美村,433,1,1067,13,1080,1331,0,0,0,0,0,0,81.14
高雄縣,鳥松鄉,仁美村,434,1,897,10,907,1241,0,0,0,0,0,0,73.09
高雄縣,鳥松鄉,仁美村,435,1,847,8,855,1244,0,0,0,0,0,0,68.73
高雄縣,鳥松鄉,華美村,436,1,939,14,953,1260,0,0,0,0,0,0,75.63
高雄縣,鳥松鄉,華美村,437,1,1177,12,1189,1659,0,0,0,0,0,0,71.67
高雄縣,鳥松鄉,大竹村,438,1,491,10,501,628,0,0,0,0,0,0,79.78
高雄縣,岡山鎮,岡山里,439,1,847,8,855,1215,0,0,0,0,0,0,70.37
高雄縣,岡山鎮,岡山里,440,1,697,13,710,1096,0,0,0,0,0,0,64.78
高雄縣,岡山鎮,岡山里,441,1,726,8,734,1060,0,0,0,0,0,0,69.25
高雄縣,岡山鎮,平安里,442,1,895,9,904,1275,0,0,0,0,0,0,70.90
高雄縣,岡山鎮,壽天里,443,1,736,12,748,1133,0,0,0,0,0,0,66.02
高雄縣,岡山鎮,壽天里,444,1,668,9,677,1006,0,0,0,0,0,0,67.30
高雄縣,岡山鎮,壽天里,445,1,469,11,480,695,0,0,0,0,0,0,69.06
高雄縣,岡山鎮,維仁里,446,1,431,2,433,661,0,0,0,0,0,0,65.51
高雄縣,岡山鎮,維仁里,447,1,480,9,489,659,0,0,0,0,0,0,74.20
高雄縣,岡山鎮,灣裡里,448,1,842,8,850,1194,0,0,0,0,0,0,71.19
高雄縣,岡山鎮,大遼里,449,1,820,10,830,1138,0,0,0,0,0,0,72.93
高雄縣,岡山鎮,後紅里,450,1,833,18,851,1163,0,0,0,0,0,0,73.17
高雄縣,岡山鎮,後紅里,451,1,809,9,818,1266,0,0,0,0,0,0,64.61
高雄縣,岡山鎮,碧紅里,452,1,934,8,942,1388,0,0,0,0,0,0,67.87
高雄縣,岡山鎮,碧紅里,453,1,791,12,803,1222,0,0,0,0,0,0,65.71
高雄縣,岡山鎮,程香里,454,1,996,21,1017,1420,0,0,0,0,0,0,71.62
高雄縣,岡山鎮,程香里,455,1,734,6,740,1142,0,0,0,0,0,0,64.80
高雄縣,岡山鎮,竹圍里,456,1,755,12,767,1196,0,0,0,0,0,0,64.13
高雄縣,岡山鎮,竹圍里,457,1,758,13,771,1168,0,0,0,0,0,0,66.01
高雄縣,岡山鎮,竹圍里,458,1,671,11,682,1013,0,0,0,0,0,0,67.32
高雄縣,岡山鎮,台上里,459,1,981,15,996,1410,0,0,0,0,0,0,70.64
高雄縣,岡山鎮,台上里,460,1,934,9,943,1346,0,0,0,0,0,0,70.06
高雄縣,岡山鎮,為隨里,461,1,464,8,472,568,0,0,0,0,0,0,83.10
高雄縣,岡山鎮,前峰里,462,1,672,8,680,976,0,0,0,0,0,0,69.67
高雄縣,岡山鎮,前峰里,463,1,963,14,977,1439,0,0,0,0,0,0,67.89
高雄縣,岡山鎮,壽峰里,464,1,1134,23,1157,1616,0,0,0,0,0,0,71.60
高雄縣,岡山鎮,仁壽里,465,1,711,11,722,1013,0,0,0,0,0,0,71.27
高雄縣,岡山鎮,仁壽里,466,1,684,7,691,968,0,0,0,0,0,0,71.38
高雄縣,岡山鎮,仁壽里,467,1,813,12,825,1198,0,0,0,0,0,0,68.86
高雄縣,岡山鎮,協和里,468,1,812,11,823,1195,0,0,0,0,0,0,68.87
高雄縣,岡山鎮,協和里,469,1,819,11,830,1208,0,0,0,0,0,0,68.71
高雄縣,岡山鎮,協和里,470,1,392,6,398,529,0,0,0,0,0,0,75.24
高雄縣,岡山鎮,本洲里,471,1,975,8,983,1259,0,0,0,0,0,0,78.08
高雄縣,岡山鎮,後協里,472,1,679,10,689,1046,0,0,0,0,0,0,65.87
高雄縣,岡山鎮,後協里,473,1,669,6,675,932,0,0,0,0,0,0,72.42
高雄縣,岡山鎮,後協里,474,1,648,7,655,1015,0,0,0,0,0,0,64.53
高雄縣,岡山鎮,後協里,475,1,830,10,840,1289,0,0,0,0,0,0,65.17
高雄縣,岡山鎮,協榮里,476,1,773,6,779,1067,0,0,0,0,0,0,73.01
高雄縣,岡山鎮,協榮里,477,1,543,9,552,763,0,0,0,0,0,0,72.35
高雄縣,岡山鎮,劉厝里,478,1,885,18,903,1265,0,0,0,0,0,0,71.38
高雄縣,岡山鎮,白米里,479,1,560,5,565,721,0,0,0,0,0,0,78.36
高雄縣,岡山鎮,石潭里,480,1,909,11,920,1179,0,0,0,0,0,0,78.03
高雄縣,岡山鎮,福興里,481,1,730,6,736,986,0,0,0,0,0,0,74.65
高雄縣,岡山鎮,嘉興里,482,1,746,9,755,1013,0,0,0,0,0,0,74.53
高雄縣,岡山鎮,嘉興里,483,1,729,11,740,1003,0,0,0,0,0,0,73.78
高雄縣,岡山鎮,嘉興里,484,1,744,11,755,1051,0,0,0,0,0,0,71.84
高雄縣,岡山鎮,嘉峰里,485,1,967,5,972,1258,0,0,0,0,0,0,77.27
高雄縣,岡山鎮,嘉峰里,486,1,253,5,258,306,0,0,0,0,0,0,84.31
高雄縣,岡山鎮,潭底里,487,1,575,10,585,717,0,0,0,0,0,0,81.59
高雄縣,岡山鎮,華崗里,488,1,1028,11,1039,1259,0,0,0,0,0,0,82.53
高雄縣,岡山鎮,三和里,489,1,534,9,543,707,0,0,0,0,0,0,76.80
高雄縣,岡山鎮,大莊里,490,1,625,11,636,819,0,0,0,0,0,0,77.66
高雄縣,岡山鎮,忠孝里,491,1,663,4,667,958,0,0,0,0,0,0,69.62
高雄縣,岡山鎮,和平里,492,1,650,6,656,943,0,0,0,0,0,0,69.57
高雄縣,岡山鎮,信義里,493,1,685,5,690,976,0,0,0,0,0,0,70.70
高雄縣,岡山鎮,信義里,494,1,779,7,786,1140,0,0,0,0,0,0,68.95
高雄縣,岡山鎮,仁愛里,495,1,419,2,421,610,0,0,0,0,0,0,69.02
高雄縣,岡山鎮,仁愛里,496,1,568,6,574,784,0,0,0,0,0,0,73.21
高雄縣,岡山鎮,四維里,497,1,440,4,444,593,0,0,0,0,0,0,74.87
高雄縣,岡山鎮,四維里,498,1,565,2,567,746,0,0,0,0,0,0,76.01
高雄縣,岡山鎮,復興里,499,1,362,3,365,508,0,0,0,0,0,0,71.85
高雄縣,橋頭鄉,橋頭村,500,1,615,12,627,903,0,0,0,0,0,0,69.44
高雄縣,橋頭鄉,橋頭村,501,1,419,2,421,587,0,0,0,0,0,0,71.72
高雄縣,橋頭鄉,橋南村,502,1,651,8,659,891,0,0,0,0,0,0,73.96
高雄縣,橋頭鄉,興糖村,503,1,237,5,242,321,0,0,0,0,0,0,75.39
高雄縣,橋頭鄉,仕隆村,504,1,655,11,666,934,0,0,0,0,0,0,71.31
高雄縣,橋頭鄉,仕隆村,505,1,850,6,856,1250,0,0,0,0,0,0,68.48
高雄縣,橋頭鄉,仕豐村,506,1,702,8,710,1031,0,0,0,0,0,0,68.87
高雄縣,橋頭鄉,仕豐村,507,1,735,12,747,1049,0,0,0,0,0,0,71.21
高雄縣,橋頭鄉,仕和村,508,1,725,9,734,1066,0,0,0,0,0,0,68.86
高雄縣,橋頭鄉,仕和村,509,1,740,9,749,1063,0,0,0,0,0,0,70.46
高雄縣,橋頭鄉,仕和村,510,1,613,1,614,873,0,0,0,0,0,0,70.33
高雄縣,橋頭鄉,新莊村,511,1,547,5,552,745,0,0,0,0,0,0,74.09
高雄縣,橋頭鄉,新莊村,512,1,270,4,274,318,0,0,0,0,0,0,86.16
高雄縣,橋頭鄉,新莊村,513,1,137,2,139,187,0,0,0,0,0,0,74.33
高雄縣,橋頭鄉,甲北村,514,1,825,14,839,1088,0,0,0,0,0,0,77.11
高雄縣,橋頭鄉,甲北村,515,1,595,6,601,868,0,0,0,0,0,0,69.24
高雄縣,橋頭鄉,甲南村,516,1,765,13,778,1065,0,0,0,0,0,0,73.05
高雄縣,橋頭鄉,甲南村,517,1,700,12,712,956,0,0,0,0,0,0,74.48
高雄縣,橋頭鄉,頂鹽村,518,1,738,9,747,1012,0,0,0,0,0,0,73.81
高雄縣,橋頭鄉,白樹村,519,1,801,7,808,1175,0,0,0,0,0,0,68.77
高雄縣,橋頭鄉,白樹村,520,1,639,11,650,900,0,0,0,0,0,0,72.22
高雄縣,橋頭鄉,白樹村,521,1,323,4,327,397,0,0,0,0,0,0,82.37
高雄縣,橋頭鄉,芋寮村,522,1,809,6,815,1075,0,0,0,0,0,0,75.81
高雄縣,橋頭鄉,芋寮村,523,1,489,7,496,696,0,0,0,0,0,0,71.26
高雄縣,橋頭鄉,西林村,524,1,538,7,545,712,0,0,0,0,0,0,76.54
高雄縣,橋頭鄉,西林村,525,1,573,5,578,729,0,0,0,0,0,0,79.29
高雄縣,橋頭鄉,東林村,526,1,748,7,755,1004,0,0,0,0,0,0,75.20
高雄縣,橋頭鄉,東林村,527,1,791,8,799,1018,0,0,0,0,0,0,78.49
高雄縣,橋頭鄉,德松村,528,1,685,7,692,929,0,0,0,0,0,0,74.49
高雄縣,橋頭鄉,筆秀村,529,1,404,2,406,498,0,0,0,0,0,0,81.53
高雄縣,橋頭鄉,筆秀村,530,1,623,3,626,841,0,0,0,0,0,0,74.44
高雄縣,橋頭鄉,中崎村,531,1,480,8,488,640,0,0,0,0,0,0,76.25
高雄縣,燕巢鄉,金山村,532,1,354,3,357,444,0,0,0,0,0,0,80.41
高雄縣,燕巢鄉,尖山村,533,1,852,13,865,1102,0,0,0,0,0,0,78.49
高雄縣,燕巢鄉,東燕村,534,1,936,17,953,1255,0,0,0,0,0,0,75.94
高雄縣,燕巢鄉,東燕村,535,1,671,3,674,850,0,0,0,0,0,0,79.29
高雄縣,燕巢鄉,西燕村,536,1,743,11,754,1000,0,0,0,0,0,0,75.40
高雄縣,燕巢鄉,西燕村,537,1,664,2,666,883,0,0,0,0,0,0,75.42
高雄縣,燕巢鄉,西燕村,538,1,734,7,741,992,0,0,0,0,0,0,74.70
高雄縣,燕巢鄉,南燕村,539,1,988,13,1001,1297,0,0,0,0,0,0,77.18
高雄縣,燕巢鄉,南燕村,540,1,933,11,944,1201,0,0,0,0,0,0,78.60
高雄縣,燕巢鄉,瓊林村,541,1,579,14,593,753,0,0,0,0,0,0,78.75
高雄縣,燕巢鄉,瓊林村,542,1,698,9,707,911,0,0,0,0,0,0,77.61
高雄縣,燕巢鄉,安招村,543,1,952,17,969,1234,0,0,0,0,0,0,78.53
高雄縣,燕巢鄉,安招村,544,1,1008,10,1018,1330,0,0,0,0,0,0,76.54
高雄縣,燕巢鄉,安招村,545,1,252,2,254,390,0,0,0,0,0,0,65.13
高雄縣,燕巢鄉,安招村,546,1,352,6,358,490,0,0,0,0,0,0,73.06
高雄縣,燕巢鄉,安招村,547,1,501,2,503,737,0,0,0,0,0,0,68.25
高雄縣,燕巢鄉,角宿村,548,1,591,4,595,783,0,0,0,0,0,0,75.99
高雄縣,燕巢鄉,角宿村,549,1,418,5,423,537,0,0,0,0,0,0,78.77
高雄縣,燕巢鄉,角宿村,550,1,521,8,529,748,0,0,0,0,0,0,70.72
高雄縣,燕巢鄉,鳳雄村,551,1,728,9,737,998,0,0,0,0,0,0,73.85
高雄縣,燕巢鄉,鳳雄村,552,1,952,18,970,1221,0,0,0,0,0,0,79.44
高雄縣,燕巢鄉,橫山村,553,1,649,10,659,917,0,0,0,0,0,0,71.86
高雄縣,燕巢鄉,橫山村,554,1,598,12,610,821,0,0,0,0,0,0,74.30
高雄縣,燕巢鄉,深水村,555,1,882,13,895,1210,0,0,0,0,0,0,73.97
高雄縣,燕巢鄉,深水村,556,1,851,22,873,1235,0,0,0,0,0,0,70.69
高雄縣,田寮鄉,鹿埔村,557,1,287,1,288,384,0,0,0,0,0,0,75.00
高雄縣,田寮鄉,古亭村,558,1,509,4,513,680,0,0,0,0,0,0,75.44
高雄縣,田寮鄉,崇德村,559,1,769,6,775,997,0,0,0,0,0,0,77.73
高雄縣,田寮鄉,三和村,560,1,299,3,302,423,0,0,0,0,0,0,71.39
高雄縣,田寮鄉,西德村,561,1,659,15,674,937,0,0,0,0,0,0,71.93
高雄縣,田寮鄉,南安村,562,1,566,13,579,829,0,0,0,0,0,0,69.84
高雄縣,田寮鄉,南安村,563,1,410,6,416,566,0,0,0,0,0,0,73.50
高雄縣,田寮鄉,大同村,564,1,270,4,274,414,0,0,0,0,0,0,66.18
高雄縣,田寮鄉,田寮村,565,1,332,2,334,471,0,0,0,0,0,0,70.91
高雄縣,田寮鄉,七星村,566,1,690,5,695,1028,0,0,0,0,0,0,67.61
高雄縣,田寮鄉,新興村,567,1,986,16,1002,1304,0,0,0,0,0,0,76.84
高雄縣,阿蓮鄉,阿蓮村,568,1,906,10,916,1390,0,0,0,0,0,0,65.90
高雄縣,阿蓮鄉,阿蓮村,569,1,839,15,854,1140,0,0,0,0,0,0,74.91
高雄縣,阿蓮鄉,阿蓮村,570,1,857,8,865,1278,0,0,0,0,0,0,67.68
高雄縣,阿蓮鄉,南蓮村,571,1,959,22,981,1387,0,0,0,0,0,0,70.73
高雄縣,阿蓮鄉,南蓮村,572,1,823,11,834,1181,0,0,0,0,0,0,70.62
高雄縣,阿蓮鄉,清蓮村,573,1,945,12,957,1343,0,0,0,0,0,0,71.26
高雄縣,阿蓮鄉,清蓮村,574,1,745,11,756,1058,0,0,0,0,0,0,71.46
高雄縣,阿蓮鄉,和蓮村,575,1,579,8,587,850,0,0,0,0,0,0,69.06
高雄縣,阿蓮鄉,和蓮村,576,1,726,11,737,1066,0,0,0,0,0,0,69.14
高雄縣,阿蓮鄉,青旗村,577,1,967,19,986,1285,0,0,0,0,0,0,76.73
高雄縣,阿蓮鄉,石安村,578,1,806,21,827,1246,0,0,0,0,0,0,66.37
高雄縣,阿蓮鄉,中路村,579,1,674,22,696,971,0,0,0,0,0,0,71.68
高雄縣,阿蓮鄉,中路村,580,1,612,10,622,869,0,0,0,0,0,0,71.58
高雄縣,阿蓮鄉,峰山村,581,1,887,14,901,1116,0,0,0,0,0,0,80.73
高雄縣,阿蓮鄉,港後村,582,1,931,13,944,1221,0,0,0,0,0,0,77.31
高雄縣,阿蓮鄉,港後村,583,1,359,5,364,479,0,0,0,0,0,0,75.99
高雄縣,阿蓮鄉,崗山村,584,1,509,10,519,705,0,0,0,0,0,0,73.62
高雄縣,阿蓮鄉,復安村,585,1,595,14,609,774,0,0,0,0,0,0,78.68
高雄縣,阿蓮鄉,復安村,586,1,519,18,537,730,0,0,0,0,0,0,73.56
高雄縣,阿蓮鄉,玉庫村,587,1,717,15,732,939,0,0,0,0,0,0,77.96
高雄縣,路竹鄉,竹園村,588,1,576,3,579,754,0,0,0,0,0,0,76.79
高雄縣,路竹鄉,竹園村,589,1,705,10,715,912,0,0,0,0,0,0,78.40
高雄縣,路竹鄉,下坑村,590,1,970,12,982,1218,0,0,0,0,0,0,80.62
高雄縣,路竹鄉,下坑村,591,1,924,13,937,1198,0,0,0,0,0,0,78.21
高雄縣,路竹鄉,甲南村,592,1,681,8,689,883,0,0,0,0,0,0,78.03
高雄縣,路竹鄉,甲南村,593,1,731,11,742,925,0,0,0,0,0,0,80.22
高雄縣,路竹鄉,甲南村,594,1,658,27,685,984,0,0,0,0,0,0,69.61
高雄縣,路竹鄉,甲北村,595,1,672,5,677,909,0,0,0,0,0,0,74.48
高雄縣,路竹鄉,甲北村,596,1,697,11,708,917,0,0,0,0,0,0,77.21
高雄縣,路竹鄉,社東村,597,1,579,5,584,753,0,0,0,0,0,0,77.56
高雄縣,路竹鄉,社東村,598,1,606,8,614,773,0,0,0,0,0,0,79.43
高雄縣,路竹鄉,社中村,599,1,722,8,730,919,0,0,0,0,0,0,79.43
高雄縣,路竹鄉,社西村,600,1,785,12,797,1050,0,0,0,0,0,0,75.90
高雄縣,路竹鄉,社西村,601,1,816,17,833,1120,0,0,0,0,0,0,74.38
高雄縣,路竹鄉,社南村,602,1,755,7,762,995,0,0,0,0,0,0,76.58
高雄縣,路竹鄉,社南村,603,1,771,8,779,1031,0,0,0,0,0,0,75.56
高雄縣,路竹鄉,社南村,604,1,743,17,760,1088,0,0,0,0,0,0,69.85
高雄縣,路竹鄉,竹東村,605,1,856,8,864,1261,0,0,0,0,0,0,68.52
高雄縣,路竹鄉,竹東村,606,1,909,10,919,1276,0,0,0,0,0,0,72.02
高雄縣,路竹鄉,竹南村,607,1,1008,15,1023,1403,0,0,0,0,0,0,72.92
高雄縣,路竹鄉,竹南村,608,1,803,11,814,1110,0,0,0,0,0,0,73.33
高雄縣,路竹鄉,竹西村,609,1,739,8,747,916,0,0,0,0,0,0,81.55
高雄縣,路竹鄉,竹西村,610,1,805,12,817,1085,0,0,0,0,0,0,75.30
高雄縣,路竹鄉,文南村,611,1,722,9,731,975,0,0,0,0,0,0,74.97
高雄縣,路竹鄉,文南村,612,1,705,9,714,981,0,0,0,0,0,0,72.78
高雄縣,路竹鄉,文北村,613,1,873,10,883,1153,0,0,0,0,0,0,76.58
高雄縣,路竹鄉,文北村,614,1,935,22,957,1263,0,0,0,0,0,0,75.77
高雄縣,路竹鄉,竹滬村,615,1,732,10,742,1054,0,0,0,0,0,0,70.40
高雄縣,路竹鄉,竹滬村,616,1,875,14,889,1164,0,0,0,0,0,0,76.37
高雄縣,路竹鄉,頂寮村,617,1,887,14,901,1142,0,0,0,0,0,0,78.90
高雄縣,路竹鄉,新達村,618,1,861,9,870,1147,0,0,0,0,0,0,75.85
高雄縣,路竹鄉,後鄉村,619,1,680,14,694,873,0,0,0,0,0,0,79.50
高雄縣,路竹鄉,北嶺村,620,1,807,4,811,1004,0,0,0,0,0,0,80.78
高雄縣,路竹鄉,三爺村,621,1,669,15,684,816,0,0,0,0,0,0,83.82
高雄縣,路竹鄉,鴨寮村,622,1,1037,17,1054,1369,0,0,0,0,0,0,76.99
高雄縣,湖內鄉,大湖村,623,1,505,11,516,659,0,0,0,0,0,0,78.30
高雄縣,湖內鄉,大湖村,624,1,558,8,566,739,0,0,0,0,0,0,76.59
高雄縣,湖內鄉,大湖村,625,1,659,11,670,917,0,0,0,0,0,0,73.06
高雄縣,湖內鄉,田尾村,626,1,798,5,803,1046,0,0,0,0,0,0,76.77
高雄縣,湖內鄉,湖內村,627,1,655,11,666,894,0,0,0,0,0,0,74.50
高雄縣,湖內鄉,湖內村,628,1,830,11,841,1371,0,0,0,0,0,0,61.34
高雄縣,湖內鄉,湖內村,629,1,430,8,438,652,0,0,0,0,0,0,67.18
高雄縣,湖內鄉,湖內村,630,1,717,16,733,1141,0,0,0,0,0,0,64.24
高雄縣,湖內鄉,海埔村,631,1,551,5,556,760,0,0,0,0,0,0,73.16
高雄縣,湖內鄉,海埔村,632,1,660,12,672,896,0,0,0,0,0,0,75.00
高雄縣,湖內鄉,海山村,633,1,842,13,855,1128,0,0,0,0,0,0,75.80
高雄縣,湖內鄉,劉家村,634,1,818,10,828,1099,0,0,0,0,0,0,75.34
高雄縣,湖內鄉,太爺村,635,1,612,7,619,845,0,0,0,0,0,0,73.25
高雄縣,湖內鄉,公館村,636,1,492,5,497,696,0,0,0,0,0,0,71.41
高雄縣,湖內鄉,公館村,637,1,508,11,519,733,0,0,0,0,0,0,70.80
高雄縣,湖內鄉,葉厝村,638,1,577,7,584,820,0,0,0,0,0,0,71.22
高雄縣,湖內鄉,葉厝村,639,1,546,8,554,815,0,0,0,0,0,0,67.98
高雄縣,湖內鄉,文賢村,640,1,800,23,823,1155,0,0,0,0,0,0,71.26
高雄縣,湖內鄉,中賢村,641,1,616,13,629,879,0,0,0,0,0,0,71.56
高雄縣,湖內鄉,中賢村,642,1,781,11,792,1072,0,0,0,0,0,0,73.88
高雄縣,湖內鄉,逸賢村,643,1,664,11,675,928,0,0,0,0,0,0,72.74
高雄縣,湖內鄉,忠興村,644,1,575,6,581,740,0,0,0,0,0,0,78.51
高雄縣,茄萣鄉,福德村,645,1,769,6,775,1032,0,0,0,0,0,0,75.10
高雄縣,茄萣鄉,萬福村,646,1,633,13,646,887,0,0,0,0,0,0,72.83
高雄縣,茄萣鄉,白雲村,647,1,1089,17,1106,1565,0,0,0,0,0,0,70.67
高雄縣,茄萣鄉,嘉賜村,648,1,856,9,865,1198,0,0,0,0,0,0,72.20
高雄縣,茄萣鄉,嘉賜村,649,1,944,12,956,1404,0,0,0,0,0,0,68.09
高雄縣,茄萣鄉,嘉安村,650,1,960,11,971,1349,0,0,0,0,0,0,71.98
高雄縣,茄萣鄉,嘉樂村,651,1,1328,11,1339,1840,0,0,0,0,0,0,72.77
高雄縣,茄萣鄉,嘉泰村,652,1,853,7,860,1212,0,0,0,0,0,0,70.96
高雄縣,茄萣鄉,嘉福村,653,1,765,11,776,1059,0,0,0,0,0,0,73.28
高雄縣,茄萣鄉,和協村,654,1,851,11,862,1208,0,0,0,0,0,0,71.36
高雄縣,茄萣鄉,嘉定村,655,1,940,10,950,1325,0,0,0,0,0,0,71.70
高雄縣,茄萣鄉,保定村,656,1,848,13,861,1288,0,0,0,0,0,0,66.85
高雄縣,茄萣鄉,保定村,657,1,1038,13,1051,1528,0,0,0,0,0,0,68.78
高雄縣,茄萣鄉,大定村,658,1,854,9,863,1163,0,0,0,0,0,0,74.20
高雄縣,茄萣鄉,光定村,659,1,737,10,747,1024,0,0,0,0,0,0,72.95
高雄縣,茄萣鄉,吉定村,660,1,942,3,945,1213,0,0,0,0,0,0,77.91
高雄縣,茄萣鄉,崎漏村,661,1,1169,16,1185,1534,0,0,0,0,0,0,77.25
高雄縣,茄萣鄉,崎漏村,662,1,963,10,973,1528,0,0,0,0,0,0,63.68
高雄縣,永安鄉,永安村,663,1,558,2,560,738,0,0,0,0,0,0,75.88
高雄縣,永安鄉,永華村,664,1,618,10,628,821,0,0,0,0,0,0,76.49
高雄縣,永安鄉,永華村,665,1,675,8,683,900,0,0,0,0,0,0,75.89
高雄縣,永安鄉,永華村,666,1,638,5,643,887,0,0,0,0,0,0,72.49
高雄縣,永安鄉,新港村,667,1,680,6,686,880,0,0,0,0,0,0,77.95
高雄縣,永安鄉,新港村,668,1,502,5,507,695,0,0,0,0,0,0,72.95
高雄縣,永安鄉,鹽田村,669,1,529,4,533,744,0,0,0,0,0,0,71.64
高雄縣,永安鄉,鹽田村,670,1,292,1,293,429,0,0,0,0,0,0,68.30
高雄縣,永安鄉,保寧村,671,1,876,6,882,1081,0,0,0,0,0,0,81.59
高雄縣,永安鄉,保寧村,672,1,572,1,573,825,0,0,0,0,0,0,69.45
高雄縣,永安鄉,維新村,673,1,891,7,898,1166,0,0,0,0,0,0,77.02
高雄縣,永安鄉,維新村,674,1,824,15,839,1218,0,0,0,0,0,0,68.88
高雄縣,彌陀鄉,舊港村,675,1,1097,17,1114,1405,0,0,0,0,0,0,79.29
高雄縣,彌陀鄉,文安村,676,1,1416,18,1434,1791,0,0,0,0,0,0,80.07
高雄縣,彌陀鄉,鹽埕村,677,1,1411,35,1446,1830,0,0,0,0,0,0,79.02
高雄縣,彌陀鄉,過港村,678,1,746,8,754,908,0,0,0,0,0,0,83.04
高雄縣,彌陀鄉,光和村,679,1,798,12,810,1051,0,0,0,0,0,0,77.07
高雄縣,彌陀鄉,彌靖村,680,1,1365,13,1378,1769,0,0,0,0,0,0,77.90
高雄縣,彌陀鄉,彌仁村,681,1,471,6,477,586,0,0,0,0,0,0,81.40
高雄縣,彌陀鄉,彌壽村,682,1,593,4,597,758,0,0,0,0,0,0,78.76
高雄縣,彌陀鄉,彌陀村,683,1,1148,16,1164,1461,0,0,0,0,0,0,79.67
高雄縣,彌陀鄉,海尾村,684,1,624,6,630,819,0,0,0,0,0,0,76.92
高雄縣,彌陀鄉,漯底村,685,1,800,7,807,924,0,0,0,0,0,0,87.34
高雄縣,彌陀鄉,南寮村,686,1,1505,21,1526,1883,0,0,0,0,0,0,81.04
高雄縣,梓官鄉,梓信村,687,1,629,12,641,900,0,0,0,0,0,0,71.22
高雄縣,梓官鄉,梓信村,688,1,674,12,686,941,0,0,0,0,0,0,72.90
高雄縣,梓官鄉,梓義村,689,1,643,15,658,941,0,0,0,0,0,0,69.93
高雄縣,梓官鄉,梓義村,690,1,697,9,706,982,0,0,0,0,0,0,71.89
高雄縣,梓官鄉,梓和村,691,1,803,7,810,1097,0,0,0,0,0,0,73.84
高雄縣,梓官鄉,梓和村,692,1,786,8,794,1082,0,0,0,0,0,0,73.38
高雄縣,梓官鄉,梓平村,693,1,813,9,822,1051,0,0,0,0,0,0,78.21
高雄縣,梓官鄉,中崙村,694,1,734,14,748,954,0,0,0,0,0,0,78.41
高雄縣,梓官鄉,同安村,695,1,671,8,679,841,0,0,0,0,0,0,80.74
高雄縣,梓官鄉,大舍村,696,1,996,16,1012,1382,0,0,0,0,0,0,73.23
高雄縣,梓官鄉,大舍村,697,1,598,16,614,869,0,0,0,0,0,0,70.66
高雄縣,梓官鄉,大舍村,698,1,744,14,758,1011,0,0,0,0,0,0,74.98
高雄縣,梓官鄉,赤崁村,699,1,855,12,867,1154,0,0,0,0,0,0,75.13
高雄縣,梓官鄉,赤崁村,700,1,562,13,575,734,0,0,0,0,0,0,78.34
高雄縣,梓官鄉,赤東村,701,1,1067,6,1073,1371,0,0,0,0,0,0,78.26
高雄縣,梓官鄉,赤東村,702,1,732,11,743,970,0,0,0,0,0,0,76.60
高雄縣,梓官鄉,赤西村,703,1,498,9,507,700,0,0,0,0,0,0,72.43
高雄縣,梓官鄉,禮蚵村,704,1,805,15,820,1110,0,0,0,0,0,0,73.87
高雄縣,梓官鄉,禮蚵村,705,1,894,16,910,1173,0,0,0,0,0,0,77.58
高雄縣,梓官鄉,智蚵村,706,1,588,10,598,829,0,0,0,0,0,0,72.14
高雄縣,梓官鄉,智蚵村,707,1,940,15,955,1321,0,0,0,0,0,0,72.29
高雄縣,梓官鄉,信蚵村,708,1,975,18,993,1378,0,0,0,0,0,0,72.06
高雄縣,梓官鄉,茄苳村,709,1,898,23,921,1171,0,0,0,0,0,0,78.65
高雄縣,梓官鄉,茄苳村,710,1,733,5,738,981,0,0,0,0,0,0,75.23
高雄縣,梓官鄉,典寶村,711,1,877,12,889,1105,0,0,0,0,0,0,80.45
高雄縣,梓官鄉,典寶村,712,1,774,13,787,1160,0,0,0,0,0,0,67.84
高雄縣,旗山鎮,太平里,713,1,664,6,670,963,0,0,0,0,0,0,69.57
高雄縣,旗山鎮,太平里,714,1,833,3,836,1279,0,0,0,0,0,0,65.36
高雄縣,旗山鎮,大德里,715,1,921,11,932,1270,0,0,0,0,0,0,73.39
高雄縣,旗山鎮,大德里,716,1,781,12,793,1156,0,0,0,0,0,0,68.60
高雄縣,旗山鎮,湄洲里,717,1,619,11,630,928,0,0,0,0,0,0,67.89
高雄縣,旗山鎮,鼓山里,718,1,475,3,478,691,0,0,0,0,0,0,69.18
高雄縣,旗山鎮,新山里,719,1,623,3,626,855,0,0,0,0,0,0,73.22
高雄縣,旗山鎮,和平里,720,1,495,7,502,715,0,0,0,0,0,0,70.21
高雄縣,旗山鎮,竹峰里,721,1,372,4,376,505,0,0,0,0,0,0,74.46
高雄縣,旗山鎮,瑞吉里,722,1,603,9,612,871,0,0,0,0,0,0,70.26
高雄縣,旗山鎮,瑞吉里,723,1,702,5,707,974,0,0,0,0,0,0,72.59
高雄縣,旗山鎮,永和里,724,1,993,8,1001,1477,0,0,0,0,0,0,67.77
高雄縣,旗山鎮,永和里,725,1,991,21,1012,1377,0,0,0,0,0,0,73.49
高雄縣,旗山鎮,三協里,726,1,705,14,719,1031,0,0,0,0,0,0,69.74
高雄縣,旗山鎮,三協里,727,1,376,4,380,532,0,0,0,0,0,0,71.43
高雄縣,旗山鎮,三協里,728,1,225,4,229,304,0,0,0,0,0,0,75.33
高雄縣,旗山鎮,圓富里,729,1,718,13,731,1026,0,0,0,0,0,0,71.25
高雄縣,旗山鎮,圓富里,730,1,581,11,592,843,0,0,0,0,0,0,70.23
高雄縣,旗山鎮,中正里,731,1,759,6,765,1042,0,0,0,0,0,0,73.42
高雄縣,旗山鎮,中正里,732,1,405,2,407,497,0,0,0,0,0,0,81.89
高雄縣,旗山鎮,大林里,733,1,714,13,727,1050,0,0,0,0,0,0,69.24
高雄縣,旗山鎮,大林里,734,1,388,4,392,538,0,0,0,0,0,0,72.86
高雄縣,旗山鎮,上洲里,735,1,750,6,756,994,0,0,0,0,0,0,76.06
高雄縣,旗山鎮,鯤洲里,736,1,723,10,733,937,0,0,0,0,0,0,78.23
高雄縣,旗山鎮,大山里,737,1,1039,17,1056,1349,0,0,0,0,0,0,78.28
高雄縣,旗山鎮,中洲里,738,1,778,7,785,1027,0,0,0,0,0,0,76.44
高雄縣,旗山鎮,南洲里,739,1,1052,16,1068,1402,0,0,0,0,0,0,76.18
高雄縣,旗山鎮,新光里,740,1,743,5,748,958,0,0,0,0,0,0,78.08
高雄縣,旗山鎮,南勝里,741,1,873,22,895,1221,0,0,0,0,0,0,73.30
高雄縣,旗山鎮,南勝里,742,1,884,12,896,1170,0,0,0,0,0,0,76.58
高雄縣,旗山鎮,東平里,743,1,681,8,689,911,0,0,0,0,0,0,75.63
高雄縣,旗山鎮,東平里,744,1,630,10,640,934,0,0,0,0,0,0,68.52
高雄縣,旗山鎮,東昌里,745,1,467,4,471,660,0,0,0,0,0,0,71.36
高雄縣,旗山鎮,糖廠里,746,1,291,1,292,376,0,0,0,0,0,0,77.66
高雄縣,旗山鎮,廣福里,747,1,442,8,450,588,0,0,0,0,0,0,76.53
高雄縣,旗山鎮,中寮里,748,1,145,1,146,201,0,0,0,0,0,0,72.64
高雄縣,美濃鎮,中圳里,749,1,1221,17,1238,1654,0,0,0,0,0,0,74.85
高雄縣,美濃鎮,東門里,750,1,1034,18,1052,1456,0,0,0,0,0,0,72.25
高雄縣,美濃鎮,泰安里,751,1,1011,12,1023,1407,0,0,0,0,0,0,72.71
高雄縣,美濃鎮,合和里,752,1,703,11,714,978,0,0,0,0,0,0,73.01
高雄縣,美濃鎮,合和里,753,1,937,8,945,1288,0,0,0,0,0,0,73.37
高雄縣,美濃鎮,瀰濃里,754,1,873,13,886,1195,0,0,0,0,0,0,74.14
高雄縣,美濃鎮,瀰濃里,755,1,749,3,752,1025,0,0,0,0,0,0,73.37
高雄縣,美濃鎮,福安里,756,1,890,3,893,1180,0,0,0,0,0,0,75.68
高雄縣,美濃鎮,福安里,757,1,956,7,963,1336,0,0,0,0,0,0,72.08
高雄縣,美濃鎮,祿興里,758,1,888,8,896,1276,0,0,0,0,0,0,70.22
高雄縣,美濃鎮,祿興里,759,1,842,15,857,1198,0,0,0,0,0,0,71.54
高雄縣,美濃鎮,中壇里,760,1,667,5,672,884,0,0,0,0,0,0,76.02
高雄縣,美濃鎮,中壇里,761,1,837,4,841,1124,0,0,0,0,0,0,74.82
高雄縣,美濃鎮,德興里,762,1,1175,6,1181,1511,0,0,0,0,0,0,78.16
高雄縣,美濃鎮,清水里,763,1,714,10,724,982,0,0,0,0,0,0,73.73
高雄縣,美濃鎮,清水里,764,1,542,4,546,738,0,0,0,0,0,0,73.98
高雄縣,美濃鎮,吉和里,765,1,1063,8,1071,1442,0,0,0,0,0,0,74.27
高雄縣,美濃鎮,吉洋里,766,1,747,12,759,1027,0,0,0,0,0,0,73.90
高雄縣,美濃鎮,吉洋里,767,1,736,6,742,1020,0,0,0,0,0,0,72.75
高雄縣,美濃鎮,吉東里,768,1,624,5,629,832,0,0,0,0,0,0,75.60
高雄縣,美濃鎮,吉東里,769,1,630,9,639,834,0,0,0,0,0,0,76.62
高雄縣,美濃鎮,龍山里,770,1,838,14,852,1170,0,0,0,0,0,0,72.82
高雄縣,美濃鎮,龍山里,771,1,742,11,753,1065,0,0,0,0,0,0,70.70
高雄縣,美濃鎮,獅山里,772,1,1039,16,1055,1381,0,0,0,0,0,0,76.39
高雄縣,美濃鎮,獅山里,773,1,734,7,741,983,0,0,0,0,0,0,75.38
高雄縣,美濃鎮,龍肚里,774,1,605,7,612,778,0,0,0,0,0,0,78.66
高雄縣,美濃鎮,龍肚里,775,1,657,8,665,899,0,0,0,0,0,0,73.97
高雄縣,美濃鎮,廣德里,776,1,1019,11,1030,1429,0,0,0,0,0,0,72.08
高雄縣,美濃鎮,興隆里,777,1,896,9,905,1215,0,0,0,0,0,0,74.49
高雄縣,美濃鎮,廣林里,778,1,667,8,675,921,0,0,0,0,0,0,73.29
高雄縣,美濃鎮,廣林里,779,1,560,6,566,849,0,0,0,0,0,0,66.67
高雄縣,六龜鄉,六龜村,780,1,648,8,656,1075,0,0,0,0,0,0,61.02
高雄縣,六龜鄉,義寶村,781,1,891,14,905,1233,0,0,0,0,0,0,73.40
高雄縣,六龜鄉,文武村,782,1,1013,23,1036,1640,0,0,0,0,0,0,63.17
高雄縣,六龜鄉,中興村,783,1,874,17,891,1387,0,0,0,0,0,0,64.24
高雄縣,六龜鄉,興龍村,784,1,637,10,647,951,0,0,0,0,0,0,68.03
高雄縣,六龜鄉,新威村,785,1,600,7,607,873,0,0,0,0,0,0,69.53
高雄縣,六龜鄉,新興村,786,1,554,8,562,772,0,0,0,0,0,0,72.80
高雄縣,六龜鄉,新寮村,787,1,508,9,517,658,0,0,0,0,0,0,78.57
高雄縣,六龜鄉,大津村,788,1,264,2,266,378,0,0,0,0,0,0,70.37
高雄縣,六龜鄉,新發村,789,1,846,15,861,1480,0,0,0,0,0,0,58.18
高雄縣,六龜鄉,荖濃村,790,1,950,21,971,1555,0,0,0,0,0,0,62.44
高雄縣,六龜鄉,寶來村,791,1,694,12,706,1079,0,0,0,0,0,0,65.43
高雄縣,甲仙鄉,東安村,792,1,466,3,469,643,0,0,0,0,0,0,72.94
高雄縣,甲仙鄉,西安村,793,1,811,11,822,1065,0,0,0,0,0,0,77.18
高雄縣,甲仙鄉,和安村,794,1,575,3,578,801,0,0,0,0,0,0,72.16
高雄縣,甲仙鄉,大田村,795,1,1077,17,1094,1516,0,0,0,0,0,0,72.16
高雄縣,甲仙鄉,寶隆村,796,1,532,3,535,718,0,0,0,0,0,0,74.51
高雄縣,甲仙鄉,關山村,797,1,513,9,522,720,0,0,0,0,0,0,72.50
高雄縣,甲仙鄉,小林村,798,1,710,14,724,1134,0,0,0,0,0,0,63.84
高雄縣,杉林鄉,杉林村,799,1,591,5,596,860,0,0,0,0,0,0,69.30
高雄縣,杉林鄉,木梓村,800,1,506,10,516,827,0,0,0,0,0,0,62.39
高雄縣,杉林鄉,集來村,801,1,715,13,728,1136,0,0,0,0,0,0,64.08
高雄縣,杉林鄉,集來村,802,1,487,11,498,782,0,0,0,0,0,0,63.68
高雄縣,杉林鄉,新庄村,803,1,844,7,851,1211,0,0,0,0,0,0,70.27
高雄縣,杉林鄉,新庄村,804,1,457,7,464,648,0,0,0,0,0,0,71.60
高雄縣,杉林鄉,上平村,805,1,1137,9,1146,1603,0,0,0,0,0,0,71.49
高雄縣,杉林鄉,月眉村,806,1,1300,17,1317,1858,0,0,0,0,0,0,70.88
高雄縣,杉林鄉,月美村,807,1,1021,16,1037,1431,0,0,0,0,0,0,72.47
高雄縣,內門鄉,金竹村,808,1,591,8,599,778,0,0,0,0,0,0,76.99
高雄縣,內門鄉,溝坪村,809,1,752,11,763,1066,0,0,0,0,0,0,71.58
高雄縣,內門鄉,永興村,810,1,340,6,346,508,0,0,0,0,0,0,68.11
高雄縣,內門鄉,永吉村,811,1,383,4,387,499,0,0,0,0,0,0,77.56
高雄縣,內門鄉,永富村,812,1,806,9,815,1028,0,0,0,0,0,0,79.28
高雄縣,內門鄉,觀亭村,813,1,521,8,529,678,0,0,0,0,0,0,78.02
高雄縣,內門鄉,觀亭村,814,1,814,9,823,1078,0,0,0,0,0,0,76.35
高雄縣,內門鄉,中埔村,815,1,497,2,499,616,0,0,0,0,0,0,81.01
高雄縣,內門鄉,瑞山村,816,1,270,5,275,377,0,0,0,0,0,0,72.94
高雄縣,內門鄉,內南村,817,1,289,6,295,372,0,0,0,0,0,0,79.30
高雄縣,內門鄉,內東村,818,1,642,9,651,805,0,0,0,0,0,0,80.87
高雄縣,內門鄉,光興村,819,1,527,3,530,655,0,0,0,0,0,0,80.92
高雄縣,內門鄉,東埔村,820,1,365,7,372,482,0,0,0,0,0,0,77.18
高雄縣,內門鄉,內豐村,821,1,910,8,918,1145,0,0,0,0,0,0,80.17
高雄縣,內門鄉,內門村,822,1,799,5,804,958,0,0,0,0,0,0,83.92
高雄縣,內門鄉,石坑村,823,1,388,4,392,543,0,0,0,0,0,0,72.19
高雄縣,內門鄉,三平村,824,1,522,5,527,680,0,0,0,0,0,0,77.50
高雄縣,內門鄉,木柵村,825,1,513,5,518,684,0,0,0,0,0,0,75.73
高雄縣,內門鄉,內興村,826,1,493,3,496,615,0,0,0,0,0,0,80.65
高雄縣,茂林鄉,茂林村,827,1,42,0,42,70,0,0,0,0,0,0,60.00
高雄縣,茂林鄉,萬山村,828,1,7,0,7,16,0,0,0,0,0,0,43.75
高雄縣,茂林鄉,多納村,829,1,14,0,14,22,0,0,0,0,0,0,63.64
高雄縣,桃源鄉,寶山村,830,1,2,0,2,5,0,0,0,0,0,0,40.00
高雄縣,桃源鄉,寶山村,831,1,12,0,12,29,0,0,0,0,0,0,41.38
高雄縣,桃源鄉,建山村,832,1,54,1,55,76,0,0,0,0,0,0,72.37
高雄縣,桃源鄉,高中村,833,1,41,1,42,83,0,0,0,0,0,0,50.60
高雄縣,桃源鄉,桃源村,834,1,81,0,81,144,0,0,0,0,0,0,56.25
高雄縣,桃源鄉,勤和村,835,1,10,0,10,19,0,0,0,0,0,0,52.63
高雄縣,桃源鄉,復興村,836,1,11,0,11,15,0,0,0,0,0,0,73.33
高雄縣,桃源鄉,梅蘭村,837,1,7,0,7,12,0,0,0,0,0,0,58.33
高雄縣,桃源鄉,梅山村,838,1,8,0,8,16,0,0,0,0,0,0,50.00
高雄縣,三民鄉,民族村,839,1,49,1,50,156,0,0,0,0,0,0,32.05
高雄縣,三民鄉,民權村,840,1,26,0,26,45,0,0,0,0,0,0,57.78
高雄縣,三民鄉,民生村,841,1,58,0,58,98,0,0,0,0,0,0,59.18
屏東縣,屏東市,端正里,1,1,801,5,806,1224,0,0,0,0,0,0,65.85
屏東縣,屏東市,光榮里,2,1,1042,13,1055,1531,0,0,0,0,0,0,68.91
屏東縣,屏東市,大同里,3,1,586,4,590,798,0,0,0,0,0,0,73.93
屏東縣,屏東市,泰安里,4,1,878,3,881,1394,0,0,0,0,0,0,63.20
屏東縣,屏東市,維新里,5,1,1037,8,1045,1497,0,0,0,0,0,0,69.81
屏東縣,屏東市,維新里,6,1,896,6,902,1385,0,0,0,0,0,0,65.13
屏東縣,屏東市,大埔里,7,1,987,5,992,1486,0,0,0,0,0,0,66.76
屏東縣,屏東市,崇禮里,8,1,608,10,618,897,0,0,0,0,0,0,68.90
屏東縣,屏東市,楠樹里,9,1,599,8,607,853,0,0,0,0,0,0,71.16
屏東縣,屏東市,金泉里,10,1,867,5,872,1282,0,0,0,0,0,0,68.02
屏東縣,屏東市,平和里,11,1,637,8,645,918,0,0,0,0,0,0,70.26
屏東縣,屏東市,安樂里,12,1,740,9,749,1102,0,0,0,0,0,0,67.97
屏東縣,屏東市,橋南里,13,1,947,6,953,1539,0,0,0,0,0,0,61.92
屏東縣,屏東市,橋北里,14,1,658,8,666,954,0,0,0,0,0,0,69.81
屏東縣,屏東市,長春里,15,1,617,5,622,976,0,0,0,0,0,0,63.73
屏東縣,屏東市,長春里,16,1,633,7,640,1046,0,0,0,0,0,0,61.19
屏東縣,屏東市,豐榮里,17,1,725,5,730,1154,0,0,0,0,0,0,63.26
屏東縣,屏東市,豐榮里,18,1,759,5,764,1142,0,0,0,0,0,0,66.90
屏東縣,屏東市,豐田里,19,1,664,1,665,1027,0,0,0,0,0,0,64.75
屏東縣,屏東市,豐田里,20,1,795,5,800,1240,0,0,0,0,0,0,64.52
屏東縣,屏東市,豐田里,21,1,899,8,907,1398,0,0,0,0,0,0,64.88
屏東縣,屏東市,大連里,22,1,826,6,832,1337,0,0,0,0,0,0,62.23
屏東縣,屏東市,大連里,23,1,963,6,969,1446,0,0,0,0,0,0,67.01
屏東縣,屏東市,大連里,24,1,873,6,879,1396,0,0,0,0,0,0,62.97
屏東縣,屏東市,大連里,25,1,1075,9,1084,1645,0,0,0,0,0,0,65.90
屏東縣,屏東市,大連里,26,1,998,12,1010,1581,0,0,0,0,0,0,63.88
屏東縣,屏東市,豐源里,27,1,770,3,773,1164,0,0,0,0,0,0,66.41
屏東縣,屏東市,豐源里,28,1,789,11,800,1174,0,0,0,0,0,0,68.14
屏東縣,屏東市,豐源里,29,1,707,3,710,1103,0,0,0,0,0,0,64.37
屏東縣,屏東市,湖南里,30,1,628,7,635,922,0,0,0,0,0,0,68.87
屏東縣,屏東市,湖西里,31,1,910,7,917,1293,0,0,0,0,0,0,70.92
屏東縣,屏東市,歸心里,32,1,715,6,721,1069,0,0,0,0,0,0,67.45
屏東縣,屏東市,瑞光里,33,1,964,4,968,1543,0,0,0,0,0,0,62.73
屏東縣,屏東市,瑞光里,34,1,848,27,875,1362,0,0,0,0,0,0,64.24
屏東縣,屏東市,瑞光里,35,1,967,7,974,1532,0,0,0,0,0,0,63.58
屏東縣,屏東市,瑞光里,36,1,870,7,877,1416,0,0,0,0,0,0,61.94
屏東縣,屏東市,一心里,37,1,958,11,969,1375,0,0,0,0,0,0,70.47
屏東縣,屏東市,建國里,38,1,984,10,994,1537,0,0,0,0,0,0,64.67
屏東縣,屏東市,光華里,39,1,490,6,496,799,0,0,0,0,0,0,62.08
屏東縣,屏東市,萬年里,40,1,578,11,589,820,0,0,0,0,0,0,71.83
屏東縣,屏東市,厚生里,41,1,803,10,813,1372,0,0,0,0,0,0,59.26
屏東縣,屏東市,厚生里,42,1,1056,13,1069,1705,0,0,0,0,0,0,62.70
屏東縣,屏東市,永安里,43,1,864,5,869,1362,0,0,0,0,0,0,63.80
屏東縣,屏東市,永安里,44,1,1037,10,1047,1586,0,0,0,0,0,0,66.02
屏東縣,屏東市,永安里,45,1,1027,12,1039,1634,0,0,0,0,0,0,63.59
屏東縣,屏東市,永安里,46,1,941,12,953,1567,0,0,0,0,0,0,60.82
屏東縣,屏東市,新生里,47,1,751,7,758,1113,0,0,0,0,0,0,68.10
屏東縣,屏東市,新生里,48,1,1035,13,1048,1742,0,0,0,0,0,0,60.16
屏東縣,屏東市,新生里,49,1,867,8,875,1359,0,0,0,0,0,0,64.39
屏東縣,屏東市,頂宅里,50,1,373,2,375,535,0,0,0,0,0,0,70.09
屏東縣,屏東市,頂柳里,51,1,679,1,680,923,0,0,0,0,0,0,73.67
屏東縣,屏東市,龍華里,52,1,926,13,939,1303,0,0,0,0,0,0,72.06
屏東縣,屏東市,龍華里,53,1,692,10,702,1020,0,0,0,0,0,0,68.82
屏東縣,屏東市,大湖里,54,1,991,16,1007,1428,0,0,0,0,0,0,70.52
屏東縣,屏東市,新興里,55,1,1433,7,1440,2046,0,0,0,0,0,0,70.38
屏東縣,屏東市,公館里,56,1,1074,10,1084,1472,0,0,0,0,0,0,73.64
屏東縣,屏東市,玉成里,57,1,949,7,956,1248,0,0,0,0,0,0,76.60
屏東縣,屏東市,永光里,58,1,757,8,765,1134,0,0,0,0,0,0,67.46
屏東縣,屏東市,安鎮里,59,1,600,11,611,922,0,0,0,0,0,0,66.27
屏東縣,屏東市,安鎮里,60,1,608,5,613,927,0,0,0,0,0,0,66.13
屏東縣,屏東市,永昌里,61,1,832,13,845,1286,0,0,0,0,0,0,65.71
屏東縣,屏東市,長安里,62,1,635,8,643,1026,0,0,0,0,0,0,62.67
屏東縣,屏東市,長安里,63,1,600,10,610,946,0,0,0,0,0,0,64.48
屏東縣,屏東市,崇武里,64,1,730,6,736,1154,0,0,0,0,0,0,63.78
屏東縣,屏東市,大武里,65,1,440,4,444,680,0,0,0,0,0,0,65.29
屏東縣,屏東市,大武里,66,1,1202,17,1219,2014,0,0,0,0,0,0,60.53
屏東縣,屏東市,大武里,67,1,1156,10,1166,1751,0,0,0,0,0,0,66.59
屏東縣,屏東市,大武里,68,1,1067,12,1079,1722,0,0,0,0,0,0,62.66
屏東縣,屏東市,清溪里,69,1,1014,11,1025,1439,0,0,0,0,0,0,71.23
屏東縣,屏東市,清溪里,70,1,557,2,559,884,0,0,0,0,0,0,63.24
屏東縣,屏東市,清溪里,71,1,833,8,841,1339,0,0,0,0,0,0,62.81
屏東縣,屏東市,前進里,72,1,800,5,805,1153,0,0,0,0,0,0,69.82
屏東縣,屏東市,大洲里,73,1,706,11,717,965,0,0,0,0,0,0,74.30
屏東縣,屏東市,凌雲里,74,1,936,9,945,1435,0,0,0,0,0,0,65.85
屏東縣,屏東市,鵬程里,75,1,949,12,961,1375,0,0,0,0,0,0,69.89
屏東縣,屏東市,興樂里,76,1,664,2,666,1012,0,0,0,0,0,0,65.81
屏東縣,屏東市,斯文里,77,1,527,8,535,725,0,0,0,0,0,0,73.79
屏東縣,屏東市,斯文里,78,1,698,4,702,1121,0,0,0,0,0,0,62.62
屏東縣,屏東市,太平里,79,1,668,5,673,1028,0,0,0,0,0,0,65.47
屏東縣,屏東市,華山里,80,1,879,10,889,1292,0,0,0,0,0,0,68.81
屏東縣,屏東市,華山里,81,1,844,7,851,1310,0,0,0,0,0,0,64.96
屏東縣,屏東市,華山里,82,1,950,7,957,1481,0,0,0,0,0,0,64.62
屏東縣,屏東市,溝美里,83,1,776,9,785,1183,0,0,0,0,0,0,66.36
屏東縣,屏東市,溝美里,84,1,884,5,889,1280,0,0,0,0,0,0,69.45
屏東縣,屏東市,中正里,85,1,1134,6,1140,1720,0,0,0,0,0,0,66.28
屏東縣,屏東市,中正里,86,1,893,4,897,1351,0,0,0,0,0,0,66.40
屏東縣,屏東市,仁愛里,87,1,578,2,580,949,0,0,0,0,0,0,61.12
屏東縣,屏東市,仁愛里,88,1,633,8,641,1050,0,0,0,0,0,0,61.05
屏東縣,屏東市,北興里,89,1,802,5,807,1215,0,0,0,0,0,0,66.42
屏東縣,屏東市,北興里,90,1,736,5,741,1257,0,0,0,0,0,0,58.95
屏東縣,屏東市,北興里,91,1,855,8,863,1440,0,0,0,0,0,0,59.93
屏東縣,屏東市,北興里,92,1,730,8,738,1159,0,0,0,0,0,0,63.68
屏東縣,屏東市,北勢里,93,1,733,5,738,1105,0,0,0,0,0,0,66.79
屏東縣,屏東市,北勢里,94,1,820,6,826,1224,0,0,0,0,0,0,67.48
屏東縣,屏東市,勝利里,95,1,725,5,730,1196,0,0,0,0,0,0,61.04
屏東縣,屏東市,勝利里,96,1,755,4,759,1225,0,0,0,0,0,0,61.96
屏東縣,屏東市,勝利里,97,1,909,11,920,1360,0,0,0,0,0,0,67.65
屏東縣,屏東市,永城里,98,1,671,8,679,1029,0,0,0,0,0,0,65.99
屏東縣,屏東市,永城里,99,1,846,8,854,1341,0,0,0,0,0,0,63.68
屏東縣,屏東市,崇蘭里,100,1,803,5,808,1220,0,0,0,0,0,0,66.23
屏東縣,屏東市,崇蘭里,101,1,963,6,969,1350,0,0,0,0,0,0,71.78
屏東縣,屏東市,崇蘭里,102,1,1036,12,1048,1572,0,0,0,0,0,0,66.67
屏東縣,屏東市,崇蘭里,103,1,950,4,954,1445,0,0,0,0,0,0,66.02
屏東縣,屏東市,廣興里,104,1,1343,11,1354,1752,0,0,0,0,0,0,77.28
屏東縣,屏東市,空翔里,105,1,1020,8,1028,1566,0,0,0,0,0,0,65.64
屏東縣,屏東市,大鵬里,106,1,504,6,510,746,0,0,0,0,0,0,68.36
屏東縣,屏東市,潭墘里,107,1,1051,19,1070,1682,0,0,0,0,0,0,63.61
屏東縣,屏東市,潭墘里,108,1,992,7,999,1575,0,0,0,0,0,0,63.43
屏東縣,屏東市,潭墘里,109,1,871,10,881,1369,0,0,0,0,0,0,64.35
屏東縣,屏東市,潭墘里,110,1,1023,6,1029,1661,0,0,0,0,0,0,61.95
屏東縣,屏東市,三山里,111,1,858,16,874,1192,0,0,0,0,0,0,73.32
屏東縣,屏東市,海豐里,112,1,633,3,636,810,0,0,0,0,0,0,78.52
屏東縣,屏東市,仁義里,113,1,713,4,717,998,0,0,0,0,0,0,71.84
屏東縣,屏東市,信和里,114,1,1040,6,1046,1428,0,0,0,0,0,0,73.25
屏東縣,屏東市,和興里,115,1,657,7,664,935,0,0,0,0,0,0,71.02
屏東縣,潮州鎮,三星里,116,1,1186,11,1197,1810,0,0,0,0,0,0,66.13
屏東縣,潮州鎮,三星里,117,1,1428,16,1444,2117,0,0,0,0,0,0,68.21
屏東縣,潮州鎮,三共里,118,1,1030,9,1039,1594,0,0,0,0,0,0,65.18
屏東縣,潮州鎮,三共里,119,1,1097,12,1109,1723,0,0,0,0,0,0,64.36
屏東縣,潮州鎮,三共里,120,1,1092,4,1096,1701,0,0,0,0,0,0,64.43
屏東縣,潮州鎮,三和里,121,1,1074,7,1081,1686,0,0,0,0,0,0,64.12
屏東縣,潮州鎮,五魁里,122,1,666,5,671,1006,0,0,0,0,0,0,66.70
屏東縣,潮州鎮,潮州里,123,1,448,1,449,645,0,0,0,0,0,0,69.61
屏東縣,潮州鎮,光華里,124,1,1257,15,1272,1913,0,0,0,0,0,0,66.49
屏東縣,潮州鎮,光華里,125,1,1093,10,1103,1683,0,0,0,0,0,0,65.54
屏東縣,潮州鎮,同榮里,126,1,599,8,607,787,0,0,0,0,0,0,77.13
屏東縣,潮州鎮,新生里,127,1,782,11,793,1224,0,0,0,0,0,0,64.79
屏東縣,潮州鎮,新榮里,128,1,971,2,973,1474,0,0,0,0,0,0,66.01
屏東縣,潮州鎮,彭城里,129,1,557,2,559,768,0,0,0,0,0,0,72.79
屏東縣,潮州鎮,蓬萊里,130,1,1252,14,1266,1813,0,0,0,0,0,0,69.83
屏東縣,潮州鎮,八爺里,131,1,1276,13,1289,1930,0,0,0,0,0,0,66.79
屏東縣,潮州鎮,永春里,132,1,1009,10,1019,1571,0,0,0,0,0,0,64.86
屏東縣,潮州鎮,永春里,133,1,829,12,841,1259,0,0,0,0,0,0,66.80
屏東縣,潮州鎮,永春里,134,1,1135,7,1142,1733,0,0,0,0,0,0,65.90
屏東縣,潮州鎮,富春里,135,1,892,8,900,1403,0,0,0,0,0,0,64.15
屏東縣,潮州鎮,光春里,136,1,881,13,894,1264,0,0,0,0,0,0,70.73
屏東縣,潮州鎮,興美里,137,1,579,3,582,798,0,0,0,0,0,0,72.93
屏東縣,潮州鎮,檨子里,138,1,377,7,384,583,0,0,0,0,0,0,65.87
屏東縣,潮州鎮,九塊里,139,1,1006,15,1021,1547,0,0,0,0,0,0,66.00
屏東縣,潮州鎮,泗林里,140,1,1025,16,1041,1437,0,0,0,0,0,0,72.44
屏東縣,潮州鎮,四春里,141,1,1337,18,1355,1872,0,0,0,0,0,0,72.38
屏東縣,潮州鎮,崙東里,142,1,1015,8,1023,1559,0,0,0,0,0,0,65.62
屏東縣,東港鎮,新勝里,143,1,800,8,808,1090,0,0,0,0,0,0,74.13
屏東縣,東港鎮,新勝里,144,1,883,5,888,1199,0,0,0,0,0,0,74.06
屏東縣,東港鎮,頂新里,145,1,426,2,428,577,0,0,0,0,0,0,74.18
屏東縣,東港鎮,頂中里,146,1,382,1,383,492,0,0,0,0,0,0,77.85
屏東縣,東港鎮,東和里,147,1,530,0,530,737,0,0,0,0,0,0,71.91
屏東縣,東港鎮,興台里,148,1,429,6,435,615,0,0,0,0,0,0,70.73
屏東縣,東港鎮,興東里,149,1,1228,13,1241,1731,0,0,0,0,0,0,71.69
屏東縣,東港鎮,興東里,150,1,1107,8,1115,1737,0,0,0,0,0,0,64.19
屏東縣,東港鎮,興東里,151,1,1096,9,1105,1515,0,0,0,0,0,0,72.94
屏東縣,東港鎮,興農里,152,1,568,4,572,725,0,0,0,0,0,0,78.90
屏東縣,東港鎮,中興里,153,1,553,11,564,745,0,0,0,0,0,0,75.70
屏東縣,東港鎮,朝安里,154,1,875,7,882,1291,0,0,0,0,0,0,68.32
屏東縣,東港鎮,朝安里,155,1,439,1,440,613,0,0,0,0,0,0,71.78
屏東縣,東港鎮,八德里,156,1,610,4,614,884,0,0,0,0,0,0,69.46
屏東縣,東港鎮,東隆里,157,1,956,12,968,1379,0,0,0,0,0,0,70.20
屏東縣,東港鎮,豐漁里,158,1,543,4,547,734,0,0,0,0,0,0,74.52
屏東縣,東港鎮,盛漁里,159,1,917,14,931,1288,0,0,0,0,0,0,72.28
屏東縣,東港鎮,興漁里,160,1,567,7,574,770,0,0,0,0,0,0,74.55
屏東縣,東港鎮,興漁里,161,1,775,9,784,1085,0,0,0,0,0,0,72.26
屏東縣,東港鎮,鎮海里,162,1,856,13,869,1187,0,0,0,0,0,0,73.21
屏東縣,東港鎮,鎮海里,163,1,860,8,868,1237,0,0,0,0,0,0,70.17
屏東縣,東港鎮,嘉蓮里,164,1,995,6,1001,1439,0,0,0,0,0,0,69.56
屏東縣,東港鎮,南平里,165,1,348,4,352,449,0,0,0,0,0,0,78.40
屏東縣,東港鎮,南平里,166,1,782,5,787,1160,0,0,0,0,0,0,67.84
屏東縣,東港鎮,船頭里,167,1,1410,13,1423,2001,0,0,0,0,0,0,71.11
屏東縣,東港鎮,船頭里,168,1,795,3,798,1226,0,0,0,0,0,0,65.09
屏東縣,東港鎮,下部里,169,1,1258,8,1266,1749,0,0,0,0,0,0,72.38
屏東縣,東港鎮,大潭里,170,1,1141,9,1150,1532,0,0,0,0,0,0,75.07
屏東縣,東港鎮,興和里,171,1,640,6,646,844,0,0,0,0,0,0,76.54
屏東縣,東港鎮,共和里,172,1,506,4,510,733,0,0,0,0,0,0,69.58
屏東縣,東港鎮,大鵬里,173,1,210,0,210,355,0,0,0,0,0,0,59.15
屏東縣,恆春鎮,城南里,174,1,643,7,650,990,0,0,0,0,0,0,65.66
屏東縣,恆春鎮,城北里,175,1,564,16,580,933,0,0,0,0,0,0,62.17
屏東縣,恆春鎮,城北里,176,1,552,9,561,985,0,0,0,0,0,0,56.95
屏東縣,恆春鎮,城西里,177,1,688,4,692,1138,0,0,0,0,0,0,60.81
屏東縣,恆春鎮,山腳里,178,1,644,4,648,1119,0,0,0,0,0,0,57.91
屏東縣,恆春鎮,山腳里,179,1,576,16,592,1042,0,0,0,0,0,0,56.81
屏東縣,恆春鎮,山腳里,180,1,559,10,569,1086,0,0,0,0,0,0,52.39
屏東縣,恆春鎮,網紗里,181,1,735,9,744,1299,0,0,0,0,0,0,57.27
屏東縣,恆春鎮,網紗里,182,1,648,9,657,1144,0,0,0,0,0,0,57.43
屏東縣,恆春鎮,仁壽里,183,1,433,2,435,802,0,0,0,0,0,0,54.24
屏東縣,恆春鎮,茄湖里,184,1,296,10,306,503,0,0,0,0,0,0,60.83
屏東縣,恆春鎮,頭溝里,185,1,240,2,242,487,0,0,0,0,0,0,49.69
屏東縣,恆春鎮,四溝里,186,1,561,13,574,924,0,0,0,0,0,0,62.12
屏東縣,恆春鎮,德和里,187,1,367,11,378,570,0,0,0,0,0,0,66.32
屏東縣,恆春鎮,龍水里,188,1,598,9,607,956,0,0,0,0,0,0,63.49
屏東縣,恆春鎮,山海里,189,1,883,15,898,1460,0,0,0,0,0,0,61.51
屏東縣,恆春鎮,大光里,190,1,501,11,512,863,0,0,0,0,0,0,59.33
屏東縣,恆春鎮,大光里,191,1,496,10,506,878,0,0,0,0,0,0,57.63
屏東縣,恆春鎮,水泉里,192,1,754,14,768,1410,0,0,0,0,0,0,54.47
屏東縣,恆春鎮,南灣里,193,1,787,17,804,1325,0,0,0,0,0,0,60.68
屏東縣,恆春鎮,墾丁里,194,1,758,16,774,1153,0,0,0,0,0,0,67.13
屏東縣,恆春鎮,鵝鑾里,195,1,660,7,667,1031,0,0,0,0,0,0,64.69
屏東縣,萬丹鄉,社上村,196,1,916,6,922,1330,0,0,0,0,0,0,69.32
屏東縣,萬丹鄉,社中村,197,1,931,5,936,1320,0,0,0,0,0,0,70.91
屏東縣,萬丹鄉,社皮村,198,1,1220,11,1231,1680,0,0,0,0,0,0,73.27
屏東縣,萬丹鄉,磚寮村,199,1,631,7,638,819,0,0,0,0,0,0,77.90
屏東縣,萬丹鄉,社口村,200,1,925,4,929,1093,0,0,0,0,0,0,85.00
屏東縣,萬丹鄉,加興村,201,1,813,9,822,1031,0,0,0,0,0,0,79.73
屏東縣,萬丹鄉,上村村,202,1,500,1,501,622,0,0,0,0,0,0,80.55
屏東縣,萬丹鄉,廈北村,203,1,1101,8,1109,1534,0,0,0,0,0,0,72.29
屏東縣,萬丹鄉,廈南村,204,1,987,9,996,1361,0,0,0,0,0,0,73.18
屏東縣,萬丹鄉,崙頂村,205,1,1034,15,1049,1373,0,0,0,0,0,0,76.40
屏東縣,萬丹鄉,田厝村,206,1,639,2,641,825,0,0,0,0,0,0,77.70
屏東縣,萬丹鄉,後村村,207,1,802,11,813,963,0,0,0,0,0,0,84.42
屏東縣,萬丹鄉,灣內村,208,1,914,6,920,1160,0,0,0,0,0,0,79.31
屏東縣,萬丹鄉,香社村,209,1,1095,8,1103,1382,0,0,0,0,0,0,79.81
屏東縣,萬丹鄉,新庄村,210,1,1369,14,1383,1752,0,0,0,0,0,0,78.94
屏東縣,萬丹鄉,新鐘村,211,1,1396,19,1415,1782,0,0,0,0,0,0,79.41
屏東縣,萬丹鄉,水仙村,212,1,383,2,385,498,0,0,0,0,0,0,77.31
屏東縣,萬丹鄉,興安村,213,1,592,6,598,762,0,0,0,0,0,0,78.48
屏東縣,萬丹鄉,興全村,214,1,860,2,862,1084,0,0,0,0,0,0,79.52
屏東縣,萬丹鄉,甘棠村,215,1,268,3,271,351,0,0,0,0,0,0,77.21
屏東縣,萬丹鄉,水泉村,216,1,975,11,986,1292,0,0,0,0,0,0,76.32
屏東縣,萬丹鄉,竹林村,217,1,1031,4,1035,1416,0,0,0,0,0,0,73.09
屏東縣,萬丹鄉,廣安村,218,1,1285,7,1292,1740,0,0,0,0,0,0,74.25
屏東縣,萬丹鄉,四維村,219,1,1205,8,1213,1631,0,0,0,0,0,0,74.37
屏東縣,萬丹鄉,寶厝村,220,1,716,9,725,955,0,0,0,0,0,0,75.92
屏東縣,萬丹鄉,寶厝村,221,1,739,6,745,953,0,0,0,0,0,0,78.17
屏東縣,萬丹鄉,萬生村,222,1,893,10,903,1192,0,0,0,0,0,0,75.76
屏東縣,萬丹鄉,萬惠村,223,1,543,4,547,687,0,0,0,0,0,0,79.62
屏東縣,萬丹鄉,萬安村,224,1,376,9,385,499,0,0,0,0,0,0,77.15
屏東縣,萬丹鄉,萬後村,225,1,351,2,353,446,0,0,0,0,0,0,79.15
屏東縣,萬丹鄉,萬全村,226,1,1245,17,1262,1655,0,0,0,0,0,0,76.25
屏東縣,萬丹鄉,萬全村,227,1,1123,8,1131,1488,0,0,0,0,0,0,76.01
屏東縣,長治鄉,進興村,228,1,572,10,582,898,0,0,0,0,0,0,64.81
屏東縣,長治鄉,進興村,229,1,715,9,724,1098,0,0,0,0,0,0,65.94
屏東縣,長治鄉,新潭村,230,1,692,2,694,1027,0,0,0,0,0,0,67.58
屏東縣,長治鄉,新潭村,231,1,943,7,950,1345,0,0,0,0,0,0,70.63
屏東縣,長治鄉,潭頭村,232,1,1002,11,1013,1408,0,0,0,0,0,0,71.95
屏東縣,長治鄉,香楊村,233,1,1059,6,1065,1609,0,0,0,0,0,0,66.19
屏東縣,長治鄉,長興村,234,1,690,4,694,960,0,0,0,0,0,0,72.29
屏東縣,長治鄉,崙上村,235,1,1028,13,1041,1404,0,0,0,0,0,0,74.15
屏東縣,長治鄉,德榮村,236,1,748,11,759,1023,0,0,0,0,0,0,74.19
屏東縣,長治鄉,德和村,237,1,562,8,570,757,0,0,0,0,0,0,75.30
屏東縣,長治鄉,復興村,238,1,974,6,980,1373,0,0,0,0,0,0,71.38
屏東縣,長治鄉,德成村,239,1,618,5,623,813,0,0,0,0,0,0,76.63
屏東縣,長治鄉,德協村,240,1,765,13,778,1038,0,0,0,0,0,0,74.95
屏東縣,長治鄉,繁榮村,241,1,889,5,894,1295,0,0,0,0,0,0,69.03
屏東縣,長治鄉,繁昌村,242,1,1090,8,1098,1582,0,0,0,0,0,0,69.41
屏東縣,長治鄉,繁隆村,243,1,731,2,733,1027,0,0,0,0,0,0,71.37
屏東縣,長治鄉,繁華村,244,1,848,7,855,1171,0,0,0,0,0,0,73.01
屏東縣,長治鄉,繁華村,245,1,565,7,572,933,0,0,0,0,0,0,61.31
屏東縣,長治鄉,榮華村,246,1,317,6,323,495,0,0,0,0,0,0,65.25
屏東縣,麟洛鄉,新田村,247,1,492,7,499,697,0,0,0,0,0,0,71.59
屏東縣,麟洛鄉,新田村,248,1,714,6,720,953,0,0,0,0,0,0,75.55
屏東縣,麟洛鄉,麟頂村,249,1,632,2,634,827,0,0,0,0,0,0,76.66
屏東縣,麟洛鄉,麟蹄村,250,1,1071,3,1074,1468,0,0,0,0,0,0,73.16
屏東縣,麟洛鄉,麟趾村,251,1,780,6,786,1108,0,0,0,0,0,0,70.94
屏東縣,麟洛鄉,麟趾村,252,1,688,1,689,988,0,0,0,0,0,0,69.74
屏東縣,麟洛鄉,田中村,253,1,774,3,777,1041,0,0,0,0,0,0,74.64
屏東縣,麟洛鄉,田心村,254,1,558,6,564,756,0,0,0,0,0,0,74.60
屏東縣,麟洛鄉,田道村,255,1,498,5,503,675,0,0,0,0,0,0,74.52
屏東縣,九如鄉,九清村,256,1,1153,7,1160,1528,0,0,0,0,0,0,75.92
屏東縣,九如鄉,九塊村,257,1,934,12,946,1248,0,0,0,0,0,0,75.80
屏東縣,九如鄉,九明村,258,1,981,10,991,1359,0,0,0,0,0,0,72.92
屏東縣,九如鄉,大坵村,259,1,746,5,751,967,0,0,0,0,0,0,77.66
屏東縣,九如鄉,玉水村,260,1,877,9,886,1211,0,0,0,0,0,0,73.16
屏東縣,九如鄉,玉泉村,261,1,1016,6,1022,1388,0,0,0,0,0,0,73.63
屏東縣,九如鄉,東寧村,262,1,452,2,454,625,0,0,0,0,0,0,72.64
屏東縣,九如鄉,東寧村,263,1,1151,13,1164,1572,0,0,0,0,0,0,74.05
屏東縣,九如鄉,東寧村,264,1,651,3,654,923,0,0,0,0,0,0,70.86
屏東縣,九如鄉,三塊村,265,1,880,9,889,1183,0,0,0,0,0,0,75.15
屏東縣,九如鄉,後庄村,266,1,807,12,819,1145,0,0,0,0,0,0,71.53
屏東縣,九如鄉,耆老村,267,1,1158,10,1168,1611,0,0,0,0,0,0,72.50
屏東縣,九如鄉,洽興村,268,1,952,5,957,1245,0,0,0,0,0,0,76.87
屏東縣,里港鄉,玉田村,269,1,534,4,538,772,0,0,0,0,0,0,69.69
屏東縣,里港鄉,玉田村,270,1,754,7,761,1083,0,0,0,0,0,0,70.27
屏東縣,里港鄉,大平村,271,1,876,7,883,1140,0,0,0,0,0,0,77.46
屏東縣,里港鄉,永春村,272,1,570,5,575,795,0,0,0,0,0,0,72.33
屏東縣,里港鄉,春林村,273,1,863,8,871,1176,0,0,0,0,0,0,74.06
屏東縣,里港鄉,過江村,274,1,587,8,595,827,0,0,0,0,0,0,71.95
屏東縣,里港鄉,過江村,275,1,481,10,491,762,0,0,0,0,0,0,64.44
屏東縣,里港鄉,鐵店村,276,1,826,6,832,1167,0,0,0,0,0,0,71.29
屏東縣,里港鄉,塔樓村,277,1,952,12,964,1303,0,0,0,0,0,0,73.98
屏東縣,里港鄉,潮厝村,278,1,931,5,936,1277,0,0,0,0,0,0,73.30
屏東縣,里港鄉,茄苳村,279,1,295,5,300,402,0,0,0,0,0,0,74.63
屏東縣,里港鄉,茄苳村,280,1,861,6,867,1159,0,0,0,0,0,0,74.81
屏東縣,里港鄉,載興村,281,1,707,6,713,969,0,0,0,0,0,0,73.58
屏東縣,里港鄉,載興村,282,1,920,8,928,1254,0,0,0,0,0,0,74.00
屏東縣,里港鄉,土庫村,283,1,1079,11,1090,1487,0,0,0,0,0,0,73.30
屏東縣,里港鄉,土庫村,284,1,370,11,381,528,0,0,0,0,0,0,72.16
屏東縣,里港鄉,三部村,285,1,631,9,640,869,0,0,0,0,0,0,73.65
屏東縣,里港鄉,三部村,286,1,606,2,608,865,0,0,0,0,0,0,70.29
屏東縣,里港鄉,中和村,287,1,526,2,528,773,0,0,0,0,0,0,68.31
屏東縣,里港鄉,瀰力村,288,1,359,4,363,498,0,0,0,0,0,0,72.89
屏東縣,鹽埔鄉,鹽北村,289,1,1183,3,1186,1592,0,0,0,0,0,0,74.50
屏東縣,鹽埔鄉,鹽中村,290,1,1573,23,1596,2187,0,0,0,0,0,0,72.98
屏東縣,鹽埔鄉,鹽南村,291,1,1058,12,1070,1516,0,0,0,0,0,0,70.58
屏東縣,鹽埔鄉,仕絨村,292,1,740,8,748,871,0,0,0,0,0,0,85.88
屏東縣,鹽埔鄉,高朗村,293,1,881,15,896,1257,0,0,0,0,0,0,71.28
屏東縣,鹽埔鄉,高朗村,294,1,954,7,961,1318,0,0,0,0,0,0,72.91
屏東縣,鹽埔鄉,振興村,295,1,1286,15,1301,1892,0,0,0,0,0,0,68.76
屏東縣,鹽埔鄉,久愛村,296,1,659,3,662,829,0,0,0,0,0,0,79.86
屏東縣,鹽埔鄉,新圍村,297,1,1899,29,1928,2711,0,0,0,0,0,0,71.12
屏東縣,鹽埔鄉,新二村,298,1,852,10,862,1229,0,0,0,0,0,0,70.14
屏東縣,鹽埔鄉,新二村,299,1,1072,11,1083,1655,0,0,0,0,0,0,65.44
屏東縣,鹽埔鄉,彭厝村,300,1,720,3,723,937,0,0,0,0,0,0,77.16
屏東縣,鹽埔鄉,洛陽村,301,1,1004,22,1026,1346,0,0,0,0,0,0,76.23
屏東縣,鹽埔鄉,永隆村,302,1,398,4,402,574,0,0,0,0,0,0,70.03
屏東縣,高樹鄉,高樹村,303,1,794,12,806,1184,0,0,0,0,0,0,68.07
屏東縣,高樹鄉,高樹村,304,1,667,3,670,986,0,0,0,0,0,0,67.95
屏東縣,高樹鄉,長榮村,305,1,930,9,939,1379,0,0,0,0,0,0,68.09
屏東縣,高樹鄉,東興村,306,1,581,7,588,838,0,0,0,0,0,0,70.17
屏東縣,高樹鄉,東振村,307,1,431,3,434,633,0,0,0,0,0,0,68.56
屏東縣,高樹鄉,源泉村,308,1,657,2,659,1006,0,0,0,0,0,0,65.51
屏東縣,高樹鄉,建興村,309,1,734,10,744,1198,0,0,0,0,0,0,62.10
屏東縣,高樹鄉,大埔村,310,1,444,6,450,696,0,0,0,0,0,0,64.66
屏東縣,高樹鄉,菜寮村,311,1,547,5,552,855,0,0,0,0,0,0,64.56
屏東縣,高樹鄉,司馬村,312,1,518,6,524,761,0,0,0,0,0,0,68.86
屏東縣,高樹鄉,舊寮村,313,1,839,8,847,1329,0,0,0,0,0,0,63.73
屏東縣,高樹鄉,新豐村,314,1,939,25,964,1554,0,0,0,0,0,0,62.03
屏東縣,高樹鄉,泰山村,315,1,599,5,604,994,0,0,0,0,0,0,60.76
屏東縣,高樹鄉,泰山村,316,1,600,10,610,1026,0,0,0,0,0,0,59.45
屏東縣,高樹鄉,南華村,317,1,789,9,798,1229,0,0,0,0,0,0,64.93
屏東縣,高樹鄉,廣福村,318,1,627,7,634,956,0,0,0,0,0,0,66.32
屏東縣,高樹鄉,廣興村,319,1,695,9,704,1073,0,0,0,0,0,0,65.61
屏東縣,高樹鄉,舊庄村,320,1,739,11,750,1046,0,0,0,0,0,0,71.70
屏東縣,高樹鄉,田子村,321,1,759,9,768,1140,0,0,0,0,0,0,67.37
屏東縣,高樹鄉,鹽樹村,322,1,466,7,473,740,0,0,0,0,0,0,63.92
屏東縣,高樹鄉,鹽樹村,323,1,395,6,401,631,0,0,0,0,0,0,63.55
屏東縣,高樹鄉,新南村,324,1,909,6,915,1406,0,0,0,0,0,0,65.08
屏東縣,萬巒鄉,萬巒村,325,1,862,4,866,1230,0,0,0,0,0,0,70.41
屏東縣,萬巒鄉,萬全村,326,1,594,5,599,799,0,0,0,0,0,0,74.97
屏東縣,萬巒鄉,萬和村,327,1,940,12,952,1369,0,0,0,0,0,0,69.54
屏東縣,萬巒鄉,鹿寮村,328,1,656,2,658,908,0,0,0,0,0,0,72.47
屏東縣,萬巒鄉,硫黃村,329,1,383,2,385,531,0,0,0,0,0,0,72.50
屏東縣,萬巒鄉,泗溝村,330,1,877,13,890,1280,0,0,0,0,0,0,69.53
屏東縣,萬巒鄉,五溝村,331,1,861,9,870,1152,0,0,0,0,0,0,75.52
屏東縣,萬巒鄉,成德村,332,1,915,17,932,1380,0,0,0,0,0,0,67.54
屏東縣,萬巒鄉,赤山村,333,1,952,22,974,1669,0,0,0,0,0,0,58.36
屏東縣,萬巒鄉,萬金村,334,1,669,9,678,990,0,0,0,0,0,0,68.48
屏東縣,萬巒鄉,萬金村,335,1,563,11,574,907,0,0,0,0,0,0,63.29
屏東縣,萬巒鄉,佳佐村,336,1,1104,10,1114,1564,0,0,0,0,0,0,71.23
屏東縣,萬巒鄉,佳和村,337,1,1155,13,1168,1497,0,0,0,0,0,0,78.02
屏東縣,萬巒鄉,新厝村,338,1,779,6,785,1063,0,0,0,0,0,0,73.85
屏東縣,萬巒鄉,新置村,339,1,395,2,397,594,0,0,0,0,0,0,66.84
屏東縣,萬巒鄉,新置村,340,1,374,3,377,593,0,0,0,0,0,0,63.58
屏東縣,內埔鄉,內埔村,341,1,832,16,848,1260,0,0,0,0,0,0,67.30
屏東縣,內埔鄉,內埔村,342,1,1125,8,1133,1755,0,0,0,0,0,0,64.56
屏東縣,內埔鄉,內田村,343,1,670,8,678,1103,0,0,0,0,0,0,61.47
屏東縣,內埔鄉,內田村,344,1,1017,11,1028,1577,0,0,0,0,0,0,65.19
屏東縣,內埔鄉,興南村,345,1,976,11,987,1337,0,0,0,0,0,0,73.82
屏東縣,內埔鄉,義亭村,346,1,374,3,377,566,0,0,0,0,0,0,66.61
屏東縣,內埔鄉,美和村,347,1,683,8,691,1005,0,0,0,0,0,0,68.76
屏東縣,內埔鄉,美和村,348,1,679,12,691,992,0,0,0,0,0,0,69.66
屏東縣,內埔鄉,和興村,349,1,585,6,591,828,0,0,0,0,0,0,71.38
屏東縣,內埔鄉,和興村,350,1,610,4,614,913,0,0,0,0,0,0,67.25
屏東縣,內埔鄉,東寧村,351,1,689,8,697,979,0,0,0,0,0,0,71.20
屏東縣,內埔鄉,東寧村,352,1,812,2,814,1274,0,0,0,0,0,0,63.89
屏東縣,內埔鄉,東寧村,353,1,963,2,965,1502,0,0,0,0,0,0,64.25
屏東縣,內埔鄉,豐田村,354,1,648,8,656,1107,0,0,0,0,0,0,59.26
屏東縣,內埔鄉,豐田村,355,1,713,5,718,1162,0,0,0,0,0,0,61.79
屏東縣,內埔鄉,振豐村,356,1,628,5,633,862,0,0,0,0,0,0,73.43
屏東縣,內埔鄉,振豐村,357,1,510,6,516,776,0,0,0,0,0,0,66.49
屏東縣,內埔鄉,富田村,358,1,578,4,582,821,0,0,0,0,0,0,70.89
屏東縣,內埔鄉,富田村,359,1,713,7,720,1072,0,0,0,0,0,0,67.16
屏東縣,內埔鄉,竹圍村,360,1,961,17,978,1498,0,0,0,0,0,0,65.29
屏東縣,內埔鄉,東勢村,361,1,804,5,809,1160,0,0,0,0,0,0,69.74
屏東縣,內埔鄉,東勢村,362,1,1169,21,1190,1741,0,0,0,0,0,0,68.35
屏東縣,內埔鄉,東片村,363,1,635,7,642,949,0,0,0,0,0,0,67.65
屏東縣,內埔鄉,上樹村,364,1,720,6,726,1027,0,0,0,0,0,0,70.69
屏東縣,內埔鄉,老埤村,365,1,678,5,683,1102,0,0,0,0,0,0,61.98
屏東縣,內埔鄉,老埤村,366,1,720,6,726,1217,0,0,0,0,0,0,59.65
屏東縣,內埔鄉,中林村,367,1,953,7,960,1399,0,0,0,0,0,0,68.62
屏東縣,內埔鄉,龍泉村,368,1,882,6,888,1336,0,0,0,0,0,0,66.47
屏東縣,內埔鄉,龍泉村,369,1,709,7,716,1133,0,0,0,0,0,0,63.20
屏東縣,內埔鄉,龍潭村,370,1,118,4,122,188,0,0,0,0,0,0,64.89
屏東縣,內埔鄉,龍潭村,371,1,860,17,877,1351,0,0,0,0,0,0,64.91
屏東縣,內埔鄉,龍潭村,372,1,599,17,616,1016,0,0,0,0,0,0,60.63
屏東縣,內埔鄉,建興村,373,1,441,3,444,638,0,0,0,0,0,0,69.59
屏東縣,內埔鄉,建興村,374,1,914,22,936,1453,0,0,0,0,0,0,64.42
屏東縣,內埔鄉,大新村,375,1,891,13,904,1277,0,0,0,0,0,0,70.79
屏東縣,內埔鄉,大新村,376,1,260,5,265,412,0,0,0,0,0,0,64.32
屏東縣,內埔鄉,黎明村,377,1,711,4,715,1128,0,0,0,0,0,0,63.39
屏東縣,內埔鄉,黎明村,378,1,696,9,705,1038,0,0,0,0,0,0,67.92
屏東縣,內埔鄉,隘寮村,379,1,704,10,714,1150,0,0,0,0,0,0,62.09
屏東縣,內埔鄉,水門村,380,1,527,6,533,800,0,0,0,0,0,0,66.63
屏東縣,竹田鄉,竹田村,381,1,1037,10,1047,1417,0,0,0,0,0,0,73.89
屏東縣,竹田鄉,竹南村,382,1,602,6,608,856,0,0,0,0,0,0,71.03
屏東縣,竹田鄉,糶糴村,383,1,497,3,500,675,0,0,0,0,0,0,74.07
屏東縣,竹田鄉,履豐村,384,1,445,3,448,585,0,0,0,0,0,0,76.58
屏東縣,竹田鄉,頭崙村,385,1,960,12,972,1292,0,0,0,0,0,0,75.23
屏東縣,竹田鄉,二崙村,386,1,738,7,745,966,0,0,0,0,0,0,77.12
屏東縣,竹田鄉,美崙村,387,1,472,2,474,601,0,0,0,0,0,0,78.87
屏東縣,竹田鄉,南勢村,388,1,351,4,355,457,0,0,0,0,0,0,77.68
屏東縣,竹田鄉,西勢村,389,1,957,12,969,1311,0,0,0,0,0,0,73.91
屏東縣,竹田鄉,西勢村,390,1,896,7,903,1250,0,0,0,0,0,0,72.24
屏東縣,竹田鄉,福田村,391,1,336,4,340,425,0,0,0,0,0,0,80.00
屏東縣,竹田鄉,永豐村,392,1,398,4,402,570,0,0,0,0,0,0,70.53
屏東縣,竹田鄉,六巷村,393,1,498,3,501,647,0,0,0,0,0,0,77.43
屏東縣,竹田鄉,泗洲村,394,1,749,11,760,1142,0,0,0,0,0,0,66.55
屏東縣,竹田鄉,大湖村,395,1,783,4,787,1108,0,0,0,0,0,0,71.03
屏東縣,竹田鄉,鳳明村,396,1,693,6,699,942,0,0,0,0,0,0,74.20
屏東縣,新埤鄉,新埤村,397,1,1057,11,1068,1521,0,0,0,0,0,0,70.22
屏東縣,新埤鄉,新埤村,398,1,254,2,256,339,0,0,0,0,0,0,75.52
屏東縣,新埤鄉,建功村,399,1,877,6,883,1214,0,0,0,0,0,0,72.73
屏東縣,新埤鄉,打鐵村,400,1,744,7,751,1058,0,0,0,0,0,0,70.98
屏東縣,新埤鄉,南豐村,401,1,503,3,506,753,0,0,0,0,0,0,67.20
屏東縣,新埤鄉,萬隆村,402,1,644,8,652,1008,0,0,0,0,0,0,64.68
屏東縣,新埤鄉,萬隆村,403,1,398,1,399,645,0,0,0,0,0,0,61.86
屏東縣,新埤鄉,餉潭村,404,1,728,5,733,1309,0,0,0,0,0,0,56.00
屏東縣,新埤鄉,箕湖村,405,1,312,0,312,528,0,0,0,0,0,0,59.09
屏東縣,新埤鄉,箕湖村,406,1,397,2,399,543,0,0,0,0,0,0,73.48
屏東縣,枋寮鄉,枋寮村,407,1,882,12,894,1344,0,0,0,0,0,0,66.52
屏東縣,枋寮鄉,新龍村,408,1,566,5,571,862,0,0,0,0,0,0,66.24
屏東縣,枋寮鄉,保生村,409,1,606,6,612,944,0,0,0,0,0,0,64.83
屏東縣,枋寮鄉,中寮村,410,1,495,5,500,744,0,0,0,0,0,0,67.20
屏東縣,枋寮鄉,安樂村,411,1,1136,7,1143,1798,0,0,0,0,0,0,63.57
屏東縣,枋寮鄉,隆山村,412,1,1028,6,1034,1728,0,0,0,0,0,0,59.84
屏東縣,枋寮鄉,隆山村,413,1,1043,9,1052,1748,0,0,0,0,0,0,60.18
屏東縣,枋寮鄉,天時村,414,1,642,2,644,920,0,0,0,0,0,0,70.00
屏東縣,枋寮鄉,天時村,415,1,722,5,727,1054,0,0,0,0,0,0,68.98
屏東縣,枋寮鄉,地利村,416,1,1156,8,1164,1682,0,0,0,0,0,0,69.20
屏東縣,枋寮鄉,人和村,417,1,713,13,726,1059,0,0,0,0,0,0,68.56
屏東縣,枋寮鄉,人和村,418,1,764,13,777,1135,0,0,0,0,0,0,68.46
屏東縣,枋寮鄉,內寮村,419,1,417,5,422,775,0,0,0,0,0,0,54.45
屏東縣,枋寮鄉,新開村,420,1,585,9,594,1000,0,0,0,0,0,0,59.40
屏東縣,枋寮鄉,東海村,421,1,755,8,763,1068,0,0,0,0,0,0,71.44
屏東縣,枋寮鄉,東海村,422,1,1061,10,1071,1570,0,0,0,0,0,0,68.22
屏東縣,枋寮鄉,大庄村,423,1,399,3,402,587,0,0,0,0,0,0,68.48
屏東縣,枋寮鄉,太源村,424,1,608,11,619,958,0,0,0,0,0,0,64.61
屏東縣,枋寮鄉,玉泉村,425,1,251,3,254,422,0,0,0,0,0,0,60.19
屏東縣,新園鄉,瓦窯村,426,1,1229,9,1238,1565,0,0,0,0,0,0,79.11
屏東縣,新園鄉,仙吉村,427,1,750,2,752,1010,0,0,0,0,0,0,74.46
屏東縣,新園鄉,仙吉村,428,1,880,8,888,1221,0,0,0,0,0,0,72.73
屏東縣,新園鄉,田洋村,429,1,727,6,733,987,0,0,0,0,0,0,74.27
屏東縣,新園鄉,田洋村,430,1,706,11,717,954,0,0,0,0,0,0,75.16
屏東縣,新園鄉,港墘村,431,1,523,7,530,710,0,0,0,0,0,0,74.65
屏東縣,新園鄉,內庄村,432,1,589,3,592,749,0,0,0,0,0,0,79.04
屏東縣,新園鄉,新東村,433,1,896,14,910,1198,0,0,0,0,0,0,75.96
屏東縣,新園鄉,新東村,434,1,749,6,755,988,0,0,0,0,0,0,76.42
屏東縣,新園鄉,新園村,435,1,677,7,684,895,0,0,0,0,0,0,76.42
屏東縣,新園鄉,新園村,436,1,805,3,808,1070,0,0,0,0,0,0,75.51
屏東縣,新園鄉,港西村,437,1,850,4,854,1053,0,0,0,0,0,0,81.10
屏東縣,新園鄉,港西村,438,1,891,7,898,1122,0,0,0,0,0,0,80.04
屏東縣,新園鄉,五房村,439,1,693,4,697,966,0,0,0,0,0,0,72.15
屏東縣,新園鄉,五房村,440,1,552,4,556,754,0,0,0,0,0,0,73.74
屏東縣,新園鄉,五房村,441,1,713,10,723,1056,0,0,0,0,0,0,68.47
屏東縣,新園鄉,烏龍村,442,1,937,15,952,1247,0,0,0,0,0,0,76.34
屏東縣,新園鄉,興龍村,443,1,661,8,669,881,0,0,0,0,0,0,75.94
屏東縣,新園鄉,興龍村,444,1,847,4,851,1144,0,0,0,0,0,0,74.39
屏東縣,新園鄉,中洲村,445,1,1159,15,1174,1625,0,0,0,0,0,0,72.25
屏東縣,新園鄉,南龍村,446,1,956,12,968,1327,0,0,0,0,0,0,72.95
屏東縣,新園鄉,鹽埔村,447,1,879,11,890,1339,0,0,0,0,0,0,66.47
屏東縣,新園鄉,鹽埔村,448,1,810,3,813,1170,0,0,0,0,0,0,69.49
屏東縣,新園鄉,鹽埔村,449,1,792,2,794,1210,0,0,0,0,0,0,65.62
屏東縣,新園鄉,共和村,450,1,754,5,759,1073,0,0,0,0,0,0,70.74
屏東縣,新園鄉,共和村,451,1,748,7,755,1101,0,0,0,0,0,0,68.57
屏東縣,崁頂鄉,崁頂村,452,1,1320,12,1332,1892,0,0,0,0,0,0,70.40
屏東縣,崁頂鄉,園寮村,453,1,973,6,979,1501,0,0,0,0,0,0,65.22
屏東縣,崁頂鄉,力社村,454,1,780,15,795,1076,0,0,0,0,0,0,73.88
屏東縣,崁頂鄉,圍內村,455,1,796,8,804,1071,0,0,0,0,0,0,75.07
屏東縣,崁頂鄉,洲子村,456,1,615,4,619,834,0,0,0,0,0,0,74.22
屏東縣,崁頂鄉,北勢村,457,1,981,10,991,1433,0,0,0,0,0,0,69.16
屏東縣,崁頂鄉,越溪村,458,1,525,8,533,743,0,0,0,0,0,0,71.74
屏東縣,崁頂鄉,港東村,459,1,1184,15,1199,1685,0,0,0,0,0,0,71.16
屏東縣,林邊鄉,林邊村,460,1,1032,11,1043,1446,0,0,0,0,0,0,72.13
屏東縣,林邊鄉,光林村,461,1,1149,7,1156,1625,0,0,0,0,0,0,71.14
屏東縣,林邊鄉,中林村,462,1,622,10,632,840,0,0,0,0,0,0,75.24
屏東縣,林邊鄉,仁和村,463,1,1110,7,1117,1584,0,0,0,0,0,0,70.52
屏東縣,林邊鄉,永樂村,464,1,1088,10,1098,1479,0,0,0,0,0,0,74.24
屏東縣,林邊鄉,永樂村,465,1,1187,22,1209,1598,0,0,0,0,0,0,75.66
屏東縣,林邊鄉,田厝村,466,1,658,5,663,875,0,0,0,0,0,0,75.77
屏東縣,林邊鄉,崎峰村,467,1,881,7,888,1269,0,0,0,0,0,0,69.98
屏東縣,林邊鄉,水利村,468,1,1166,16,1182,1754,0,0,0,0,0,0,67.39
屏東縣,林邊鄉,竹林村,469,1,1121,15,1136,1551,0,0,0,0,0,0,73.24
屏東縣,林邊鄉,竹林村,470,1,981,14,995,1373,0,0,0,0,0,0,72.47
屏東縣,林邊鄉,鎮安村,471,1,810,18,828,1143,0,0,0,0,0,0,72.44
屏東縣,南州鄉,溪洲村,472,1,1306,13,1319,1760,0,0,0,0,0,0,74.94
屏東縣,南州鄉,溪南村,473,1,722,6,728,1007,0,0,0,0,0,0,72.29
屏東縣,南州鄉,仁里村,474,1,427,5,432,602,0,0,0,0,0,0,71.76
屏東縣,南州鄉,溪北村,475,1,584,9,593,778,0,0,0,0,0,0,76.22
屏東縣,南州鄉,七塊村,476,1,736,8,744,1039,0,0,0,0,0,0,71.61
屏東縣,南州鄉,萬華村,477,1,710,7,717,973,0,0,0,0,0,0,73.69
屏東縣,南州鄉,米崙村,478,1,779,5,784,1035,0,0,0,0,0,0,75.75
屏東縣,南州鄉,壽元村,479,1,738,7,745,1099,0,0,0,0,0,0,67.79
屏東縣,南州鄉,同安村,480,1,629,5,634,895,0,0,0,0,0,0,70.84
屏東縣,南州鄉,南安村,481,1,426,10,436,589,0,0,0,0,0,0,74.02
屏東縣,佳冬鄉,佳冬村,482,1,1045,11,1056,1488,0,0,0,0,0,0,70.97
屏東縣,佳冬鄉,六根村,483,1,1173,14,1187,1701,0,0,0,0,0,0,69.78
屏東縣,佳冬鄉,賴家村,484,1,676,12,688,968,0,0,0,0,0,0,71.07
屏東縣,佳冬鄉,萬建村,485,1,1159,15,1174,1684,0,0,0,0,0,0,69.71
屏東縣,佳冬鄉,石光村,486,1,1254,12,1266,1841,0,0,0,0,0,0,68.77
屏東縣,佳冬鄉,玉光村,487,1,649,12,661,1004,0,0,0,0,0,0,65.84
屏東縣,佳冬鄉,玉光村,488,1,802,7,809,1220,0,0,0,0,0,0,66.31
屏東縣,佳冬鄉,昌隆村,489,1,842,6,848,1162,0,0,0,0,0,0,72.98
屏東縣,佳冬鄉,豐隆村,490,1,586,11,597,865,0,0,0,0,0,0,69.02
屏東縣,佳冬鄉,大同村,491,1,887,9,896,1230,0,0,0,0,0,0,72.85
屏東縣,佳冬鄉,羌園村,492,1,736,8,744,970,0,0,0,0,0,0,76.70
屏東縣,佳冬鄉,燄溫村,493,1,763,6,769,1074,0,0,0,0,0,0,71.60
屏東縣,佳冬鄉,塭豐村,494,1,731,8,739,1042,0,0,0,0,0,0,70.92
屏東縣,佳冬鄉,塭豐村,495,1,793,6,799,1112,0,0,0,0,0,0,71.85
屏東縣,琉球鄉,本福村,496,1,1020,8,1028,1692,0,0,0,0,0,0,60.76
屏東縣,琉球鄉,中福村,497,1,611,3,614,953,0,0,0,0,0,0,64.43
屏東縣,琉球鄉,漁福村,498,1,515,4,519,770,0,0,0,0,0,0,67.40
屏東縣,琉球鄉,大福村,499,1,826,7,833,1411,0,0,0,0,0,0,59.04
屏東縣,琉球鄉,南福村,500,1,582,5,587,1043,0,0,0,0,0,0,56.28
屏東縣,琉球鄉,天福村,501,1,525,1,526,966,0,0,0,0,0,0,54.45
屏東縣,琉球鄉,上福村,502,1,754,10,764,1305,0,0,0,0,0,0,58.54
屏東縣,琉球鄉,杉福村,503,1,419,1,420,693,0,0,0,0,0,0,60.61
屏東縣,車城鄉,福興村,504,1,300,1,301,452,0,0,0,0,0,0,66.59
屏東縣,車城鄉,福興村,505,1,532,4,536,902,0,0,0,0,0,0,59.42
屏東縣,車城鄉,福安村,506,1,390,10,400,597,0,0,0,0,0,0,67.00
屏東縣,車城鄉,田中村,507,1,459,2,461,755,0,0,0,0,0,0,61.06
屏東縣,車城鄉,海口村,508,1,495,11,506,841,0,0,0,0,0,0,60.17
屏東縣,車城鄉,統埔村,509,1,243,3,246,427,0,0,0,0,0,0,57.61
屏東縣,車城鄉,溫泉村,510,1,552,8,560,1001,0,0,0,0,0,0,55.94
屏東縣,車城鄉,保力村,511,1,431,7,438,713,0,0,0,0,0,0,61.43
屏東縣,車城鄉,保力村,512,1,406,8,414,686,0,0,0,0,0,0,60.35
屏東縣,車城鄉,新街村,513,1,285,5,290,432,0,0,0,0,0,0,67.13
屏東縣,車城鄉,埔墘村,514,1,269,12,281,451,0,0,0,0,0,0,62.31
屏東縣,車城鄉,射寮村,515,1,334,3,337,540,0,0,0,0,0,0,62.41
屏東縣,車城鄉,後灣村,516,1,297,6,303,512,0,0,0,0,0,0,59.18
屏東縣,滿州鄉,滿州村,517,1,762,16,778,1393,0,0,0,0,0,0,55.85
屏東縣,滿州鄉,里德村,518,1,142,3,145,271,0,0,0,0,0,0,53.51
屏東縣,滿州鄉,永靖村,519,1,619,3,622,1133,0,0,0,0,0,0,54.90
屏東縣,滿州鄉,港口村,520,1,611,5,616,1067,0,0,0,0,0,0,57.73
屏東縣,滿州鄉,響林村,521,1,218,1,219,441,0,0,0,0,0,0,49.66
屏東縣,滿州鄉,長樂村,522,1,323,5,328,679,0,0,0,0,0,0,48.31
屏東縣,滿州鄉,九棚村,523,1,113,3,116,242,0,0,0,0,0,0,47.93
屏東縣,滿州鄉,港仔村,524,1,172,1,173,301,0,0,0,0,0,0,57.48
屏東縣,枋山鄉,加祿村,525,1,599,11,610,835,0,0,0,0,0,0,73.05
屏東縣,枋山鄉,加祿村,526,1,702,6,708,920,0,0,0,0,0,0,76.96
屏東縣,枋山鄉,枋山村,527,1,398,4,402,628,0,0,0,0,0,0,64.01
屏東縣,枋山鄉,枋山村,528,1,316,2,318,483,0,0,0,0,0,0,65.84
屏東縣,枋山鄉,楓港村,529,1,585,11,596,1129,0,0,0,0,0,0,52.79
屏東縣,枋山鄉,善餘村,530,1,555,10,565,1037,0,0,0,0,0,0,54.48
屏東縣,三地門鄉,三地村,531,1,63,2,65,117,0,0,0,0,0,0,55.56
屏東縣,三地門鄉,達來村,532,1,8,0,8,21,0,0,0,0,0,0,38.10
屏東縣,三地門鄉,德文村,533,1,5,0,5,14,0,0,0,0,0,0,35.71
屏東縣,三地門鄉,大社村,534,1,7,2,9,22,0,0,0,0,0,0,40.91
屏東縣,三地門鄉,賽嘉村,535,1,19,0,19,46,0,0,0,0,0,0,41.30
屏東縣,三地門鄉,口社村,536,1,24,0,24,42,0,0,0,0,0,0,57.14
屏東縣,三地門鄉,馬兒村,537,1,6,0,6,15,0,0,0,0,0,0,40.00
屏東縣,三地門鄉,安坡村,538,1,19,1,20,38,0,0,0,0,0,0,52.63
屏東縣,三地門鄉,青山村,539,1,32,0,32,56,0,0,0,0,0,0,57.14
屏東縣,三地門鄉,青葉村,540,1,22,0,22,38,0,0,0,0,0,0,57.89
屏東縣,霧台鄉,霧台村,541,1,5,0,5,14,0,0,0,0,0,0,35.71
屏東縣,霧台鄉,霧台村,542,1,3,0,3,8,0,0,0,0,0,0,37.50
屏東縣,霧台鄉,霧台村,543,1,4,0,4,5,0,0,0,0,0,0,80.00
屏東縣,霧台鄉,好茶村,544,1,8,0,8,19,0,0,0,0,0,0,42.11
屏東縣,霧台鄉,阿禮村,545,1,1,0,1,2,0,0,0,0,0,0,50.00
屏東縣,霧台鄉,吉露村,546,1,3,0,3,4,0,0,0,0,0,0,75.00
屏東縣,霧台鄉,大武村,547,1,6,0,6,20,0,0,0,0,0,0,30.00
屏東縣,霧台鄉,佳暮村,548,1,3,0,3,7,0,0,0,0,0,0,42.86
屏東縣,瑪家鄉,瑪家村,549,1,4,1,5,17,0,0,0,0,0,0,29.41
屏東縣,瑪家鄉,北葉村,550,1,59,0,59,96,0,0,0,0,0,0,61.46
屏東縣,瑪家鄉,涼山村,551,1,34,0,34,48,0,0,0,0,0,0,70.83
屏東縣,瑪家鄉,佳義村,552,1,30,1,31,57,0,0,0,0,0,0,54.39
屏東縣,瑪家鄉,排灣村,553,1,7,0,7,14,0,0,0,0,0,0,50.00
屏東縣,瑪家鄉,三和村,554,1,24,0,24,42,0,0,0,0,0,0,57.14
屏東縣,瑪家鄉,三和村,555,1,28,1,29,48,0,0,0,0,0,0,60.42
屏東縣,瑪家鄉,三和村,556,1,30,1,31,54,0,0,0,0,0,0,57.41
屏東縣,泰武鄉,佳平村,557,1,28,0,28,37,0,0,0,0,0,0,75.68
屏東縣,泰武鄉,佳平村,558,1,8,0,8,12,0,0,0,0,0,0,66.67
屏東縣,泰武鄉,武潭村,559,1,15,0,15,33,0,0,0,0,0,0,45.45
屏東縣,泰武鄉,平和村,560,1,19,0,19,33,0,0,0,0,0,0,57.58
屏東縣,泰武鄉,佳興村,561,1,5,0,5,14,0,0,0,0,0,0,35.71
屏東縣,泰武鄉,泰武村,562,1,5,0,5,9,0,0,0,0,0,0,55.56
屏東縣,泰武鄉,萬安村,563,1,13,0,13,34,0,0,0,0,0,0,38.24
屏東縣,來義鄉,來義村,564,1,16,1,17,37,0,0,0,0,0,0,45.95
屏東縣,來義鄉,義林村,565,1,13,0,13,34,0,0,0,0,0,0,38.24
屏東縣,來義鄉,義林村,566,1,4,0,4,9,0,0,0,0,0,0,44.44
屏東縣,來義鄉,丹林村,567,1,29,0,29,49,0,0,0,0,0,0,59.18
屏東縣,來義鄉,丹林村,568,1,14,1,15,23,0,0,0,0,0,0,65.22
屏東縣,來義鄉,古樓村,569,1,51,3,54,97,0,0,0,0,0,0,55.67
屏東縣,來義鄉,文樂村,570,1,25,3,28,47,0,0,0,0,0,0,59.57
屏東縣,來義鄉,望嘉村,571,1,45,1,46,63,0,0,0,0,0,0,73.02
屏東縣,來義鄉,南和村,572,1,40,2,42,70,0,0,0,0,0,0,60.00
屏東縣,春日鄉,春日村,573,1,28,0,28,59,0,0,0,0,0,0,47.46
屏東縣,春日鄉,古華村,574,1,37,0,37,53,0,0,0,0,0,0,69.81
屏東縣,春日鄉,士文村,575,1,7,0,7,9,0,0,0,0,0,0,77.78
屏東縣,春日鄉,歸崇村,576,1,97,0,97,150,0,0,0,0,0,0,64.67
屏東縣,春日鄉,七佳村,577,1,79,0,79,122,0,0,0,0,0,0,64.75
屏東縣,春日鄉,力里村,578,1,10,0,10,15,0,0,0,0,0,0,66.67
屏東縣,獅子鄉,楓林村,579,1,24,0,24,44,0,0,0,0,0,0,54.55
屏東縣,獅子鄉,丹路村,580,1,31,0,31,76,0,0,0,0,0,0,40.79
屏東縣,獅子鄉,草埔村,581,1,32,0,32,59,0,0,0,0,0,0,54.24
屏東縣,獅子鄉,內文村,582,1,8,0,8,21,0,0,0,0,0,0,38.10
屏東縣,獅子鄉,竹坑村,583,1,19,0,19,32,0,0,0,0,0,0,59.38
屏東縣,獅子鄉,獅子村,584,1,8,0,8,17,0,0,0,0,0,0,47.06
屏東縣,獅子鄉,內獅村,585,1,21,0,21,36,0,0,0,0,0,0,58.33
屏東縣,獅子鄉,南世村,586,1,9,0,9,18,0,0,0,0,0,0,50.00
屏東縣,牡丹鄉,石門村,587,1,105,1,106,176,0,0,0,0,0,0,60.23
屏東縣,牡丹鄉,牡丹村,588,1,17,0,17,47,0,0,0,0,0,0,36.17
屏東縣,牡丹鄉,東源村,589,1,11,0,11,21,0,0,0,0,0,0,52.38
屏東縣,牡丹鄉,旭海村,590,1,49,2,51,106,0,0,0,0,0,0,48.11
屏東縣,牡丹鄉,高士村,591,1,16,0,16,34,0,0,0,0,0,0,47.06
屏東縣,牡丹鄉,四林村,592,1,11,0,11,20,0,0,0,0,0,0,55.00
臺東縣,台東市,文化里,1,1,752,7,759,1172,0,0,0,0,0,0,64.76
臺東縣,台東市,民族里,2,1,572,6,578,821,0,0,0,0,0,0,70.40
臺東縣,台東市,民族里,3,1,579,5,584,811,0,0,0,0,0,0,72.01
臺東縣,台東市,自強里,4,1,877,10,887,1430,0,0,0,0,0,0,62.03
臺東縣,台東市,自強里,5,1,1107,10,1117,1764,0,0,0,0,0,0,63.32
臺東縣,台東市,民生里,6,1,880,13,893,1404,0,0,0,0,0,0,63.60
臺東縣,台東市,民生里,7,1,761,9,770,1201,0,0,0,0,0,0,64.11
臺東縣,台東市,寶桑里,8,1,463,6,469,745,0,0,0,0,0,0,62.95
臺東縣,台東市,民權里,9,1,670,12,682,1067,0,0,0,0,0,0,63.92
臺東縣,台東市,四維里,10,1,264,0,264,455,0,0,0,0,0,0,58.02
臺東縣,台東市,中華里,11,1,592,7,599,912,0,0,0,0,0,0,65.68
臺東縣,台東市,中華里,12,1,488,8,496,848,0,0,0,0,0,0,58.49
臺東縣,台東市,仁愛里,13,1,503,3,506,768,0,0,0,0,0,0,65.89
臺東縣,台東市,強國里,14,1,397,2,399,621,0,0,0,0,0,0,64.25
臺東縣,台東市,大同里,15,1,487,5,492,769,0,0,0,0,0,0,63.98
臺東縣,台東市,成功里,16,1,513,3,516,873,0,0,0,0,0,0,59.11
臺東縣,台東市,建國里,17,1,880,11,891,1441,0,0,0,0,0,0,61.83
臺東縣,台東市,中正里,18,1,570,2,572,916,0,0,0,0,0,0,62.45
臺東縣,台東市,中山里,19,1,688,5,693,1048,0,0,0,0,0,0,66.13
臺東縣,台東市,興國里,20,1,471,5,476,721,0,0,0,0,0,0,66.02
臺東縣,台東市,鐵花里,21,1,291,4,295,473,0,0,0,0,0,0,62.37
臺東縣,台東市,東海里,22,1,695,6,701,1159,0,0,0,0,0,0,60.48
臺東縣,台東市,東海里,23,1,931,10,941,1505,0,0,0,0,0,0,62.52
臺東縣,台東市,復國里,24,1,454,2,456,724,0,0,0,0,0,0,62.98
臺東縣,台東市,復興里,25,1,285,4,289,501,0,0,0,0,0,0,57.68
臺東縣,台東市,新興里,26,1,776,9,785,1207,0,0,0,0,0,0,65.04
臺東縣,台東市,新生里,27,1,637,6,643,1139,0,0,0,0,0,0,56.45
臺東縣,台東市,新生里,28,1,919,10,929,1523,0,0,0,0,0,0,61.00
臺東縣,台東市,新生里,29,1,912,7,919,1532,0,0,0,0,0,0,59.99
臺東縣,台東市,中心里,30,1,528,5,533,838,0,0,0,0,0,0,63.60
臺東縣,台東市,中心里,31,1,811,9,820,1224,0,0,0,0,0,0,66.99
臺東縣,台東市,馬蘭里,32,1,636,11,647,988,0,0,0,0,0,0,65.49
臺東縣,台東市,馬蘭里,33,1,642,3,645,963,0,0,0,0,0,0,66.98
臺東縣,台東市,馬蘭里,34,1,666,4,670,1021,0,0,0,0,0,0,65.62
臺東縣,台東市,光明里,35,1,770,4,774,1227,0,0,0,0,0,0,63.08
臺東縣,台東市,豐年里,36,1,332,2,334,509,0,0,0,0,0,0,65.62
臺東縣,台東市,豐年里,37,1,698,14,712,1093,0,0,0,0,0,0,65.14
臺東縣,台東市,豐樂里,38,1,505,7,512,823,0,0,0,0,0,0,62.21
臺東縣,台東市,永樂里,39,1,694,9,703,983,0,0,0,0,0,0,71.52
臺東縣,台東市,康樂里,40,1,666,5,671,1030,0,0,0,0,0,0,65.15
臺東縣,台東市,豐榮里,41,1,697,9,706,1142,0,0,0,0,0,0,61.82
臺東縣,台東市,豐榮里,42,1,700,9,709,1188,0,0,0,0,0,0,59.68
臺東縣,台東市,豐榮里,43,1,732,9,741,1261,0,0,0,0,0,0,58.76
臺東縣,台東市,豐榮里,44,1,901,8,909,1482,0,0,0,0,0,0,61.34
臺東縣,台東市,豐谷里,45,1,609,4,613,1014,0,0,0,0,0,0,60.45
臺東縣,台東市,豐谷里,46,1,343,9,352,574,0,0,0,0,0,0,61.32
臺東縣,台東市,豐谷里,47,1,763,10,773,1247,0,0,0,0,0,0,61.99
臺東縣,台東市,豐里里,48,1,944,11,955,1507,0,0,0,0,0,0,63.37
臺東縣,台東市,豐原里,49,1,629,12,641,956,0,0,0,0,0,0,67.05
臺東縣,台東市,富岡里,50,1,685,9,694,1087,0,0,0,0,0,0,63.85
臺東縣,台東市,富豐里,51,1,284,3,287,459,0,0,0,0,0,0,62.53
臺東縣,台東市,南榮里,52,1,662,10,672,997,0,0,0,0,0,0,67.40
臺東縣,台東市,南榮里,53,1,297,4,301,468,0,0,0,0,0,0,64.32
臺東縣,台東市,南榮里,54,1,147,0,147,230,0,0,0,0,0,0,63.91
臺東縣,台東市,岩灣里,55,1,578,7,585,1044,0,0,0,0,0,0,56.03
臺東縣,台東市,卑南里,56,1,1129,12,1141,1573,0,0,0,0,0,0,72.54
臺東縣,台東市,南王里,57,1,491,4,495,780,0,0,0,0,0,0,63.46
臺東縣,台東市,南王里,58,1,345,5,350,553,0,0,0,0,0,0,63.29
臺東縣,台東市,豐田里,59,1,596,3,599,855,0,0,0,0,0,0,70.06
臺東縣,台東市,豐田里,60,1,611,3,614,893,0,0,0,0,0,0,68.76
臺東縣,台東市,新園里,61,1,650,6,656,1012,0,0,0,0,0,0,64.82
臺東縣,台東市,建和里,62,1,508,9,517,942,0,0,0,0,0,0,54.88
臺東縣,台東市,建興里,63,1,530,4,534,839,0,0,0,0,0,0,63.65
臺東縣,台東市,建業里,64,1,544,6,550,868,0,0,0,0,0,0,63.36
臺東縣,台東市,知本里,65,1,526,9,535,855,0,0,0,0,0,0,62.57
臺東縣,台東市,建農里,66,1,711,25,736,1121,0,0,0,0,0,0,65.66
臺東縣,成功鎮,信義里,67,1,119,0,119,204,0,0,0,0,0,0,58.33
臺東縣,成功鎮,信義里,68,1,94,1,95,168,0,0,0,0,0,0,56.55
臺東縣,成功鎮,信義里,69,1,61,1,62,105,0,0,0,0,0,0,59.05
臺東縣,成功鎮,和平里,70,1,101,0,101,179,0,0,0,0,0,0,56.42
臺東縣,成功鎮,忠仁里,71,1,52,0,52,101,0,0,0,0,0,0,51.49
臺東縣,成功鎮,忠仁里,72,1,694,4,698,1038,0,0,0,0,0,0,67.24
臺東縣,成功鎮,忠仁里,73,1,869,3,872,1286,0,0,0,0,0,0,67.81
臺東縣,成功鎮,忠智里,74,1,725,4,729,1066,0,0,0,0,0,0,68.39
臺東縣,成功鎮,三民里,75,1,229,1,230,405,0,0,0,0,0,0,56.79
臺東縣,成功鎮,三民里,76,1,417,1,418,631,0,0,0,0,0,0,66.24
臺東縣,成功鎮,三仙里,77,1,112,0,112,184,0,0,0,0,0,0,60.87
臺東縣,成功鎮,三仙里,78,1,219,3,222,426,0,0,0,0,0,0,52.11
臺東縣,成功鎮,忠孝里,79,1,151,0,151,265,0,0,0,0,0,0,56.98
臺東縣,成功鎮,忠孝里,80,1,140,0,140,266,0,0,0,0,0,0,52.63
臺東縣,成功鎮,博愛里,81,1,36,0,36,66,0,0,0,0,0,0,54.55
臺東縣,成功鎮,博愛里,82,1,19,0,19,47,0,0,0,0,0,0,40.43
臺東縣,關山鎮,里壟里,83,1,565,2,567,921,0,0,0,0,0,0,61.56
臺東縣,關山鎮,里壟里,84,1,397,8,405,726,0,0,0,0,0,0,55.79
臺東縣,關山鎮,中福里,85,1,558,7,565,901,0,0,0,0,0,0,62.71
臺東縣,關山鎮,新福里,86,1,410,6,416,657,0,0,0,0,0,0,63.32
臺東縣,關山鎮,豐泉里,87,1,585,2,587,947,0,0,0,0,0,0,61.99
臺東縣,關山鎮,月眉里,88,1,407,4,411,709,0,0,0,0,0,0,57.97
臺東縣,關山鎮,德高里,89,1,293,4,297,501,0,0,0,0,0,0,59.28
臺東縣,關山鎮,德高里,90,1,482,2,484,784,0,0,0,0,0,0,61.73
臺東縣,關山鎮,電光里,91,1,118,2,120,242,0,0,0,0,0,0,49.59
臺東縣,卑南鄉,賓朗村,92,1,576,18,594,858,0,0,0,0,0,0,69.23
臺東縣,卑南鄉,賓朗村,93,1,584,6,590,867,0,0,0,0,0,0,68.05
臺東縣,卑南鄉,美農村,94,1,148,1,149,258,0,0,0,0,0,0,57.75
臺東縣,卑南鄉,美農村,95,1,279,1,280,428,0,0,0,0,0,0,65.42
臺東縣,卑南鄉,美農村,96,1,177,0,177,322,0,0,0,0,0,0,54.97
臺東縣,卑南鄉,初鹿村,97,1,382,6,388,600,0,0,0,0,0,0,64.67
臺東縣,卑南鄉,初鹿村,98,1,310,6,316,457,0,0,0,0,0,0,69.15
臺東縣,卑南鄉,明峰村,99,1,477,5,482,734,0,0,0,0,0,0,65.67
臺東縣,卑南鄉,明峰村,100,1,170,8,178,320,0,0,0,0,0,0,55.63
臺東縣,卑南鄉,嘉豐村,101,1,117,0,117,194,0,0,0,0,0,0,60.31
臺東縣,卑南鄉,嘉豐村,102,1,22,0,22,42,0,0,0,0,0,0,52.38
臺東縣,卑南鄉,太平村,103,1,796,5,801,1210,0,0,0,0,0,0,66.20
臺東縣,卑南鄉,太平村,104,1,666,6,672,977,0,0,0,0,0,0,68.78
臺東縣,卑南鄉,太平村,105,1,425,3,428,708,0,0,0,0,0,0,60.45
臺東縣,卑南鄉,泰安村,106,1,447,4,451,715,0,0,0,0,0,0,63.08
臺東縣,卑南鄉,利嘉村,107,1,248,2,250,402,0,0,0,0,0,0,62.19
臺東縣,卑南鄉,東興村,108,1,169,2,171,299,0,0,0,0,0,0,57.19
臺東縣,卑南鄉,溫泉村,109,1,552,6,558,870,0,0,0,0,0,0,64.14
臺東縣,卑南鄉,溫泉村,110,1,112,1,113,196,0,0,0,0,0,0,57.65
臺東縣,卑南鄉,富山村,111,1,283,1,284,449,0,0,0,0,0,0,63.25
臺東縣,卑南鄉,富源村,112,1,218,0,218,358,0,0,0,0,0,0,60.89
臺東縣,卑南鄉,利吉村,113,1,144,1,145,261,0,0,0,0,0,0,55.56
臺東縣,鹿野鄉,鹿野村,114,1,110,3,113,203,0,0,0,0,0,0,55.67
臺東縣,鹿野鄉,鹿野村,115,1,401,3,404,596,0,0,0,0,0,0,67.79
臺東縣,鹿野鄉,龍田村,116,1,644,3,647,1055,0,0,0,0,0,0,61.33
臺東縣,鹿野鄉,永安村,117,1,433,7,440,765,0,0,0,0,0,0,57.52
臺東縣,鹿野鄉,永安村,118,1,163,2,165,297,0,0,0,0,0,0,55.56
臺東縣,鹿野鄉,瑞隆村,119,1,474,3,477,793,0,0,0,0,0,0,60.15
臺東縣,鹿野鄉,瑞源村,120,1,388,2,390,655,0,0,0,0,0,0,59.54
臺東縣,鹿野鄉,瑞和村,121,1,243,2,245,377,0,0,0,0,0,0,64.99
臺東縣,鹿野鄉,瑞豐村,122,1,257,1,258,460,0,0,0,0,0,0,56.09
臺東縣,鹿野鄉,瑞豐村,123,1,316,1,317,565,0,0,0,0,0,0,56.11
臺東縣,池上鄉,福原村,124,1,620,5,625,949,0,0,0,0,0,0,65.86
臺東縣,池上鄉,福原村,125,1,604,2,606,922,0,0,0,0,0,0,65.73
臺東縣,池上鄉,福文村,126,1,396,3,399,635,0,0,0,0,0,0,62.83
臺東縣,池上鄉,福文村,127,1,405,13,418,734,0,0,0,0,0,0,56.95
臺東縣,池上鄉,慶豐村,128,1,420,2,422,700,0,0,0,0,0,0,60.29
臺東縣,池上鄉,大坡村,129,1,63,1,64,111,0,0,0,0,0,0,57.66
臺東縣,池上鄉,大埔村,130,1,249,4,253,399,0,0,0,0,0,0,63.41
臺東縣,池上鄉,新興村,131,1,491,9,500,842,0,0,0,0,0,0,59.38
臺東縣,池上鄉,錦園村,132,1,276,0,276,457,0,0,0,0,0,0,60.39
臺東縣,池上鄉,萬安村,133,1,240,1,241,413,0,0,0,0,0,0,58.35
臺東縣,池上鄉,富興村,134,1,224,1,225,383,0,0,0,0,0,0,58.75
臺東縣,池上鄉,振興村,135,1,96,0,96,181,0,0,0,0,0,0,53.04
臺東縣,東河鄉,都蘭村,136,1,146,3,149,285,0,0,0,0,0,0,52.28
臺東縣,東河鄉,都蘭村,137,1,246,5,251,395,0,0,0,0,0,0,63.54
臺東縣,東河鄉,都蘭村,138,1,306,3,309,556,0,0,0,0,0,0,55.58
臺東縣,東河鄉,興昌村,139,1,239,2,241,436,0,0,0,0,0,0,55.28
臺東縣,東河鄉,興昌村,140,1,143,2,145,250,0,0,0,0,0,0,58.00
臺東縣,東河鄉,隆昌村,141,1,115,0,115,215,0,0,0,0,0,0,53.49
臺東縣,東河鄉,東河村,142,1,168,2,170,325,0,0,0,0,0,0,52.31
臺東縣,東河鄉,泰源村,143,1,411,3,414,686,0,0,0,0,0,0,60.35
臺東縣,東河鄉,北源村,144,1,192,3,195,517,0,0,0,0,0,0,37.72
臺東縣,東河鄉,北源村,145,1,127,0,127,220,0,0,0,0,0,0,57.73
臺東縣,東河鄉,北源村,146,1,201,2,203,337,0,0,0,0,0,0,60.24
臺東縣,東河鄉,尚德村,147,1,68,0,68,145,0,0,0,0,0,0,46.90
臺東縣,東河鄉,尚德村,148,1,33,0,33,66,0,0,0,0,0,0,50.00
臺東縣,長濱鄉,寧埔村,149,1,55,0,55,119,0,0,0,0,0,0,46.22
臺東縣,長濱鄉,寧埔村,150,1,132,3,135,296,0,0,0,0,0,0,45.61
臺東縣,長濱鄉,竹湖村,151,1,201,1,202,418,0,0,0,0,0,0,48.33
臺東縣,長濱鄉,長濱村,152,1,663,5,668,1175,0,0,0,0,0,0,56.85
臺東縣,長濱鄉,忠勇村,153,1,257,3,260,550,0,0,0,0,0,0,47.27
臺東縣,長濱鄉,長濱村,154,1,107,0,107,226,0,0,0,0,0,0,47.35
臺東縣,長濱鄉,三間村,155,1,94,1,95,222,0,0,0,0,0,0,42.79
臺東縣,長濱鄉,三間村,156,1,70,1,71,134,0,0,0,0,0,0,52.99
臺東縣,長濱鄉,三間村,157,1,65,0,65,145,0,0,0,0,0,0,44.83
臺東縣,長濱鄉,樟原村,158,1,164,1,165,285,0,0,0,0,0,0,57.89
臺東縣,太麻里鄉,美和村,159,1,592,4,596,924,0,0,0,0,0,0,64.50
臺東縣,太麻里鄉,三和村,160,1,387,1,388,598,0,0,0,0,0,0,64.88
臺東縣,太麻里鄉,華源村,161,1,453,3,456,734,0,0,0,0,0,0,62.13
臺東縣,太麻里鄉,北里村,162,1,246,1,247,386,0,0,0,0,0,0,63.99
臺東縣,太麻里鄉,大王村,163,1,327,1,328,529,0,0,0,0,0,0,62.00
臺東縣,太麻里鄉,大王村,164,1,377,1,378,662,0,0,0,0,0,0,57.10
臺東縣,太麻里鄉,泰和村,165,1,527,5,532,780,0,0,0,0,0,0,68.21
臺東縣,太麻里鄉,泰和村,166,1,350,4,354,564,0,0,0,0,0,0,62.77
臺東縣,太麻里鄉,香蘭村,167,1,249,1,250,385,0,0,0,0,0,0,64.94
臺東縣,太麻里鄉,香蘭村,168,1,83,0,83,134,0,0,0,0,0,0,61.94
臺東縣,太麻里鄉,金崙村,169,1,125,1,126,228,0,0,0,0,0,0,55.26
臺東縣,太麻里鄉,金崙村,170,1,158,1,159,293,0,0,0,0,0,0,54.27
臺東縣,太麻里鄉,金崙村,171,1,31,4,35,75,0,0,0,0,0,0,46.67
臺東縣,太麻里鄉,多良村,172,1,5,0,5,19,0,0,0,0,0,0,26.32
臺東縣,太麻里鄉,多良村,173,1,135,3,138,236,0,0,0,0,0,0,58.47
臺東縣,大武鄉,南興村,174,1,144,2,146,292,0,0,0,0,0,0,50.00
臺東縣,大武鄉,尚武村,175,1,691,3,694,1211,0,0,0,0,0,0,57.31
臺東縣,大武鄉,大武村,176,1,549,9,558,920,0,0,0,0,0,0,60.65
臺東縣,大武鄉,大鳥村,177,1,69,1,70,152,0,0,0,0,0,0,46.05
臺東縣,大武鄉,大竹村,178,1,18,0,18,60,0,0,0,0,0,0,30.00
臺東縣,大武鄉,大竹村,179,1,20,0,20,40,0,0,0,0,0,0,50.00
臺東縣,綠島鄉,南寮村,180,1,384,2,386,665,0,0,0,0,0,0,58.05
臺東縣,綠島鄉,中寮村,181,1,402,3,405,702,0,0,0,0,0,0,57.69
臺東縣,綠島鄉,公館村,182,1,227,4,231,424,0,0,0,0,0,0,54.48
臺東縣,綠島鄉,公館村,183,1,86,2,88,121,0,0,0,0,0,0,72.73
臺東縣,海端鄉,加拿村,184,1,12,1,13,26,0,0,0,0,0,0,50.00
臺東縣,海端鄉,崁頂村,185,1,30,1,31,48,0,0,0,0,0,0,64.58
臺東縣,海端鄉,海端村,186,1,64,1,65,121,0,0,0,0,0,0,53.72
臺東縣,海端鄉,廣原村,187,1,41,2,43,88,0,0,0,0,0,0,48.86
臺東縣,海端鄉,霧鹿村,188,1,16,1,17,29,0,0,0,0,0,0,58.62
臺東縣,海端鄉,利稻村,189,1,15,1,16,29,0,0,0,0,0,0,55.17
臺東縣,延平鄉,桃源村,190,1,56,1,57,104,0,0,0,0,0,0,54.81
臺東縣,延平鄉,紅葉村,191,1,15,1,16,26,0,0,0,0,0,0,61.54
臺東縣,延平鄉,永康村,192,1,11,0,11,23,0,0,0,0,0,0,47.83
臺東縣,延平鄉,武陵村,193,1,21,0,21,41,0,0,0,0,0,0,51.22
臺東縣,延平鄉,鸞山村,194,1,14,0,14,33,0,0,0,0,0,0,42.42
臺東縣,延平鄉,鸞山村,195,1,49,0,49,78,0,0,0,0,0,0,62.82
臺東縣,金峰鄉,嘉蘭村,196,1,48,0,48,93,0,0,0,0,0,0,51.61
臺東縣,金峰鄉,正興村,197,1,27,0,27,46,0,0,0,0,0,0,58.70
臺東縣,金峰鄉,新興村,198,1,19,1,20,35,0,0,0,0,0,0,57.14
臺東縣,金峰鄉,賓茂村,199,1,8,0,8,14,0,0,0,0,0,0,57.14
臺東縣,金峰鄉,歷坵村,200,1,4,0,4,18,0,0,0,0,0,0,22.22
臺東縣,達仁鄉,安朔村,201,1,64,1,65,131,0,0,0,0,0,0,49.62
臺東縣,達仁鄉,安朔村,202,1,34,0,34,60,0,0,0,0,0,0,56.67
臺東縣,達仁鄉,南田村,203,1,27,0,27,73,0,0,0,0,0,0,36.99
臺東縣,達仁鄉,森永村,204,1,28,2,30,81,0,0,0,0,0,0,37.04
臺東縣,達仁鄉,新化村,205,1,7,0,7,19,0,0,0,0,0,0,36.84
臺東縣,達仁鄉,台板村,206,1,8,0,8,32,0,0,0,0,0,0,25.00
臺東縣,達仁鄉,土板村,207,1,8,0,8,28,0,0,0,0,0,0,28.57
臺東縣,蘭嶼鄉,椰油村,208,1,24,0,24,55,0,0,0,0,0,0,43.64
臺東縣,蘭嶼鄉,紅頭村,209,1,40,1,41,83,0,0,0,0,0,0,49.40
臺東縣,蘭嶼鄉,東清村,210,1,4,0,4,15,0,0,0,0,0,0,26.67
臺東縣,蘭嶼鄉,朗島村,211,1,6,0,6,13,0,0,0,0,0,0,46.15
花蓮縣,花蓮市,民德里,1,1,933,4,937,1485,0,0,0,0,0,0,63.10
花蓮縣,花蓮市,民勤里,2,1,764,12,776,1309,0,0,0,0,0,0,59.28
花蓮縣,花蓮市,民勤里,3,1,560,12,572,929,0,0,0,0,0,0,61.57
花蓮縣,花蓮市,民勤里,4,1,577,2,579,957,0,0,0,0,0,0,60.50
花蓮縣,花蓮市,民意里,5,1,538,4,542,994,0,0,0,0,0,0,54.53
花蓮縣,花蓮市,民意里,6,1,625,17,642,1159,0,0,0,0,0,0,55.39
花蓮縣,花蓮市,民意里,7,1,467,7,474,833,0,0,0,0,0,0,56.90
花蓮縣,花蓮市,民心里,8,1,409,9,418,706,0,0,0,0,0,0,59.21
花蓮縣,花蓮市,民享里,9,1,373,0,373,670,0,0,0,0,0,0,55.67
花蓮縣,花蓮市,民享里,10,1,545,7,552,978,0,0,0,0,0,0,56.44
花蓮縣,花蓮市,民享里,11,1,699,7,706,1214,0,0,0,0,0,0,58.15
花蓮縣,花蓮市,民運里,12,1,576,11,587,935,0,0,0,0,0,0,62.78
花蓮縣,花蓮市,民運里,13,1,476,7,483,754,0,0,0,0,0,0,64.06
花蓮縣,花蓮市,民政里,14,1,683,10,693,1181,0,0,0,0,0,0,58.68
花蓮縣,花蓮市,民政里,15,1,754,9,763,1341,0,0,0,0,0,0,56.90
花蓮縣,花蓮市,民立里,16,1,897,14,911,1450,0,0,0,0,0,0,62.83
花蓮縣,花蓮市,民樂里,17,1,234,2,236,428,0,0,0,0,0,0,55.14
花蓮縣,花蓮市,民有里,18,1,363,3,366,618,0,0,0,0,0,0,59.22
花蓮縣,花蓮市,民主里,19,1,391,4,395,635,0,0,0,0,0,0,62.20
花蓮縣,花蓮市,民治里,20,1,265,9,274,432,0,0,0,0,0,0,63.43
花蓮縣,花蓮市,民族里,21,1,340,2,342,622,0,0,0,0,0,0,54.98
花蓮縣,花蓮市,民生里,22,1,772,11,783,1318,0,0,0,0,0,0,59.41
花蓮縣,花蓮市,民權里,23,1,301,2,303,505,0,0,0,0,0,0,60.00
花蓮縣,花蓮市,主商里,24,1,492,3,495,776,0,0,0,0,0,0,63.79
花蓮縣,花蓮市,主勤里,25,1,595,4,599,1008,0,0,0,0,0,0,59.42
花蓮縣,花蓮市,主工里,26,1,407,6,413,687,0,0,0,0,0,0,60.12
花蓮縣,花蓮市,主信里,27,1,419,7,426,734,0,0,0,0,0,0,58.04
花蓮縣,花蓮市,主義里,28,1,593,7,600,995,0,0,0,0,0,0,60.30
花蓮縣,花蓮市,主計里,29,1,443,4,447,824,0,0,0,0,0,0,54.25
花蓮縣,花蓮市,主和里,30,1,731,13,744,1259,0,0,0,0,0,0,59.09
花蓮縣,花蓮市,主和里,31,1,783,6,789,1465,0,0,0,0,0,0,53.86
花蓮縣,花蓮市,主學里,32,1,441,5,446,786,0,0,0,0,0,0,56.74
花蓮縣,花蓮市,主學里,33,1,492,3,495,844,0,0,0,0,0,0,58.65
花蓮縣,花蓮市,主農里,34,1,887,12,899,1466,0,0,0,0,0,0,61.32
花蓮縣,花蓮市,主農里,35,1,591,9,600,1097,0,0,0,0,0,0,54.69
花蓮縣,花蓮市,主農里,36,1,591,9,600,1023,0,0,0,0,0,0,58.65
花蓮縣,花蓮市,主農里,37,1,673,8,681,1217,0,0,0,0,0,0,55.96
花蓮縣,花蓮市,主權里,38,1,621,7,628,1103,0,0,0,0,0,0,56.94
花蓮縣,花蓮市,主權里,39,1,658,3,661,1225,0,0,0,0,0,0,53.96
花蓮縣,花蓮市,主權里,40,1,701,6,707,1246,0,0,0,0,0,0,56.74
花蓮縣,花蓮市,主力里,41,1,685,10,695,1165,0,0,0,0,0,0,59.66
花蓮縣,花蓮市,主力里,42,1,618,5,623,1063,0,0,0,0,0,0,58.61
花蓮縣,花蓮市,國風里,43,1,907,7,914,1511,0,0,0,0,0,0,60.49
花蓮縣,花蓮市,國風里,44,1,825,10,835,1490,0,0,0,0,0,0,56.04
花蓮縣,花蓮市,國威里,45,1,900,4,904,1480,0,0,0,0,0,0,61.08
花蓮縣,花蓮市,國治里,46,1,652,3,655,1086,0,0,0,0,0,0,60.31
花蓮縣,花蓮市,國安里,47,1,265,2,267,450,0,0,0,0,0,0,59.33
花蓮縣,花蓮市,國光里,48,1,857,14,871,1411,0,0,0,0,0,0,61.73
花蓮縣,花蓮市,國防里,49,1,459,3,462,799,0,0,0,0,0,0,57.82
花蓮縣,花蓮市,國華里,50,1,679,6,685,1146,0,0,0,0,0,0,59.77
花蓮縣,花蓮市,國華里,51,1,499,4,503,868,0,0,0,0,0,0,57.95
花蓮縣,花蓮市,國魂里,52,1,544,4,548,955,0,0,0,0,0,0,57.38
花蓮縣,花蓮市,國魂里,53,1,483,2,485,803,0,0,0,0,0,0,60.40
花蓮縣,花蓮市,國聯里,54,1,836,10,846,1506,0,0,0,0,0,0,56.18
花蓮縣,花蓮市,國聯里,55,1,763,7,770,1617,0,0,0,0,0,0,47.62
花蓮縣,花蓮市,國聯里,56,1,558,4,562,1110,0,0,0,0,0,0,50.63
花蓮縣,花蓮市,國強里,57,1,487,3,490,908,0,0,0,0,0,0,53.96
花蓮縣,花蓮市,國富里,58,1,751,8,759,1250,0,0,0,0,0,0,60.72
花蓮縣,花蓮市,國富里,59,1,808,6,814,1421,0,0,0,0,0,0,57.28
花蓮縣,花蓮市,國富里,60,1,714,7,721,1344,0,0,0,0,0,0,53.65
花蓮縣,花蓮市,國裕里,61,1,476,6,482,933,0,0,0,0,0,0,51.66
花蓮縣,花蓮市,國裕里,62,1,548,5,553,944,0,0,0,0,0,0,58.58
花蓮縣,花蓮市,國裕里,63,1,526,3,529,971,0,0,0,0,0,0,54.48
花蓮縣,花蓮市,國慶里,64,1,453,8,461,812,0,0,0,0,0,0,56.77
花蓮縣,花蓮市,國慶里,65,1,519,3,522,1144,0,0,0,0,0,0,45.63
花蓮縣,花蓮市,國慶里,66,1,630,3,633,1104,0,0,0,0,0,0,57.34
花蓮縣,花蓮市,國福里,67,1,368,3,371,788,0,0,0,0,0,0,47.08
花蓮縣,新城鄉,新城村,68,1,175,1,176,365,0,0,0,0,0,0,48.22
花蓮縣,新城鄉,新城村,69,1,529,7,536,934,0,0,0,0,0,0,57.39
花蓮縣,新城鄉,順安村,70,1,303,2,305,590,0,0,0,0,0,0,51.69
花蓮縣,新城鄉,順安村,71,1,156,1,157,284,0,0,0,0,0,0,55.28
花蓮縣,新城鄉,康樂村,72,1,184,4,188,306,0,0,0,0,0,0,61.44
花蓮縣,新城鄉,康樂村,73,1,895,9,904,1634,0,0,0,0,0,0,55.32
花蓮縣,新城鄉,大漢村,74,1,603,17,620,1212,0,0,0,0,0,0,51.16
花蓮縣,新城鄉,大漢村,75,1,245,12,257,424,0,0,0,0,0,0,60.61
花蓮縣,新城鄉,北埔村,76,1,577,9,586,1099,0,0,0,0,0,0,53.32
花蓮縣,新城鄉,北埔村,77,1,620,7,627,1172,0,0,0,0,0,0,53.50
花蓮縣,新城鄉,佳林村,78,1,279,4,283,536,0,0,0,0,0,0,52.80
花蓮縣,新城鄉,嘉里村,79,1,748,14,762,1320,0,0,0,0,0,0,57.73
花蓮縣,新城鄉,嘉里村,80,1,729,14,743,1238,0,0,0,0,0,0,60.02
花蓮縣,新城鄉,嘉新村,81,1,422,7,429,623,0,0,0,0,0,0,68.86
花蓮縣,新城鄉,嘉新村,82,1,225,8,233,393,0,0,0,0,0,0,59.29
花蓮縣,秀林鄉,和平村,83,1,91,0,91,274,0,0,0,0,0,0,33.21
花蓮縣,秀林鄉,和平村,84,1,50,0,50,129,0,0,0,0,0,0,38.76
花蓮縣,秀林鄉,崇德村,85,1,200,1,201,349,0,0,0,0,0,0,57.59
花蓮縣,秀林鄉,富世村,86,1,114,1,115,237,0,0,0,0,0,0,48.52
花蓮縣,秀林鄉,富世村,87,1,90,1,91,229,0,0,0,0,0,0,39.74
花蓮縣,秀林鄉,秀林村,88,1,58,0,58,139,0,0,0,0,0,0,41.73
花蓮縣,秀林鄉,景美村,89,1,30,4,34,60,0,0,0,0,0,0,56.67
花蓮縣,秀林鄉,景美村,90,1,38,1,39,87,0,0,0,0,0,0,44.83
花蓮縣,秀林鄉,佳民村,91,1,73,3,76,138,0,0,0,0,0,0,55.07
花蓮縣,秀林鄉,水源村,92,1,63,0,63,113,0,0,0,0,0,0,55.75
花蓮縣,秀林鄉,銅門村,93,1,64,0,64,117,0,0,0,0,0,0,54.70
花蓮縣,秀林鄉,文蘭村,94,1,32,1,33,77,0,0,0,0,0,0,42.86
花蓮縣,秀林鄉,文蘭村,95,1,6,0,6,12,0,0,0,0,0,0,50.00
花蓮縣,吉安鄉,永安村,96,1,750,10,760,1336,0,0,0,0,0,0,56.89
花蓮縣,吉安鄉,永安村,97,1,775,8,783,1501,0,0,0,0,0,0,52.17
花蓮縣,吉安鄉,太昌村,98,1,782,7,789,1419,0,0,0,0,0,0,55.60
花蓮縣,吉安鄉,太昌村,99,1,494,8,502,876,0,0,0,0,0,0,57.31
花蓮縣,吉安鄉,慶豐村,100,1,701,4,705,1254,0,0,0,0,0,0,56.22
花蓮縣,吉安鄉,慶豐村,101,1,762,12,774,1299,0,0,0,0,0,0,59.58
花蓮縣,吉安鄉,慶豐村,102,1,658,11,669,1206,0,0,0,0,0,0,55.47
花蓮縣,吉安鄉,吉安村,103,1,605,6,611,1127,0,0,0,0,0,0,54.21
花蓮縣,吉安鄉,吉安村,104,1,862,13,875,1532,0,0,0,0,0,0,57.11
花蓮縣,吉安鄉,福興村,105,1,440,7,447,775,0,0,0,0,0,0,57.68
花蓮縣,吉安鄉,福興村,106,1,630,9,639,1057,0,0,0,0,0,0,60.45
花蓮縣,吉安鄉,南華村,107,1,668,19,687,1128,0,0,0,0,0,0,60.90
花蓮縣,吉安鄉,干城村,108,1,506,11,517,907,0,0,0,0,0,0,57.00
花蓮縣,吉安鄉,永興村,109,1,828,7,835,1420,0,0,0,0,0,0,58.80
花蓮縣,吉安鄉,稻香村,110,1,723,5,728,1299,0,0,0,0,0,0,56.04
花蓮縣,吉安鄉,稻香村,111,1,510,4,514,913,0,0,0,0,0,0,56.30
花蓮縣,吉安鄉,南昌村,112,1,372,3,375,722,0,0,0,0,0,0,51.94
花蓮縣,吉安鄉,南昌村,113,1,592,5,597,1112,0,0,0,0,0,0,53.69
花蓮縣,吉安鄉,宜昌村,114,1,694,13,707,1271,0,0,0,0,0,0,55.63
花蓮縣,吉安鄉,宜昌村,115,1,682,7,689,1234,0,0,0,0,0,0,55.83
花蓮縣,吉安鄉,北昌村,116,1,737,9,746,1359,0,0,0,0,0,0,54.89
花蓮縣,吉安鄉,北昌村,117,1,819,6,825,1319,0,0,0,0,0,0,62.55
花蓮縣,吉安鄉,北昌村,118,1,763,5,768,1267,0,0,0,0,0,0,60.62
花蓮縣,吉安鄉,北昌村,119,1,754,4,758,1283,0,0,0,0,0,0,59.08
花蓮縣,吉安鄉,勝安村,120,1,740,9,749,1348,0,0,0,0,0,0,55.56
花蓮縣,吉安鄉,勝安村,121,1,904,13,917,1592,0,0,0,0,0,0,57.60
花蓮縣,吉安鄉,仁里村,122,1,503,1,504,817,0,0,0,0,0,0,61.69
花蓮縣,吉安鄉,仁里村,123,1,722,8,730,1281,0,0,0,0,0,0,56.99
花蓮縣,吉安鄉,仁里村,124,1,553,2,555,975,0,0,0,0,0,0,56.92
花蓮縣,吉安鄉,仁里村,125,1,631,4,635,1116,0,0,0,0,0,0,56.90
花蓮縣,吉安鄉,東昌村,126,1,529,5,534,935,0,0,0,0,0,0,57.11
花蓮縣,吉安鄉,東昌村,127,1,572,7,579,1077,0,0,0,0,0,0,53.76
花蓮縣,吉安鄉,東昌村,128,1,369,10,379,744,0,0,0,0,0,0,50.94
花蓮縣,吉安鄉,仁安村,129,1,670,13,683,1354,0,0,0,0,0,0,50.44
花蓮縣,吉安鄉,仁和村,130,1,638,6,644,1145,0,0,0,0,0,0,56.24
花蓮縣,吉安鄉,仁和村,131,1,542,6,548,973,0,0,0,0,0,0,56.32
花蓮縣,吉安鄉,仁和村,132,1,503,18,521,947,0,0,0,0,0,0,55.02
花蓮縣,吉安鄉,光華村,133,1,469,11,480,855,0,0,0,0,0,0,56.14
花蓮縣,壽豐鄉,溪口村,134,1,410,5,415,718,0,0,0,0,0,0,57.80
花蓮縣,壽豐鄉,樹湖村,135,1,171,3,174,323,0,0,0,0,0,0,53.87
花蓮縣,壽豐鄉,豐山村,136,1,1018,11,1029,1834,0,0,0,0,0,0,56.11
花蓮縣,壽豐鄉,豐裡村,137,1,658,13,671,1207,0,0,0,0,0,0,55.59
花蓮縣,壽豐鄉,豐坪村,138,1,391,4,395,655,0,0,0,0,0,0,60.31
花蓮縣,壽豐鄉,壽豐村,139,1,605,7,612,1062,0,0,0,0,0,0,57.63
花蓮縣,壽豐鄉,共和村,140,1,305,4,309,561,0,0,0,0,0,0,55.08
花蓮縣,壽豐鄉,光榮村,141,1,79,4,83,149,0,0,0,0,0,0,55.70
花蓮縣,壽豐鄉,池南村,142,1,307,5,312,561,0,0,0,0,0,0,55.61
花蓮縣,壽豐鄉,平和村,143,1,455,3,458,747,0,0,0,0,0,0,61.31
花蓮縣,壽豐鄉,平和村,144,1,162,3,165,288,0,0,0,0,0,0,57.29
花蓮縣,壽豐鄉,志學村,145,1,928,10,938,1734,0,0,0,0,0,0,54.09
花蓮縣,壽豐鄉,志學村,146,1,212,5,217,379,0,0,0,0,0,0,57.26
花蓮縣,壽豐鄉,米棧村,147,1,53,2,55,88,0,0,0,0,0,0,62.50
花蓮縣,壽豐鄉,米棧村,148,1,23,0,23,44,0,0,0,0,0,0,52.27
花蓮縣,壽豐鄉,月眉村,149,1,125,3,128,269,0,0,0,0,0,0,47.58
花蓮縣,壽豐鄉,鹽寮村,150,1,194,4,198,384,0,0,0,0,0,0,51.56
花蓮縣,壽豐鄉,水璉村,151,1,173,4,177,417,0,0,0,0,0,0,42.45
花蓮縣,壽豐鄉,水璉村,152,1,34,0,34,57,0,0,0,0,0,0,59.65
花蓮縣,鳳林鎮,鳳仁里,153,1,690,5,695,1124,0,0,0,0,0,0,61.83
花蓮縣,鳳林鎮,鳳義里,154,1,408,1,409,683,0,0,0,0,0,0,59.88
花蓮縣,鳳林鎮,鳳禮里,155,1,456,5,461,734,0,0,0,0,0,0,62.81
花蓮縣,鳳林鎮,鳳智里,156,1,740,8,748,1206,0,0,0,0,0,0,62.02
花蓮縣,鳳林鎮,鳳信里,157,1,400,3,403,681,0,0,0,0,0,0,59.18
花蓮縣,鳳林鎮,鳳信里,158,1,142,1,143,222,0,0,0,0,0,0,64.41
花蓮縣,鳳林鎮,山興里,159,1,91,2,93,184,0,0,0,0,0,0,50.54
花蓮縣,鳳林鎮,山興里,160,1,43,0,43,81,0,0,0,0,0,0,53.09
花蓮縣,鳳林鎮,大榮里,161,1,324,6,330,668,0,0,0,0,0,0,49.40
花蓮縣,鳳林鎮,大榮里,162,1,314,11,325,610,0,0,0,0,0,0,53.28
花蓮縣,鳳林鎮,北林里,163,1,366,12,378,647,0,0,0,0,0,0,58.42
花蓮縣,鳳林鎮,南平里,164,1,387,3,390,719,0,0,0,0,0,0,54.24
花蓮縣,鳳林鎮,林榮里,165,1,549,8,557,868,0,0,0,0,0,0,64.17
花蓮縣,鳳林鎮,長橋里,166,1,586,9,595,1087,0,0,0,0,0,0,54.74
花蓮縣,鳳林鎮,森榮里,167,1,89,1,90,165,0,0,0,0,0,0,54.55
花蓮縣,光復鄉,大華村,168,1,532,5,537,931,0,0,0,0,0,0,57.68
花蓮縣,光復鄉,大安村,169,1,593,4,597,952,0,0,0,0,0,0,62.71
花蓮縣,光復鄉,大馬村,170,1,209,2,211,436,0,0,0,0,0,0,48.39
花蓮縣,光復鄉,大平村,171,1,144,3,147,315,0,0,0,0,0,0,46.67
花蓮縣,光復鄉,大同村,172,1,414,2,416,729,0,0,0,0,0,0,57.06
花蓮縣,光復鄉,東富村,173,1,43,0,43,92,0,0,0,0,0,0,46.74
花蓮縣,光復鄉,東富村,174,1,50,5,55,138,0,0,0,0,0,0,39.86
花蓮縣,光復鄉,西富村,175,1,71,1,72,128,0,0,0,0,0,0,56.25
花蓮縣,光復鄉,南富村,176,1,54,0,54,120,0,0,0,0,0,0,45.00
花蓮縣,光復鄉,北富村,177,1,83,2,85,219,0,0,0,0,0,0,38.81
花蓮縣,光復鄉,西富村,178,1,118,2,120,230,0,0,0,0,0,0,52.17
花蓮縣,光復鄉,大進村,179,1,345,4,349,515,0,0,0,0,0,0,67.77
花蓮縣,光復鄉,大全村,180,1,300,3,303,541,0,0,0,0,0,0,56.01
花蓮縣,光復鄉,大全村,181,1,80,2,82,137,0,0,0,0,0,0,59.85
花蓮縣,光復鄉,大興村,182,1,193,2,195,380,0,0,0,0,0,0,51.32
花蓮縣,光復鄉,大富村,183,1,212,4,216,388,0,0,0,0,0,0,55.67
花蓮縣,光復鄉,大豐村,184,1,348,4,352,606,0,0,0,0,0,0,58.09
花蓮縣,豐濱鄉,靜浦村,185,1,44,0,44,138,0,0,0,0,0,0,31.88
花蓮縣,豐濱鄉,港口村,186,1,64,1,65,165,0,0,0,0,0,0,39.39
花蓮縣,豐濱鄉,豐濱村,187,1,36,0,36,74,0,0,0,0,0,0,48.65
花蓮縣,豐濱鄉,豐濱村,188,1,314,5,319,590,0,0,0,0,0,0,54.07
花蓮縣,豐濱鄉,豐濱村,189,1,42,0,42,88,0,0,0,0,0,0,47.73
花蓮縣,豐濱鄉,新社村,190,1,58,0,58,126,0,0,0,0,0,0,46.03
花蓮縣,豐濱鄉,磯崎村,191,1,55,0,55,103,0,0,0,0,0,0,53.40
花蓮縣,萬榮鄉,西林村,192,1,30,1,31,67,0,0,0,0,0,0,46.27
花蓮縣,萬榮鄉,見晴村,193,1,13,0,13,29,0,0,0,0,0,0,44.83
花蓮縣,萬榮鄉,萬榮村,194,1,27,0,27,63,0,0,0,0,0,0,42.86
花蓮縣,萬榮鄉,明利村,195,1,25,0,25,63,0,0,0,0,0,0,39.68
花蓮縣,萬榮鄉,馬遠村,196,1,5,0,5,13,0,0,0,0,0,0,38.46
花蓮縣,萬榮鄉,馬遠村,197,1,9,0,9,25,0,0,0,0,0,0,36.00
花蓮縣,萬榮鄉,紅葉村,198,1,47,0,47,120,0,0,0,0,0,0,39.17
花蓮縣,瑞穗鄉,瑞穗村,199,1,458,5,463,794,0,0,0,0,0,0,58.31
花蓮縣,瑞穗鄉,瑞穗村,200,1,584,5,589,1054,0,0,0,0,0,0,55.88
花蓮縣,瑞穗鄉,瑞美村,201,1,436,7,443,792,0,0,0,0,0,0,55.93
花蓮縣,瑞穗鄉,瑞美村,202,1,456,4,460,857,0,0,0,0,0,0,53.68
花蓮縣,瑞穗鄉,瑞良村,203,1,243,3,246,419,0,0,0,0,0,0,58.71
花蓮縣,瑞穗鄉,瑞祥村,204,1,451,4,455,850,0,0,0,0,0,0,53.53
花蓮縣,瑞穗鄉,瑞北村,205,1,231,2,233,437,0,0,0,0,0,0,53.32
花蓮縣,瑞穗鄉,舞鶴村,206,1,267,3,270,518,0,0,0,0,0,0,52.12
花蓮縣,瑞穗鄉,鶴岡村,207,1,146,2,148,335,0,0,0,0,0,0,44.18
花蓮縣,瑞穗鄉,奇美村,208,1,24,0,24,53,0,0,0,0,0,0,45.28
花蓮縣,瑞穗鄉,富源村,209,1,379,1,380,670,0,0,0,0,0,0,56.72
花蓮縣,瑞穗鄉,富民村,210,1,133,4,137,323,0,0,0,0,0,0,42.41
花蓮縣,瑞穗鄉,富興村,211,1,268,3,271,492,0,0,0,0,0,0,55.08
花蓮縣,玉里鎮,中城里,212,1,845,9,854,1575,0,0,0,0,0,0,54.22
花蓮縣,玉里鎮,中城里,213,1,781,5,786,1416,0,0,0,0,0,0,55.51
花蓮縣,玉里鎮,中城里,214,1,627,6,633,1090,0,0,0,0,0,0,58.07
花蓮縣,玉里鎮,國武里,215,1,780,8,788,1385,0,0,0,0,0,0,56.90
花蓮縣,玉里鎮,啟模里,216,1,455,3,458,848,0,0,0,0,0,0,54.01
花蓮縣,玉里鎮,啟模里,217,1,487,4,491,914,0,0,0,0,0,0,53.72
花蓮縣,玉里鎮,泰昌里,218,1,661,13,674,1136,0,0,0,0,0,0,59.33
花蓮縣,玉里鎮,泰昌里,219,1,667,65,732,1251,0,0,0,0,0,0,58.51
花蓮縣,玉里鎮,泰昌里,220,1,319,42,361,967,0,0,0,0,0,0,37.33
花蓮縣,玉里鎮,永昌里,221,1,560,13,573,1065,0,0,0,0,0,0,53.80
花蓮縣,玉里鎮,源城里,222,1,553,10,563,1106,0,0,0,0,0,0,50.90
花蓮縣,玉里鎮,長良里,223,1,351,15,366,691,0,0,0,0,0,0,52.97
花蓮縣,玉里鎮,樂合里,224,1,156,2,158,399,0,0,0,0,0,0,39.60
花蓮縣,玉里鎮,東豐里,225,1,178,5,183,352,0,0,0,0,0,0,51.99
花蓮縣,玉里鎮,觀音里,226,1,326,7,333,722,0,0,0,0,0,0,46.12
花蓮縣,玉里鎮,觀音里,227,1,167,4,171,347,0,0,0,0,0,0,49.28
花蓮縣,玉里鎮,松浦里,228,1,271,8,279,577,0,0,0,0,0,0,48.35
花蓮縣,玉里鎮,春日里,229,1,249,5,254,525,0,0,0,0,0,0,48.38
花蓮縣,玉里鎮,德武里,230,1,38,1,39,85,0,0,0,0,0,0,45.88
花蓮縣,玉里鎮,三民里,231,1,531,13,544,1016,0,0,0,0,0,0,53.54
花蓮縣,玉里鎮,大禹里,232,1,540,11,551,1100,0,0,0,0,0,0,50.09
花蓮縣,富里鄉,吳江村,233,1,242,0,242,470,0,0,0,0,0,0,51.49
花蓮縣,富里鄉,東里村,234,1,582,11,593,1265,0,0,0,0,0,0,46.88
花蓮縣,富里鄉,萬寧村,235,1,269,2,271,544,0,0,0,0,0,0,49.82
花蓮縣,富里鄉,新興村,236,1,292,9,301,643,0,0,0,0,0,0,46.81
花蓮縣,富里鄉,竹田村,237,1,574,5,579,1077,0,0,0,0,0,0,53.76
花蓮縣,富里鄉,羅山村,238,1,232,2,234,468,0,0,0,0,0,0,50.00
花蓮縣,富里鄉,石牌村,239,1,464,4,468,888,0,0,0,0,0,0,52.70
花蓮縣,富里鄉,明里村,240,1,238,2,240,403,0,0,0,0,0,0,59.55
花蓮縣,富里鄉,富里村,241,1,875,7,882,1663,0,0,0,0,0,0,53.04
花蓮縣,富里鄉,永豐村,242,1,267,2,269,549,0,0,0,0,0,0,49.00
花蓮縣,富里鄉,豐南村,243,1,178,1,179,376,0,0,0,0,0,0,47.61
花蓮縣,富里鄉,富南村,244,1,275,2,277,535,0,0,0,0,0,0,51.78
花蓮縣,富里鄉,學田村,245,1,313,3,316,580,0,0,0,0,0,0,54.48
花蓮縣,卓溪鄉,崙山村,246,1,11,0,11,31,0,0,0,0,0,0,35.48
花蓮縣,卓溪鄉,立山村,247,1,7,0,7,18,0,0,0,0,0,0,38.89
花蓮縣,卓溪鄉,立山村,248,1,13,0,13,28,0,0,0,0,0,0,46.43
花蓮縣,卓溪鄉,太平村,249,1,7,0,7,13,0,0,0,0,0,0,53.85
花蓮縣,卓溪鄉,太平村,250,1,9,0,9,18,0,0,0,0,0,0,50.00
花蓮縣,卓溪鄉,卓溪村,251,1,38,3,41,78,0,0,0,0,0,0,52.56
花蓮縣,卓溪鄉,卓清村,252,1,35,3,38,71,0,0,0,0,0,0,53.52
花蓮縣,卓溪鄉,卓清村,253,1,19,1,20,32,0,0,0,0,0,0,62.50
花蓮縣,卓溪鄉,古風村,254,1,18,0,18,44,0,0,0,0,0,0,40.91
花蓮縣,卓溪鄉,古風村,255,1,12,1,13,32,0,0,0,0,0,0,40.63
花蓮縣,卓溪鄉,古風村,256,1,11,0,11,21,0,0,0,0,0,0,52.38
澎湖縣,馬公市,新復里,1,1,266,4,270,393,0,0,0,0,0,0,68.70
澎湖縣,馬公市,復興里,2,1,210,2,212,315,0,0,0,0,0,0,67.30
澎湖縣,馬公市,長安里,3,1,341,5,346,560,0,0,0,0,0,0,61.79
澎湖縣,馬公市,中央里,4,1,291,4,295,507,0,0,0,0,0,0,58.19
澎湖縣,馬公市,啟明里,5,1,513,3,516,879,0,0,0,0,0,0,58.70
澎湖縣,馬公市,重慶里,6,1,570,4,574,1016,0,0,0,0,0,0,56.50
澎湖縣,馬公市,中興里,7,1,427,7,434,720,0,0,0,0,0,0,60.28
澎湖縣,馬公市,光復里,8,1,520,6,526,891,0,0,0,0,0,0,59.03
澎湖縣,馬公市,光復里,9,1,513,6,519,831,0,0,0,0,0,0,62.45
澎湖縣,馬公市,光明里,10,1,322,10,332,584,0,0,0,0,0,0,56.85
澎湖縣,馬公市,光明里,11,1,386,4,390,617,0,0,0,0,0,0,63.21
澎湖縣,馬公市,光榮里,12,1,696,8,704,1154,0,0,0,0,0,0,61.01
澎湖縣,馬公市,光榮里,13,1,668,10,678,1132,0,0,0,0,0,0,59.89
澎湖縣,馬公市,朝陽里,14,1,736,4,740,1250,0,0,0,0,0,0,59.20
澎湖縣,馬公市,朝陽里,15,1,778,9,787,1382,0,0,0,0,0,0,56.95
澎湖縣,馬公市,朝陽里,16,1,787,10,797,1443,0,0,0,0,0,0,55.23
澎湖縣,馬公市,陽明里,17,1,642,7,649,1123,0,0,0,0,0,0,57.79
澎湖縣,馬公市,陽明里,18,1,575,6,581,1086,0,0,0,0,0,0,53.50
澎湖縣,馬公市,重光里,19,1,550,8,558,950,0,0,0,0,0,0,58.74
澎湖縣,馬公市,西衛里,20,1,658,15,673,1140,0,0,0,0,0,0,59.04
澎湖縣,馬公市,西衛里,21,1,680,7,687,1158,0,0,0,0,0,0,59.33
澎湖縣,馬公市,西文里,22,1,590,5,595,994,0,0,0,0,0,0,59.86
澎湖縣,馬公市,西文里,23,1,480,3,483,827,0,0,0,0,0,0,58.40
澎湖縣,馬公市,東文里,24,1,550,6,556,870,0,0,0,0,0,0,63.91
澎湖縣,馬公市,東文里,25,1,418,6,424,756,0,0,0,0,0,0,56.08
澎湖縣,馬公市,案山里,26,1,761,16,777,1204,0,0,0,0,0,0,64.53
澎湖縣,馬公市,光華里,27,1,303,5,308,475,0,0,0,0,0,0,64.84
澎湖縣,馬公市,前寮里,28,1,330,7,337,495,0,0,0,0,0,0,68.08
澎湖縣,馬公市,石泉里,29,1,698,15,713,1135,0,0,0,0,0,0,62.82
澎湖縣,馬公市,菜園里,30,1,235,1,236,324,0,0,0,0,0,0,72.84
澎湖縣,馬公市,東衛里,31,1,716,14,730,1169,0,0,0,0,0,0,62.45
澎湖縣,馬公市,安宅里,32,1,273,1,274,412,0,0,0,0,0,0,66.50
澎湖縣,馬公市,興仁里,33,1,317,4,321,500,0,0,0,0,0,0,64.20
澎湖縣,馬公市,烏崁里,34,1,455,10,465,781,0,0,0,0,0,0,59.54
澎湖縣,馬公市,鐵線里,35,1,214,3,217,338,0,0,0,0,0,0,64.20
澎湖縣,馬公市,鎖港里,36,1,493,10,503,951,0,0,0,0,0,0,52.89
澎湖縣,馬公市,鎖港里,37,1,521,2,523,953,0,0,0,0,0,0,54.88
澎湖縣,馬公市,山水里,38,1,698,4,702,1287,0,0,0,0,0,0,54.55
澎湖縣,馬公市,五德里,39,1,98,3,101,164,0,0,0,0,0,0,61.59
澎湖縣,馬公市,井垵里,40,1,198,2,200,333,0,0,0,0,0,0,60.06
澎湖縣,馬公市,時裡里,41,1,654,6,660,972,0,0,0,0,0,0,67.90
澎湖縣,馬公市,風櫃里,42,1,681,7,688,1078,0,0,0,0,0,0,63.82
澎湖縣,馬公市,虎井里,43,1,182,2,184,533,0,0,0,0,0,0,34.52
澎湖縣,馬公市,桶盤里,44,1,61,0,61,192,0,0,0,0,0,0,31.77
澎湖縣,湖西鄉,湖西村,45,1,525,5,530,815,0,0,0,0,0,0,65.03
澎湖縣,湖西鄉,湖東村,46,1,166,1,167,273,0,0,0,0,0,0,61.17
澎湖縣,湖西鄉,青螺村,47,1,112,1,113,189,0,0,0,0,0,0,59.79
澎湖縣,湖西鄉,白坑村,48,1,142,4,146,235,0,0,0,0,0,0,62.13
澎湖縣,湖西鄉,南寮村,49,1,325,8,333,592,0,0,0,0,0,0,56.25
澎湖縣,湖西鄉,北寮村,50,1,174,4,178,258,0,0,0,0,0,0,68.99
澎湖縣,湖西鄉,紅羅村,51,1,307,5,312,535,0,0,0,0,0,0,58.32
澎湖縣,湖西鄉,西溪村,52,1,248,2,250,421,0,0,0,0,0,0,59.38
澎湖縣,湖西鄉,成功村,53,1,233,1,234,382,0,0,0,0,0,0,61.26
澎湖縣,湖西鄉,東石村,54,1,51,0,51,102,0,0,0,0,0,0,50.00
澎湖縣,湖西鄉,沙港村,55,1,431,3,434,703,0,0,0,0,0,0,61.74
澎湖縣,湖西鄉,中西村,56,1,98,2,100,161,0,0,0,0,0,0,62.11
澎湖縣,湖西鄉,鼎灣村,57,1,175,6,181,295,0,0,0,0,0,0,61.36
澎湖縣,湖西鄉,潭邊村,58,1,143,1,144,215,0,0,0,0,0,0,66.98
澎湖縣,湖西鄉,許家村,59,1,94,6,100,177,0,0,0,0,0,0,56.50
澎湖縣,湖西鄉,城北村,60,1,124,2,126,174,0,0,0,0,0,0,72.41
澎湖縣,湖西鄉,太武村,61,1,50,1,51,80,0,0,0,0,0,0,63.75
澎湖縣,湖西鄉,隘門村,62,1,392,4,396,598,0,0,0,0,0,0,66.22
澎湖縣,湖西鄉,林投村,63,1,460,9,469,811,0,0,0,0,0,0,57.83
澎湖縣,湖西鄉,尖山村,64,1,292,5,297,500,0,0,0,0,0,0,59.40
澎湖縣,湖西鄉,龍門村,65,1,422,5,427,734,0,0,0,0,0,0,58.17
澎湖縣,湖西鄉,龍門村,66,1,448,7,455,759,0,0,0,0,0,0,59.95
澎湖縣,湖西鄉,果葉村,67,1,346,2,348,598,0,0,0,0,0,0,58.19
澎湖縣,白沙鄉,中屯村,68,1,256,2,258,401,0,0,0,0,0,0,64.34
澎湖縣,白沙鄉,講美村,69,1,298,1,299,495,0,0,0,0,0,0,60.40
澎湖縣,白沙鄉,城前村,70,1,56,1,57,85,0,0,0,0,0,0,67.06
澎湖縣,白沙鄉,鎮海村,71,1,64,1,65,101,0,0,0,0,0,0,64.36
澎湖縣,白沙鄉,港子村,72,1,150,3,153,252,0,0,0,0,0,0,60.71
澎湖縣,白沙鄉,岐頭村,73,1,104,1,105,197,0,0,0,0,0,0,53.30
澎湖縣,白沙鄉,小赤村,74,1,104,3,107,166,0,0,0,0,0,0,64.46
澎湖縣,白沙鄉,赤崁村,75,1,771,14,785,1265,0,0,0,0,0,0,62.06
澎湖縣,白沙鄉,瓦硐村,76,1,164,3,167,261,0,0,0,0,0,0,63.98
澎湖縣,白沙鄉,後寮村,77,1,358,7,365,637,0,0,0,0,0,0,57.30
澎湖縣,白沙鄉,通梁村,78,1,404,3,407,677,0,0,0,0,0,0,60.12
澎湖縣,白沙鄉,吉貝村,79,1,408,1,409,1109,0,0,0,0,0,0,36.88
澎湖縣,白沙鄉,鳥嶼村,80,1,292,6,298,848,0,0,0,0,0,0,35.14
澎湖縣,白沙鄉,員貝村,81,1,82,0,82,205,0,0,0,0,0,0,40.00
澎湖縣,白沙鄉,大倉村,82,1,75,1,76,148,0,0,0,0,0,0,51.35
澎湖縣,西嶼鄉,橫礁村,83,1,111,3,114,233,0,0,0,0,0,0,48.93
澎湖縣,西嶼鄉,合界村,84,1,205,1,206,410,0,0,0,0,0,0,50.24
澎湖縣,西嶼鄉,竹灣村,85,1,351,7,358,735,0,0,0,0,0,0,48.71
澎湖縣,西嶼鄉,小門村,86,1,124,2,126,241,0,0,0,0,0,0,52.28
澎湖縣,西嶼鄉,大池村,87,1,286,7,293,575,0,0,0,0,0,0,50.96
澎湖縣,西嶼鄉,二崁村,88,1,55,0,55,108,0,0,0,0,0,0,50.93
澎湖縣,西嶼鄉,池東村,89,1,257,10,267,479,0,0,0,0,0,0,55.74
澎湖縣,西嶼鄉,池西村,90,1,114,1,115,202,0,0,0,0,0,0,56.93
澎湖縣,西嶼鄉,赤馬村,91,1,277,4,281,583,0,0,0,0,0,0,48.20
澎湖縣,西嶼鄉,內垵村,92,1,543,14,557,1159,0,0,0,0,0,0,48.06
澎湖縣,西嶼鄉,外垵村,93,1,359,4,363,771,0,0,0,0,0,0,47.08
澎湖縣,西嶼鄉,外垵村,94,1,489,2,491,935,0,0,0,0,0,0,52.51
澎湖縣,望安鄉,東安村,95,1,170,2,172,394,0,0,0,0,0,0,43.65
澎湖縣,望安鄉,西安村,96,1,152,3,155,303,0,0,0,0,0,0,51.16
澎湖縣,望安鄉,中社村,97,1,62,2,64,209,0,0,0,0,0,0,30.62
澎湖縣,望安鄉,水垵村,98,1,100,3,103,265,0,0,0,0,0,0,38.87
澎湖縣,望安鄉,將軍村,99,1,161,3,164,550,0,0,0,0,0,0,29.82
澎湖縣,望安鄉,將軍村,100,1,199,1,200,557,0,0,0,0,0,0,35.91
澎湖縣,望安鄉,東吉村,101,1,20,0,20,320,0,0,0,0,0,0,6.25
澎湖縣,望安鄉,東坪村,102,1,30,0,30,227,0,0,0,0,0,0,13.22
澎湖縣,望安鄉,西坪村,103,1,26,0,26,116,0,0,0,0,0,0,22.41
澎湖縣,望安鄉,花嶼村,104,1,104,0,104,217,0,0,0,0,0,0,47.93
澎湖縣,七美鄉,東湖村,105,1,110,4,114,225,0,0,0,0,0,0,50.67
澎湖縣,七美鄉,西湖村,106,1,153,5,158,388,0,0,0,0,0,0,40.72
澎湖縣,七美鄉,中和村,107,1,167,2,169,376,0,0,0,0,0,0,44.95
澎湖縣,七美鄉,平和村,108,1,101,0,101,216,0,0,0,0,0,0,46.76
澎湖縣,七美鄉,海豐村,109,1,100,1,101,240,0,0,0,0,0,0,42.08
澎湖縣,七美鄉,南港村,110,1,365,8,373,742,0,0,0,0,0,0,50.27
基隆市,中正區,長潭里,1,1,413,3,416,629,0,0,0,0,0,0,66.14
基隆市,中正區,砂子里,2,1,711,12,723,1314,0,0,0,0,0,0,55.02
基隆市,中正區,砂子里,3,1,308,8,316,612,0,0,0,0,0,0,51.63
基隆市,中正區,八斗里,4,1,967,8,975,1593,0,0,0,0,0,0,61.21
基隆市,中正區,碧砂里,5,1,741,5,746,1367,0,0,0,0,0,0,54.57
基隆市,中正區,新豐里,6,1,735,9,744,1767,0,0,0,0,0,0,42.11
基隆市,中正區,新豐里,7,1,897,7,904,2297,0,0,0,0,0,0,39.36
基隆市,中正區,平寮里,8,1,893,14,907,1588,0,0,0,0,0,0,57.12
基隆市,中正區,社寮里,9,1,542,8,550,981,0,0,0,0,0,0,56.07
基隆市,中正區,社寮里,10,1,540,5,545,1014,0,0,0,0,0,0,53.75
基隆市,中正區,和憲里,11,1,563,6,569,1004,0,0,0,0,0,0,56.67
基隆市,中正區,海濱里,12,1,516,5,521,1030,0,0,0,0,0,0,50.58
基隆市,中正區,正濱里,13,1,687,11,698,1342,0,0,0,0,0,0,52.01
基隆市,中正區,中正里,14,1,558,4,562,966,0,0,0,0,0,0,58.18
基隆市,中正區,中正里,15,1,535,5,540,1030,0,0,0,0,0,0,52.43
基隆市,中正區,中濱里,16,1,771,4,775,1477,0,0,0,0,0,0,52.47
基隆市,中正區,建國里,17,1,556,7,563,989,0,0,0,0,0,0,56.93
基隆市,中正區,建國里,18,1,657,9,666,1167,0,0,0,0,0,0,57.07
基隆市,中正區,砂灣里,19,1,524,9,533,1080,0,0,0,0,0,0,49.35
基隆市,中正區,砂灣里,20,1,521,5,526,1011,0,0,0,0,0,0,52.03
基隆市,中正區,真砂里,21,1,798,7,805,1474,0,0,0,0,0,0,54.61
基隆市,中正區,正砂里,22,1,564,14,578,1005,0,0,0,0,0,0,57.51
基隆市,中正區,正砂里,23,1,707,12,719,1417,0,0,0,0,0,0,50.74
基隆市,中正區,中砂里,24,1,816,3,819,1425,0,0,0,0,0,0,57.47
基隆市,中正區,入船里,25,1,723,5,728,1388,0,0,0,0,0,0,52.45
基隆市,中正區,正船里,26,1,887,7,894,1559,0,0,0,0,0,0,57.34
基隆市,中正區,中船里,27,1,699,9,708,1425,0,0,0,0,0,0,49.68
基隆市,中正區,港通里,28,1,696,8,704,1273,0,0,0,0,0,0,55.30
基隆市,中正區,義重里,29,1,616,7,623,1216,0,0,0,0,0,0,51.23
基隆市,中正區,信義里,30,1,582,8,590,1106,0,0,0,0,0,0,53.35
基隆市,中正區,正義里,31,1,822,13,835,1512,0,0,0,0,0,0,55.22
基隆市,中正區,德義里,32,1,482,3,485,834,0,0,0,0,0,0,58.15
基隆市,信義區,仁壽里,33,1,699,11,710,1202,0,0,0,0,0,0,59.07
基隆市,信義區,仁義里,34,1,742,7,749,1237,0,0,0,0,0,0,60.55
基隆市,信義區,義昭里,35,1,636,4,640,1071,0,0,0,0,0,0,59.76
基隆市,信義區,義幸里,36,1,737,9,746,1221,0,0,0,0,0,0,61.10
基隆市,信義區,義幸里,37,1,704,5,709,1214,0,0,0,0,0,0,58.40
基隆市,信義區,義民里,38,1,508,5,513,855,0,0,0,0,0,0,60.00
基隆市,信義區,義和里,39,1,813,7,820,1357,0,0,0,0,0,0,60.43
基隆市,信義區,智慧里,40,1,440,7,447,725,0,0,0,0,0,0,61.66
基隆市,信義區,智誠里,41,1,377,9,386,714,0,0,0,0,0,0,54.06
基隆市,信義區,智誠里,42,1,579,6,585,1080,0,0,0,0,0,0,54.17
基隆市,信義區,禮儀里,43,1,849,7,856,1511,0,0,0,0,0,0,56.65
基隆市,信義區,禮東里,44,1,972,4,976,1641,0,0,0,0,0,0,59.48
基隆市,信義區,信綠里,45,1,825,11,836,1357,0,0,0,0,0,0,61.61
基隆市,信義區,信綠里,46,1,556,3,559,1023,0,0,0,0,0,0,54.64
基隆市,信義區,東信里,47,1,507,2,509,932,0,0,0,0,0,0,54.61
基隆市,信義區,東信里,48,1,885,12,897,1642,0,0,0,0,0,0,54.63
基隆市,信義區,東光里,49,1,988,10,998,1863,0,0,0,0,0,0,53.57
基隆市,信義區,東明里,50,1,810,8,818,1521,0,0,0,0,0,0,53.78
基隆市,信義區,東明里,51,1,950,6,956,1791,0,0,0,0,0,0,53.38
基隆市,信義區,東安里,52,1,801,15,816,1451,0,0,0,0,0,0,56.24
基隆市,信義區,東安里,53,1,744,11,755,1274,0,0,0,0,0,0,59.26
基隆市,信義區,孝賢里,54,1,1221,8,1229,2306,0,0,0,0,0,0,53.30
基隆市,信義區,孝深里,55,1,880,11,891,1498,0,0,0,0,0,0,59.48
基隆市,信義區,孝深里,56,1,1122,14,1136,2435,0,0,0,0,0,0,46.65
基隆市,信義區,孝岡里,57,1,520,3,523,857,0,0,0,0,0,0,61.03
基隆市,仁愛區,林泉里,58,1,410,3,413,807,0,0,0,0,0,0,51.18
基隆市,仁愛區,林泉里,59,1,564,1,565,1035,0,0,0,0,0,0,54.59
基隆市,仁愛區,花崗里,60,1,578,7,585,990,0,0,0,0,0,0,59.09
基隆市,仁愛區,虹橋里,61,1,894,13,907,1569,0,0,0,0,0,0,57.81
基隆市,仁愛區,水錦里,62,1,1024,14,1038,1794,0,0,0,0,0,0,57.86
基隆市,仁愛區,智仁里,63,1,658,8,666,1155,0,0,0,0,0,0,57.66
基隆市,仁愛區,智仁里,64,1,622,5,627,1125,0,0,0,0,0,0,55.73
基隆市,仁愛區,和明里,65,1,600,6,606,1118,0,0,0,0,0,0,54.20
基隆市,仁愛區,忠勇里,66,1,554,8,562,1082,0,0,0,0,0,0,51.94
基隆市,仁愛區,玉田里,67,1,657,5,662,1160,0,0,0,0,0,0,57.07
基隆市,仁愛區,仁德里,68,1,608,6,614,1052,0,0,0,0,0,0,58.37
基隆市,仁愛區,博愛里,69,1,638,7,645,1207,0,0,0,0,0,0,53.44
基隆市,仁愛區,博愛里,70,1,302,5,307,527,0,0,0,0,0,0,58.25
基隆市,仁愛區,福仁里,71,1,460,5,465,902,0,0,0,0,0,0,51.55
基隆市,仁愛區,誠仁里,72,1,540,7,547,1074,0,0,0,0,0,0,50.93
基隆市,仁愛區,吉仁里,73,1,795,9,804,1571,0,0,0,0,0,0,51.18
基隆市,仁愛區,吉仁里,74,1,725,12,737,1473,0,0,0,0,0,0,50.03
基隆市,仁愛區,育仁里,75,1,439,6,445,920,0,0,0,0,0,0,48.37
基隆市,仁愛區,英仁里,76,1,411,6,417,805,0,0,0,0,0,0,51.80
基隆市,仁愛區,英仁里,77,1,375,6,381,780,0,0,0,0,0,0,48.85
基隆市,仁愛區,龍門里,78,1,444,9,453,937,0,0,0,0,0,0,48.35
基隆市,仁愛區,德厚里,79,1,669,7,676,1346,0,0,0,0,0,0,50.22
基隆市,仁愛區,曲水里,80,1,497,8,505,982,0,0,0,0,0,0,51.43
基隆市,仁愛區,崇文里,81,1,515,6,521,948,0,0,0,0,0,0,54.96
基隆市,仁愛區,文安里,82,1,612,5,617,1170,0,0,0,0,0,0,52.74
基隆市,仁愛區,兆連里,83,1,346,1,347,685,0,0,0,0,0,0,50.66
基隆市,仁愛區,獅球里,84,1,624,13,637,1243,0,0,0,0,0,0,51.25
基隆市,仁愛區,書院里,85,1,693,7,700,1165,0,0,0,0,0,0,60.09
基隆市,仁愛區,朝棟里,86,1,897,9,906,1437,0,0,0,0,0,0,63.05
基隆市,仁愛區,朝棟里,87,1,691,5,696,1271,0,0,0,0,0,0,54.76
基隆市,仁愛區,光華里,88,1,623,7,630,1192,0,0,0,0,0,0,52.85
基隆市,仁愛區,光華里,89,1,605,10,615,1123,0,0,0,0,0,0,54.76
基隆市,仁愛區,明德里,90,1,434,2,436,752,0,0,0,0,0,0,57.98
基隆市,仁愛區,同風里,91,1,389,8,397,699,0,0,0,0,0,0,56.80
基隆市,仁愛區,文昌里,92,1,499,4,503,883,0,0,0,0,0,0,56.96
基隆市,仁愛區,新店里,93,1,452,2,454,808,0,0,0,0,0,0,56.19
基隆市,中山區,新建里,94,1,498,13,511,828,0,0,0,0,0,0,61.71
基隆市,中山區,安民里,95,1,639,6,645,1135,0,0,0,0,0,0,56.83
基隆市,中山區,安平里,96,1,588,10,598,988,0,0,0,0,0,0,60.53
基隆市,中山區,中山里,97,1,664,13,677,1153,0,0,0,0,0,0,58.72
基隆市,中山區,民治里,98,1,603,11,614,1062,0,0,0,0,0,0,57.82
基隆市,中山區,中興里,99,1,856,10,866,1455,0,0,0,0,0,0,59.52
基隆市,中山區,仁正里,100,1,506,5,511,875,0,0,0,0,0,0,58.40
基隆市,中山區,健民里,101,1,958,16,974,1663,0,0,0,0,0,0,58.57
基隆市,中山區,通化里,102,1,698,8,706,1321,0,0,0,0,0,0,53.44
基隆市,中山區,居仁里,103,1,356,4,360,670,0,0,0,0,0,0,53.73
基隆市,中山區,居仁里,104,1,499,5,504,952,0,0,0,0,0,0,52.94
基隆市,中山區,通明里,105,1,458,8,466,756,0,0,0,0,0,0,61.64
基隆市,中山區,通明里,106,1,786,8,794,1329,0,0,0,0,0,0,59.74
基隆市,中山區,和平里,107,1,467,7,474,816,0,0,0,0,0,0,58.09
基隆市,中山區,仙洞里,108,1,444,3,447,838,0,0,0,0,0,0,53.34
基隆市,中山區,太白里,109,1,631,13,644,1029,0,0,0,0,0,0,62.59
基隆市,中山區,協和里,110,1,352,10,362,652,0,0,0,0,0,0,55.52
基隆市,中山區,協和里,111,1,569,10,579,1002,0,0,0,0,0,0,57.78
基隆市,中山區,文化里,112,1,601,6,607,1114,0,0,0,0,0,0,54.49
基隆市,中山區,德安里,113,1,688,10,698,1120,0,0,0,0,0,0,62.32
基隆市,中山區,德安里,114,1,931,12,943,1767,0,0,0,0,0,0,53.37
基隆市,中山區,德和里,115,1,1149,18,1167,2064,0,0,0,0,0,0,56.54
基隆市,中山區,德和里,116,1,951,8,959,1535,0,0,0,0,0,0,62.48
基隆市,中山區,中和里,117,1,710,8,718,1380,0,0,0,0,0,0,52.03
基隆市,中山區,中和里,118,1,751,10,761,1602,0,0,0,0,0,0,47.50
基隆市,中山區,中和里,119,1,1331,17,1348,2813,0,0,0,0,0,0,47.92
基隆市,中山區,西康里,120,1,547,7,554,1002,0,0,0,0,0,0,55.29
基隆市,中山區,西康里,121,1,422,3,425,812,0,0,0,0,0,0,52.34
基隆市,中山區,西定里,122,1,567,2,569,1027,0,0,0,0,0,0,55.40
基隆市,中山區,西華里,123,1,596,7,603,1036,0,0,0,0,0,0,58.20
基隆市,中山區,西榮里,124,1,509,11,520,910,0,0,0,0,0,0,57.14
基隆市,安樂區,新西里,125,1,869,8,877,1594,0,0,0,0,0,0,55.02
基隆市,安樂區,西川里,126,1,795,16,811,1456,0,0,0,0,0,0,55.70
基隆市,安樂區,定國里,127,1,600,12,612,1251,0,0,0,0,0,0,48.92
基隆市,安樂區,定邦里,128,1,713,16,729,1368,0,0,0,0,0,0,53.29
基隆市,安樂區,干城里,129,1,830,4,834,1585,0,0,0,0,0,0,52.62
基隆市,安樂區,干城里,130,1,461,13,474,844,0,0,0,0,0,0,56.16
基隆市,安樂區,永康里,131,1,685,6,691,1542,0,0,0,0,0,0,44.81
基隆市,安樂區,永康里,132,1,228,10,238,483,0,0,0,0,0,0,49.28
基隆市,安樂區,慈仁里,133,1,505,9,514,1083,0,0,0,0,0,0,47.46
基隆市,安樂區,安和里,134,1,464,5,469,898,0,0,0,0,0,0,52.23
基隆市,安樂區,樂一里,135,1,450,3,453,763,0,0,0,0,0,0,59.37
基隆市,安樂區,嘉仁里,136,1,962,10,972,1854,0,0,0,0,0,0,52.43
基隆市,安樂區,嘉仁里,137,1,713,15,728,1387,0,0,0,0,0,0,52.49
基隆市,安樂區,鶯歌里,138,1,1118,15,1133,2275,0,0,0,0,0,0,49.80
基隆市,安樂區,鶯歌里,139,1,710,7,717,1361,0,0,0,0,0,0,52.68
基隆市,安樂區,七賢里,140,1,782,2,784,1484,0,0,0,0,0,0,52.83
基隆市,安樂區,七賢里,141,1,667,5,672,1328,0,0,0,0,0,0,50.60
基隆市,安樂區,三民里,142,1,851,10,861,1623,0,0,0,0,0,0,53.05
基隆市,安樂區,三民里,143,1,793,10,803,1600,0,0,0,0,0,0,50.19
基隆市,安樂區,三民里,144,1,282,3,285,582,0,0,0,0,0,0,48.97
基隆市,安樂區,四維里,145,1,1079,11,1090,1909,0,0,0,0,0,0,57.10
基隆市,安樂區,四維里,146,1,590,1,591,1226,0,0,0,0,0,0,48.21
基隆市,安樂區,五福里,147,1,1025,12,1037,1851,0,0,0,0,0,0,56.02
基隆市,安樂區,五福里,148,1,772,10,782,1460,0,0,0,0,0,0,53.56
基隆市,安樂區,長樂里,149,1,930,6,936,1794,0,0,0,0,0,0,52.17
基隆市,安樂區,六合里,150,1,902,9,911,1644,0,0,0,0,0,0,55.41
基隆市,安樂區,六合里,151,1,922,8,930,1708,0,0,0,0,0,0,54.45
基隆市,安樂區,外寮里,152,1,1172,15,1187,2347,0,0,0,0,0,0,50.58
基隆市,安樂區,外寮里,153,1,696,5,701,1557,0,0,0,0,0,0,45.02
基隆市,安樂區,外寮里,154,1,556,4,560,1171,0,0,0,0,0,0,47.82
基隆市,安樂區,新崙里,155,1,829,7,836,1714,0,0,0,0,0,0,48.77
基隆市,安樂區,新崙里,156,1,459,7,466,1006,0,0,0,0,0,0,46.32
基隆市,安樂區,武崙里,157,1,1022,8,1030,2185,0,0,0,0,0,0,47.14
基隆市,安樂區,中崙里,158,1,596,5,601,1152,0,0,0,0,0,0,52.17
基隆市,安樂區,內寮里,159,1,673,5,678,1590,0,0,0,0,0,0,42.64
基隆市,安樂區,內寮里,160,1,679,8,687,1495,0,0,0,0,0,0,45.95
基隆市,暖暖區,八西里,161,1,644,12,656,1236,0,0,0,0,0,0,53.07
基隆市,暖暖區,八中里,162,1,390,5,395,686,0,0,0,0,0,0,57.58
基隆市,暖暖區,八堵里,163,1,414,3,417,809,0,0,0,0,0,0,51.55
基隆市,暖暖區,八南里,164,1,291,3,294,608,0,0,0,0,0,0,48.36
基隆市,暖暖區,過港里,165,1,773,14,787,1683,0,0,0,0,0,0,46.76
基隆市,暖暖區,過港里,166,1,794,5,799,1500,0,0,0,0,0,0,53.27
基隆市,暖暖區,暖暖里,167,1,511,7,518,1079,0,0,0,0,0,0,48.01
基隆市,暖暖區,暖暖里,168,1,467,2,469,953,0,0,0,0,0,0,49.21
基隆市,暖暖區,暖同里,169,1,450,6,456,813,0,0,0,0,0,0,56.09
基隆市,暖暖區,暖同里,170,1,600,3,603,1134,0,0,0,0,0,0,53.17
基隆市,暖暖區,暖東里,171,1,200,4,204,389,0,0,0,0,0,0,52.44
基隆市,暖暖區,暖西里,172,1,891,12,903,1839,0,0,0,0,0,0,49.10
基隆市,暖暖區,暖西里,173,1,721,7,728,1524,0,0,0,0,0,0,47.77
基隆市,暖暖區,碇內里,174,1,461,3,464,863,0,0,0,0,0,0,53.77
基隆市,暖暖區,碇內里,175,1,577,7,584,1234,0,0,0,0,0,0,47.33
基隆市,暖暖區,碇和里,176,1,553,7,560,830,0,0,0,0,0,0,67.47
基隆市,暖暖區,碇和里,177,1,578,4,582,1334,0,0,0,0,0,0,43.63
基隆市,暖暖區,碇祥里,178,1,1076,16,1092,2667,0,0,0,0,0,0,40.94
基隆市,暖暖區,碇安里,179,1,937,16,953,1935,0,0,0,0,0,0,49.25
基隆市,暖暖區,碇安里,180,1,742,5,747,1342,0,0,0,0,0,0,55.66
基隆市,七堵區,長興里,181,1,804,10,814,1580,0,0,0,0,0,0,51.52
基隆市,七堵區,長興里,182,1,501,7,508,1157,0,0,0,0,0,0,43.91
基隆市,七堵區,長興里,183,1,523,8,531,1020,0,0,0,0,0,0,52.06
基隆市,七堵區,正光里,184,1,665,8,673,1141,0,0,0,0,0,0,58.98
基隆市,七堵區,正光里,185,1,429,5,434,776,0,0,0,0,0,0,55.93
基隆市,七堵區,正明里,186,1,693,8,701,1331,0,0,0,0,0,0,52.67
基隆市,七堵區,正明里,187,1,409,5,414,736,0,0,0,0,0,0,56.25
基隆市,七堵區,富民里,188,1,951,5,956,1772,0,0,0,0,0,0,53.95
基隆市,七堵區,富民里,189,1,1014,9,1023,1798,0,0,0,0,0,0,56.90
基隆市,七堵區,永平里,190,1,565,12,577,1022,0,0,0,0,0,0,56.46
基隆市,七堵區,永平里,191,1,599,1,600,1117,0,0,0,0,0,0,53.72
基隆市,七堵區,永安里,192,1,651,8,659,1245,0,0,0,0,0,0,52.93
基隆市,七堵區,永安里,193,1,439,4,443,796,0,0,0,0,0,0,55.65
基隆市,七堵區,八德里,194,1,139,1,140,282,0,0,0,0,0,0,49.65
基隆市,七堵區,八德里,195,1,682,2,684,1190,0,0,0,0,0,0,57.48
基隆市,七堵區,自強里,196,1,472,7,479,931,0,0,0,0,0,0,51.45
基隆市,七堵區,泰安里,197,1,390,5,395,775,0,0,0,0,0,0,50.97
基隆市,七堵區,泰安里,198,1,545,12,557,1294,0,0,0,0,0,0,43.04
基隆市,七堵區,泰安里,199,1,493,7,500,873,0,0,0,0,0,0,57.27
基隆市,七堵區,六堵里,200,1,614,8,622,1317,0,0,0,0,0,0,47.23
基隆市,七堵區,堵南里,201,1,590,5,595,1238,0,0,0,0,0,0,48.06
基隆市,七堵區,堵南里,202,1,665,12,677,1520,0,0,0,0,0,0,44.54
基隆市,七堵區,堵北里,203,1,614,8,622,1283,0,0,0,0,0,0,48.48
基隆市,七堵區,堵北里,204,1,694,9,703,1339,0,0,0,0,0,0,52.50
基隆市,七堵區,百福里,205,1,535,9,544,1140,0,0,0,0,0,0,47.72
基隆市,七堵區,百福里,206,1,698,9,707,1401,0,0,0,0,0,0,50.46
基隆市,七堵區,百福里,207,1,558,6,564,1292,0,0,0,0,0,0,43.65
基隆市,七堵區,實踐里,208,1,580,8,588,1147,0,0,0,0,0,0,51.26
基隆市,七堵區,實踐里,209,1,397,2,399,875,0,0,0,0,0,0,45.60
基隆市,七堵區,實踐里,210,1,538,11,549,1117,0,0,0,0,0,0,49.15
基隆市,七堵區,瑪南里,211,1,214,1,215,436,0,0,0,0,0,0,49.31
基隆市,七堵區,瑪東里,212,1,151,2,153,330,0,0,0,0,0,0,46.36
基隆市,七堵區,瑪西里,213,1,193,6,199,378,0,0,0,0,0,0,52.65
基隆市,七堵區,友一里,214,1,416,3,419,895,0,0,0,0,0,0,46.82
基隆市,七堵區,友二里,215,1,241,1,242,448,0,0,0,0,0,0,54.02
新竹市,東區,育賢里,1,1,322,6,328,667,0,0,0,0,0,0,49.18
新竹市,東區,親仁里,2,1,485,4,489,943,0,0,0,0,0,0,51.86
新竹市,東區,親仁里,3,1,434,13,447,915,0,0,0,0,0,0,48.85
新竹市,東區,東門里,4,1,419,13,432,838,0,0,0,0,0,0,51.55
新竹市,東區,成功里,5,1,401,11,412,806,0,0,0,0,0,0,51.12
新竹市,東區,榮光里,6,1,252,10,262,514,0,0,0,0,0,0,50.97
新竹市,東區,中正里,7,1,280,4,284,592,0,0,0,0,0,0,47.97
新竹市,東區,錦華里,8,1,589,11,600,1090,0,0,0,0,0,0,55.05
新竹市,東區,錦華里,9,1,443,6,449,786,0,0,0,0,0,0,57.12
新竹市,東區,文華里,10,1,533,9,542,1022,0,0,0,0,0,0,53.03
新竹市,東區,文華里,11,1,506,6,512,898,0,0,0,0,0,0,57.02
新竹市,東區,文華里,12,1,565,13,578,1135,0,0,0,0,0,0,50.93
新竹市,東區,復中里,13,1,807,18,825,1637,0,0,0,0,0,0,50.40
新竹市,東區,復中里,14,1,866,17,883,1742,0,0,0,0,0,0,50.69
新竹市,東區,復興里,15,1,681,11,692,1464,0,0,0,0,0,0,47.27
新竹市,東區,復興里,16,1,692,16,708,1395,0,0,0,0,0,0,50.75
新竹市,東區,三民里,17,1,618,12,630,1178,0,0,0,0,0,0,53.48
新竹市,東區,三民里,18,1,890,20,910,1716,0,0,0,0,0,0,53.03
新竹市,東區,三民里,19,1,578,8,586,1162,0,0,0,0,0,0,50.43
新竹市,東區,東園里,20,1,410,6,416,842,0,0,0,0,0,0,49.41
新竹市,東區,東園里,21,1,709,16,725,1289,0,0,0,0,0,0,56.25
新竹市,東區,公園里,22,1,454,12,466,970,0,0,0,0,0,0,48.04
新竹市,東區,公園里,23,1,500,12,512,972,0,0,0,0,0,0,52.67
新竹市,東區,建華里,24,1,591,16,607,1173,0,0,0,0,0,0,51.75
新竹市,東區,建華里,25,1,434,10,444,902,0,0,0,0,0,0,49.22
新竹市,東區,東山里,26,1,424,17,441,905,0,0,0,0,0,0,48.73
新竹市,東區,東山里,27,1,516,7,523,989,0,0,0,0,0,0,52.88
新竹市,東區,東山里,28,1,505,7,512,978,0,0,0,0,0,0,52.35
新竹市,東區,綠水里,29,1,664,16,680,1240,0,0,0,0,0,0,54.84
新竹市,東區,綠水里,30,1,646,14,660,1308,0,0,0,0,0,0,50.46
新竹市,東區,綠水里,31,1,749,10,759,1408,0,0,0,0,0,0,53.91
新竹市,東區,光復里,32,1,432,11,443,917,0,0,0,0,0,0,48.31
新竹市,東區,光復里,33,1,442,8,450,844,0,0,0,0,0,0,53.32
新竹市,東區,東勢里,34,1,508,13,521,1030,0,0,0,0,0,0,50.58
新竹市,東區,前溪里,35,1,691,13,704,1381,0,0,0,0,0,0,50.98
新竹市,東區,前溪里,36,1,478,13,491,852,0,0,0,0,0,0,57.63
新竹市,東區,水源里,37,1,630,54,684,1414,0,0,0,0,0,0,48.37
新竹市,東區,水源里,38,1,715,28,743,1485,0,0,0,0,0,0,50.03
新竹市,東區,千甲里,39,1,847,42,889,1497,0,0,0,0,0,0,59.39
新竹市,東區,豐功里,40,1,835,26,861,1531,0,0,0,0,0,0,56.24
新竹市,東區,豐功里,41,1,610,11,621,1159,0,0,0,0,0,0,53.58
新竹市,東區,偉功里,42,1,445,10,455,737,0,0,0,0,0,0,61.74
新竹市,東區,武功里,43,1,213,2,215,409,0,0,0,0,0,0,52.57
新竹市,東區,軍功里,44,1,840,15,855,1338,0,0,0,0,0,0,63.90
新竹市,東區,軍功里,45,1,877,16,893,1585,0,0,0,0,0,0,56.34
新竹市,東區,立功里,46,1,477,11,488,757,0,0,0,0,0,0,64.46
新竹市,東區,建功里,47,1,797,20,817,1288,0,0,0,0,0,0,63.43
新竹市,東區,建功里,48,1,501,8,509,784,0,0,0,0,0,0,64.92
新竹市,東區,建功里,49,1,538,11,549,805,0,0,0,0,0,0,68.20
新竹市,東區,光明里,50,1,664,12,676,1253,0,0,0,0,0,0,53.95
新竹市,東區,光明里,51,1,281,3,284,513,0,0,0,0,0,0,55.36
新竹市,東區,光明里,52,1,599,4,603,1118,0,0,0,0,0,0,53.94
新竹市,東區,龍山里,53,1,439,8,447,846,0,0,0,0,0,0,52.84
新竹市,東區,龍山里,54,1,401,8,409,785,0,0,0,0,0,0,52.10
新竹市,東區,龍山里,55,1,549,15,564,957,0,0,0,0,0,0,58.93
新竹市,東區,科園里,56,1,841,12,853,1540,0,0,0,0,0,0,55.39
新竹市,東區,科園里,57,1,852,17,869,1595,0,0,0,0,0,0,54.48
新竹市,東區,科園里,58,1,754,11,765,1326,0,0,0,0,0,0,57.69
新竹市,東區,埔頂里,59,1,493,21,514,1015,0,0,0,0,0,0,50.64
新竹市,東區,埔頂里,60,1,507,10,517,1050,0,0,0,0,0,0,49.24
新竹市,東區,新莊里,61,1,654,13,667,1313,0,0,0,0,0,0,50.80
新竹市,東區,新莊里,62,1,623,10,633,1272,0,0,0,0,0,0,49.76
新竹市,東區,新莊里,63,1,556,7,563,1088,0,0,0,0,0,0,51.75
新竹市,東區,關東里,64,1,532,17,549,1065,0,0,0,0,0,0,51.55
新竹市,東區,關東里,65,1,616,20,636,1216,0,0,0,0,0,0,52.30
新竹市,東區,關東里,66,1,676,20,696,1304,0,0,0,0,0,0,53.37
新竹市,東區,金山里,67,1,383,7,390,780,0,0,0,0,0,0,50.00
新竹市,東區,金山里,68,1,434,11,445,697,0,0,0,0,0,0,63.85
新竹市,東區,金山里,69,1,471,9,480,798,0,0,0,0,0,0,60.15
新竹市,東區,仙水里,70,1,603,12,615,1193,0,0,0,0,0,0,51.55
新竹市,東區,仙水里,71,1,746,11,757,1423,0,0,0,0,0,0,53.20
新竹市,東區,仙宮里,72,1,371,7,378,709,0,0,0,0,0,0,53.31
新竹市,東區,關帝里,73,1,296,8,304,632,0,0,0,0,0,0,48.10
新竹市,東區,南門里,74,1,370,9,379,684,0,0,0,0,0,0,55.41
新竹市,東區,南市里,75,1,481,21,502,914,0,0,0,0,0,0,54.92
新竹市,東區,福德里,76,1,651,16,667,1221,0,0,0,0,0,0,54.63
新竹市,東區,振興里,77,1,565,11,576,1204,0,0,0,0,0,0,47.84
新竹市,東區,振興里,78,1,689,12,701,1523,0,0,0,0,0,0,46.03
新竹市,東區,振興里,79,1,558,14,572,1362,0,0,0,0,0,0,42.00
新竹市,東區,新興里,80,1,503,13,516,930,0,0,0,0,0,0,55.48
新竹市,東區,新興里,81,1,535,16,551,1060,0,0,0,0,0,0,51.98
新竹市,東區,新興里,82,1,485,5,490,961,0,0,0,0,0,0,50.99
新竹市,東區,寺前里,83,1,410,12,422,829,0,0,0,0,0,0,50.90
新竹市,東區,竹蓮里,84,1,446,16,462,880,0,0,0,0,0,0,52.50
新竹市,東區,下竹里,85,1,645,16,661,1199,0,0,0,0,0,0,55.13
新竹市,東區,頂竹里,86,1,469,10,479,1012,0,0,0,0,0,0,47.33
新竹市,東區,頂竹里,87,1,495,9,504,971,0,0,0,0,0,0,51.91
新竹市,東區,頂竹里,88,1,504,10,514,1055,0,0,0,0,0,0,48.72
新竹市,東區,南大里,89,1,307,10,317,725,0,0,0,0,0,0,43.72
新竹市,東區,南大里,90,1,446,11,457,892,0,0,0,0,0,0,51.23
新竹市,東區,新光里,91,1,330,8,338,582,0,0,0,0,0,0,58.08
新竹市,東區,新光里,92,1,697,31,728,1403,0,0,0,0,0,0,51.89
新竹市,東區,新光里,93,1,552,13,565,1090,0,0,0,0,0,0,51.83
新竹市,東區,光鎮里,94,1,620,19,639,1350,0,0,0,0,0,0,47.33
新竹市,東區,光鎮里,95,1,703,9,712,1376,0,0,0,0,0,0,51.74
新竹市,東區,高峰里,96,1,740,20,760,1470,0,0,0,0,0,0,51.70
新竹市,東區,高峰里,97,1,547,21,568,1155,0,0,0,0,0,0,49.18
新竹市,東區,高峰里,98,1,653,16,669,1328,0,0,0,0,0,0,50.38
新竹市,東區,湖濱里,99,1,673,12,685,1301,0,0,0,0,0,0,52.65
新竹市,東區,湖濱里,100,1,535,15,550,1011,0,0,0,0,0,0,54.40
新竹市,東區,柴橋里,101,1,593,12,605,1224,0,0,0,0,0,0,49.43
新竹市,東區,柴橋里,102,1,577,9,586,1293,0,0,0,0,0,0,45.32
新竹市,東區,明湖里,103,1,398,5,403,921,0,0,0,0,0,0,43.76
新竹市,東區,明湖里,104,1,467,6,473,1104,0,0,0,0,0,0,42.84
新竹市,北區,西門里,105,1,267,9,276,541,0,0,0,0,0,0,51.02
新竹市,北區,仁德里,106,1,385,10,395,778,0,0,0,0,0,0,50.77
新竹市,北區,中央里,107,1,295,7,302,567,0,0,0,0,0,0,53.26
新竹市,北區,石坊里,108,1,271,5,276,552,0,0,0,0,0,0,50.00
新竹市,北區,潛園里,109,1,447,13,460,835,0,0,0,0,0,0,55.09
新竹市,北區,崇禮里,110,1,612,24,636,1147,0,0,0,0,0,0,55.45
新竹市,北區,興南里,111,1,635,23,658,1287,0,0,0,0,0,0,51.13
新竹市,北區,育英里,112,1,441,14,455,840,0,0,0,0,0,0,54.17
新竹市,北區,育英里,113,1,590,11,601,1254,0,0,0,0,0,0,47.93
新竹市,北區,育英里,114,1,749,15,764,1487,0,0,0,0,0,0,51.38
新竹市,北區,台溪里,115,1,477,5,482,1018,0,0,0,0,0,0,47.35
新竹市,北區,曲溪里,116,1,474,8,482,803,0,0,0,0,0,0,60.02
新竹市,北區,曲溪里,117,1,661,27,688,1334,0,0,0,0,0,0,51.57
新竹市,北區,曲溪里,118,1,702,23,725,1163,0,0,0,0,0,0,62.34
新竹市,北區,曲溪里,119,1,588,6,594,1271,0,0,0,0,0,0,46.73
新竹市,北區,西雅里,120,1,575,20,595,1163,0,0,0,0,0,0,51.16
新竹市,北區,西雅里,121,1,666,25,691,1230,0,0,0,0,0,0,56.18
新竹市,北區,客雅里,122,1,529,18,547,905,0,0,0,0,0,0,60.44
新竹市,北區,客雅里,123,1,569,17,586,991,0,0,0,0,0,0,59.13
新竹市,北區,客雅里,124,1,546,16,562,1181,0,0,0,0,0,0,47.59
新竹市,北區,南勢里,125,1,494,19,513,897,0,0,0,0,0,0,57.19
新竹市,北區,南勢里,126,1,652,15,667,1264,0,0,0,0,0,0,52.77
新竹市,北區,南勢里,127,1,477,20,497,923,0,0,0,0,0,0,53.85
新竹市,北區,大鵬里,128,1,541,12,553,811,0,0,0,0,0,0,68.19
新竹市,北區,大鵬里,129,1,472,13,485,699,0,0,0,0,0,0,69.38
新竹市,北區,大同里,130,1,452,10,462,816,0,0,0,0,0,0,56.62
新竹市,北區,中山里,131,1,333,14,347,658,0,0,0,0,0,0,52.74
新竹市,北區,中興里,132,1,279,11,290,618,0,0,0,0,0,0,46.93
新竹市,北區,新民里,133,1,693,17,710,1293,0,0,0,0,0,0,54.91
新竹市,北區,長和里,134,1,600,12,612,1125,0,0,0,0,0,0,54.40
新竹市,北區,北門里,135,1,482,12,494,946,0,0,0,0,0,0,52.22
新竹市,北區,民富里,136,1,565,21,586,1186,0,0,0,0,0,0,49.41
新竹市,北區,民富里,137,1,665,18,683,1360,0,0,0,0,0,0,50.22
新竹市,北區,民富里,138,1,595,15,610,1272,0,0,0,0,0,0,47.96
新竹市,北區,磐石里,139,1,620,14,634,1171,0,0,0,0,0,0,54.14
新竹市,北區,磐石里,140,1,537,13,550,1102,0,0,0,0,0,0,49.91
新竹市,北區,磐石里,141,1,540,22,562,1073,0,0,0,0,0,0,52.38
新竹市,北區,新雅里,142,1,727,14,741,1441,0,0,0,0,0,0,51.42
新竹市,北區,新雅里,143,1,616,15,631,1224,0,0,0,0,0,0,51.55
新竹市,北區,新雅里,144,1,426,17,443,839,0,0,0,0,0,0,52.80
新竹市,北區,文雅里,145,1,747,17,764,1395,0,0,0,0,0,0,54.77
新竹市,北區,文雅里,146,1,816,23,839,1553,0,0,0,0,0,0,54.02
新竹市,北區,水田里,147,1,608,10,618,1188,0,0,0,0,0,0,52.02
新竹市,北區,水田里,148,1,559,9,568,1140,0,0,0,0,0,0,49.82
新竹市,北區,光田里,149,1,477,15,492,978,0,0,0,0,0,0,50.31
新竹市,北區,光田里,150,1,575,12,587,1044,0,0,0,0,0,0,56.23
新竹市,北區,光華里,151,1,455,11,466,1141,0,0,0,0,0,0,40.84
新竹市,北區,光華里,152,1,616,12,628,1339,0,0,0,0,0,0,46.90
新竹市,北區,金華里,153,1,652,11,663,1533,0,0,0,0,0,0,43.25
新竹市,北區,金華里,154,1,827,13,840,1569,0,0,0,0,0,0,53.54
新竹市,北區,湳雅里,155,1,473,15,488,917,0,0,0,0,0,0,53.22
新竹市,北區,湳雅里,156,1,550,10,560,1157,0,0,0,0,0,0,48.40
新竹市,北區,金雅里,157,1,601,20,621,1149,0,0,0,0,0,0,54.05
新竹市,北區,湳中里,158,1,839,13,852,1633,0,0,0,0,0,0,52.17
新竹市,北區,舊社里,159,1,640,18,658,1329,0,0,0,0,0,0,49.51
新竹市,北區,舊社里,160,1,403,9,412,902,0,0,0,0,0,0,45.68
新竹市,北區,舊社里,161,1,680,18,698,1326,0,0,0,0,0,0,52.64
新竹市,北區,金竹里,162,1,804,17,821,1670,0,0,0,0,0,0,49.16
新竹市,北區,金竹里,163,1,867,18,885,1735,0,0,0,0,0,0,51.01
新竹市,北區,武陵里,164,1,741,14,755,1222,0,0,0,0,0,0,61.78
新竹市,北區,福林里,165,1,602,20,622,1105,0,0,0,0,0,0,56.29
新竹市,北區,福林里,166,1,747,17,764,1448,0,0,0,0,0,0,52.76
新竹市,北區,境福里,167,1,858,19,877,1812,0,0,0,0,0,0,48.40
新竹市,北區,境福里,168,1,717,16,733,1383,0,0,0,0,0,0,53.00
新竹市,北區,士林里,169,1,648,15,663,1200,0,0,0,0,0,0,55.25
新竹市,北區,士林里,170,1,522,6,528,831,0,0,0,0,0,0,63.54
新竹市,北區,士林里,171,1,529,12,541,903,0,0,0,0,0,0,59.91
新竹市,北區,古賢里,172,1,394,11,405,816,0,0,0,0,0,0,49.63
新竹市,北區,南寮里,173,1,573,14,587,1213,0,0,0,0,0,0,48.39
新竹市,北區,南寮里,174,1,398,4,402,838,0,0,0,0,0,0,47.97
新竹市,北區,南寮里,175,1,528,12,540,1250,0,0,0,0,0,0,43.20
新竹市,北區,康樂里,176,1,724,31,755,1505,0,0,0,0,0,0,50.17
新竹市,北區,中寮里,177,1,542,17,559,1100,0,0,0,0,0,0,50.82
新竹市,北區,海濱里,178,1,611,20,631,1265,0,0,0,0,0,0,49.88
新竹市,北區,港北里,179,1,493,11,504,1058,0,0,0,0,0,0,47.64
新竹市,北區,舊港里,180,1,261,4,265,491,0,0,0,0,0,0,53.97
新竹市,香山區,頂埔里,181,1,718,21,739,1469,0,0,0,0,0,0,50.31
新竹市,香山區,頂埔里,182,1,588,8,596,1132,0,0,0,0,0,0,52.65
新竹市,香山區,頂福里,183,1,362,12,374,776,0,0,0,0,0,0,48.20
新竹市,香山區,頂福里,184,1,656,20,676,1272,0,0,0,0,0,0,53.14
新竹市,香山區,中埔里,185,1,486,10,496,925,0,0,0,0,0,0,53.62
新竹市,香山區,中埔里,186,1,519,13,532,1066,0,0,0,0,0,0,49.91
新竹市,香山區,牛埔里,187,1,473,7,480,972,0,0,0,0,0,0,49.38
新竹市,香山區,牛埔里,188,1,396,9,405,832,0,0,0,0,0,0,48.68
新竹市,香山區,埔前里,189,1,536,13,549,1052,0,0,0,0,0,0,52.19
新竹市,香山區,埔前里,190,1,524,15,539,1074,0,0,0,0,0,0,50.19
新竹市,香山區,樹下里,191,1,403,7,410,776,0,0,0,0,0,0,52.84
新竹市,香山區,樹下里,192,1,429,12,441,859,0,0,0,0,0,0,51.34
新竹市,香山區,浸水里,193,1,670,18,688,1361,0,0,0,0,0,0,50.55
新竹市,香山區,虎林里,194,1,467,11,478,957,0,0,0,0,0,0,49.95
新竹市,香山區,虎林里,195,1,408,8,416,802,0,0,0,0,0,0,51.87
新竹市,香山區,虎山里,196,1,602,14,616,1250,0,0,0,0,0,0,49.28
新竹市,香山區,虎山里,197,1,480,21,501,1198,0,0,0,0,0,0,41.82
新竹市,香山區,虎山里,198,1,700,20,720,1583,0,0,0,0,0,0,45.48
新竹市,香山區,港南里,199,1,433,14,447,847,0,0,0,0,0,0,52.77
新竹市,香山區,港南里,200,1,356,6,362,753,0,0,0,0,0,0,48.07
新竹市,香山區,東香里,201,1,274,7,281,618,0,0,0,0,0,0,45.47
新竹市,香山區,東香里,202,1,457,9,466,890,0,0,0,0,0,0,52.36
新竹市,香山區,香村里,203,1,370,14,384,745,0,0,0,0,0,0,51.54
新竹市,香山區,香村里,204,1,439,4,443,909,0,0,0,0,0,0,48.73
新竹市,香山區,香山里,205,1,667,16,683,1403,0,0,0,0,0,0,48.68
新竹市,香山區,香山里,206,1,505,13,518,1079,0,0,0,0,0,0,48.01
新竹市,香山區,大庄里,207,1,446,11,457,860,0,0,0,0,0,0,53.14
新竹市,香山區,大庄里,208,1,434,8,442,904,0,0,0,0,0,0,48.89
新竹市,香山區,美山里,209,1,435,9,444,933,0,0,0,0,0,0,47.59
新竹市,香山區,朝山里,210,1,752,61,813,1592,0,0,0,0,0,0,51.07
新竹市,香山區,海山里,211,1,542,16,558,939,0,0,0,0,0,0,59.42
新竹市,香山區,海山里,212,1,306,15,321,654,0,0,0,0,0,0,49.08
新竹市,香山區,鹽水里,213,1,506,18,524,1034,0,0,0,0,0,0,50.68
新竹市,香山區,內湖里,214,1,593,15,608,1369,0,0,0,0,0,0,44.41
新竹市,香山區,內湖里,215,1,660,21,681,1467,0,0,0,0,0,0,46.42
新竹市,香山區,南港里,216,1,405,7,412,735,0,0,0,0,0,0,56.05
新竹市,香山區,中隘里,217,1,588,20,608,1143,0,0,0,0,0,0,53.19
新竹市,香山區,南隘里,218,1,358,7,365,594,0,0,0,0,0,0,61.45
新竹市,香山區,大湖里,219,1,353,3,356,667,0,0,0,0,0,0,53.37
新竹市,香山區,茄苳里,220,1,402,8,410,682,0,0,0,0,0,0,60.12
臺中市,中區,中山里,1,1,575,7,582,996,0,0,0,0,0,0,58.43
臺中市,中區,南京里,2,1,647,5,652,1031,0,0,0,0,0,0,63.24
臺中市,中區,繼光里,3,1,675,5,680,1162,0,0,0,0,0,0,58.52
臺中市,中區,自由里,4,1,745,5,750,1391,0,0,0,0,0,0,53.92
臺中市,中區,重慶里,5,1,566,6,572,908,0,0,0,0,0,0,63.00
臺中市,中區,錦上里,6,1,787,9,796,1269,0,0,0,0,0,0,62.73
臺中市,中區,錦花里,7,1,699,9,708,1142,0,0,0,0,0,0,62.00
臺中市,中區,大墩里,8,1,830,11,841,1413,0,0,0,0,0,0,59.52
臺中市,中區,中墩里,9,1,734,9,743,1208,0,0,0,0,0,0,61.51
臺中市,中區,柳岸里,10,1,691,11,702,1100,0,0,0,0,0,0,63.82
臺中市,中區,柳原里,11,1,658,5,663,1099,0,0,0,0,0,0,60.33
臺中市,中區,光音里,12,1,811,9,820,1307,0,0,0,0,0,0,62.74
臺中市,中區,博松里,13,1,834,6,840,1298,0,0,0,0,0,0,64.71
臺中市,中區,中政里,14,1,774,6,780,1239,0,0,0,0,0,0,62.95
臺中市,東區,新庄里,15,1,661,9,670,1051,0,0,0,0,0,0,63.75
臺中市,東區,立德里,16,1,392,10,402,629,0,0,0,0,0,0,63.91
臺中市,東區,朱文里,17,1,516,4,520,874,0,0,0,0,0,0,59.50
臺中市,東區,翰第里,18,1,623,7,630,957,0,0,0,0,0,0,65.83
臺中市,東區,振興里,19,1,746,5,751,1233,0,0,0,0,0,0,60.91
臺中市,東區,曙峰里,20,1,722,8,730,1099,0,0,0,0,0,0,66.42
臺中市,東區,頂峰里,21,1,874,11,885,1297,0,0,0,0,0,0,68.23
臺中市,東區,忠孝里,22,1,678,4,682,1039,0,0,0,0,0,0,65.64
臺中市,東區,東橋里,23,1,795,9,804,1187,0,0,0,0,0,0,67.73
臺中市,東區,東橋里,24,1,765,14,779,1267,0,0,0,0,0,0,61.48
臺中市,東區,東橋里,25,1,766,8,774,1234,0,0,0,0,0,0,62.72
臺中市,東區,東興里,26,1,636,3,639,915,0,0,0,0,0,0,69.84
臺中市,東區,東興里,27,1,685,6,691,1005,0,0,0,0,0,0,68.76
臺中市,東區,樂業里,28,1,559,8,567,843,0,0,0,0,0,0,67.26
臺中市,東區,泉源里,29,1,575,5,580,824,0,0,0,0,0,0,70.39
臺中市,東區,文化里,30,1,709,9,718,1162,0,0,0,0,0,0,61.79
臺中市,東區,干城里,31,1,487,3,490,781,0,0,0,0,0,0,62.74
臺中市,東區,祖聖里,32,1,687,8,695,999,0,0,0,0,0,0,69.57
臺中市,東區,旱溪里,33,1,984,16,1000,1371,0,0,0,0,0,0,72.94
臺中市,東區,樂成里,34,1,920,12,932,1395,0,0,0,0,0,0,66.81
臺中市,東區,東門里,35,1,710,10,720,1211,0,0,0,0,0,0,59.45
臺中市,東區,東門里,36,1,1151,18,1169,1690,0,0,0,0,0,0,69.17
臺中市,東區,東門里,37,1,1043,10,1053,1623,0,0,0,0,0,0,64.88
臺中市,東區,十甲里,38,1,959,12,971,1611,0,0,0,0,0,0,60.27
臺中市,東區,十甲里,39,1,972,18,990,1519,0,0,0,0,0,0,65.17
臺中市,東區,十甲里,40,1,867,19,886,1543,0,0,0,0,0,0,57.42
臺中市,東區,東南里,41,1,745,9,754,1247,0,0,0,0,0,0,60.47
臺中市,東區,東南里,42,1,696,10,706,1119,0,0,0,0,0,0,63.09
臺中市,東區,東南里,43,1,527,6,533,805,0,0,0,0,0,0,66.21
臺中市,東區,東勢里,44,1,491,9,500,813,0,0,0,0,0,0,61.50
臺中市,東區,東勢里,45,1,465,7,472,796,0,0,0,0,0,0,59.30
臺中市,東區,合作里,46,1,545,8,553,855,0,0,0,0,0,0,64.68
臺中市,東區,合作里,47,1,492,5,497,854,0,0,0,0,0,0,58.20
臺中市,東區,東明里,48,1,908,10,918,1449,0,0,0,0,0,0,63.35
臺中市,東區,成功里,49,1,489,13,502,834,0,0,0,0,0,0,60.19
臺中市,東區,尚武里,50,1,911,8,919,1398,0,0,0,0,0,0,65.74
臺中市,東區,富台里,51,1,526,6,532,799,0,0,0,0,0,0,66.58
臺中市,東區,富台里,52,1,481,7,488,743,0,0,0,0,0,0,65.68
臺中市,東區,富仁里,53,1,746,12,758,1295,0,0,0,0,0,0,58.53
臺中市,東區,東信里,54,1,1007,11,1018,1572,0,0,0,0,0,0,64.76
臺中市,東區,東信里,55,1,857,10,867,1392,0,0,0,0,0,0,62.28
臺中市,東區,東信里,56,1,934,3,937,1437,0,0,0,0,0,0,65.21
臺中市,南區,南興里,57,1,446,1,447,714,0,0,0,0,0,0,62.61
臺中市,南區,正義里,58,1,387,1,388,714,0,0,0,0,0,0,54.34
臺中市,南區,民主里,59,1,553,7,560,872,0,0,0,0,0,0,64.22
臺中市,南區,復興里,60,1,1115,7,1122,1655,0,0,0,0,0,0,67.79
臺中市,南區,萬安里,61,1,639,13,652,1030,0,0,0,0,0,0,63.30
臺中市,南區,信義里,62,1,666,15,681,1051,0,0,0,0,0,0,64.80
臺中市,南區,城隍里,63,1,878,8,886,1404,0,0,0,0,0,0,63.11
臺中市,南區,頂南里,64,1,661,7,668,1036,0,0,0,0,0,0,64.48
臺中市,南區,國光里,65,1,968,8,976,1630,0,0,0,0,0,0,59.88
臺中市,南區,國光里,66,1,1026,20,1046,1654,0,0,0,0,0,0,63.24
臺中市,南區,南門里,67,1,967,15,982,1693,0,0,0,0,0,0,58.00
臺中市,南區,南門里,68,1,902,12,914,1500,0,0,0,0,0,0,60.93
臺中市,南區,德義里,69,1,636,2,638,1046,0,0,0,0,0,0,60.99
臺中市,南區,德義里,70,1,755,9,764,1211,0,0,0,0,0,0,63.09
臺中市,南區,積善里,71,1,741,7,748,1188,0,0,0,0,0,0,62.96
臺中市,南區,積善里,72,1,900,13,913,1489,0,0,0,0,0,0,61.32
臺中市,南區,江川里,73,1,1091,9,1100,1740,0,0,0,0,0,0,63.22
臺中市,南區,新榮里,74,1,1104,20,1124,1976,0,0,0,0,0,0,56.88
臺中市,南區,福興里,75,1,809,9,818,1291,0,0,0,0,0,0,63.36
臺中市,南區,福興里,76,1,800,8,808,1262,0,0,0,0,0,0,64.03
臺中市,南區,福平里,77,1,946,11,957,1666,0,0,0,0,0,0,57.44
臺中市,南區,福平里,78,1,892,12,904,1528,0,0,0,0,0,0,59.16
臺中市,南區,福平里,79,1,941,10,951,1560,0,0,0,0,0,0,60.96
臺中市,南區,福平里,80,1,956,16,972,1633,0,0,0,0,0,0,59.52
臺中市,南區,和平里,81,1,825,8,833,1490,0,0,0,0,0,0,55.91
臺中市,南區,和平里,82,1,958,7,965,2056,0,0,0,0,0,0,46.94
臺中市,南區,和平里,83,1,802,9,811,1277,0,0,0,0,0,0,63.51
臺中市,南區,和平里,84,1,806,6,812,1318,0,0,0,0,0,0,61.61
臺中市,南區,和平里,85,1,823,8,831,1433,0,0,0,0,0,0,57.99
臺中市,南區,永興里,86,1,767,5,772,1370,0,0,0,0,0,0,56.35
臺中市,南區,永興里,87,1,880,12,892,1514,0,0,0,0,0,0,58.92
臺中市,南區,永興里,88,1,889,3,892,1470,0,0,0,0,0,0,60.68
臺中市,南區,永興里,89,1,820,7,827,1530,0,0,0,0,0,0,54.05
臺中市,南區,樹義里,90,1,940,6,946,1534,0,0,0,0,0,0,61.67
臺中市,南區,樹義里,91,1,958,12,970,1659,0,0,0,0,0,0,58.47
臺中市,南區,樹義里,92,1,829,5,834,1724,0,0,0,0,0,0,48.38
臺中市,南區,樹義里,93,1,917,13,930,1544,0,0,0,0,0,0,60.23
臺中市,南區,樹德里,94,1,786,15,801,1362,0,0,0,0,0,0,58.81
臺中市,南區,樹德里,95,1,682,8,690,1081,0,0,0,0,0,0,63.83
臺中市,南區,西川里,96,1,905,21,926,1334,0,0,0,0,0,0,69.42
臺中市,南區,西川里,97,1,828,6,834,1457,0,0,0,0,0,0,57.24
臺中市,南區,西川里,98,1,799,6,805,1234,0,0,0,0,0,0,65.24
臺中市,南區,西川里,99,1,791,12,803,1237,0,0,0,0,0,0,64.92
臺中市,西區,福壽里,100,1,870,9,879,1403,0,0,0,0,0,0,62.65
臺中市,西區,光明里,101,1,533,8,541,931,0,0,0,0,0,0,58.11
臺中市,西區,利民里,102,1,509,5,514,901,0,0,0,0,0,0,57.05
臺中市,西區,利民里,103,1,545,7,552,1192,0,0,0,0,0,0,46.31
臺中市,西區,平和里,104,1,888,15,903,1532,0,0,0,0,0,0,58.94
臺中市,西區,公民里,105,1,801,6,807,1306,0,0,0,0,0,0,61.79
臺中市,西區,公民里,106,1,703,6,709,1178,0,0,0,0,0,0,60.19
臺中市,西區,公民里,107,1,793,9,802,1300,0,0,0,0,0,0,61.69
臺中市,西區,中民里,108,1,1115,12,1127,1751,0,0,0,0,0,0,64.36
臺中市,西區,藍興里,109,1,614,4,618,974,0,0,0,0,0,0,63.45
臺中市,西區,藍興里,110,1,855,14,869,1320,0,0,0,0,0,0,65.83
臺中市,西區,公館里,111,1,814,12,826,1235,0,0,0,0,0,0,66.88
臺中市,西區,公館里,112,1,929,11,940,1345,0,0,0,0,0,0,69.89
臺中市,西區,公館里,113,1,986,19,1005,1623,0,0,0,0,0,0,61.92
臺中市,西區,元龍里,114,1,526,6,532,794,0,0,0,0,0,0,67.00
臺中市,西區,和龍里,115,1,901,11,912,1531,0,0,0,0,0,0,59.57
臺中市,西區,三民里,116,1,730,8,738,1256,0,0,0,0,0,0,58.76
臺中市,西區,平民里,117,1,641,5,646,1049,0,0,0,0,0,0,61.58
臺中市,西區,東昇里,118,1,902,11,913,1529,0,0,0,0,0,0,59.71
臺中市,西區,廣民里,119,1,774,12,786,1272,0,0,0,0,0,0,61.79
臺中市,西區,民龍里,120,1,652,7,659,1128,0,0,0,0,0,0,58.42
臺中市,西區,民龍里,121,1,451,5,456,757,0,0,0,0,0,0,60.24
臺中市,西區,福龍里,122,1,757,12,769,1260,0,0,0,0,0,0,61.03
臺中市,西區,靖龍里,123,1,543,2,545,914,0,0,0,0,0,0,59.63
臺中市,西區,靖龍里,124,1,528,9,537,875,0,0,0,0,0,0,61.37
臺中市,西區,雲龍里,125,1,559,8,567,983,0,0,0,0,0,0,57.68
臺中市,西區,雲龍里,126,1,567,6,573,958,0,0,0,0,0,0,59.81
臺中市,西區,永龍里,127,1,624,7,631,930,0,0,0,0,0,0,67.85
臺中市,西區,安龍里,128,1,646,10,656,1123,0,0,0,0,0,0,58.41
臺中市,西區,安龍里,129,1,550,9,559,959,0,0,0,0,0,0,58.29
臺中市,西區,吉龍里,130,1,553,3,556,857,0,0,0,0,0,0,64.88
臺中市,西區,吉龍里,131,1,617,6,623,1065,0,0,0,0,0,0,58.50
臺中市,西區,吉龍里,132,1,817,11,828,1329,0,0,0,0,0,0,62.30
臺中市,西區,吉龍里,133,1,913,7,920,1525,0,0,0,0,0,0,60.33
臺中市,西區,昇平里,134,1,762,10,772,1236,0,0,0,0,0,0,62.46
臺中市,西區,昇平里,135,1,647,10,657,1108,0,0,0,0,0,0,59.30
臺中市,西區,昇平里,136,1,643,7,650,1189,0,0,0,0,0,0,54.67
臺中市,西區,忠明里,137,1,718,8,726,1272,0,0,0,0,0,0,57.08
臺中市,西區,忠明里,138,1,732,6,738,1298,0,0,0,0,0,0,56.86
臺中市,西區,忠明里,139,1,809,7,816,1388,0,0,0,0,0,0,58.79
臺中市,西區,忠誠里,140,1,659,12,671,1223,0,0,0,0,0,0,54.87
臺中市,西區,忠誠里,141,1,694,7,701,1221,0,0,0,0,0,0,57.41
臺中市,西區,忠誠里,142,1,583,8,591,1044,0,0,0,0,0,0,56.61
臺中市,西區,忠誠里,143,1,714,5,719,1146,0,0,0,0,0,0,62.74
臺中市,西區,公正里,144,1,936,12,948,1575,0,0,0,0,0,0,60.19
臺中市,西區,公正里,145,1,583,8,591,967,0,0,0,0,0,0,61.12
臺中市,西區,公正里,146,1,574,8,582,1054,0,0,0,0,0,0,55.22
臺中市,西區,公正里,147,1,524,2,526,888,0,0,0,0,0,0,59.23
臺中市,西區,公正里,148,1,618,6,624,1176,0,0,0,0,0,0,53.06
臺中市,西區,公正里,149,1,654,6,660,1136,0,0,0,0,0,0,58.10
臺中市,西區,公正里,150,1,781,9,790,1271,0,0,0,0,0,0,62.16
臺中市,西區,公正里,151,1,565,7,572,1051,0,0,0,0,0,0,54.42
臺中市,西區,公益里,152,1,756,20,776,1212,0,0,0,0,0,0,64.03
臺中市,西區,公益里,153,1,769,9,778,1174,0,0,0,0,0,0,66.27
臺中市,西區,中興里,154,1,820,16,836,1335,0,0,0,0,0,0,62.62
臺中市,西區,中興里,155,1,984,8,992,1594,0,0,0,0,0,0,62.23
臺中市,西區,土庫里,156,1,913,8,921,1474,0,0,0,0,0,0,62.48
臺中市,西區,土庫里,157,1,887,7,894,1481,0,0,0,0,0,0,60.36
臺中市,西區,土庫里,158,1,842,7,849,1523,0,0,0,0,0,0,55.75
臺中市,西區,土庫里,159,1,590,9,599,1036,0,0,0,0,0,0,57.82
臺中市,西區,土庫里,160,1,634,7,641,1016,0,0,0,0,0,0,63.09
臺中市,北區,高風里,161,1,564,6,570,868,0,0,0,0,0,0,65.67
臺中市,北區,高平里,162,1,669,6,675,1056,0,0,0,0,0,0,63.92
臺中市,北區,大安里,163,1,562,10,572,956,0,0,0,0,0,0,59.83
臺中市,北區,光興里,164,1,671,13,684,1132,0,0,0,0,0,0,60.42
臺中市,北區,光大里,165,1,582,25,607,948,0,0,0,0,0,0,64.03
臺中市,北區,光大里,166,1,542,6,548,915,0,0,0,0,0,0,59.89
臺中市,北區,文莊里,167,1,637,11,648,976,0,0,0,0,0,0,66.39
臺中市,北區,文莊里,168,1,558,0,558,983,0,0,0,0,0,0,56.77
臺中市,北區,湖北里,169,1,617,3,620,1014,0,0,0,0,0,0,61.14
臺中市,北區,中湖里,170,1,1018,15,1033,1615,0,0,0,0,0,0,63.96
臺中市,北區,錦和里,171,1,644,2,646,1001,0,0,0,0,0,0,64.54
臺中市,北區,五常里,172,1,557,6,563,904,0,0,0,0,0,0,62.28
臺中市,北區,五常里,173,1,415,1,416,734,0,0,0,0,0,0,56.68
臺中市,北區,仁和里,174,1,509,8,517,747,0,0,0,0,0,0,69.21
臺中市,北區,新興里,175,1,734,8,742,1209,0,0,0,0,0,0,61.37
臺中市,北區,武順里,176,1,493,5,498,867,0,0,0,0,0,0,57.44
臺中市,北區,新北里,177,1,842,17,859,1400,0,0,0,0,0,0,61.36
臺中市,北區,新北里,178,1,519,3,522,990,0,0,0,0,0,0,52.73
臺中市,北區,樂英里,179,1,689,8,697,1064,0,0,0,0,0,0,65.51
臺中市,北區,樂英里,180,1,812,8,820,1244,0,0,0,0,0,0,65.92
臺中市,北區,樂英里,181,1,460,3,463,827,0,0,0,0,0,0,55.99
臺中市,北區,錦村里,182,1,569,4,573,878,0,0,0,0,0,0,65.26
臺中市,北區,錦村里,183,1,580,10,590,932,0,0,0,0,0,0,63.30
臺中市,北區,錦村里,184,1,726,6,732,1109,0,0,0,0,0,0,66.01
臺中市,北區,建成里,185,1,646,10,656,1041,0,0,0,0,0,0,63.02
臺中市,北區,建成里,186,1,710,9,719,1102,0,0,0,0,0,0,65.25
臺中市,北區,建成里,187,1,700,8,708,1078,0,0,0,0,0,0,65.68
臺中市,北區,建成里,188,1,616,7,623,1199,0,0,0,0,0,0,51.96
臺中市,北區,建成里,189,1,608,12,620,1134,0,0,0,0,0,0,54.67
臺中市,北區,建成里,190,1,725,12,737,1171,0,0,0,0,0,0,62.94
臺中市,北區,錦洲里,191,1,836,9,845,1325,0,0,0,0,0,0,63.77
臺中市,北區,錦洲里,192,1,960,14,974,1572,0,0,0,0,0,0,61.96
臺中市,北區,錦祥里,193,1,736,7,743,1378,0,0,0,0,0,0,53.92
臺中市,北區,錦祥里,194,1,813,13,826,1485,0,0,0,0,0,0,55.62
臺中市,北區,金華里,195,1,843,11,854,1517,0,0,0,0,0,0,56.30
臺中市,北區,金龍里,196,1,819,8,827,1354,0,0,0,0,0,0,61.08
臺中市,北區,金龍里,197,1,790,9,799,1389,0,0,0,0,0,0,57.52
臺中市,北區,金龍里,198,1,816,14,830,1336,0,0,0,0,0,0,62.13
臺中市,北區,邱厝里,199,1,669,9,678,1177,0,0,0,0,0,0,57.60
臺中市,北區,邱厝里,200,1,469,3,472,952,0,0,0,0,0,0,49.58
臺中市,北區,建興里,201,1,894,8,902,1565,0,0,0,0,0,0,57.64
臺中市,北區,建興里,202,1,909,11,920,1576,0,0,0,0,0,0,58.38
臺中市,北區,建興里,203,1,832,6,838,1513,0,0,0,0,0,0,55.39
臺中市,北區,頂厝里,204,1,719,17,736,1177,0,0,0,0,0,0,62.53
臺中市,北區,頂厝里,205,1,793,5,798,1348,0,0,0,0,0,0,59.20
臺中市,北區,頂厝里,206,1,827,8,835,1396,0,0,0,0,0,0,59.81
臺中市,北區,頂厝里,207,1,908,7,915,1501,0,0,0,0,0,0,60.96
臺中市,北區,賴厝里,208,1,821,13,834,1356,0,0,0,0,0,0,61.50
臺中市,北區,賴厝里,209,1,619,5,624,1018,0,0,0,0,0,0,61.30
臺中市,北區,賴厝里,210,1,803,9,812,1372,0,0,0,0,0,0,59.18
臺中市,北區,賴明里,211,1,678,11,689,1257,0,0,0,0,0,0,54.81
臺中市,北區,賴明里,212,1,812,4,816,1405,0,0,0,0,0,0,58.08
臺中市,北區,賴明里,213,1,766,9,775,1406,0,0,0,0,0,0,55.12
臺中市,北區,賴興里,214,1,715,9,724,1396,0,0,0,0,0,0,51.86
臺中市,北區,賴興里,215,1,755,6,761,1322,0,0,0,0,0,0,57.56
臺中市,北區,賴興里,216,1,671,8,679,1211,0,0,0,0,0,0,56.07
臺中市,北區,賴興里,217,1,714,8,722,1219,0,0,0,0,0,0,59.23
臺中市,北區,賴村里,218,1,736,16,752,1200,0,0,0,0,0,0,62.67
臺中市,北區,賴村里,219,1,697,11,708,1199,0,0,0,0,0,0,59.05
臺中市,北區,賴村里,220,1,746,8,754,1211,0,0,0,0,0,0,62.26
臺中市,北區,育德里,221,1,800,8,808,1433,0,0,0,0,0,0,56.39
臺中市,北區,育德里,222,1,859,2,861,1427,0,0,0,0,0,0,60.34
臺中市,北區,淡溝里,223,1,796,6,802,1229,0,0,0,0,0,0,65.26
臺中市,北區,淡溝里,224,1,763,10,773,1200,0,0,0,0,0,0,64.42
臺中市,北區,淡溝里,225,1,732,5,737,1124,0,0,0,0,0,0,65.57
臺中市,北區,健行里,226,1,689,10,699,1080,0,0,0,0,0,0,64.72
臺中市,北區,健行里,227,1,794,12,806,1268,0,0,0,0,0,0,63.56
臺中市,北區,健行里,228,1,805,7,812,1371,0,0,0,0,0,0,59.23
臺中市,北區,健行里,229,1,696,10,706,1221,0,0,0,0,0,0,57.82
臺中市,北區,明德里,230,1,556,5,561,957,0,0,0,0,0,0,58.62
臺中市,北區,明德里,231,1,840,10,850,1426,0,0,0,0,0,0,59.61
臺中市,北區,明德里,232,1,662,4,666,1218,0,0,0,0,0,0,54.68
臺中市,北區,明德里,233,1,750,0,750,1297,0,0,0,0,0,0,57.83
臺中市,北區,明德里,234,1,712,6,718,1153,0,0,0,0,0,0,62.27
臺中市,北區,長青里,235,1,741,7,748,1342,0,0,0,0,0,0,55.74
臺中市,北區,長青里,236,1,853,9,862,1580,0,0,0,0,0,0,54.56
臺中市,北區,長青里,237,1,744,8,752,1310,0,0,0,0,0,0,57.40
臺中市,北區,長青里,238,1,940,10,950,1484,0,0,0,0,0,0,64.02
臺中市,北區,長青里,239,1,784,4,788,1256,0,0,0,0,0,0,62.74
臺中市,北區,中達里,240,1,780,8,788,1293,0,0,0,0,0,0,60.94
臺中市,北區,中達里,241,1,748,8,756,1220,0,0,0,0,0,0,61.97
臺中市,西屯區,西安里,242,1,1077,9,1086,1669,0,0,0,0,0,0,65.07
臺中市,西屯區,西安里,243,1,1071,14,1085,1767,0,0,0,0,0,0,61.40
臺中市,西屯區,西安里,244,1,835,8,843,1413,0,0,0,0,0,0,59.66
臺中市,西屯區,西平里,245,1,618,8,626,1087,0,0,0,0,0,0,57.59
臺中市,西屯區,西平里,246,1,725,7,732,1229,0,0,0,0,0,0,59.56
臺中市,西屯區,西平里,247,1,910,1,911,1360,0,0,0,0,0,0,66.99
臺中市,西屯區,西墩里,248,1,1155,12,1167,1790,0,0,0,0,0,0,65.20
臺中市,西屯區,西墩里,249,1,865,8,873,1475,0,0,0,0,0,0,59.19
臺中市,西屯區,潮洋里,250,1,866,7,873,1325,0,0,0,0,0,0,65.89
臺中市,西屯區,龍潭里,251,1,686,5,691,947,0,0,0,0,0,0,72.97
臺中市,西屯區,惠來里,252,1,1140,11,1151,1733,0,0,0,0,0,0,66.42
臺中市,西屯區,惠來里,253,1,963,9,972,1504,0,0,0,0,0,0,64.63
臺中市,西屯區,上石里,254,1,828,2,830,1304,0,0,0,0,0,0,63.65
臺中市,西屯區,上石里,255,1,967,13,980,1861,0,0,0,0,0,0,52.66
臺中市,西屯區,上石里,256,1,954,17,971,1835,0,0,0,0,0,0,52.92
臺中市,西屯區,上石里,257,1,895,12,907,1664,0,0,0,0,0,0,54.51
臺中市,西屯區,逢甲里,258,1,1086,16,1102,1806,0,0,0,0,0,0,61.02
臺中市,西屯區,逢甲里,259,1,813,6,819,1401,0,0,0,0,0,0,58.46
臺中市,西屯區,逢甲里,260,1,800,5,805,1460,0,0,0,0,0,0,55.14
臺中市,西屯區,逢甲里,261,1,869,7,876,1418,0,0,0,0,0,0,61.78
臺中市,西屯區,鵬程里,262,1,663,7,670,896,0,0,0,0,0,0,74.78
臺中市,西屯區,鵬程里,263,1,603,9,612,814,0,0,0,0,0,0,75.18
臺中市,西屯區,何厝里,264,1,966,9,975,1620,0,0,0,0,0,0,60.19
臺中市,西屯區,何厝里,265,1,963,12,975,1633,0,0,0,0,0,0,59.71
臺中市,西屯區,何厝里,266,1,889,10,899,1599,0,0,0,0,0,0,56.22
臺中市,西屯區,何南里,267,1,1038,6,1044,1735,0,0,0,0,0,0,60.17
臺中市,西屯區,何南里,268,1,950,10,960,1587,0,0,0,0,0,0,60.49
臺中市,西屯區,何南里,269,1,783,7,790,1429,0,0,0,0,0,0,55.28
臺中市,西屯區,何南里,270,1,928,9,937,1699,0,0,0,0,0,0,55.15
臺中市,西屯區,何安里,271,1,686,7,693,1170,0,0,0,0,0,0,59.23
臺中市,西屯區,何安里,272,1,629,8,637,1072,0,0,0,0,0,0,59.42
臺中市,西屯區,何安里,273,1,709,5,714,1170,0,0,0,0,0,0,61.03
臺中市,西屯區,何仁里,274,1,865,12,877,1500,0,0,0,0,0,0,58.47
臺中市,西屯區,何仁里,275,1,729,4,733,1250,0,0,0,0,0,0,58.64
臺中市,西屯區,何仁里,276,1,800,11,811,1430,0,0,0,0,0,0,56.71
臺中市,西屯區,何德里,277,1,1010,3,1013,1558,0,0,0,0,0,0,65.02
臺中市,西屯區,何德里,278,1,1018,11,1029,1827,0,0,0,0,0,0,56.32
臺中市,西屯區,何德里,279,1,1012,12,1024,1781,0,0,0,0,0,0,57.50
臺中市,西屯區,何源里,280,1,958,6,964,1571,0,0,0,0,0,0,61.36
臺中市,西屯區,何源里,281,1,847,16,863,1451,0,0,0,0,0,0,59.48
臺中市,西屯區,何源里,282,1,651,5,656,1238,0,0,0,0,0,0,52.99
臺中市,西屯區,大河里,283,1,1013,22,1035,1653,0,0,0,0,0,0,62.61
臺中市,西屯區,大河里,284,1,1000,9,1009,1563,0,0,0,0,0,0,64.56
臺中市,西屯區,大石里,285,1,703,2,705,1027,0,0,0,0,0,0,68.65
臺中市,西屯區,大福里,286,1,866,15,881,1337,0,0,0,0,0,0,65.89
臺中市,西屯區,大福里,287,1,838,12,850,1346,0,0,0,0,0,0,63.15
臺中市,西屯區,大鵬里,288,1,968,10,978,1480,0,0,0,0,0,0,66.08
臺中市,西屯區,大鵬里,289,1,697,7,704,1151,0,0,0,0,0,0,61.16
臺中市,西屯區,大鵬里,290,1,694,7,701,1213,0,0,0,0,0,0,57.79
臺中市,西屯區,港尾里,291,1,618,5,623,824,0,0,0,0,0,0,75.61
臺中市,西屯區,港尾里,292,1,647,5,652,983,0,0,0,0,0,0,66.33
臺中市,西屯區,港尾里,293,1,752,6,758,1297,0,0,0,0,0,0,58.44
臺中市,西屯區,港尾里,294,1,786,14,800,1306,0,0,0,0,0,0,61.26
臺中市,西屯區,廣福里,295,1,607,3,610,848,0,0,0,0,0,0,71.93
臺中市,西屯區,廣福里,296,1,700,12,712,981,0,0,0,0,0,0,72.58
臺中市,西屯區,林厝里,297,1,638,14,652,1031,0,0,0,0,0,0,63.24
臺中市,西屯區,林厝里,298,1,600,6,606,1088,0,0,0,0,0,0,55.70
臺中市,西屯區,永安里,299,1,928,6,934,1512,0,0,0,0,0,0,61.77
臺中市,西屯區,永安里,300,1,792,8,800,1343,0,0,0,0,0,0,59.57
臺中市,西屯區,永安里,301,1,575,10,585,1005,0,0,0,0,0,0,58.21
臺中市,西屯區,福安里,302,1,969,11,980,1690,0,0,0,0,0,0,57.99
臺中市,西屯區,福安里,303,1,847,6,853,1585,0,0,0,0,0,0,53.82
臺中市,西屯區,福安里,304,1,744,4,748,1445,0,0,0,0,0,0,51.76
臺中市,西屯區,福安里,305,1,738,12,750,1159,0,0,0,0,0,0,64.71
臺中市,西屯區,福安里,306,1,931,11,942,1597,0,0,0,0,0,0,58.99
臺中市,西屯區,福安里,307,1,957,5,962,1640,0,0,0,0,0,0,58.66
臺中市,西屯區,福安里,308,1,787,3,790,1339,0,0,0,0,0,0,59.00
臺中市,西屯區,福安里,309,1,706,4,710,1341,0,0,0,0,0,0,52.95
臺中市,西屯區,福安里,310,1,656,5,661,1265,0,0,0,0,0,0,52.25
臺中市,西屯區,福安里,311,1,684,12,696,1365,0,0,0,0,0,0,50.99
臺中市,西屯區,福安里,312,1,657,2,659,1478,0,0,0,0,0,0,44.59
臺中市,西屯區,協和里,313,1,647,4,651,1148,0,0,0,0,0,0,56.71
臺中市,西屯區,協和里,314,1,1112,10,1122,1723,0,0,0,0,0,0,65.12
臺中市,西屯區,協和里,315,1,553,7,560,883,0,0,0,0,0,0,63.42
臺中市,南屯區,南屯里,316,1,907,9,916,1396,0,0,0,0,0,0,65.62
臺中市,南屯區,南屯里,317,1,764,9,773,1222,0,0,0,0,0,0,63.26
臺中市,南屯區,南屯里,318,1,928,7,935,1457,0,0,0,0,0,0,64.17
臺中市,南屯區,豐樂里,319,1,918,13,931,1409,0,0,0,0,0,0,66.08
臺中市,南屯區,豐樂里,320,1,764,9,773,1314,0,0,0,0,0,0,58.83
臺中市,南屯區,豐樂里,321,1,841,7,848,1357,0,0,0,0,0,0,62.49
臺中市,南屯區,楓樹里,322,1,669,19,688,1078,0,0,0,0,0,0,63.82
臺中市,南屯區,楓樹里,323,1,892,13,905,1288,0,0,0,0,0,0,70.26
臺中市,南屯區,楓樹里,324,1,665,4,669,1019,0,0,0,0,0,0,65.65
臺中市,南屯區,中和里,325,1,728,13,741,1079,0,0,0,0,0,0,68.67
臺中市,南屯區,中和里,326,1,759,9,768,1064,0,0,0,0,0,0,72.18
臺中市,南屯區,中和里,327,1,752,10,762,1100,0,0,0,0,0,0,69.27
臺中市,南屯區,鎮平里,328,1,679,6,685,886,0,0,0,0,0,0,77.31
臺中市,南屯區,鎮平里,329,1,418,7,425,608,0,0,0,0,0,0,69.90
臺中市,南屯區,永定里,330,1,618,10,628,1043,0,0,0,0,0,0,60.21
臺中市,南屯區,永定里,331,1,965,12,977,1561,0,0,0,0,0,0,62.59
臺中市,南屯區,春社里,332,1,974,11,985,1512,0,0,0,0,0,0,65.15
臺中市,南屯區,春社里,333,1,857,10,867,1297,0,0,0,0,0,0,66.85
臺中市,南屯區,春社里,334,1,627,9,636,896,0,0,0,0,0,0,70.98
臺中市,南屯區,春社里,335,1,397,6,403,948,0,0,0,0,0,0,42.51
臺中市,南屯區,春安里,336,1,697,5,702,972,0,0,0,0,0,0,72.22
臺中市,南屯區,春安里,337,1,712,12,724,995,0,0,0,0,0,0,72.76
臺中市,南屯區,文山里,338,1,762,11,773,1176,0,0,0,0,0,0,65.73
臺中市,南屯區,文山里,339,1,625,3,628,1173,0,0,0,0,0,0,53.54
臺中市,南屯區,文山里,340,1,872,14,886,1384,0,0,0,0,0,0,64.02
臺中市,南屯區,文山里,341,1,676,4,680,1080,0,0,0,0,0,0,62.96
臺中市,南屯區,文山里,342,1,789,6,795,1125,0,0,0,0,0,0,70.67
臺中市,南屯區,新生里,343,1,732,9,741,1155,0,0,0,0,0,0,64.16
臺中市,南屯區,三厝里,344,1,726,11,737,1254,0,0,0,0,0,0,58.77
臺中市,南屯區,三厝里,345,1,763,4,767,1446,0,0,0,0,0,0,53.04
臺中市,南屯區,三厝里,346,1,863,8,871,1444,0,0,0,0,0,0,60.32
臺中市,南屯區,三厝里,347,1,957,11,968,1532,0,0,0,0,0,0,63.19
臺中市,南屯區,三厝里,348,1,815,11,826,1439,0,0,0,0,0,0,57.40
臺中市,南屯區,黎光里,349,1,818,8,826,1232,0,0,0,0,0,0,67.05
臺中市,南屯區,黎光里,350,1,714,5,719,1213,0,0,0,0,0,0,59.27
臺中市,南屯區,黎明里,351,1,871,20,891,1316,0,0,0,0,0,0,67.71
臺中市,南屯區,田心里,352,1,980,6,986,1603,0,0,0,0,0,0,61.51
臺中市,南屯區,田心里,353,1,943,11,954,1715,0,0,0,0,0,0,55.63
臺中市,南屯區,田心里,354,1,786,11,797,1272,0,0,0,0,0,0,62.66
臺中市,南屯區,田心里,355,1,653,6,659,1077,0,0,0,0,0,0,61.19
臺中市,南屯區,田心里,356,1,609,13,622,1001,0,0,0,0,0,0,62.14
臺中市,南屯區,田心里,357,1,784,12,796,1188,0,0,0,0,0,0,67.00
臺中市,南屯區,田心里,358,1,669,14,683,1027,0,0,0,0,0,0,66.50
臺中市,南屯區,田心里,359,1,707,9,716,1184,0,0,0,0,0,0,60.47
臺中市,南屯區,大同里,360,1,781,6,787,1333,0,0,0,0,0,0,59.04
臺中市,南屯區,大同里,361,1,608,8,616,960,0,0,0,0,0,0,64.17
臺中市,南屯區,大同里,362,1,521,5,526,897,0,0,0,0,0,0,58.64
臺中市,南屯區,大同里,363,1,544,11,555,942,0,0,0,0,0,0,58.92
臺中市,南屯區,大同里,364,1,635,3,638,1017,0,0,0,0,0,0,62.73
臺中市,南屯區,大同里,365,1,603,6,609,976,0,0,0,0,0,0,62.40
臺中市,南屯區,大同里,366,1,570,2,572,988,0,0,0,0,0,0,57.89
臺中市,南屯區,溝墘里,367,1,913,5,918,1484,0,0,0,0,0,0,61.86
臺中市,南屯區,溝墘里,368,1,866,8,874,1470,0,0,0,0,0,0,59.46
臺中市,南屯區,溝墘里,369,1,748,2,750,1106,0,0,0,0,0,0,67.81
臺中市,南屯區,溝墘里,370,1,695,2,697,1085,0,0,0,0,0,0,64.24
臺中市,南屯區,溝墘里,371,1,693,6,699,1213,0,0,0,0,0,0,57.63
臺中市,南屯區,溝墘里,372,1,780,10,790,1368,0,0,0,0,0,0,57.75
臺中市,南屯區,溝墘里,373,1,785,3,788,1240,0,0,0,0,0,0,63.55
臺中市,北屯區,北屯里,374,1,1096,11,1107,1689,0,0,0,0,0,0,65.54
臺中市,北屯區,北屯里,375,1,1003,16,1019,1743,0,0,0,0,0,0,58.46
臺中市,北屯區,北屯里,376,1,1071,9,1080,1723,0,0,0,0,0,0,62.68
臺中市,北屯區,北興里,377,1,1043,13,1056,1687,0,0,0,0,0,0,62.60
臺中市,北屯區,北興里,378,1,928,8,936,1463,0,0,0,0,0,0,63.98
臺中市,北屯區,三光里,379,1,864,6,870,1566,0,0,0,0,0,0,55.56
臺中市,北屯區,三光里,380,1,736,4,740,1308,0,0,0,0,0,0,56.57
臺中市,北屯區,三光里,381,1,685,4,689,1076,0,0,0,0,0,0,64.03
臺中市,北屯區,三光里,382,1,1266,10,1276,2257,0,0,0,0,0,0,56.54
臺中市,北屯區,三光里,383,1,967,10,977,1668,0,0,0,0,0,0,58.57
臺中市,北屯區,三光里,384,1,652,6,658,1020,0,0,0,0,0,0,64.51
臺中市,北屯區,平田里,385,1,1177,9,1186,2040,0,0,0,0,0,0,58.14
臺中市,北屯區,平田里,386,1,1097,14,1111,1906,0,0,0,0,0,0,58.29
臺中市,北屯區,平田里,387,1,1066,17,1083,1831,0,0,0,0,0,0,59.15
臺中市,北屯區,平田里,388,1,672,8,680,1230,0,0,0,0,0,0,55.28
臺中市,北屯區,平田里,389,1,844,11,855,1424,0,0,0,0,0,0,60.04
臺中市,北屯區,平和里,390,1,942,15,957,1674,0,0,0,0,0,0,57.17
臺中市,北屯區,平和里,391,1,856,6,862,1575,0,0,0,0,0,0,54.73
臺中市,北屯區,平和里,392,1,779,9,788,1335,0,0,0,0,0,0,59.03
臺中市,北屯區,平和里,393,1,833,13,846,1394,0,0,0,0,0,0,60.69
臺中市,北屯區,平安里,394,1,814,17,831,1240,0,0,0,0,0,0,67.02
臺中市,北屯區,平安里,395,1,749,13,762,1254,0,0,0,0,0,0,60.77
臺中市,北屯區,平安里,396,1,820,12,832,1386,0,0,0,0,0,0,60.03
臺中市,北屯區,平順里,397,1,800,9,809,1394,0,0,0,0,0,0,58.03
臺中市,北屯區,平順里,398,1,760,10,770,1414,0,0,0,0,0,0,54.46
臺中市,北屯區,平順里,399,1,971,12,983,1658,0,0,0,0,0,0,59.29
臺中市,北屯區,平順里,400,1,1025,13,1038,1586,0,0,0,0,0,0,65.45
臺中市,北屯區,平德里,401,1,634,7,641,1186,0,0,0,0,0,0,54.05
臺中市,北屯區,平德里,402,1,773,8,781,1283,0,0,0,0,0,0,60.87
臺中市,北屯區,平德里,403,1,816,9,825,1286,0,0,0,0,0,0,64.15
臺中市,北屯區,東光里,404,1,1058,9,1067,1628,0,0,0,0,0,0,65.54
臺中市,北屯區,東光里,405,1,1040,21,1061,1723,0,0,0,0,0,0,61.58
臺中市,北屯區,舊社里,406,1,827,9,836,1258,0,0,0,0,0,0,66.45
臺中市,北屯區,舊社里,407,1,920,11,931,1617,0,0,0,0,0,0,57.58
臺中市,北屯區,舊社里,408,1,833,8,841,1426,0,0,0,0,0,0,58.98
臺中市,北屯區,水景里,409,1,833,12,845,1280,0,0,0,0,0,0,66.02
臺中市,北屯區,水景里,410,1,1178,9,1187,1787,0,0,0,0,0,0,66.42
臺中市,北屯區,水景里,411,1,1056,9,1065,1681,0,0,0,0,0,0,63.36
臺中市,北屯區,軍功里,412,1,1005,10,1015,1518,0,0,0,0,0,0,66.86
臺中市,北屯區,軍功里,413,1,928,17,945,1304,0,0,0,0,0,0,72.47
臺中市,北屯區,軍功里,414,1,878,11,889,1318,0,0,0,0,0,0,67.45
臺中市,北屯區,軍功里,415,1,847,14,861,1438,0,0,0,0,0,0,59.87
臺中市,北屯區,和平里,416,1,1167,12,1179,1717,0,0,0,0,0,0,68.67
臺中市,北屯區,和平里,417,1,977,7,984,1537,0,0,0,0,0,0,64.02
臺中市,北屯區,和平里,418,1,437,2,439,718,0,0,0,0,0,0,61.14
臺中市,北屯區,東山里,419,1,1037,9,1046,1484,0,0,0,0,0,0,70.49
臺中市,北屯區,部子里,420,1,488,4,492,780,0,0,0,0,0,0,63.08
臺中市,北屯區,部子里,421,1,664,26,690,1012,0,0,0,0,0,0,68.18
臺中市,北屯區,民政里,422,1,641,3,644,894,0,0,0,0,0,0,72.04
臺中市,北屯區,民德里,423,1,512,3,515,708,0,0,0,0,0,0,72.74
臺中市,北屯區,大坑里,424,1,950,15,965,1338,0,0,0,0,0,0,72.12
臺中市,北屯區,松竹里,425,1,796,8,804,1285,0,0,0,0,0,0,62.57
臺中市,北屯區,松竹里,426,1,871,15,886,1364,0,0,0,0,0,0,64.96
臺中市,北屯區,松竹里,427,1,722,7,729,1241,0,0,0,0,0,0,58.74
臺中市,北屯區,松安里,428,1,826,14,840,1387,0,0,0,0,0,0,60.56
臺中市,北屯區,松安里,429,1,618,9,627,1193,0,0,0,0,0,0,52.56
臺中市,北屯區,松安里,430,1,580,5,585,1011,0,0,0,0,0,0,57.86
臺中市,北屯區,松安里,431,1,632,11,643,1075,0,0,0,0,0,0,59.81
臺中市,北屯區,松安里,432,1,741,2,743,1230,0,0,0,0,0,0,60.41
臺中市,北屯區,松安里,433,1,640,4,644,1109,0,0,0,0,0,0,58.07
臺中市,北屯區,松茂里,434,1,872,10,882,1626,0,0,0,0,0,0,54.24
臺中市,北屯區,松茂里,435,1,881,11,892,1589,0,0,0,0,0,0,56.14
臺中市,北屯區,松茂里,436,1,848,9,857,1389,0,0,0,0,0,0,61.70
臺中市,北屯區,松茂里,437,1,835,12,847,1389,0,0,0,0,0,0,60.98
臺中市,北屯區,松茂里,438,1,901,10,911,1515,0,0,0,0,0,0,60.13
臺中市,北屯區,松茂里,439,1,871,5,876,1480,0,0,0,0,0,0,59.19
臺中市,北屯區,仁和里,440,1,1090,16,1106,1579,0,0,0,0,0,0,70.04
臺中市,北屯區,仁和里,441,1,934,6,940,1315,0,0,0,0,0,0,71.48
臺中市,北屯區,仁和里,442,1,1006,5,1011,1437,0,0,0,0,0,0,70.35
臺中市,北屯區,仁和里,443,1,870,11,881,1258,0,0,0,0,0,0,70.03
臺中市,北屯區,仁美里,444,1,1140,20,1160,1622,0,0,0,0,0,0,71.52
臺中市,北屯區,仁美里,445,1,1181,45,1226,1614,0,0,0,0,0,0,75.96
臺中市,北屯區,仁美里,446,1,1203,14,1217,1636,0,0,0,0,0,0,74.39
臺中市,北屯區,四民里,447,1,783,7,790,1005,0,0,0,0,0,0,78.61
臺中市,北屯區,同榮里,448,1,1104,15,1119,1454,0,0,0,0,0,0,76.96
臺中市,北屯區,同榮里,449,1,936,8,944,1411,0,0,0,0,0,0,66.90
臺中市,北屯區,同榮里,450,1,993,15,1008,1673,0,0,0,0,0,0,60.25
臺中市,北屯區,后庄里,451,1,1051,14,1065,1693,0,0,0,0,0,0,62.91
臺中市,北屯區,后庄里,452,1,862,13,875,1334,0,0,0,0,0,0,65.59
臺中市,北屯區,后庄里,453,1,797,7,804,1180,0,0,0,0,0,0,68.14
臺中市,北屯區,陳平里,454,1,702,12,714,1228,0,0,0,0,0,0,58.14
臺中市,北屯區,陳平里,455,1,810,9,819,1389,0,0,0,0,0,0,58.96
臺中市,北屯區,陳平里,456,1,1008,10,1018,1516,0,0,0,0,0,0,67.15
臺中市,北屯區,陳平里,457,1,1023,14,1037,1858,0,0,0,0,0,0,55.81
臺中市,北屯區,大德里,458,1,761,10,771,1251,0,0,0,0,0,0,61.63
臺中市,北屯區,大德里,459,1,749,4,753,1145,0,0,0,0,0,0,65.76
臺中市,北屯區,大德里,460,1,760,6,766,1172,0,0,0,0,0,0,65.36
臺中市,北屯區,新平里,461,1,914,12,926,1593,0,0,0,0,0,0,58.13
臺中市,北屯區,新平里,462,1,881,17,898,1324,0,0,0,0,0,0,67.82
臺中市,北屯區,新平里,463,1,754,14,768,1238,0,0,0,0,0,0,62.04
臺中市,北屯區,仁愛里,464,1,562,7,569,807,0,0,0,0,0,0,70.51
臺中市,北屯區,水湳里,465,1,777,8,785,1215,0,0,0,0,0,0,64.61
臺中市,北屯區,水湳里,466,1,747,11,758,1189,0,0,0,0,0,0,63.75
臺中市,北屯區,水湳里,467,1,1023,11,1034,1593,0,0,0,0,0,0,64.91
臺中市,北屯區,水湳里,468,1,838,11,849,1270,0,0,0,0,0,0,66.85
嘉義市,東區,短竹里,1,1,723,8,731,1236,0,0,0,0,0,0,59.14
嘉義市,東區,短竹里,2,1,556,7,563,1083,0,0,0,0,0,0,51.99
嘉義市,東區,短竹里,3,1,785,14,799,1313,0,0,0,0,0,0,60.85
嘉義市,東區,東川里,4,1,501,3,504,823,0,0,0,0,0,0,61.24
嘉義市,東區,東川里,5,1,570,5,575,920,0,0,0,0,0,0,62.50
嘉義市,東區,鹿寮里,6,1,374,8,382,587,0,0,0,0,0,0,65.08
嘉義市,東區,盧厝里,7,1,569,9,578,892,0,0,0,0,0,0,64.80
嘉義市,東區,盧厝里,8,1,865,6,871,1691,0,0,0,0,0,0,51.51
嘉義市,東區,東平里,9,1,533,6,539,885,0,0,0,0,0,0,60.90
嘉義市,東區,太平里,10,1,483,8,491,834,0,0,0,0,0,0,58.87
嘉義市,東區,太平里,11,1,458,3,461,770,0,0,0,0,0,0,59.87
嘉義市,東區,太平里,12,1,395,8,403,673,0,0,0,0,0,0,59.88
嘉義市,東區,太平里,13,1,491,1,492,822,0,0,0,0,0,0,59.85
嘉義市,東區,王田里,14,1,626,8,634,1080,0,0,0,0,0,0,58.70
嘉義市,東區,王田里,15,1,600,13,613,1086,0,0,0,0,0,0,56.45
嘉義市,東區,長竹里,16,1,773,4,777,1106,0,0,0,0,0,0,70.25
嘉義市,東區,長竹里,17,1,712,7,719,1165,0,0,0,0,0,0,61.72
嘉義市,東區,後庄里,18,1,663,9,672,1252,0,0,0,0,0,0,53.67
嘉義市,東區,後庄里,19,1,535,3,538,916,0,0,0,0,0,0,58.73
嘉義市,東區,後庄里,20,1,451,9,460,808,0,0,0,0,0,0,56.93
嘉義市,東區,新店里,21,1,715,7,722,1163,0,0,0,0,0,0,62.08
嘉義市,東區,新店里,22,1,479,6,485,884,0,0,0,0,0,0,54.86
嘉義市,東區,新店里,23,1,482,3,485,881,0,0,0,0,0,0,55.05
嘉義市,東區,圳頭里,24,1,827,9,836,1168,0,0,0,0,0,0,71.58
嘉義市,東區,圳頭里,25,1,663,13,676,985,0,0,0,0,0,0,68.63
嘉義市,東區,圳頭里,26,1,900,14,914,1536,0,0,0,0,0,0,59.51
嘉義市,東區,東噴里,27,1,727,10,737,1274,0,0,0,0,0,0,57.85
嘉義市,東區,希康里,28,1,246,0,246,335,0,0,0,0,0,0,73.43
嘉義市,東區,東山里,29,1,285,3,288,487,0,0,0,0,0,0,59.14
嘉義市,東區,東安里,30,1,314,5,319,533,0,0,0,0,0,0,59.85
嘉義市,東區,大街里,31,1,301,4,305,511,0,0,0,0,0,0,59.69
嘉義市,東區,祐民里,32,1,397,5,402,611,0,0,0,0,0,0,65.79
嘉義市,東區,東仁里,33,1,330,2,332,550,0,0,0,0,0,0,60.36
嘉義市,東區,內安里,34,1,299,2,301,480,0,0,0,0,0,0,62.71
嘉義市,東區,雲霄里,35,1,399,3,402,643,0,0,0,0,0,0,62.52
嘉義市,東區,雲霄里,36,1,393,7,400,661,0,0,0,0,0,0,60.51
嘉義市,東區,建國里,37,1,368,3,371,625,0,0,0,0,0,0,59.36
嘉義市,東區,府路里,38,1,581,2,583,998,0,0,0,0,0,0,58.42
嘉義市,東區,鎮南里,39,1,238,1,239,395,0,0,0,0,0,0,60.51
嘉義市,東區,神農里,40,1,657,6,663,1039,0,0,0,0,0,0,63.81
嘉義市,東區,崇文里,41,1,390,1,391,649,0,0,0,0,0,0,60.25
嘉義市,東區,龍山里,42,1,397,4,401,741,0,0,0,0,0,0,54.12
嘉義市,東區,安平里,43,1,449,4,453,777,0,0,0,0,0,0,58.30
嘉義市,東區,文昌里,44,1,414,2,416,682,0,0,0,0,0,0,61.00
嘉義市,東區,志航里,45,1,807,10,817,1250,0,0,0,0,0,0,65.36
嘉義市,東區,蘭井里,46,1,361,2,363,638,0,0,0,0,0,0,56.90
嘉義市,東區,光復里,47,1,721,6,727,1156,0,0,0,0,0,0,62.89
嘉義市,東區,初陽里,48,1,717,9,726,1242,0,0,0,0,0,0,58.45
嘉義市,東區,震安里,49,1,514,2,516,818,0,0,0,0,0,0,63.08
嘉義市,東區,新開里,50,1,400,4,404,688,0,0,0,0,0,0,58.72
嘉義市,東區,新開里,51,1,371,1,372,649,0,0,0,0,0,0,57.32
嘉義市,東區,宣信里,52,1,532,5,537,1000,0,0,0,0,0,0,53.70
嘉義市,東區,宣信里,53,1,506,3,509,939,0,0,0,0,0,0,54.21
嘉義市,東區,興南里,54,1,353,4,357,610,0,0,0,0,0,0,58.52
嘉義市,東區,興南里,55,1,439,4,443,741,0,0,0,0,0,0,59.78
嘉義市,東區,豐年里,56,1,441,2,443,711,0,0,0,0,0,0,62.31
嘉義市,東區,豐年里,57,1,417,7,424,828,0,0,0,0,0,0,51.21
嘉義市,東區,芳草里,58,1,648,5,653,1133,0,0,0,0,0,0,57.63
嘉義市,東區,芳草里,59,1,519,5,524,920,0,0,0,0,0,0,56.96
嘉義市,東區,芳草里,60,1,523,11,534,1017,0,0,0,0,0,0,52.51
嘉義市,東區,芳安里,61,1,710,11,721,1251,0,0,0,0,0,0,57.63
嘉義市,東區,芳安里,62,1,478,5,483,777,0,0,0,0,0,0,62.16
嘉義市,東區,頂寮里,63,1,633,7,640,1053,0,0,0,0,0,0,60.78
嘉義市,東區,頂寮里,64,1,510,3,513,865,0,0,0,0,0,0,59.31
嘉義市,東區,安寮里,65,1,531,4,535,953,0,0,0,0,0,0,56.14
嘉義市,東區,安寮里,66,1,493,3,496,974,0,0,0,0,0,0,50.92
嘉義市,東區,安寮里,67,1,605,6,611,1144,0,0,0,0,0,0,53.41
嘉義市,東區,安寮里,68,1,703,7,710,1372,0,0,0,0,0,0,51.75
嘉義市,東區,興村里,69,1,743,8,751,1197,0,0,0,0,0,0,62.74
嘉義市,東區,興村里,70,1,764,10,774,1418,0,0,0,0,0,0,54.58
嘉義市,東區,興安里,71,1,607,7,614,1051,0,0,0,0,0,0,58.42
嘉義市,東區,興安里,72,1,598,6,604,953,0,0,0,0,0,0,63.38
嘉義市,東區,興仁里,73,1,710,9,719,1347,0,0,0,0,0,0,53.38
嘉義市,東區,興仁里,74,1,792,5,797,1492,0,0,0,0,0,0,53.42
嘉義市,東區,北城里,75,1,522,9,531,874,0,0,0,0,0,0,60.76
嘉義市,東區,仁武里,76,1,495,9,504,673,0,0,0,0,0,0,74.89
嘉義市,東區,泰安里,77,1,732,10,742,1113,0,0,0,0,0,0,66.67
嘉義市,東區,檜村里,78,1,583,4,587,975,0,0,0,0,0,0,60.21
嘉義市,東區,檜村里,79,1,294,4,298,505,0,0,0,0,0,0,59.01
嘉義市,東區,社口里,80,1,582,14,596,881,0,0,0,0,0,0,67.65
嘉義市,東區,仁和里,81,1,324,1,325,496,0,0,0,0,0,0,65.52
嘉義市,東區,中庄里,82,1,697,1,698,1165,0,0,0,0,0,0,59.91
嘉義市,東區,中庄里,83,1,773,9,782,1261,0,0,0,0,0,0,62.01
嘉義市,東區,仁義里,84,1,610,10,620,1093,0,0,0,0,0,0,56.72
嘉義市,東區,仁義里,85,1,483,7,490,924,0,0,0,0,0,0,53.03
嘉義市,東區,後湖里,86,1,920,15,935,1480,0,0,0,0,0,0,63.18
嘉義市,東區,後湖里,87,1,782,12,794,1277,0,0,0,0,0,0,62.18
嘉義市,東區,荖藤里,88,1,526,5,531,1045,0,0,0,0,0,0,50.81
嘉義市,東區,荖藤里,89,1,601,6,607,1050,0,0,0,0,0,0,57.81
嘉義市,東區,頂庄里,90,1,621,11,632,1106,0,0,0,0,0,0,57.14
嘉義市,東區,頂庄里,91,1,620,7,627,1129,0,0,0,0,0,0,55.54
嘉義市,東區,頂庄里,92,1,458,6,464,894,0,0,0,0,0,0,51.90
嘉義市,東區,頂庄里,93,1,601,7,608,972,0,0,0,0,0,0,62.55
嘉義市,西區,書院里,94,1,637,10,647,1039,0,0,0,0,0,0,62.27
嘉義市,西區,驛站里,95,1,397,5,402,651,0,0,0,0,0,0,61.75
嘉義市,西區,民安里,96,1,333,3,336,567,0,0,0,0,0,0,59.26
嘉義市,西區,菜園里,97,1,424,6,430,671,0,0,0,0,0,0,64.08
嘉義市,西區,集英里,98,1,340,1,341,595,0,0,0,0,0,0,57.31
嘉義市,西區,福松里,99,1,556,3,559,832,0,0,0,0,0,0,67.19
嘉義市,西區,義昌里,100,1,409,8,417,590,0,0,0,0,0,0,70.68
嘉義市,西區,自治里,101,1,691,9,700,1023,0,0,0,0,0,0,68.43
嘉義市,西區,大業里,102,1,544,8,552,906,0,0,0,0,0,0,60.93
嘉義市,西區,中庸里,103,1,517,4,521,864,0,0,0,0,0,0,60.30
嘉義市,西區,學圃里,104,1,361,4,365,550,0,0,0,0,0,0,66.36
嘉義市,西區,北杏里,105,1,477,2,479,809,0,0,0,0,0,0,59.21
嘉義市,西區,社內里,106,1,340,0,340,550,0,0,0,0,0,0,61.82
嘉義市,西區,民生里,107,1,348,6,354,556,0,0,0,0,0,0,63.67
嘉義市,西區,慶昇里,108,1,271,3,274,436,0,0,0,0,0,0,62.84
嘉義市,西區,通運里,109,1,253,5,258,440,0,0,0,0,0,0,58.64
嘉義市,西區,榮檜里,110,1,369,8,377,642,0,0,0,0,0,0,58.72
嘉義市,西區,功科里,111,1,486,2,488,722,0,0,0,0,0,0,67.59
嘉義市,西區,康莊里,112,1,409,1,410,655,0,0,0,0,0,0,62.60
嘉義市,西區,福全里,113,1,687,7,694,1219,0,0,0,0,0,0,56.93
嘉義市,西區,福全里,114,1,691,4,695,1297,0,0,0,0,0,0,53.59
嘉義市,西區,福全里,115,1,654,6,660,1121,0,0,0,0,0,0,58.88
嘉義市,西區,福全里,116,1,737,8,745,1459,0,0,0,0,0,0,51.06
嘉義市,西區,力行里,117,1,594,3,597,1012,0,0,0,0,0,0,58.99
嘉義市,西區,劉厝里,118,1,541,7,548,1011,0,0,0,0,0,0,54.20
嘉義市,西區,劉厝里,119,1,676,5,681,1316,0,0,0,0,0,0,51.75
嘉義市,西區,劉厝里,120,1,371,1,372,663,0,0,0,0,0,0,56.11
嘉義市,西區,港坪里,121,1,900,12,912,1475,0,0,0,0,0,0,61.83
嘉義市,西區,頭港里,122,1,644,10,654,1089,0,0,0,0,0,0,60.06
嘉義市,西區,西平里,123,1,744,10,754,1215,0,0,0,0,0,0,62.06
嘉義市,西區,大溪里,124,1,481,8,489,871,0,0,0,0,0,0,56.14
嘉義市,西區,大溪里,125,1,479,6,485,782,0,0,0,0,0,0,62.02
嘉義市,西區,磚窯里,126,1,772,15,787,1303,0,0,0,0,0,0,60.40
嘉義市,西區,磚窯里,127,1,818,8,826,1419,0,0,0,0,0,0,58.21
嘉義市,西區,新西里,128,1,527,7,534,934,0,0,0,0,0,0,57.17
嘉義市,西區,新西里,129,1,635,3,638,1195,0,0,0,0,0,0,53.39
嘉義市,西區,華明里,130,1,465,5,470,761,0,0,0,0,0,0,61.76
嘉義市,西區,導民里,131,1,291,4,295,540,0,0,0,0,0,0,54.63
嘉義市,西區,導民里,132,1,433,2,435,767,0,0,0,0,0,0,56.71
嘉義市,西區,培元里,133,1,576,9,585,1052,0,0,0,0,0,0,55.61
嘉義市,西區,垂楊里,134,1,503,8,511,869,0,0,0,0,0,0,58.80
嘉義市,西區,垂楊里,135,1,580,2,582,1047,0,0,0,0,0,0,55.59
嘉義市,西區,車店里,136,1,593,5,598,1141,0,0,0,0,0,0,52.41
嘉義市,西區,車店里,137,1,644,6,650,1102,0,0,0,0,0,0,58.98
嘉義市,西區,車店里,138,1,765,2,767,1385,0,0,0,0,0,0,55.38
嘉義市,西區,福民里,139,1,637,5,642,1077,0,0,0,0,0,0,59.61
嘉義市,西區,福民里,140,1,616,4,620,1039,0,0,0,0,0,0,59.67
嘉義市,西區,福民里,141,1,644,5,649,1082,0,0,0,0,0,0,59.98
嘉義市,西區,湖內里,142,1,587,9,596,1029,0,0,0,0,0,0,57.92
嘉義市,西區,湖內里,143,1,630,4,634,1153,0,0,0,0,0,0,54.99
嘉義市,西區,湖內里,144,1,703,6,709,1310,0,0,0,0,0,0,54.12
嘉義市,西區,湖內里,145,1,577,4,581,1084,0,0,0,0,0,0,53.60
嘉義市,西區,湖內里,146,1,580,6,586,1045,0,0,0,0,0,0,56.08
嘉義市,西區,美源里,147,1,703,3,706,1053,0,0,0,0,0,0,67.05
嘉義市,西區,美源里,148,1,706,6,712,1220,0,0,0,0,0,0,58.36
嘉義市,西區,美源里,149,1,507,1,508,867,0,0,0,0,0,0,58.59
嘉義市,西區,光路里,150,1,627,9,636,1052,0,0,0,0,0,0,60.46
嘉義市,西區,光路里,151,1,813,9,822,1367,0,0,0,0,0,0,60.13
嘉義市,西區,光路里,152,1,707,13,720,1303,0,0,0,0,0,0,55.26
嘉義市,西區,育英里,153,1,629,5,634,1095,0,0,0,0,0,0,57.90
嘉義市,西區,育英里,154,1,616,2,618,1125,0,0,0,0,0,0,54.93
嘉義市,西區,致遠里,155,1,383,4,387,639,0,0,0,0,0,0,60.56
嘉義市,西區,翠岱里,156,1,298,10,308,478,0,0,0,0,0,0,64.44
嘉義市,西區,自強里,157,1,533,4,537,883,0,0,0,0,0,0,60.82
嘉義市,西區,自強里,158,1,528,8,536,882,0,0,0,0,0,0,60.77
嘉義市,西區,長安里,159,1,766,11,777,1264,0,0,0,0,0,0,61.47
嘉義市,西區,北榮里,160,1,508,8,516,912,0,0,0,0,0,0,56.58
嘉義市,西區,北榮里,161,1,537,3,540,881,0,0,0,0,0,0,61.29
嘉義市,西區,重興里,162,1,575,7,582,1111,0,0,0,0,0,0,52.39
嘉義市,西區,重興里,163,1,570,13,583,927,0,0,0,0,0,0,62.89
嘉義市,西區,慶昌里,164,1,300,4,304,550,0,0,0,0,0,0,55.27
嘉義市,西區,小湖里,165,1,488,7,495,678,0,0,0,0,0,0,73.01
嘉義市,西區,竹文里,166,1,492,5,497,736,0,0,0,0,0,0,67.53
嘉義市,西區,竹文里,167,1,431,9,440,669,0,0,0,0,0,0,65.77
嘉義市,西區,香湖里,168,1,722,7,729,1289,0,0,0,0,0,0,56.56
嘉義市,西區,湖邊里,169,1,445,6,451,838,0,0,0,0,0,0,53.82
嘉義市,西區,湖邊里,170,1,492,5,497,886,0,0,0,0,0,0,56.09
嘉義市,西區,竹圍里,171,1,981,20,1001,1548,0,0,0,0,0,0,64.66
嘉義市,西區,竹圍里,172,1,637,5,642,1055,0,0,0,0,0,0,60.85
嘉義市,西區,竹圍里,173,1,495,2,497,882,0,0,0,0,0,0,56.35
嘉義市,西區,保安里,174,1,825,11,836,1293,0,0,0,0,0,0,64.66
嘉義市,西區,保安里,175,1,842,9,851,1229,0,0,0,0,0,0,69.24
嘉義市,西區,保安里,176,1,684,8,692,1205,0,0,0,0,0,0,57.43
嘉義市,西區,保安里,177,1,765,10,775,1289,0,0,0,0,0,0,60.12
嘉義市,西區,保安里,178,1,612,8,620,1187,0,0,0,0,0,0,52.23
嘉義市,西區,保安里,179,1,683,11,694,1262,0,0,0,0,0,0,54.99
嘉義市,西區,新厝里,180,1,592,7,599,955,0,0,0,0,0,0,62.72
嘉義市,西區,新厝里,181,1,633,5,638,1108,0,0,0,0,0,0,57.58
嘉義市,西區,新厝里,182,1,571,5,576,967,0,0,0,0,0,0,59.57
嘉義市,西區,北湖里,183,1,633,5,638,1051,0,0,0,0,0,0,60.70
嘉義市,西區,北湖里,184,1,673,10,683,1102,0,0,0,0,0,0,61.98
嘉義市,西區,下埤里,185,1,556,8,564,1105,0,0,0,0,0,0,51.04
嘉義市,西區,竹村里,186,1,507,6,513,862,0,0,0,0,0,0,59.51
臺南市,東區,崇學里,1,1,663,9,672,1196,0,0,0,0,0,0,56.19
臺南市,東區,崇學里,2,1,996,9,1005,1810,0,0,0,0,0,0,55.52
臺南市,東區,崇學里,3,1,799,6,805,1487,0,0,0,0,0,0,54.14
臺南市,東區,崇學里,4,1,733,5,738,1247,0,0,0,0,0,0,59.18
臺南市,東區,崇德里,5,1,1133,12,1145,1827,0,0,0,0,0,0,62.67
臺南市,東區,崇德里,6,1,1025,9,1034,1732,0,0,0,0,0,0,59.70
臺南市,東區,崇善里,7,1,803,13,816,1336,0,0,0,0,0,0,61.08
臺南市,東區,崇善里,8,1,770,10,780,1394,0,0,0,0,0,0,55.95
臺南市,東區,崇成里,9,1,1119,12,1131,1815,0,0,0,0,0,0,62.31
臺南市,東區,崇成里,10,1,1151,8,1159,2014,0,0,0,0,0,0,57.55
臺南市,東區,崇成里,11,1,889,4,893,1413,0,0,0,0,0,0,63.20
臺南市,東區,大智里,12,1,736,17,753,1195,0,0,0,0,0,0,63.01
臺南市,東區,大智里,13,1,949,13,962,1545,0,0,0,0,0,0,62.27
臺南市,東區,大智里,14,1,845,9,854,1370,0,0,0,0,0,0,62.34
臺南市,東區,東智里,15,1,1122,19,1141,1765,0,0,0,0,0,0,64.65
臺南市,東區,德高里,16,1,580,7,587,965,0,0,0,0,0,0,60.83
臺南市,東區,德高里,17,1,847,17,864,1539,0,0,0,0,0,0,56.14
臺南市,東區,和平里,18,1,606,7,613,959,0,0,0,0,0,0,63.92
臺南市,東區,和平里,19,1,797,8,805,1275,0,0,0,0,0,0,63.14
臺南市,東區,仁和里,20,1,703,7,710,1101,0,0,0,0,0,0,64.49
臺南市,東區,仁和里,21,1,814,10,824,1519,0,0,0,0,0,0,54.25
臺南市,東區,虎尾里,22,1,917,16,933,1492,0,0,0,0,0,0,62.53
臺南市,東區,虎尾里,23,1,974,10,984,1780,0,0,0,0,0,0,55.28
臺南市,東區,虎尾里,24,1,1075,6,1081,1763,0,0,0,0,0,0,61.32
臺南市,東區,自強里,25,1,881,12,893,1634,0,0,0,0,0,0,54.65
臺南市,東區,自強里,26,1,1064,15,1079,1930,0,0,0,0,0,0,55.91
臺南市,東區,自強里,27,1,994,10,1004,1832,0,0,0,0,0,0,54.80
臺南市,東區,東聖里,28,1,675,7,682,1121,0,0,0,0,0,0,60.84
臺南市,東區,東聖里,29,1,545,6,551,931,0,0,0,0,0,0,59.18
臺南市,東區,關聖里,30,1,817,14,831,1349,0,0,0,0,0,0,61.60
臺南市,東區,關聖里,31,1,1002,14,1016,1629,0,0,0,0,0,0,62.37
臺南市,東區,後甲里,32,1,679,3,682,1131,0,0,0,0,0,0,60.30
臺南市,東區,後甲里,33,1,852,6,858,1433,0,0,0,0,0,0,59.87
臺南市,東區,復國里,34,1,723,8,731,1068,0,0,0,0,0,0,68.45
臺南市,東區,復國里,35,1,712,3,715,1033,0,0,0,0,0,0,69.22
臺南市,東區,中興里,36,1,636,4,640,922,0,0,0,0,0,0,69.41
臺南市,東區,中興里,37,1,631,4,635,934,0,0,0,0,0,0,67.99
臺南市,東區,東光里,38,1,869,8,877,1515,0,0,0,0,0,0,57.89
臺南市,東區,東光里,39,1,1002,6,1008,1776,0,0,0,0,0,0,56.76
臺南市,東區,東明里,40,1,786,6,792,1401,0,0,0,0,0,0,56.53
臺南市,東區,東明里,41,1,871,5,876,1578,0,0,0,0,0,0,55.51
臺南市,東區,莊敬里,42,1,828,11,839,1353,0,0,0,0,0,0,62.01
臺南市,東區,莊敬里,43,1,781,3,784,1334,0,0,0,0,0,0,58.77
臺南市,東區,小東里,44,1,760,11,771,1308,0,0,0,0,0,0,58.94
臺南市,東區,小東里,45,1,739,3,742,1227,0,0,0,0,0,0,60.47
臺南市,東區,小東里,46,1,690,3,693,1141,0,0,0,0,0,0,60.74
臺南市,東區,大學里,47,1,855,5,860,1454,0,0,0,0,0,0,59.15
臺南市,東區,育樂里,48,1,526,10,536,900,0,0,0,0,0,0,59.56
臺南市,東區,前鋒里,49,1,443,7,450,777,0,0,0,0,0,0,57.92
臺南市,東區,大廟里,50,1,649,9,658,1185,0,0,0,0,0,0,55.53
臺南市,東區,泉北里,51,1,651,5,656,1131,0,0,0,0,0,0,58.00
臺南市,東區,圍上里,52,1,470,11,481,777,0,0,0,0,0,0,61.90
臺南市,東區,圍下里,53,1,585,7,592,1006,0,0,0,0,0,0,58.85
臺南市,東區,圍下里,54,1,451,7,458,800,0,0,0,0,0,0,57.25
臺南市,東區,中西里,55,1,795,6,801,1372,0,0,0,0,0,0,58.38
臺南市,東區,中西里,56,1,754,9,763,1365,0,0,0,0,0,0,55.90
臺南市,東區,東安里,57,1,947,16,963,1699,0,0,0,0,0,0,56.68
臺南市,東區,新東里,58,1,686,7,693,1201,0,0,0,0,0,0,57.70
臺南市,東區,新東里,59,1,665,12,677,1151,0,0,0,0,0,0,58.82
臺南市,東區,崇誨里,60,1,914,7,921,1457,0,0,0,0,0,0,63.21
臺南市,東區,崇誨里,61,1,686,7,693,1245,0,0,0,0,0,0,55.66
臺南市,東區,衛國里,62,1,886,9,895,1542,0,0,0,0,0,0,58.04
臺南市,東區,裕農里,63,1,733,8,741,1246,0,0,0,0,0,0,59.47
臺南市,東區,裕農里,64,1,794,12,806,1386,0,0,0,0,0,0,58.15
臺南市,東區,富裕里,65,1,530,2,532,951,0,0,0,0,0,0,55.94
臺南市,東區,富裕里,66,1,623,4,627,1060,0,0,0,0,0,0,59.15
臺南市,東區,富強里,67,1,1365,14,1379,2043,0,0,0,0,0,0,67.50
臺南市,東區,富強里,68,1,1117,12,1129,1699,0,0,0,0,0,0,66.45
臺南市,東區,崇明里,69,1,1066,5,1071,1892,0,0,0,0,0,0,56.61
臺南市,東區,大德里,70,1,1026,7,1033,1771,0,0,0,0,0,0,58.33
臺南市,東區,忠孝里,71,1,752,10,762,991,0,0,0,0,0,0,76.89
臺南市,東區,忠孝里,72,1,766,5,771,1356,0,0,0,0,0,0,56.86
臺南市,東區,忠孝里,73,1,591,6,597,1117,0,0,0,0,0,0,53.45
臺南市,東區,忠孝里,74,1,723,6,729,1226,0,0,0,0,0,0,59.46
臺南市,東區,大福里,75,1,622,10,632,1025,0,0,0,0,0,0,61.66
臺南市,東區,大福里,76,1,565,11,576,912,0,0,0,0,0,0,63.16
臺南市,東區,路東里,77,1,753,9,762,1335,0,0,0,0,0,0,57.08
臺南市,東區,府宅里,78,1,750,9,759,1200,0,0,0,0,0,0,63.25
臺南市,東區,川東里,79,1,491,7,498,812,0,0,0,0,0,0,61.33
臺南市,東區,大興里,80,1,632,9,641,1093,0,0,0,0,0,0,58.65
臺南市,東區,泉南里,81,1,1122,12,1134,1935,0,0,0,0,0,0,58.60
臺南市,東區,泉南里,82,1,1207,22,1229,2019,0,0,0,0,0,0,60.87
臺南市,東區,龍山里,83,1,875,9,884,1522,0,0,0,0,0,0,58.08
臺南市,東區,龍山里,84,1,1100,10,1110,1974,0,0,0,0,0,0,56.23
臺南市,東區,龍山里,85,1,856,10,866,1518,0,0,0,0,0,0,57.05
臺南市,南區,大恩里,86,1,834,10,844,1413,0,0,0,0,0,0,59.73
臺南市,南區,大恩里,87,1,913,7,920,1536,0,0,0,0,0,0,59.90
臺南市,南區,大林里,88,1,637,9,646,1076,0,0,0,0,0,0,60.04
臺南市,南區,大林里,89,1,564,6,570,996,0,0,0,0,0,0,57.23
臺南市,南區,大忠里,90,1,716,8,724,1191,0,0,0,0,0,0,60.79
臺南市,南區,大忠里,91,1,826,14,840,1487,0,0,0,0,0,0,56.49
臺南市,南區,大忠里,92,1,921,8,929,1442,0,0,0,0,0,0,64.42
臺南市,南區,新生里,93,1,286,4,290,513,0,0,0,0,0,0,56.53
臺南市,南區,竹溪里,94,1,755,15,770,1345,0,0,0,0,0,0,57.25
臺南市,南區,明德里,95,1,690,11,701,1074,0,0,0,0,0,0,65.27
臺南市,南區,興中里,96,1,851,8,859,1255,0,0,0,0,0,0,68.45
臺南市,南區,荔宅里,97,1,939,14,953,1444,0,0,0,0,0,0,66.00
臺南市,南區,大成里,98,1,615,7,622,1012,0,0,0,0,0,0,61.46
臺南市,南區,田寮里,99,1,506,3,509,913,0,0,0,0,0,0,55.75
臺南市,南區,田寮里,100,1,861,8,869,1447,0,0,0,0,0,0,60.06
臺南市,南區,田寮里,101,1,609,5,614,976,0,0,0,0,0,0,62.91
臺南市,南區,新興里,102,1,707,9,716,1216,0,0,0,0,0,0,58.88
臺南市,南區,新興里,103,1,787,6,793,1387,0,0,0,0,0,0,57.17
臺南市,南區,再興里,104,1,677,5,682,1063,0,0,0,0,0,0,64.16
臺南市,南區,再興里,105,1,576,6,582,988,0,0,0,0,0,0,58.91
臺南市,南區,廣州里,106,1,780,5,785,1266,0,0,0,0,0,0,62.01
臺南市,南區,廣州里,107,1,848,4,852,1283,0,0,0,0,0,0,66.41
臺南市,南區,新昌里,108,1,601,10,611,997,0,0,0,0,0,0,61.28
臺南市,南區,新昌里,109,1,765,2,767,1376,0,0,0,0,0,0,55.74
臺南市,南區,文華里,110,1,815,5,820,1468,0,0,0,0,0,0,55.86
臺南市,南區,文華里,111,1,913,9,922,1541,0,0,0,0,0,0,59.83
臺南市,南區,文南里,112,1,944,8,952,1534,0,0,0,0,0,0,62.06
臺南市,南區,文南里,113,1,980,7,987,1673,0,0,0,0,0,0,59.00
臺南市,南區,金華里,114,1,815,8,823,1395,0,0,0,0,0,0,59.00
臺南市,南區,金華里,115,1,883,5,888,1578,0,0,0,0,0,0,56.27
臺南市,南區,金華里,116,1,869,10,879,1516,0,0,0,0,0,0,57.98
臺南市,南區,國宅里,117,1,926,7,933,1543,0,0,0,0,0,0,60.47
臺南市,南區,國宅里,118,1,790,4,794,1419,0,0,0,0,0,0,55.95
臺南市,南區,日新里,119,1,568,6,574,928,0,0,0,0,0,0,61.85
臺南市,南區,日新里,120,1,534,4,538,1020,0,0,0,0,0,0,52.75
臺南市,南區,光明里,121,1,889,5,894,1539,0,0,0,0,0,0,58.09
臺南市,南區,光明里,122,1,661,4,665,1266,0,0,0,0,0,0,52.53
臺南市,南區,光明里,123,1,690,7,697,1131,0,0,0,0,0,0,61.63
臺南市,南區,白雪里,124,1,476,6,482,807,0,0,0,0,0,0,59.73
臺南市,南區,白雪里,125,1,693,13,706,1142,0,0,0,0,0,0,61.82
臺南市,南區,明亮里,126,1,830,10,840,1565,0,0,0,0,0,0,53.67
臺南市,南區,明亮里,127,1,1007,7,1014,1745,0,0,0,0,0,0,58.11
臺南市,南區,府南里,128,1,631,7,638,1183,0,0,0,0,0,0,53.93
臺南市,南區,府南里,129,1,847,10,857,1459,0,0,0,0,0,0,58.74
臺南市,南區,府南里,130,1,542,7,549,1080,0,0,0,0,0,0,50.83
臺南市,南區,明興里,131,1,934,10,944,1501,0,0,0,0,0,0,62.89
臺南市,南區,明興里,132,1,888,8,896,1559,0,0,0,0,0,0,57.47
臺南市,南區,郡南里,133,1,957,4,961,1602,0,0,0,0,0,0,59.99
臺南市,南區,郡南里,134,1,902,7,909,1601,0,0,0,0,0,0,56.78
臺南市,南區,建南里,135,1,977,8,985,1589,0,0,0,0,0,0,61.99
臺南市,南區,建南里,136,1,1000,13,1013,1723,0,0,0,0,0,0,58.79
臺南市,南區,南都里,137,1,673,7,680,1235,0,0,0,0,0,0,55.06
臺南市,南區,南都里,138,1,804,11,815,1509,0,0,0,0,0,0,54.01
臺南市,南區,南都里,139,1,796,7,803,1434,0,0,0,0,0,0,56.00
臺南市,南區,開南里,140,1,889,11,900,1625,0,0,0,0,0,0,55.38
臺南市,南區,開南里,141,1,1122,14,1136,2055,0,0,0,0,0,0,55.28
臺南市,南區,彰南里,142,1,490,7,497,926,0,0,0,0,0,0,53.67
臺南市,南區,彰南里,143,1,608,5,613,981,0,0,0,0,0,0,62.49
臺南市,南區,清泉里,144,1,725,9,734,1018,0,0,0,0,0,0,72.10
臺南市,南區,龍崗里,145,1,656,7,663,963,0,0,0,0,0,0,68.85
臺南市,南區,喜北里,146,1,580,7,587,1016,0,0,0,0,0,0,57.78
臺南市,南區,喜北里,147,1,646,6,652,1089,0,0,0,0,0,0,59.87
臺南市,南區,喜南里,148,1,921,9,930,1467,0,0,0,0,0,0,63.39
臺南市,南區,喜東里,149,1,889,5,894,1411,0,0,0,0,0,0,63.36
臺南市,南區,省躬里,150,1,824,4,828,1248,0,0,0,0,0,0,66.35
臺南市,南區,省躬里,151,1,761,6,767,1198,0,0,0,0,0,0,64.02
臺南市,南區,覺醒里,152,1,418,3,421,596,0,0,0,0,0,0,70.64
臺南市,南區,海豐里,153,1,407,5,412,588,0,0,0,0,0,0,70.07
臺南市,南區,松山里,154,1,612,0,612,986,0,0,0,0,0,0,62.07
臺南市,南區,南山里,155,1,517,4,521,725,0,0,0,0,0,0,71.86
臺南市,南區,佛壇里,156,1,1074,18,1092,1635,0,0,0,0,0,0,66.79
臺南市,南區,同安里,157,1,1122,12,1134,1775,0,0,0,0,0,0,63.89
臺南市,南區,中和里,158,1,525,5,530,733,0,0,0,0,0,0,72.31
臺南市,南區,興農里,159,1,1150,9,1159,1752,0,0,0,0,0,0,66.15
臺南市,西區,西賢里,160,1,1064,9,1073,1892,0,0,0,0,0,0,56.71
臺南市,西區,西賢里,161,1,614,4,618,921,0,0,0,0,0,0,67.10
臺南市,西區,西湖里,162,1,526,4,530,855,0,0,0,0,0,0,61.99
臺南市,西區,西湖里,163,1,899,10,909,1412,0,0,0,0,0,0,64.38
臺南市,西區,光賢里,164,1,863,12,875,1335,0,0,0,0,0,0,65.54
臺南市,西區,光賢里,165,1,619,10,629,998,0,0,0,0,0,0,63.03
臺南市,西區,文賢里,166,1,809,3,812,1295,0,0,0,0,0,0,62.70
臺南市,西區,協和里,167,1,762,13,775,1142,0,0,0,0,0,0,67.86
臺南市,西區,協和里,168,1,632,9,641,924,0,0,0,0,0,0,69.37
臺南市,西區,金安里,169,1,438,5,443,687,0,0,0,0,0,0,64.48
臺南市,西區,忠信里,170,1,487,2,489,784,0,0,0,0,0,0,62.37
臺南市,西區,工業里,171,1,550,6,556,809,0,0,0,0,0,0,68.73
臺南市,西區,普濟里,172,1,486,8,494,740,0,0,0,0,0,0,66.76
臺南市,西區,濟同里,173,1,442,3,445,655,0,0,0,0,0,0,67.94
臺南市,西區,水仙里,174,1,618,9,627,993,0,0,0,0,0,0,63.14
臺南市,西區,北勢里,175,1,545,9,554,870,0,0,0,0,0,0,63.68
臺南市,西區,藥王里,176,1,667,11,678,1051,0,0,0,0,0,0,64.51
臺南市,西區,藥王里,177,1,684,2,686,1181,0,0,0,0,0,0,58.09
臺南市,西區,協進里,178,1,675,12,687,1010,0,0,0,0,0,0,68.02
臺南市,西區,西羅里,179,1,601,1,602,879,0,0,0,0,0,0,68.49
臺南市,西區,安新里,180,1,334,4,338,543,0,0,0,0,0,0,62.25
臺南市,西區,中正里,181,1,541,9,550,905,0,0,0,0,0,0,60.77
臺南市,西區,正德里,182,1,385,2,387,608,0,0,0,0,0,0,63.65
臺南市,西區,安海里,183,1,580,3,583,942,0,0,0,0,0,0,61.89
臺南市,西區,大涼里,184,1,559,7,566,985,0,0,0,0,0,0,57.46
臺南市,西區,大涼里,185,1,712,10,722,1165,0,0,0,0,0,0,61.97
臺南市,西區,民主里,186,1,495,5,500,850,0,0,0,0,0,0,58.82
臺南市,西區,運河里,187,1,351,3,354,562,0,0,0,0,0,0,62.99
臺南市,西區,北頭里,188,1,192,2,194,263,0,0,0,0,0,0,73.76
臺南市,西區,保民里,189,1,286,0,286,422,0,0,0,0,0,0,67.77
臺南市,西區,保良里,190,1,272,4,276,474,0,0,0,0,0,0,58.23
臺南市,西區,天池里,191,1,190,0,190,283,0,0,0,0,0,0,67.14
臺南市,西區,中頭里,192,1,596,3,599,943,0,0,0,0,0,0,63.52
臺南市,西區,民生里,193,1,769,6,775,1130,0,0,0,0,0,0,68.58
臺南市,西區,新安里,194,1,600,10,610,823,0,0,0,0,0,0,74.12
臺南市,西區,元安里,195,1,882,9,891,1460,0,0,0,0,0,0,61.03
臺南市,北區,城隍里,196,1,544,9,553,948,0,0,0,0,0,0,58.33
臺南市,北區,元和里,197,1,594,6,600,994,0,0,0,0,0,0,60.36
臺南市,北區,城朔里,198,1,515,4,519,978,0,0,0,0,0,0,53.07
臺南市,北區,共和里,199,1,724,10,734,1252,0,0,0,0,0,0,58.63
臺南市,北區,福德里,200,1,591,8,599,942,0,0,0,0,0,0,63.59
臺南市,北區,花園里,201,1,650,5,655,1055,0,0,0,0,0,0,62.09
臺南市,北區,西華里,202,1,715,12,727,1219,0,0,0,0,0,0,59.64
臺南市,北區,北門里,203,1,522,4,526,880,0,0,0,0,0,0,59.77
臺南市,北區,東豐里,204,1,755,13,768,1186,0,0,0,0,0,0,64.76
臺南市,北區,水源里,205,1,570,14,584,939,0,0,0,0,0,0,62.19
臺南市,北區,仁愛里,206,1,469,2,471,795,0,0,0,0,0,0,59.25
臺南市,北區,仁愛里,207,1,556,11,567,937,0,0,0,0,0,0,60.51
臺南市,北區,振興里,208,1,572,7,579,945,0,0,0,0,0,0,61.27
臺南市,北區,振興里,209,1,637,9,646,972,0,0,0,0,0,0,66.46
臺南市,北區,東興里,210,1,573,10,583,976,0,0,0,0,0,0,59.73
臺南市,北區,東興里,211,1,643,7,650,1002,0,0,0,0,0,0,64.87
臺南市,北區,重興里,212,1,835,16,851,1472,0,0,0,0,0,0,57.81
臺南市,北區,重興里,213,1,876,8,884,1258,0,0,0,0,0,0,70.27
臺南市,北區,華興里,214,1,573,7,580,1022,0,0,0,0,0,0,56.75
臺南市,北區,華興里,215,1,603,4,607,1043,0,0,0,0,0,0,58.20
臺南市,北區,力行里,216,1,585,8,593,989,0,0,0,0,0,0,59.96
臺南市,北區,力行里,217,1,647,12,659,1029,0,0,0,0,0,0,64.04
臺南市,北區,國興里,218,1,910,14,924,1480,0,0,0,0,0,0,62.43
臺南市,北區,新勝里,219,1,524,6,530,912,0,0,0,0,0,0,58.11
臺南市,北區,新勝里,220,1,519,5,524,940,0,0,0,0,0,0,55.74
臺南市,北區,開元里,221,1,1108,13,1121,1710,0,0,0,0,0,0,65.56
臺南市,北區,開元里,222,1,800,17,817,1655,0,0,0,0,0,0,49.37
臺南市,北區,北垣里,223,1,522,7,529,842,0,0,0,0,0,0,62.83
臺南市,北區,富台里,224,1,372,4,376,551,0,0,0,0,0,0,68.24
臺南市,北區,勝安里,225,1,768,17,785,1280,0,0,0,0,0,0,61.33
臺南市,北區,大仁里,226,1,675,2,677,1078,0,0,0,0,0,0,62.80
臺南市,北區,大山里,227,1,881,13,894,1422,0,0,0,0,0,0,62.87
臺南市,北區,大道里,228,1,440,8,448,753,0,0,0,0,0,0,59.50
臺南市,北區,光武里,229,1,334,2,336,585,0,0,0,0,0,0,57.44
臺南市,北區,實踐里,230,1,472,10,482,824,0,0,0,0,0,0,58.50
臺南市,北區,實踐里,231,1,415,5,420,712,0,0,0,0,0,0,58.99
臺南市,北區,小康里,232,1,732,7,739,1196,0,0,0,0,0,0,61.79
臺南市,北區,小康里,233,1,672,11,683,1158,0,0,0,0,0,0,58.98
臺南市,北區,小康里,234,1,647,6,653,1191,0,0,0,0,0,0,54.83
臺南市,北區,小康里,235,1,741,12,753,1246,0,0,0,0,0,0,60.43
臺南市,北區,正風里,236,1,897,8,905,1560,0,0,0,0,0,0,58.01
臺南市,北區,延平里,237,1,501,6,507,891,0,0,0,0,0,0,56.90
臺南市,北區,延平里,238,1,562,10,572,1005,0,0,0,0,0,0,56.92
臺南市,北區,興北里,239,1,972,13,985,1624,0,0,0,0,0,0,60.65
臺南市,北區,興南里,240,1,721,12,733,1304,0,0,0,0,0,0,56.21
臺南市,北區,國姓里,241,1,946,13,959,1550,0,0,0,0,0,0,61.87
臺南市,北區,六甲里,242,1,642,7,649,1115,0,0,0,0,0,0,58.21
臺南市,北區,六甲里,243,1,606,6,612,1124,0,0,0,0,0,0,54.45
臺南市,北區,正覺里,244,1,756,4,760,1252,0,0,0,0,0,0,60.70
臺南市,北區,正覺里,245,1,647,6,653,1066,0,0,0,0,0,0,61.26
臺南市,北區,正覺里,246,1,582,4,586,987,0,0,0,0,0,0,59.37
臺南市,北區,成功里,247,1,707,5,712,1264,0,0,0,0,0,0,56.33
臺南市,北區,成功里,248,1,645,2,647,1074,0,0,0,0,0,0,60.24
臺南市,北區,成功里,249,1,827,10,837,1499,0,0,0,0,0,0,55.84
臺南市,北區,成功里,250,1,702,6,708,1250,0,0,0,0,0,0,56.64
臺南市,北區,和順里,251,1,693,5,698,1257,0,0,0,0,0,0,55.53
臺南市,北區,和順里,252,1,893,9,902,1763,0,0,0,0,0,0,51.16
臺南市,北區,和順里,253,1,525,9,534,915,0,0,0,0,0,0,58.36
臺南市,北區,安民里,254,1,795,9,804,1205,0,0,0,0,0,0,66.72
臺南市,北區,裕民里,255,1,893,10,903,1426,0,0,0,0,0,0,63.32
臺南市,北區,文元里,256,1,666,5,671,1033,0,0,0,0,0,0,64.96
臺南市,北區,文元里,257,1,667,7,674,1181,0,0,0,0,0,0,57.07
臺南市,北區,文元里,258,1,685,6,691,1111,0,0,0,0,0,0,62.20
臺南市,北區,文元里,259,1,671,12,683,1088,0,0,0,0,0,0,62.78
臺南市,北區,大港里,260,1,820,4,824,1275,0,0,0,0,0,0,64.63
臺南市,北區,大港里,261,1,785,6,791,1274,0,0,0,0,0,0,62.09
臺南市,北區,大港里,262,1,768,5,773,1179,0,0,0,0,0,0,65.56
臺南市,北區,大港里,263,1,846,11,857,1305,0,0,0,0,0,0,65.67
臺南市,北區,大港里,264,1,779,7,786,1321,0,0,0,0,0,0,59.50
臺南市,北區,大豐里,265,1,775,8,783,1318,0,0,0,0,0,0,59.41
臺南市,北區,大豐里,266,1,881,21,902,1478,0,0,0,0,0,0,61.03
臺南市,北區,大豐里,267,1,742,7,749,1330,0,0,0,0,0,0,56.32
臺南市,北區,大豐里,268,1,791,10,801,1230,0,0,0,0,0,0,65.12
臺南市,中區,萬壽里,269,1,806,4,810,1182,0,0,0,0,0,0,68.53
臺南市,中區,文昌里,270,1,754,11,765,1132,0,0,0,0,0,0,67.58
臺南市,中區,萬鍾里,271,1,721,10,731,1203,0,0,0,0,0,0,60.76
臺南市,中區,銀同里,272,1,828,9,837,1441,0,0,0,0,0,0,58.08
臺南市,中區,清水里,273,1,439,5,444,702,0,0,0,0,0,0,63.25
臺南市,中區,環翠里,274,1,401,2,403,706,0,0,0,0,0,0,57.08
臺南市,中區,公正里,275,1,272,1,273,442,0,0,0,0,0,0,61.76
臺南市,中區,廣慈里,276,1,257,0,257,447,0,0,0,0,0,0,57.49
臺南市,中區,啟智里,277,1,744,7,751,1233,0,0,0,0,0,0,60.91
臺南市,中區,永慶里,278,1,285,1,286,423,0,0,0,0,0,0,67.61
臺南市,中區,保西里,279,1,472,7,479,783,0,0,0,0,0,0,61.17
臺南市,中區,中南里,280,1,373,7,380,577,0,0,0,0,0,0,65.86
臺南市,中區,福安里,281,1,547,4,551,913,0,0,0,0,0,0,60.35
臺南市,中區,昇平里,282,1,307,2,309,483,0,0,0,0,0,0,63.98
臺南市,中區,聖前里,283,1,288,4,292,477,0,0,0,0,0,0,61.22
臺南市,中區,小西里,284,1,670,4,674,1076,0,0,0,0,0,0,62.64
臺南市,中區,仙草里,285,1,623,4,627,1230,0,0,0,0,0,0,50.98
臺南市,中區,仙草里,286,1,623,8,631,1074,0,0,0,0,0,0,58.75
臺南市,中區,五妃里,287,1,658,5,663,1065,0,0,0,0,0,0,62.25
臺南市,中區,大南里,288,1,881,6,887,1462,0,0,0,0,0,0,60.67
臺南市,中區,天中里,289,1,304,6,310,520,0,0,0,0,0,0,59.62
臺南市,中區,中山里,290,1,365,6,371,579,0,0,0,0,0,0,64.08
臺南市,中區,白金里,291,1,468,6,474,688,0,0,0,0,0,0,68.90
臺南市,中區,武聖里,292,1,473,4,477,717,0,0,0,0,0,0,66.53
臺南市,中區,蓬壺里,293,1,642,7,649,1028,0,0,0,0,0,0,63.13
臺南市,中區,赤嵌里,294,1,308,5,313,517,0,0,0,0,0,0,60.54
臺南市,中區,觀音里,295,1,402,4,406,686,0,0,0,0,0,0,59.18
臺南市,中區,竹翠里,296,1,328,7,335,544,0,0,0,0,0,0,61.58
臺南市,中區,溫陵里,297,1,368,4,372,641,0,0,0,0,0,0,58.03
臺南市,中區,開仙里,298,1,459,5,464,746,0,0,0,0,0,0,62.20
臺南市,中區,進學里,299,1,420,6,426,671,0,0,0,0,0,0,63.49
臺南市,中區,川西里,300,1,474,8,482,773,0,0,0,0,0,0,62.35
臺南市,中區,開山里,301,1,879,10,889,1528,0,0,0,0,0,0,58.18
臺南市,中區,郡王里,302,1,1046,11,1057,1735,0,0,0,0,0,0,60.92
臺南市,中區,法華里,303,1,977,6,983,1650,0,0,0,0,0,0,59.58
臺南市,中區,法華里,304,1,835,6,841,1526,0,0,0,0,0,0,55.11
臺南市,安南區,東和里,305,1,365,7,372,522,0,0,0,0,0,0,71.26
臺南市,安南區,塭南里,306,1,1086,15,1101,1796,0,0,0,0,0,0,61.30
臺南市,安南區,塭南里,307,1,765,11,776,1346,0,0,0,0,0,0,57.65
臺南市,安南區,州南里,308,1,980,13,993,1474,0,0,0,0,0,0,67.37
臺南市,安南區,州南里,309,1,852,16,868,1305,0,0,0,0,0,0,66.51
臺南市,安南區,州南里,310,1,724,10,734,1193,0,0,0,0,0,0,61.53
臺南市,安南區,安順里,311,1,698,11,709,1033,0,0,0,0,0,0,68.64
臺南市,安南區,安順里,312,1,686,12,698,1050,0,0,0,0,0,0,66.48
臺南市,安南區,州北里,313,1,852,9,861,1234,0,0,0,0,0,0,69.77
臺南市,安南區,州北里,314,1,901,15,916,1459,0,0,0,0,0,0,62.78
臺南市,安南區,新順里,315,1,704,15,719,1131,0,0,0,0,0,0,63.57
臺南市,安南區,新順里,316,1,732,9,741,1269,0,0,0,0,0,0,58.39
臺南市,安南區,頂安里,317,1,771,8,779,1121,0,0,0,0,0,0,69.49
臺南市,安南區,頂安里,318,1,674,5,679,1158,0,0,0,0,0,0,58.64
臺南市,安南區,安慶里,319,1,1279,20,1299,2001,0,0,0,0,0,0,64.92
臺南市,安南區,安慶里,320,1,1001,11,1012,1619,0,0,0,0,0,0,62.51
臺南市,安南區,溪北里,321,1,693,7,700,1139,0,0,0,0,0,0,61.46
臺南市,安南區,溪北里,322,1,673,4,677,1151,0,0,0,0,0,0,58.82
臺南市,安南區,安和里,323,1,1102,18,1120,1804,0,0,0,0,0,0,62.08
臺南市,安南區,安西里,324,1,337,5,342,477,0,0,0,0,0,0,71.70
臺南市,安南區,安西里,325,1,1087,13,1100,1536,0,0,0,0,0,0,71.61
臺南市,安南區,溪頂里,326,1,803,12,815,1380,0,0,0,0,0,0,59.06
臺南市,安南區,溪頂里,327,1,866,14,880,1484,0,0,0,0,0,0,59.30
臺南市,安南區,安東里,328,1,751,16,767,1165,0,0,0,0,0,0,65.84
臺南市,安南區,安東里,329,1,765,7,772,1336,0,0,0,0,0,0,57.78
臺南市,安南區,鳳凰里,330,1,866,10,876,1584,0,0,0,0,0,0,55.30
臺南市,安南區,鳳凰里,331,1,788,8,796,1421,0,0,0,0,0,0,56.02
臺南市,安南區,梅花里,332,1,788,18,806,1278,0,0,0,0,0,0,63.07
臺南市,安南區,梅花里,333,1,798,7,805,1334,0,0,0,0,0,0,60.34
臺南市,安南區,理想里,334,1,1099,7,1106,1951,0,0,0,0,0,0,56.69
臺南市,安南區,理想里,335,1,962,13,975,1738,0,0,0,0,0,0,56.10
臺南市,安南區,理想里,336,1,1097,14,1111,1798,0,0,0,0,0,0,61.79
臺南市,安南區,原佃里,337,1,883,15,898,1240,0,0,0,0,0,0,72.42
臺南市,安南區,長安里,338,1,808,11,819,1319,0,0,0,0,0,0,62.09
臺南市,安南區,長安里,339,1,893,15,908,1427,0,0,0,0,0,0,63.63
臺南市,安南區,公親里,340,1,594,9,603,888,0,0,0,0,0,0,67.91
臺南市,安南區,布袋里,341,1,690,11,701,1084,0,0,0,0,0,0,64.67
臺南市,安南區,總頭里,342,1,1001,10,1011,1566,0,0,0,0,0,0,64.56
臺南市,安南區,南興里,343,1,774,13,787,1166,0,0,0,0,0,0,67.50
臺南市,安南區,學東里,344,1,1098,18,1116,1620,0,0,0,0,0,0,68.89
臺南市,安南區,公塭里,345,1,636,3,639,787,0,0,0,0,0,0,81.19
臺南市,安南區,佃東里,346,1,662,9,671,1002,0,0,0,0,0,0,66.97
臺南市,安南區,佃東里,347,1,588,10,598,957,0,0,0,0,0,0,62.49
臺南市,安南區,佃西里,348,1,938,14,952,1356,0,0,0,0,0,0,70.21
臺南市,安南區,淵西里,349,1,685,8,693,1097,0,0,0,0,0,0,63.17
臺南市,安南區,淵西里,350,1,670,15,685,1153,0,0,0,0,0,0,59.41
臺南市,安南區,海西里,351,1,575,12,587,988,0,0,0,0,0,0,59.41
臺南市,安南區,海西里,352,1,642,6,648,1174,0,0,0,0,0,0,55.20
臺南市,安南區,海東里,353,1,789,10,799,1357,0,0,0,0,0,0,58.88
臺南市,安南區,海東里,354,1,667,9,676,1205,0,0,0,0,0,0,56.10
臺南市,安南區,溪心里,355,1,505,5,510,785,0,0,0,0,0,0,64.97
臺南市,安南區,溪心里,356,1,1166,22,1188,2039,0,0,0,0,0,0,58.26
臺南市,安南區,淵東里,357,1,648,8,656,1104,0,0,0,0,0,0,59.42
臺南市,安南區,淵東里,358,1,673,7,680,1215,0,0,0,0,0,0,55.97
臺南市,安南區,淵中里,359,1,808,11,819,1413,0,0,0,0,0,0,57.96
臺南市,安南區,淵中里,360,1,627,8,635,1052,0,0,0,0,0,0,60.36
臺南市,安南區,溪墘里,361,1,804,10,814,1330,0,0,0,0,0,0,61.20
臺南市,安南區,溪墘里,362,1,784,11,795,1298,0,0,0,0,0,0,61.25
臺南市,安南區,海佃里,363,1,1050,22,1072,1746,0,0,0,0,0,0,61.40
臺南市,安南區,海佃里,364,1,1021,10,1031,1667,0,0,0,0,0,0,61.85
臺南市,安南區,國安里,365,1,856,15,871,1419,0,0,0,0,0,0,61.38
臺南市,安南區,溪東里,366,1,890,16,906,1589,0,0,0,0,0,0,57.02
臺南市,安南區,溪東里,367,1,418,6,424,728,0,0,0,0,0,0,58.24
臺南市,安南區,安富里,368,1,955,14,969,1720,0,0,0,0,0,0,56.34
臺南市,安南區,安富里,369,1,1102,15,1117,1979,0,0,0,0,0,0,56.44
臺南市,安南區,幸福里,370,1,835,11,846,1330,0,0,0,0,0,0,63.61
臺南市,安南區,幸福里,371,1,1093,13,1106,1819,0,0,0,0,0,0,60.80
臺南市,安南區,海南里,372,1,575,5,580,966,0,0,0,0,0,0,60.04
臺南市,安南區,海南里,373,1,518,2,520,897,0,0,0,0,0,0,57.97
臺南市,安南區,城東里,374,1,931,10,941,1312,0,0,0,0,0,0,71.72
臺南市,安南區,城南里,375,1,447,8,455,614,0,0,0,0,0,0,74.10
臺南市,安南區,城南里,376,1,1129,10,1139,1568,0,0,0,0,0,0,72.64
臺南市,安南區,青草里,377,1,858,9,867,1115,0,0,0,0,0,0,77.76
臺南市,安南區,城西里,378,1,611,7,618,875,0,0,0,0,0,0,70.63
臺南市,安南區,城北里,379,1,818,8,826,1091,0,0,0,0,0,0,75.71
臺南市,安南區,城中里,380,1,557,7,564,676,0,0,0,0,0,0,83.43
臺南市,安南區,砂崙里,381,1,336,4,340,444,0,0,0,0,0,0,76.58
臺南市,安南區,砂崙里,382,1,354,5,359,501,0,0,0,0,0,0,71.66
臺南市,安南區,顯宮里,383,1,726,6,732,990,0,0,0,0,0,0,73.94
臺南市,安南區,鹿耳里,384,1,446,6,452,605,0,0,0,0,0,0,74.71
臺南市,安南區,四草里,385,1,953,11,964,1368,0,0,0,0,0,0,70.47
臺南市,安南區,鹽田里,386,1,404,8,412,558,0,0,0,0,0,0,73.84
臺南市,安平區,校前里,387,1,545,5,550,825,0,0,0,0,0,0,66.67
臺南市,安平區,海興里,388,1,530,6,536,857,0,0,0,0,0,0,62.54
臺南市,安平區,菩薩里,389,1,256,1,257,360,0,0,0,0,0,0,71.39
臺南市,安平區,妙壽里,390,1,223,5,228,389,0,0,0,0,0,0,58.61
臺南市,安平區,西門里,391,1,676,3,679,1051,0,0,0,0,0,0,64.61
臺南市,安平區,西門里,392,1,724,4,728,1052,0,0,0,0,0,0,69.20
臺南市,安平區,文朱里,393,1,242,1,243,344,0,0,0,0,0,0,70.64
臺南市,安平區,金城里,394,1,892,8,900,1386,0,0,0,0,0,0,64.94
臺南市,安平區,石門里,395,1,900,7,907,1498,0,0,0,0,0,0,60.55
臺南市,安平區,石門里,396,1,1013,4,1017,1586,0,0,0,0,0,0,64.12
臺南市,安平區,石門里,397,1,913,14,927,1476,0,0,0,0,0,0,62.80
臺南市,安平區,安中里,398,1,306,2,308,464,0,0,0,0,0,0,66.38
臺南市,安平區,漁光里,399,1,356,6,362,486,0,0,0,0,0,0,74.49
臺南市,安平區,建平里,400,1,1052,12,1064,1908,0,0,0,0,0,0,55.77
臺南市,安平區,怡平里,401,1,657,4,661,1375,0,0,0,0,0,0,48.07
臺南市,安平區,華平里,402,1,774,7,781,1394,0,0,0,0,0,0,56.03
臺南市,安平區,華平里,403,1,699,5,704,1397,0,0,0,0,0,0,50.39
臺南市,安平區,平通里,404,1,703,6,709,1408,0,0,0,0,0,0,50.36
臺南市,安平區,平通里,405,1,711,4,715,1259,0,0,0,0,0,0,56.79
臺南市,安平區,文平里,406,1,684,9,693,1130,0,0,0,0,0,0,61.33
臺南市,安平區,文平里,407,1,485,2,487,935,0,0,0,0,0,0,52.09
臺南市,安平區,國平里,408,1,486,1,487,893,0,0,0,0,0,0,54.54
臺南市,安平區,國平里,409,1,475,2,477,970,0,0,0,0,0,0,49.18
臺南市,安平區,育平里,410,1,635,3,638,1426,0,0,0,0,0,0,44.74
臺南市,安平區,育平里,411,1,583,3,586,1236,0,0,0,0,0,0,47.41
臺南市,安平區,億載里,412,1,502,5,507,885,0,0,0,0,0,0,57.29
金門縣,金城鎮,東門里,1,1,910,6,916,1553,0,0,0,0,0,0,58.98
金門縣,金城鎮,南門里,2,1,508,8,516,842,0,0,0,0,0,0,61.28
金門縣,金城鎮,南門里,3,1,620,14,634,1027,0,0,0,0,0,0,61.73
金門縣,金城鎮,西門里,4,1,549,9,558,940,0,0,0,0,0,0,59.36
金門縣,金城鎮,西門里,5,1,558,6,564,983,0,0,0,0,0,0,57.38
金門縣,金城鎮,西門里,6,1,607,14,621,978,0,0,0,0,0,0,63.50
金門縣,金城鎮,北門里,7,1,755,12,767,1341,0,0,0,0,0,0,57.20
金門縣,金城鎮,賢庵里,8,1,625,12,637,1062,0,0,0,0,0,0,59.98
金門縣,金城鎮,金水里,9,1,383,5,388,575,0,0,0,0,0,0,67.48
金門縣,金城鎮,古城里,10,1,695,16,711,1133,0,0,0,0,0,0,62.75
金門縣,金城鎮,珠沙里,11,1,304,7,311,565,0,0,0,0,0,0,55.04
金門縣,金寧鄉,古寧村,12,1,696,11,707,1069,0,0,0,0,0,0,66.14
金門縣,金寧鄉,安美村,13,1,771,12,783,1314,0,0,0,0,0,0,59.59
金門縣,金寧鄉,湖埔村,14,1,606,11,617,1029,0,0,0,0,0,0,59.96
金門縣,金寧鄉,榜林村,15,1,698,13,711,1293,0,0,0,0,0,0,54.99
金門縣,金寧鄉,盤山村,16,1,606,7,613,990,0,0,0,0,0,0,61.92
金門縣,金寧鄉,后盤村,17,1,239,6,245,442,0,0,0,0,0,0,55.43
金門縣,金湖鎮,新市里,18,1,554,10,564,782,0,0,0,0,0,0,72.12
金門縣,金湖鎮,新市里,19,1,495,3,498,808,0,0,0,0,0,0,61.63
金門縣,金湖鎮,山外里,20,1,730,11,741,1164,0,0,0,0,0,0,63.66
金門縣,金湖鎮,溪湖里,21,1,301,4,305,514,0,0,0,0,0,0,59.34
金門縣,金湖鎮,蓮庵里,22,1,312,4,316,500,0,0,0,0,0,0,63.20
金門縣,金湖鎮,料羅里,23,1,327,3,330,527,0,0,0,0,0,0,62.62
金門縣,金湖鎮,新湖里,24,1,802,19,821,1298,0,0,0,0,0,0,63.25
金門縣,金湖鎮,正義里,25,1,553,11,564,799,0,0,0,0,0,0,70.59
金門縣,金湖鎮,瓊林里,26,1,653,16,669,1078,0,0,0,0,0,0,62.06
金門縣,金沙鎮,汶沙里,27,1,522,7,529,873,0,0,0,0,0,0,60.60
金門縣,金沙鎮,汶沙里,28,1,512,4,516,828,0,0,0,0,0,0,62.32
金門縣,金沙鎮,何斗里,29,1,449,6,455,675,0,0,0,0,0,0,67.41
金門縣,金沙鎮,浦山里,30,1,432,7,439,756,0,0,0,0,0,0,58.07
金門縣,金沙鎮,西園里,31,1,274,7,281,509,0,0,0,0,0,0,55.21
金門縣,金沙鎮,官嶼里,32,1,321,3,324,629,0,0,0,0,0,0,51.51
金門縣,金沙鎮,三山里,33,1,373,6,379,641,0,0,0,0,0,0,59.13
金門縣,金沙鎮,大洋里,34,1,224,4,228,405,0,0,0,0,0,0,56.30
金門縣,金沙鎮,光前里,35,1,381,11,392,671,0,0,0,0,0,0,58.42
金門縣,烈嶼鄉,林湖村,36,1,609,10,619,1022,0,0,0,0,0,0,60.57
金門縣,烈嶼鄉,黃埔村,37,1,243,8,251,445,0,0,0,0,0,0,56.40
金門縣,烈嶼鄉,西口村,38,1,352,7,359,684,0,0,0,0,0,0,52.49
金門縣,烈嶼鄉,上林村,39,1,246,2,248,427,0,0,0,0,0,0,58.08
金門縣,烈嶼鄉,上歧村,40,1,491,9,500,869,0,0,0,0,0,0,57.54
金門縣,烏坵鄉,大坵村,41,1,38,0,38,276,0,0,0,0,0,0,13.77
連江縣,南竿鄉,介壽村,1,1,568,63,631,996,0,0,0,0,0,0,63.35
連江縣,南竿鄉,福沃村、復興村,2,1,477,35,512,790,0,0,0,0,0,0,64.81
連江縣,南竿鄉,仁愛村、馬祖村、津沙村、珠螺村、清水村、四維村,3,1,443,52,495,852,0,0,0,0,0,0,58.10
連江縣,北竿鄉,后沃村、橋仔村、塘岐村,4,1,277,76,353,666,0,0,0,0,0,0,53.00
連江縣,北竿鄉,白沙村、板里村、芹壁村,5,1,122,28,150,263,0,0,0,0,0,0,57.03
連江縣,莒光鄉,青帆村、田沃村、西坵村,6,1,140,19,159,426,0,0,0,0,0,0,37.32
連江縣,莒光鄉,大坪村、福正村,7,1,113,9,122,226,0,0,0,0,0,0,53.98
連江縣,東引鄉,中柳村、樂華村,8,1,303,30,333,515,0,0,0,0,0,0,64.66
