CountyCityName,TownshipName,VillageName,PollStationNo,DistrictName,BallotsAccepted,BallotsRejected,BallotsCast,Voters,CandidateCounts,ElectedCounts,CandidateMaleCounts,CandidateFemaleCounts,ElectedMaleCounts,ElectedFemaleCounts,BallotsRate
全國,,,0,0,6072262,148036,6220298,10899572,881,319,815,66,300,19,57.07
臺北縣,,,0,0,1077075,17519,1094594,2527329,90,29,78,12,26,3,43.31
宜蘭縣,,,0,0,199704,3416,203120,328118,33,12,31,2,12,0,61.90
桃園縣,,,0,0,577356,12738,590094,1184648,45,13,43,2,12,1,49.81
新竹縣,,,0,0,182951,6018,188969,304025,29,13,29,0,13,0,62.16
苗栗縣,,,0,0,249731,5909,255640,395592,51,18,42,9,16,2,64.62
臺中縣,,,0,0,582460,12976,595436,1019199,70,21,65,5,20,1,58.42
彰化縣,,,0,0,573876,17878,591754,915274,75,26,68,7,23,3,64.65
南投縣,,,0,0,251742,5901,257643,386620,42,13,39,3,12,1,66.64
雲林縣,,,0,0,356513,12194,368707,541243,57,20,53,4,18,2,68.12
嘉義縣,,,0,0,263655,7150,270805,413038,39,18,36,3,17,1,65.56
臺南縣,,,0,0,476864,14805,491669,800059,80,31,76,4,29,2,61.45
高雄縣,,,0,0,532340,11886,544226,887213,72,27,68,4,26,1,61.34
屏東縣,,,0,0,440100,8966,449066,654213,88,33,85,3,32,1,68.64
臺東縣,,,0,0,102043,2864,104907,176363,32,16,31,1,16,0,59.48
花蓮縣,,,0,0,131589,2746,134335,252596,34,13,29,5,12,1,53.18
澎湖縣,,,0,0,44426,3724,48150,67311,14,6,13,1,6,0,71.53
金門縣,,,0,0,25818,1178,26996,40180,22,6,21,1,6,0,67.19
連江縣,,,0,0,4019,168,4187,6551,8,4,8,0,4,0,63.91
臺北縣,板橋市,,0,0,149101,2880,151981,374974,2,1,2,0,1,0,40.53
臺北縣,三重市,,0,0,119875,1561,121436,271542,4,1,4,0,1,0,44.72
臺北縣,中和市,,0,0,114132,2947,117079,293544,2,1,1,1,1,0,39.88
臺北縣,永和市,,0,0,61424,846,62270,166765,3,1,3,0,1,0,37.34
臺北縣,新莊市,,0,0,105486,1575,107061,250426,3,1,2,1,0,1,42.75
臺北縣,新店市,,0,0,75813,671,76484,200886,3,1,2,1,1,0,38.07
臺北縣,樹林市,,0,0,46409,585,46994,103285,5,1,4,1,0,1,45.50
臺北縣,鶯歌鎮,,0,0,27871,521,28392,54302,2,1,1,1,1,0,52.29
臺北縣,三峽鎮,,0,0,27868,422,28290,55746,3,1,3,0,1,0,50.75
臺北縣,淡水鎮,,0,0,33221,819,34040,85075,3,1,3,0,1,0,40.01
臺北縣,汐止市,,0,0,43183,442,43625,120859,7,1,6,1,1,0,36.10
臺北縣,瑞芳鎮,,0,0,21319,358,21677,34362,2,1,2,0,1,0,63.08
臺北縣,土城市,,0,0,59569,819,60388,153621,5,1,5,0,1,0,39.31
臺北縣,蘆洲市,,0,0,47396,539,47935,110814,7,1,6,1,1,0,43.26
臺北縣,五股鄉,,0,0,23904,396,24300,47423,3,1,3,0,1,0,51.24
臺北縣,泰山鄉,,0,0,21339,484,21823,42316,2,1,1,1,1,0,51.57
臺北縣,林口鄉,,0,0,18005,246,18251,34536,4,1,3,1,1,0,52.85
臺北縣,深坑鄉,,0,0,6907,142,7049,14703,4,1,3,1,0,1,47.94
臺北縣,石碇鄉,,0,0,4412,48,4460,5877,4,1,4,0,1,0,75.89
臺北縣,坪林鄉,,0,0,4331,45,4376,4899,2,1,2,0,1,0,89.32
臺北縣,三芝鄉,,0,0,9572,155,9727,16276,2,1,1,1,1,0,59.76
臺北縣,石門鄉,,0,0,6052,74,6126,8231,2,1,2,0,1,0,74.43
臺北縣,八里鄉,,0,0,10740,196,10936,20310,4,1,4,0,1,0,53.85
臺北縣,平溪鄉,,0,0,3733,54,3787,5094,2,1,2,0,1,0,74.34
臺北縣,雙溪鄉,,0,0,6632,78,6710,8408,3,1,3,0,1,0,79.80
臺北縣,貢寮鄉,,0,0,8452,136,8588,10688,2,1,2,0,1,0,80.35
臺北縣,金山鄉,,0,0,10510,166,10676,15272,2,1,1,1,1,0,69.91
臺北縣,萬里鄉,,0,0,8080,155,8235,13940,2,1,2,0,1,0,59.07
臺北縣,烏來鄉,,0,0,1739,159,1898,3155,1,1,1,0,1,0,60.16
宜蘭縣,宜蘭市,,0,0,36254,415,36669,63619,3,1,2,1,1,0,57.64
宜蘭縣,羅東鎮,,0,0,26020,427,26447,47659,3,1,2,1,1,0,55.49
宜蘭縣,蘇澳鎮,,0,0,21065,284,21349,33596,3,1,3,0,1,0,63.55
宜蘭縣,頭城鎮,,0,0,16097,273,16370,23551,3,1,3,0,1,0,69.51
宜蘭縣,礁溪鄉,,0,0,18059,404,18463,27109,3,1,3,0,1,0,68.11
宜蘭縣,壯圍鄉,,0,0,13143,471,13614,19257,2,1,2,0,1,0,70.70
宜蘭縣,員山鄉,,0,0,14623,187,14810,24249,3,1,3,0,1,0,61.07
宜蘭縣,冬山鄉,,0,0,22267,538,22805,36723,3,1,3,0,1,0,62.10
宜蘭縣,五結鄉,,0,0,16119,210,16329,28068,2,1,2,0,1,0,58.18
宜蘭縣,三星鄉,,0,0,10043,142,10185,16437,2,1,2,0,1,0,61.96
宜蘭縣,大同鄉,,0,0,3056,32,3088,3994,2,1,2,0,1,0,77.32
宜蘭縣,南澳鄉,,0,0,2958,33,2991,3856,4,1,4,0,1,0,77.57
桃園縣,桃園市,,0,0,99052,1539,100591,224921,5,1,5,0,1,0,44.72
桃園縣,中壢市,,0,0,105758,2832,108590,224528,3,1,3,0,1,0,48.36
桃園縣,大溪鎮,,0,0,30911,698,31609,57340,3,1,3,0,1,0,55.13
桃園縣,楊梅鎮,,0,0,42167,899,43066,87709,5,1,5,0,1,0,49.10
桃園縣,蘆竹鄉,,0,0,33399,490,33889,66591,4,1,4,0,1,0,50.89
桃園縣,大園鄉,,0,0,31432,572,32004,51562,4,1,4,0,1,0,62.07
桃園縣,龜山鄉,,0,0,31521,847,32368,79481,2,1,2,0,1,0,40.72
桃園縣,八德市,,0,0,54357,1506,55863,113106,3,1,3,0,1,0,49.39
桃園縣,龍潭鄉,,0,0,34413,930,35343,71793,3,1,3,0,1,0,49.23
桃園縣,平鎮市,,0,0,61513,1154,62667,128539,5,1,3,2,0,1,48.75
桃園縣,新屋鄉,,0,0,23893,761,24654,34445,2,1,2,0,1,0,71.57
桃園縣,觀音鄉,,0,0,23809,423,24232,36787,2,1,2,0,1,0,65.87
桃園縣,復興鄉,,0,0,5131,87,5218,7846,4,1,4,0,1,0,66.51
新竹縣,竹北市,,0,0,33242,1237,34479,61319,2,1,2,0,1,0,56.23
新竹縣,竹東鎮,,0,0,32771,971,33742,60467,2,1,2,0,1,0,55.80
新竹縣,新埔鎮,,0,0,17086,370,17456,26143,2,1,2,0,1,0,66.77
新竹縣,關西鎮,,0,0,15142,381,15523,23423,3,1,3,0,1,0,66.27
新竹縣,湖口鄉,,0,0,28153,1374,29527,45644,2,1,2,0,1,0,64.69
新竹縣,新豐鄉,,0,0,18923,697,19620,30808,2,1,2,0,1,0,63.68
新竹縣,芎林鄉,,0,0,8897,138,9035,14551,2,1,2,0,1,0,62.09
新竹縣,橫山鄉,,0,0,7367,95,7462,10985,2,1,2,0,1,0,67.93
新竹縣,北埔鄉,,0,0,4372,484,4856,7584,1,1,1,0,1,0,64.03
新竹縣,寶山鄉,,0,0,6619,83,6702,9162,2,1,2,0,1,0,73.15
新竹縣,峨眉鄉,,0,0,3371,70,3441,4869,2,1,2,0,1,0,70.67
新竹縣,尖石鄉,,0,0,4268,76,4344,5529,4,1,4,0,1,0,78.57
新竹縣,五峰鄉,,0,0,2740,42,2782,3541,3,1,3,0,1,0,78.57
苗栗縣,苗栗市,,0,0,36938,554,37492,64280,4,1,3,1,1,0,58.33
苗栗縣,苑裡鎮,,0,0,22455,719,23174,34584,2,1,1,1,1,0,67.01
苗栗縣,通霄鎮,,0,0,20159,710,20869,29627,2,1,2,0,1,0,70.44
苗栗縣,竹南鎮,,0,0,29887,394,30281,47982,4,1,4,0,1,0,63.11
苗栗縣,頭份鎮,,0,0,34987,1060,36047,60924,3,1,3,0,1,0,59.17
苗栗縣,後龍鎮,,0,0,19354,354,19708,30368,2,1,2,0,1,0,64.90
苗栗縣,卓蘭鎮,,0,0,9832,149,9981,14221,2,1,2,0,1,0,70.18
苗栗縣,大湖鄉,,0,0,8185,117,8302,12611,4,1,3,1,1,0,65.83
苗栗縣,公館鄉,,0,0,13387,1036,14423,24320,1,1,1,0,1,0,59.31
苗栗縣,銅鑼鄉,,0,0,10429,137,10566,14843,2,1,1,1,1,0,71.19
苗栗縣,南庄鄉,,0,0,6353,69,6422,9243,6,1,5,1,1,0,69.48
苗栗縣,頭屋鄉,,0,0,6710,101,6811,9020,3,1,2,1,0,1,75.51
苗栗縣,三義鄉,,0,0,8346,128,8474,12620,3,1,3,0,1,0,67.15
苗栗縣,西湖鄉,,0,0,4881,86,4967,6512,2,1,1,1,1,0,76.27
苗栗縣,造橋鄉,,0,0,6831,131,6962,10180,3,1,3,0,1,0,68.39
苗栗縣,三灣鄉,,0,0,4373,73,4446,5729,4,1,4,0,1,0,77.61
苗栗縣,獅潭鄉,,0,0,3141,49,3190,4348,2,1,2,0,1,0,73.37
苗栗縣,泰安鄉,,0,0,3483,42,3525,4180,2,1,0,2,0,1,84.33
臺中縣,豐原市,,0,0,58259,872,59131,109912,3,1,3,0,1,0,53.80
臺中縣,東勢鎮,,0,0,25893,421,26314,41446,5,1,4,1,1,0,63.49
臺中縣,大甲鎮,,0,0,31380,749,32129,52470,3,1,3,0,1,0,61.23
臺中縣,清水鎮,,0,0,37271,1160,38431,58753,4,1,4,0,1,0,65.41
臺中縣,沙鹿鎮,,0,0,33540,965,34505,49424,5,1,4,1,0,1,69.81
臺中縣,梧棲鎮,,0,0,22695,436,23131,33880,4,1,3,1,1,0,68.27
臺中縣,后里鄉,,0,0,25836,414,26250,38843,2,1,2,0,1,0,67.58
臺中縣,神岡鄉,,0,0,25406,489,25895,42674,4,1,4,0,1,0,60.68
臺中縣,潭子鄉,,0,0,31930,565,32495,60972,3,1,3,0,1,0,53.29
臺中縣,大雅鄉,,0,0,27901,794,28695,53151,2,1,2,0,1,0,53.99
臺中縣,新社鄉,,0,0,13375,214,13589,19501,4,1,4,0,1,0,69.68
臺中縣,石岡鄉,,0,0,7461,121,7582,11173,3,1,2,1,1,0,67.86
臺中縣,外埔鄉,,0,0,14536,286,14822,21651,3,1,3,0,1,0,68.46
臺中縣,大安鄉,,0,0,10594,356,10950,15088,2,1,1,1,1,0,72.57
臺中縣,烏日鄉,,0,0,25991,590,26581,44477,3,1,3,0,1,0,59.76
臺中縣,大肚鄉,,0,0,22505,471,22976,37230,3,1,3,0,1,0,61.71
臺中縣,龍井鄉,,0,0,23494,660,24154,44877,3,1,3,0,1,0,53.82
臺中縣,霧峰鄉,,0,0,27499,629,28128,45734,4,1,4,0,1,0,61.50
臺中縣,太平市,,0,0,54148,1590,55738,112747,2,1,2,0,1,0,49.44
臺中縣,大里市,,0,0,57331,1122,58453,116592,5,1,5,0,1,0,50.13
臺中縣,和平鄉,,0,0,5415,72,5487,8604,3,1,3,0,1,0,63.77
彰化縣,彰化市,,0,0,87044,3193,90237,157807,4,1,4,0,1,0,57.18
彰化縣,鹿港鎮,,0,0,34189,951,35140,57098,4,1,3,1,1,0,61.54
彰化縣,和美鎮,,0,0,34219,1525,35744,59332,2,1,2,0,1,0,60.24
彰化縣,線西鄉,,0,0,7344,460,7804,11599,2,1,2,0,1,0,67.28
彰化縣,伸港鄉,,0,0,18926,363,19289,23016,3,1,3,0,1,0,83.81
彰化縣,福興鄉,,0,0,23366,743,24109,33221,3,1,3,0,1,0,72.57
彰化縣,秀水鄉,,0,0,16205,507,16712,25809,2,1,2,0,1,0,64.75
彰化縣,花壇鄉,,0,0,23075,588,23663,31891,4,1,4,0,1,0,74.20
彰化縣,芬園鄉,,0,0,13192,288,13480,19165,3,1,2,1,0,1,70.34
彰化縣,員林鎮,,0,0,46676,1235,47911,86237,5,1,5,0,1,0,55.56
彰化縣,溪湖鎮,,0,0,24452,839,25291,37616,2,1,2,0,1,0,67.23
彰化縣,田中鎮,,0,0,19658,420,20078,33494,3,1,3,0,1,0,59.95
彰化縣,大村鄉,,0,0,15468,487,15955,25187,2,1,2,0,1,0,63.35
彰化縣,埔鹽鄉,,0,0,18558,542,19100,25229,3,1,3,0,1,0,75.71
彰化縣,埔心鄉,,0,0,18666,281,18947,24525,2,1,2,0,1,0,77.26
彰化縣,永靖鄉,,0,0,19604,627,20231,28198,3,1,3,0,1,0,71.75
彰化縣,社頭鄉,,0,0,20866,1133,21999,31628,2,1,1,1,0,1,69.56
彰化縣,二水鄉,,0,0,8982,361,9343,13688,2,1,1,1,1,0,68.26
彰化縣,北斗鎮,,0,0,14579,276,14855,23642,4,1,4,0,1,0,62.83
彰化縣,二林鎮,,0,0,29610,582,30192,40121,5,1,4,1,1,0,75.25
彰化縣,田尾鄉,,0,0,13685,460,14145,20864,3,1,2,1,0,1,67.80
彰化縣,埤頭鄉,,0,0,13959,655,14614,23394,2,1,2,0,1,0,62.47
彰化縣,芳苑鄉,,0,0,16671,606,17277,29156,2,1,2,0,1,0,59.26
彰化縣,大城鄉,,0,0,10741,203,10944,16454,3,1,2,1,1,0,66.51
彰化縣,竹塘鄉,,0,0,8329,157,8486,12913,2,1,2,0,1,0,65.72
彰化縣,溪州鄉,,0,0,15812,396,16208,23990,3,1,3,0,1,0,67.56
南投縣,南投市,,0,0,47770,1307,49077,72083,4,1,4,0,1,0,68.08
南投縣,埔里鎮,,0,0,41386,716,42102,62802,5,1,3,2,0,1,67.04
南投縣,草屯鎮,,0,0,42421,957,43378,68636,2,1,2,0,1,0,63.20
南投縣,竹山鎮,,0,0,27486,567,28053,44162,3,1,3,0,1,0,63.52
南投縣,集集鎮,,0,0,5525,175,5700,9132,2,1,2,0,1,0,62.42
南投縣,名間鄉,,0,0,23670,341,24011,30973,5,1,5,0,1,0,77.52
南投縣,鹿谷鄉,,0,0,8772,1011,9783,15370,1,1,1,0,1,0,63.65
南投縣,中寮鄉,,0,0,10318,143,10461,13441,4,1,4,0,1,0,77.83
南投縣,魚池鄉,,0,0,8322,96,8418,13459,3,1,3,0,1,0,62.55
南投縣,國姓鄉,,0,0,10872,243,11115,17369,2,1,2,0,1,0,63.99
南投縣,水里鄉,,0,0,10123,110,10233,16669,3,1,3,0,1,0,61.39
南投縣,信義鄉,,0,0,7723,147,7870,11773,4,1,4,0,1,0,66.85
南投縣,仁愛鄉,,0,0,7354,88,7442,10751,4,1,3,1,1,0,69.22
雲林縣,斗六市,,0,0,47576,1267,48843,70142,4,1,4,0,1,0,69.63
雲林縣,斗南鎮,,0,0,22096,582,22678,34379,2,1,2,0,1,0,65.96
雲林縣,虎尾鎮,,0,0,31894,1293,33187,48386,3,1,3,0,1,0,68.59
雲林縣,西螺鎮,,0,0,23229,363,23592,35863,3,1,2,1,0,1,65.78
雲林縣,土庫鎮,,0,0,12323,4021,16344,23489,1,1,1,0,1,0,69.58
雲林縣,北港鎮,,0,0,21334,434,21768,33768,2,1,1,1,1,0,64.46
雲林縣,古坑鄉,,0,0,16627,379,17006,26285,3,1,2,1,0,1,64.70
雲林縣,大埤鄉,,0,0,12254,186,12440,16990,4,1,4,0,1,0,73.22
雲林縣,莿桐鄉,,0,0,16241,414,16655,23059,2,1,2,0,1,0,72.23
雲林縣,林內鄉,,0,0,11144,220,11364,15056,4,1,3,1,1,0,75.48
雲林縣,二崙鄉,,0,0,15400,403,15803,24187,2,1,2,0,1,0,65.34
雲林縣,崙背鄉,,0,0,16533,295,16828,21804,2,1,2,0,1,0,77.18
雲林縣,麥寮鄉,,0,0,17045,322,17367,23461,5,1,5,0,1,0,74.02
雲林縣,東勢鄉,,0,0,8818,337,9155,14467,4,1,4,0,1,0,63.28
雲林縣,褒忠鄉,,0,0,8687,153,8840,11275,4,1,4,0,1,0,78.40
雲林縣,臺西鄉,,0,0,14718,286,15004,21835,2,1,2,0,1,0,68.72
雲林縣,元長鄉,,0,0,15234,412,15646,24543,3,1,3,0,1,0,63.75
雲林縣,四湖鄉,,0,0,12707,324,13031,22900,2,1,2,0,1,0,56.90
雲林縣,口湖鄉,,0,0,15597,200,15797,24473,3,1,3,0,1,0,64.55
雲林縣,水林鄉,,0,0,17056,303,17359,24881,2,1,2,0,1,0,69.77
嘉義縣,太保市,,0,0,16324,618,16942,22881,2,1,2,0,1,0,74.04
嘉義縣,朴子市,,0,0,19467,584,20051,31732,2,1,1,1,0,1,63.19
嘉義縣,布袋鎮,,0,0,18019,391,18410,25241,2,1,2,0,1,0,72.94
嘉義縣,大林鎮,,0,0,16849,606,17455,26496,2,1,1,1,1,0,65.88
嘉義縣,民雄鄉,,0,0,27756,1109,28865,49823,2,1,2,0,1,0,57.94
嘉義縣,溪口鄉,,0,0,7978,231,8209,13492,3,1,3,0,1,0,60.84
嘉義縣,新港鄉,,0,0,16910,326,17236,26268,2,1,2,0,1,0,65.62
嘉義縣,六腳鄉,,0,0,14609,558,15167,22524,2,1,2,0,1,0,67.34
嘉義縣,東石鄉,,0,0,17285,251,17536,23466,2,1,2,0,1,0,74.73
嘉義縣,義竹鄉,,0,0,14011,196,14207,18531,2,1,2,0,1,0,76.67
嘉義縣,鹿草鄉,,0,0,9122,241,9363,14076,3,1,3,0,1,0,66.52
嘉義縣,水上鄉,,0,0,25413,699,26112,40518,3,1,2,1,1,0,64.45
嘉義縣,中埔鄉,,0,0,19511,396,19907,34544,3,1,3,0,1,0,57.63
嘉義縣,竹崎鄉,,0,0,18556,283,18839,29946,2,1,2,0,1,0,62.91
嘉義縣,梅山鄉,,0,0,11537,245,11782,17174,2,1,2,0,1,0,68.60
嘉義縣,番路鄉,,0,0,5360,215,5575,8900,1,1,1,0,1,0,62.64
嘉義縣,大埔鄉,,0,0,2421,23,2444,2943,3,1,3,0,1,0,83.04
嘉義縣,阿里山鄉,,0,0,2527,178,2705,4483,1,1,1,0,1,0,60.34
臺南縣,新營市,,0,0,30740,1524,32264,54467,2,1,2,0,1,0,59.24
臺南縣,鹽水鎮,,0,0,14294,445,14739,21359,2,1,2,0,1,0,69.01
臺南縣,白河鎮,,0,0,15024,378,15402,26408,2,1,2,0,1,0,58.32
臺南縣,柳營鄉,,0,0,12345,269,12614,17905,4,1,4,0,1,0,70.45
臺南縣,後壁鄉,,0,0,14030,243,14273,21487,6,1,6,0,1,0,66.43
臺南縣,東山鄉,,0,0,12382,171,12553,19188,3,1,2,1,0,1,65.42
臺南縣,麻豆鎮,,0,0,23379,357,23736,34750,6,1,6,0,1,0,68.31
臺南縣,下營鄉,,0,0,14071,451,14522,20771,2,1,2,0,1,0,69.91
臺南縣,六甲鄉,,0,0,10612,775,11387,17905,1,1,1,0,1,0,63.60
臺南縣,官田鄉,,0,0,11657,146,11803,17582,4,1,4,0,1,0,67.13
臺南縣,大內鄉,,0,0,7032,91,7123,9548,2,1,2,0,1,0,74.60
臺南縣,佳里鎮,,0,0,22980,892,23872,41650,2,1,2,0,1,0,57.32
臺南縣,學甲鎮,,0,0,13886,276,14162,21906,4,1,2,2,0,1,64.65
臺南縣,西港鄉,,0,0,12073,539,12612,18687,2,1,2,0,1,0,67.49
臺南縣,七股鄉,,0,0,13146,188,13334,19778,3,1,2,1,1,0,67.42
臺南縣,將軍鄉,,0,0,11753,178,11931,18129,2,1,2,0,1,0,65.81
臺南縣,北門鄉,,0,0,5919,767,6686,10246,1,1,1,0,1,0,65.25
臺南縣,新化鎮,,0,0,19509,722,20231,32501,2,1,2,0,1,0,62.25
臺南縣,善化鎮,,0,0,14385,2027,16412,30510,1,1,1,0,1,0,53.79
臺南縣,新市鄉,,0,0,14600,291,14891,23719,3,1,3,0,1,0,62.78
臺南縣,安定鄉,,0,0,11999,689,12688,21595,1,1,1,0,1,0,58.75
臺南縣,山上鄉,,0,0,4356,143,4499,6142,2,1,2,0,1,0,73.25
臺南縣,玉井鄉,,0,0,8369,127,8496,12609,2,1,2,0,1,0,67.38
臺南縣,楠西鄉,,0,0,7048,91,7139,9120,2,1,2,0,1,0,78.28
臺南縣,南化鄉,,0,0,5504,49,5553,7411,3,1,3,0,1,0,74.93
臺南縣,左鎮鄉,,0,0,2764,56,2820,4937,1,1,1,0,1,0,57.12
臺南縣,仁德鄉,,0,0,30369,666,31035,48287,2,1,2,0,1,0,64.27
臺南縣,歸仁鄉,,0,0,26643,827,27470,44079,2,1,2,0,1,0,62.32
臺南縣,關廟鄉,,0,0,20065,246,20311,28140,3,1,3,0,1,0,72.18
臺南縣,龍崎鄉,,0,0,2462,150,2612,3669,1,1,1,0,1,0,71.19
臺南縣,永康市,,0,0,63468,1031,64499,135574,7,1,7,0,1,0,47.57
高雄縣,鳳山市,,0,0,104262,3348,107610,228855,2,1,2,0,1,0,47.02
高雄縣,林園鄉,,0,0,34320,541,34861,49982,4,1,3,1,1,0,69.75
高雄縣,大寮鄉,,0,0,49732,857,50589,82113,5,1,4,1,1,0,61.61
高雄縣,大樹鄉,,0,0,21716,237,21953,33537,3,1,3,0,1,0,65.46
高雄縣,大社鄉,,0,0,16853,284,17137,24353,2,1,2,0,1,0,70.37
高雄縣,仁武鄉,,0,0,20377,346,20723,38064,3,1,3,0,1,0,54.44
高雄縣,鳥松鄉,,0,0,17350,322,17672,28580,4,1,3,1,0,1,61.83
高雄縣,岡山鎮,,0,0,39194,903,40097,65831,2,1,2,0,1,0,60.91
高雄縣,橋頭鄉,,0,0,18112,442,18554,27585,3,1,3,0,1,0,67.26
高雄縣,燕巢鄉,,0,0,16290,364,16654,23564,2,1,2,0,1,0,70.68
高雄縣,田寮鄉,,0,0,5407,68,5475,7753,2,1,2,0,1,0,70.62
高雄縣,阿蓮鄉,,0,0,14452,180,14632,21797,3,1,3,0,1,0,67.13
高雄縣,路竹鄉,,0,0,26632,657,27289,38116,2,1,2,0,1,0,71.59
高雄縣,湖內鄉,,0,0,14466,244,14710,21019,2,1,2,0,1,0,69.98
高雄縣,茄萣鄉,,0,0,16652,454,17106,24140,2,1,2,0,1,0,70.86
高雄縣,永安鄉,,0,0,6363,658,7021,10608,1,1,1,0,1,0,66.19
高雄縣,彌陀鄉,,0,0,11932,246,12178,15527,2,1,2,0,1,0,78.43
高雄縣,梓官鄉,,0,0,19385,310,19695,28251,3,1,3,0,1,0,69.71
高雄縣,旗山鎮,,0,0,22447,291,22738,32562,3,1,2,1,1,0,69.83
高雄縣,美濃鎮,,0,0,21238,354,21592,34977,4,1,4,0,1,0,61.73
高雄縣,六龜鄉,,0,0,8675,157,8832,12966,4,1,4,0,1,0,68.12
高雄縣,甲仙鄉,,0,0,5537,34,5571,6837,2,1,2,0,1,0,81.48
高雄縣,杉林鄉,,0,0,6811,90,6901,10008,3,1,3,0,1,0,68.95
高雄縣,內門鄉,,0,0,8794,441,9235,13494,2,1,2,0,1,0,68.44
高雄縣,茂林鄉,,0,0,1108,11,1119,1296,2,1,2,0,1,0,86.34
高雄縣,桃源鄉,,0,0,2532,27,2559,3258,3,1,3,0,1,0,78.55
高雄縣,三民鄉,,0,0,1703,20,1723,2140,2,1,2,0,1,0,80.51
屏東縣,屏東市,,0,0,93182,1441,94623,152877,3,1,3,0,1,0,61.89
屏東縣,潮州鎮,,0,0,24131,543,24674,40963,5,1,5,0,1,0,60.23
屏東縣,東港鎮,,0,0,23248,295,23543,34129,3,1,3,0,1,0,68.98
屏東縣,恆春鎮,,0,0,15350,253,15603,22675,4,1,4,0,1,0,68.81
屏東縣,萬丹鄉,,0,0,26728,1310,28038,38234,2,1,2,0,1,0,73.33
屏東縣,長治鄉,,0,0,15117,306,15423,22253,3,1,3,0,1,0,69.31
屏東縣,麟洛鄉,,0,0,6348,98,6446,8845,2,1,2,0,1,0,72.88
屏東縣,九如鄉,,0,0,11423,314,11737,16671,4,1,3,1,1,0,70.40
屏東縣,里港鄉,,0,0,14741,227,14968,19538,2,1,2,0,1,0,76.61
屏東縣,鹽埔鄉,,0,0,15746,284,16030,20534,4,1,4,0,1,0,78.07
屏東縣,高樹鄉,,0,0,15449,572,16021,22406,2,1,2,0,1,0,71.50
屏東縣,萬巒鄉,,0,0,12534,161,12695,17871,3,1,3,0,1,0,71.04
屏東縣,內埔鄉,,0,0,27212,669,27881,45074,3,1,3,0,1,0,61.86
屏東縣,竹田鄉,,0,0,10136,233,10369,14340,2,1,1,1,1,0,72.31
屏東縣,新埤鄉,,0,0,6861,74,6935,9031,3,1,2,1,0,1,76.79
屏東縣,枋寮鄉,,0,0,15253,318,15571,21799,2,1,2,0,1,0,71.43
屏東縣,新園鄉,,0,0,20558,672,21230,29137,2,1,2,0,1,0,72.86
屏東縣,崁頂鄉,,0,0,8414,97,8511,10721,5,1,5,0,1,0,79.39
屏東縣,林邊鄉,,0,0,12228,184,12412,16889,2,1,2,0,1,0,73.49
屏東縣,南州鄉,,0,0,7735,76,7811,9828,3,1,3,0,1,0,79.48
屏東縣,佳冬鄉,,0,0,11722,142,11864,17387,2,1,2,0,1,0,68.23
屏東縣,琉球鄉,,0,0,8118,103,8221,10722,2,1,2,0,1,0,76.67
屏東縣,車城鄉,,0,0,5738,85,5823,8241,4,1,4,0,1,0,70.66
屏東縣,滿州鄉,,0,0,5312,73,5385,6944,4,1,4,0,1,0,77.55
屏東縣,枋山鄉,,0,0,3802,60,3862,4960,2,1,2,0,1,0,77.86
屏東縣,三地門鄉,,0,0,3896,32,3928,5232,2,1,2,0,1,0,75.08
屏東縣,霧臺鄉,,0,0,2137,49,2186,2492,2,1,2,0,1,0,87.72
屏東縣,瑪家鄉,,0,0,3365,36,3401,4517,2,1,2,0,1,0,75.29
屏東縣,泰武鄉,,0,0,2613,33,2646,3377,2,1,2,0,1,0,78.35
屏東縣,來義鄉,,0,0,4080,81,4161,5566,2,1,2,0,1,0,74.76
屏東縣,春日鄉,,0,0,1894,85,1979,3541,1,1,1,0,1,0,55.89
屏東縣,獅子鄉,,0,0,2476,29,2505,3680,2,1,2,0,1,0,68.07
屏東縣,牡丹鄉,,0,0,2553,31,2584,3739,2,1,2,0,1,0,69.11
臺東縣,臺東市,,0,0,45839,1514,47353,77753,2,1,2,0,1,0,60.90
臺東縣,成功鎮,,0,0,7580,83,7663,13588,2,1,2,0,1,0,56.40
臺東縣,關山鎮,,0,0,4620,67,4687,7876,2,1,2,0,1,0,59.51
臺東縣,卑南鄉,,0,0,8891,178,9069,15043,2,1,2,0,1,0,60.29
臺東縣,鹿野鄉,,0,0,4554,70,4624,7339,3,1,2,1,1,0,63.01
臺東縣,池上鄉,,0,0,4702,85,4787,8062,2,1,2,0,1,0,59.38
臺東縣,東河鄉,,0,0,4450,77,4527,8638,2,1,2,0,1,0,52.41
臺東縣,長濱鄉,,0,0,3915,46,3961,7999,3,1,3,0,1,0,49.52
臺東縣,太麻里鄉,,0,0,5134,385,5519,9871,1,1,1,0,1,0,55.91
臺東縣,大武鄉,,0,0,2864,41,2905,4900,2,1,2,0,1,0,59.29
臺東縣,綠島鄉,,0,0,1152,116,1268,2015,1,1,1,0,1,0,62.93
臺東縣,海端鄉,,0,0,1428,52,1480,3127,2,1,2,0,1,0,47.33
臺東縣,延平鄉,,0,0,1780,43,1823,2636,2,1,2,0,1,0,69.16
臺東縣,金峰鄉,,0,0,1787,17,1804,2348,2,1,2,0,1,0,76.83
臺東縣,達仁鄉,,0,0,2062,11,2073,3026,2,1,2,0,1,0,68.51
臺東縣,蘭嶼鄉,,0,0,1285,79,1364,2142,2,1,2,0,1,0,63.68
花蓮縣,花蓮市,,0,0,34213,1029,35242,75230,2,1,2,0,1,0,46.85
花蓮縣,鳳林鎮,,0,0,6821,105,6926,10650,3,1,3,0,1,0,65.03
花蓮縣,玉里鎮,,0,0,12918,307,13225,23699,4,1,3,1,1,0,55.80
花蓮縣,新城鄉,,0,0,7684,142,7826,14990,3,1,2,1,1,0,52.21
花蓮縣,吉安鄉,,0,0,26222,493,26715,55104,2,1,2,0,1,0,48.48
花蓮縣,壽豐鄉,,0,0,9607,114,9721,15203,2,1,1,1,0,1,63.94
花蓮縣,光復鄉,,0,0,6624,132,6756,12143,2,1,2,0,1,0,55.64
花蓮縣,豐濱鄉,,0,0,2924,33,2957,4805,3,1,2,1,1,0,61.54
花蓮縣,瑞穗鄉,,0,0,5643,68,5711,10966,3,1,3,0,1,0,52.08
花蓮縣,富里鄉,,0,0,5714,85,5799,10190,2,1,2,0,1,0,56.91
花蓮縣,秀林鄉,,0,0,7032,125,7157,9979,3,1,2,1,1,0,71.72
花蓮縣,萬榮鄉,,0,0,3428,62,3490,4897,3,1,3,0,1,0,71.27
花蓮縣,卓溪鄉,,0,0,2759,51,2810,4740,2,1,2,0,1,0,59.28
澎湖縣,馬公市,,0,0,23829,3375,27204,37867,1,1,1,0,1,0,71.84
澎湖縣,湖西鄉,,0,0,6701,153,6854,9746,3,1,2,1,1,0,70.33
澎湖縣,白沙鄉,,0,0,5035,72,5107,7085,3,1,3,0,1,0,72.08
澎湖縣,西嶼鄉,,0,0,4559,54,4613,6519,2,1,2,0,1,0,70.76
澎湖縣,望安鄉,,0,0,2739,41,2780,3819,2,1,2,0,1,0,72.79
澎湖縣,七美鄉,,0,0,1563,29,1592,2275,3,1,3,0,1,0,69.98
金門縣,金城鎮,,0,0,8692,172,8864,13150,9,1,8,1,1,0,67.41
金門縣,金沙鎮,,0,0,4585,84,4669,6917,3,1,3,0,1,0,67.50
金門縣,金湖鎮,,0,0,5074,748,5822,8575,1,1,1,0,1,0,67.90
金門縣,金寧鄉,,0,0,4664,132,4796,7291,3,1,3,0,1,0,65.78
金門縣,烈嶼鄉,,0,0,2574,38,2612,3939,3,1,3,0,1,0,66.31
金門縣,烏坵鄉,,0,0,229,4,233,308,3,1,3,0,1,0,75.65
連江縣,南竿鄉,,0,0,2706,84,2790,3911,3,1,3,0,1,0,71.34
連江縣,北竿鄉,,0,0,450,65,515,1403,1,1,1,0,1,0,36.71
連江縣,莒光鄉,,0,0,405,10,415,645,2,1,2,0,1,0,64.34
連江縣,東引鄉,,0,0,458,9,467,592,2,1,2,0,1,0,78.89
