CountyCityName,TownshipName,VillageName,PollStationNo,DistrictName,BallotsAccepted,BallotsRejected,BallotsCast,Voters,CandidateCounts,ElectedCounts,CandidateMaleCounts,CandidateFemaleCounts,ElectedMaleCounts,ElectedFemaleCounts,BallotsRate
全國,,,0,0,2024759,34666,2059425,3127793,174,94,120,54,59,35,65.84
臺北市,,,0,6,1269173,20601,1289774,1996635,101,51,71,30,32,19,64.60
臺北市,,,0,6,266443,3356,269799,409850,20,10,14,6,6,4,65.83
臺北市,,,0,6,176711,2878,179589,275962,14,7,9,5,4,3,65.08
臺北市,,,0,6,211912,4320,216232,335800,16,9,11,5,6,3,64.39
臺北市,,,0,6,167793,3217,171010,269362,12,7,9,3,4,3,63.49
臺北市,,,0,6,172250,3020,175270,272262,17,7,14,3,5,2,64.38
臺北市,,,0,6,274064,3810,277874,433399,22,11,14,8,7,4,64.12
高雄市,,,0,5,755586,14065,769651,1131158,73,43,49,24,27,16,68.04
高雄市,,,0,5,94362,1528,95890,136158,9,5,6,3,3,2,70.43
高雄市,,,0,5,168127,2903,171030,250411,17,10,10,7,6,4,68.30
高雄市,,,0,5,175582,3295,178877,267096,17,10,14,3,7,3,66.97
高雄市,,,0,5,144782,2661,147443,218122,14,8,10,4,6,2,67.60
高雄市,,,0,5,172733,3678,176411,259371,16,10,9,7,5,5,68.01
臺北市,北投區,,0,1,122368,1483,123851,188850,2,1,2,0,1,0,65.58
臺北市,士林區,,0,1,144075,1873,145948,221000,6,1,6,0,1,0,66.04
臺北市,內湖區,,0,2,122532,1957,124489,191165,3,1,3,0,1,0,65.12
臺北市,南港區,,0,2,54179,921,55100,84797,3,1,2,1,1,0,64.98
臺北市,松山區,,0,3,98885,2111,100996,156627,4,1,4,0,1,0,64.48
臺北市,信義區,,0,3,113027,2209,115236,179173,3,1,2,1,0,1,64.32
臺北市,中山區,,0,4,105268,2038,107306,171025,2,1,2,0,1,0,62.74
臺北市,大同區,,0,4,62525,1179,63704,98337,4,1,4,0,1,0,64.78
臺北市,中正區,,0,5,73598,1463,75061,118156,2,1,2,0,1,0,63.53
臺北市,萬華區,,0,5,98652,1557,100209,154106,4,1,3,1,1,0,65.03
臺北市,大安區,,0,6,148713,2207,150920,239391,3,1,3,0,1,0,63.04
臺北市,文山區,,0,6,125351,1603,126954,194008,4,1,4,0,1,0,65.44
高雄市,鹽埕區,,0,1,16363,250,16613,23099,3,1,3,0,1,0,71.92
高雄市,鼓山區,,0,1,61717,1075,62792,89722,4,1,4,0,1,0,69.99
高雄市,旗津區,,0,1,16282,203,16485,23337,2,1,2,0,1,0,70.64
高雄市,左營區,,0,2,88172,1757,89929,131930,4,1,2,2,1,0,68.16
高雄市,楠梓區,,0,2,79955,1146,81101,118481,2,1,0,2,0,1,68.45
高雄市,三民區,,0,3,175582,3295,178877,267096,3,1,2,1,1,0,66.97
高雄市,新興區,,0,4,30241,553,30794,45928,3,1,3,0,1,0,67.05
高雄市,前金區,,0,4,16137,292,16429,24718,3,1,3,0,1,0,66.47
高雄市,苓雅區,,0,4,98404,1816,100220,147476,5,1,4,1,0,1,67.96
高雄市,前鎮區,,0,5,100311,2344,102655,150844,2,1,1,1,1,0,68.05
高雄市,小港區,,0,5,72422,1334,73756,108527,3,1,3,0,1,0,67.96
臺北市,北投區,建民里,0,1,2210,20,2230,3347,3,1,3,0,1,0,66.63
臺北市,北投區,文林里,0,1,2410,35,2445,3664,7,1,6,1,1,0,66.73
臺北市,北投區,石牌里,0,1,2810,40,2850,4301,2,1,2,0,1,0,66.26
臺北市,北投區,福興里,0,1,3767,31,3798,5436,5,1,5,0,1,0,69.87
臺北市,北投區,榮光里,0,1,3717,40,3757,5654,7,1,6,1,1,0,66.45
臺北市,北投區,榮華里,0,1,3954,40,3994,6111,3,1,3,0,1,0,65.36
臺北市,北投區,裕民里,0,1,3713,59,3772,5656,2,1,1,1,1,0,66.69
臺北市,北投區,振華里,0,1,4190,52,4242,6375,4,1,3,1,1,0,66.54
臺北市,北投區,永和里,0,1,4266,56,4322,6743,4,1,3,1,0,1,64.10
臺北市,北投區,永欣里,0,1,3624,53,3677,5730,4,1,4,0,1,0,64.17
臺北市,北投區,永明里,0,1,2426,30,2456,3618,2,1,2,0,1,0,67.88
臺北市,北投區,東華里,0,1,2569,31,2600,3677,2,1,1,1,1,0,70.71
臺北市,北投區,吉利里,0,1,3380,38,3418,5160,2,1,2,0,1,0,66.24
臺北市,北投區,吉慶里,0,1,2756,31,2787,4074,4,1,4,0,1,0,68.41
臺北市,北投區,尊賢里,0,1,2483,30,2513,3795,2,1,2,0,1,0,66.22
臺北市,北投區,立賢里,0,1,2618,38,2656,4176,3,1,3,0,1,0,63.60
臺北市,北投區,立農里,0,1,4519,42,4561,6888,2,1,2,0,1,0,66.22
臺北市,北投區,八仙里,0,1,2624,31,2655,4026,2,1,1,1,1,0,65.95
臺北市,北投區,洲美里,0,1,1077,8,1085,1594,2,1,2,0,1,0,68.07
臺北市,北投區,奇岩里,0,1,5017,52,5069,7805,1,1,1,0,1,0,64.95
臺北市,北投區,清江里,0,1,4662,51,4713,7704,3,1,2,1,1,0,61.18
臺北市,北投區,中央里,0,1,3903,46,3949,5983,3,1,2,1,1,0,66.00
臺北市,北投區,長安里,0,1,3131,34,3165,4863,3,1,3,0,1,0,65.08
臺北市,北投區,大同里,0,1,3113,39,3152,4824,3,1,3,0,1,0,65.34
臺北市,北投區,溫泉里,0,1,3328,37,3365,5129,3,1,3,0,1,0,65.61
臺北市,北投區,林泉里,0,1,1631,14,1645,2708,2,1,2,0,1,0,60.75
臺北市,北投區,中心里,0,1,2927,31,2958,4946,3,1,3,0,1,0,59.81
臺北市,北投區,中庸里,0,1,2270,35,2305,3496,3,1,3,0,1,0,65.93
臺北市,北投區,開明里,0,1,3457,37,3494,5264,2,1,2,0,1,0,66.38
臺北市,北投區,中和里,0,1,2694,32,2726,4099,2,1,2,0,1,0,66.50
臺北市,北投區,智仁里,0,1,3154,42,3196,4720,2,1,2,0,1,0,67.71
臺北市,北投區,秀山里,0,1,1940,21,1961,2879,4,1,4,0,1,0,68.11
臺北市,北投區,文化里,0,1,2281,27,2308,3361,5,1,5,0,1,0,68.67
臺北市,北投區,豐年里,0,1,2189,22,2211,3351,3,1,3,0,1,0,65.98
臺北市,北投區,稻香里,0,1,2441,32,2473,3998,3,1,3,0,1,0,61.86
臺北市,北投區,桃源里,0,1,2917,44,2961,4428,5,1,5,0,1,0,66.87
臺北市,北投區,一德里,0,1,3247,33,3280,5165,4,1,4,0,1,0,63.50
臺北市,北投區,關渡里,0,1,5422,110,5532,8526,4,1,4,0,1,0,64.88
臺北市,北投區,泉源里,0,1,1300,11,1311,1977,2,1,2,0,1,0,66.31
臺北市,北投區,湖山里,0,1,1130,14,1144,1803,3,1,3,0,1,0,63.45
臺北市,北投區,大屯里,0,1,608,9,617,986,3,1,3,0,1,0,62.58
臺北市,北投區,湖田里,0,1,493,5,498,810,5,1,3,2,0,1,61.48
臺北市,士林區,仁勇里,0,1,2248,26,2274,3377,2,1,2,0,1,0,67.34
臺北市,士林區,義信里,0,1,1839,33,1872,2715,2,1,2,0,1,0,68.95
臺北市,士林區,福林里,0,1,1628,10,1638,2514,4,1,4,0,1,0,65.16
臺北市,士林區,福德里,0,1,2334,30,2364,4619,2,1,2,0,1,0,51.18
臺北市,士林區,福志里,0,1,4235,56,4291,6373,2,1,2,0,1,0,67.33
臺北市,士林區,舊佳里,0,1,3482,43,3525,5234,2,1,2,0,1,0,67.35
臺北市,士林區,福佳里,0,1,4177,38,4215,6161,3,1,3,0,1,0,68.41
臺北市,士林區,後港里,0,1,4122,67,4189,6469,2,1,2,0,1,0,64.75
臺北市,士林區,福中里,0,1,2981,24,3005,4485,2,1,2,0,1,0,67.00
臺北市,士林區,前港里,0,1,2265,27,2292,3490,2,1,2,0,1,0,65.67
臺北市,士林區,百齡里,0,1,3932,52,3984,5836,2,1,2,0,1,0,68.27
臺北市,士林區,承德里,0,1,2922,37,2959,4507,1,1,1,0,1,0,65.65
臺北市,士林區,福華里,0,1,3407,53,3460,5485,2,1,2,0,1,0,63.08
臺北市,士林區,明勝里,0,1,2640,32,2672,4105,2,1,2,0,1,0,65.09
臺北市,士林區,福順里,0,1,2780,52,2832,4294,4,1,4,0,1,0,65.95
臺北市,士林區,富光里,0,1,3123,54,3177,4798,3,1,3,0,1,0,66.22
臺北市,士林區,葫蘆里,0,1,4106,63,4169,6049,4,1,3,1,1,0,68.92
臺北市,士林區,葫東里,0,1,2026,24,2050,3165,2,1,1,1,1,0,64.77
臺北市,士林區,社子里,0,1,3381,43,3424,5079,2,1,2,0,1,0,67.41
臺北市,士林區,社新里,0,1,4505,31,4536,6822,4,1,4,0,1,0,66.49
臺北市,士林區,社園里,0,1,3982,42,4024,5770,3,1,3,0,1,0,69.74
臺北市,士林區,永倫里,0,1,4071,38,4109,5803,2,1,2,0,1,0,70.81
臺北市,士林區,福安里,0,1,2804,32,2836,3943,2,1,2,0,1,0,71.92
臺北市,士林區,富洲里,0,1,3194,38,3232,4469,4,1,3,1,1,0,72.32
臺北市,士林區,岩山里,0,1,1956,22,1978,3103,1,1,1,0,1,0,63.74
臺北市,士林區,名山里,0,1,3827,49,3876,5830,2,1,1,1,1,0,66.48
臺北市,士林區,德行里,0,1,2202,25,2227,3387,6,1,5,1,1,0,65.75
臺北市,士林區,德華里,0,1,2988,32,3020,4763,3,1,2,1,0,1,63.41
臺北市,士林區,聖山里,0,1,2804,29,2833,4264,3,1,3,0,1,0,66.44
臺北市,士林區,忠誠里,0,1,3142,38,3180,4656,2,1,1,1,1,0,68.30
臺北市,士林區,芝山里,0,1,3884,53,3937,5896,3,1,3,0,1,0,66.77
臺北市,士林區,東山里,0,1,2849,43,2892,4216,4,1,4,0,1,0,68.60
臺北市,士林區,三玉里,0,1,2919,46,2965,4557,2,1,2,0,1,0,65.06
臺北市,士林區,蘭雅里,0,1,4443,61,4504,7094,2,1,0,2,0,1,63.49
臺北市,士林區,蘭興里,0,1,3330,41,3371,5011,3,1,3,0,1,0,67.27
臺北市,士林區,天福里,0,1,3272,59,3331,4994,5,1,4,1,1,0,66.70
臺北市,士林區,天祿里,0,1,2676,46,2722,4136,3,1,3,0,1,0,65.81
臺北市,士林區,天壽里,0,1,2484,41,2525,3913,4,1,4,0,1,0,64.53
臺北市,士林區,天和里,0,1,3880,50,3930,6133,5,1,4,1,0,1,64.08
臺北市,士林區,天山里,0,1,3480,55,3535,5652,4,1,3,1,1,0,62.54
臺北市,士林區,天玉里,0,1,4229,67,4296,6778,2,1,2,0,1,0,63.38
臺北市,士林區,天母里,0,1,3391,45,3436,5249,4,1,4,0,1,0,65.46
臺北市,士林區,永福里,0,1,751,9,760,1211,3,1,3,0,1,0,62.76
臺北市,士林區,公館里,0,1,794,5,799,1260,2,1,2,0,1,0,63.41
臺北市,士林區,新安里,0,1,1180,10,1190,1775,4,1,4,0,1,0,67.04
臺北市,士林區,陽明里,0,1,1650,20,1670,2711,3,1,2,1,1,0,61.60
臺北市,士林區,菁山里,0,1,948,12,960,1395,3,1,3,0,1,0,68.82
臺北市,士林區,平等里,0,1,836,7,843,1191,2,1,1,1,1,0,70.78
臺北市,士林區,溪山里,0,1,871,9,880,1292,2,1,1,1,1,0,68.11
臺北市,士林區,翠山里,0,1,1561,20,1581,2475,2,1,1,1,1,0,63.88
臺北市,士林區,臨溪里,0,1,1544,34,1578,2496,2,1,1,1,1,0,63.22
臺北市,內湖區,西湖里,0,2,4106,69,4175,6215,2,1,1,1,1,0,67.18
臺北市,內湖區,西康里,0,2,4329,72,4401,6588,2,1,1,1,1,0,66.80
臺北市,內湖區,西安里,0,2,3321,65,3386,5142,2,1,1,1,1,0,65.85
臺北市,內湖區,港墘里,0,2,2959,49,3008,4564,2,1,1,1,1,0,65.91
臺北市,內湖區,港都里,0,2,2655,45,2700,4044,2,1,1,1,1,0,66.77
臺北市,內湖區,麗山里,0,2,2731,49,2780,4190,2,1,1,1,1,0,66.35
臺北市,內湖區,港富里,0,2,4744,81,4825,7207,2,1,1,1,1,0,66.95
臺北市,內湖區,港華里,0,2,4188,90,4278,6326,2,1,1,1,1,0,67.63
臺北市,內湖區,內湖里,0,2,2946,42,2988,4692,2,1,1,1,1,0,63.68
臺北市,內湖區,湖濱里,0,2,3944,55,3999,5878,2,1,1,1,1,0,68.03
臺北市,內湖區,大湖里,0,2,2555,34,2589,3973,3,1,3,0,1,0,65.16
臺北市,內湖區,秀湖里,0,2,3062,51,3113,4817,3,1,3,0,1,0,64.63
臺北市,內湖區,金龍里,0,2,2852,38,2890,4491,3,1,3,0,1,0,64.35
臺北市,內湖區,金瑞里,0,2,3357,55,3412,5114,4,1,4,0,1,0,66.72
臺北市,內湖區,碧山里,0,2,3530,50,3580,5366,2,1,2,0,1,0,66.72
臺北市,內湖區,瑞光里,0,2,2502,32,2534,3709,5,1,5,0,1,0,68.32
臺北市,內湖區,瑞陽里,0,2,4330,58,4388,6269,3,1,3,0,1,0,70.00
臺北市,內湖區,紫陽里,0,2,3718,49,3767,5910,4,1,4,0,1,0,63.74
臺北市,內湖區,紫星里,0,2,4372,56,4428,6568,4,1,3,1,1,0,67.42
臺北市,內湖區,紫雲里,0,2,3106,54,3160,4665,2,1,2,0,1,0,67.74
臺北市,內湖區,清白里,0,2,3760,63,3823,6003,2,1,2,0,1,0,63.68
臺北市,內湖區,金湖里,0,2,3512,59,3571,5510,3,1,3,0,1,0,64.81
臺北市,內湖區,葫洲里,0,2,4724,77,4801,7448,3,1,3,0,1,0,64.46
臺北市,內湖區,康寧里,0,2,3741,52,3793,5981,2,1,2,0,1,0,63.42
臺北市,內湖區,明湖里,0,2,2353,28,2381,3638,4,1,4,0,1,0,65.45
臺北市,內湖區,五分里,0,2,4442,62,4504,7030,3,1,2,1,0,1,64.07
臺北市,內湖區,東湖里,0,2,3816,55,3871,6127,5,1,5,0,1,0,63.18
臺北市,內湖區,安湖里,0,2,3478,51,3529,5394,2,1,2,0,1,0,65.42
臺北市,內湖區,樂康里,0,2,3795,64,3859,6318,3,1,3,0,1,0,61.08
臺北市,內湖區,內溝里,0,2,2095,29,2124,3328,2,1,2,0,1,0,63.82
臺北市,內湖區,安泰里,0,2,2341,40,2381,3721,3,1,3,0,1,0,63.99
臺北市,內湖區,蘆洲里,0,2,551,4,555,863,2,1,2,0,1,0,64.31
臺北市,內湖區,週美里,0,2,2582,38,2620,3973,3,1,3,0,1,0,65.95
臺北市,內湖區,行善里,0,2,3278,86,3364,5157,2,1,1,1,0,1,65.23
臺北市,內湖區,石潭里,0,2,855,19,874,1345,2,1,1,1,1,0,64.98
臺北市,內湖區,湖興里,0,2,5295,89,5384,9478,4,1,4,0,1,0,56.81
臺北市,內湖區,湖元里,0,2,2607,47,2654,4123,5,1,4,1,1,0,64.37
臺北市,南港區,南港里,0,2,2995,55,3050,4943,3,1,2,1,0,1,61.70
臺北市,南港區,中南里,0,2,2004,24,2028,3182,2,1,2,0,1,0,63.73
臺北市,南港區,三重里,0,2,1639,30,1669,2569,2,1,2,0,1,0,64.97
臺北市,南港區,新富里,0,2,2011,27,2038,3166,3,1,2,1,1,0,64.37
臺北市,南港區,東新里,0,2,4421,69,4490,6969,2,1,2,0,1,0,64.43
臺北市,南港區,東明里,0,2,2388,34,2422,3693,3,1,3,0,1,0,65.58
臺北市,南港區,玉成里,0,2,2448,34,2482,3762,4,1,4,0,1,0,65.98
臺北市,南港區,中研里,0,2,4673,62,4735,7157,5,1,3,2,0,1,66.16
臺北市,南港區,九如里,0,2,3304,46,3350,4964,2,1,2,0,1,0,67.49
臺北市,南港區,舊莊里,0,2,4257,57,4314,6902,3,1,3,0,1,0,62.50
臺北市,南港區,西新里,0,2,2222,42,2264,3600,2,1,2,0,1,0,62.89
臺北市,南港區,合成里,0,2,3517,82,3599,5520,5,1,5,0,1,0,65.20
臺北市,南港區,新光里,0,2,2066,43,2109,3137,1,1,1,0,1,0,67.23
臺北市,南港區,鴻福里,0,2,2414,37,2451,3752,4,1,4,0,1,0,65.33
臺北市,南港區,聯成里,0,2,2804,48,2852,4234,3,1,3,0,1,0,67.36
臺北市,南港區,成福里,0,2,3487,75,3562,5454,2,1,2,0,1,0,65.31
臺北市,南港區,萬福里,0,2,2237,44,2281,3349,3,1,3,0,1,0,68.11
臺北市,南港區,百福里,0,2,2528,57,2585,4060,4,1,4,0,1,0,63.67
臺北市,南港區,仁福里,0,2,2764,55,2819,4384,4,1,3,1,1,0,64.30
臺北市,松山區,莊敬里,0,3,3016,62,3078,4727,4,1,4,0,1,0,65.12
臺北市,松山區,東榮里,0,3,4240,82,4322,6728,2,1,2,0,1,0,64.24
臺北市,松山區,三民里,0,3,3499,63,3562,5555,3,1,3,0,1,0,64.12
臺北市,松山區,新益里,0,3,2386,45,2431,3761,3,1,2,1,0,1,64.64
臺北市,松山區,富錦里,0,3,2706,66,2772,4243,1,1,1,0,1,0,65.33
臺北市,松山區,新東里,0,3,2493,52,2545,4040,2,1,1,1,1,0,63.00
臺北市,松山區,富泰里,0,3,2323,42,2365,3735,3,1,2,1,0,1,63.32
臺北市,松山區,介壽里,0,3,2361,52,2413,3695,4,1,4,0,1,0,65.30
臺北市,松山區,精忠里,0,3,2210,52,2262,3623,2,1,2,0,1,0,62.43
臺北市,松山區,東光里,0,3,3804,65,3869,6030,4,1,3,1,1,0,64.16
臺北市,松山區,龍田里,0,3,4795,112,4907,7519,2,1,2,0,1,0,65.26
臺北市,松山區,東昌里,0,3,1389,37,1426,2204,2,1,2,0,1,0,64.70
臺北市,松山區,東勢里,0,3,2300,42,2342,3625,5,1,5,0,1,0,64.61
臺北市,松山區,中華里,0,3,3188,49,3237,4931,4,1,4,0,1,0,65.65
臺北市,松山區,民有里,0,3,4429,127,4556,7105,4,1,4,0,1,0,64.12
臺北市,松山區,民福里,0,3,3440,80,3520,5262,2,1,2,0,1,0,66.89
臺北市,松山區,慈祐里,0,3,2978,57,3035,5578,3,1,3,0,1,0,54.41
臺北市,松山區,安平里,0,3,4633,85,4718,6838,2,1,2,0,1,0,69.00
臺北市,松山區,鵬程里,0,3,2989,46,3035,4655,3,1,3,0,1,0,65.20
臺北市,松山區,自強里,0,3,4996,88,5084,7481,2,1,2,0,1,0,67.96
臺北市,松山區,吉祥里,0,3,4280,97,4377,6859,2,1,2,0,1,0,63.81
臺北市,松山區,新聚里,0,3,3972,76,4048,6212,2,1,1,1,0,1,65.16
臺北市,松山區,復盛里,0,3,3427,78,3505,5294,2,1,2,0,1,0,66.21
臺北市,松山區,中正里,0,3,3912,101,4013,6645,2,1,1,1,1,0,60.39
臺北市,松山區,中崙里,0,3,2026,41,2067,3160,2,1,2,0,1,0,65.41
臺北市,松山區,美仁里,0,3,1691,35,1726,2665,3,1,3,0,1,0,64.77
臺北市,松山區,吉仁里,0,3,2027,47,2074,3194,2,1,2,0,1,0,64.93
臺北市,松山區,敦化里,0,3,3595,102,3697,5620,2,1,2,0,1,0,65.78
臺北市,松山區,復源里,0,3,1574,45,1619,2510,2,1,2,0,1,0,64.50
臺北市,松山區,復建里,0,3,1932,46,1978,3138,2,1,2,0,1,0,63.03
臺北市,松山區,復勢里,0,3,3053,53,3106,4799,3,1,3,0,1,0,64.72
臺北市,松山區,福成里,0,3,1329,42,1371,2122,3,1,2,1,1,0,64.61
臺北市,松山區,松基里,0,3,1892,44,1936,3074,3,1,3,0,1,0,62.98
臺北市,信義區,西村里,0,3,2630,54,2684,4980,2,1,2,0,1,0,53.90
臺北市,信義區,正和里,0,3,2492,49,2541,3908,2,1,2,0,1,0,65.02
臺北市,信義區,興隆里,0,3,1474,35,1509,2519,1,1,1,0,1,0,59.90
臺北市,信義區,中興里,0,3,1470,26,1496,2619,3,1,3,0,1,0,57.12
臺北市,信義區,新仁里,0,3,1825,44,1869,2852,1,1,1,0,1,0,65.53
臺北市,信義區,興雅里,0,3,3137,73,3210,4849,2,1,2,0,1,0,66.20
臺北市,信義區,敦厚里,0,3,2438,37,2475,3893,2,1,2,0,1,0,63.58
臺北市,信義區,廣居里,0,3,3843,60,3903,6082,2,1,2,0,1,0,64.17
臺北市,信義區,安康里,0,3,4076,85,4161,6607,4,1,4,0,1,0,62.98
臺北市,信義區,六藝里,0,3,1948,40,1988,2982,6,1,6,0,1,0,66.67
臺北市,信義區,雅祥里,0,3,2577,33,2610,4002,3,1,2,1,0,1,65.22
臺北市,信義區,五常里,0,3,1919,46,1965,3055,6,1,6,0,1,0,64.32
臺北市,信義區,五全里,0,3,2821,42,2863,4242,2,1,2,0,1,0,67.49
臺北市,信義區,永吉里,0,3,2241,57,2298,3598,1,1,1,0,1,0,63.87
臺北市,信義區,長春里,0,3,2307,40,2347,3544,4,1,4,0,1,0,66.22
臺北市,信義區,四育里,0,3,3106,61,3167,4676,2,1,2,0,1,0,67.73
臺北市,信義區,四維里,0,3,2728,65,2793,4531,2,1,2,0,1,0,61.64
臺北市,信義區,永春里,0,3,2668,74,2742,4266,4,1,2,2,0,1,64.28
臺北市,信義區,富台里,0,3,2123,33,2156,3364,2,1,2,0,1,0,64.09
臺北市,信義區,國業里,0,3,3782,54,3836,5994,3,1,2,1,1,0,64.00
臺北市,信義區,松隆里,0,3,1234,18,1252,2020,2,1,2,0,1,0,61.98
臺北市,信義區,松友里,0,3,3330,59,3389,5381,1,1,1,0,1,0,62.98
臺北市,信義區,松光里,0,3,2761,49,2810,4406,2,1,2,0,1,0,63.78
臺北市,信義區,中坡里,0,3,2376,48,2424,3737,1,1,1,0,1,0,64.86
臺北市,信義區,中行里,0,3,4151,82,4233,6491,3,1,3,0,1,0,65.21
臺北市,信義區,大道里,0,3,3385,56,3441,5405,1,1,1,0,1,0,63.66
臺北市,信義區,大仁里,0,3,2721,58,2779,4084,2,1,2,0,1,0,68.05
臺北市,信義區,景新里,0,3,2622,58,2680,4129,2,1,2,0,1,0,64.91
臺北市,信義區,惠安里,0,3,3604,79,3683,5480,2,1,2,0,1,0,67.21
臺北市,信義區,三張里,0,3,4869,86,4955,7566,3,1,3,0,1,0,65.49
臺北市,信義區,三犁里,0,3,2601,35,2636,4154,1,1,1,0,1,0,63.46
臺北市,信義區,六合里,0,3,3421,53,3474,5641,2,1,2,0,1,0,61.58
臺北市,信義區,泰和里,0,3,4109,85,4194,6613,2,1,2,0,1,0,63.42
臺北市,信義區,景聯里,0,3,2504,55,2559,3913,3,1,3,0,1,0,65.40
臺北市,信義區,景勤里,0,3,2346,46,2392,3619,1,1,1,0,1,0,66.10
臺北市,信義區,雙和里,0,3,3806,73,3879,5921,7,1,7,0,1,0,65.51
臺北市,信義區,嘉興里,0,3,1727,39,1766,2666,2,1,2,0,1,0,66.24
臺北市,信義區,黎順里,0,3,2210,48,2258,3542,4,1,3,1,1,0,63.75
臺北市,信義區,黎平里,0,3,3649,75,3724,5622,5,1,4,1,1,0,66.24
臺北市,信義區,黎忠里,0,3,2587,65,2652,4027,3,1,3,0,1,0,65.86
臺北市,信義區,黎安里,0,3,1409,34,1443,2193,2,1,2,0,1,0,65.80
臺北市,中山區,正守里,0,4,1493,36,1529,2400,3,1,3,0,1,0,63.71
臺北市,中山區,正義里,0,4,2035,52,2087,3663,4,1,3,1,0,1,56.98
臺北市,中山區,正得里,0,4,1481,25,1506,2689,2,1,2,0,1,0,56.01
臺北市,中山區,民安里,0,4,2614,49,2663,4178,3,1,3,0,1,0,63.74
臺北市,中山區,康樂里,0,4,1092,20,1112,2004,2,1,2,0,1,0,55.49
臺北市,中山區,中山里,0,4,2453,43,2496,4278,2,1,2,0,1,0,58.35
臺北市,中山區,聚盛里,0,4,1629,35,1664,3038,3,1,3,0,1,0,54.77
臺北市,中山區,集英里,0,4,3090,64,3154,5068,2,1,2,0,1,0,62.23
臺北市,中山區,聚葉里,0,4,1813,21,1834,3086,2,1,2,0,1,0,59.43
臺北市,中山區,恒安里,0,4,1939,47,1986,3260,2,1,2,0,1,0,60.92
臺北市,中山區,晴光里,0,4,2122,51,2173,3824,1,1,1,0,1,0,56.83
臺北市,中山區,圓山里,0,4,1760,36,1796,3110,2,1,2,0,1,0,57.75
臺北市,中山區,新庄里,0,4,2488,44,2532,4035,3,1,3,0,1,0,62.75
臺北市,中山區,劍潭里,0,4,2142,23,2165,3183,3,1,2,1,1,0,68.02
臺北市,中山區,大直里,0,4,5018,75,5093,7628,4,1,4,0,1,0,66.77
臺北市,中山區,成功里,0,4,2017,40,2057,3147,4,1,4,0,1,0,65.36
臺北市,中山區,永安里,0,4,4455,92,4547,6934,2,1,2,0,1,0,65.58
臺北市,中山區,大佳里,0,4,709,9,718,1046,3,1,3,0,1,0,68.64
臺北市,中山區,金泰里,0,4,2891,61,2952,4695,2,1,2,0,1,0,62.88
臺北市,中山區,北安里,0,4,1490,23,1513,2208,2,1,2,0,1,0,68.52
臺北市,中山區,新喜里,0,4,2595,43,2638,4040,3,1,3,0,1,0,65.30
臺北市,中山區,新福里,0,4,2668,59,2727,4223,2,1,2,0,1,0,64.57
臺北市,中山區,松江里,0,4,3340,49,3389,5035,3,1,3,0,1,0,67.31
臺北市,中山區,新生里,0,4,2710,68,2778,4151,5,1,5,0,1,0,66.92
臺北市,中山區,中庄里,0,4,2715,43,2758,4380,3,1,3,0,1,0,62.97
臺北市,中山區,行政里,0,4,2900,66,2966,5873,4,1,4,0,1,0,50.50
臺北市,中山區,行仁里,0,4,4176,86,4262,6564,2,1,2,0,1,0,64.93
臺北市,中山區,行孝里,0,4,2136,29,2165,3471,3,1,3,0,1,0,62.37
臺北市,中山區,下埤里,0,4,3753,98,3851,6003,2,1,2,0,1,0,64.15
臺北市,中山區,江寧里,0,4,3467,55,3522,5522,4,1,3,1,1,0,63.78
臺北市,中山區,江山里,0,4,3974,81,4055,6350,2,1,2,0,1,0,63.86
臺北市,中山區,中吉里,0,4,2617,47,2664,4187,4,1,4,0,1,0,63.63
臺北市,中山區,中原里,0,4,2491,33,2524,3947,2,1,2,0,1,0,63.95
臺北市,中山區,興亞里,0,4,2521,32,2553,4152,3,1,3,0,1,0,61.49
臺北市,中山區,中央里,0,4,1884,30,1914,2934,3,1,3,0,1,0,65.24
臺北市,中山區,朱馥里,0,4,2995,62,3057,4885,2,1,1,1,1,0,62.58
臺北市,中山區,龍洲里,0,4,2873,54,2927,4245,3,1,2,1,0,1,68.95
臺北市,中山區,朱園里,0,4,2225,57,2282,3663,2,1,2,0,1,0,62.30
臺北市,中山區,埤頭里,0,4,1899,56,1955,3073,2,1,2,0,1,0,63.62
臺北市,中山區,朱崙里,0,4,1509,34,1543,2506,5,1,5,0,1,0,61.57
臺北市,中山區,力行里,0,4,3009,71,3080,4922,2,1,2,0,1,0,62.58
臺北市,中山區,復華里,0,4,2080,39,2119,3425,3,1,3,0,1,0,61.87
臺北市,大同區,玉泉里,0,4,1620,42,1662,2701,2,1,2,0,1,0,61.53
臺北市,大同區,建明里,0,4,1739,34,1773,2760,2,1,2,0,1,0,64.24
臺北市,大同區,建功里,0,4,2440,52,2492,3906,4,1,4,0,1,0,63.80
臺北市,大同區,建泰里,0,4,1813,46,1859,2883,4,1,4,0,1,0,64.48
臺北市,大同區,永樂里,0,4,2667,38,2705,4305,2,1,2,0,1,0,62.83
臺北市,大同區,朝陽里,0,4,2013,39,2052,3299,2,1,2,0,1,0,62.20
臺北市,大同區,星明里,0,4,2669,45,2714,4210,2,1,2,0,1,0,64.47
臺北市,大同區,光能里,0,4,2665,63,2728,4157,2,1,2,0,1,0,65.62
臺北市,大同區,大有里,0,4,2690,46,2736,4074,2,1,2,0,1,0,67.16
臺北市,大同區,延平里,0,4,2089,39,2128,3328,2,1,2,0,1,0,63.94
臺北市,大同區,雙連里,0,4,4883,55,4938,7652,1,1,1,0,1,0,64.53
臺北市,大同區,南芳里,0,4,2088,46,2134,3368,2,1,2,0,1,0,63.36
臺北市,大同區,民權里,0,4,3187,56,3243,5061,2,1,2,0,1,0,64.08
臺北市,大同區,景星里,0,4,1581,35,1616,2419,2,1,2,0,1,0,66.80
臺北市,大同區,隆和里,0,4,1769,25,1794,2638,2,1,2,0,1,0,68.01
臺北市,大同區,蓬萊里,0,4,2432,46,2478,3857,2,1,2,0,1,0,64.25
臺北市,大同區,國順里,0,4,1687,40,1727,2578,2,1,2,0,1,0,66.99
臺北市,大同區,國慶里,0,4,2104,34,2138,3258,3,1,2,1,1,0,65.62
臺北市,大同區,揚雅里,0,4,1778,44,1822,3309,2,1,2,0,1,0,55.06
臺北市,大同區,斯文里,0,4,2721,55,2776,4322,2,1,2,0,1,0,64.23
臺北市,大同區,鄰江里,0,4,3347,68,3415,5142,3,1,3,0,1,0,66.41
臺北市,大同區,至聖里,0,4,4078,68,4146,6262,1,1,1,0,1,0,66.21
臺北市,大同區,老師里,0,4,3041,54,3095,4730,2,1,2,0,1,0,65.43
臺北市,大同區,重慶里,0,4,3096,62,3158,4635,1,1,1,0,1,0,68.13
臺北市,大同區,保安里,0,4,2328,47,2375,3483,2,1,2,0,1,0,68.19
臺北市,中正區,水源里,0,5,1511,40,1551,2509,2,1,2,0,1,0,61.82
臺北市,中正區,富水里,0,5,1541,31,1572,2512,2,1,2,0,1,0,62.58
臺北市,中正區,文盛里,0,5,1418,35,1453,2222,2,1,2,0,1,0,65.39
臺北市,中正區,林興里,0,5,2413,51,2464,3871,2,1,2,0,1,0,63.65
臺北市,中正區,河堤里,0,5,2373,44,2417,3836,2,1,2,0,1,0,63.01
臺北市,中正區,頂東里,0,5,3049,55,3104,4710,3,1,3,0,1,0,65.90
臺北市,中正區,網溪里,0,5,2815,73,2888,4433,4,1,3,1,1,0,65.15
臺北市,中正區,板溪里,0,5,1796,39,1835,2812,3,1,2,1,1,0,65.26
臺北市,中正區,螢圃里,0,5,3008,43,3051,4499,2,1,2,0,1,0,67.82
臺北市,中正區,螢雪里,0,5,2369,40,2409,3647,2,1,1,1,0,1,66.05
臺北市,中正區,永功里,0,5,3196,39,3235,4986,2,1,2,0,1,0,64.88
臺北市,中正區,永昌里,0,5,2843,35,2878,4396,3,1,2,1,1,0,65.47
臺北市,中正區,龍興里,0,5,1998,37,2035,3061,3,1,3,0,1,0,66.48
臺北市,中正區,忠勤里,0,5,3553,49,3602,5601,2,1,2,0,1,0,64.31
臺北市,中正區,廈安里,0,5,1900,34,1934,3027,3,1,2,1,1,0,63.89
臺北市,中正區,愛國里,0,5,1606,18,1624,2494,3,1,3,0,1,0,65.12
臺北市,中正區,南門里,0,5,1391,17,1408,2228,2,1,2,0,1,0,63.20
臺北市,中正區,龍光里,0,5,1703,32,1735,2729,1,1,1,0,1,0,63.58
臺北市,中正區,南福里,0,5,4262,84,4346,6614,3,1,2,1,1,0,65.71
臺北市,中正區,龍福里,0,5,3012,48,3060,5484,3,1,3,0,1,0,55.80
臺北市,中正區,新營里,0,5,4016,93,4109,6405,2,1,2,0,1,0,64.15
臺北市,中正區,建國里,0,5,622,5,627,1064,2,1,2,0,1,0,58.93
臺北市,中正區,光復里,0,5,1736,47,1783,3021,3,1,3,0,1,0,59.02
臺北市,中正區,黎明里,0,5,1342,32,1374,2458,9,1,8,1,1,0,55.90
臺北市,中正區,梅花里,0,5,1725,42,1767,2800,3,1,3,0,1,0,63.11
臺北市,中正區,幸福里,0,5,2223,52,2275,3685,1,1,1,0,1,0,61.74
臺北市,中正區,幸市里,0,5,2111,59,2170,3481,3,1,3,0,1,0,62.34
臺北市,中正區,東門里,0,5,2127,47,2174,3535,3,1,3,0,1,0,61.50
臺北市,中正區,文北里,0,5,2518,64,2582,4077,3,1,3,0,1,0,63.33
臺北市,中正區,文祥里,0,5,3590,74,3664,5671,3,1,3,0,1,0,64.61
臺北市,中正區,三愛里,0,5,3831,104,3935,6288,1,1,1,0,1,0,62.58
臺北市,萬華區,福星里,0,5,2594,47,2641,4340,2,1,2,0,1,0,60.85
臺北市,萬華區,萬壽里,0,5,1603,36,1639,2925,2,1,2,0,1,0,56.03
臺北市,萬華區,西門里,0,5,1747,31,1778,3136,2,1,2,0,1,0,56.70
臺北市,萬華區,新起里,0,5,3316,76,3392,5469,2,1,2,0,1,0,62.02
臺北市,萬華區,菜園里,0,5,3039,62,3101,4892,2,1,2,0,1,0,63.39
臺北市,萬華區,青山里,0,5,2828,51,2879,4600,2,1,2,0,1,0,62.59
臺北市,萬華區,富民里,0,5,2832,49,2881,4370,2,1,2,0,1,0,65.93
臺北市,萬華區,福音里,0,5,2012,25,2037,3025,2,1,2,0,1,0,67.34
臺北市,萬華區,仁德里,0,5,2374,47,2421,3593,2,1,2,0,1,0,67.38
臺北市,萬華區,富福里,0,5,2570,31,2601,4126,2,1,2,0,1,0,63.04
臺北市,萬華區,柳鄉里,0,5,2859,39,2898,4508,2,1,2,0,1,0,64.29
臺北市,萬華區,華江里,0,5,4493,80,4573,7011,2,1,2,0,1,0,65.23
臺北市,萬華區,糖廍里,0,5,2947,66,3013,4660,2,1,2,0,1,0,64.66
臺北市,萬華區,綠堤里,0,5,2256,31,2287,3717,2,1,2,0,1,0,61.53
臺北市,萬華區,頂碩里,0,5,4391,49,4440,7060,2,1,2,0,1,0,62.89
臺北市,萬華區,雙園里,0,5,2501,39,2540,3870,2,1,2,0,1,0,65.63
臺北市,萬華區,和平里,0,5,3943,63,4006,5969,2,1,2,0,1,0,67.11
臺北市,萬華區,和德里,0,5,3567,69,3636,5843,2,1,2,0,1,0,62.23
臺北市,萬華區,全德里,0,5,2229,26,2255,3545,2,1,2,0,1,0,63.61
臺北市,萬華區,日善里,0,5,2076,35,2111,3169,2,1,2,0,1,0,66.61
臺北市,萬華區,壽德里,0,5,2883,39,2922,4407,2,1,2,0,1,0,66.30
臺北市,萬華區,忠德里,0,5,2522,26,2548,3744,2,1,2,0,1,0,68.06
臺北市,萬華區,錦德里,0,5,2883,42,2925,4476,2,1,2,0,1,0,65.35
臺北市,萬華區,銘德里,0,5,2566,42,2608,3893,2,1,2,0,1,0,66.99
臺北市,萬華區,孝德里,0,5,1798,26,1824,2681,2,1,2,0,1,0,68.03
臺北市,萬華區,保德里,0,5,1683,25,1708,2449,2,1,2,0,1,0,69.74
臺北市,萬華區,榮德里,0,5,2301,40,2341,3291,2,1,2,0,1,0,71.13
臺北市,萬華區,華中里,0,5,3386,44,3430,5126,2,1,2,0,1,0,66.91
臺北市,萬華區,興德里,0,5,2479,40,2519,3892,2,1,2,0,1,0,64.72
臺北市,萬華區,日祥里,0,5,2623,39,2662,4026,2,1,2,0,1,0,66.12
臺北市,萬華區,忠貞里,0,5,2900,39,2939,4282,2,1,2,0,1,0,68.64
臺北市,萬華區,新忠里,0,5,2137,30,2167,3275,2,1,2,0,1,0,66.17
臺北市,萬華區,新和里,0,5,4958,65,5023,7348,2,1,2,0,1,0,68.36
臺北市,萬華區,新安里,0,5,3446,51,3497,5368,2,1,2,0,1,0,65.15
臺北市,萬華區,凌霄里,0,5,2185,30,2215,3398,2,1,2,0,1,0,65.19
臺北市,萬華區,騰雲里,0,5,1725,27,1752,2622,2,1,2,0,1,0,66.82
臺北市,大安區,德安里,0,6,2825,44,2869,4739,2,1,2,0,1,0,60.54
臺北市,大安區,仁慈里,0,6,2375,45,2420,3894,2,1,2,0,1,0,62.15
臺北市,大安區,和安里,0,6,3286,36,3322,5159,2,1,2,0,1,0,64.39
臺北市,大安區,民炤里,0,6,3898,58,3956,6344,2,1,2,0,1,0,62.36
臺北市,大安區,仁愛里,0,6,2590,51,2641,4697,2,1,2,0,1,0,56.23
臺北市,大安區,義村里,0,6,3492,36,3528,5458,2,1,2,0,1,0,64.64
臺北市,大安區,民輝里,0,6,3453,63,3516,5629,2,1,2,0,1,0,62.46
臺北市,大安區,昌隆里,0,6,1698,34,1732,2710,2,1,2,0,1,0,63.91
臺北市,大安區,誠安里,0,6,2279,58,2337,3679,2,1,2,0,1,0,63.52
臺北市,大安區,光武里,0,6,3868,66,3934,6578,2,1,2,0,1,0,59.81
臺北市,大安區,龍坡里,0,6,2939,37,2976,4721,2,1,2,0,1,0,63.04
臺北市,大安區,龍泉里,0,6,2250,17,2267,3630,2,1,2,0,1,0,62.45
臺北市,大安區,古風里,0,6,2097,30,2127,3399,2,1,2,0,1,0,62.58
臺北市,大安區,古莊里,0,6,3280,48,3328,5305,2,1,2,0,1,0,62.73
臺北市,大安區,龍安里,0,6,2834,31,2865,5802,2,1,2,0,1,0,49.38
臺北市,大安區,錦安里,0,6,2604,33,2637,4159,2,1,2,0,1,0,63.40
臺北市,大安區,福住里,0,6,2813,41,2854,4495,2,1,2,0,1,0,63.49
臺北市,大安區,永康里,0,6,1677,17,1694,2651,2,1,2,0,1,0,63.90
臺北市,大安區,光明里,0,6,1918,22,1940,2915,2,1,2,0,1,0,66.55
臺北市,大安區,錦泰里,0,6,2557,42,2599,3961,2,1,2,0,1,0,65.61
臺北市,大安區,錦華里,0,6,2653,23,2676,4050,2,1,2,0,1,0,66.07
臺北市,大安區,龍圖里,0,6,3276,42,3318,5341,2,1,2,0,1,0,62.12
臺北市,大安區,新龍里,0,6,3386,40,3426,5250,2,1,2,0,1,0,65.26
臺北市,大安區,龍陣里,0,6,1827,23,1850,2946,2,1,2,0,1,0,62.80
臺北市,大安區,龍雲里,0,6,2515,60,2575,4028,2,1,2,0,1,0,63.93
臺北市,大安區,龍生里,0,6,3297,39,3336,5010,2,1,2,0,1,0,66.59
臺北市,大安區,住安里,0,6,2630,35,2665,4321,2,1,2,0,1,0,61.68
臺北市,大安區,義安里,0,6,2807,35,2842,4561,2,1,2,0,1,0,62.31
臺北市,大安區,通化里,0,6,3219,53,3272,5019,2,1,2,0,1,0,65.19
臺北市,大安區,通安里,0,6,2938,47,2985,4721,2,1,2,0,1,0,63.23
臺北市,大安區,臨江里,0,6,2270,39,2309,3436,2,1,2,0,1,0,67.20
臺北市,大安區,法治里,0,6,2331,53,2384,3646,2,1,2,0,1,0,65.39
臺北市,大安區,全安里,0,6,2248,40,2288,3639,2,1,2,0,1,0,62.87
臺北市,大安區,群賢里,0,6,3126,42,3168,5064,2,1,2,0,1,0,62.56
臺北市,大安區,群英里,0,6,3956,51,4007,5931,2,1,2,0,1,0,67.56
臺北市,大安區,虎嘯里,0,6,1821,29,1850,2917,2,1,2,0,1,0,63.42
臺北市,大安區,臥龍里,0,6,1118,21,1139,1780,2,1,2,0,1,0,63.99
臺北市,大安區,龍淵里,0,6,4571,59,4630,7032,2,1,2,0,1,0,65.84
臺北市,大安區,龍門里,0,6,2070,22,2092,3325,2,1,2,0,1,0,62.92
臺北市,大安區,大學里,0,6,4031,54,4085,6537,2,1,2,0,1,0,62.49
臺北市,大安區,芳和里,0,6,3307,51,3358,5131,2,1,2,0,1,0,65.45
臺北市,大安區,黎元里,0,6,2922,44,2966,4545,2,1,2,0,1,0,65.26
臺北市,大安區,黎孝里,0,6,4190,57,4247,6247,2,1,2,0,1,0,67.98
臺北市,大安區,黎和里,0,6,2398,30,2428,3709,2,1,2,0,1,0,65.46
臺北市,大安區,建安里,0,6,2454,37,2491,4141,2,1,2,0,1,0,60.15
臺北市,大安區,建倫里,0,6,2897,43,2940,4983,2,1,2,0,1,0,59.00
臺北市,大安區,敦安里,0,6,2982,57,3039,4989,2,1,2,0,1,0,60.91
臺北市,大安區,正聲里,0,6,2425,50,2475,4062,2,1,2,0,1,0,60.93
臺北市,大安區,敦煌里,0,6,3000,49,3049,4834,2,1,2,0,1,0,63.07
臺北市,大安區,華聲里,0,6,2217,40,2257,3568,2,1,2,0,1,0,63.26
臺北市,大安區,車層里,0,6,3162,44,3206,5335,2,1,2,0,1,0,60.09
臺北市,大安區,光信里,0,6,4024,61,4085,6365,2,1,2,0,1,0,64.18
臺北市,大安區,學府里,0,6,1912,28,1940,3003,2,1,2,0,1,0,64.60
臺北市,文山區,景行里,0,6,2796,37,2833,4451,2,1,2,0,1,0,63.65
臺北市,文山區,景東里,0,6,3442,47,3489,5407,2,1,2,0,1,0,64.53
臺北市,文山區,景美里,0,6,2410,30,2440,3721,2,1,2,0,1,0,65.57
臺北市,文山區,景慶里,0,6,3325,44,3369,5119,2,1,2,0,1,0,65.81
臺北市,文山區,景仁里,0,6,2406,27,2433,3616,2,1,2,0,1,0,67.28
臺北市,文山區,景華里,0,6,3034,36,3070,4669,2,1,2,0,1,0,65.75
臺北市,文山區,萬有里,0,6,2514,23,2537,3787,2,1,2,0,1,0,66.99
臺北市,文山區,萬祥里,0,6,2440,40,2480,3673,2,1,2,0,1,0,67.52
臺北市,文山區,萬隆里,0,6,3867,46,3913,5798,2,1,2,0,1,0,67.49
臺北市,文山區,萬年里,0,6,2777,36,2813,4305,2,1,2,0,1,0,65.34
臺北市,文山區,萬和里,0,6,1712,9,1721,2576,2,1,2,0,1,0,66.81
臺北市,文山區,萬盛里,0,6,2393,29,2422,3788,2,1,2,0,1,0,63.94
臺北市,文山區,興豐里,0,6,4698,54,4752,7125,2,1,2,0,1,0,66.69
臺北市,文山區,興光里,0,6,1631,17,1648,2540,2,1,2,0,1,0,64.88
臺北市,文山區,興家里,0,6,3912,43,3955,5904,2,1,2,0,1,0,66.99
臺北市,文山區,興得里,0,6,3051,34,3085,4994,2,1,2,0,1,0,61.77
臺北市,文山區,興業里,0,6,2859,35,2894,4860,2,1,2,0,1,0,59.55
臺北市,文山區,興安里,0,6,3338,34,3372,5072,2,1,2,0,1,0,66.48
臺北市,文山區,興福里,0,6,3085,35,3120,4644,2,1,2,0,1,0,67.18
臺北市,文山區,興旺里,0,6,3627,56,3683,5633,2,1,2,0,1,0,65.38
臺北市,文山區,興泰里,0,6,1948,24,1972,3012,2,1,2,0,1,0,65.47
臺北市,文山區,興昌里,0,6,3315,38,3353,5288,2,1,2,0,1,0,63.41
臺北市,文山區,試院里,0,6,3471,50,3521,5214,2,1,2,0,1,0,67.53
臺北市,文山區,華興里,0,6,3929,51,3980,6104,2,1,2,0,1,0,65.20
臺北市,文山區,明義里,0,6,2248,41,2289,3879,2,1,2,0,1,0,59.01
臺北市,文山區,明興里,0,6,3605,38,3643,5606,2,1,2,0,1,0,64.98
臺北市,文山區,木柵里,0,6,4056,41,4097,6039,2,1,2,0,1,0,67.84
臺北市,文山區,木新里,0,6,4529,74,4603,7145,2,1,2,0,1,0,64.42
臺北市,文山區,順興里,0,6,3725,59,3784,5626,2,1,2,0,1,0,67.26
臺北市,文山區,忠順里,0,6,2072,25,2097,3098,2,1,2,0,1,0,67.69
臺北市,文山區,樟林里,0,6,4323,49,4372,6657,2,1,2,0,1,0,65.68
臺北市,文山區,樟新里,0,6,5872,103,5975,9164,2,1,2,0,1,0,65.20
臺北市,文山區,樟腳里,0,6,4856,93,4949,7295,2,1,2,0,1,0,67.84
臺北市,文山區,萬芳里,0,6,3903,31,3934,6071,2,1,2,0,1,0,64.80
臺北市,文山區,萬美里,0,6,3382,41,3423,5438,2,1,2,0,1,0,62.95
臺北市,文山區,博嘉里,0,6,2671,40,2711,4087,2,1,2,0,1,0,66.33
臺北市,文山區,萬興里,0,6,6184,66,6250,9546,2,1,2,0,1,0,65.47
臺北市,文山區,指南里,0,6,1495,23,1518,2352,2,1,2,0,1,0,64.54
臺北市,文山區,老泉里,0,6,450,4,454,705,2,1,2,0,1,0,64.40
高雄市,鹽埕區,藍橋里,0,1,936,12,948,1290,2,1,2,0,1,0,73.49
高雄市,鹽埕區,慈愛里,0,1,333,9,342,439,2,1,2,0,1,0,77.90
高雄市,鹽埕區,博愛里,0,1,539,13,552,720,2,1,2,0,1,0,76.67
高雄市,鹽埕區,壽星里,0,1,946,15,961,1357,2,1,2,0,1,0,70.82
高雄市,鹽埕區,中山里,0,1,856,10,866,1170,2,1,2,0,1,0,74.02
高雄市,鹽埕區,教仁里,0,1,1600,17,1617,2179,2,1,2,0,1,0,74.21
高雄市,鹽埕區,新樂里,0,1,659,14,673,910,2,1,2,0,1,0,73.96
高雄市,鹽埕區,中原里,0,1,540,5,545,730,2,1,2,0,1,0,74.66
高雄市,鹽埕區,光明里,0,1,809,11,820,1262,2,1,2,0,1,0,64.98
高雄市,鹽埕區,育仁里,0,1,573,8,581,822,2,1,2,0,1,0,70.68
高雄市,鹽埕區,河濱里,0,1,1259,18,1277,1822,2,1,2,0,1,0,70.09
高雄市,鹽埕區,沙地里,0,1,720,6,726,1042,2,1,2,0,1,0,69.67
高雄市,鹽埕區,南端里,0,1,813,15,828,1136,2,1,2,0,1,0,72.89
高雄市,鹽埕區,港都里,0,1,763,8,771,1149,2,1,2,0,1,0,67.10
高雄市,鹽埕區,江西里,0,1,863,11,874,1189,2,1,2,0,1,0,73.51
高雄市,鹽埕區,新豐里,0,1,444,11,455,563,2,1,2,0,1,0,80.82
高雄市,鹽埕區,府北里,0,1,1185,24,1209,1799,2,1,2,0,1,0,67.20
高雄市,鹽埕區,陸橋里,0,1,889,16,905,1266,2,1,2,0,1,0,71.48
高雄市,鹽埕區,瀨南里,0,1,496,9,505,690,2,1,2,0,1,0,73.19
高雄市,鹽埕區,新化里,0,1,544,6,550,690,2,1,2,0,1,0,79.71
高雄市,鹽埕區,江南里,0,1,596,12,608,874,2,1,2,0,1,0,69.57
高雄市,鼓山區,鼓峰里,0,1,1412,14,1426,1989,2,1,2,0,1,0,71.69
高雄市,鼓山區,雄峰里,0,1,1443,29,1472,2088,2,1,2,0,1,0,70.50
高雄市,鼓山區,前峰里,0,1,3108,41,3149,4238,2,1,2,0,1,0,74.30
高雄市,鼓山區,光榮里,0,1,2752,35,2787,3776,2,1,2,0,1,0,73.81
高雄市,鼓山區,民族里,0,1,1088,19,1107,1433,2,1,2,0,1,0,77.25
高雄市,鼓山區,內惟里,0,1,861,8,869,1185,2,1,2,0,1,0,73.33
高雄市,鼓山區,建國里,0,1,1630,20,1650,2184,2,1,2,0,1,0,75.55
高雄市,鼓山區,忠正里,0,1,2784,36,2820,3878,2,1,2,0,1,0,72.72
高雄市,鼓山區,自強里,0,1,593,6,599,802,2,1,2,0,1,0,74.69
高雄市,鼓山區,龍井里,0,1,966,17,983,1440,2,1,2,0,1,0,68.26
高雄市,鼓山區,正德里,0,1,1344,27,1371,1869,2,1,2,0,1,0,73.35
高雄市,鼓山區,平和里,0,1,2311,36,2347,3287,2,1,2,0,1,0,71.40
高雄市,鼓山區,民強里,0,1,1988,28,2016,2731,2,1,2,0,1,0,73.82
高雄市,鼓山區,厚生里,0,1,1908,32,1940,2721,2,1,2,0,1,0,71.30
高雄市,鼓山區,龍子里,0,1,4777,116,4893,7278,2,1,2,0,1,0,67.23
高雄市,鼓山區,龍水里,0,1,3566,92,3658,5753,2,1,2,0,1,0,63.58
高雄市,鼓山區,明誠里,0,1,7958,167,8125,12170,2,1,2,0,1,0,66.76
高雄市,鼓山區,華豐里,0,1,2529,57,2586,3626,2,1,2,0,1,0,71.32
高雄市,鼓山區,裕興里,0,1,1963,40,2003,2836,2,1,2,0,1,0,70.63
高雄市,鼓山區,裕豐里,0,1,1540,23,1563,2345,2,1,2,0,1,0,66.65
高雄市,鼓山區,鼓岩里,0,1,1030,15,1045,1446,2,1,2,0,1,0,72.27
高雄市,鼓山區,樹德里,0,1,939,6,945,1194,2,1,2,0,1,0,79.15
高雄市,鼓山區,寶樹里,0,1,734,13,747,1295,2,1,2,0,1,0,57.68
高雄市,鼓山區,興宗里,0,1,1023,18,1041,1454,2,1,2,0,1,0,71.60
高雄市,鼓山區,光化里,0,1,1005,13,1018,1409,2,1,2,0,1,0,72.25
高雄市,鼓山區,山下里,0,1,893,11,904,1249,2,1,2,0,1,0,72.38
高雄市,鼓山區,河邊里,0,1,1110,23,1133,1510,2,1,2,0,1,0,75.03
高雄市,鼓山區,綠川里,0,1,1043,16,1059,1527,2,1,2,0,1,0,69.35
高雄市,鼓山區,登山里,0,1,502,9,511,754,2,1,2,0,1,0,67.77
高雄市,鼓山區,峰南里,0,1,666,14,680,1013,2,1,2,0,1,0,67.13
高雄市,鼓山區,麗興里,0,1,751,16,767,1100,2,1,2,0,1,0,69.73
高雄市,鼓山區,新民里,0,1,755,16,771,1137,2,1,2,0,1,0,67.81
高雄市,鼓山區,延平里,0,1,646,8,654,906,2,1,2,0,1,0,72.19
高雄市,鼓山區,維生里,0,1,960,8,968,1403,2,1,2,0,1,0,69.00
高雄市,鼓山區,惠安里,0,1,875,18,893,1372,2,1,2,0,1,0,65.09
高雄市,鼓山區,壽山里,0,1,1029,11,1040,1540,2,1,2,0,1,0,67.53
高雄市,鼓山區,哨船頭里,0,1,780,11,791,1151,2,1,2,0,1,0,68.72
高雄市,鼓山區,桃源里,0,1,455,6,461,633,2,1,2,0,1,0,72.83
高雄市,旗津區,旗下里,0,1,861,5,866,1224,2,1,2,0,1,0,70.75
高雄市,旗津區,永安里,0,1,753,8,761,1098,2,1,2,0,1,0,69.31
高雄市,旗津區,振興里,0,1,1171,16,1187,1720,2,1,2,0,1,0,69.01
高雄市,旗津區,慈愛里,0,1,1540,19,1559,2160,2,1,2,0,1,0,72.18
高雄市,旗津區,復興里,0,1,1922,21,1943,2785,2,1,2,0,1,0,69.77
高雄市,旗津區,中華里,0,1,917,11,928,1275,2,1,2,0,1,0,72.78
高雄市,旗津區,實踐里,0,1,865,12,877,1309,2,1,2,0,1,0,67.00
高雄市,旗津區,北汕里,0,1,1738,24,1762,2475,2,1,2,0,1,0,71.19
高雄市,旗津區,南汕里,0,1,1291,8,1299,1771,2,1,2,0,1,0,73.35
高雄市,旗津區,上竹里,0,1,1759,19,1778,2611,2,1,2,0,1,0,68.10
高雄市,旗津區,中洲里,0,1,1172,22,1194,1697,2,1,2,0,1,0,70.36
高雄市,旗津區,安順里,0,1,603,5,608,896,2,1,2,0,1,0,67.86
高雄市,旗津區,中興里,0,1,1690,33,1723,2316,2,1,2,0,1,0,74.40
高雄市,左營區,進學里,0,2,1094,12,1106,2048,2,1,2,0,1,0,54.00
高雄市,左營區,尾西里,0,2,830,13,843,1150,2,1,2,0,1,0,73.30
高雄市,左營區,頂北里,0,2,427,9,436,587,2,1,2,0,1,0,74.28
高雄市,左營區,中北里,0,2,527,10,537,690,2,1,2,0,1,0,77.83
高雄市,左營區,中南里,0,2,396,8,404,570,2,1,2,0,1,0,70.88
高雄市,左營區,廟東里,0,2,608,11,619,862,2,1,2,0,1,0,71.81
高雄市,左營區,廟北里,0,2,735,6,741,992,2,1,2,0,1,0,74.70
高雄市,左營區,尾南里,0,2,552,6,558,788,2,1,2,0,1,0,70.81
高雄市,左營區,尾北里,0,2,2023,32,2055,2858,2,1,2,0,1,0,71.90
高雄市,左營區,屏山里,0,2,1035,22,1057,1437,2,1,2,0,1,0,73.56
高雄市,左營區,祥和里,0,2,404,10,414,540,2,1,2,0,1,0,76.67
高雄市,左營區,永清里,0,2,1251,32,1283,1809,2,1,2,0,1,0,70.92
高雄市,左營區,復興里,0,2,826,8,834,1150,2,1,2,0,1,0,72.52
高雄市,左營區,莒光里,0,2,1158,15,1173,1713,2,1,2,0,1,0,68.48
高雄市,左營區,光輝里,0,2,1743,34,1777,2523,2,1,2,0,1,0,70.43
高雄市,左營區,合群里,0,2,923,17,940,1319,2,1,2,0,1,0,71.27
高雄市,左營區,明建里,0,2,989,12,1001,1456,2,1,2,0,1,0,68.75
高雄市,左營區,頂西里,0,2,868,16,884,1130,2,1,2,0,1,0,78.23
高雄市,左營區,聖后里,0,2,663,10,673,897,2,1,2,0,1,0,75.03
高雄市,左營區,聖西里,0,2,264,2,266,355,2,1,2,0,1,0,74.93
高雄市,左營區,聖南里,0,2,373,3,376,546,2,1,2,0,1,0,68.86
高雄市,左營區,城南里,0,2,385,7,392,545,2,1,2,0,1,0,71.93
高雄市,左營區,路東里,0,2,534,8,542,739,2,1,2,0,1,0,73.34
高雄市,左營區,廍北里,0,2,359,8,367,501,2,1,2,0,1,0,73.25
高雄市,左營區,廍南里,0,2,498,7,505,687,2,1,2,0,1,0,73.51
高雄市,左營區,埤西里,0,2,750,10,760,1050,2,1,2,0,1,0,72.38
高雄市,左營區,埤北里,0,2,892,31,923,1376,2,1,2,0,1,0,67.08
高雄市,左營區,埤東里,0,2,764,8,772,1098,2,1,2,0,1,0,70.31
高雄市,左營區,海勝里,0,2,4230,78,4308,5804,2,1,2,0,1,0,74.22
高雄市,左營區,崇實里,0,2,830,18,848,1198,2,1,2,0,1,0,70.78
高雄市,左營區,自助里,0,2,1430,28,1458,2088,2,1,2,0,1,0,69.83
高雄市,左營區,果貿里,0,2,1335,17,1352,1820,2,1,2,0,1,0,74.29
高雄市,左營區,果惠里,0,2,1037,22,1059,1542,2,1,2,0,1,0,68.68
高雄市,左營區,果峰里,0,2,1194,11,1205,1701,2,1,2,0,1,0,70.84
高雄市,左營區,新下里,0,2,6829,115,6944,10116,2,1,2,0,1,0,68.64
高雄市,左營區,新上里,0,2,12995,316,13311,19825,2,1,2,0,1,0,67.14
高雄市,左營區,新中里,0,2,3117,62,3179,4524,2,1,2,0,1,0,70.27
高雄市,左營區,新光里,0,2,6554,128,6682,9767,2,1,2,0,1,0,68.41
高雄市,左營區,菜公里,0,2,12793,275,13068,19763,2,1,2,0,1,0,66.12
高雄市,左營區,福山里,0,2,13957,320,14277,22366,2,1,2,0,1,0,63.83
高雄市,楠梓區,清豐里,0,2,7604,115,7719,11736,2,1,2,0,1,0,65.77
高雄市,楠梓區,東寧里,0,2,1560,28,1588,2414,2,1,2,0,1,0,65.78
高雄市,楠梓區,五常里,0,2,2800,42,2842,4508,2,1,2,0,1,0,63.04
高雄市,楠梓區,享平里,0,2,1779,21,1800,2698,2,1,2,0,1,0,66.72
高雄市,楠梓區,中陽里,0,2,1765,25,1790,2626,2,1,2,0,1,0,68.16
高雄市,楠梓區,惠楠里,0,2,1475,25,1500,2649,2,1,2,0,1,0,56.63
高雄市,楠梓區,惠民里,0,2,2216,31,2247,3271,2,1,2,0,1,0,68.69
高雄市,楠梓區,惠豐里,0,2,2225,23,2248,3448,2,1,2,0,1,0,65.20
高雄市,楠梓區,錦屏里,0,2,2272,29,2301,3275,2,1,2,0,1,0,70.26
高雄市,楠梓區,玉屏里,0,2,1624,22,1646,2224,2,1,2,0,1,0,74.01
高雄市,楠梓區,金田里,0,2,2138,37,2175,3069,2,1,2,0,1,0,70.87
高雄市,楠梓區,稔田里,0,2,1104,10,1114,1543,2,1,2,0,1,0,72.20
高雄市,楠梓區,瑞屏里,0,2,2236,33,2269,3383,2,1,2,0,1,0,67.07
高雄市,楠梓區,翠屏里,0,2,6805,131,6936,10778,2,1,2,0,1,0,64.35
高雄市,楠梓區,宏南里,0,2,1141,20,1161,1707,2,1,2,0,1,0,68.01
高雄市,楠梓區,宏毅里,0,2,2009,32,2041,2799,2,1,2,0,1,0,72.92
高雄市,楠梓區,宏榮里,0,2,1634,24,1658,2230,2,1,2,0,1,0,74.35
高雄市,楠梓區,廣昌里,0,2,2127,31,2158,2956,2,1,2,0,1,0,73.00
高雄市,楠梓區,久昌里,0,2,1479,26,1505,2236,2,1,2,0,1,0,67.31
高雄市,楠梓區,大昌里,0,2,1433,16,1449,2011,2,1,2,0,1,0,72.05
高雄市,楠梓區,福昌里,0,2,1353,17,1370,1823,2,1,2,0,1,0,75.15
高雄市,楠梓區,盛昌里,0,2,3120,47,3167,4387,2,1,2,0,1,0,72.19
高雄市,楠梓區,泰昌里,0,2,1040,9,1049,1446,2,1,2,0,1,0,72.54
高雄市,楠梓區,興昌里,0,2,2402,30,2432,3378,2,1,2,0,1,0,72.00
高雄市,楠梓區,建昌里,0,2,1657,21,1678,2418,2,1,2,0,1,0,69.40
高雄市,楠梓區,宏昌里,0,2,1665,17,1682,2455,2,1,2,0,1,0,68.51
高雄市,楠梓區,和昌里,0,2,1479,21,1500,2074,2,1,2,0,1,0,72.32
高雄市,楠梓區,慶昌里,0,2,2253,17,2270,3080,2,1,2,0,1,0,73.70
高雄市,楠梓區,隆昌里,0,2,2197,24,2221,3196,2,1,2,0,1,0,69.49
高雄市,楠梓區,秀昌里,0,2,1376,18,1394,2038,2,1,2,0,1,0,68.40
高雄市,楠梓區,裕昌里,0,2,2301,30,2331,3133,2,1,2,0,1,0,74.40
高雄市,楠梓區,國昌里,0,2,2185,27,2212,3217,2,1,2,0,1,0,68.76
高雄市,楠梓區,加昌里,0,2,4160,63,4223,6340,2,1,2,0,1,0,66.61
高雄市,楠梓區,仁昌里,0,2,2255,45,2300,3548,2,1,2,0,1,0,64.83
高雄市,楠梓區,藍田里,0,2,1296,19,1315,1864,2,1,2,0,1,0,70.55
高雄市,楠梓區,中興里,0,2,683,8,691,983,2,1,2,0,1,0,70.30
高雄市,楠梓區,中和里,0,2,1107,12,1119,1540,2,1,2,0,1,0,72.66
高雄市,三民區,鼎金里,0,3,1936,34,1970,3105,2,1,2,0,1,0,63.45
高雄市,三民區,鼎盛里,0,3,3837,74,3911,6019,2,1,2,0,1,0,64.98
高雄市,三民區,鼎強里,0,3,2271,47,2318,3404,2,1,2,0,1,0,68.10
高雄市,三民區,鼎力里,0,3,2239,46,2285,3393,2,1,2,0,1,0,67.34
高雄市,三民區,鼎西里,0,3,3796,82,3878,5962,2,1,2,0,1,0,65.05
高雄市,三民區,鼎中里,0,3,2288,41,2329,3189,2,1,2,0,1,0,73.03
高雄市,三民區,鼎泰里,0,3,10912,210,11122,16481,2,1,2,0,1,0,67.48
高雄市,三民區,本館里,0,3,4971,82,5053,7506,2,1,2,0,1,0,67.32
高雄市,三民區,本和里,0,3,3897,67,3964,6090,2,1,2,0,1,0,65.09
高雄市,三民區,本文里,0,3,1399,16,1415,2027,2,1,2,0,1,0,69.81
高雄市,三民區,本武里,0,3,1053,23,1076,1557,2,1,2,0,1,0,69.11
高雄市,三民區,本元里,0,3,3095,55,3150,4610,2,1,2,0,1,0,68.33
高雄市,三民區,本安里,0,3,2614,52,2666,3886,2,1,2,0,1,0,68.61
高雄市,三民區,本上里,0,3,2787,47,2834,4246,2,1,2,0,1,0,66.75
高雄市,三民區,本揚里,0,3,4311,92,4403,6662,2,1,2,0,1,0,66.09
高雄市,三民區,寶獅里,0,3,2196,44,2240,3448,2,1,2,0,1,0,64.97
高雄市,三民區,寶德里,0,3,2874,53,2927,4511,2,1,2,0,1,0,64.89
高雄市,三民區,寶泰里,0,3,2093,44,2137,3395,2,1,2,0,1,0,62.95
高雄市,三民區,寶興里,0,3,3680,59,3739,5444,2,1,2,0,1,0,68.68
高雄市,三民區,寶中里,0,3,1848,29,1877,2718,2,1,2,0,1,0,69.06
高雄市,三民區,寶華里,0,3,1793,45,1838,2843,2,1,2,0,1,0,64.65
高雄市,三民區,寶國里,0,3,4352,74,4426,6701,2,1,2,0,1,0,66.05
高雄市,三民區,寶民里,0,3,1717,43,1760,2648,2,1,2,0,1,0,66.47
高雄市,三民區,寶慶里,0,3,1547,38,1585,2517,2,1,2,0,1,0,62.97
高雄市,三民區,寶業里,0,3,2660,46,2706,4245,2,1,2,0,1,0,63.75
高雄市,三民區,寶盛里,0,3,2806,54,2860,4175,2,1,2,0,1,0,68.50
高雄市,三民區,寶安里,0,3,3802,61,3863,6043,2,1,2,0,1,0,63.93
高雄市,三民區,寶龍里,0,3,2650,42,2692,3917,2,1,2,0,1,0,68.73
高雄市,三民區,寶珠里,0,3,3106,61,3167,5518,2,1,2,0,1,0,57.39
高雄市,三民區,寶玉里,0,3,4587,81,4668,7243,2,1,2,0,1,0,64.45
高雄市,三民區,灣子里,0,3,1916,36,1952,3057,2,1,2,0,1,0,63.85
高雄市,三民區,灣愛里,0,3,1825,41,1866,2881,2,1,2,0,1,0,64.77
高雄市,三民區,灣中里,0,3,2596,46,2642,4044,2,1,2,0,1,0,65.33
高雄市,三民區,灣華里,0,3,1618,22,1640,2606,2,1,2,0,1,0,62.93
高雄市,三民區,灣勝里,0,3,1398,21,1419,2010,2,1,2,0,1,0,70.60
高雄市,三民區,灣利里,0,3,2155,42,2197,3212,2,1,2,0,1,0,68.40
高雄市,三民區,灣復里,0,3,1914,30,1944,3040,2,1,2,0,1,0,63.95
高雄市,三民區,正興里,0,3,5783,79,5862,9144,2,1,2,0,1,0,64.11
高雄市,三民區,正順里,0,3,2157,37,2194,3271,2,1,2,0,1,0,67.07
高雄市,三民區,灣興里,0,3,1138,20,1158,1625,2,1,2,0,1,0,71.26
高雄市,三民區,灣成里,0,3,1293,16,1309,2076,2,1,2,0,1,0,63.05
高雄市,三民區,安康里,0,3,1875,31,1906,2893,2,1,2,0,1,0,65.88
高雄市,三民區,安寧里,0,3,1337,24,1361,1990,2,1,2,0,1,0,68.39
高雄市,三民區,安吉里,0,3,2808,45,2853,4392,2,1,2,0,1,0,64.96
高雄市,三民區,安發里,0,3,2721,59,2780,4243,2,1,2,0,1,0,65.52
高雄市,三民區,安東里,0,3,2148,42,2190,3078,2,1,2,0,1,0,71.15
高雄市,三民區,安和里,0,3,1807,39,1846,2590,2,1,2,0,1,0,71.27
高雄市,三民區,達德里,0,3,1021,18,1039,1406,2,1,2,0,1,0,73.90
高雄市,三民區,達明里,0,3,1166,22,1188,1630,2,1,2,0,1,0,72.88
高雄市,三民區,達仁里,0,3,991,18,1009,1412,2,1,2,0,1,0,71.46
高雄市,三民區,達勇里,0,3,729,14,743,1042,2,1,2,0,1,0,71.31
高雄市,三民區,同德里,0,3,1876,33,1909,2814,2,1,2,0,1,0,67.84
高雄市,三民區,德智里,0,3,1643,26,1669,2375,2,1,2,0,1,0,70.27
高雄市,三民區,德仁里,0,3,1215,27,1242,1853,2,1,2,0,1,0,67.03
高雄市,三民區,安生里,0,3,1153,21,1174,1605,2,1,2,0,1,0,73.15
高雄市,三民區,德東里,0,3,615,8,623,852,2,1,2,0,1,0,73.12
高雄市,三民區,德行里,0,3,769,17,786,1086,2,1,2,0,1,0,72.38
高雄市,三民區,精華里,0,3,1094,32,1126,1569,2,1,2,0,1,0,71.77
高雄市,三民區,民享里,0,3,1457,21,1478,2057,2,1,2,0,1,0,71.85
高雄市,三民區,安宜里,0,3,2207,48,2255,3129,2,1,2,0,1,0,72.07
高雄市,三民區,安泰里,0,3,2560,42,2602,3856,2,1,2,0,1,0,67.48
高雄市,三民區,安邦里,0,3,2428,38,2466,3909,2,1,2,0,1,0,63.09
高雄市,三民區,十全里,0,3,1082,10,1092,1531,2,1,2,0,1,0,71.33
高雄市,三民區,十美里,0,3,1238,26,1264,1814,2,1,2,0,1,0,69.68
高雄市,三民區,德北里,0,3,1340,28,1368,2006,2,1,2,0,1,0,68.20
高雄市,三民區,立誠里,0,3,636,12,648,881,2,1,2,0,1,0,73.55
高雄市,三民區,立業里,0,3,723,15,738,1035,2,1,2,0,1,0,71.30
高雄市,三民區,港東里,0,3,913,12,925,1351,2,1,2,0,1,0,68.47
高雄市,三民區,港新里,0,3,923,17,940,1386,2,1,2,0,1,0,67.82
高雄市,三民區,港西里,0,3,528,8,536,805,2,1,2,0,1,0,66.58
高雄市,三民區,港北里,0,3,172,3,175,248,2,1,2,0,1,0,70.56
高雄市,三民區,博愛里,0,3,735,11,746,1142,2,1,2,0,1,0,65.32
高雄市,三民區,博惠里,0,3,2719,55,2774,4007,2,1,2,0,1,0,69.23
高雄市,三民區,長明里,0,3,752,19,771,1131,2,1,2,0,1,0,68.17
高雄市,三民區,建東里,0,3,620,12,632,1088,2,1,2,0,1,0,58.09
高雄市,三民區,興德里,0,3,1106,28,1134,1669,2,1,2,0,1,0,67.94
高雄市,三民區,鳳南里,0,3,786,13,799,1109,2,1,2,0,1,0,72.05
高雄市,三民區,鳳北里,0,3,1222,21,1243,1724,2,1,2,0,1,0,72.10
高雄市,三民區,德西里,0,3,772,20,792,1168,2,1,2,0,1,0,67.81
高雄市,三民區,豐裕里,0,3,1831,52,1883,2626,2,1,2,0,1,0,71.71
高雄市,三民區,川東里,0,3,1184,34,1218,1826,2,1,2,0,1,0,66.70
高雄市,三民區,裕民里,0,3,808,33,841,1165,2,1,2,0,1,0,72.19
高雄市,三民區,力行里,0,3,853,13,866,1114,2,1,2,0,1,0,77.74
高雄市,三民區,千歲里,0,3,795,16,811,1136,2,1,2,0,1,0,71.39
高雄市,三民區,立德里,0,3,911,18,929,1315,2,1,2,0,1,0,70.65
高雄市,三民區,千北里,0,3,925,30,955,1315,2,1,2,0,1,0,72.62
高雄市,三民區,千秋里,0,3,1478,32,1510,2254,2,1,2,0,1,0,66.99
高雄市,新興區,浩然里,0,4,1273,20,1293,1897,2,1,2,0,1,0,68.16
高雄市,新興區,振成里,0,4,798,14,812,1249,2,1,2,0,1,0,65.01
高雄市,新興區,德生里,0,4,1716,26,1742,2687,2,1,2,0,1,0,64.83
高雄市,新興區,振華里,0,4,844,11,855,1268,2,1,2,0,1,0,67.43
高雄市,新興區,正氣里,0,4,1052,19,1071,1553,2,1,2,0,1,0,68.96
高雄市,新興區,德政里,0,4,491,9,500,747,2,1,2,0,1,0,66.93
高雄市,新興區,仁聲里,0,4,537,11,548,908,2,1,2,0,1,0,60.35
高雄市,新興區,德望里,0,4,1348,19,1367,2044,2,1,2,0,1,0,66.88
高雄市,新興區,華聲里,0,4,668,14,682,995,2,1,2,0,1,0,68.54
高雄市,新興區,蕉園里,0,4,540,9,549,762,2,1,2,0,1,0,72.05
高雄市,新興區,永寧里,0,4,900,15,915,1405,2,1,2,0,1,0,65.12
高雄市,新興區,玉衡里,0,4,657,12,669,1027,2,1,2,0,1,0,65.14
高雄市,新興區,順昌里,0,4,1413,22,1435,2020,2,1,2,0,1,0,71.04
高雄市,新興區,文昌里,0,4,1709,34,1743,2580,2,1,2,0,1,0,67.56
高雄市,新興區,光耀里,0,4,1571,19,1590,2326,2,1,2,0,1,0,68.36
高雄市,新興區,興昌里,0,4,1185,21,1206,1741,2,1,2,0,1,0,69.27
高雄市,新興區,開平里,0,4,2073,48,2121,3035,2,1,2,0,1,0,69.88
高雄市,新興區,成功里,0,4,779,15,794,1160,2,1,2,0,1,0,68.45
高雄市,新興區,新江里,0,4,690,17,707,1112,2,1,2,0,1,0,63.58
高雄市,新興區,黎明里,0,4,589,11,600,905,2,1,2,0,1,0,66.30
高雄市,新興區,愛平里,0,4,550,6,556,857,2,1,2,0,1,0,64.88
高雄市,新興區,南港里,0,4,1528,29,1557,2184,2,1,2,0,1,0,71.29
高雄市,新興區,中東里,0,4,1595,33,1628,2825,2,1,2,0,1,0,57.63
高雄市,新興區,明莊里,0,4,525,9,534,820,2,1,2,0,1,0,65.12
高雄市,新興區,大明里,0,4,750,15,765,1137,2,1,2,0,1,0,67.28
高雄市,新興區,秋山里,0,4,625,10,635,948,2,1,2,0,1,0,66.98
高雄市,新興區,長驛里,0,4,627,14,641,966,2,1,2,0,1,0,66.36
高雄市,新興區,建興里,0,4,577,11,588,881,2,1,2,0,1,0,66.74
高雄市,新興區,建華里,0,4,606,18,624,944,2,1,2,0,1,0,66.10
高雄市,新興區,漢民里,0,4,599,18,617,850,2,1,2,0,1,0,72.59
高雄市,新興區,榮治里,0,4,565,11,576,822,2,1,2,0,1,0,70.07
高雄市,新興區,東坡里,0,4,861,13,874,1273,2,1,2,0,1,0,68.66
高雄市,前金區,三川里,0,4,519,11,530,753,2,1,2,0,1,0,70.39
高雄市,前金區,草江里,0,4,743,20,763,1118,2,1,2,0,1,0,68.25
高雄市,前金區,長城里,0,4,951,11,962,1395,2,1,2,0,1,0,68.96
高雄市,前金區,北金里,0,4,562,9,571,886,2,1,2,0,1,0,64.45
高雄市,前金區,東金里,0,4,619,12,631,948,2,1,2,0,1,0,66.56
高雄市,前金區,新生里,0,4,2014,37,2051,3043,2,1,2,0,1,0,67.40
高雄市,前金區,後金里,0,4,571,10,581,907,2,1,2,0,1,0,64.06
高雄市,前金區,長興里,0,4,712,6,718,1137,2,1,2,0,1,0,63.15
高雄市,前金區,青山里,0,4,893,16,909,1458,2,1,2,0,1,0,62.35
高雄市,前金區,民生里,0,4,467,8,475,732,2,1,2,0,1,0,64.89
高雄市,前金區,復元里,0,4,694,8,702,1055,2,1,2,0,1,0,66.54
高雄市,前金區,林投里,0,4,750,16,766,1262,2,1,2,0,1,0,60.70
高雄市,前金區,國民里,0,4,720,19,739,1073,2,1,2,0,1,0,68.87
高雄市,前金區,社東里,0,4,1156,19,1175,1690,2,1,2,0,1,0,69.53
高雄市,前金區,社西里,0,4,764,12,776,1169,2,1,2,0,1,0,66.38
高雄市,前金區,博孝里,0,4,604,9,613,930,2,1,2,0,1,0,65.91
高雄市,前金區,長生里,0,4,954,18,972,1520,2,1,2,0,1,0,63.95
高雄市,前金區,榮復里,0,4,851,19,870,1255,2,1,2,0,1,0,69.32
高雄市,前金區,文西里,0,4,729,7,736,1070,2,1,2,0,1,0,68.79
高雄市,前金區,文東里,0,4,864,25,889,1317,2,1,2,0,1,0,67.50
高雄市,苓雅區,博仁里,0,4,434,9,443,605,2,1,2,0,1,0,73.22
高雄市,苓雅區,苓洲里,0,4,867,20,887,1271,2,1,2,0,1,0,69.79
高雄市,苓雅區,苓昇里,0,4,1008,9,1017,1383,2,1,2,0,1,0,73.54
高雄市,苓雅區,苓中里,0,4,1082,16,1098,1627,2,1,2,0,1,0,67.49
高雄市,苓雅區,苓雅里,0,4,995,16,1011,1470,2,1,2,0,1,0,68.78
高雄市,苓雅區,苓東里,0,4,1037,23,1060,1577,2,1,2,0,1,0,67.22
高雄市,苓雅區,城北里,0,4,1017,22,1039,1550,2,1,2,0,1,0,67.03
高雄市,苓雅區,城西里,0,4,457,10,467,673,2,1,2,0,1,0,69.39
高雄市,苓雅區,城東里,0,4,1241,31,1272,1981,2,1,2,0,1,0,64.21
高雄市,苓雅區,意誠里,0,4,1742,31,1773,2921,2,1,2,0,1,0,60.70
高雄市,苓雅區,鼓中里,0,4,777,16,793,1080,2,1,2,0,1,0,73.43
高雄市,苓雅區,田西里,0,4,953,10,963,1377,2,1,2,0,1,0,69.93
高雄市,苓雅區,人和里,0,4,1206,17,1223,1856,2,1,2,0,1,0,65.89
高雄市,苓雅區,仁政里,0,4,854,15,869,1327,2,1,2,0,1,0,65.49
高雄市,苓雅區,廣澤里,0,4,1425,30,1455,1978,2,1,2,0,1,0,73.56
高雄市,苓雅區,美田里,0,4,819,17,836,1231,2,1,2,0,1,0,67.91
高雄市,苓雅區,華堂里,0,4,1941,28,1969,2937,2,1,2,0,1,0,67.04
高雄市,苓雅區,日中里,0,4,1483,43,1526,2214,2,1,2,0,1,0,68.93
高雄市,苓雅區,普照里,0,4,1729,30,1759,2580,2,1,2,0,1,0,68.18
高雄市,苓雅區,和煦里,0,4,1481,18,1499,2134,2,1,2,0,1,0,70.24
高雄市,苓雅區,晴朗里,0,4,791,17,808,1899,2,1,2,0,1,0,42.55
高雄市,苓雅區,普天里,0,4,1901,30,1931,2855,2,1,2,0,1,0,67.64
高雄市,苓雅區,林富里,0,4,1252,26,1278,1845,2,1,2,0,1,0,69.27
高雄市,苓雅區,林圍里,0,4,1451,37,1488,2189,2,1,2,0,1,0,67.98
高雄市,苓雅區,林安里,0,4,1062,14,1076,1540,2,1,2,0,1,0,69.87
高雄市,苓雅區,光華里,0,4,527,11,538,756,2,1,2,0,1,0,71.16
高雄市,苓雅區,林興里,0,4,985,19,1004,1405,2,1,2,0,1,0,71.46
高雄市,苓雅區,林華里,0,4,1953,40,1993,2939,2,1,2,0,1,0,67.81
高雄市,苓雅區,林西里,0,4,1120,24,1144,1710,2,1,2,0,1,0,66.90
高雄市,苓雅區,林中里,0,4,2137,46,2183,3172,2,1,2,0,1,0,68.82
高雄市,苓雅區,林泉里,0,4,1230,20,1250,1834,2,1,2,0,1,0,68.16
高雄市,苓雅區,林南里,0,4,1907,40,1947,2899,2,1,2,0,1,0,67.16
高雄市,苓雅區,中正里,0,4,1705,32,1737,2607,2,1,2,0,1,0,66.63
高雄市,苓雅區,尚義里,0,4,942,12,954,1429,2,1,2,0,1,0,66.76
高雄市,苓雅區,同慶里,0,4,1358,31,1389,2004,2,1,2,0,1,0,69.31
高雄市,苓雅區,凱旋里,0,4,1331,22,1353,1848,2,1,2,0,1,0,73.21
高雄市,苓雅區,安祥里,0,4,1559,42,1601,2368,2,1,2,0,1,0,67.61
高雄市,苓雅區,奏捷里,0,4,1135,8,1143,1611,2,1,2,0,1,0,70.95
高雄市,苓雅區,福壽里,0,4,1062,13,1075,1526,2,1,2,0,1,0,70.45
高雄市,苓雅區,福南里,0,4,1544,26,1570,2259,2,1,2,0,1,0,69.50
高雄市,苓雅區,五權里,0,4,1341,28,1369,1957,2,1,2,0,1,0,69.95
高雄市,苓雅區,民主里,0,4,2506,45,2551,3822,2,1,2,0,1,0,66.75
高雄市,苓雅區,林德里,0,4,1204,19,1223,1818,2,1,2,0,1,0,67.27
高雄市,苓雅區,林貴里,0,4,955,15,970,1349,2,1,2,0,1,0,71.91
高雄市,苓雅區,林榮里,0,4,2628,52,2680,3913,2,1,2,0,1,0,68.49
高雄市,苓雅區,英明里,0,4,1321,22,1343,2028,2,1,2,0,1,0,66.22
高雄市,苓雅區,林靖里,0,4,1077,9,1086,1538,2,1,2,0,1,0,70.61
高雄市,苓雅區,朝陽里,0,4,957,16,973,1458,2,1,2,0,1,0,66.74
高雄市,苓雅區,福隆里,0,4,1750,28,1778,2693,2,1,2,0,1,0,66.02
高雄市,苓雅區,福祥里,0,4,900,10,910,1308,2,1,2,0,1,0,69.57
高雄市,苓雅區,福海里,0,4,757,15,772,1075,2,1,2,0,1,0,71.81
高雄市,苓雅區,福康里,0,4,1288,21,1309,1892,2,1,2,0,1,0,69.19
高雄市,苓雅區,福人里,0,4,1431,31,1462,2085,2,1,2,0,1,0,70.12
高雄市,苓雅區,福地里,0,4,1970,40,2010,2818,2,1,2,0,1,0,71.33
高雄市,苓雅區,福居里,0,4,1944,43,1987,2791,2,1,2,0,1,0,71.19
高雄市,苓雅區,福東里,0,4,1732,29,1761,2548,2,1,2,0,1,0,69.11
高雄市,苓雅區,福西里,0,4,1323,35,1358,1922,2,1,2,0,1,0,70.66
高雄市,苓雅區,永康里,0,4,1618,22,1640,2371,2,1,2,0,1,0,69.17
高雄市,苓雅區,正文里,0,4,1219,20,1239,1826,2,1,2,0,1,0,67.85
高雄市,苓雅區,正言里,0,4,1842,39,1881,2704,2,1,2,0,1,0,69.56
高雄市,苓雅區,正大里,0,4,2949,64,3013,4598,2,1,2,0,1,0,65.53
高雄市,苓雅區,五福里,0,4,2475,56,2531,3800,2,1,2,0,1,0,66.61
高雄市,苓雅區,正心里,0,4,2336,43,2379,3610,2,1,2,0,1,0,65.90
高雄市,苓雅區,正道里,0,4,2698,44,2742,4171,2,1,2,0,1,0,65.74
高雄市,苓雅區,正義里,0,4,1609,31,1640,2404,2,1,2,0,1,0,68.22
高雄市,苓雅區,正仁里,0,4,1702,22,1724,2521,2,1,2,0,1,0,68.39
高雄市,苓雅區,文昌里,0,4,2646,48,2694,3809,2,1,2,0,1,0,70.73
高雄市,苓雅區,建軍里,0,4,1382,29,1411,2049,2,1,2,0,1,0,68.86
高雄市,苓雅區,衛武里,0,4,1344,19,1363,2131,2,1,2,0,1,0,63.96
高雄市,前鎮區,草衙里,0,5,5266,122,5388,8279,2,1,2,0,1,0,65.08
高雄市,前鎮區,明孝里,0,5,1674,45,1719,2480,2,1,2,0,1,0,69.31
高雄市,前鎮區,明正里,0,5,2194,44,2238,3266,2,1,2,0,1,0,68.52
高雄市,前鎮區,明義里,0,5,1458,35,1493,2068,2,1,2,0,1,0,72.20
高雄市,前鎮區,仁愛里,0,5,923,11,934,1381,2,1,2,0,1,0,67.63
高雄市,前鎮區,德昌里,0,5,1214,23,1237,1807,2,1,2,0,1,0,68.46
高雄市,前鎮區,平等里,0,5,1167,19,1186,2404,2,1,2,0,1,0,49.33
高雄市,前鎮區,平昌里,0,5,413,11,424,661,2,1,2,0,1,0,64.15
高雄市,前鎮區,明禮里,0,5,1107,20,1127,1700,2,1,2,0,1,0,66.29
高雄市,前鎮區,信義里,0,5,1058,26,1084,1527,2,1,2,0,1,0,70.99
高雄市,前鎮區,信德里,0,5,1533,30,1563,2356,2,1,2,0,1,0,66.34
高雄市,前鎮區,明道里,0,5,869,15,884,1216,2,1,2,0,1,0,72.70
高雄市,前鎮區,興化里,0,5,544,8,552,750,2,1,2,0,1,0,73.60
高雄市,前鎮區,興仁里,0,5,550,13,563,855,2,1,2,0,1,0,65.85
高雄市,前鎮區,前鎮里,0,5,1093,30,1123,1533,2,1,2,0,1,0,73.26
高雄市,前鎮區,鎮東里,0,5,1327,38,1365,1862,2,1,2,0,1,0,73.31
高雄市,前鎮區,鎮榮里,0,5,1544,34,1578,2249,2,1,2,0,1,0,70.16
高雄市,前鎮區,鎮昌里,0,5,1371,37,1408,2037,2,1,2,0,1,0,69.12
高雄市,前鎮區,鎮海里,0,5,2524,61,2585,4000,2,1,2,0,1,0,64.63
高雄市,前鎮區,鎮陽里,0,5,785,20,805,1075,2,1,2,0,1,0,74.88
高雄市,前鎮區,興邦里,0,5,1384,38,1422,2069,2,1,2,0,1,0,68.73
高雄市,前鎮區,鎮中里,0,5,625,23,648,871,2,1,2,0,1,0,74.40
高雄市,前鎮區,鎮北里,0,5,792,22,814,1056,2,1,2,0,1,0,77.08
高雄市,前鎮區,忠純里,0,5,3420,52,3472,4910,2,1,2,0,1,0,70.71
高雄市,前鎮區,忠誠里,0,5,1524,33,1557,2048,2,1,2,0,1,0,76.03
高雄市,前鎮區,西山里,0,5,2282,59,2341,3397,2,1,2,0,1,0,68.91
高雄市,前鎮區,民權里,0,5,2662,73,2735,3859,2,1,2,0,1,0,70.87
高雄市,前鎮區,建隆里,0,5,566,16,582,835,2,1,2,0,1,0,69.70
高雄市,前鎮區,振興里,0,5,1412,34,1446,2056,2,1,2,0,1,0,70.33
高雄市,前鎮區,良和里,0,5,1762,34,1796,2615,2,1,2,0,1,0,68.68
高雄市,前鎮區,西甲里,0,5,1298,27,1325,1904,2,1,2,0,1,0,69.59
高雄市,前鎮區,盛興里,0,5,1533,44,1577,2497,2,1,2,0,1,0,63.16
高雄市,前鎮區,盛豐里,0,5,1812,59,1871,2883,2,1,2,0,1,0,64.90
高雄市,前鎮區,興中里,0,5,1819,46,1865,2942,2,1,2,0,1,0,63.39
高雄市,前鎮區,興東里,0,5,3052,88,3140,4763,2,1,2,0,1,0,65.92
高雄市,前鎮區,忠孝里,0,5,1577,42,1619,2313,2,1,2,0,1,0,70.00
高雄市,前鎮區,復國里,0,5,1891,31,1922,2769,2,1,2,0,1,0,69.41
高雄市,前鎮區,竹內里,0,5,1783,35,1818,2526,2,1,2,0,1,0,71.97
高雄市,前鎮區,竹東里,0,5,1305,39,1344,2092,2,1,2,0,1,0,64.24
高雄市,前鎮區,竹南里,0,5,2194,59,2253,3486,2,1,2,0,1,0,64.63
高雄市,前鎮區,竹北里,0,5,1316,29,1345,2036,2,1,2,0,1,0,66.06
高雄市,前鎮區,竹西里,0,5,2662,79,2741,3809,2,1,2,0,1,0,71.96
高雄市,前鎮區,竹中里,0,5,1927,46,1973,2945,2,1,2,0,1,0,66.99
高雄市,前鎮區,瑞竹里,0,5,876,37,913,1315,2,1,2,0,1,0,69.43
高雄市,前鎮區,瑞南里,0,5,3016,71,3087,4467,2,1,2,0,1,0,69.11
高雄市,前鎮區,瑞豐里,0,5,1787,44,1831,2604,2,1,2,0,1,0,70.31
高雄市,前鎮區,瑞祥里,0,5,3146,68,3214,4627,2,1,2,0,1,0,69.46
高雄市,前鎮區,瑞東里,0,5,1633,40,1673,2344,2,1,2,0,1,0,71.37
高雄市,前鎮區,瑞和里,0,5,1283,37,1320,1962,2,1,2,0,1,0,67.28
高雄市,前鎮區,瑞平里,0,5,2514,50,2564,3639,2,1,2,0,1,0,70.46
高雄市,前鎮區,瑞隆里,0,5,2218,43,2261,3398,2,1,2,0,1,0,66.54
高雄市,前鎮區,瑞北里,0,5,1923,42,1965,2916,2,1,2,0,1,0,67.39
高雄市,前鎮區,瑞西里,0,5,1784,33,1817,2535,2,1,2,0,1,0,71.68
高雄市,前鎮區,瑞崗里,0,5,1680,25,1705,2490,2,1,2,0,1,0,68.47
高雄市,前鎮區,瑞興里,0,5,1654,33,1687,2559,2,1,2,0,1,0,65.92
高雄市,前鎮區,瑞誠里,0,5,1637,30,1667,2496,2,1,2,0,1,0,66.79
高雄市,前鎮區,瑞文里,0,5,1560,40,1600,2391,2,1,2,0,1,0,66.92
高雄市,前鎮區,瑞華里,0,5,2639,68,2707,4202,2,1,2,0,1,0,64.42
高雄市,前鎮區,瑞昌里,0,5,1749,33,1782,2712,2,1,2,0,1,0,65.71
高雄市,小港區,小港里,0,5,1336,18,1354,1960,2,1,2,0,1,0,69.08
高雄市,小港區,港口里,0,5,2120,41,2161,3239,2,1,2,0,1,0,66.72
高雄市,小港區,港正里,0,5,1645,37,1682,2467,2,1,2,0,1,0,68.18
高雄市,小港區,港墘里,0,5,1120,19,1139,1568,2,1,2,0,1,0,72.64
高雄市,小港區,港明里,0,5,2020,34,2054,2910,2,1,2,0,1,0,70.58
高雄市,小港區,港后里,0,5,1393,19,1412,2006,2,1,2,0,1,0,70.39
高雄市,小港區,港南里,0,5,1125,23,1148,1922,2,1,2,0,1,0,59.73
高雄市,小港區,港興里,0,5,1553,28,1581,2248,2,1,2,0,1,0,70.33
高雄市,小港區,鳳宮里,0,5,1235,25,1260,1984,2,1,2,0,1,0,63.51
高雄市,小港區,店鎮里,0,5,3270,53,3323,5075,2,1,2,0,1,0,65.48
高雄市,小港區,大苓里,0,5,1561,32,1593,2358,2,1,2,0,1,0,67.56
高雄市,小港區,二苓里,0,5,2274,45,2319,3445,2,1,2,0,1,0,67.31
高雄市,小港區,三苓里,0,5,1818,34,1852,2719,2,1,2,0,1,0,68.11
高雄市,小港區,正苓里,0,5,2360,39,2399,3615,2,1,2,0,1,0,66.36
高雄市,小港區,順苓里,0,5,2501,45,2546,3946,2,1,2,0,1,0,64.52
高雄市,小港區,六苓里,0,5,1440,21,1461,2096,2,1,2,0,1,0,69.70
高雄市,小港區,宏亮里,0,5,1873,44,1917,2875,2,1,2,0,1,0,66.68
高雄市,小港區,山東里,0,5,1560,31,1591,2302,2,1,2,0,1,0,69.11
高雄市,小港區,青島里,0,5,1331,24,1355,1919,2,1,2,0,1,0,70.61
高雄市,小港區,濟南里,0,5,2391,31,2422,3369,2,1,2,0,1,0,71.89
高雄市,小港區,泰山里,0,5,1816,35,1851,2582,2,1,2,0,1,0,71.69
高雄市,小港區,山明里,0,5,4754,69,4823,7238,2,1,2,0,1,0,66.63
高雄市,小港區,高松里,0,5,2056,48,2104,3188,2,1,2,0,1,0,66.00
高雄市,小港區,松金里,0,5,1460,29,1489,2226,2,1,2,0,1,0,66.89
高雄市,小港區,松山里,0,5,1579,38,1617,2294,2,1,2,0,1,0,70.49
高雄市,小港區,大坪里,0,5,1008,18,1026,1515,2,1,2,0,1,0,67.72
高雄市,小港區,坪頂里,0,5,1687,28,1715,2476,2,1,2,0,1,0,69.26
高雄市,小港區,孔宅里,0,5,2083,34,2117,3200,2,1,2,0,1,0,66.16
高雄市,小港區,廈莊里,0,5,1324,34,1358,2054,2,1,2,0,1,0,66.11
高雄市,小港區,合作里,0,5,1572,36,1608,2292,2,1,2,0,1,0,70.16
高雄市,小港區,桂林里,0,5,3998,90,4088,6238,2,1,2,0,1,0,65.53
高雄市,小港區,中厝里,0,5,1794,44,1838,2872,2,1,2,0,1,0,64.00
高雄市,小港區,鳳鳴里,0,5,1787,23,1810,2424,2,1,2,0,1,0,74.67
高雄市,小港區,龍鳳里,0,5,1604,29,1633,2277,2,1,2,0,1,0,71.72
高雄市,小港區,鳳森里,0,5,1179,19,1198,1727,2,1,2,0,1,0,69.37
高雄市,小港區,鳳林里,0,5,1577,38,1615,2315,2,1,2,0,1,0,69.76
高雄市,小港區,鳳興里,0,5,1299,23,1322,1787,2,1,2,0,1,0,73.98
高雄市,小港區,鳳源里,0,5,1837,30,1867,2690,2,1,2,0,1,0,69.41
高雄市,小港區,海澄里,0,5,680,8,688,988,2,1,2,0,1,0,69.64
高雄市,小港區,海昌里,0,5,377,1,378,548,2,1,2,0,1,0,68.98
高雄市,小港區,海豐里,0,5,263,5,268,409,2,1,2,0,1,0,65.53
高雄市,小港區,海原里,0,5,354,5,359,549,2,1,2,0,1,0,65.39
高雄市,小港區,海城里,0,5,408,7,415,615,2,1,2,0,1,0,67.48
臺北市,北投區,建民里,1,1,1018,11,1029,1569,2,1,2,0,1,0,65.58
臺北市,北投區,建民里,2,1,1192,9,1201,1778,2,1,2,0,1,0,67.55
臺北市,北投區,文林里,3,1,745,9,754,1161,2,1,2,0,1,0,64.94
臺北市,北投區,文林里,4,1,880,9,889,1272,2,1,2,0,1,0,69.89
臺北市,北投區,文林里,5,1,785,17,802,1231,2,1,2,0,1,0,65.15
臺北市,北投區,石牌里,6,1,894,16,910,1399,2,1,2,0,1,0,65.05
臺北市,北投區,石牌里,7,1,973,10,983,1435,2,1,2,0,1,0,68.5
臺北市,北投區,石牌里,8,1,943,14,957,1467,2,1,2,0,1,0,65.24
臺北市,北投區,福興里,9,1,933,8,941,1355,2,1,2,0,1,0,69.45
臺北市,北投區,福興里,10,1,919,2,921,1337,2,1,2,0,1,0,68.89
臺北市,北投區,福興里,11,1,900,13,913,1302,2,1,2,0,1,0,70.12
臺北市,北投區,福興里,12,1,1015,8,1023,1442,2,1,2,0,1,0,70.94
臺北市,北投區,榮光里,13,1,888,6,894,1387,2,1,2,0,1,0,64.46
臺北市,北投區,榮光里,14,1,933,11,944,1423,2,1,2,0,1,0,66.34
臺北市,北投區,榮光里,15,1,987,9,996,1453,2,1,2,0,1,0,68.55
臺北市,北投區,榮光里,16,1,909,14,923,1391,2,1,2,0,1,0,66.36
臺北市,北投區,榮華里,17,1,937,4,941,1489,2,1,2,0,1,0,63.2
臺北市,北投區,榮華里,18,1,967,6,973,1569,2,1,2,0,1,0,62.01
臺北市,北投區,榮華里,19,1,1089,13,1102,1637,2,1,2,0,1,0,67.32
臺北市,北投區,榮華里,20,1,961,17,978,1416,2,1,2,0,1,0,69.07
臺北市,北投區,裕民里,21,1,937,15,952,1424,2,1,2,0,1,0,66.85
臺北市,北投區,裕民里,22,1,988,12,1000,1454,2,1,2,0,1,0,68.78
臺北市,北投區,裕民里,23,1,893,16,909,1400,2,1,2,0,1,0,64.93
臺北市,北投區,裕民里,24,1,895,16,911,1378,2,1,2,0,1,0,66.11
臺北市,北投區,振華里,25,1,1132,10,1142,1692,2,1,2,0,1,0,67.49
臺北市,北投區,振華里,26,1,1167,14,1181,1794,2,1,2,0,1,0,65.83
臺北市,北投區,振華里,27,1,925,17,942,1425,2,1,2,0,1,0,66.11
臺北市,北投區,振華里,28,1,966,11,977,1464,2,1,2,0,1,0,66.73
臺北市,北投區,永和里,29,1,1077,12,1089,1696,2,1,2,0,1,0,64.21
臺北市,北投區,永和里,30,1,1038,9,1047,1628,2,1,2,0,1,0,64.31
臺北市,北投區,永和里,31,1,1061,18,1079,1691,2,1,2,0,1,0,63.81
臺北市,北投區,永和里,32,1,1090,17,1107,1728,2,1,2,0,1,0,64.06
臺北市,北投區,永欣里,33,1,1208,17,1225,1968,2,1,2,0,1,0,62.25
臺北市,北投區,永欣里,34,1,1190,13,1203,1792,2,1,2,0,1,0,67.13
臺北市,北投區,永欣里,35,1,1226,23,1249,1970,2,1,2,0,1,0,63.4
臺北市,北投區,永明里,36,1,1268,12,1280,1838,2,1,2,0,1,0,69.64
臺北市,北投區,永明里,37,1,1158,18,1176,1780,2,1,2,0,1,0,66.07
臺北市,北投區,東華里,38,1,1324,14,1338,1854,2,1,2,0,1,0,72.17
臺北市,北投區,東華里,39,1,1245,17,1262,1823,2,1,2,0,1,0,69.23
臺北市,北投區,吉利里,40,1,1094,11,1105,1700,2,1,2,0,1,0,65
臺北市,北投區,吉利里,41,1,1154,14,1168,1763,2,1,2,0,1,0,66.25
臺北市,北投區,吉利里,42,1,1132,13,1145,1697,2,1,2,0,1,0,67.47
臺北市,北投區,吉慶里,43,1,927,12,939,1385,2,1,2,0,1,0,67.8
臺北市,北投區,吉慶里,44,1,925,11,936,1339,2,1,2,0,1,0,69.9
臺北市,北投區,吉慶里,45,1,904,8,912,1350,2,1,2,0,1,0,67.56
臺北市,北投區,尊賢里,46,1,801,13,814,1261,2,1,2,0,1,0,64.55
臺北市,北投區,尊賢里,47,1,843,8,851,1295,2,1,2,0,1,0,65.71
臺北市,北投區,尊賢里,48,1,839,9,848,1239,2,1,2,0,1,0,68.44
臺北市,北投區,立賢里,49,1,935,12,947,1453,2,1,2,0,1,0,65.18
臺北市,北投區,立賢里,50,1,809,11,820,1264,2,1,2,0,1,0,64.87
臺北市,北投區,立賢里,51,1,874,15,889,1459,2,1,2,0,1,0,60.93
臺北市,北投區,立農里,52,1,1152,8,1160,1759,2,1,2,0,1,0,65.95
臺北市,北投區,立農里,53,1,1127,11,1138,1753,2,1,2,0,1,0,64.92
臺北市,北投區,立農里,54,1,1100,14,1114,1669,2,1,2,0,1,0,66.75
臺北市,北投區,立農里,55,1,1140,9,1149,1707,2,1,2,0,1,0,67.31
臺北市,北投區,八仙里,56,1,851,18,869,1343,2,1,2,0,1,0,64.71
臺北市,北投區,八仙里,57,1,1003,5,1008,1496,2,1,2,0,1,0,67.38
臺北市,北投區,八仙里,58,1,770,8,778,1187,2,1,2,0,1,0,65.54
臺北市,北投區,洲美里,59,1,1077,8,1085,1594,2,1,2,0,1,0,68.07
臺北市,北投區,奇岩里,60,1,941,17,958,1438,2,1,2,0,1,0,66.62
臺北市,北投區,奇岩里,61,1,948,15,963,1507,2,1,2,0,1,0,63.9
臺北市,北投區,奇岩里,62,1,994,5,999,1505,2,1,2,0,1,0,66.38
臺北市,北投區,奇岩里,63,1,1089,8,1097,1759,2,1,2,0,1,0,62.36
臺北市,北投區,奇岩里,64,1,1045,7,1052,1596,2,1,2,0,1,0,65.91
臺北市,北投區,清江里,65,1,1181,24,1205,2520,2,1,2,0,1,0,47.82
臺北市,北投區,清江里,66,1,1168,8,1176,1705,2,1,2,0,1,0,68.97
臺北市,北投區,清江里,67,1,1166,11,1177,1759,2,1,2,0,1,0,66.91
臺北市,北投區,清江里,68,1,1147,8,1155,1720,2,1,2,0,1,0,67.15
臺北市,北投區,中央里,69,1,1009,12,1021,1482,2,1,2,0,1,0,68.89
臺北市,北投區,中央里,70,1,920,12,932,1416,2,1,2,0,1,0,65.82
臺北市,北投區,中央里,71,1,986,9,995,1602,2,1,2,0,1,0,62.11
臺北市,北投區,中央里,72,1,988,13,1001,1483,2,1,2,0,1,0,67.5
臺北市,北投區,長安里,73,1,1101,7,1108,1604,2,1,2,0,1,0,69.08
臺北市,北投區,長安里,74,1,949,14,963,1472,2,1,2,0,1,0,65.42
臺北市,北投區,長安里,75,1,1081,13,1094,1787,2,1,2,0,1,0,61.22
臺北市,北投區,大同里,76,1,1101,14,1115,1636,2,1,2,0,1,0,68.15
臺北市,北投區,大同里,77,1,986,8,994,1540,2,1,2,0,1,0,64.55
臺北市,北投區,大同里,78,1,1026,17,1043,1648,2,1,2,0,1,0,63.29
臺北市,北投區,溫泉里,79,1,1130,12,1142,1689,2,1,2,0,1,0,67.61
臺北市,北投區,溫泉里,80,1,1071,15,1086,1699,2,1,2,0,1,0,63.92
臺北市,北投區,溫泉里,81,1,1127,10,1137,1741,2,1,2,0,1,0,65.31
臺北市,北投區,林泉里,82,1,780,8,788,1259,2,1,2,0,1,0,62.59
臺北市,北投區,林泉里,83,1,851,6,857,1449,2,1,2,0,1,0,59.14
臺北市,北投區,中心里,84,1,984,6,990,1655,2,1,2,0,1,0,59.82
臺北市,北投區,中心里,85,1,920,13,933,1531,2,1,2,0,1,0,60.94
臺北市,北投區,中心里,86,1,1023,12,1035,1760,2,1,2,0,1,0,58.81
臺北市,北投區,中庸里,87,1,1136,12,1148,1763,2,1,2,0,1,0,65.12
臺北市,北投區,中庸里,88,1,1134,23,1157,1733,2,1,2,0,1,0,66.76
臺北市,北投區,開明里,89,1,1185,11,1196,1748,2,1,2,0,1,0,68.42
臺北市,北投區,開明里,90,1,1148,16,1164,1745,2,1,2,0,1,0,66.7
臺北市,北投區,開明里,91,1,1124,10,1134,1771,2,1,2,0,1,0,64.03
臺北市,北投區,中和里,92,1,1117,18,1135,1664,2,1,2,0,1,0,68.21
臺北市,北投區,中和里,93,1,794,10,804,1232,2,1,2,0,1,0,65.26
臺北市,北投區,中和里,94,1,783,4,787,1203,2,1,2,0,1,0,65.42
臺北市,北投區,智仁里,95,1,944,15,959,1436,2,1,2,0,1,0,66.78
臺北市,北投區,智仁里,96,1,1163,13,1176,1704,2,1,2,0,1,0,69.01
臺北市,北投區,智仁里,97,1,1047,14,1061,1580,2,1,2,0,1,0,67.15
臺北市,北投區,秀山里,98,1,949,14,963,1398,2,1,2,0,1,0,68.88
臺北市,北投區,秀山里,99,1,991,7,998,1481,2,1,2,0,1,0,67.39
臺北市,北投區,文化里,100,1,1202,12,1214,1722,2,1,2,0,1,0,70.5
臺北市,北投區,文化里,101,1,1079,15,1094,1639,2,1,2,0,1,0,66.75
臺北市,北投區,豐年里,102,1,1129,14,1143,1722,2,1,2,0,1,0,66.38
臺北市,北投區,豐年里,103,1,1060,8,1068,1629,2,1,2,0,1,0,65.56
臺北市,北投區,稻香里,104,1,926,14,940,1496,2,1,2,0,1,0,62.83
臺北市,北投區,稻香里,105,1,900,10,910,1485,2,1,2,0,1,0,61.28
臺北市,北投區,稻香里,106,1,615,8,623,1017,2,1,2,0,1,0,61.26
臺北市,北投區,桃源里,107,1,924,18,942,1442,2,1,2,0,1,0,65.33
臺北市,北投區,桃源里,108,1,1085,17,1102,1587,2,1,2,0,1,0,69.44
臺北市,北投區,桃源里,109,1,908,9,917,1399,2,1,2,0,1,0,65.55
臺北市,北投區,一德里,110,1,1149,8,1157,1805,2,1,2,0,1,0,64.1
臺北市,北投區,一德里,111,1,1041,14,1055,1708,2,1,2,0,1,0,61.77
臺北市,北投區,一德里,112,1,1057,11,1068,1652,2,1,2,0,1,0,64.65
臺北市,北投區,關渡里,113,1,919,12,931,1463,2,1,2,0,1,0,63.64
臺北市,北投區,關渡里,114,1,806,10,816,1377,2,1,2,0,1,0,59.26
臺北市,北投區,關渡里,115,1,957,14,971,1459,2,1,2,0,1,0,66.55
臺北市,北投區,關渡里,116,1,921,17,938,1421,2,1,2,0,1,0,66.01
臺北市,北投區,關渡里,117,1,972,24,996,1500,2,1,2,0,1,0,66.4
臺北市,北投區,關渡里,118,1,847,33,880,1306,2,1,2,0,1,0,67.38
臺北市,北投區,泉源里,119,1,285,2,287,399,2,1,2,0,1,0,71.93
臺北市,北投區,泉源里,120,1,1015,9,1024,1578,2,1,2,0,1,0,64.89
臺北市,北投區,湖山里,121,1,486,7,493,746,2,1,2,0,1,0,66.09
臺北市,北投區,湖山里,122,1,644,7,651,1057,2,1,2,0,1,0,61.59
臺北市,北投區,大屯里,123,1,608,9,617,986,2,1,2,0,1,0,62.58
臺北市,北投區,湖田里,124,1,493,5,498,810,2,1,2,0,1,0,61.48
臺北市,士林區,仁勇里,125,1,1166,13,1179,1777,2,1,2,0,1,0,66.35
臺北市,士林區,仁勇里,126,1,1082,13,1095,1600,2,1,2,0,1,0,68.44
臺北市,士林區,義信里,127,1,861,15,876,1324,2,1,2,0,1,0,66.16
臺北市,士林區,義信里,128,1,978,18,996,1391,2,1,2,0,1,0,71.6
臺北市,士林區,福林里,129,1,259,3,262,415,2,1,2,0,1,0,63.13
臺北市,士林區,福林里,130,1,438,3,441,722,2,1,2,0,1,0,61.08
臺北市,士林區,福林里,131,1,931,4,935,1377,2,1,2,0,1,0,67.9
臺北市,士林區,福德里,132,1,890,11,901,1383,2,1,2,0,1,0,65.15
臺北市,士林區,福德里,133,1,893,7,900,1398,2,1,2,0,1,0,64.38
臺北市,士林區,福德里,134,1,551,12,563,1838,2,1,2,0,1,0,30.63
臺北市,士林區,福志里,135,1,976,8,984,1527,2,1,2,0,1,0,64.44
臺北市,士林區,福志里,136,1,1089,20,1109,1543,2,1,2,0,1,0,71.87
臺北市,士林區,福志里,137,1,990,15,1005,1547,2,1,2,0,1,0,64.96
臺北市,士林區,福志里,138,1,1180,13,1193,1756,2,1,2,0,1,0,67.94
臺北市,士林區,舊佳里,139,1,1209,16,1225,1772,2,1,2,0,1,0,69.13
臺北市,士林區,舊佳里,140,1,1062,15,1077,1579,2,1,2,0,1,0,68.21
臺北市,士林區,舊佳里,141,1,1211,12,1223,1883,2,1,2,0,1,0,64.95
臺北市,士林區,福佳里,142,1,908,6,914,1359,2,1,2,0,1,0,67.26
臺北市,士林區,福佳里,143,1,1039,10,1049,1532,2,1,2,0,1,0,68.47
臺北市,士林區,福佳里,144,1,1180,12,1192,1786,2,1,2,0,1,0,66.74
臺北市,士林區,福佳里,145,1,1050,10,1060,1484,2,1,2,0,1,0,71.43
臺北市,士林區,後港里,146,1,1122,14,1136,1695,2,1,2,0,1,0,67.02
臺北市,士林區,後港里,147,1,1025,15,1040,1638,2,1,2,0,1,0,63.49
臺北市,士林區,後港里,148,1,1053,21,1074,1680,2,1,2,0,1,0,63.93
臺北市,士林區,後港里,149,1,922,17,939,1456,2,1,2,0,1,0,64.49
臺北市,士林區,福中里,150,1,900,6,906,1377,2,1,2,0,1,0,65.8
臺北市,士林區,福中里,151,1,983,7,990,1456,2,1,2,0,1,0,67.99
臺北市,士林區,福中里,152,1,1098,11,1109,1652,2,1,2,0,1,0,67.13
臺北市,士林區,前港里,153,1,1106,13,1119,1751,2,1,2,0,1,0,63.91
臺北市,士林區,前港里,154,1,1159,14,1173,1739,2,1,2,0,1,0,67.45
臺北市,士林區,百齡里,155,1,993,24,1017,1495,2,1,2,0,1,0,68.03
臺北市,士林區,百齡里,156,1,959,7,966,1420,2,1,2,0,1,0,68.03
臺北市,士林區,百齡里,157,1,951,17,968,1389,2,1,2,0,1,0,69.69
臺北市,士林區,百齡里,158,1,1029,4,1033,1532,2,1,2,0,1,0,67.43
臺北市,士林區,承德里,159,1,974,16,990,1497,2,1,2,0,1,0,66.13
臺北市,士林區,承德里,160,1,1030,12,1042,1582,2,1,2,0,1,0,65.87
臺北市,士林區,承德里,161,1,918,9,927,1428,2,1,2,0,1,0,64.92
臺北市,士林區,福華里,162,1,758,15,773,1275,2,1,2,0,1,0,60.63
臺北市,士林區,福華里,163,1,630,10,640,1050,2,1,2,0,1,0,60.95
臺北市,士林區,福華里,164,1,883,20,903,1485,2,1,2,0,1,0,60.81
臺北市,士林區,福華里,165,1,1136,8,1144,1675,2,1,2,0,1,0,68.3
臺北市,士林區,明勝里,166,1,794,7,801,1286,2,1,2,0,1,0,62.29
臺北市,士林區,明勝里,167,1,928,13,941,1379,2,1,2,0,1,0,68.24
臺北市,士林區,明勝里,168,1,918,12,930,1440,2,1,2,0,1,0,64.58
臺北市,士林區,福順里,169,1,862,18,880,1371,2,1,2,0,1,0,64.19
臺北市,士林區,福順里,170,1,917,21,938,1396,2,1,2,0,1,0,67.19
臺北市,士林區,福順里,171,1,1001,13,1014,1527,2,1,2,0,1,0,66.4
臺北市,士林區,富光里,172,1,1051,21,1072,1663,2,1,2,0,1,0,64.46
臺北市,士林區,富光里,173,1,997,18,1015,1535,2,1,2,0,1,0,66.12
臺北市,士林區,富光里,174,1,1075,15,1090,1600,2,1,2,0,1,0,68.12
臺北市,士林區,葫蘆里,175,1,1069,17,1086,1523,2,1,2,0,1,0,71.31
臺北市,士林區,葫蘆里,176,1,1017,23,1040,1521,2,1,2,0,1,0,68.38
臺北市,士林區,葫蘆里,177,1,1099,8,1107,1633,2,1,2,0,1,0,67.79
臺北市,士林區,葫蘆里,178,1,921,15,936,1372,2,1,2,0,1,0,68.22
臺北市,士林區,葫東里,179,1,1058,11,1069,1739,2,1,2,0,1,0,61.47
臺北市,士林區,葫東里,180,1,968,13,981,1426,2,1,2,0,1,0,68.79
臺北市,士林區,社子里,181,1,1074,20,1094,1583,2,1,2,0,1,0,69.11
臺北市,士林區,社子里,182,1,1111,13,1124,1720,2,1,2,0,1,0,65.35
臺北市,士林區,社子里,183,1,1196,10,1206,1776,2,1,2,0,1,0,67.91
臺北市,士林區,社新里,184,1,994,4,998,1473,2,1,2,0,1,0,67.75
臺北市,士林區,社新里,185,1,846,5,851,1270,2,1,2,0,1,0,67.01
臺北市,士林區,社新里,186,1,942,6,948,1471,2,1,2,0,1,0,64.45
臺北市,士林區,社新里,187,1,788,8,796,1217,2,1,2,0,1,0,65.41
臺北市,士林區,社新里,188,1,935,8,943,1391,2,1,2,0,1,0,67.79
臺北市,士林區,社園里,189,1,1234,11,1245,1854,2,1,2,0,1,0,67.15
臺北市,士林區,社園里,190,1,1298,14,1312,1854,2,1,2,0,1,0,70.77
臺北市,士林區,社園里,191,1,1450,17,1467,2062,2,1,2,0,1,0,71.14
臺北市,士林區,永倫里,192,1,1024,5,1029,1486,2,1,2,0,1,0,69.25
臺北市,士林區,永倫里,193,1,897,12,909,1281,2,1,2,0,1,0,70.96
臺北市,士林區,永倫里,194,1,1101,8,1109,1539,2,1,2,0,1,0,72.06
臺北市,士林區,永倫里,195,1,1049,13,1062,1497,2,1,2,0,1,0,70.94
臺北市,士林區,福安里,196,1,945,11,956,1309,2,1,2,0,1,0,73.03
臺北市,士林區,福安里,197,1,922,12,934,1295,2,1,2,0,1,0,72.12
臺北市,士林區,福安里,198,1,937,9,946,1339,2,1,2,0,1,0,70.65
臺北市,士林區,富洲里,199,1,994,10,1004,1414,2,1,2,0,1,0,71
臺北市,士林區,富洲里,200,1,957,15,972,1348,2,1,2,0,1,0,72.11
臺北市,士林區,富洲里,201,1,1243,13,1256,1707,2,1,2,0,1,0,73.58
臺北市,士林區,岩山里,202,1,959,15,974,1565,2,1,2,0,1,0,62.24
臺北市,士林區,岩山里,203,1,997,7,1004,1538,2,1,2,0,1,0,65.28
臺北市,士林區,名山里,204,1,1014,11,1025,1517,2,1,2,0,1,0,67.57
臺北市,士林區,名山里,205,1,978,12,990,1472,2,1,2,0,1,0,67.26
臺北市,士林區,名山里,206,1,893,12,905,1395,2,1,2,0,1,0,64.87
臺北市,士林區,名山里,207,1,942,14,956,1446,2,1,2,0,1,0,66.11
臺北市,士林區,德行里,208,1,1082,12,1094,1622,2,1,2,0,1,0,67.45
臺北市,士林區,德行里,209,1,1120,13,1133,1765,2,1,2,0,1,0,64.19
臺北市,士林區,德華里,210,1,865,8,873,1432,2,1,2,0,1,0,60.96
臺北市,士林區,德華里,211,1,1050,12,1062,1632,2,1,2,0,1,0,65.07
臺北市,士林區,德華里,212,1,1073,12,1085,1699,2,1,2,0,1,0,63.86
臺北市,士林區,聖山里,213,1,911,13,924,1434,2,1,2,0,1,0,64.44
臺北市,士林區,聖山里,214,1,936,8,944,1407,2,1,2,0,1,0,67.09
臺北市,士林區,聖山里,215,1,957,8,965,1423,2,1,2,0,1,0,67.81
臺北市,士林區,忠誠里,216,1,1067,17,1084,1514,2,1,2,0,1,0,71.6
臺北市,士林區,忠誠里,217,1,991,11,1002,1489,2,1,2,0,1,0,67.29
臺北市,士林區,忠誠里,218,1,1084,10,1094,1653,2,1,2,0,1,0,66.18
臺北市,士林區,芝山里,219,1,908,13,921,1417,2,1,2,0,1,0,65
臺北市,士林區,芝山里,220,1,979,15,994,1475,2,1,2,0,1,0,67.39
臺北市,士林區,芝山里,221,1,963,13,976,1424,2,1,2,0,1,0,68.54
臺北市,士林區,芝山里,222,1,1034,12,1046,1580,2,1,2,0,1,0,66.2
臺北市,士林區,東山里,223,1,1012,15,1027,1452,2,1,2,0,1,0,70.73
臺北市,士林區,東山里,224,1,980,12,992,1507,2,1,2,0,1,0,65.83
臺北市,士林區,東山里,225,1,857,16,873,1257,2,1,2,0,1,0,69.45
臺北市,士林區,三玉里,226,1,917,19,936,1467,2,1,2,0,1,0,63.8
臺北市,士林區,三玉里,227,1,1037,12,1049,1618,2,1,2,0,1,0,64.83
臺北市,士林區,三玉里,228,1,965,15,980,1472,2,1,2,0,1,0,66.58
臺北市,士林區,蘭雅里,229,1,872,11,883,1433,2,1,2,0,1,0,61.62
臺北市,士林區,蘭雅里,230,1,883,13,896,1379,2,1,2,0,1,0,64.97
臺北市,士林區,蘭雅里,231,1,966,13,979,1489,2,1,2,0,1,0,65.75
臺北市,士林區,蘭雅里,232,1,866,10,876,1409,2,1,2,0,1,0,62.17
臺北市,士林區,蘭雅里,233,1,856,14,870,1384,2,1,2,0,1,0,62.86
臺北市,士林區,蘭興里,234,1,1097,10,1107,1676,2,1,2,0,1,0,66.05
臺北市,士林區,蘭興里,235,1,1010,17,1027,1544,2,1,2,0,1,0,66.52
臺北市,士林區,蘭興里,236,1,1223,14,1237,1791,2,1,2,0,1,0,69.07
臺北市,士林區,天福里,237,1,1079,19,1098,1631,2,1,2,0,1,0,67.32
臺北市,士林區,天福里,238,1,1203,25,1228,1825,2,1,2,0,1,0,67.29
臺北市,士林區,天福里,239,1,990,15,1005,1538,2,1,2,0,1,0,65.34
臺北市,士林區,天祿里,240,1,895,18,913,1401,2,1,2,0,1,0,65.17
臺北市,士林區,天祿里,241,1,921,16,937,1395,2,1,2,0,1,0,67.17
臺北市,士林區,天祿里,242,1,860,12,872,1340,2,1,2,0,1,0,65.07
臺北市,士林區,天壽里,243,1,1267,17,1284,2007,2,1,2,0,1,0,63.98
臺北市,士林區,天壽里,244,1,1217,24,1241,1906,2,1,2,0,1,0,65.11
臺北市,士林區,天和里,245,1,957,9,966,1487,2,1,2,0,1,0,64.96
臺北市,士林區,天和里,246,1,1006,12,1018,1539,2,1,2,0,1,0,66.15
臺北市,士林區,天和里,247,1,977,14,991,1606,2,1,2,0,1,0,61.71
臺北市,士林區,天和里,248,1,940,15,955,1501,2,1,2,0,1,0,63.62
臺北市,士林區,天山里,249,1,864,14,878,1392,2,1,2,0,1,0,63.07
臺北市,士林區,天山里,250,1,897,17,914,1501,2,1,2,0,1,0,60.89
臺北市,士林區,天山里,251,1,799,11,810,1290,2,1,2,0,1,0,62.79
臺北市,士林區,天山里,252,1,920,13,933,1469,2,1,2,0,1,0,63.51
臺北市,士林區,天玉里,253,1,1068,17,1085,1766,2,1,2,0,1,0,61.44
臺北市,士林區,天玉里,254,1,1021,14,1035,1553,2,1,2,0,1,0,66.65
臺北市,士林區,天玉里,255,1,1131,20,1151,1764,2,1,2,0,1,0,65.25
臺北市,士林區,天玉里,256,1,1009,16,1025,1695,2,1,2,0,1,0,60.47
臺北市,士林區,天母里,257,1,1125,11,1136,1750,2,1,2,0,1,0,64.91
臺北市,士林區,天母里,258,1,1180,21,1201,1820,2,1,2,0,1,0,65.99
臺北市,士林區,天母里,259,1,1086,13,1099,1679,2,1,2,0,1,0,65.46
臺北市,士林區,永福里,260,1,751,9,760,1211,2,1,2,0,1,0,62.76
臺北市,士林區,公館里,261,1,794,5,799,1260,2,1,2,0,1,0,63.41
臺北市,士林區,新安里,262,1,1180,10,1190,1775,2,1,2,0,1,0,67.04
臺北市,士林區,陽明里,263,1,588,6,594,931,2,1,2,0,1,0,63.8
臺北市,士林區,陽明里,264,1,584,9,593,993,2,1,2,0,1,0,59.72
臺北市,士林區,陽明里,265,1,478,5,483,787,2,1,2,0,1,0,61.37
臺北市,士林區,菁山里,266,1,373,1,374,532,2,1,2,0,1,0,70.3
臺北市,士林區,菁山里,267,1,575,11,586,863,2,1,2,0,1,0,67.9
臺北市,士林區,平等里,268,1,836,7,843,1191,2,1,2,0,1,0,70.78
臺北市,士林區,溪山里,269,1,871,9,880,1292,2,1,2,0,1,0,68.11
臺北市,士林區,翠山里,270,1,788,11,799,1245,2,1,2,0,1,0,64.18
臺北市,士林區,翠山里,271,1,773,9,782,1230,2,1,2,0,1,0,63.58
臺北市,士林區,臨溪里,272,1,889,19,908,1398,2,1,2,0,1,0,64.95
臺北市,士林區,臨溪里,273,1,655,15,670,1098,2,1,2,0,1,0,61.02
臺北市,內湖區,西湖里,274,2,961,19,980,1441,2,1,2,0,1,0,68.01
臺北市,內湖區,西湖里,275,2,1041,13,1054,1589,2,1,2,0,1,0,66.33
臺北市,內湖區,西湖里,276,2,1063,21,1084,1614,2,1,2,0,1,0,67.16
臺北市,內湖區,西湖里,277,2,1041,16,1057,1571,2,1,2,0,1,0,67.28
臺北市,內湖區,西康里,278,2,1070,27,1097,1599,2,1,2,0,1,0,68.61
臺北市,內湖區,西康里,279,2,1018,11,1029,1555,2,1,2,0,1,0,66.17
臺北市,內湖區,西康里,280,2,932,18,950,1520,2,1,2,0,1,0,62.5
臺北市,內湖區,西康里,281,2,1309,16,1325,1914,2,1,2,0,1,0,69.23
臺北市,內湖區,西安里,282,2,1072,12,1084,1637,2,1,2,0,1,0,66.22
臺北市,內湖區,西安里,283,2,1235,25,1260,1858,2,1,2,0,1,0,67.81
臺北市,內湖區,西安里,284,2,1014,28,1042,1647,2,1,2,0,1,0,63.27
臺北市,內湖區,港墘里,285,2,1055,18,1073,1525,2,1,2,0,1,0,70.36
臺北市,內湖區,港墘里,286,2,988,14,1002,1560,2,1,2,0,1,0,64.23
臺北市,內湖區,港墘里,287,2,916,17,933,1479,2,1,2,0,1,0,63.08
臺北市,內湖區,港都里,288,2,893,14,907,1301,2,1,2,0,1,0,69.72
臺北市,內湖區,港都里,289,2,913,19,932,1412,2,1,2,0,1,0,66.01
臺北市,內湖區,港都里,290,2,849,12,861,1331,2,1,2,0,1,0,64.69
臺北市,內湖區,麗山里,291,2,946,21,967,1472,2,1,2,0,1,0,65.69
臺北市,內湖區,麗山里,292,2,959,12,971,1437,2,1,2,0,1,0,67.57
臺北市,內湖區,麗山里,293,2,826,16,842,1281,2,1,2,0,1,0,65.73
臺北市,內湖區,港富里,294,2,971,9,980,1441,2,1,2,0,1,0,68.01
臺北市,內湖區,港富里,295,2,960,23,983,1494,2,1,2,0,1,0,65.8
臺北市,內湖區,港富里,296,2,870,10,880,1352,2,1,2,0,1,0,65.09
臺北市,內湖區,港富里,297,2,1031,24,1055,1507,2,1,2,0,1,0,70.01
臺北市,內湖區,港富里,298,2,912,15,927,1413,2,1,2,0,1,0,65.61
臺北市,內湖區,港華里,299,2,1064,21,1085,1607,2,1,2,0,1,0,67.52
臺北市,內湖區,港華里,300,2,1024,28,1052,1544,2,1,2,0,1,0,68.13
臺北市,內湖區,港華里,301,2,1117,18,1135,1652,2,1,2,0,1,0,68.7
臺北市,內湖區,港華里,302,2,983,23,1006,1523,2,1,2,0,1,0,66.05
臺北市,內湖區,內湖里,303,2,996,10,1006,1534,2,1,2,0,1,0,65.58
臺北市,內湖區,內湖里,304,2,1044,14,1058,1601,2,1,2,0,1,0,66.08
臺北市,內湖區,內湖里,305,2,906,18,924,1557,2,1,2,0,1,0,59.34
臺北市,內湖區,湖濱里,306,2,1033,14,1047,1651,2,1,2,0,1,0,63.42
臺北市,內湖區,湖濱里,307,2,1157,16,1173,1704,2,1,2,0,1,0,68.84
臺北市,內湖區,湖濱里,308,2,1000,14,1014,1386,2,1,2,0,1,0,73.16
臺北市,內湖區,湖濱里,309,2,754,11,765,1137,2,1,2,0,1,0,67.28
臺北市,內湖區,大湖里,310,2,795,13,808,1263,2,1,2,0,1,0,63.97
臺北市,內湖區,大湖里,311,2,961,10,971,1382,2,1,2,0,1,0,70.26
臺北市,內湖區,大湖里,312,2,799,11,810,1328,2,1,2,0,1,0,60.99
臺北市,內湖區,秀湖里,313,2,1020,20,1040,1615,2,1,2,0,1,0,64.4
臺北市,內湖區,秀湖里,314,2,1052,15,1067,1643,2,1,2,0,1,0,64.94
臺北市,內湖區,秀湖里,315,2,990,16,1006,1559,2,1,2,0,1,0,64.53
臺北市,內湖區,金龍里,316,2,980,14,994,1570,2,1,2,0,1,0,63.31
臺北市,內湖區,金龍里,317,2,978,15,993,1554,2,1,2,0,1,0,63.9
臺北市,內湖區,金龍里,318,2,894,9,903,1367,2,1,2,0,1,0,66.06
臺北市,內湖區,金瑞里,319,2,1120,20,1140,1680,2,1,2,0,1,0,67.86
臺北市,內湖區,金瑞里,320,2,1074,22,1096,1686,2,1,2,0,1,0,65.01
臺北市,內湖區,金瑞里,321,2,1163,13,1176,1748,2,1,2,0,1,0,67.28
臺北市,內湖區,碧山里,322,2,279,0,279,406,2,1,2,0,1,0,68.72
臺北市,內湖區,碧山里,323,2,1147,17,1164,1715,2,1,2,0,1,0,67.87
臺北市,內湖區,碧山里,324,2,1159,18,1177,1764,2,1,2,0,1,0,66.72
臺北市,內湖區,碧山里,325,2,945,15,960,1481,2,1,2,0,1,0,64.82
臺北市,內湖區,瑞光里,326,2,826,14,840,1234,2,1,2,0,1,0,68.07
臺北市,內湖區,瑞光里,327,2,805,6,811,1193,2,1,2,0,1,0,67.98
臺北市,內湖區,瑞光里,328,2,871,12,883,1282,2,1,2,0,1,0,68.88
臺北市,內湖區,瑞陽里,329,2,1136,18,1154,1662,2,1,2,0,1,0,69.43
臺北市,內湖區,瑞陽里,330,2,1014,11,1025,1505,2,1,2,0,1,0,68.11
臺北市,內湖區,瑞陽里,331,2,1066,15,1081,1491,2,1,2,0,1,0,72.5
臺北市,內湖區,瑞陽里,332,2,1114,14,1128,1611,2,1,2,0,1,0,70.02
臺北市,內湖區,紫陽里,333,2,923,14,937,1450,2,1,2,0,1,0,64.62
臺北市,內湖區,紫陽里,334,2,903,14,917,1492,2,1,2,0,1,0,61.46
臺北市,內湖區,紫陽里,335,2,902,9,911,1455,2,1,2,0,1,0,62.61
臺北市,內湖區,紫陽里,336,2,990,12,1002,1513,2,1,2,0,1,0,66.23
臺北市,內湖區,紫星里,337,2,1043,11,1054,1519,2,1,2,0,1,0,69.39
臺北市,內湖區,紫星里,338,2,1117,14,1131,1743,2,1,2,0,1,0,64.89
臺北市,內湖區,紫星里,339,2,1100,17,1117,1661,2,1,2,0,1,0,67.25
臺北市,內湖區,紫星里,340,2,1112,14,1126,1645,2,1,2,0,1,0,68.45
臺北市,內湖區,紫雲里,341,2,1058,16,1074,1507,2,1,2,0,1,0,71.27
臺北市,內湖區,紫雲里,342,2,990,24,1014,1514,2,1,2,0,1,0,66.97
臺北市,內湖區,紫雲里,343,2,1058,14,1072,1644,2,1,2,0,1,0,65.21
臺北市,內湖區,清白里,344,2,992,24,1016,1558,2,1,2,0,1,0,65.21
臺北市,內湖區,清白里,345,2,987,10,997,1500,2,1,2,0,1,0,66.47
臺北市,內湖區,清白里,346,2,866,8,874,1443,2,1,2,0,1,0,60.57
臺北市,內湖區,清白里,347,2,915,21,936,1502,2,1,2,0,1,0,62.32
臺北市,內湖區,金湖里,348,2,860,20,880,1305,2,1,2,0,1,0,67.43
臺北市,內湖區,金湖里,349,2,940,17,957,1544,2,1,2,0,1,0,61.98
臺北市,內湖區,金湖里,350,2,873,13,886,1349,2,1,2,0,1,0,65.68
臺北市,內湖區,金湖里,351,2,839,9,848,1312,2,1,2,0,1,0,64.63
臺北市,內湖區,葫洲里,352,2,962,14,976,1454,2,1,2,0,1,0,67.13
臺北市,內湖區,葫洲里,353,2,911,9,920,1459,2,1,2,0,1,0,63.06
臺北市,內湖區,葫洲里,354,2,970,22,992,1535,2,1,2,0,1,0,64.63
臺北市,內湖區,葫洲里,355,2,947,20,967,1468,2,1,2,0,1,0,65.87
臺北市,內湖區,葫洲里,356,2,934,12,946,1532,2,1,2,0,1,0,61.75
臺北市,內湖區,康寧里,357,2,934,15,949,1543,2,1,2,0,1,0,61.5
臺北市,內湖區,康寧里,358,2,965,9,974,1550,2,1,2,0,1,0,62.84
臺北市,內湖區,康寧里,359,2,932,14,946,1444,2,1,2,0,1,0,65.51
臺北市,內湖區,康寧里,360,2,910,14,924,1444,2,1,2,0,1,0,63.99
臺北市,內湖區,明湖里,361,2,821,10,831,1242,2,1,2,0,1,0,66.91
臺北市,內湖區,明湖里,362,2,764,10,774,1167,2,1,2,0,1,0,66.32
臺北市,內湖區,明湖里,363,2,768,8,776,1229,2,1,2,0,1,0,63.14
臺北市,內湖區,五分里,364,2,903,8,911,1421,2,1,2,0,1,0,64.11
臺北市,內湖區,五分里,365,2,903,12,915,1478,2,1,2,0,1,0,61.91
臺北市,內湖區,五分里,366,2,890,16,906,1382,2,1,2,0,1,0,65.56
臺北市,內湖區,五分里,367,2,876,15,891,1387,2,1,2,0,1,0,64.24
臺北市,內湖區,五分里,368,2,870,11,881,1362,2,1,2,0,1,0,64.68
臺北市,內湖區,東湖里,369,2,973,14,987,1530,2,1,2,0,1,0,64.51
臺北市,內湖區,東湖里,370,2,983,9,992,1553,2,1,2,0,1,0,63.88
臺北市,內湖區,東湖里,371,2,949,15,964,1543,2,1,2,0,1,0,62.48
臺北市,內湖區,東湖里,372,2,911,17,928,1501,2,1,2,0,1,0,61.83
臺北市,內湖區,安湖里,373,2,912,17,929,1413,2,1,2,0,1,0,65.75
臺北市,內湖區,安湖里,374,2,793,14,807,1248,2,1,2,0,1,0,64.66
臺北市,內湖區,安湖里,375,2,824,8,832,1256,2,1,2,0,1,0,66.24
臺北市,內湖區,安湖里,376,2,949,12,961,1477,2,1,2,0,1,0,65.06
臺北市,內湖區,樂康里,377,2,917,21,938,1551,2,1,2,0,1,0,60.48
臺北市,內湖區,樂康里,378,2,968,16,984,1622,2,1,2,0,1,0,60.67
臺北市,內湖區,樂康里,379,2,940,17,957,1487,2,1,2,0,1,0,64.36
臺北市,內湖區,樂康里,380,2,970,10,980,1658,2,1,2,0,1,0,59.11
臺北市,內湖區,內溝里,381,2,495,7,502,792,2,1,2,0,1,0,63.38
臺北市,內湖區,內溝里,382,2,764,11,775,1203,2,1,2,0,1,0,64.42
臺北市,內湖區,內溝里,383,2,836,11,847,1333,2,1,2,0,1,0,63.54
臺北市,內湖區,安泰里,384,2,761,11,772,1208,2,1,2,0,1,0,63.91
臺北市,內湖區,安泰里,385,2,885,12,897,1358,2,1,2,0,1,0,66.05
臺北市,內湖區,安泰里,386,2,695,17,712,1155,2,1,2,0,1,0,61.65
臺北市,內湖區,蘆洲里,387,2,551,4,555,863,2,1,2,0,1,0,64.31
臺北市,內湖區,週美里,388,2,802,15,817,1229,2,1,2,0,1,0,66.48
臺北市,內湖區,週美里,389,2,841,9,850,1283,2,1,2,0,1,0,66.25
臺北市,內湖區,週美里,390,2,939,14,953,1461,2,1,2,0,1,0,65.23
臺北市,內湖區,行善里,391,2,675,15,690,1059,2,1,2,0,1,0,65.16
臺北市,內湖區,行善里,392,2,890,27,917,1367,2,1,2,0,1,0,67.08
臺北市,內湖區,行善里,393,2,843,19,862,1338,2,1,2,0,1,0,64.42
臺北市,內湖區,行善里,394,2,870,25,895,1393,2,1,2,0,1,0,64.25
臺北市,內湖區,石潭里,395,2,855,19,874,1345,2,1,2,0,1,0,64.98
臺北市,內湖區,湖興里,396,2,828,12,840,1362,2,1,2,0,1,0,61.67
臺北市,內湖區,湖興里,397,2,824,14,838,2327,2,1,2,0,1,0,36.01
臺北市,內湖區,湖興里,398,2,988,14,1002,1522,2,1,2,0,1,0,65.83
臺北市,內湖區,湖興里,399,2,829,13,842,1275,2,1,2,0,1,0,66.04
臺北市,內湖區,湖興里,400,2,857,21,878,1438,2,1,2,0,1,0,61.06
臺北市,內湖區,湖興里,401,2,969,15,984,1554,2,1,2,0,1,0,63.32
臺北市,內湖區,湖元里,402,2,844,16,860,1339,2,1,2,0,1,0,64.23
臺北市,內湖區,湖元里,403,2,836,16,852,1346,2,1,2,0,1,0,63.3
臺北市,內湖區,湖元里,404,2,927,15,942,1438,2,1,2,0,1,0,65.51
臺北市,南港區,南港里,405,2,994,20,1014,1551,2,1,2,0,1,0,65.38
臺北市,南港區,南港里,406,2,997,20,1017,1564,2,1,2,0,1,0,65.03
臺北市,南港區,南港里,407,2,1004,15,1019,1828,2,1,2,0,1,0,55.74
臺北市,南港區,中南里,408,2,1119,18,1137,1806,2,1,2,0,1,0,62.96
臺北市,南港區,中南里,409,2,885,6,891,1376,2,1,2,0,1,0,64.75
臺北市,南港區,三重里,410,2,834,12,846,1310,2,1,2,0,1,0,64.58
臺北市,南港區,三重里,411,2,805,18,823,1259,2,1,2,0,1,0,65.37
臺北市,南港區,新富里,412,2,974,16,990,1514,2,1,2,0,1,0,65.39
臺北市,南港區,新富里,413,2,1037,11,1048,1652,2,1,2,0,1,0,63.44
臺北市,南港區,東新里,414,2,887,16,903,1400,2,1,2,0,1,0,64.5
臺北市,南港區,東新里,415,2,1028,11,1039,1589,2,1,2,0,1,0,65.39
臺北市,南港區,東新里,416,2,783,17,800,1269,2,1,2,0,1,0,63.04
臺北市,南港區,東新里,417,2,588,11,599,949,2,1,2,0,1,0,63.12
臺北市,南港區,東新里,418,2,1135,14,1149,1762,2,1,2,0,1,0,65.21
臺北市,南港區,東明里,419,2,1285,21,1306,1896,2,1,2,0,1,0,68.88
臺北市,南港區,東明里,420,2,1103,13,1116,1797,2,1,2,0,1,0,62.1
臺北市,南港區,玉成里,421,2,1190,16,1206,1901,2,1,2,0,1,0,63.44
臺北市,南港區,玉成里,422,2,1258,18,1276,1861,2,1,2,0,1,0,68.57
臺北市,南港區,中研里,423,2,963,16,979,1524,2,1,2,0,1,0,64.24
臺北市,南港區,中研里,424,2,953,11,964,1454,2,1,2,0,1,0,66.3
臺北市,南港區,中研里,425,2,860,9,869,1345,2,1,2,0,1,0,64.61
臺北市,南港區,中研里,426,2,1019,13,1032,1502,2,1,2,0,1,0,68.71
臺北市,南港區,中研里,427,2,878,13,891,1332,2,1,2,0,1,0,66.89
臺北市,南港區,九如里,428,2,1114,16,1130,1696,2,1,2,0,1,0,66.63
臺北市,南港區,九如里,429,2,1182,12,1194,1664,2,1,2,0,1,0,71.75
臺北市,南港區,九如里,430,2,1008,18,1026,1604,2,1,2,0,1,0,63.97
臺北市,南港區,舊莊里,431,2,813,7,820,1295,2,1,2,0,1,0,63.32
臺北市,南港區,舊莊里,432,2,785,15,800,1316,2,1,2,0,1,0,60.79
臺北市,南港區,舊莊里,433,2,908,7,915,1457,2,1,2,0,1,0,62.8
臺北市,南港區,舊莊里,434,2,864,11,875,1368,2,1,2,0,1,0,63.96
臺北市,南港區,舊莊里,435,2,887,17,904,1466,2,1,2,0,1,0,61.66
臺北市,南港區,西新里,436,2,1081,25,1106,1795,2,1,2,0,1,0,61.62
臺北市,南港區,西新里,437,2,1141,17,1158,1805,2,1,2,0,1,0,64.16
臺北市,南港區,合成里,438,2,979,18,997,1523,2,1,2,0,1,0,65.46
臺北市,南港區,合成里,439,2,864,30,894,1395,2,1,2,0,1,0,64.09
臺北市,南港區,合成里,440,2,833,19,852,1342,2,1,2,0,1,0,63.49
臺北市,南港區,合成里,441,2,841,15,856,1260,2,1,2,0,1,0,67.94
臺北市,南港區,新光里,442,2,1128,19,1147,1623,2,1,2,0,1,0,70.67
臺北市,南港區,新光里,443,2,938,24,962,1514,2,1,2,0,1,0,63.54
臺北市,南港區,鴻福里,444,2,1208,15,1223,1849,2,1,2,0,1,0,66.14
臺北市,南港區,鴻福里,445,2,1206,22,1228,1903,2,1,2,0,1,0,64.53
臺北市,南港區,聯成里,446,2,907,15,922,1365,2,1,2,0,1,0,67.55
臺北市,南港區,聯成里,447,2,916,11,927,1418,2,1,2,0,1,0,65.37
臺北市,南港區,聯成里,448,2,981,22,1003,1451,2,1,2,0,1,0,69.12
臺北市,南港區,成福里,449,2,890,14,904,1332,2,1,2,0,1,0,67.87
臺北市,南港區,成福里,450,2,867,20,887,1357,2,1,2,0,1,0,65.36
臺北市,南港區,成福里,451,2,593,13,606,990,2,1,2,0,1,0,61.21
臺北市,南港區,成福里,452,2,1137,28,1165,1775,2,1,2,0,1,0,65.63
臺北市,南港區,萬福里,453,2,1192,21,1213,1737,2,1,2,0,1,0,69.83
臺北市,南港區,萬福里,454,2,1045,23,1068,1612,2,1,2,0,1,0,66.25
臺北市,南港區,百福里,455,2,916,12,928,1438,2,1,2,0,1,0,64.53
臺北市,南港區,百福里,456,2,823,17,840,1324,2,1,2,0,1,0,63.44
臺北市,南港區,百福里,457,2,789,28,817,1298,2,1,2,0,1,0,62.94
臺北市,南港區,仁福里,458,2,818,8,826,1330,2,1,2,0,1,0,62.11
臺北市,南港區,仁福里,459,2,992,18,1010,1566,2,1,2,0,1,0,64.5
臺北市,南港區,仁福里,460,2,954,29,983,1488,2,1,2,0,1,0,66.06
臺北市,松山區,莊敬里,461,3,951,23,974,1525,2,1,2,0,1,0,63.87
臺北市,松山區,莊敬里,462,3,1064,20,1084,1607,2,1,2,0,1,0,67.45
臺北市,松山區,莊敬里,463,3,1001,19,1020,1595,2,1,2,0,1,0,63.95
臺北市,松山區,東榮里,464,3,1095,18,1113,1711,2,1,2,0,1,0,65.05
臺北市,松山區,東榮里,465,3,1081,23,1104,1748,2,1,2,0,1,0,63.16
臺北市,松山區,東榮里,466,3,1064,18,1082,1629,2,1,2,0,1,0,66.42
臺北市,松山區,東榮里,467,3,1000,23,1023,1640,2,1,2,0,1,0,62.38
臺北市,松山區,三民里,468,3,955,13,968,1466,2,1,2,0,1,0,66.03
臺北市,松山區,三民里,469,3,822,13,835,1324,2,1,2,0,1,0,63.07
臺北市,松山區,三民里,470,3,865,21,886,1435,2,1,2,0,1,0,61.74
臺北市,松山區,三民里,471,3,857,16,873,1330,2,1,2,0,1,0,65.64
臺北市,松山區,新益里,472,3,810,17,827,1303,2,1,2,0,1,0,63.47
臺北市,松山區,新益里,473,3,796,19,815,1271,2,1,2,0,1,0,64.12
臺北市,松山區,新益里,474,3,780,9,789,1187,2,1,2,0,1,0,66.47
臺北市,松山區,富錦里,475,3,955,24,979,1550,2,1,2,0,1,0,63.16
臺北市,松山區,富錦里,476,3,942,27,969,1517,2,1,2,0,1,0,63.88
臺北市,松山區,富錦里,477,3,809,15,824,1176,2,1,2,0,1,0,70.07
臺北市,松山區,新東里,478,3,824,22,846,1317,2,1,2,0,1,0,64.24
臺北市,松山區,新東里,479,3,843,16,859,1334,2,1,2,0,1,0,64.39
臺北市,松山區,新東里,480,3,826,14,840,1389,2,1,2,0,1,0,60.48
臺北市,松山區,富泰里,481,3,782,14,796,1224,2,1,2,0,1,0,65.03
臺北市,松山區,富泰里,482,3,818,7,825,1280,2,1,2,0,1,0,64.45
臺北市,松山區,富泰里,483,3,723,21,744,1231,2,1,2,0,1,0,60.44
臺北市,松山區,介壽里,484,3,787,21,808,1191,2,1,2,0,1,0,67.84
臺北市,松山區,介壽里,485,3,745,18,763,1196,2,1,2,0,1,0,63.8
臺北市,松山區,介壽里,486,3,829,13,842,1308,2,1,2,0,1,0,64.37
臺北市,松山區,精忠里,487,3,699,19,718,1132,2,1,2,0,1,0,63.43
臺北市,松山區,精忠里,488,3,835,14,849,1332,2,1,2,0,1,0,63.74
臺北市,松山區,精忠里,489,3,676,19,695,1159,2,1,2,0,1,0,59.97
臺北市,松山區,東光里,490,3,915,20,935,1556,2,1,2,0,1,0,60.09
臺北市,松山區,東光里,491,3,982,19,1001,1509,2,1,2,0,1,0,66.34
臺北市,松山區,東光里,492,3,864,10,874,1399,2,1,2,0,1,0,62.47
臺北市,松山區,東光里,493,3,1043,16,1059,1566,2,1,2,0,1,0,67.62
臺北市,松山區,龍田里,494,3,804,25,829,1298,2,1,2,0,1,0,63.87
臺北市,松山區,龍田里,495,3,966,24,990,1445,2,1,2,0,1,0,68.51
臺北市,松山區,龍田里,496,3,1050,12,1062,1634,2,1,2,0,1,0,64.99
臺北市,松山區,龍田里,497,3,1051,24,1075,1665,2,1,2,0,1,0,64.56
臺北市,松山區,龍田里,498,3,924,27,951,1477,2,1,2,0,1,0,64.39
臺北市,松山區,東昌里,499,3,662,17,679,1057,2,1,2,0,1,0,64.24
臺北市,松山區,東昌里,500,3,727,20,747,1147,2,1,2,0,1,0,65.13
臺北市,松山區,東勢里,501,3,747,17,764,1197,2,1,2,0,1,0,63.83
臺北市,松山區,東勢里,502,3,806,15,821,1252,2,1,2,0,1,0,65.58
臺北市,松山區,東勢里,503,3,747,10,757,1176,2,1,2,0,1,0,64.37
臺北市,松山區,中華里,504,3,1071,30,1101,1698,2,1,2,0,1,0,64.84
臺北市,松山區,中華里,505,3,982,8,990,1499,2,1,2,0,1,0,66.04
臺北市,松山區,中華里,506,3,1135,11,1146,1734,2,1,2,0,1,0,66.09
臺北市,松山區,民有里,507,3,908,21,929,1467,2,1,2,0,1,0,63.33
臺北市,松山區,民有里,508,3,906,24,930,1446,2,1,2,0,1,0,64.32
臺北市,松山區,民有里,509,3,929,28,957,1445,2,1,2,0,1,0,66.23
臺北市,松山區,民有里,510,3,813,27,840,1354,2,1,2,0,1,0,62.04
臺北市,松山區,民有里,511,3,873,27,900,1393,2,1,2,0,1,0,64.61
臺北市,松山區,民福里,512,3,1250,24,1274,1843,2,1,2,0,1,0,69.13
臺北市,松山區,民福里,513,3,1159,25,1184,1756,2,1,2,0,1,0,67.43
臺北市,松山區,民福里,514,3,1031,31,1062,1663,2,1,2,0,1,0,63.86
臺北市,松山區,慈祐里,515,3,1090,22,1112,1733,2,1,2,0,1,0,64.17
臺北市,松山區,慈祐里,516,3,950,18,968,2407,2,1,2,0,1,0,40.22
臺北市,松山區,慈祐里,517,3,938,17,955,1438,2,1,2,0,1,0,66.41
臺北市,松山區,安平里,518,3,1187,26,1213,1747,2,1,2,0,1,0,69.43
臺北市,松山區,安平里,519,3,1141,17,1158,1731,2,1,2,0,1,0,66.9
臺北市,松山區,安平里,520,3,1201,27,1228,1776,2,1,2,0,1,0,69.14
臺北市,松山區,安平里,521,3,1104,15,1119,1584,2,1,2,0,1,0,70.64
臺北市,松山區,鵬程里,522,3,1011,17,1028,1558,2,1,2,0,1,0,65.98
臺北市,松山區,鵬程里,523,3,955,13,968,1479,2,1,2,0,1,0,65.45
臺北市,松山區,鵬程里,524,3,1023,16,1039,1618,2,1,2,0,1,0,64.22
臺北市,松山區,自強里,525,3,892,17,909,1264,2,1,2,0,1,0,71.91
臺北市,松山區,自強里,526,3,958,14,972,1477,2,1,2,0,1,0,65.81
臺北市,松山區,自強里,527,3,981,18,999,1480,2,1,2,0,1,0,67.5
臺北市,松山區,自強里,528,3,1064,16,1080,1624,2,1,2,0,1,0,66.5
臺北市,松山區,自強里,529,3,1101,23,1124,1636,2,1,2,0,1,0,68.7
臺北市,松山區,吉祥里,530,3,1088,29,1117,1725,2,1,2,0,1,0,64.75
臺北市,松山區,吉祥里,531,3,1114,25,1139,1769,2,1,2,0,1,0,64.39
臺北市,松山區,吉祥里,532,3,1011,21,1032,1680,2,1,2,0,1,0,61.43
臺北市,松山區,吉祥里,533,3,1067,22,1089,1685,2,1,2,0,1,0,64.63
臺北市,松山區,新聚里,534,3,906,20,926,1473,2,1,2,0,1,0,62.86
臺北市,松山區,新聚里,535,3,1094,15,1109,1654,2,1,2,0,1,0,67.05
臺北市,松山區,新聚里,536,3,960,12,972,1538,2,1,2,0,1,0,63.2
臺北市,松山區,新聚里,537,3,1012,29,1041,1547,2,1,2,0,1,0,67.29
臺北市,松山區,復盛里,538,3,808,17,825,1246,2,1,2,0,1,0,66.21
臺北市,松山區,復盛里,539,3,810,18,828,1233,2,1,2,0,1,0,67.15
臺北市,松山區,復盛里,540,3,886,26,912,1389,2,1,2,0,1,0,65.66
臺北市,松山區,復盛里,541,3,923,17,940,1426,2,1,2,0,1,0,65.92
臺北市,松山區,中正里,542,3,993,25,1018,1646,2,1,2,0,1,0,61.85
臺北市,松山區,中正里,543,3,995,23,1018,1706,2,1,2,0,1,0,59.67
臺北市,松山區,中正里,544,3,1039,32,1071,1747,2,1,2,0,1,0,61.31
臺北市,松山區,中正里,545,3,885,21,906,1546,2,1,2,0,1,0,58.6
臺北市,松山區,中崙里,546,3,985,27,1012,1629,2,1,2,0,1,0,62.12
臺北市,松山區,中崙里,547,3,1041,14,1055,1531,2,1,2,0,1,0,68.91
臺北市,松山區,美仁里,548,3,853,19,872,1364,2,1,2,0,1,0,63.93
臺北市,松山區,美仁里,549,3,838,16,854,1301,2,1,2,0,1,0,65.64
臺北市,松山區,吉仁里,550,3,1032,24,1056,1634,2,1,2,0,1,0,64.63
臺北市,松山區,吉仁里,551,3,995,23,1018,1560,2,1,2,0,1,0,65.26
臺北市,松山區,敦化里,552,3,829,23,852,1376,2,1,2,0,1,0,61.92
臺北市,松山區,敦化里,553,3,991,25,1016,1502,2,1,2,0,1,0,67.64
臺北市,松山區,敦化里,554,3,930,24,954,1432,2,1,2,0,1,0,66.62
臺北市,松山區,敦化里,555,3,845,30,875,1310,2,1,2,0,1,0,66.79
臺北市,松山區,復源里,556,3,835,20,855,1331,2,1,2,0,1,0,64.24
臺北市,松山區,復源里,557,3,739,25,764,1179,2,1,2,0,1,0,64.8
臺北市,松山區,復建里,558,3,920,25,945,1471,2,1,2,0,1,0,64.24
臺北市,松山區,復建里,559,3,1012,21,1033,1667,2,1,2,0,1,0,61.97
臺北市,松山區,復勢里,560,3,1160,18,1178,1755,2,1,2,0,1,0,67.12
臺北市,松山區,復勢里,561,3,964,18,982,1549,2,1,2,0,1,0,63.4
臺北市,松山區,復勢里,562,3,929,17,946,1495,2,1,2,0,1,0,63.28
臺北市,松山區,福成里,563,3,740,27,767,1192,2,1,2,0,1,0,64.35
臺北市,松山區,福成里,564,3,589,15,604,930,2,1,2,0,1,0,64.95
臺北市,松山區,松基里,565,3,1007,27,1034,1591,2,1,2,0,1,0,64.99
臺北市,松山區,松基里,566,3,885,17,902,1483,2,1,2,0,1,0,60.82
臺北市,信義區,西村里,567,3,851,17,868,2271,2,1,2,0,1,0,38.22
臺北市,信義區,西村里,568,3,930,20,950,1378,2,1,2,0,1,0,68.94
臺北市,信義區,西村里,569,3,849,17,866,1331,2,1,2,0,1,0,65.06
臺北市,信義區,正和里,570,3,889,16,905,1407,2,1,2,0,1,0,64.32
臺北市,信義區,正和里,571,3,828,17,845,1233,2,1,2,0,1,0,68.53
臺北市,信義區,正和里,572,3,775,16,791,1268,2,1,2,0,1,0,62.38
臺北市,信義區,興隆里,573,3,655,12,667,1093,2,1,2,0,1,0,61.02
臺北市,信義區,興隆里,574,3,819,23,842,1426,2,1,2,0,1,0,59.05
臺北市,信義區,中興里,575,3,733,11,744,1313,2,1,2,0,1,0,56.66
臺北市,信義區,中興里,576,3,737,15,752,1306,2,1,2,0,1,0,57.58
臺北市,信義區,新仁里,577,3,932,18,950,1457,2,1,2,0,1,0,65.2
臺北市,信義區,新仁里,578,3,893,26,919,1395,2,1,2,0,1,0,65.88
臺北市,信義區,興雅里,579,3,1055,30,1085,1666,2,1,2,0,1,0,65.13
臺北市,信義區,興雅里,580,3,1008,27,1035,1532,2,1,2,0,1,0,67.56
臺北市,信義區,興雅里,581,3,1074,16,1090,1651,2,1,2,0,1,0,66.02
臺北市,信義區,敦厚里,582,3,841,15,856,1307,2,1,2,0,1,0,65.49
臺北市,信義區,敦厚里,583,3,770,11,781,1286,2,1,2,0,1,0,60.73
臺北市,信義區,敦厚里,584,3,827,11,838,1300,2,1,2,0,1,0,64.46
臺北市,信義區,廣居里,585,3,967,12,979,1557,2,1,2,0,1,0,62.88
臺北市,信義區,廣居里,586,3,1067,21,1088,1642,2,1,2,0,1,0,66.26
臺北市,信義區,廣居里,587,3,967,13,980,1576,2,1,2,0,1,0,62.18
臺北市,信義區,廣居里,588,3,842,14,856,1307,2,1,2,0,1,0,65.49
臺北市,信義區,安康里,589,3,1008,22,1030,1574,2,1,2,0,1,0,65.44
臺北市,信義區,安康里,590,3,1044,15,1059,1657,2,1,2,0,1,0,63.91
臺北市,信義區,安康里,591,3,1046,19,1065,1687,2,1,2,0,1,0,63.13
臺北市,信義區,安康里,592,3,978,29,1007,1689,2,1,2,0,1,0,59.62
臺北市,信義區,六藝里,593,3,965,20,985,1541,2,1,2,0,1,0,63.92
臺北市,信義區,六藝里,594,3,983,20,1003,1441,2,1,2,0,1,0,69.6
臺北市,信義區,雅祥里,595,3,812,10,822,1281,2,1,2,0,1,0,64.17
臺北市,信義區,雅祥里,596,3,798,14,812,1251,2,1,2,0,1,0,64.91
臺北市,信義區,雅祥里,597,3,967,9,976,1470,2,1,2,0,1,0,66.39
臺北市,信義區,五常里,598,3,950,17,967,1508,2,1,2,0,1,0,64.12
臺北市,信義區,五常里,599,3,969,29,998,1547,2,1,2,0,1,0,64.51
臺北市,信義區,五全里,600,3,953,8,961,1450,2,1,2,0,1,0,66.28
臺北市,信義區,五全里,601,3,940,19,959,1401,2,1,2,0,1,0,68.45
臺北市,信義區,五全里,602,3,928,15,943,1391,2,1,2,0,1,0,67.79
臺北市,信義區,永吉里,603,3,1117,24,1141,1909,2,1,2,0,1,0,59.77
臺北市,信義區,永吉里,604,3,1124,33,1157,1689,2,1,2,0,1,0,68.5
臺北市,信義區,長春里,605,3,1135,19,1154,1762,2,1,2,0,1,0,65.49
臺北市,信義區,長春里,606,3,1172,21,1193,1782,2,1,2,0,1,0,66.95
臺北市,信義區,四育里,607,3,984,23,1007,1530,2,1,2,0,1,0,65.82
臺北市,信義區,四育里,608,3,1073,17,1090,1577,2,1,2,0,1,0,69.12
臺北市,信義區,四育里,609,3,1049,21,1070,1569,2,1,2,0,1,0,68.2
臺北市,信義區,四維里,610,3,1005,22,1027,1607,2,1,2,0,1,0,63.91
臺北市,信義區,四維里,611,3,931,22,953,1545,2,1,2,0,1,0,61.68
臺北市,信義區,四維里,612,3,792,21,813,1379,2,1,2,0,1,0,58.96
臺北市,信義區,永春里,613,3,899,31,930,1453,2,1,2,0,1,0,64.01
臺北市,信義區,永春里,614,3,861,24,885,1338,2,1,2,0,1,0,66.14
臺北市,信義區,永春里,615,3,908,19,927,1475,2,1,2,0,1,0,62.85
臺北市,信義區,富台里,616,3,1172,25,1197,1762,2,1,2,0,1,0,67.93
臺北市,信義區,富台里,617,3,951,8,959,1602,2,1,2,0,1,0,59.86
臺北市,信義區,國業里,618,3,834,8,842,1404,2,1,2,0,1,0,59.97
臺北市,信義區,國業里,619,3,1014,11,1025,1509,2,1,2,0,1,0,67.93
臺北市,信義區,國業里,620,3,962,17,979,1531,2,1,2,0,1,0,63.95
臺北市,信義區,國業里,621,3,972,18,990,1550,2,1,2,0,1,0,63.87
臺北市,信義區,松隆里,622,3,681,11,692,1109,2,1,2,0,1,0,62.4
臺北市,信義區,松隆里,623,3,553,7,560,911,2,1,2,0,1,0,61.47
臺北市,信義區,松友里,624,3,1120,15,1135,1791,2,1,2,0,1,0,63.37
臺北市,信義區,松友里,625,3,1106,24,1130,1782,2,1,2,0,1,0,63.41
臺北市,信義區,松友里,626,3,1104,20,1124,1808,2,1,2,0,1,0,62.17
臺北市,信義區,松光里,627,3,849,20,869,1417,2,1,2,0,1,0,61.33
臺北市,信義區,松光里,628,3,919,17,936,1443,2,1,2,0,1,0,64.86
臺北市,信義區,松光里,629,3,993,12,1005,1546,2,1,2,0,1,0,65.01
臺北市,信義區,中坡里,630,3,732,18,750,1154,2,1,2,0,1,0,64.99
臺北市,信義區,中坡里,631,3,780,16,796,1219,2,1,2,0,1,0,65.3
臺北市,信義區,中坡里,632,3,864,14,878,1364,2,1,2,0,1,0,64.37
臺北市,信義區,中行里,633,3,992,23,1015,1561,2,1,2,0,1,0,65.02
臺北市,信義區,中行里,634,3,1090,15,1105,1714,2,1,2,0,1,0,64.47
臺北市,信義區,中行里,635,3,1030,11,1041,1568,2,1,2,0,1,0,66.39
臺北市,信義區,中行里,636,3,1039,33,1072,1648,2,1,2,0,1,0,65.05
臺北市,信義區,大道里,637,3,871,20,891,1414,2,1,2,0,1,0,63.01
臺北市,信義區,大道里,638,3,882,13,895,1379,2,1,2,0,1,0,64.9
臺北市,信義區,大道里,639,3,812,15,827,1280,2,1,2,0,1,0,64.61
臺北市,信義區,大道里,640,3,820,8,828,1332,2,1,2,0,1,0,62.16
臺北市,信義區,大仁里,641,3,696,29,725,1097,2,1,2,0,1,0,66.09
臺北市,信義區,大仁里,642,3,998,22,1020,1498,2,1,2,0,1,0,68.09
臺北市,信義區,大仁里,643,3,1027,7,1034,1489,2,1,2,0,1,0,69.44
臺北市,信義區,景新里,644,3,889,16,905,1390,2,1,2,0,1,0,65.11
臺北市,信義區,景新里,645,3,908,24,932,1399,2,1,2,0,1,0,66.62
臺北市,信義區,景新里,646,3,825,18,843,1340,2,1,2,0,1,0,62.91
臺北市,信義區,惠安里,647,3,842,27,869,1327,2,1,2,0,1,0,65.49
臺北市,信義區,惠安里,648,3,969,14,983,1488,2,1,2,0,1,0,66.06
臺北市,信義區,惠安里,649,3,949,19,968,1414,2,1,2,0,1,0,68.46
臺北市,信義區,惠安里,650,3,844,19,863,1251,2,1,2,0,1,0,68.98
臺北市,信義區,三張里,651,3,1002,17,1019,1525,2,1,2,0,1,0,66.82
臺北市,信義區,三張里,652,3,953,19,972,1495,2,1,2,0,1,0,65.02
臺北市,信義區,三張里,653,3,1030,14,1044,1590,2,1,2,0,1,0,65.66
臺北市,信義區,三張里,654,3,995,24,1019,1535,2,1,2,0,1,0,66.38
臺北市,信義區,三張里,655,3,889,12,901,1421,2,1,2,0,1,0,63.41
臺北市,信義區,三犁里,656,3,789,14,803,1257,2,1,2,0,1,0,63.88
臺北市,信義區,三犁里,657,3,949,12,961,1491,2,1,2,0,1,0,64.45
臺北市,信義區,三犁里,658,3,863,9,872,1406,2,1,2,0,1,0,62.02
臺北市,信義區,六合里,659,3,970,13,983,1558,2,1,2,0,1,0,63.09
臺北市,信義區,六合里,660,3,899,19,918,1441,2,1,2,0,1,0,63.71
臺北市,信義區,六合里,661,3,802,11,813,1333,2,1,2,0,1,0,60.99
臺北市,信義區,六合里,662,3,750,10,760,1309,2,1,2,0,1,0,58.06
臺北市,信義區,泰和里,663,3,884,14,898,1545,2,1,2,0,1,0,58.12
臺北市,信義區,泰和里,664,3,979,21,1000,1537,2,1,2,0,1,0,65.06
臺北市,信義區,泰和里,665,3,1151,24,1175,1789,2,1,2,0,1,0,65.68
臺北市,信義區,泰和里,666,3,1095,26,1121,1742,2,1,2,0,1,0,64.35
臺北市,信義區,景聯里,667,3,761,19,780,1230,2,1,2,0,1,0,63.41
臺北市,信義區,景聯里,668,3,895,19,914,1365,2,1,2,0,1,0,66.96
臺北市,信義區,景聯里,669,3,848,17,865,1318,2,1,2,0,1,0,65.63
臺北市,信義區,景勤里,670,3,683,12,695,1053,2,1,2,0,1,0,66
臺北市,信義區,景勤里,671,3,783,14,797,1239,2,1,2,0,1,0,64.33
臺北市,信義區,景勤里,672,3,880,20,900,1327,2,1,2,0,1,0,67.82
臺北市,信義區,雙和里,673,3,991,12,1003,1553,2,1,2,0,1,0,64.58
臺北市,信義區,雙和里,674,3,913,14,927,1389,2,1,2,0,1,0,66.74
臺北市,信義區,雙和里,675,3,923,22,945,1474,2,1,2,0,1,0,64.11
臺北市,信義區,雙和里,676,3,979,25,1004,1505,2,1,2,0,1,0,66.71
臺北市,信義區,嘉興里,677,3,923,22,945,1414,2,1,2,0,1,0,66.83
臺北市,信義區,嘉興里,678,3,804,17,821,1252,2,1,2,0,1,0,65.58
臺北市,信義區,黎順里,679,3,1071,24,1095,1780,2,1,2,0,1,0,61.52
臺北市,信義區,黎順里,680,3,1139,24,1163,1762,2,1,2,0,1,0,66
臺北市,信義區,黎平里,681,3,1066,16,1082,1602,2,1,2,0,1,0,67.54
臺北市,信義區,黎平里,682,3,802,28,830,1254,2,1,2,0,1,0,66.19
臺北市,信義區,黎平里,683,3,1020,17,1037,1577,2,1,2,0,1,0,65.76
臺北市,信義區,黎平里,684,3,761,14,775,1189,2,1,2,0,1,0,65.18
臺北市,信義區,黎忠里,685,3,903,24,927,1397,2,1,2,0,1,0,66.36
臺北市,信義區,黎忠里,686,3,750,14,764,1191,2,1,2,0,1,0,64.15
臺北市,信義區,黎忠里,687,3,934,27,961,1439,2,1,2,0,1,0,66.78
臺北市,信義區,黎安里,688,3,742,20,762,1226,2,1,2,0,1,0,62.15
臺北市,信義區,黎安里,689,3,667,14,681,967,2,1,2,0,1,0,70.42
臺北市,中山區,正守里,690,4,577,14,591,868,2,1,2,0,1,0,68.09
臺北市,中山區,正守里,691,4,916,22,938,1532,2,1,2,0,1,0,61.23
臺北市,中山區,正義里,692,4,635,16,651,1182,2,1,2,0,1,0,55.08
臺北市,中山區,正義里,693,4,552,14,566,1000,2,1,2,0,1,0,56.6
臺北市,中山區,正義里,694,4,848,22,870,1481,2,1,2,0,1,0,58.74
臺北市,中山區,正得里,695,4,626,9,635,1126,2,1,2,0,1,0,56.39
臺北市,中山區,正得里,696,4,855,16,871,1563,2,1,2,0,1,0,55.73
臺北市,中山區,民安里,697,4,997,24,1021,1546,2,1,2,0,1,0,66.04
臺北市,中山區,民安里,698,4,771,15,786,1335,2,1,2,0,1,0,58.88
臺北市,中山區,民安里,699,4,846,10,856,1297,2,1,2,0,1,0,66
臺北市,中山區,康樂里,700,4,600,13,613,1084,2,1,2,0,1,0,56.55
臺北市,中山區,康樂里,701,4,492,7,499,920,2,1,2,0,1,0,54.24
臺北市,中山區,中山里,702,4,821,13,834,1404,2,1,2,0,1,0,59.4
臺北市,中山區,中山里,703,4,772,13,785,1438,2,1,2,0,1,0,54.59
臺北市,中山區,中山里,704,4,860,17,877,1436,2,1,2,0,1,0,61.07
臺北市,中山區,聚盛里,705,4,877,11,888,1596,2,1,2,0,1,0,55.64
臺北市,中山區,聚盛里,706,4,752,24,776,1442,2,1,2,0,1,0,53.81
臺北市,中山區,集英里,707,4,1037,25,1062,1662,2,1,2,0,1,0,63.9
臺北市,中山區,集英里,708,4,987,20,1007,1598,2,1,2,0,1,0,63.02
臺北市,中山區,集英里,709,4,1066,19,1085,1808,2,1,2,0,1,0,60.01
臺北市,中山區,聚葉里,710,4,897,9,906,1542,2,1,2,0,1,0,58.75
臺北市,中山區,聚葉里,711,4,916,12,928,1544,2,1,2,0,1,0,60.1
臺北市,中山區,恒安里,712,4,876,22,898,1496,2,1,2,0,1,0,60.03
臺北市,中山區,恒安里,713,4,1063,25,1088,1764,2,1,2,0,1,0,61.68
臺北市,中山區,晴光里,714,4,747,16,763,1334,2,1,2,0,1,0,57.2
臺北市,中山區,晴光里,715,4,621,17,638,1186,2,1,2,0,1,0,53.79
臺北市,中山區,晴光里,716,4,754,18,772,1304,2,1,2,0,1,0,59.2
臺北市,中山區,圓山里,717,4,923,19,942,1616,2,1,2,0,1,0,58.29
臺北市,中山區,圓山里,718,4,837,17,854,1494,2,1,2,0,1,0,57.16
臺北市,中山區,新庄里,719,4,795,8,803,1375,2,1,2,0,1,0,58.4
臺北市,中山區,新庄里,720,4,842,24,866,1338,2,1,2,0,1,0,64.72
臺北市,中山區,新庄里,721,4,851,12,863,1322,2,1,2,0,1,0,65.28
臺北市,中山區,劍潭里,722,4,962,8,970,1457,2,1,2,0,1,0,66.58
臺北市,中山區,劍潭里,723,4,1180,15,1195,1726,2,1,2,0,1,0,69.24
臺北市,中山區,大直里,724,4,935,9,944,1420,2,1,2,0,1,0,66.48
臺北市,中山區,大直里,725,4,965,18,983,1474,2,1,2,0,1,0,66.69
臺北市,中山區,大直里,726,4,1011,18,1029,1525,2,1,2,0,1,0,67.48
臺北市,中山區,大直里,727,4,1085,15,1100,1630,2,1,2,0,1,0,67.48
臺北市,中山區,大直里,728,4,1022,15,1037,1579,2,1,2,0,1,0,65.67
臺北市,中山區,成功里,729,4,1024,16,1040,1543,2,1,2,0,1,0,67.4
臺北市,中山區,成功里,730,4,993,24,1017,1604,2,1,2,0,1,0,63.4
臺北市,中山區,永安里,731,4,1184,17,1201,1826,2,1,2,0,1,0,65.77
臺北市,中山區,永安里,732,4,1073,26,1099,1665,2,1,2,0,1,0,66.01
臺北市,中山區,永安里,733,4,1087,26,1113,1736,2,1,2,0,1,0,64.11
臺北市,中山區,永安里,734,4,1111,23,1134,1707,2,1,2,0,1,0,66.43
臺北市,中山區,大佳里,735,4,709,9,718,1046,2,1,2,0,1,0,68.64
臺北市,中山區,金泰里,736,4,1066,19,1085,1727,2,1,2,0,1,0,62.83
臺北市,中山區,金泰里,737,4,893,28,921,1470,2,1,2,0,1,0,62.65
臺北市,中山區,金泰里,738,4,932,14,946,1498,2,1,2,0,1,0,63.15
臺北市,中山區,北安里,739,4,816,10,826,1218,2,1,2,0,1,0,67.82
臺北市,中山區,北安里,740,4,674,13,687,990,2,1,2,0,1,0,69.39
臺北市,中山區,新喜里,741,4,939,18,957,1356,2,1,2,0,1,0,70.58
臺北市,中山區,新喜里,742,4,864,8,872,1365,2,1,2,0,1,0,63.88
臺北市,中山區,新喜里,743,4,792,17,809,1319,2,1,2,0,1,0,61.33
臺北市,中山區,新福里,744,4,828,21,849,1285,2,1,2,0,1,0,66.07
臺北市,中山區,新福里,745,4,881,24,905,1469,2,1,2,0,1,0,61.61
臺北市,中山區,新福里,746,4,959,14,973,1469,2,1,2,0,1,0,66.24
臺北市,中山區,松江里,747,4,1206,12,1218,1750,2,1,2,0,1,0,69.6
臺北市,中山區,松江里,748,4,1133,23,1156,1715,2,1,2,0,1,0,67.41
臺北市,中山區,松江里,749,4,1001,14,1015,1570,2,1,2,0,1,0,64.65
臺北市,中山區,新生里,750,4,827,19,846,1250,2,1,2,0,1,0,67.68
臺北市,中山區,新生里,751,4,893,21,914,1449,2,1,2,0,1,0,63.08
臺北市,中山區,新生里,752,4,990,28,1018,1452,2,1,2,0,1,0,70.11
臺北市,中山區,中庄里,753,4,923,12,935,1449,2,1,2,0,1,0,64.53
臺北市,中山區,中庄里,754,4,963,11,974,1497,2,1,2,0,1,0,65.06
臺北市,中山區,中庄里,755,4,829,20,849,1434,2,1,2,0,1,0,59.21
臺北市,中山區,行政里,756,4,699,11,710,2392,2,1,2,0,1,0,29.68
臺北市,中山區,行政里,757,4,1111,29,1140,1785,2,1,2,0,1,0,63.87
臺北市,中山區,行政里,758,4,1090,26,1116,1696,2,1,2,0,1,0,65.8
臺北市,中山區,行仁里,759,4,1093,22,1115,1780,2,1,2,0,1,0,62.64
臺北市,中山區,行仁里,760,4,1157,27,1184,1776,2,1,2,0,1,0,66.67
臺北市,中山區,行仁里,761,4,997,20,1017,1546,2,1,2,0,1,0,65.78
臺北市,中山區,行仁里,762,4,929,17,946,1462,2,1,2,0,1,0,64.71
臺北市,中山區,行孝里,763,4,1089,15,1104,1708,2,1,2,0,1,0,64.64
臺北市,中山區,行孝里,764,4,1047,14,1061,1763,2,1,2,0,1,0,60.18
臺北市,中山區,下埤里,765,4,920,15,935,1441,2,1,2,0,1,0,64.89
臺北市,中山區,下埤里,766,4,907,27,934,1460,2,1,2,0,1,0,63.97
臺北市,中山區,下埤里,767,4,868,17,885,1399,2,1,2,0,1,0,63.26
臺北市,中山區,下埤里,768,4,1058,39,1097,1703,2,1,2,0,1,0,64.42
臺北市,中山區,江寧里,769,4,989,13,1002,1528,2,1,2,0,1,0,65.58
臺北市,中山區,江寧里,770,4,807,15,822,1291,2,1,2,0,1,0,63.67
臺北市,中山區,江寧里,771,4,833,9,842,1323,2,1,2,0,1,0,63.64
臺北市,中山區,江寧里,772,4,838,18,856,1380,2,1,2,0,1,0,62.03
臺北市,中山區,江山里,773,4,962,21,983,1506,2,1,2,0,1,0,65.27
臺北市,中山區,江山里,774,4,1094,29,1123,1750,2,1,2,0,1,0,64.17
臺北市,中山區,江山里,775,4,998,17,1015,1637,2,1,2,0,1,0,62
臺北市,中山區,江山里,776,4,920,14,934,1457,2,1,2,0,1,0,64.1
臺北市,中山區,中吉里,777,4,887,16,903,1396,2,1,2,0,1,0,64.68
臺北市,中山區,中吉里,778,4,866,14,880,1402,2,1,2,0,1,0,62.77
臺北市,中山區,中吉里,779,4,864,17,881,1389,2,1,2,0,1,0,63.43
臺北市,中山區,中原里,780,4,720,14,734,1148,2,1,2,0,1,0,63.94
臺北市,中山區,中原里,781,4,911,9,920,1422,2,1,2,0,1,0,64.7
臺北市,中山區,中原里,782,4,860,10,870,1377,2,1,2,0,1,0,63.18
臺北市,中山區,興亞里,783,4,992,9,1001,1669,2,1,2,0,1,0,59.98
臺北市,中山區,興亞里,784,4,641,11,652,1027,2,1,2,0,1,0,63.49
臺北市,中山區,興亞里,785,4,888,12,900,1456,2,1,2,0,1,0,61.81
臺北市,中山區,中央里,786,4,913,11,924,1424,2,1,2,0,1,0,64.89
臺北市,中山區,中央里,787,4,971,19,990,1510,2,1,2,0,1,0,65.56
臺北市,中山區,朱馥里,788,4,984,23,1007,1629,2,1,2,0,1,0,61.82
臺北市,中山區,朱馥里,789,4,1010,21,1031,1616,2,1,2,0,1,0,63.8
臺北市,中山區,朱馥里,790,4,1001,18,1019,1640,2,1,2,0,1,0,62.13
臺北市,中山區,龍洲里,791,4,968,24,992,1470,2,1,2,0,1,0,67.48
臺北市,中山區,龍洲里,792,4,868,12,880,1249,2,1,2,0,1,0,70.46
臺北市,中山區,龍洲里,793,4,1037,18,1055,1526,2,1,2,0,1,0,69.13
臺北市,中山區,朱園里,794,4,764,11,775,1201,2,1,2,0,1,0,64.53
臺北市,中山區,朱園里,795,4,621,14,635,1113,2,1,2,0,1,0,57.05
臺北市,中山區,朱園里,796,4,840,32,872,1349,2,1,2,0,1,0,64.64
臺北市,中山區,埤頭里,797,4,883,28,911,1451,2,1,2,0,1,0,62.78
臺北市,中山區,埤頭里,798,4,1016,28,1044,1622,2,1,2,0,1,0,64.36
臺北市,中山區,朱崙里,799,4,773,16,789,1338,2,1,2,0,1,0,58.97
臺北市,中山區,朱崙里,800,4,736,18,754,1168,2,1,2,0,1,0,64.55
臺北市,中山區,力行里,801,4,972,22,994,1538,2,1,2,0,1,0,64.63
臺北市,中山區,力行里,802,4,1022,25,1047,1709,2,1,2,0,1,0,61.26
臺北市,中山區,力行里,803,4,1015,24,1039,1675,2,1,2,0,1,0,62.03
臺北市,中山區,復華里,804,4,1049,17,1066,1684,2,1,2,0,1,0,63.3
臺北市,中山區,復華里,805,4,1031,22,1053,1741,2,1,2,0,1,0,60.48
臺北市,大同區,玉泉里,806,4,915,23,938,1444,2,1,2,0,1,0,64.96
臺北市,大同區,玉泉里,807,4,705,19,724,1257,2,1,2,0,1,0,57.6
臺北市,大同區,建明里,808,4,852,17,869,1354,2,1,2,0,1,0,64.18
臺北市,大同區,建明里,809,4,887,17,904,1406,2,1,2,0,1,0,64.3
臺北市,大同區,建功里,810,4,1304,34,1338,1964,2,1,2,0,1,0,68.13
臺北市,大同區,建功里,811,4,1136,18,1154,1942,2,1,2,0,1,0,59.42
臺北市,大同區,建泰里,812,4,1024,26,1050,1619,2,1,2,0,1,0,64.85
臺北市,大同區,建泰里,813,4,789,20,809,1264,2,1,2,0,1,0,64
臺北市,大同區,永樂里,814,4,970,13,983,1606,2,1,2,0,1,0,61.21
臺北市,大同區,永樂里,815,4,836,11,847,1321,2,1,2,0,1,0,64.12
臺北市,大同區,永樂里,816,4,861,14,875,1378,2,1,2,0,1,0,63.5
臺北市,大同區,朝陽里,817,4,1014,22,1036,1683,2,1,2,0,1,0,61.56
臺北市,大同區,朝陽里,818,4,999,17,1016,1616,2,1,2,0,1,0,62.87
臺北市,大同區,星明里,819,4,875,13,888,1386,2,1,2,0,1,0,64.07
臺北市,大同區,星明里,820,4,884,16,900,1367,2,1,2,0,1,0,65.84
臺北市,大同區,星明里,821,4,910,16,926,1457,2,1,2,0,1,0,63.56
臺北市,大同區,光能里,822,4,920,26,946,1483,2,1,2,0,1,0,63.79
臺北市,大同區,光能里,823,4,800,14,814,1263,2,1,2,0,1,0,64.45
臺北市,大同區,光能里,824,4,945,23,968,1411,2,1,2,0,1,0,68.6
臺北市,大同區,大有里,825,4,858,16,874,1307,2,1,2,0,1,0,66.87
臺北市,大同區,大有里,826,4,930,22,952,1447,2,1,2,0,1,0,65.79
臺北市,大同區,大有里,827,4,902,8,910,1320,2,1,2,0,1,0,68.94
臺北市,大同區,延平里,828,4,1032,21,1053,1699,2,1,2,0,1,0,61.98
臺北市,大同區,延平里,829,4,1057,18,1075,1629,2,1,2,0,1,0,65.99
臺北市,大同區,雙連里,830,4,1037,10,1047,1510,2,1,2,0,1,0,69.34
臺北市,大同區,雙連里,831,4,1024,14,1038,1643,2,1,2,0,1,0,63.18
臺北市,大同區,雙連里,832,4,1039,9,1048,1596,2,1,2,0,1,0,65.66
臺北市,大同區,雙連里,833,4,909,5,914,1442,2,1,2,0,1,0,63.38
臺北市,大同區,雙連里,834,4,874,17,891,1461,2,1,2,0,1,0,60.99
臺北市,大同區,南芳里,835,4,984,19,1003,1633,2,1,2,0,1,0,61.42
臺北市,大同區,南芳里,836,4,1104,27,1131,1735,2,1,2,0,1,0,65.19
臺北市,大同區,民權里,837,4,1092,19,1111,1755,2,1,2,0,1,0,63.3
臺北市,大同區,民權里,838,4,1114,20,1134,1705,2,1,2,0,1,0,66.51
臺北市,大同區,民權里,839,4,981,17,998,1601,2,1,2,0,1,0,62.34
臺北市,大同區,景星里,840,4,832,14,846,1276,2,1,2,0,1,0,66.3
臺北市,大同區,景星里,841,4,749,21,770,1143,2,1,2,0,1,0,67.37
臺北市,大同區,隆和里,842,4,923,14,937,1398,2,1,2,0,1,0,67.02
臺北市,大同區,隆和里,843,4,846,11,857,1240,2,1,2,0,1,0,69.11
臺北市,大同區,蓬萊里,844,4,782,14,796,1289,2,1,2,0,1,0,61.75
臺北市,大同區,蓬萊里,845,4,767,14,781,1204,2,1,2,0,1,0,64.87
臺北市,大同區,蓬萊里,846,4,883,18,901,1364,2,1,2,0,1,0,66.06
臺北市,大同區,國順里,847,4,725,9,734,1094,2,1,2,0,1,0,67.09
臺北市,大同區,國順里,848,4,962,31,993,1484,2,1,2,0,1,0,66.91
臺北市,大同區,國慶里,849,4,1009,16,1025,1537,2,1,2,0,1,0,66.69
臺北市,大同區,國慶里,850,4,1095,18,1113,1721,2,1,2,0,1,0,64.67
臺北市,大同區,揚雅里,851,4,933,29,962,1381,2,1,2,0,1,0,69.66
臺北市,大同區,揚雅里,852,4,845,15,860,1928,2,1,2,0,1,0,44.61
臺北市,大同區,斯文里,853,4,858,17,875,1491,2,1,2,0,1,0,58.69
臺北市,大同區,斯文里,854,4,1047,23,1070,1594,2,1,2,0,1,0,67.13
臺北市,大同區,斯文里,855,4,816,15,831,1237,2,1,2,0,1,0,67.18
臺北市,大同區,鄰江里,856,4,879,15,894,1352,2,1,2,0,1,0,66.12
臺北市,大同區,鄰江里,857,4,836,18,854,1284,2,1,2,0,1,0,66.51
臺北市,大同區,鄰江里,858,4,782,19,801,1273,2,1,2,0,1,0,62.92
臺北市,大同區,鄰江里,859,4,850,16,866,1233,2,1,2,0,1,0,70.24
臺北市,大同區,至聖里,860,4,984,22,1006,1554,2,1,2,0,1,0,64.74
臺北市,大同區,至聖里,861,4,1020,12,1032,1554,2,1,2,0,1,0,66.41
臺北市,大同區,至聖里,862,4,1008,16,1024,1523,2,1,2,0,1,0,67.24
臺北市,大同區,至聖里,863,4,1066,18,1084,1631,2,1,2,0,1,0,66.46
臺北市,大同區,老師里,864,4,1013,21,1034,1649,2,1,2,0,1,0,62.7
臺北市,大同區,老師里,865,4,996,9,1005,1500,2,1,2,0,1,0,67
臺北市,大同區,老師里,866,4,1032,24,1056,1581,2,1,2,0,1,0,66.79
臺北市,大同區,重慶里,867,4,1064,20,1084,1600,2,1,2,0,1,0,67.75
臺北市,大同區,重慶里,868,4,983,18,1001,1468,2,1,2,0,1,0,68.19
臺北市,大同區,重慶里,869,4,1049,24,1073,1567,2,1,2,0,1,0,68.47
臺北市,大同區,保安里,870,4,822,21,843,1207,2,1,2,0,1,0,69.84
臺北市,大同區,保安里,871,4,796,13,809,1192,2,1,2,0,1,0,67.87
臺北市,大同區,保安里,872,4,710,13,723,1084,2,1,2,0,1,0,66.7
臺北市,中正區,水源里,873,5,797,23,820,1315,2,1,2,0,1,0,62.36
臺北市,中正區,水源里,874,5,714,17,731,1194,2,1,2,0,1,0,61.22
臺北市,中正區,富水里,875,5,781,12,793,1310,2,1,2,0,1,0,60.53
臺北市,中正區,富水里,876,5,760,19,779,1202,2,1,2,0,1,0,64.81
臺北市,中正區,文盛里,877,5,752,16,768,1128,2,1,2,0,1,0,68.09
臺北市,中正區,文盛里,878,5,666,19,685,1094,2,1,2,0,1,0,62.61
臺北市,中正區,林興里,879,5,802,18,820,1249,2,1,2,0,1,0,65.65
臺北市,中正區,林興里,880,5,819,11,830,1309,2,1,2,0,1,0,63.41
臺北市,中正區,林興里,881,5,792,22,814,1313,2,1,2,0,1,0,62
臺北市,中正區,河堤里,882,5,799,14,813,1240,2,1,2,0,1,0,65.56
臺北市,中正區,河堤里,883,5,787,15,802,1309,2,1,2,0,1,0,61.27
臺北市,中正區,河堤里,884,5,787,15,802,1287,2,1,2,0,1,0,62.32
臺北市,中正區,頂東里,885,5,952,14,966,1541,2,1,2,0,1,0,62.69
臺北市,中正區,頂東里,886,5,1065,21,1086,1613,2,1,2,0,1,0,67.33
臺北市,中正區,頂東里,887,5,1032,20,1052,1556,2,1,2,0,1,0,67.61
臺北市,中正區,網溪里,888,5,978,20,998,1551,2,1,2,0,1,0,64.35
臺北市,中正區,網溪里,889,5,898,21,919,1380,2,1,2,0,1,0,66.59
臺北市,中正區,網溪里,890,5,939,32,971,1502,2,1,2,0,1,0,64.65
臺北市,中正區,板溪里,891,5,965,21,986,1511,2,1,2,0,1,0,65.25
臺北市,中正區,板溪里,892,5,831,18,849,1301,2,1,2,0,1,0,65.26
臺北市,中正區,螢圃里,893,5,1084,16,1100,1568,2,1,2,0,1,0,70.15
臺北市,中正區,螢圃里,894,5,911,14,925,1397,2,1,2,0,1,0,66.21
臺北市,中正區,螢圃里,895,5,1013,13,1026,1534,2,1,2,0,1,0,66.88
臺北市,中正區,螢雪里,896,5,738,8,746,1147,2,1,2,0,1,0,65.04
臺北市,中正區,螢雪里,897,5,878,21,899,1307,2,1,2,0,1,0,68.78
臺北市,中正區,螢雪里,898,5,753,11,764,1193,2,1,2,0,1,0,64.04
臺北市,中正區,永功里,899,5,1159,16,1175,1759,2,1,2,0,1,0,66.8
臺北市,中正區,永功里,900,5,1013,16,1029,1588,2,1,2,0,1,0,64.8
臺北市,中正區,永功里,901,5,1024,7,1031,1639,2,1,2,0,1,0,62.9
臺北市,中正區,永昌里,902,5,979,14,993,1495,2,1,2,0,1,0,66.42
臺北市,中正區,永昌里,903,5,985,12,997,1517,2,1,2,0,1,0,65.72
臺北市,中正區,永昌里,904,5,879,9,888,1384,2,1,2,0,1,0,64.16
臺北市,中正區,龍興里,905,5,1051,15,1066,1612,2,1,2,0,1,0,66.13
臺北市,中正區,龍興里,906,5,947,22,969,1449,2,1,2,0,1,0,66.87
臺北市,中正區,忠勤里,907,5,903,10,913,1473,2,1,2,0,1,0,61.98
臺北市,中正區,忠勤里,908,5,911,14,925,1453,2,1,2,0,1,0,63.66
臺北市,中正區,忠勤里,909,5,846,14,860,1334,2,1,2,0,1,0,64.47
臺北市,中正區,忠勤里,910,5,893,11,904,1341,2,1,2,0,1,0,67.41
臺北市,中正區,廈安里,911,5,960,18,978,1468,2,1,2,0,1,0,66.62
臺北市,中正區,廈安里,912,5,940,16,956,1559,2,1,2,0,1,0,61.32
臺北市,中正區,愛國里,913,5,783,9,792,1238,2,1,2,0,1,0,63.97
臺北市,中正區,愛國里,914,5,823,9,832,1256,2,1,2,0,1,0,66.24
臺北市,中正區,南門里,915,5,747,13,760,1158,2,1,2,0,1,0,65.63
臺北市,中正區,南門里,916,5,644,4,648,1070,2,1,2,0,1,0,60.56
臺北市,中正區,龍光里,917,5,858,15,873,1388,2,1,2,0,1,0,62.9
臺北市,中正區,龍光里,918,5,845,17,862,1341,2,1,2,0,1,0,64.28
臺北市,中正區,南福里,919,5,1094,20,1114,1710,2,1,2,0,1,0,65.15
臺北市,中正區,南福里,920,5,1136,16,1152,1715,2,1,2,0,1,0,67.17
臺北市,中正區,南福里,921,5,946,27,973,1556,2,1,2,0,1,0,62.53
臺北市,中正區,南福里,922,5,1086,21,1107,1633,2,1,2,0,1,0,67.79
臺北市,中正區,龍福里,923,5,1007,16,1023,2291,2,1,2,0,1,0,44.65
臺北市,中正區,龍福里,924,5,981,14,995,1576,2,1,2,0,1,0,63.13
臺北市,中正區,龍福里,925,5,1024,18,1042,1617,2,1,2,0,1,0,64.44
臺北市,中正區,新營里,926,5,987,23,1010,1596,2,1,2,0,1,0,63.28
臺北市,中正區,新營里,927,5,993,17,1010,1610,2,1,2,0,1,0,62.73
臺北市,中正區,新營里,928,5,988,34,1022,1595,2,1,2,0,1,0,64.08
臺北市,中正區,新營里,929,5,1048,19,1067,1604,2,1,2,0,1,0,66.52
臺北市,中正區,建國里,930,5,622,5,627,1064,2,1,2,0,1,0,58.93
臺北市,中正區,光復里,931,5,768,21,789,1338,2,1,2,0,1,0,58.97
臺北市,中正區,光復里,932,5,968,26,994,1683,2,1,2,0,1,0,59.06
臺北市,中正區,黎明里,933,5,643,20,663,1245,2,1,2,0,1,0,53.25
臺北市,中正區,黎明里,934,5,699,12,711,1213,2,1,2,0,1,0,58.62
臺北市,中正區,梅花里,935,5,939,21,960,1505,2,1,2,0,1,0,63.79
臺北市,中正區,梅花里,936,5,786,21,807,1295,2,1,2,0,1,0,62.32
臺北市,中正區,幸福里,937,5,780,21,801,1298,2,1,2,0,1,0,61.71
臺北市,中正區,幸福里,938,5,758,11,769,1210,2,1,2,0,1,0,63.55
臺北市,中正區,幸福里,939,5,685,20,705,1177,2,1,2,0,1,0,59.9
臺北市,中正區,幸市里,940,5,715,18,733,1183,2,1,2,0,1,0,61.96
臺北市,中正區,幸市里,941,5,689,23,712,1157,2,1,2,0,1,0,61.54
臺北市,中正區,幸市里,942,5,707,18,725,1141,2,1,2,0,1,0,63.54
臺北市,中正區,東門里,943,5,745,16,761,1183,2,1,2,0,1,0,64.33
臺北市,中正區,東門里,944,5,697,12,709,1174,2,1,2,0,1,0,60.39
臺北市,中正區,東門里,945,5,685,19,704,1178,2,1,2,0,1,0,59.76
臺北市,中正區,文北里,946,5,774,22,796,1237,2,1,2,0,1,0,64.35
臺北市,中正區,文北里,947,5,896,18,914,1436,2,1,2,0,1,0,63.65
臺北市,中正區,文北里,948,5,848,24,872,1404,2,1,2,0,1,0,62.11
臺北市,中正區,文祥里,949,5,921,19,940,1476,2,1,2,0,1,0,63.69
臺北市,中正區,文祥里,950,5,811,20,831,1310,2,1,2,0,1,0,63.44
臺北市,中正區,文祥里,951,5,949,19,968,1464,2,1,2,0,1,0,66.12
臺北市,中正區,文祥里,952,5,909,16,925,1421,2,1,2,0,1,0,65.1
臺北市,中正區,三愛里,953,5,1072,36,1108,1699,2,1,2,0,1,0,65.21
臺北市,中正區,三愛里,954,5,1023,26,1049,1712,2,1,2,0,1,0,61.27
臺北市,中正區,三愛里,955,5,835,24,859,1391,2,1,2,0,1,0,61.75
臺北市,中正區,三愛里,956,5,901,18,919,1486,2,1,2,0,1,0,61.84
臺北市,萬華區,福星里,957,5,968,14,982,1553,2,1,2,0,1,0,63.23
臺北市,萬華區,福星里,958,5,780,13,793,1331,2,1,2,0,1,0,59.58
臺北市,萬華區,福星里,959,5,846,20,866,1456,2,1,2,0,1,0,59.48
臺北市,萬華區,萬壽里,960,5,775,19,794,1429,2,1,2,0,1,0,55.56
臺北市,萬華區,萬壽里,961,5,828,17,845,1496,2,1,2,0,1,0,56.48
臺北市,萬華區,西門里,962,5,877,14,891,1605,2,1,2,0,1,0,55.51
臺北市,萬華區,西門里,963,5,870,17,887,1531,2,1,2,0,1,0,57.94
臺北市,萬華區,新起里,964,5,849,22,871,1383,2,1,2,0,1,0,62.98
臺北市,萬華區,新起里,965,5,834,20,854,1375,2,1,2,0,1,0,62.11
臺北市,萬華區,新起里,966,5,790,17,807,1362,2,1,2,0,1,0,59.25
臺北市,萬華區,新起里,967,5,843,17,860,1349,2,1,2,0,1,0,63.75
臺北市,萬華區,菜園里,968,5,934,26,960,1587,2,1,2,0,1,0,60.49
臺北市,萬華區,菜園里,969,5,998,19,1017,1527,2,1,2,0,1,0,66.6
臺北市,萬華區,菜園里,970,5,1107,17,1124,1778,2,1,2,0,1,0,63.22
臺北市,萬華區,青山里,971,5,925,28,953,1529,2,1,2,0,1,0,62.33
臺北市,萬華區,青山里,972,5,1010,11,1021,1628,2,1,2,0,1,0,62.71
臺北市,萬華區,青山里,973,5,893,12,905,1443,2,1,2,0,1,0,62.72
臺北市,萬華區,富民里,974,5,1134,25,1159,1769,2,1,2,0,1,0,65.52
臺北市,萬華區,富民里,975,5,766,15,781,1245,2,1,2,0,1,0,62.73
臺北市,萬華區,富民里,976,5,932,9,941,1356,2,1,2,0,1,0,69.4
臺北市,萬華區,福音里,977,5,1029,16,1045,1570,2,1,2,0,1,0,66.56
臺北市,萬華區,福音里,978,5,983,9,992,1455,2,1,2,0,1,0,68.18
臺北市,萬華區,仁德里,979,5,1205,35,1240,1844,2,1,2,0,1,0,67.25
臺北市,萬華區,仁德里,980,5,1169,12,1181,1749,2,1,2,0,1,0,67.52
臺北市,萬華區,富福里,981,5,821,11,832,1547,2,1,2,0,1,0,53.78
臺北市,萬華區,富福里,982,5,801,8,809,1190,2,1,2,0,1,0,67.98
臺北市,萬華區,富福里,983,5,948,12,960,1389,2,1,2,0,1,0,69.11
臺北市,萬華區,柳鄉里,984,5,1076,17,1093,1764,2,1,2,0,1,0,61.96
臺北市,萬華區,柳鄉里,985,5,818,7,825,1220,2,1,2,0,1,0,67.62
臺北市,萬華區,柳鄉里,986,5,965,15,980,1524,2,1,2,0,1,0,64.3
臺北市,萬華區,華江里,987,5,881,17,898,1314,2,1,2,0,1,0,68.34
臺北市,萬華區,華江里,988,5,911,13,924,1397,2,1,2,0,1,0,66.14
臺北市,萬華區,華江里,989,5,851,16,867,1286,2,1,2,0,1,0,67.42
臺北市,萬華區,華江里,990,5,947,10,957,1478,2,1,2,0,1,0,64.75
臺北市,萬華區,華江里,991,5,903,24,927,1536,2,1,2,0,1,0,60.35
臺北市,萬華區,糖廍里,992,5,918,12,930,1427,2,1,2,0,1,0,65.17
臺北市,萬華區,糖廍里,993,5,918,37,955,1520,2,1,2,0,1,0,62.83
臺北市,萬華區,糖廍里,994,5,1111,17,1128,1713,2,1,2,0,1,0,65.85
臺北市,萬華區,綠堤里,995,5,873,7,880,1331,2,1,2,0,1,0,66.12
臺北市,萬華區,綠堤里,996,5,679,8,687,1190,2,1,2,0,1,0,57.73
臺北市,萬華區,綠堤里,997,5,704,16,720,1196,2,1,2,0,1,0,60.2
臺北市,萬華區,頂碩里,998,5,941,10,951,1295,2,1,2,0,1,0,73.44
臺北市,萬華區,頂碩里,999,5,833,6,839,1248,2,1,2,0,1,0,67.23
臺北市,萬華區,頂碩里,1000,5,678,6,684,1582,2,1,2,0,1,0,43.24
臺北市,萬華區,頂碩里,1001,5,1033,15,1048,1515,2,1,2,0,1,0,69.17
臺北市,萬華區,頂碩里,1002,5,906,12,918,1420,2,1,2,0,1,0,64.65
臺北市,萬華區,雙園里,1003,5,822,9,831,1255,2,1,2,0,1,0,66.22
臺北市,萬華區,雙園里,1004,5,839,14,853,1287,2,1,2,0,1,0,66.28
臺北市,萬華區,雙園里,1005,5,840,16,856,1328,2,1,2,0,1,0,64.46
臺北市,萬華區,和平里,1006,5,939,21,960,1428,2,1,2,0,1,0,67.23
臺北市,萬華區,和平里,1007,5,1063,17,1080,1566,2,1,2,0,1,0,68.97
臺北市,萬華區,和平里,1008,5,945,11,956,1441,2,1,2,0,1,0,66.34
臺北市,萬華區,和平里,1009,5,996,14,1010,1534,2,1,2,0,1,0,65.84
臺北市,萬華區,和德里,1010,5,1048,21,1069,1601,2,1,2,0,1,0,66.77
臺北市,萬華區,和德里,1011,5,770,15,785,1387,2,1,2,0,1,0,56.6
臺北市,萬華區,和德里,1012,5,815,20,835,1406,2,1,2,0,1,0,59.39
臺北市,萬華區,和德里,1013,5,934,13,947,1449,2,1,2,0,1,0,65.36
臺北市,萬華區,全德里,1014,5,1128,17,1145,1784,2,1,2,0,1,0,64.18
臺北市,萬華區,全德里,1015,5,1101,9,1110,1761,2,1,2,0,1,0,63.03
臺北市,萬華區,日善里,1016,5,962,11,973,1507,2,1,2,0,1,0,64.57
臺北市,萬華區,日善里,1017,5,1114,24,1138,1662,2,1,2,0,1,0,68.47
臺北市,萬華區,壽德里,1018,5,1143,11,1154,1638,2,1,2,0,1,0,70.45
臺北市,萬華區,壽德里,1019,5,831,12,843,1362,2,1,2,0,1,0,61.89
臺北市,萬華區,壽德里,1020,5,909,16,925,1407,2,1,2,0,1,0,65.74
臺北市,萬華區,忠德里,1021,5,897,9,906,1364,2,1,2,0,1,0,66.42
臺北市,萬華區,忠德里,1022,5,866,10,876,1265,2,1,2,0,1,0,69.25
臺北市,萬華區,忠德里,1023,5,759,7,766,1115,2,1,2,0,1,0,68.7
臺北市,萬華區,錦德里,1024,5,977,12,989,1512,2,1,2,0,1,0,65.41
臺北市,萬華區,錦德里,1025,5,1029,9,1038,1628,2,1,2,0,1,0,63.76
臺北市,萬華區,錦德里,1026,5,877,21,898,1336,2,1,2,0,1,0,67.22
臺北市,萬華區,銘德里,1027,5,920,22,942,1368,2,1,2,0,1,0,68.86
臺北市,萬華區,銘德里,1028,5,939,14,953,1405,2,1,2,0,1,0,67.83
臺北市,萬華區,銘德里,1029,5,707,6,713,1120,2,1,2,0,1,0,63.66
臺北市,萬華區,孝德里,1030,5,944,14,958,1436,2,1,2,0,1,0,66.71
臺北市,萬華區,孝德里,1031,5,854,12,866,1245,2,1,2,0,1,0,69.56
臺北市,萬華區,保德里,1032,5,856,18,874,1221,2,1,2,0,1,0,71.58
臺北市,萬華區,保德里,1033,5,827,7,834,1228,2,1,2,0,1,0,67.92
臺北市,萬華區,榮德里,1034,5,1095,16,1111,1550,2,1,2,0,1,0,71.68
臺北市,萬華區,榮德里,1035,5,1206,24,1230,1741,2,1,2,0,1,0,70.65
臺北市,萬華區,華中里,1036,5,1186,13,1199,1834,2,1,2,0,1,0,65.38
臺北市,萬華區,華中里,1037,5,1158,26,1184,1725,2,1,2,0,1,0,68.64
臺北市,萬華區,華中里,1038,5,1042,5,1047,1567,2,1,2,0,1,0,66.82
臺北市,萬華區,興德里,1039,5,806,14,820,1240,2,1,2,0,1,0,66.13
臺北市,萬華區,興德里,1040,5,886,8,894,1364,2,1,2,0,1,0,65.54
臺北市,萬華區,興德里,1041,5,787,18,805,1288,2,1,2,0,1,0,62.5
臺北市,萬華區,日祥里,1042,5,894,18,912,1425,2,1,2,0,1,0,64
臺北市,萬華區,日祥里,1043,5,1038,13,1051,1636,2,1,2,0,1,0,64.24
臺北市,萬華區,日祥里,1044,5,691,8,699,965,2,1,2,0,1,0,72.44
臺北市,萬華區,忠貞里,1045,5,931,11,942,1319,2,1,2,0,1,0,71.42
臺北市,萬華區,忠貞里,1046,5,1004,18,1022,1503,2,1,2,0,1,0,68
臺北市,萬華區,忠貞里,1047,5,965,10,975,1460,2,1,2,0,1,0,66.78
臺北市,萬華區,新忠里,1048,5,936,14,950,1529,2,1,2,0,1,0,62.13
臺北市,萬華區,新忠里,1049,5,1201,16,1217,1746,2,1,2,0,1,0,69.7
臺北市,萬華區,新和里,1050,5,1079,12,1091,1525,2,1,2,0,1,0,71.54
臺北市,萬華區,新和里,1051,5,975,17,992,1437,2,1,2,0,1,0,69.03
臺北市,萬華區,新和里,1052,5,966,13,979,1468,2,1,2,0,1,0,66.69
臺北市,萬華區,新和里,1053,5,883,7,890,1424,2,1,2,0,1,0,62.5
臺北市,萬華區,新和里,1054,5,1055,16,1071,1494,2,1,2,0,1,0,71.69
臺北市,萬華區,新安里,1055,5,922,14,936,1481,2,1,2,0,1,0,63.2
臺北市,萬華區,新安里,1056,5,888,9,897,1413,2,1,2,0,1,0,63.48
臺北市,萬華區,新安里,1057,5,714,13,727,1151,2,1,2,0,1,0,63.16
臺北市,萬華區,新安里,1058,5,922,15,937,1323,2,1,2,0,1,0,70.82
臺北市,萬華區,凌霄里,1059,5,1124,13,1137,1772,2,1,2,0,1,0,64.16
臺北市,萬華區,凌霄里,1060,5,1061,17,1078,1626,2,1,2,0,1,0,66.3
臺北市,萬華區,騰雲里,1061,5,883,10,893,1342,2,1,2,0,1,0,66.54
臺北市,萬華區,騰雲里,1062,5,842,17,859,1280,2,1,2,0,1,0,67.11
臺北市,大安區,德安里,1063,6,1079,15,1094,1666,2,1,2,0,1,0,65.67
臺北市,大安區,德安里,1064,6,912,13,925,1525,2,1,2,0,1,0,60.66
臺北市,大安區,德安里,1065,6,834,16,850,1548,2,1,2,0,1,0,54.91
臺北市,大安區,仁慈里,1066,6,821,18,839,1372,2,1,2,0,1,0,61.15
臺北市,大安區,仁慈里,1067,6,682,10,692,1098,2,1,2,0,1,0,63.02
臺北市,大安區,仁慈里,1068,6,872,17,889,1424,2,1,2,0,1,0,62.43
臺北市,大安區,和安里,1069,6,1067,11,1078,1708,2,1,2,0,1,0,63.11
臺北市,大安區,和安里,1070,6,1077,17,1094,1715,2,1,2,0,1,0,63.79
臺北市,大安區,和安里,1071,6,1142,8,1150,1736,2,1,2,0,1,0,66.24
臺北市,大安區,民炤里,1072,6,989,12,1001,1637,2,1,2,0,1,0,61.15
臺北市,大安區,民炤里,1073,6,953,14,967,1519,2,1,2,0,1,0,63.66
臺北市,大安區,民炤里,1074,6,893,13,906,1450,2,1,2,0,1,0,62.48
臺北市,大安區,民炤里,1075,6,1063,19,1082,1738,2,1,2,0,1,0,62.26
臺北市,大安區,仁愛里,1076,6,904,19,923,1638,2,1,2,0,1,0,56.35
臺北市,大安區,仁愛里,1077,6,856,23,879,1579,2,1,2,0,1,0,55.67
臺北市,大安區,仁愛里,1078,6,830,9,839,1480,2,1,2,0,1,0,56.69
臺北市,大安區,義村里,1079,6,901,6,907,1383,2,1,2,0,1,0,65.58
臺北市,大安區,義村里,1080,6,852,6,858,1352,2,1,2,0,1,0,63.46
臺北市,大安區,義村里,1081,6,848,10,858,1287,2,1,2,0,1,0,66.67
臺北市,大安區,義村里,1082,6,891,14,905,1436,2,1,2,0,1,0,63.02
臺北市,大安區,民輝里,1083,6,898,21,919,1469,2,1,2,0,1,0,62.56
臺北市,大安區,民輝里,1084,6,1036,17,1053,1651,2,1,2,0,1,0,63.78
臺北市,大安區,民輝里,1085,6,642,16,658,1097,2,1,2,0,1,0,59.98
臺北市,大安區,民輝里,1086,6,877,9,886,1412,2,1,2,0,1,0,62.75
臺北市,大安區,昌隆里,1087,6,801,19,820,1276,2,1,2,0,1,0,64.26
臺北市,大安區,昌隆里,1088,6,897,15,912,1434,2,1,2,0,1,0,63.6
臺北市,大安區,誠安里,1089,6,837,22,859,1300,2,1,2,0,1,0,66.08
臺北市,大安區,誠安里,1090,6,727,23,750,1178,2,1,2,0,1,0,63.67
臺北市,大安區,誠安里,1091,6,715,13,728,1201,2,1,2,0,1,0,60.62
臺北市,大安區,光武里,1092,6,980,15,995,1711,2,1,2,0,1,0,58.15
臺北市,大安區,光武里,1093,6,1025,24,1049,1727,2,1,2,0,1,0,60.74
臺北市,大安區,光武里,1094,6,909,13,922,1548,2,1,2,0,1,0,59.56
臺北市,大安區,光武里,1095,6,954,14,968,1592,2,1,2,0,1,0,60.8
臺北市,大安區,龍坡里,1096,6,908,11,919,1506,2,1,2,0,1,0,61.02
臺北市,大安區,龍坡里,1097,6,958,10,968,1525,2,1,2,0,1,0,63.48
臺北市,大安區,龍坡里,1098,6,1073,16,1089,1690,2,1,2,0,1,0,64.44
臺北市,大安區,龍泉里,1099,6,700,8,708,1130,2,1,2,0,1,0,62.65
臺北市,大安區,龍泉里,1100,6,781,5,786,1282,2,1,2,0,1,0,61.31
臺北市,大安區,龍泉里,1101,6,769,4,773,1218,2,1,2,0,1,0,63.46
臺北市,大安區,古風里,1102,6,1037,19,1056,1688,2,1,2,0,1,0,62.56
臺北市,大安區,古風里,1103,6,1060,11,1071,1711,2,1,2,0,1,0,62.59
臺北市,大安區,古莊里,1104,6,780,8,788,1278,2,1,2,0,1,0,61.66
臺北市,大安區,古莊里,1105,6,708,13,721,1154,2,1,2,0,1,0,62.48
臺北市,大安區,古莊里,1106,6,761,10,771,1237,2,1,2,0,1,0,62.33
臺北市,大安區,古莊里,1107,6,1031,17,1048,1636,2,1,2,0,1,0,64.06
臺北市,大安區,龍安里,1108,6,245,2,247,1768,2,1,2,0,1,0,13.97
臺北市,大安區,龍安里,1109,6,949,14,963,1465,2,1,2,0,1,0,65.73
臺北市,大安區,龍安里,1110,6,797,4,801,1233,2,1,2,0,1,0,64.96
臺北市,大安區,龍安里,1111,6,843,11,854,1336,2,1,2,0,1,0,63.92
臺北市,大安區,錦安里,1112,6,757,6,763,1247,2,1,2,0,1,0,61.19
臺北市,大安區,錦安里,1113,6,893,16,909,1372,2,1,2,0,1,0,66.25
臺北市,大安區,錦安里,1114,6,954,11,965,1540,2,1,2,0,1,0,62.66
臺北市,大安區,福住里,1115,6,829,9,838,1325,2,1,2,0,1,0,63.25
臺北市,大安區,福住里,1116,6,957,9,966,1556,2,1,2,0,1,0,62.08
臺北市,大安區,福住里,1117,6,1027,23,1050,1614,2,1,2,0,1,0,65.06
臺北市,大安區,永康里,1118,6,889,6,895,1398,2,1,2,0,1,0,64.02
臺北市,大安區,永康里,1119,6,788,11,799,1253,2,1,2,0,1,0,63.77
臺北市,大安區,光明里,1120,6,975,11,986,1467,2,1,2,0,1,0,67.21
臺北市,大安區,光明里,1121,6,943,11,954,1448,2,1,2,0,1,0,65.88
臺北市,大安區,錦泰里,1122,6,823,16,839,1270,2,1,2,0,1,0,66.06
臺北市,大安區,錦泰里,1123,6,890,11,901,1364,2,1,2,0,1,0,66.06
臺北市,大安區,錦泰里,1124,6,844,15,859,1327,2,1,2,0,1,0,64.73
臺北市,大安區,錦華里,1125,6,912,2,914,1361,2,1,2,0,1,0,67.16
臺北市,大安區,錦華里,1126,6,916,10,926,1397,2,1,2,0,1,0,66.28
臺北市,大安區,錦華里,1127,6,825,11,836,1292,2,1,2,0,1,0,64.71
臺北市,大安區,龍圖里,1128,6,762,9,771,1265,2,1,2,0,1,0,60.95
臺北市,大安區,龍圖里,1129,6,816,12,828,1310,2,1,2,0,1,0,63.21
臺北市,大安區,龍圖里,1130,6,789,10,799,1291,2,1,2,0,1,0,61.89
臺北市,大安區,龍圖里,1131,6,909,11,920,1475,2,1,2,0,1,0,62.37
臺北市,大安區,新龍里,1132,6,1069,16,1085,1731,2,1,2,0,1,0,62.68
臺北市,大安區,新龍里,1133,6,1221,14,1235,1778,2,1,2,0,1,0,69.46
臺北市,大安區,新龍里,1134,6,1096,10,1106,1741,2,1,2,0,1,0,63.53
臺北市,大安區,龍陣里,1135,6,885,11,896,1429,2,1,2,0,1,0,62.7
臺北市,大安區,龍陣里,1136,6,942,12,954,1517,2,1,2,0,1,0,62.89
臺北市,大安區,龍雲里,1137,6,789,20,809,1265,2,1,2,0,1,0,63.95
臺北市,大安區,龍雲里,1138,6,916,17,933,1405,2,1,2,0,1,0,66.41
臺北市,大安區,龍雲里,1139,6,810,23,833,1358,2,1,2,0,1,0,61.34
臺北市,大安區,龍生里,1140,6,1129,11,1140,1615,2,1,2,0,1,0,70.59
臺北市,大安區,龍生里,1141,6,1088,14,1102,1709,2,1,2,0,1,0,64.48
臺北市,大安區,龍生里,1142,6,1080,14,1094,1686,2,1,2,0,1,0,64.89
臺北市,大安區,住安里,1143,6,936,13,949,1512,2,1,2,0,1,0,62.76
臺北市,大安區,住安里,1144,6,770,16,786,1268,2,1,2,0,1,0,61.99
臺北市,大安區,住安里,1145,6,924,6,930,1541,2,1,2,0,1,0,60.35
臺北市,大安區,義安里,1146,6,964,14,978,1587,2,1,2,0,1,0,61.63
臺北市,大安區,義安里,1147,6,979,12,991,1560,2,1,2,0,1,0,63.53
臺北市,大安區,義安里,1148,6,864,9,873,1414,2,1,2,0,1,0,61.74
臺北市,大安區,通化里,1149,6,987,18,1005,1602,2,1,2,0,1,0,62.73
臺北市,大安區,通化里,1150,6,1179,21,1200,1762,2,1,2,0,1,0,68.1
臺北市,大安區,通化里,1151,6,1053,14,1067,1655,2,1,2,0,1,0,64.47
臺北市,大安區,通安里,1152,6,1047,20,1067,1680,2,1,2,0,1,0,63.51
臺北市,大安區,通安里,1153,6,928,15,943,1531,2,1,2,0,1,0,61.59
臺北市,大安區,通安里,1154,6,963,12,975,1510,2,1,2,0,1,0,64.57
臺北市,大安區,臨江里,1155,6,1110,22,1132,1655,2,1,2,0,1,0,68.4
臺北市,大安區,臨江里,1156,6,1160,17,1177,1781,2,1,2,0,1,0,66.09
臺北市,大安區,法治里,1157,6,823,15,838,1272,2,1,2,0,1,0,65.88
臺北市,大安區,法治里,1158,6,740,22,762,1149,2,1,2,0,1,0,66.32
臺北市,大安區,法治里,1159,6,768,16,784,1225,2,1,2,0,1,0,64
臺北市,大安區,全安里,1160,6,792,16,808,1281,2,1,2,0,1,0,63.08
臺北市,大安區,全安里,1161,6,746,9,755,1208,2,1,2,0,1,0,62.5
臺北市,大安區,全安里,1162,6,710,15,725,1150,2,1,2,0,1,0,63.04
臺北市,大安區,群賢里,1163,6,1109,14,1123,1774,2,1,2,0,1,0,63.3
臺北市,大安區,群賢里,1164,6,957,15,972,1521,2,1,2,0,1,0,63.91
臺北市,大安區,群賢里,1165,6,1060,13,1073,1769,2,1,2,0,1,0,60.66
臺北市,大安區,群英里,1166,6,1018,17,1035,1560,2,1,2,0,1,0,66.35
臺北市,大安區,群英里,1167,6,954,14,968,1395,2,1,2,0,1,0,69.39
臺北市,大安區,群英里,1168,6,911,8,919,1361,2,1,2,0,1,0,67.52
臺北市,大安區,群英里,1169,6,1073,12,1085,1615,2,1,2,0,1,0,67.18
臺北市,大安區,虎嘯里,1170,6,869,11,880,1336,2,1,2,0,1,0,65.87
臺北市,大安區,虎嘯里,1171,6,952,18,970,1581,2,1,2,0,1,0,61.35
臺北市,大安區,臥龍里,1172,6,1118,21,1139,1780,2,1,2,0,1,0,63.99
臺北市,大安區,龍淵里,1173,6,906,17,923,1427,2,1,2,0,1,0,64.68
臺北市,大安區,龍淵里,1174,6,1010,12,1022,1548,2,1,2,0,1,0,66.02
臺北市,大安區,龍淵里,1175,6,900,6,906,1376,2,1,2,0,1,0,65.84
臺北市,大安區,龍淵里,1176,6,843,10,853,1280,2,1,2,0,1,0,66.64
臺北市,大安區,龍淵里,1177,6,912,14,926,1401,2,1,2,0,1,0,66.1
臺北市,大安區,龍門里,1178,6,1026,11,1037,1664,2,1,2,0,1,0,62.32
臺北市,大安區,龍門里,1179,6,1044,11,1055,1661,2,1,2,0,1,0,63.52
臺北市,大安區,大學里,1180,6,986,17,1003,1608,2,1,2,0,1,0,62.38
臺北市,大安區,大學里,1181,6,1051,11,1062,1660,2,1,2,0,1,0,63.98
臺北市,大安區,大學里,1182,6,974,10,984,1642,2,1,2,0,1,0,59.93
臺北市,大安區,大學里,1183,6,1020,16,1036,1627,2,1,2,0,1,0,63.68
臺北市,大安區,芳和里,1184,6,1196,9,1205,1775,2,1,2,0,1,0,67.89
臺北市,大安區,芳和里,1185,6,1032,21,1053,1610,2,1,2,0,1,0,65.4
臺北市,大安區,芳和里,1186,6,1079,21,1100,1746,2,1,2,0,1,0,63
臺北市,大安區,黎元里,1187,6,981,17,998,1559,2,1,2,0,1,0,64.02
臺北市,大安區,黎元里,1188,6,1033,5,1038,1563,2,1,2,0,1,0,66.41
臺北市,大安區,黎元里,1189,6,908,22,930,1423,2,1,2,0,1,0,65.35
臺北市,大安區,黎孝里,1190,6,1004,19,1023,1502,2,1,2,0,1,0,68.11
臺北市,大安區,黎孝里,1191,6,958,12,970,1457,2,1,2,0,1,0,66.58
臺北市,大安區,黎孝里,1192,6,1092,15,1107,1594,2,1,2,0,1,0,69.45
臺北市,大安區,黎孝里,1193,6,1136,11,1147,1694,2,1,2,0,1,0,67.71
臺北市,大安區,黎和里,1194,6,719,13,732,1168,2,1,2,0,1,0,62.67
臺北市,大安區,黎和里,1195,6,869,11,880,1305,2,1,2,0,1,0,67.43
臺北市,大安區,黎和里,1196,6,810,6,816,1236,2,1,2,0,1,0,66.02
臺北市,大安區,建安里,1197,6,930,12,942,1527,2,1,2,0,1,0,61.69
臺北市,大安區,建安里,1198,6,771,13,784,1429,2,1,2,0,1,0,54.86
臺北市,大安區,建安里,1199,6,753,12,765,1185,2,1,2,0,1,0,64.56
臺北市,大安區,建倫里,1200,6,961,15,976,1698,2,1,2,0,1,0,57.48
臺北市,大安區,建倫里,1201,6,1040,12,1052,1735,2,1,2,0,1,0,60.63
臺北市,大安區,建倫里,1202,6,896,16,912,1550,2,1,2,0,1,0,58.84
臺北市,大安區,敦安里,1203,6,1006,12,1018,1678,2,1,2,0,1,0,60.67
臺北市,大安區,敦安里,1204,6,958,21,979,1578,2,1,2,0,1,0,62.04
臺北市,大安區,敦安里,1205,6,1018,24,1042,1733,2,1,2,0,1,0,60.13
臺北市,大安區,正聲里,1206,6,702,17,719,1179,2,1,2,0,1,0,60.98
臺北市,大安區,正聲里,1207,6,817,10,827,1308,2,1,2,0,1,0,63.23
臺北市,大安區,正聲里,1208,6,906,23,929,1575,2,1,2,0,1,0,58.98
臺北市,大安區,敦煌里,1209,6,1058,17,1075,1655,2,1,2,0,1,0,64.95
臺北市,大安區,敦煌里,1210,6,977,20,997,1612,2,1,2,0,1,0,61.85
臺北市,大安區,敦煌里,1211,6,965,12,977,1567,2,1,2,0,1,0,62.35
臺北市,大安區,華聲里,1212,6,1185,20,1205,1931,2,1,2,0,1,0,62.4
臺北市,大安區,華聲里,1213,6,1032,20,1052,1637,2,1,2,0,1,0,64.26
臺北市,大安區,車層里,1214,6,990,15,1005,1763,2,1,2,0,1,0,57.01
臺北市,大安區,車層里,1215,6,1107,16,1123,1825,2,1,2,0,1,0,61.53
臺北市,大安區,車層里,1216,6,1065,13,1078,1747,2,1,2,0,1,0,61.71
臺北市,大安區,光信里,1217,6,1052,16,1068,1609,2,1,2,0,1,0,66.38
臺北市,大安區,光信里,1218,6,1069,15,1084,1669,2,1,2,0,1,0,64.95
臺北市,大安區,光信里,1219,6,948,16,964,1526,2,1,2,0,1,0,63.17
臺北市,大安區,光信里,1220,6,955,14,969,1561,2,1,2,0,1,0,62.08
臺北市,大安區,學府里,1221,6,698,7,705,1033,2,1,2,0,1,0,68.25
臺北市,大安區,學府里,1222,6,456,10,466,727,2,1,2,0,1,0,64.1
臺北市,大安區,學府里,1223,6,758,11,769,1243,2,1,2,0,1,0,61.87
臺北市,文山區,景行里,1224,6,814,9,823,1362,2,1,2,0,1,0,60.43
臺北市,文山區,景行里,1225,6,940,12,952,1442,2,1,2,0,1,0,66.02
臺北市,文山區,景行里,1226,6,1042,16,1058,1647,2,1,2,0,1,0,64.24
臺北市,文山區,景東里,1227,6,900,16,916,1473,2,1,2,0,1,0,62.19
臺北市,文山區,景東里,1228,6,829,14,843,1322,2,1,2,0,1,0,63.77
臺北市,文山區,景東里,1229,6,808,5,813,1235,2,1,2,0,1,0,65.83
臺北市,文山區,景東里,1230,6,905,12,917,1377,2,1,2,0,1,0,66.59
臺北市,文山區,景美里,1231,6,902,12,914,1385,2,1,2,0,1,0,65.99
臺北市,文山區,景美里,1232,6,788,8,796,1225,2,1,2,0,1,0,64.98
臺北市,文山區,景美里,1233,6,720,10,730,1111,2,1,2,0,1,0,65.71
臺北市,文山區,景慶里,1234,6,1083,15,1098,1704,2,1,2,0,1,0,64.44
臺北市,文山區,景慶里,1235,6,1076,13,1089,1675,2,1,2,0,1,0,65.01
臺北市,文山區,景慶里,1236,6,1166,16,1182,1740,2,1,2,0,1,0,67.93
臺北市,文山區,景仁里,1237,6,964,9,973,1425,2,1,2,0,1,0,68.28
臺北市,文山區,景仁里,1238,6,880,13,893,1299,2,1,2,0,1,0,68.75
臺北市,文山區,景仁里,1239,6,562,5,567,892,2,1,2,0,1,0,63.57
臺北市,文山區,景華里,1240,6,1036,13,1049,1637,2,1,2,0,1,0,64.08
臺北市,文山區,景華里,1241,6,989,14,1003,1527,2,1,2,0,1,0,65.68
臺北市,文山區,景華里,1242,6,1009,9,1018,1505,2,1,2,0,1,0,67.64
臺北市,文山區,萬有里,1243,6,850,6,856,1238,2,1,2,0,1,0,69.14
臺北市,文山區,萬有里,1244,6,776,5,781,1227,2,1,2,0,1,0,63.65
臺北市,文山區,萬有里,1245,6,888,12,900,1322,2,1,2,0,1,0,68.08
臺北市,文山區,萬祥里,1246,6,838,13,851,1286,2,1,2,0,1,0,66.17
臺北市,文山區,萬祥里,1247,6,738,5,743,1100,2,1,2,0,1,0,67.55
臺北市,文山區,萬祥里,1248,6,864,22,886,1287,2,1,2,0,1,0,68.84
臺北市,文山區,萬隆里,1249,6,1005,14,1019,1460,2,1,2,0,1,0,69.79
臺北市,文山區,萬隆里,1250,6,1053,13,1066,1574,2,1,2,0,1,0,67.73
臺北市,文山區,萬隆里,1251,6,984,11,995,1475,2,1,2,0,1,0,67.46
臺北市,文山區,萬隆里,1252,6,825,8,833,1289,2,1,2,0,1,0,64.62
臺北市,文山區,萬年里,1253,6,1002,11,1013,1567,2,1,2,0,1,0,64.65
臺北市,文山區,萬年里,1254,6,886,12,898,1361,2,1,2,0,1,0,65.98
臺北市,文山區,萬年里,1255,6,889,13,902,1377,2,1,2,0,1,0,65.5
臺北市,文山區,萬和里,1256,6,826,3,829,1259,2,1,2,0,1,0,65.85
臺北市,文山區,萬和里,1257,6,886,6,892,1317,2,1,2,0,1,0,67.73
臺北市,文山區,萬盛里,1258,6,771,12,783,1270,2,1,2,0,1,0,61.65
臺北市,文山區,萬盛里,1259,6,740,8,748,1175,2,1,2,0,1,0,63.66
臺北市,文山區,萬盛里,1260,6,882,9,891,1343,2,1,2,0,1,0,66.34
臺北市,文山區,興豐里,1261,6,925,10,935,1424,2,1,2,0,1,0,65.66
臺北市,文山區,興豐里,1262,6,943,8,951,1425,2,1,2,0,1,0,66.74
臺北市,文山區,興豐里,1263,6,956,6,962,1444,2,1,2,0,1,0,66.62
臺北市,文山區,興豐里,1264,6,992,19,1011,1540,2,1,2,0,1,0,65.65
臺北市,文山區,興豐里,1265,6,882,11,893,1292,2,1,2,0,1,0,69.12
臺北市,文山區,興光里,1266,6,833,12,845,1316,2,1,2,0,1,0,64.21
臺北市,文山區,興光里,1267,6,798,5,803,1224,2,1,2,0,1,0,65.6
臺北市,文山區,興家里,1268,6,937,9,946,1447,2,1,2,0,1,0,65.38
臺北市,文山區,興家里,1269,6,1194,16,1210,1737,2,1,2,0,1,0,69.66
臺北市,文山區,興家里,1270,6,1078,8,1086,1601,2,1,2,0,1,0,67.83
臺北市,文山區,興家里,1271,6,703,10,713,1119,2,1,2,0,1,0,63.72
臺北市,文山區,興得里,1272,6,971,13,984,1544,2,1,2,0,1,0,63.73
臺北市,文山區,興得里,1273,6,1090,10,1100,1795,2,1,2,0,1,0,61.28
臺北市,文山區,興得里,1274,6,990,11,1001,1655,2,1,2,0,1,0,60.48
臺北市,文山區,興業里,1275,6,894,11,905,1765,2,1,2,0,1,0,51.27
臺北市,文山區,興業里,1276,6,930,12,942,1475,2,1,2,0,1,0,63.86
臺北市,文山區,興業里,1277,6,1035,12,1047,1620,2,1,2,0,1,0,64.63
臺北市,文山區,興安里,1278,6,861,7,868,1298,2,1,2,0,1,0,66.87
臺北市,文山區,興安里,1279,6,831,11,842,1285,2,1,2,0,1,0,65.53
臺北市,文山區,興安里,1280,6,872,6,878,1244,2,1,2,0,1,0,70.58
臺北市,文山區,興安里,1281,6,774,10,784,1245,2,1,2,0,1,0,62.97
臺北市,文山區,興福里,1282,6,1092,5,1097,1655,2,1,2,0,1,0,66.28
臺北市,文山區,興福里,1283,6,987,12,999,1507,2,1,2,0,1,0,66.29
臺北市,文山區,興福里,1284,6,1006,18,1024,1482,2,1,2,0,1,0,69.1
臺北市,文山區,興旺里,1285,6,917,11,928,1450,2,1,2,0,1,0,64
臺北市,文山區,興旺里,1286,6,925,11,936,1375,2,1,2,0,1,0,68.07
臺北市,文山區,興旺里,1287,6,833,17,850,1345,2,1,2,0,1,0,63.2
臺北市,文山區,興旺里,1288,6,952,17,969,1463,2,1,2,0,1,0,66.23
臺北市,文山區,興泰里,1289,6,1030,16,1046,1585,2,1,2,0,1,0,65.99
臺北市,文山區,興泰里,1290,6,918,8,926,1427,2,1,2,0,1,0,64.89
臺北市,文山區,興昌里,1291,6,863,7,870,1339,2,1,2,0,1,0,64.97
臺北市,文山區,興昌里,1292,6,813,9,822,1300,2,1,2,0,1,0,63.23
臺北市,文山區,興昌里,1293,6,888,12,900,1408,2,1,2,0,1,0,63.92
臺北市,文山區,興昌里,1294,6,751,10,761,1241,2,1,2,0,1,0,61.32
臺北市,文山區,試院里,1295,6,1102,18,1120,1670,2,1,2,0,1,0,67.07
臺北市,文山區,試院里,1296,6,1169,16,1185,1755,2,1,2,0,1,0,67.52
臺北市,文山區,試院里,1297,6,1200,16,1216,1789,2,1,2,0,1,0,67.97
臺北市,文山區,華興里,1298,6,992,10,1002,1558,2,1,2,0,1,0,64.31
臺北市,文山區,華興里,1299,6,995,15,1010,1564,2,1,2,0,1,0,64.58
臺北市,文山區,華興里,1300,6,1000,16,1016,1546,2,1,2,0,1,0,65.72
臺北市,文山區,華興里,1301,6,942,10,952,1436,2,1,2,0,1,0,66.3
臺北市,文山區,明義里,1302,6,815,8,823,1313,2,1,2,0,1,0,62.68
臺北市,文山區,明義里,1303,6,674,19,693,1233,2,1,2,0,1,0,56.2
臺北市,文山區,明義里,1304,6,759,14,773,1333,2,1,2,0,1,0,57.99
臺北市,文山區,明興里,1305,6,945,11,956,1439,2,1,2,0,1,0,66.44
臺北市,文山區,明興里,1306,6,781,6,787,1296,2,1,2,0,1,0,60.73
臺北市,文山區,明興里,1307,6,976,9,985,1490,2,1,2,0,1,0,66.11
臺北市,文山區,明興里,1308,6,903,12,915,1381,2,1,2,0,1,0,66.26
臺北市,文山區,木柵里,1309,6,985,11,996,1527,2,1,2,0,1,0,65.23
臺北市,文山區,木柵里,1310,6,1009,12,1021,1558,2,1,2,0,1,0,65.53
臺北市,文山區,木柵里,1311,6,1072,8,1080,1469,2,1,2,0,1,0,73.52
臺北市,文山區,木柵里,1312,6,990,10,1000,1485,2,1,2,0,1,0,67.34
臺北市,文山區,木新里,1313,6,839,15,854,1388,2,1,2,0,1,0,61.53
臺北市,文山區,木新里,1314,6,908,12,920,1449,2,1,2,0,1,0,63.49
臺北市,文山區,木新里,1315,6,902,21,923,1428,2,1,2,0,1,0,64.64
臺北市,文山區,木新里,1316,6,937,16,953,1403,2,1,2,0,1,0,67.93
臺北市,文山區,木新里,1317,6,943,10,953,1477,2,1,2,0,1,0,64.52
臺北市,文山區,順興里,1318,6,938,10,948,1403,2,1,2,0,1,0,67.57
臺北市,文山區,順興里,1319,6,927,20,947,1390,2,1,2,0,1,0,68.13
臺北市,文山區,順興里,1320,6,957,17,974,1463,2,1,2,0,1,0,66.58
臺北市,文山區,順興里,1321,6,903,12,915,1370,2,1,2,0,1,0,66.79
臺北市,文山區,忠順里,1322,6,1065,15,1080,1571,2,1,2,0,1,0,68.75
臺北市,文山區,忠順里,1323,6,1007,10,1017,1527,2,1,2,0,1,0,66.6
臺北市,文山區,樟林里,1324,6,1049,7,1056,1600,2,1,2,0,1,0,66
臺北市,文山區,樟林里,1325,6,1148,20,1168,1762,2,1,2,0,1,0,66.29
臺北市,文山區,樟林里,1326,6,1030,12,1042,1617,2,1,2,0,1,0,64.44
臺北市,文山區,樟林里,1327,6,1096,10,1106,1678,2,1,2,0,1,0,65.91
臺北市,文山區,樟新里,1328,6,1041,24,1065,1564,2,1,2,0,1,0,68.09
臺北市,文山區,樟新里,1329,6,1058,8,1066,1657,2,1,2,0,1,0,64.33
臺北市,文山區,樟新里,1330,6,943,13,956,1503,2,1,2,0,1,0,63.61
臺北市,文山區,樟新里,1331,6,1012,23,1035,1594,2,1,2,0,1,0,64.93
臺北市,文山區,樟新里,1332,6,919,12,931,1457,2,1,2,0,1,0,63.9
臺北市,文山區,樟新里,1333,6,899,23,922,1389,2,1,2,0,1,0,66.38
臺北市,文山區,樟腳里,1334,6,976,12,988,1531,2,1,2,0,1,0,64.53
臺北市,文山區,樟腳里,1335,6,958,32,990,1495,2,1,2,0,1,0,66.22
臺北市,文山區,樟腳里,1336,6,989,17,1006,1363,2,1,2,0,1,0,73.81
臺北市,文山區,樟腳里,1337,6,933,15,948,1404,2,1,2,0,1,0,67.52
臺北市,文山區,樟腳里,1338,6,1000,17,1017,1502,2,1,2,0,1,0,67.71
臺北市,文山區,萬芳里,1339,6,833,5,838,1315,2,1,2,0,1,0,63.73
臺北市,文山區,萬芳里,1340,6,978,5,983,1499,2,1,2,0,1,0,65.58
臺北市,文山區,萬芳里,1341,6,1032,11,1043,1609,2,1,2,0,1,0,64.82
臺北市,文山區,萬芳里,1342,6,1060,10,1070,1648,2,1,2,0,1,0,64.93
臺北市,文山區,萬美里,1343,6,879,10,889,1364,2,1,2,0,1,0,65.18
臺北市,文山區,萬美里,1344,6,872,17,889,1472,2,1,2,0,1,0,60.39
臺北市,文山區,萬美里,1345,6,788,6,794,1303,2,1,2,0,1,0,60.94
臺北市,文山區,萬美里,1346,6,843,8,851,1299,2,1,2,0,1,0,65.51
臺北市,文山區,博嘉里,1347,6,834,16,850,1278,2,1,2,0,1,0,66.51
臺北市,文山區,博嘉里,1348,6,1025,12,1037,1556,2,1,2,0,1,0,66.65
臺北市,文山區,博嘉里,1349,6,812,12,824,1253,2,1,2,0,1,0,65.76
臺北市,文山區,萬興里,1350,6,965,8,973,1466,2,1,2,0,1,0,66.37
臺北市,文山區,萬興里,1351,6,991,11,1002,1474,2,1,2,0,1,0,67.98
臺北市,文山區,萬興里,1352,6,1034,10,1044,1642,2,1,2,0,1,0,63.58
臺北市,文山區,萬興里,1353,6,1013,15,1028,1549,2,1,2,0,1,0,66.37
臺北市,文山區,萬興里,1354,6,1090,11,1101,1715,2,1,2,0,1,0,64.2
臺北市,文山區,萬興里,1355,6,1091,11,1102,1700,2,1,2,0,1,0,64.82
臺北市,文山區,指南里,1356,6,1002,13,1015,1597,2,1,2,0,1,0,63.56
臺北市,文山區,指南里,1357,6,493,10,503,755,2,1,2,0,1,0,66.62
臺北市,文山區,老泉里,1358,6,450,4,454,705,2,1,2,0,1,0,64.4
高雄市,鹽埕區,藍橋里,1,1,936,12,948,1290,2,1,2,0,1,0,73.49
高雄市,鹽埕區,慈愛里,2,1,333,9,342,439,2,1,2,0,1,0,77.9
高雄市,鹽埕區,博愛里,3,1,539,13,552,720,2,1,2,0,1,0,76.67
高雄市,鹽埕區,壽星里,4,1,946,15,961,1357,2,1,2,0,1,0,70.82
高雄市,鹽埕區,中山里,5,1,856,10,866,1170,2,1,2,0,1,0,74.02
高雄市,鹽埕區,教仁里,6,1,692,9,701,972,2,1,2,0,1,0,72.12
高雄市,鹽埕區,教仁里,7,1,908,8,916,1207,2,1,2,0,1,0,75.89
高雄市,鹽埕區,新樂里,8,1,659,14,673,910,2,1,2,0,1,0,73.96
高雄市,鹽埕區,中原里,9,1,540,5,545,730,2,1,2,0,1,0,74.66
高雄市,鹽埕區,光明里,10,1,809,11,820,1262,2,1,2,0,1,0,64.98
高雄市,鹽埕區,育仁里,11,1,573,8,581,822,2,1,2,0,1,0,70.68
高雄市,鹽埕區,河濱里,12,1,678,10,688,988,2,1,2,0,1,0,69.64
高雄市,鹽埕區,河濱里,13,1,581,8,589,834,2,1,2,0,1,0,70.62
高雄市,鹽埕區,沙地里,14,1,720,6,726,1042,2,1,2,0,1,0,69.67
高雄市,鹽埕區,南端里,15,1,813,15,828,1136,2,1,2,0,1,0,72.89
高雄市,鹽埕區,港都里,16,1,763,8,771,1149,2,1,2,0,1,0,67.1
高雄市,鹽埕區,江西里,17,1,863,11,874,1189,2,1,2,0,1,0,73.51
高雄市,鹽埕區,新豐里,18,1,444,11,455,563,2,1,2,0,1,0,80.82
高雄市,鹽埕區,府北里,19,1,1185,24,1209,1799,2,1,2,0,1,0,67.2
高雄市,鹽埕區,陸橋里,20,1,889,16,905,1266,2,1,2,0,1,0,71.48
高雄市,鹽埕區,瀨南里,21,1,496,9,505,690,2,1,2,0,1,0,73.19
高雄市,鹽埕區,新化里,22,1,544,6,550,690,2,1,2,0,1,0,79.71
高雄市,鹽埕區,江南里,23,1,596,12,608,874,2,1,2,0,1,0,69.57
高雄市,鼓山區,鼓峰里,24,1,705,7,712,1012,2,1,2,0,1,0,70.36
高雄市,鼓山區,鼓峰里,25,1,707,7,714,977,2,1,2,0,1,0,73.08
高雄市,鼓山區,雄峰里,26,1,684,17,701,987,2,1,2,0,1,0,71.02
高雄市,鼓山區,雄峰里,27,1,759,12,771,1101,2,1,2,0,1,0,70.03
高雄市,鼓山區,前峰里,28,1,1182,12,1194,1625,2,1,2,0,1,0,73.48
高雄市,鼓山區,前峰里,29,1,1055,18,1073,1418,2,1,2,0,1,0,75.67
高雄市,鼓山區,前峰里,30,1,871,11,882,1195,2,1,2,0,1,0,73.81
高雄市,鼓山區,光榮里,31,1,865,10,875,1174,2,1,2,0,1,0,74.53
高雄市,鼓山區,光榮里,32,1,917,18,935,1320,2,1,2,0,1,0,70.83
高雄市,鼓山區,光榮里,33,1,970,7,977,1282,2,1,2,0,1,0,76.21
高雄市,鼓山區,民族里,34,1,1088,19,1107,1433,2,1,2,0,1,0,77.25
高雄市,鼓山區,內惟里,35,1,861,8,869,1185,2,1,2,0,1,0,73.33
高雄市,鼓山區,建國里,36,1,961,12,973,1284,2,1,2,0,1,0,75.78
高雄市,鼓山區,建國里,37,1,669,8,677,900,2,1,2,0,1,0,75.22
高雄市,鼓山區,忠正里,38,1,965,10,975,1373,2,1,2,0,1,0,71.01
高雄市,鼓山區,忠正里,39,1,946,15,961,1301,2,1,2,0,1,0,73.87
高雄市,鼓山區,忠正里,40,1,873,11,884,1204,2,1,2,0,1,0,73.42
高雄市,鼓山區,自強里,41,1,593,6,599,802,2,1,2,0,1,0,74.69
高雄市,鼓山區,龍井里,42,1,966,17,983,1440,2,1,2,0,1,0,68.26
高雄市,鼓山區,正德里,43,1,1344,27,1371,1869,2,1,2,0,1,0,73.35
高雄市,鼓山區,平和里,44,1,1176,16,1192,1680,2,1,2,0,1,0,70.95
高雄市,鼓山區,平和里,45,1,1135,20,1155,1607,2,1,2,0,1,0,71.87
高雄市,鼓山區,民強里,46,1,1000,22,1022,1352,2,1,2,0,1,0,75.59
高雄市,鼓山區,民強里,47,1,988,6,994,1379,2,1,2,0,1,0,72.08
高雄市,鼓山區,厚生里,48,1,832,16,848,1235,2,1,2,0,1,0,68.66
高雄市,鼓山區,厚生里,49,1,1076,16,1092,1486,2,1,2,0,1,0,73.49
高雄市,鼓山區,龍子里,50,1,1123,33,1156,1716,2,1,2,0,1,0,67.37
高雄市,鼓山區,龍子里,51,1,1349,35,1384,2175,2,1,2,0,1,0,63.63
高雄市,鼓山區,龍子里,52,1,1114,26,1140,1603,2,1,2,0,1,0,71.12
高雄市,鼓山區,龍子里,53,1,1191,22,1213,1784,2,1,2,0,1,0,67.99
高雄市,鼓山區,龍水里,54,1,1578,44,1622,2603,2,1,2,0,1,0,62.31
高雄市,鼓山區,龍水里,55,1,1988,48,2036,3150,2,1,2,0,1,0,64.63
高雄市,鼓山區,明誠里,56,1,1245,21,1266,1786,2,1,2,0,1,0,70.88
高雄市,鼓山區,明誠里,57,1,1158,20,1178,1723,2,1,2,0,1,0,68.37
高雄市,鼓山區,明誠里,58,1,1037,21,1058,1709,2,1,2,0,1,0,61.91
高雄市,鼓山區,明誠里,59,1,1095,28,1123,1689,2,1,2,0,1,0,66.49
高雄市,鼓山區,明誠里,60,1,1175,19,1194,1732,2,1,2,0,1,0,68.94
高雄市,鼓山區,明誠里,61,1,1121,28,1149,1784,2,1,2,0,1,0,64.41
高雄市,鼓山區,明誠里,62,1,1127,30,1157,1747,2,1,2,0,1,0,66.23
高雄市,鼓山區,華豐里,63,1,1256,27,1283,1801,2,1,2,0,1,0,71.24
高雄市,鼓山區,華豐里,64,1,1273,30,1303,1825,2,1,2,0,1,0,71.4
高雄市,鼓山區,裕興里,65,1,939,10,949,1380,2,1,2,0,1,0,68.77
高雄市,鼓山區,裕興里,66,1,1024,30,1054,1456,2,1,2,0,1,0,72.39
高雄市,鼓山區,裕豐里,67,1,725,12,737,1057,2,1,2,0,1,0,69.73
高雄市,鼓山區,裕豐里,68,1,815,11,826,1288,2,1,2,0,1,0,64.13
高雄市,鼓山區,鼓岩里,69,1,1030,15,1045,1446,2,1,2,0,1,0,72.27
高雄市,鼓山區,樹德里,70,1,939,6,945,1194,2,1,2,0,1,0,79.15
高雄市,鼓山區,寶樹里,71,1,734,13,747,1295,2,1,2,0,1,0,57.68
高雄市,鼓山區,興宗里,72,1,1023,18,1041,1454,2,1,2,0,1,0,71.6
高雄市,鼓山區,光化里,73,1,1005,13,1018,1409,2,1,2,0,1,0,72.25
高雄市,鼓山區,山下里,74,1,893,11,904,1249,2,1,2,0,1,0,72.38
高雄市,鼓山區,河邊里,75,1,1110,23,1133,1510,2,1,2,0,1,0,75.03
高雄市,鼓山區,綠川里,76,1,1043,16,1059,1527,2,1,2,0,1,0,69.35
高雄市,鼓山區,登山里,77,1,502,9,511,754,2,1,2,0,1,0,67.77
高雄市,鼓山區,峰南里,78,1,666,14,680,1013,2,1,2,0,1,0,67.13
高雄市,鼓山區,麗興里,79,1,751,16,767,1100,2,1,2,0,1,0,69.73
高雄市,鼓山區,新民里,80,1,755,16,771,1137,2,1,2,0,1,0,67.81
高雄市,鼓山區,延平里,81,1,646,8,654,906,2,1,2,0,1,0,72.19
高雄市,鼓山區,維生里,82,1,960,8,968,1403,2,1,2,0,1,0,69
高雄市,鼓山區,惠安里,83,1,875,18,893,1372,2,1,2,0,1,0,65.09
高雄市,鼓山區,壽山里,84,1,1029,11,1040,1540,2,1,2,0,1,0,67.53
高雄市,鼓山區,哨船頭里,85,1,780,11,791,1151,2,1,2,0,1,0,68.72
高雄市,鼓山區,桃源里,86,1,455,6,461,633,2,1,2,0,1,0,72.83
高雄市,旗津區,旗下里,87,1,861,5,866,1224,2,1,2,0,1,0,70.75
高雄市,旗津區,永安里,88,1,753,8,761,1098,2,1,2,0,1,0,69.31
高雄市,旗津區,振興里,89,1,1171,16,1187,1720,2,1,2,0,1,0,69.01
高雄市,旗津區,慈愛里,90,1,831,9,840,1140,2,1,2,0,1,0,73.68
高雄市,旗津區,慈愛里,91,1,709,10,719,1020,2,1,2,0,1,0,70.49
高雄市,旗津區,復興里,92,1,1006,10,1016,1435,2,1,2,0,1,0,70.8
高雄市,旗津區,復興里,93,1,916,11,927,1350,2,1,2,0,1,0,68.67
高雄市,旗津區,中華里,94,1,917,11,928,1275,2,1,2,0,1,0,72.78
高雄市,旗津區,實踐里,95,1,865,12,877,1309,2,1,2,0,1,0,67
高雄市,旗津區,北汕里,96,1,855,15,870,1219,2,1,2,0,1,0,71.37
高雄市,旗津區,北汕里,97,1,883,9,892,1256,2,1,2,0,1,0,71.02
高雄市,旗津區,南汕里,98,1,1291,8,1299,1771,2,1,2,0,1,0,73.35
高雄市,旗津區,上竹里,99,1,604,6,610,882,2,1,2,0,1,0,69.16
高雄市,旗津區,上竹里,100,1,1155,13,1168,1729,2,1,2,0,1,0,67.55
高雄市,旗津區,中洲里,101,1,1172,22,1194,1697,2,1,2,0,1,0,70.36
高雄市,旗津區,安順里,102,1,603,5,608,896,2,1,2,0,1,0,67.86
高雄市,旗津區,中興里,103,1,842,20,862,1128,2,1,2,0,1,0,76.42
高雄市,旗津區,中興里,104,1,848,13,861,1188,2,1,2,0,1,0,72.47
高雄市,左營區,進學里,105,2,1094,12,1106,2048,2,1,2,0,1,0,54
高雄市,左營區,尾西里,106,2,830,13,843,1150,2,1,2,0,1,0,73.3
高雄市,左營區,頂北里,107,2,427,9,436,587,2,1,2,0,1,0,74.28
高雄市,左營區,中北里,108,2,527,10,537,690,2,1,2,0,1,0,77.83
高雄市,左營區,中南里,109,2,396,8,404,570,2,1,2,0,1,0,70.88
高雄市,左營區,廟東里,110,2,608,11,619,862,2,1,2,0,1,0,71.81
高雄市,左營區,廟北里,111,2,735,6,741,992,2,1,2,0,1,0,74.7
高雄市,左營區,尾南里,112,2,552,6,558,788,2,1,2,0,1,0,70.81
高雄市,左營區,尾北里,113,2,955,23,978,1335,2,1,2,0,1,0,73.26
高雄市,左營區,尾北里,114,2,1068,9,1077,1523,2,1,2,0,1,0,70.72
高雄市,左營區,屏山里,115,2,1035,22,1057,1437,2,1,2,0,1,0,73.56
高雄市,左營區,祥和里,116,2,404,10,414,540,2,1,2,0,1,0,76.67
高雄市,左營區,永清里,117,2,654,16,670,950,2,1,2,0,1,0,70.53
高雄市,左營區,永清里,118,2,597,16,613,859,2,1,2,0,1,0,71.36
高雄市,左營區,復興里,119,2,826,8,834,1150,2,1,2,0,1,0,72.52
高雄市,左營區,莒光里,120,2,1158,15,1173,1713,2,1,2,0,1,0,68.48
高雄市,左營區,光輝里,121,2,770,16,786,1119,2,1,2,0,1,0,70.24
高雄市,左營區,光輝里,122,2,973,18,991,1404,2,1,2,0,1,0,70.58
高雄市,左營區,合群里,123,2,923,17,940,1319,2,1,2,0,1,0,71.27
高雄市,左營區,明建里,124,2,989,12,1001,1456,2,1,2,0,1,0,68.75
高雄市,左營區,頂西里,125,2,868,16,884,1130,2,1,2,0,1,0,78.23
高雄市,左營區,聖后里,126,2,663,10,673,897,2,1,2,0,1,0,75.03
高雄市,左營區,聖西里,127,2,264,2,266,355,2,1,2,0,1,0,74.93
高雄市,左營區,聖南里,128,2,373,3,376,546,2,1,2,0,1,0,68.86
高雄市,左營區,城南里,129,2,385,7,392,545,2,1,2,0,1,0,71.93
高雄市,左營區,路東里,130,2,534,8,542,739,2,1,2,0,1,0,73.34
高雄市,左營區,廍北里,131,2,359,8,367,501,2,1,2,0,1,0,73.25
高雄市,左營區,廍南里,132,2,498,7,505,687,2,1,2,0,1,0,73.51
高雄市,左營區,埤西里,133,2,750,10,760,1050,2,1,2,0,1,0,72.38
高雄市,左營區,埤北里,134,2,892,31,923,1376,2,1,2,0,1,0,67.08
高雄市,左營區,埤東里,135,2,764,8,772,1098,2,1,2,0,1,0,70.31
高雄市,左營區,海勝里,136,2,1020,19,1039,1390,2,1,2,0,1,0,74.75
高雄市,左營區,海勝里,137,2,1435,25,1460,2019,2,1,2,0,1,0,72.31
高雄市,左營區,海勝里,138,2,992,22,1014,1346,2,1,2,0,1,0,75.33
高雄市,左營區,海勝里,139,2,783,12,795,1049,2,1,2,0,1,0,75.79
高雄市,左營區,崇實里,140,2,830,18,848,1198,2,1,2,0,1,0,70.78
高雄市,左營區,自助里,141,2,919,16,935,1312,2,1,2,0,1,0,71.27
高雄市,左營區,自助里,142,2,511,12,523,776,2,1,2,0,1,0,67.4
高雄市,左營區,果貿里,143,2,1335,17,1352,1820,2,1,2,0,1,0,74.29
高雄市,左營區,果惠里,144,2,1037,22,1059,1542,2,1,2,0,1,0,68.68
高雄市,左營區,果峰里,145,2,1194,11,1205,1701,2,1,2,0,1,0,70.84
高雄市,左營區,新下里,146,2,1171,26,1197,1740,2,1,2,0,1,0,68.79
高雄市,左營區,新下里,147,2,1201,20,1221,1785,2,1,2,0,1,0,68.4
高雄市,左營區,新下里,148,2,1086,18,1104,1668,2,1,2,0,1,0,66.19
高雄市,左營區,新下里,149,2,1211,19,1230,1833,2,1,2,0,1,0,67.1
高雄市,左營區,新下里,150,2,1185,11,1196,1713,2,1,2,0,1,0,69.82
高雄市,左營區,新下里,151,2,975,21,996,1377,2,1,2,0,1,0,72.33
高雄市,左營區,新上里,152,2,1170,23,1193,1648,2,1,2,0,1,0,72.39
高雄市,左營區,新上里,153,2,1096,20,1116,1573,2,1,2,0,1,0,70.95
高雄市,左營區,新上里,154,2,1037,18,1055,1532,2,1,2,0,1,0,68.86
高雄市,左營區,新上里,155,2,966,25,991,1452,2,1,2,0,1,0,68.25
高雄市,左營區,新上里,156,2,1102,22,1124,1657,2,1,2,0,1,0,67.83
高雄市,左營區,新上里,157,2,1032,27,1059,1778,2,1,2,0,1,0,59.56
高雄市,左營區,新上里,158,2,1096,34,1130,1638,2,1,2,0,1,0,68.99
高雄市,左營區,新上里,159,2,1161,28,1189,1736,2,1,2,0,1,0,68.49
高雄市,左營區,新上里,160,2,1067,36,1103,1689,2,1,2,0,1,0,65.3
高雄市,左營區,新上里,161,2,1043,22,1065,1664,2,1,2,0,1,0,64
高雄市,左營區,新上里,162,2,1143,35,1178,1748,2,1,2,0,1,0,67.39
高雄市,左營區,新上里,163,2,1082,26,1108,1710,2,1,2,0,1,0,64.8
高雄市,左營區,新中里,164,2,1205,35,1240,1755,2,1,2,0,1,0,70.66
高雄市,左營區,新中里,165,2,894,13,907,1252,2,1,2,0,1,0,72.44
高雄市,左營區,新中里,166,2,1018,14,1032,1517,2,1,2,0,1,0,68.03
高雄市,左營區,新光里,167,2,1153,17,1170,1608,2,1,2,0,1,0,72.76
高雄市,左營區,新光里,168,2,1106,25,1131,1621,2,1,2,0,1,0,69.77
高雄市,左營區,新光里,169,2,1023,22,1045,1542,2,1,2,0,1,0,67.77
高雄市,左營區,新光里,170,2,1073,25,1098,1605,2,1,2,0,1,0,68.41
高雄市,左營區,新光里,171,2,1097,17,1114,1647,2,1,2,0,1,0,67.64
高雄市,左營區,新光里,172,2,1102,22,1124,1744,2,1,2,0,1,0,64.45
高雄市,左營區,菜公里,173,2,1193,14,1207,1714,2,1,2,0,1,0,70.42
高雄市,左營區,菜公里,174,2,1084,29,1113,1641,2,1,2,0,1,0,67.82
高雄市,左營區,菜公里,175,2,1097,30,1127,1652,2,1,2,0,1,0,68.22
高雄市,左營區,菜公里,176,2,1061,27,1088,1636,2,1,2,0,1,0,66.5
高雄市,左營區,菜公里,177,2,1002,24,1026,1602,2,1,2,0,1,0,64.04
高雄市,左營區,菜公里,178,2,962,26,988,1624,2,1,2,0,1,0,60.84
高雄市,左營區,菜公里,179,2,1075,27,1102,1725,2,1,2,0,1,0,63.88
高雄市,左營區,菜公里,180,2,1085,26,1111,1709,2,1,2,0,1,0,65.01
高雄市,左營區,菜公里,181,2,1158,23,1181,1810,2,1,2,0,1,0,65.25
高雄市,左營區,菜公里,182,2,1187,6,1193,1741,2,1,2,0,1,0,68.52
高雄市,左營區,菜公里,183,2,1014,28,1042,1587,2,1,2,0,1,0,65.66
高雄市,左營區,菜公里,184,2,875,15,890,1322,2,1,2,0,1,0,67.32
高雄市,左營區,福山里,185,2,879,23,902,1442,2,1,2,0,1,0,62.55
高雄市,左營區,福山里,186,2,959,21,980,1565,2,1,2,0,1,0,62.62
高雄市,左營區,福山里,187,2,969,13,982,1486,2,1,2,0,1,0,66.08
高雄市,左營區,福山里,188,2,942,19,961,1452,2,1,2,0,1,0,66.18
高雄市,左營區,福山里,189,2,979,27,1006,1534,2,1,2,0,1,0,65.58
高雄市,左營區,福山里,190,2,995,22,1017,1580,2,1,2,0,1,0,64.37
高雄市,左營區,福山里,191,2,949,22,971,1553,2,1,2,0,1,0,62.52
高雄市,左營區,福山里,192,2,973,21,994,1657,2,1,2,0,1,0,59.99
高雄市,左營區,福山里,193,2,1124,22,1146,1795,2,1,2,0,1,0,63.84
高雄市,左營區,福山里,194,2,1025,25,1050,1622,2,1,2,0,1,0,64.73
高雄市,左營區,福山里,195,2,1151,28,1179,1865,2,1,2,0,1,0,63.22
高雄市,左營區,福山里,196,2,924,21,945,1563,2,1,2,0,1,0,60.46
高雄市,左營區,福山里,197,2,1070,41,1111,1691,2,1,2,0,1,0,65.7
高雄市,左營區,福山里,198,2,1018,15,1033,1561,2,1,2,0,1,0,66.18
高雄市,楠梓區,清豐里,199,2,1073,18,1091,1571,2,1,2,0,1,0,69.45
高雄市,楠梓區,清豐里,200,2,1100,21,1121,1664,2,1,2,0,1,0,67.37
高雄市,楠梓區,清豐里,201,2,904,15,919,1422,2,1,2,0,1,0,64.63
高雄市,楠梓區,清豐里,202,2,897,17,914,1479,2,1,2,0,1,0,61.8
高雄市,楠梓區,清豐里,203,2,1040,18,1058,1638,2,1,2,0,1,0,64.59
高雄市,楠梓區,清豐里,204,2,889,10,899,1352,2,1,2,0,1,0,66.49
高雄市,楠梓區,清豐里,205,2,885,8,893,1408,2,1,2,0,1,0,63.42
高雄市,楠梓區,清豐里,206,2,816,8,824,1202,2,1,2,0,1,0,68.55
高雄市,楠梓區,東寧里,207,2,741,7,748,1135,2,1,2,0,1,0,65.9
高雄市,楠梓區,東寧里,208,2,819,21,840,1279,2,1,2,0,1,0,65.68
高雄市,楠梓區,五常里,209,2,935,10,945,1382,2,1,2,0,1,0,68.38
高雄市,楠梓區,五常里,210,2,1020,18,1038,1610,2,1,2,0,1,0,64.47
高雄市,楠梓區,五常里,211,2,845,14,859,1516,2,1,2,0,1,0,56.66
高雄市,楠梓區,享平里,212,2,891,12,903,1262,2,1,2,0,1,0,71.55
高雄市,楠梓區,享平里,213,2,888,9,897,1436,2,1,2,0,1,0,62.47
高雄市,楠梓區,中陽里,214,2,875,14,889,1286,2,1,2,0,1,0,69.13
高雄市,楠梓區,中陽里,215,2,890,11,901,1340,2,1,2,0,1,0,67.24
高雄市,楠梓區,惠楠里,216,2,662,8,670,1391,2,1,2,0,1,0,48.17
高雄市,楠梓區,惠楠里,217,2,813,17,830,1258,2,1,2,0,1,0,65.98
高雄市,楠梓區,惠民里,218,2,1043,11,1054,1564,2,1,2,0,1,0,67.39
高雄市,楠梓區,惠民里,219,2,1173,20,1193,1707,2,1,2,0,1,0,69.89
高雄市,楠梓區,惠豐里,220,2,1054,8,1062,1626,2,1,2,0,1,0,65.31
高雄市,楠梓區,惠豐里,221,2,1171,15,1186,1822,2,1,2,0,1,0,65.09
高雄市,楠梓區,錦屏里,222,2,1121,20,1141,1604,2,1,2,0,1,0,71.13
高雄市,楠梓區,錦屏里,223,2,1151,9,1160,1671,2,1,2,0,1,0,69.42
高雄市,楠梓區,玉屏里,224,2,731,7,738,1001,2,1,2,0,1,0,73.73
高雄市,楠梓區,玉屏里,225,2,893,15,908,1223,2,1,2,0,1,0,74.24
高雄市,楠梓區,金田里,226,2,1058,16,1074,1500,2,1,2,0,1,0,71.6
高雄市,楠梓區,金田里,227,2,1080,21,1101,1569,2,1,2,0,1,0,70.17
高雄市,楠梓區,稔田里,228,2,1104,10,1114,1543,2,1,2,0,1,0,72.2
高雄市,楠梓區,瑞屏里,229,2,1150,18,1168,1709,2,1,2,0,1,0,68.34
高雄市,楠梓區,瑞屏里,230,2,1086,15,1101,1674,2,1,2,0,1,0,65.77
高雄市,楠梓區,翠屏里,231,2,964,20,984,1454,2,1,2,0,1,0,67.68
高雄市,楠梓區,翠屏里,232,2,991,18,1009,1552,2,1,2,0,1,0,65.01
高雄市,楠梓區,翠屏里,233,2,890,28,918,1441,2,1,2,0,1,0,63.71
高雄市,楠梓區,翠屏里,234,2,983,16,999,1587,2,1,2,0,1,0,62.95
高雄市,楠梓區,翠屏里,235,2,958,15,973,1487,2,1,2,0,1,0,65.43
高雄市,楠梓區,翠屏里,236,2,960,17,977,1553,2,1,2,0,1,0,62.91
高雄市,楠梓區,翠屏里,237,2,1059,17,1076,1704,2,1,2,0,1,0,63.15
高雄市,楠梓區,宏南里,238,2,1141,20,1161,1707,2,1,2,0,1,0,68.01
高雄市,楠梓區,宏毅里,239,2,1022,11,1033,1412,2,1,2,0,1,0,73.16
高雄市,楠梓區,宏毅里,240,2,987,21,1008,1387,2,1,2,0,1,0,72.67
高雄市,楠梓區,宏榮里,241,2,906,8,914,1255,2,1,2,0,1,0,72.83
高雄市,楠梓區,宏榮里,242,2,728,16,744,975,2,1,2,0,1,0,76.31
高雄市,楠梓區,廣昌里,243,2,1019,15,1034,1366,2,1,2,0,1,0,75.7
高雄市,楠梓區,廣昌里,244,2,1108,16,1124,1590,2,1,2,0,1,0,70.69
高雄市,楠梓區,久昌里,245,2,695,9,704,1029,2,1,2,0,1,0,68.42
高雄市,楠梓區,久昌里,246,2,784,17,801,1207,2,1,2,0,1,0,66.36
高雄市,楠梓區,大昌里,247,2,717,6,723,1003,2,1,2,0,1,0,72.08
高雄市,楠梓區,大昌里,248,2,716,10,726,1008,2,1,2,0,1,0,72.02
高雄市,楠梓區,福昌里,249,2,1353,17,1370,1823,2,1,2,0,1,0,75.15
高雄市,楠梓區,盛昌里,250,2,1109,10,1119,1488,2,1,2,0,1,0,75.2
高雄市,楠梓區,盛昌里,251,2,995,20,1015,1471,2,1,2,0,1,0,69
高雄市,楠梓區,盛昌里,252,2,1016,17,1033,1428,2,1,2,0,1,0,72.34
高雄市,楠梓區,泰昌里,253,2,1040,9,1049,1446,2,1,2,0,1,0,72.54
高雄市,楠梓區,興昌里,254,2,1245,17,1262,1733,2,1,2,0,1,0,72.82
高雄市,楠梓區,興昌里,255,2,1157,13,1170,1645,2,1,2,0,1,0,71.12
高雄市,楠梓區,建昌里,256,2,952,12,964,1389,2,1,2,0,1,0,69.4
高雄市,楠梓區,建昌里,257,2,705,9,714,1029,2,1,2,0,1,0,69.39
高雄市,楠梓區,宏昌里,258,2,778,9,787,1142,2,1,2,0,1,0,68.91
高雄市,楠梓區,宏昌里,259,2,887,8,895,1313,2,1,2,0,1,0,68.16
高雄市,楠梓區,和昌里,260,2,704,9,713,986,2,1,2,0,1,0,72.31
高雄市,楠梓區,和昌里,261,2,775,12,787,1088,2,1,2,0,1,0,72.33
高雄市,楠梓區,慶昌里,262,2,1196,8,1204,1604,2,1,2,0,1,0,75.06
高雄市,楠梓區,慶昌里,263,2,1057,9,1066,1476,2,1,2,0,1,0,72.22
高雄市,楠梓區,隆昌里,264,2,1140,15,1155,1640,2,1,2,0,1,0,70.43
高雄市,楠梓區,隆昌里,265,2,1057,9,1066,1556,2,1,2,0,1,0,68.51
高雄市,楠梓區,秀昌里,266,2,654,7,661,1015,2,1,2,0,1,0,65.12
高雄市,楠梓區,秀昌里,267,2,722,11,733,1023,2,1,2,0,1,0,71.65
高雄市,楠梓區,裕昌里,268,2,1085,16,1101,1465,2,1,2,0,1,0,75.15
高雄市,楠梓區,裕昌里,269,2,1216,14,1230,1668,2,1,2,0,1,0,73.74
高雄市,楠梓區,國昌里,270,2,1116,15,1131,1565,2,1,2,0,1,0,72.27
高雄市,楠梓區,國昌里,271,2,1069,12,1081,1652,2,1,2,0,1,0,65.44
高雄市,楠梓區,加昌里,272,2,1014,18,1032,1560,2,1,2,0,1,0,66.15
高雄市,楠梓區,加昌里,273,2,1097,15,1112,1589,2,1,2,0,1,0,69.98
高雄市,楠梓區,加昌里,274,2,1036,11,1047,1630,2,1,2,0,1,0,64.23
高雄市,楠梓區,加昌里,275,2,1013,19,1032,1561,2,1,2,0,1,0,66.11
高雄市,楠梓區,仁昌里,276,2,1133,23,1156,1793,2,1,2,0,1,0,64.47
高雄市,楠梓區,仁昌里,277,2,1122,22,1144,1755,2,1,2,0,1,0,65.19
高雄市,楠梓區,藍田里,278,2,1296,19,1315,1864,2,1,2,0,1,0,70.55
高雄市,楠梓區,中興里,279,2,683,8,691,983,2,1,2,0,1,0,70.3
高雄市,楠梓區,中和里,280,2,1107,12,1119,1540,2,1,2,0,1,0,72.66
高雄市,三民區,鼎金里,281,3,1149,19,1168,1879,2,1,2,0,1,0,62.16
高雄市,三民區,鼎金里,282,3,787,15,802,1226,2,1,2,0,1,0,65.42
高雄市,三民區,鼎盛里,283,3,863,25,888,1366,2,1,2,0,1,0,65.01
高雄市,三民區,鼎盛里,284,3,951,12,963,1450,2,1,2,0,1,0,66.41
高雄市,三民區,鼎盛里,285,3,995,17,1012,1578,2,1,2,0,1,0,64.13
高雄市,三民區,鼎盛里,286,3,1028,20,1048,1625,2,1,2,0,1,0,64.49
高雄市,三民區,鼎強里,287,3,1126,22,1148,1635,2,1,2,0,1,0,70.21
高雄市,三民區,鼎強里,288,3,1145,25,1170,1769,2,1,2,0,1,0,66.14
高雄市,三民區,鼎力里,289,3,1063,29,1092,1632,2,1,2,0,1,0,66.91
高雄市,三民區,鼎力里,290,3,1176,17,1193,1761,2,1,2,0,1,0,67.75
高雄市,三民區,鼎西里,291,3,954,22,976,1443,2,1,2,0,1,0,67.64
高雄市,三民區,鼎西里,292,3,923,19,942,1389,2,1,2,0,1,0,67.82
高雄市,三民區,鼎西里,293,3,967,22,989,1541,2,1,2,0,1,0,64.18
高雄市,三民區,鼎西里,294,3,952,19,971,1589,2,1,2,0,1,0,61.11
高雄市,三民區,鼎中里,295,3,1158,18,1176,1615,2,1,2,0,1,0,72.82
高雄市,三民區,鼎中里,296,3,1130,23,1153,1574,2,1,2,0,1,0,73.25
高雄市,三民區,鼎泰里,297,3,1160,26,1186,1740,2,1,2,0,1,0,68.16
高雄市,三民區,鼎泰里,298,3,1140,19,1159,1687,2,1,2,0,1,0,68.7
高雄市,三民區,鼎泰里,299,3,1155,23,1178,1717,2,1,2,0,1,0,68.61
高雄市,三民區,鼎泰里,300,3,997,26,1023,1649,2,1,2,0,1,0,62.04
高雄市,三民區,鼎泰里,301,3,1111,19,1130,1708,2,1,2,0,1,0,66.16
高雄市,三民區,鼎泰里,302,3,1129,14,1143,1722,2,1,2,0,1,0,66.38
高雄市,三民區,鼎泰里,303,3,1091,19,1110,1628,2,1,2,0,1,0,68.18
高雄市,三民區,鼎泰里,304,3,938,8,946,1382,2,1,2,0,1,0,68.45
高雄市,三民區,鼎泰里,305,3,1117,22,1139,1634,2,1,2,0,1,0,69.71
高雄市,三民區,鼎泰里,306,3,1074,34,1108,1614,2,1,2,0,1,0,68.65
高雄市,三民區,本館里,307,3,1015,20,1035,1534,2,1,2,0,1,0,67.47
高雄市,三民區,本館里,308,3,925,18,943,1407,2,1,2,0,1,0,67.02
高雄市,三民區,本館里,309,3,948,13,961,1448,2,1,2,0,1,0,66.37
高雄市,三民區,本館里,310,3,1033,15,1048,1538,2,1,2,0,1,0,68.14
高雄市,三民區,本館里,311,3,1050,16,1066,1579,2,1,2,0,1,0,67.51
高雄市,三民區,本和里,312,3,1043,21,1064,1571,2,1,2,0,1,0,67.73
高雄市,三民區,本和里,313,3,1022,18,1040,1552,2,1,2,0,1,0,67.01
高雄市,三民區,本和里,314,3,907,7,914,1478,2,1,2,0,1,0,61.84
高雄市,三民區,本和里,315,3,925,21,946,1489,2,1,2,0,1,0,63.53
高雄市,三民區,本文里,316,3,728,9,737,1090,2,1,2,0,1,0,67.61
高雄市,三民區,本文里,317,3,671,7,678,937,2,1,2,0,1,0,72.36
高雄市,三民區,本武里,318,3,1053,23,1076,1557,2,1,2,0,1,0,69.11
高雄市,三民區,本元里,319,3,1034,20,1054,1569,2,1,2,0,1,0,67.18
高雄市,三民區,本元里,320,3,1011,27,1038,1565,2,1,2,0,1,0,66.33
高雄市,三民區,本元里,321,3,1050,8,1058,1476,2,1,2,0,1,0,71.68
高雄市,三民區,本安里,322,3,774,16,790,1197,2,1,2,0,1,0,66
高雄市,三民區,本安里,323,3,895,17,912,1311,2,1,2,0,1,0,69.57
高雄市,三民區,本安里,324,3,945,19,964,1378,2,1,2,0,1,0,69.96
高雄市,三民區,本上里,325,3,938,18,956,1404,2,1,2,0,1,0,68.09
高雄市,三民區,本上里,326,3,862,19,881,1325,2,1,2,0,1,0,66.49
高雄市,三民區,本上里,327,3,987,10,997,1517,2,1,2,0,1,0,65.72
高雄市,三民區,本揚里,328,3,1088,19,1107,1636,2,1,2,0,1,0,67.67
高雄市,三民區,本揚里,329,3,1087,20,1107,1650,2,1,2,0,1,0,67.09
高雄市,三民區,本揚里,330,3,1104,32,1136,1742,2,1,2,0,1,0,65.21
高雄市,三民區,本揚里,331,3,1032,21,1053,1634,2,1,2,0,1,0,64.44
高雄市,三民區,寶獅里,332,3,1169,24,1193,1852,2,1,2,0,1,0,64.42
高雄市,三民區,寶獅里,333,3,1027,20,1047,1596,2,1,2,0,1,0,65.6
高雄市,三民區,寶德里,334,3,960,18,978,1529,2,1,2,0,1,0,63.96
高雄市,三民區,寶德里,335,3,924,16,940,1435,2,1,2,0,1,0,65.51
高雄市,三民區,寶德里,336,3,990,19,1009,1547,2,1,2,0,1,0,65.22
高雄市,三民區,寶泰里,337,3,1108,24,1132,1729,2,1,2,0,1,0,65.47
高雄市,三民區,寶泰里,338,3,985,20,1005,1666,2,1,2,0,1,0,60.32
高雄市,三民區,寶興里,339,3,835,12,847,1209,2,1,2,0,1,0,70.06
高雄市,三民區,寶興里,340,3,970,16,986,1404,2,1,2,0,1,0,70.23
高雄市,三民區,寶興里,341,3,939,12,951,1361,2,1,2,0,1,0,69.88
高雄市,三民區,寶興里,342,3,936,19,955,1470,2,1,2,0,1,0,64.97
高雄市,三民區,寶中里,343,3,851,14,865,1248,2,1,2,0,1,0,69.31
高雄市,三民區,寶中里,344,3,997,15,1012,1470,2,1,2,0,1,0,68.84
高雄市,三民區,寶華里,345,3,887,24,911,1392,2,1,2,0,1,0,65.45
高雄市,三民區,寶華里,346,3,906,21,927,1451,2,1,2,0,1,0,63.89
高雄市,三民區,寶國里,347,3,1179,25,1204,1931,2,1,2,0,1,0,62.35
高雄市,三民區,寶國里,348,3,980,10,990,1525,2,1,2,0,1,0,64.92
高雄市,三民區,寶國里,349,3,1163,22,1185,1743,2,1,2,0,1,0,67.99
高雄市,三民區,寶國里,350,3,1030,17,1047,1502,2,1,2,0,1,0,69.71
高雄市,三民區,寶民里,351,3,848,25,873,1305,2,1,2,0,1,0,66.9
高雄市,三民區,寶民里,352,3,869,18,887,1343,2,1,2,0,1,0,66.05
高雄市,三民區,寶慶里,353,3,786,13,799,1273,2,1,2,0,1,0,62.77
高雄市,三民區,寶慶里,354,3,761,25,786,1244,2,1,2,0,1,0,63.18
高雄市,三民區,寶業里,355,3,897,17,914,1465,2,1,2,0,1,0,62.39
高雄市,三民區,寶業里,356,3,898,19,917,1439,2,1,2,0,1,0,63.72
高雄市,三民區,寶業里,357,3,865,10,875,1341,2,1,2,0,1,0,65.25
高雄市,三民區,寶盛里,358,3,844,17,861,1261,2,1,2,0,1,0,68.28
高雄市,三民區,寶盛里,359,3,996,21,1017,1449,2,1,2,0,1,0,70.19
高雄市,三民區,寶盛里,360,3,966,16,982,1465,2,1,2,0,1,0,67.03
高雄市,三民區,寶安里,361,3,1160,21,1181,1763,2,1,2,0,1,0,66.99
高雄市,三民區,寶安里,362,3,867,15,882,1389,2,1,2,0,1,0,63.5
高雄市,三民區,寶安里,363,3,883,13,896,1414,2,1,2,0,1,0,63.37
高雄市,三民區,寶安里,364,3,892,12,904,1477,2,1,2,0,1,0,61.21
高雄市,三民區,寶龍里,365,3,918,12,930,1328,2,1,2,0,1,0,70.03
高雄市,三民區,寶龍里,366,3,829,11,840,1189,2,1,2,0,1,0,70.65
高雄市,三民區,寶龍里,367,3,903,19,922,1400,2,1,2,0,1,0,65.86
高雄市,三民區,寶珠里,368,3,822,7,829,2005,2,1,2,0,1,0,41.35
高雄市,三民區,寶珠里,369,3,1173,32,1205,1763,2,1,2,0,1,0,68.35
高雄市,三民區,寶珠里,370,3,1111,22,1133,1750,2,1,2,0,1,0,64.74
高雄市,三民區,寶玉里,371,3,1178,27,1205,1820,2,1,2,0,1,0,66.21
高雄市,三民區,寶玉里,372,3,1148,19,1167,1788,2,1,2,0,1,0,65.27
高雄市,三民區,寶玉里,373,3,1126,16,1142,1787,2,1,2,0,1,0,63.91
高雄市,三民區,寶玉里,374,3,1135,19,1154,1848,2,1,2,0,1,0,62.45
高雄市,三民區,灣子里,375,3,1010,19,1029,1572,2,1,2,0,1,0,65.46
高雄市,三民區,灣子里,376,3,906,17,923,1485,2,1,2,0,1,0,62.15
高雄市,三民區,灣愛里,377,3,896,21,917,1398,2,1,2,0,1,0,65.59
高雄市,三民區,灣愛里,378,3,929,20,949,1483,2,1,2,0,1,0,63.99
高雄市,三民區,灣中里,379,3,971,18,989,1469,2,1,2,0,1,0,67.32
高雄市,三民區,灣中里,380,3,795,9,804,1267,2,1,2,0,1,0,63.46
高雄市,三民區,灣中里,381,3,830,19,849,1308,2,1,2,0,1,0,64.91
高雄市,三民區,灣華里,382,3,784,12,796,1233,2,1,2,0,1,0,64.56
高雄市,三民區,灣華里,383,3,834,10,844,1373,2,1,2,0,1,0,61.47
高雄市,三民區,灣勝里,384,3,685,10,695,997,2,1,2,0,1,0,69.71
高雄市,三民區,灣勝里,385,3,713,11,724,1013,2,1,2,0,1,0,71.47
高雄市,三民區,灣利里,386,3,1124,19,1143,1696,2,1,2,0,1,0,67.39
高雄市,三民區,灣利里,387,3,1031,23,1054,1516,2,1,2,0,1,0,69.53
高雄市,三民區,灣復里,388,3,1067,15,1082,1814,2,1,2,0,1,0,59.65
高雄市,三民區,灣復里,389,3,847,15,862,1226,2,1,2,0,1,0,70.31
高雄市,三民區,正興里,390,3,1161,20,1181,1971,2,1,2,0,1,0,59.92
高雄市,三民區,正興里,391,3,1140,11,1151,1737,2,1,2,0,1,0,66.26
高雄市,三民區,正興里,392,3,1057,16,1073,1665,2,1,2,0,1,0,64.44
高雄市,三民區,正興里,393,3,1262,13,1275,1945,2,1,2,0,1,0,65.55
高雄市,三民區,正興里,394,3,1163,19,1182,1826,2,1,2,0,1,0,64.73
高雄市,三民區,正順里,395,3,1024,15,1039,1549,2,1,2,0,1,0,67.08
高雄市,三民區,正順里,396,3,1133,22,1155,1722,2,1,2,0,1,0,67.07
高雄市,三民區,灣興里,397,3,1138,20,1158,1625,2,1,2,0,1,0,71.26
高雄市,三民區,灣成里,398,3,634,10,644,1078,2,1,2,0,1,0,59.74
高雄市,三民區,灣成里,399,3,659,6,665,998,2,1,2,0,1,0,66.63
高雄市,三民區,安康里,400,3,944,11,955,1456,2,1,2,0,1,0,65.59
高雄市,三民區,安康里,401,3,931,20,951,1437,2,1,2,0,1,0,66.18
高雄市,三民區,安寧里,402,3,658,15,673,981,2,1,2,0,1,0,68.6
高雄市,三民區,安寧里,403,3,679,9,688,1009,2,1,2,0,1,0,68.19
高雄市,三民區,安吉里,404,3,926,14,940,1521,2,1,2,0,1,0,61.8
高雄市,三民區,安吉里,405,3,880,18,898,1347,2,1,2,0,1,0,66.67
高雄市,三民區,安吉里,406,3,1002,13,1015,1524,2,1,2,0,1,0,66.6
高雄市,三民區,安發里,407,3,908,16,924,1407,2,1,2,0,1,0,65.67
高雄市,三民區,安發里,408,3,903,25,928,1418,2,1,2,0,1,0,65.44
高雄市,三民區,安發里,409,3,910,18,928,1418,2,1,2,0,1,0,65.44
高雄市,三民區,安東里,410,3,1085,15,1100,1549,2,1,2,0,1,0,71.01
高雄市,三民區,安東里,411,3,1063,27,1090,1529,2,1,2,0,1,0,71.29
高雄市,三民區,安和里,412,3,893,20,913,1238,2,1,2,0,1,0,73.75
高雄市,三民區,安和里,413,3,914,19,933,1352,2,1,2,0,1,0,69.01
高雄市,三民區,達德里,414,3,1021,18,1039,1406,2,1,2,0,1,0,73.9
高雄市,三民區,達明里,415,3,1166,22,1188,1630,2,1,2,0,1,0,72.88
高雄市,三民區,達仁里,416,3,991,18,1009,1412,2,1,2,0,1,0,71.46
高雄市,三民區,達勇里,417,3,729,14,743,1042,2,1,2,0,1,0,71.31
高雄市,三民區,同德里,418,3,970,15,985,1475,2,1,2,0,1,0,66.78
高雄市,三民區,同德里,419,3,906,18,924,1339,2,1,2,0,1,0,69.01
高雄市,三民區,德智里,420,3,808,12,820,1152,2,1,2,0,1,0,71.18
高雄市,三民區,德智里,421,3,835,14,849,1223,2,1,2,0,1,0,69.42
高雄市,三民區,德仁里,422,3,1215,27,1242,1853,2,1,2,0,1,0,67.03
高雄市,三民區,安生里,423,3,1153,21,1174,1605,2,1,2,0,1,0,73.15
高雄市,三民區,德東里,424,3,615,8,623,852,2,1,2,0,1,0,73.12
高雄市,三民區,德行里,425,3,769,17,786,1086,2,1,2,0,1,0,72.38
高雄市,三民區,精華里,426,3,1094,32,1126,1569,2,1,2,0,1,0,71.77
高雄市,三民區,民享里,427,3,716,9,725,992,2,1,2,0,1,0,73.08
高雄市,三民區,民享里,428,3,741,12,753,1065,2,1,2,0,1,0,70.7
高雄市,三民區,安宜里,429,3,1121,20,1141,1585,2,1,2,0,1,0,71.99
高雄市,三民區,安宜里,430,3,1086,28,1114,1544,2,1,2,0,1,0,72.15
高雄市,三民區,安泰里,431,3,797,10,807,1153,2,1,2,0,1,0,69.99
高雄市,三民區,安泰里,432,3,792,15,807,1197,2,1,2,0,1,0,67.42
高雄市,三民區,安泰里,433,3,971,17,988,1506,2,1,2,0,1,0,65.6
高雄市,三民區,安邦里,434,3,735,10,745,1456,2,1,2,0,1,0,51.17
高雄市,三民區,安邦里,435,3,890,19,909,1266,2,1,2,0,1,0,71.8
高雄市,三民區,安邦里,436,3,803,9,812,1187,2,1,2,0,1,0,68.41
高雄市,三民區,十全里,437,3,1082,10,1092,1531,2,1,2,0,1,0,71.33
高雄市,三民區,十美里,438,3,517,8,525,750,2,1,2,0,1,0,70
高雄市,三民區,十美里,439,3,721,18,739,1064,2,1,2,0,1,0,69.45
高雄市,三民區,德北里,440,3,620,17,637,950,2,1,2,0,1,0,67.05
高雄市,三民區,德北里,441,3,720,11,731,1056,2,1,2,0,1,0,69.22
高雄市,三民區,立誠里,442,3,636,12,648,881,2,1,2,0,1,0,73.55
高雄市,三民區,立業里,443,3,723,15,738,1035,2,1,2,0,1,0,71.3
高雄市,三民區,港東里,444,3,913,12,925,1351,2,1,2,0,1,0,68.47
高雄市,三民區,港新里,445,3,923,17,940,1386,2,1,2,0,1,0,67.82
高雄市,三民區,港西里,446,3,528,8,536,805,2,1,2,0,1,0,66.58
高雄市,三民區,港北里,447,3,172,3,175,248,2,1,2,0,1,0,70.56
高雄市,三民區,博愛里,448,3,735,11,746,1142,2,1,2,0,1,0,65.32
高雄市,三民區,博惠里,449,3,904,17,921,1345,2,1,2,0,1,0,68.48
高雄市,三民區,博惠里,450,3,934,17,951,1374,2,1,2,0,1,0,69.21
高雄市,三民區,博惠里,451,3,881,21,902,1288,2,1,2,0,1,0,70.03
高雄市,三民區,長明里,452,3,752,19,771,1131,2,1,2,0,1,0,68.17
高雄市,三民區,建東里,453,3,620,12,632,1088,2,1,2,0,1,0,58.09
高雄市,三民區,興德里,454,3,1106,28,1134,1669,2,1,2,0,1,0,67.94
高雄市,三民區,鳳南里,455,3,786,13,799,1109,2,1,2,0,1,0,72.05
高雄市,三民區,鳳北里,456,3,1222,21,1243,1724,2,1,2,0,1,0,72.1
高雄市,三民區,德西里,457,3,772,20,792,1168,2,1,2,0,1,0,67.81
高雄市,三民區,豐裕里,458,3,999,30,1029,1411,2,1,2,0,1,0,72.93
高雄市,三民區,豐裕里,459,3,832,22,854,1215,2,1,2,0,1,0,70.29
高雄市,三民區,川東里,460,3,605,15,620,913,2,1,2,0,1,0,67.91
高雄市,三民區,川東里,461,3,579,19,598,913,2,1,2,0,1,0,65.5
高雄市,三民區,裕民里,462,3,808,33,841,1165,2,1,2,0,1,0,72.19
高雄市,三民區,力行里,463,3,853,13,866,1114,2,1,2,0,1,0,77.74
高雄市,三民區,千歲里,464,3,795,16,811,1136,2,1,2,0,1,0,71.39
高雄市,三民區,立德里,465,3,911,18,929,1315,2,1,2,0,1,0,70.65
高雄市,三民區,千北里,466,3,925,30,955,1315,2,1,2,0,1,0,72.62
高雄市,三民區,千秋里,467,3,729,20,749,1130,2,1,2,0,1,0,66.28
高雄市,三民區,千秋里,468,3,749,12,761,1124,2,1,2,0,1,0,67.7
高雄市,新興區,浩然里,469,4,739,11,750,1086,2,1,2,0,1,0,69.06
高雄市,新興區,浩然里,470,4,534,9,543,811,2,1,2,0,1,0,66.95
高雄市,新興區,振成里,471,4,798,14,812,1249,2,1,2,0,1,0,65.01
高雄市,新興區,德生里,472,4,929,10,939,1413,2,1,2,0,1,0,66.45
高雄市,新興區,德生里,473,4,787,16,803,1274,2,1,2,0,1,0,63.03
高雄市,新興區,振華里,474,4,844,11,855,1268,2,1,2,0,1,0,67.43
高雄市,新興區,正氣里,475,4,1052,19,1071,1553,2,1,2,0,1,0,68.96
高雄市,新興區,德政里,476,4,491,9,500,747,2,1,2,0,1,0,66.93
高雄市,新興區,仁聲里,477,4,537,11,548,908,2,1,2,0,1,0,60.35
高雄市,新興區,德望里,478,4,666,8,674,1025,2,1,2,0,1,0,65.76
高雄市,新興區,德望里,479,4,682,11,693,1019,2,1,2,0,1,0,68.01
高雄市,新興區,華聲里,480,4,668,14,682,995,2,1,2,0,1,0,68.54
高雄市,新興區,蕉園里,481,4,540,9,549,762,2,1,2,0,1,0,72.05
高雄市,新興區,永寧里,482,4,900,15,915,1405,2,1,2,0,1,0,65.12
高雄市,新興區,玉衡里,483,4,657,12,669,1027,2,1,2,0,1,0,65.14
高雄市,新興區,順昌里,484,4,814,11,825,1132,2,1,2,0,1,0,72.88
高雄市,新興區,順昌里,485,4,599,11,610,888,2,1,2,0,1,0,68.69
高雄市,新興區,文昌里,486,4,980,20,1000,1478,2,1,2,0,1,0,67.66
高雄市,新興區,文昌里,487,4,729,14,743,1102,2,1,2,0,1,0,67.42
高雄市,新興區,光耀里,488,4,779,11,790,1179,2,1,2,0,1,0,67.01
高雄市,新興區,光耀里,489,4,792,8,800,1147,2,1,2,0,1,0,69.75
高雄市,新興區,興昌里,490,4,612,7,619,847,2,1,2,0,1,0,73.08
高雄市,新興區,興昌里,491,4,573,14,587,894,2,1,2,0,1,0,65.66
高雄市,新興區,開平里,492,4,1008,18,1026,1488,2,1,2,0,1,0,68.95
高雄市,新興區,開平里,493,4,1065,30,1095,1547,2,1,2,0,1,0,70.78
高雄市,新興區,成功里,494,4,779,15,794,1160,2,1,2,0,1,0,68.45
高雄市,新興區,新江里,495,4,690,17,707,1112,2,1,2,0,1,0,63.58
高雄市,新興區,黎明里,496,4,589,11,600,905,2,1,2,0,1,0,66.3
高雄市,新興區,愛平里,497,4,550,6,556,857,2,1,2,0,1,0,64.88
高雄市,新興區,南港里,498,4,724,16,740,1038,2,1,2,0,1,0,71.29
高雄市,新興區,南港里,499,4,804,13,817,1146,2,1,2,0,1,0,71.29
高雄市,新興區,中東里,500,4,711,14,725,1400,2,1,2,0,1,0,51.79
高雄市,新興區,中東里,501,4,884,19,903,1425,2,1,2,0,1,0,63.37
高雄市,新興區,明莊里,502,4,525,9,534,820,2,1,2,0,1,0,65.12
高雄市,新興區,大明里,503,4,750,15,765,1137,2,1,2,0,1,0,67.28
高雄市,新興區,秋山里,504,4,625,10,635,948,2,1,2,0,1,0,66.98
高雄市,新興區,長驛里,505,4,627,14,641,966,2,1,2,0,1,0,66.36
高雄市,新興區,建興里,506,4,577,11,588,881,2,1,2,0,1,0,66.74
高雄市,新興區,建華里,507,4,606,18,624,944,2,1,2,0,1,0,66.1
高雄市,新興區,漢民里,508,4,599,18,617,850,2,1,2,0,1,0,72.59
高雄市,新興區,榮治里,509,4,565,11,576,822,2,1,2,0,1,0,70.07
高雄市,新興區,東坡里,510,4,861,13,874,1273,2,1,2,0,1,0,68.66
高雄市,前金區,三川里,511,4,519,11,530,753,2,1,2,0,1,0,70.39
高雄市,前金區,草江里,512,4,743,20,763,1118,2,1,2,0,1,0,68.25
高雄市,前金區,長城里,513,4,951,11,962,1395,2,1,2,0,1,0,68.96
高雄市,前金區,北金里,514,4,562,9,571,886,2,1,2,0,1,0,64.45
高雄市,前金區,東金里,515,4,619,12,631,948,2,1,2,0,1,0,66.56
高雄市,前金區,新生里,516,4,954,13,967,1403,2,1,2,0,1,0,68.92
高雄市,前金區,新生里,517,4,1060,24,1084,1640,2,1,2,0,1,0,66.1
高雄市,前金區,後金里,518,4,571,10,581,907,2,1,2,0,1,0,64.06
高雄市,前金區,長興里,519,4,712,6,718,1137,2,1,2,0,1,0,63.15
高雄市,前金區,青山里,520,4,893,16,909,1458,2,1,2,0,1,0,62.35
高雄市,前金區,民生里,521,4,467,8,475,732,2,1,2,0,1,0,64.89
高雄市,前金區,復元里,522,4,694,8,702,1055,2,1,2,0,1,0,66.54
高雄市,前金區,林投里,523,4,750,16,766,1262,2,1,2,0,1,0,60.7
高雄市,前金區,國民里,524,4,720,19,739,1073,2,1,2,0,1,0,68.87
高雄市,前金區,社東里,525,4,572,8,580,838,2,1,2,0,1,0,69.21
高雄市,前金區,社東里,526,4,584,11,595,852,2,1,2,0,1,0,69.84
高雄市,前金區,社西里,527,4,764,12,776,1169,2,1,2,0,1,0,66.38
高雄市,前金區,博孝里,528,4,604,9,613,930,2,1,2,0,1,0,65.91
高雄市,前金區,長生里,529,4,954,18,972,1520,2,1,2,0,1,0,63.95
高雄市,前金區,榮復里,530,4,851,19,870,1255,2,1,2,0,1,0,69.32
高雄市,前金區,文西里,531,4,729,7,736,1070,2,1,2,0,1,0,68.79
高雄市,前金區,文東里,532,4,864,25,889,1317,2,1,2,0,1,0,67.5
高雄市,苓雅區,博仁里,533,4,434,9,443,605,2,1,2,0,1,0,73.22
高雄市,苓雅區,苓洲里,534,4,867,20,887,1271,2,1,2,0,1,0,69.79
高雄市,苓雅區,苓昇里,535,4,1008,9,1017,1383,2,1,2,0,1,0,73.54
高雄市,苓雅區,苓中里,536,4,1082,16,1098,1627,2,1,2,0,1,0,67.49
高雄市,苓雅區,苓雅里,537,4,995,16,1011,1470,2,1,2,0,1,0,68.78
高雄市,苓雅區,苓東里,538,4,1037,23,1060,1577,2,1,2,0,1,0,67.22
高雄市,苓雅區,城北里,539,4,1017,22,1039,1550,2,1,2,0,1,0,67.03
高雄市,苓雅區,城西里,540,4,457,10,467,673,2,1,2,0,1,0,69.39
高雄市,苓雅區,城東里,541,4,666,18,684,1113,2,1,2,0,1,0,61.46
高雄市,苓雅區,城東里,542,4,575,13,588,868,2,1,2,0,1,0,67.74
高雄市,苓雅區,意誠里,543,4,838,12,850,1362,2,1,2,0,1,0,62.41
高雄市,苓雅區,意誠里,544,4,904,19,923,1559,2,1,2,0,1,0,59.2
高雄市,苓雅區,鼓中里,545,4,777,16,793,1080,2,1,2,0,1,0,73.43
高雄市,苓雅區,田西里,546,4,953,10,963,1377,2,1,2,0,1,0,69.93
高雄市,苓雅區,人和里,547,4,659,11,670,976,2,1,2,0,1,0,68.65
高雄市,苓雅區,人和里,548,4,547,6,553,880,2,1,2,0,1,0,62.84
高雄市,苓雅區,仁政里,549,4,854,15,869,1327,2,1,2,0,1,0,65.49
高雄市,苓雅區,廣澤里,550,4,753,14,767,1057,2,1,2,0,1,0,72.56
高雄市,苓雅區,廣澤里,551,4,672,16,688,921,2,1,2,0,1,0,74.7
高雄市,苓雅區,美田里,552,4,819,17,836,1231,2,1,2,0,1,0,67.91
高雄市,苓雅區,華堂里,553,4,993,14,1007,1493,2,1,2,0,1,0,67.45
高雄市,苓雅區,華堂里,554,4,948,14,962,1444,2,1,2,0,1,0,66.62
高雄市,苓雅區,日中里,555,4,801,28,829,1178,2,1,2,0,1,0,70.37
高雄市,苓雅區,日中里,556,4,682,15,697,1036,2,1,2,0,1,0,67.28
高雄市,苓雅區,普照里,557,4,851,15,866,1241,2,1,2,0,1,0,69.78
高雄市,苓雅區,普照里,558,4,878,15,893,1339,2,1,2,0,1,0,66.69
高雄市,苓雅區,和煦里,559,4,684,9,693,975,2,1,2,0,1,0,71.08
高雄市,苓雅區,和煦里,560,4,797,9,806,1159,2,1,2,0,1,0,69.54
高雄市,苓雅區,晴朗里,561,4,791,17,808,1899,2,1,2,0,1,0,42.55
高雄市,苓雅區,普天里,562,4,979,19,998,1466,2,1,2,0,1,0,68.08
高雄市,苓雅區,普天里,563,4,922,11,933,1389,2,1,2,0,1,0,67.17
高雄市,苓雅區,林富里,564,4,608,15,623,903,2,1,2,0,1,0,68.99
高雄市,苓雅區,林富里,565,4,644,11,655,942,2,1,2,0,1,0,69.53
高雄市,苓雅區,林圍里,566,4,714,19,733,1083,2,1,2,0,1,0,67.68
高雄市,苓雅區,林圍里,567,4,737,18,755,1106,2,1,2,0,1,0,68.26
高雄市,苓雅區,林安里,568,4,1062,14,1076,1540,2,1,2,0,1,0,69.87
高雄市,苓雅區,光華里,569,4,527,11,538,756,2,1,2,0,1,0,71.16
高雄市,苓雅區,林興里,570,4,985,19,1004,1405,2,1,2,0,1,0,71.46
高雄市,苓雅區,林華里,571,4,1031,25,1056,1519,2,1,2,0,1,0,69.52
高雄市,苓雅區,林華里,572,4,922,15,937,1420,2,1,2,0,1,0,65.99
高雄市,苓雅區,林西里,573,4,1120,24,1144,1710,2,1,2,0,1,0,66.9
高雄市,苓雅區,林中里,574,4,1029,24,1053,1530,2,1,2,0,1,0,68.82
高雄市,苓雅區,林中里,575,4,1108,22,1130,1642,2,1,2,0,1,0,68.82
高雄市,苓雅區,林泉里,576,4,1230,20,1250,1834,2,1,2,0,1,0,68.16
高雄市,苓雅區,林南里,577,4,1003,19,1022,1530,2,1,2,0,1,0,66.8
高雄市,苓雅區,林南里,578,4,904,21,925,1369,2,1,2,0,1,0,67.57
高雄市,苓雅區,中正里,579,4,830,19,849,1276,2,1,2,0,1,0,66.54
高雄市,苓雅區,中正里,580,4,875,13,888,1331,2,1,2,0,1,0,66.72
高雄市,苓雅區,尚義里,581,4,942,12,954,1429,2,1,2,0,1,0,66.76
高雄市,苓雅區,同慶里,582,4,745,18,763,1092,2,1,2,0,1,0,69.87
高雄市,苓雅區,同慶里,583,4,613,13,626,912,2,1,2,0,1,0,68.64
高雄市,苓雅區,凱旋里,584,4,1331,22,1353,1848,2,1,2,0,1,0,73.21
高雄市,苓雅區,安祥里,585,4,669,17,686,1055,2,1,2,0,1,0,65.02
高雄市,苓雅區,安祥里,586,4,890,25,915,1313,2,1,2,0,1,0,69.69
高雄市,苓雅區,奏捷里,587,4,1135,8,1143,1611,2,1,2,0,1,0,70.95
高雄市,苓雅區,福壽里,588,4,1062,13,1075,1526,2,1,2,0,1,0,70.45
高雄市,苓雅區,福南里,589,4,785,13,798,1119,2,1,2,0,1,0,71.31
高雄市,苓雅區,福南里,590,4,759,13,772,1140,2,1,2,0,1,0,67.72
高雄市,苓雅區,五權里,591,4,639,11,650,949,2,1,2,0,1,0,68.49
高雄市,苓雅區,五權里,592,4,702,17,719,1008,2,1,2,0,1,0,71.33
高雄市,苓雅區,民主里,593,4,848,17,865,1292,2,1,2,0,1,0,66.95
高雄市,苓雅區,民主里,594,4,767,13,780,1185,2,1,2,0,1,0,65.82
高雄市,苓雅區,民主里,595,4,891,15,906,1345,2,1,2,0,1,0,67.36
高雄市,苓雅區,林德里,596,4,631,12,643,941,2,1,2,0,1,0,68.33
高雄市,苓雅區,林德里,597,4,573,7,580,877,2,1,2,0,1,0,66.13
高雄市,苓雅區,林貴里,598,4,955,15,970,1349,2,1,2,0,1,0,71.91
高雄市,苓雅區,林榮里,599,4,938,19,957,1382,2,1,2,0,1,0,69.25
高雄市,苓雅區,林榮里,600,4,803,19,822,1182,2,1,2,0,1,0,69.54
高雄市,苓雅區,林榮里,601,4,887,14,901,1349,2,1,2,0,1,0,66.79
高雄市,苓雅區,英明里,602,4,656,6,662,1012,2,1,2,0,1,0,65.42
高雄市,苓雅區,英明里,603,4,665,16,681,1016,2,1,2,0,1,0,67.03
高雄市,苓雅區,林靖里,604,4,1077,9,1086,1538,2,1,2,0,1,0,70.61
高雄市,苓雅區,朝陽里,605,4,957,16,973,1458,2,1,2,0,1,0,66.74
高雄市,苓雅區,福隆里,606,4,904,15,919,1444,2,1,2,0,1,0,63.64
高雄市,苓雅區,福隆里,607,4,846,13,859,1249,2,1,2,0,1,0,68.78
高雄市,苓雅區,福祥里,608,4,900,10,910,1308,2,1,2,0,1,0,69.57
高雄市,苓雅區,福海里,609,4,757,15,772,1075,2,1,2,0,1,0,71.81
高雄市,苓雅區,福康里,610,4,606,12,618,901,2,1,2,0,1,0,68.59
高雄市,苓雅區,福康里,611,4,682,9,691,991,2,1,2,0,1,0,69.73
高雄市,苓雅區,福人里,612,4,750,10,760,1085,2,1,2,0,1,0,70.05
高雄市,苓雅區,福人里,613,4,681,21,702,1000,2,1,2,0,1,0,70.2
高雄市,苓雅區,福地里,614,4,984,23,1007,1349,2,1,2,0,1,0,74.65
高雄市,苓雅區,福地里,615,4,986,17,1003,1469,2,1,2,0,1,0,68.28
高雄市,苓雅區,福居里,616,4,924,21,945,1319,2,1,2,0,1,0,71.65
高雄市,苓雅區,福居里,617,4,1020,22,1042,1472,2,1,2,0,1,0,70.79
高雄市,苓雅區,福東里,618,4,805,7,812,1159,2,1,2,0,1,0,70.06
高雄市,苓雅區,福東里,619,4,927,22,949,1389,2,1,2,0,1,0,68.32
高雄市,苓雅區,福西里,620,4,653,16,669,943,2,1,2,0,1,0,70.94
高雄市,苓雅區,福西里,621,4,670,19,689,979,2,1,2,0,1,0,70.38
高雄市,苓雅區,永康里,622,4,792,12,804,1143,2,1,2,0,1,0,70.34
高雄市,苓雅區,永康里,623,4,826,10,836,1228,2,1,2,0,1,0,68.08
高雄市,苓雅區,正文里,624,4,1219,20,1239,1826,2,1,2,0,1,0,67.85
高雄市,苓雅區,正言里,625,4,766,16,782,1143,2,1,2,0,1,0,68.42
高雄市,苓雅區,正言里,626,4,1076,23,1099,1561,2,1,2,0,1,0,70.4
高雄市,苓雅區,正大里,627,4,967,23,990,1540,2,1,2,0,1,0,64.29
高雄市,苓雅區,正大里,628,4,1029,17,1046,1536,2,1,2,0,1,0,68.1
高雄市,苓雅區,正大里,629,4,953,24,977,1522,2,1,2,0,1,0,64.19
高雄市,苓雅區,五福里,630,4,835,20,855,1216,2,1,2,0,1,0,70.31
高雄市,苓雅區,五福里,631,4,789,21,810,1263,2,1,2,0,1,0,64.13
高雄市,苓雅區,五福里,632,4,851,15,866,1321,2,1,2,0,1,0,65.56
高雄市,苓雅區,正心里,633,4,1148,26,1174,1820,2,1,2,0,1,0,64.51
高雄市,苓雅區,正心里,634,4,1188,17,1205,1790,2,1,2,0,1,0,67.32
高雄市,苓雅區,正道里,635,4,828,17,845,1297,2,1,2,0,1,0,65.15
高雄市,苓雅區,正道里,636,4,966,12,978,1456,2,1,2,0,1,0,67.17
高雄市,苓雅區,正道里,637,4,904,15,919,1418,2,1,2,0,1,0,64.81
高雄市,苓雅區,正義里,638,4,838,19,857,1230,2,1,2,0,1,0,69.67
高雄市,苓雅區,正義里,639,4,771,12,783,1174,2,1,2,0,1,0,66.7
高雄市,苓雅區,正仁里,640,4,871,12,883,1244,2,1,2,0,1,0,70.98
高雄市,苓雅區,正仁里,641,4,831,10,841,1277,2,1,2,0,1,0,65.86
高雄市,苓雅區,文昌里,642,4,830,12,842,1176,2,1,2,0,1,0,71.6
高雄市,苓雅區,文昌里,643,4,860,14,874,1272,2,1,2,0,1,0,68.71
高雄市,苓雅區,文昌里,644,4,956,22,978,1361,2,1,2,0,1,0,71.86
高雄市,苓雅區,建軍里,645,4,658,15,673,986,2,1,2,0,1,0,68.26
高雄市,苓雅區,建軍里,646,4,724,14,738,1063,2,1,2,0,1,0,69.43
高雄市,苓雅區,衛武里,647,4,682,9,691,1077,2,1,2,0,1,0,64.16
高雄市,苓雅區,衛武里,648,4,662,10,672,1054,2,1,2,0,1,0,63.76
高雄市,前鎮區,草衙里,649,5,904,21,925,1321,2,1,2,0,1,0,70.02
高雄市,前鎮區,草衙里,650,5,1165,29,1194,1776,2,1,2,0,1,0,67.23
高雄市,前鎮區,草衙里,651,5,1082,22,1104,1729,2,1,2,0,1,0,63.85
高雄市,前鎮區,草衙里,652,5,1108,27,1135,1810,2,1,2,0,1,0,62.71
高雄市,前鎮區,草衙里,653,5,1007,23,1030,1643,2,1,2,0,1,0,62.69
高雄市,前鎮區,明孝里,654,5,1127,28,1155,1629,2,1,2,0,1,0,70.9
高雄市,前鎮區,明孝里,655,5,547,17,564,851,2,1,2,0,1,0,66.27
高雄市,前鎮區,明正里,656,5,1146,19,1165,1668,2,1,2,0,1,0,69.84
高雄市,前鎮區,明正里,657,5,1048,25,1073,1598,2,1,2,0,1,0,67.15
高雄市,前鎮區,明義里,658,5,715,19,734,1017,2,1,2,0,1,0,72.17
高雄市,前鎮區,明義里,659,5,743,16,759,1051,2,1,2,0,1,0,72.22
高雄市,前鎮區,仁愛里,660,5,923,11,934,1381,2,1,2,0,1,0,67.63
高雄市,前鎮區,德昌里,661,5,1214,23,1237,1807,2,1,2,0,1,0,68.46
高雄市,前鎮區,平等里,662,5,1167,19,1186,2404,2,1,2,0,1,0,49.33
高雄市,前鎮區,平昌里,663,5,413,11,424,661,2,1,2,0,1,0,64.15
高雄市,前鎮區,明禮里,664,5,1107,20,1127,1700,2,1,2,0,1,0,66.29
高雄市,前鎮區,信義里,665,5,1058,26,1084,1527,2,1,2,0,1,0,70.99
高雄市,前鎮區,信德里,666,5,682,15,697,1045,2,1,2,0,1,0,66.7
高雄市,前鎮區,信德里,667,5,851,15,866,1311,2,1,2,0,1,0,66.06
高雄市,前鎮區,明道里,668,5,869,15,884,1216,2,1,2,0,1,0,72.7
高雄市,前鎮區,興化里,669,5,544,8,552,750,2,1,2,0,1,0,73.6
高雄市,前鎮區,興仁里,670,5,550,13,563,855,2,1,2,0,1,0,65.85
高雄市,前鎮區,前鎮里,671,5,1093,30,1123,1533,2,1,2,0,1,0,73.26
高雄市,前鎮區,鎮東里,672,5,1327,38,1365,1862,2,1,2,0,1,0,73.31
高雄市,前鎮區,鎮榮里,673,5,901,17,918,1260,2,1,2,0,1,0,72.86
高雄市,前鎮區,鎮榮里,674,5,643,17,660,989,2,1,2,0,1,0,66.73
高雄市,前鎮區,鎮昌里,675,5,579,18,597,846,2,1,2,0,1,0,70.57
高雄市,前鎮區,鎮昌里,676,5,792,19,811,1191,2,1,2,0,1,0,68.09
高雄市,前鎮區,鎮海里,677,5,668,21,689,1055,2,1,2,0,1,0,65.31
高雄市,前鎮區,鎮海里,678,5,868,22,890,1384,2,1,2,0,1,0,64.31
高雄市,前鎮區,鎮海里,679,5,988,18,1006,1561,2,1,2,0,1,0,64.45
高雄市,前鎮區,鎮陽里,680,5,785,20,805,1075,2,1,2,0,1,0,74.88
高雄市,前鎮區,興邦里,681,5,718,21,739,1063,2,1,2,0,1,0,69.52
高雄市,前鎮區,興邦里,682,5,666,17,683,1006,2,1,2,0,1,0,67.89
高雄市,前鎮區,鎮中里,683,5,625,23,648,871,2,1,2,0,1,0,74.4
高雄市,前鎮區,鎮北里,684,5,792,22,814,1056,2,1,2,0,1,0,77.08
高雄市,前鎮區,忠純里,685,5,1114,12,1126,1546,2,1,2,0,1,0,72.83
高雄市,前鎮區,忠純里,686,5,1147,17,1164,1625,2,1,2,0,1,0,71.63
高雄市,前鎮區,忠純里,687,5,1159,23,1182,1739,2,1,2,0,1,0,67.97
高雄市,前鎮區,忠誠里,688,5,746,17,763,1017,2,1,2,0,1,0,75.02
高雄市,前鎮區,忠誠里,689,5,778,16,794,1031,2,1,2,0,1,0,77.01
高雄市,前鎮區,西山里,690,5,1120,40,1160,1711,2,1,2,0,1,0,67.8
高雄市,前鎮區,西山里,691,5,1162,19,1181,1686,2,1,2,0,1,0,70.05
高雄市,前鎮區,民權里,692,5,849,24,873,1215,2,1,2,0,1,0,71.85
高雄市,前鎮區,民權里,693,5,960,24,984,1347,2,1,2,0,1,0,73.05
高雄市,前鎮區,民權里,694,5,853,25,878,1297,2,1,2,0,1,0,67.69
高雄市,前鎮區,建隆里,695,5,566,16,582,835,2,1,2,0,1,0,69.7
高雄市,前鎮區,振興里,696,5,1412,34,1446,2056,2,1,2,0,1,0,70.33
高雄市,前鎮區,良和里,697,5,874,11,885,1264,2,1,2,0,1,0,70.02
高雄市,前鎮區,良和里,698,5,888,23,911,1351,2,1,2,0,1,0,67.43
高雄市,前鎮區,西甲里,699,5,1298,27,1325,1904,2,1,2,0,1,0,69.59
高雄市,前鎮區,盛興里,700,5,794,25,819,1285,2,1,2,0,1,0,63.74
高雄市,前鎮區,盛興里,701,5,739,19,758,1212,2,1,2,0,1,0,62.54
高雄市,前鎮區,盛豐里,702,5,908,20,928,1404,2,1,2,0,1,0,66.1
高雄市,前鎮區,盛豐里,703,5,904,39,943,1479,2,1,2,0,1,0,63.76
高雄市,前鎮區,興中里,704,5,993,22,1015,1510,2,1,2,0,1,0,67.22
高雄市,前鎮區,興中里,705,5,826,24,850,1432,2,1,2,0,1,0,59.36
高雄市,前鎮區,興東里,706,5,993,22,1015,1533,2,1,2,0,1,0,66.21
高雄市,前鎮區,興東里,707,5,1006,28,1034,1576,2,1,2,0,1,0,65.61
高雄市,前鎮區,興東里,708,5,1053,38,1091,1654,2,1,2,0,1,0,65.96
高雄市,前鎮區,忠孝里,709,5,774,25,799,1164,2,1,2,0,1,0,68.64
高雄市,前鎮區,忠孝里,710,5,803,17,820,1149,2,1,2,0,1,0,71.37
高雄市,前鎮區,復國里,711,5,866,12,878,1305,2,1,2,0,1,0,67.28
高雄市,前鎮區,復國里,712,5,1025,19,1044,1464,2,1,2,0,1,0,71.31
高雄市,前鎮區,竹內里,713,5,867,24,891,1212,2,1,2,0,1,0,73.51
高雄市,前鎮區,竹內里,714,5,916,11,927,1314,2,1,2,0,1,0,70.55
高雄市,前鎮區,竹東里,715,5,624,15,639,1052,2,1,2,0,1,0,60.74
高雄市,前鎮區,竹東里,716,5,681,24,705,1040,2,1,2,0,1,0,67.79
高雄市,前鎮區,竹南里,717,5,1029,35,1064,1731,2,1,2,0,1,0,61.47
高雄市,前鎮區,竹南里,718,5,1165,24,1189,1755,2,1,2,0,1,0,67.75
高雄市,前鎮區,竹北里,719,5,737,15,752,1131,2,1,2,0,1,0,66.49
高雄市,前鎮區,竹北里,720,5,579,14,593,905,2,1,2,0,1,0,65.52
高雄市,前鎮區,竹西里,721,5,845,29,874,1190,2,1,2,0,1,0,73.45
高雄市,前鎮區,竹西里,722,5,915,24,939,1314,2,1,2,0,1,0,71.46
高雄市,前鎮區,竹西里,723,5,902,26,928,1305,2,1,2,0,1,0,71.11
高雄市,前鎮區,竹中里,724,5,925,27,952,1453,2,1,2,0,1,0,65.52
高雄市,前鎮區,竹中里,725,5,1002,19,1021,1492,2,1,2,0,1,0,68.43
高雄市,前鎮區,瑞竹里,726,5,876,37,913,1315,2,1,2,0,1,0,69.43
高雄市,前鎮區,瑞南里,727,5,1021,20,1041,1482,2,1,2,0,1,0,70.24
高雄市,前鎮區,瑞南里,728,5,921,22,943,1391,2,1,2,0,1,0,67.79
高雄市,前鎮區,瑞南里,729,5,1074,29,1103,1594,2,1,2,0,1,0,69.2
高雄市,前鎮區,瑞豐里,730,5,973,26,999,1436,2,1,2,0,1,0,69.57
高雄市,前鎮區,瑞豐里,731,5,814,18,832,1168,2,1,2,0,1,0,71.23
高雄市,前鎮區,瑞祥里,732,5,1085,24,1109,1624,2,1,2,0,1,0,68.29
高雄市,前鎮區,瑞祥里,733,5,1108,26,1134,1620,2,1,2,0,1,0,70
高雄市,前鎮區,瑞祥里,734,5,953,18,971,1383,2,1,2,0,1,0,70.21
高雄市,前鎮區,瑞東里,735,5,800,16,816,1179,2,1,2,0,1,0,69.21
高雄市,前鎮區,瑞東里,736,5,833,24,857,1165,2,1,2,0,1,0,73.56
高雄市,前鎮區,瑞和里,737,5,611,14,625,908,2,1,2,0,1,0,68.83
高雄市,前鎮區,瑞和里,738,5,672,23,695,1054,2,1,2,0,1,0,65.94
高雄市,前鎮區,瑞平里,739,5,849,14,863,1208,2,1,2,0,1,0,71.44
高雄市,前鎮區,瑞平里,740,5,847,20,867,1190,2,1,2,0,1,0,72.86
高雄市,前鎮區,瑞平里,741,5,818,16,834,1241,2,1,2,0,1,0,67.2
高雄市,前鎮區,瑞隆里,742,5,779,10,789,1183,2,1,2,0,1,0,66.69
高雄市,前鎮區,瑞隆里,743,5,669,15,684,1014,2,1,2,0,1,0,67.46
高雄市,前鎮區,瑞隆里,744,5,770,18,788,1201,2,1,2,0,1,0,65.61
高雄市,前鎮區,瑞北里,745,5,962,17,979,1431,2,1,2,0,1,0,68.41
高雄市,前鎮區,瑞北里,746,5,961,25,986,1485,2,1,2,0,1,0,66.4
高雄市,前鎮區,瑞西里,747,5,950,18,968,1369,2,1,2,0,1,0,70.71
高雄市,前鎮區,瑞西里,748,5,834,15,849,1166,2,1,2,0,1,0,72.81
高雄市,前鎮區,瑞崗里,749,5,868,8,876,1217,2,1,2,0,1,0,71.98
高雄市,前鎮區,瑞崗里,750,5,812,17,829,1273,2,1,2,0,1,0,65.12
高雄市,前鎮區,瑞興里,751,5,862,20,882,1330,2,1,2,0,1,0,66.32
高雄市,前鎮區,瑞興里,752,5,792,13,805,1229,2,1,2,0,1,0,65.5
高雄市,前鎮區,瑞誠里,753,5,864,17,881,1314,2,1,2,0,1,0,67.05
高雄市,前鎮區,瑞誠里,754,5,773,13,786,1182,2,1,2,0,1,0,66.5
高雄市,前鎮區,瑞文里,755,5,815,21,836,1251,2,1,2,0,1,0,66.83
高雄市,前鎮區,瑞文里,756,5,745,19,764,1140,2,1,2,0,1,0,67.02
高雄市,前鎮區,瑞華里,757,5,874,22,896,1401,2,1,2,0,1,0,63.95
高雄市,前鎮區,瑞華里,758,5,918,20,938,1450,2,1,2,0,1,0,64.69
高雄市,前鎮區,瑞華里,759,5,847,26,873,1351,2,1,2,0,1,0,64.62
高雄市,前鎮區,瑞昌里,760,5,881,14,895,1332,2,1,2,0,1,0,67.19
高雄市,前鎮區,瑞昌里,761,5,868,19,887,1380,2,1,2,0,1,0,64.28
高雄市,小港區,小港里,762,5,1336,18,1354,1960,2,1,2,0,1,0,69.08
高雄市,小港區,港口里,763,5,1112,19,1131,1729,2,1,2,0,1,0,65.41
高雄市,小港區,港口里,764,5,1008,22,1030,1510,2,1,2,0,1,0,68.21
高雄市,小港區,港正里,765,5,764,16,780,1177,2,1,2,0,1,0,66.27
高雄市,小港區,港正里,766,5,881,21,902,1290,2,1,2,0,1,0,69.92
高雄市,小港區,港墘里,767,5,1120,19,1139,1568,2,1,2,0,1,0,72.64
高雄市,小港區,港明里,768,5,1053,19,1072,1519,2,1,2,0,1,0,70.57
高雄市,小港區,港明里,769,5,967,15,982,1391,2,1,2,0,1,0,70.6
高雄市,小港區,港后里,770,5,1393,19,1412,2006,2,1,2,0,1,0,70.39
高雄市,小港區,港南里,771,5,1125,23,1148,1922,2,1,2,0,1,0,59.73
高雄市,小港區,港興里,772,5,717,14,731,1043,2,1,2,0,1,0,70.09
高雄市,小港區,港興里,773,5,836,14,850,1205,2,1,2,0,1,0,70.54
高雄市,小港區,鳳宮里,774,5,1235,25,1260,1984,2,1,2,0,1,0,63.51
高雄市,小港區,店鎮里,775,5,952,25,977,1502,2,1,2,0,1,0,65.05
高雄市,小港區,店鎮里,776,5,1143,19,1162,1745,2,1,2,0,1,0,66.59
高雄市,小港區,店鎮里,777,5,1175,9,1184,1828,2,1,2,0,1,0,64.77
高雄市,小港區,大苓里,778,5,711,10,721,1101,2,1,2,0,1,0,65.49
高雄市,小港區,大苓里,779,5,850,22,872,1257,2,1,2,0,1,0,69.37
高雄市,小港區,二苓里,780,5,1112,24,1136,1676,2,1,2,0,1,0,67.78
高雄市,小港區,二苓里,781,5,1162,21,1183,1769,2,1,2,0,1,0,66.87
高雄市,小港區,三苓里,782,5,883,14,897,1368,2,1,2,0,1,0,65.57
高雄市,小港區,三苓里,783,5,935,20,955,1351,2,1,2,0,1,0,70.69
高雄市,小港區,正苓里,784,5,1147,23,1170,1813,2,1,2,0,1,0,64.53
高雄市,小港區,正苓里,785,5,1213,16,1229,1802,2,1,2,0,1,0,68.2
高雄市,小港區,順苓里,786,5,876,15,891,1428,2,1,2,0,1,0,62.39
高雄市,小港區,順苓里,787,5,787,15,802,1219,2,1,2,0,1,0,65.79
高雄市,小港區,順苓里,788,5,838,15,853,1299,2,1,2,0,1,0,65.67
高雄市,小港區,六苓里,789,5,1440,21,1461,2096,2,1,2,0,1,0,69.7
高雄市,小港區,宏亮里,790,5,799,27,826,1242,2,1,2,0,1,0,66.51
高雄市,小港區,宏亮里,791,5,1074,17,1091,1633,2,1,2,0,1,0,66.81
高雄市,小港區,山東里,792,5,683,11,694,987,2,1,2,0,1,0,70.31
高雄市,小港區,山東里,793,5,877,20,897,1315,2,1,2,0,1,0,68.21
高雄市,小港區,青島里,794,5,1331,24,1355,1919,2,1,2,0,1,0,70.61
高雄市,小港區,濟南里,795,5,1223,18,1241,1757,2,1,2,0,1,0,70.63
高雄市,小港區,濟南里,796,5,1168,13,1181,1612,2,1,2,0,1,0,73.26
高雄市,小港區,泰山里,797,5,838,10,848,1162,2,1,2,0,1,0,72.98
高雄市,小港區,泰山里,798,5,978,25,1003,1420,2,1,2,0,1,0,70.63
高雄市,小港區,山明里,799,5,1030,13,1043,1588,2,1,2,0,1,0,65.68
高雄市,小港區,山明里,800,5,887,13,900,1361,2,1,2,0,1,0,66.13
高雄市,小港區,山明里,801,5,907,13,920,1368,2,1,2,0,1,0,67.25
高雄市,小港區,山明里,802,5,969,13,982,1437,2,1,2,0,1,0,68.34
高雄市,小港區,山明里,803,5,961,17,978,1484,2,1,2,0,1,0,65.9
高雄市,小港區,高松里,804,5,903,25,928,1484,2,1,2,0,1,0,62.53
高雄市,小港區,高松里,805,5,1153,23,1176,1704,2,1,2,0,1,0,69.01
高雄市,小港區,松金里,806,5,738,11,749,1073,2,1,2,0,1,0,69.8
高雄市,小港區,松金里,807,5,722,18,740,1153,2,1,2,0,1,0,64.18
高雄市,小港區,松山里,808,5,809,16,825,1175,2,1,2,0,1,0,70.21
高雄市,小港區,松山里,809,5,770,22,792,1119,2,1,2,0,1,0,70.78
高雄市,小港區,大坪里,810,5,1008,18,1026,1515,2,1,2,0,1,0,67.72
高雄市,小港區,坪頂里,811,5,725,7,732,987,2,1,2,0,1,0,74.16
高雄市,小港區,坪頂里,812,5,962,21,983,1489,2,1,2,0,1,0,66.02
高雄市,小港區,孔宅里,813,5,805,11,816,1176,2,1,2,0,1,0,69.39
高雄市,小港區,孔宅里,814,5,701,10,711,1114,2,1,2,0,1,0,63.82
高雄市,小港區,孔宅里,815,5,577,13,590,910,2,1,2,0,1,0,64.84
高雄市,小港區,廈莊里,816,5,1324,34,1358,2054,2,1,2,0,1,0,66.11
高雄市,小港區,合作里,817,5,804,20,824,1164,2,1,2,0,1,0,70.79
高雄市,小港區,合作里,818,5,768,16,784,1128,2,1,2,0,1,0,69.5
高雄市,小港區,桂林里,819,5,922,23,945,1447,2,1,2,0,1,0,65.31
高雄市,小港區,桂林里,820,5,1053,28,1081,1591,2,1,2,0,1,0,67.94
高雄市,小港區,桂林里,821,5,1010,21,1031,1651,2,1,2,0,1,0,62.45
高雄市,小港區,桂林里,822,5,1013,18,1031,1549,2,1,2,0,1,0,66.56
高雄市,小港區,中厝里,823,5,788,19,807,1245,2,1,2,0,1,0,64.82
高雄市,小港區,中厝里,824,5,1006,25,1031,1627,2,1,2,0,1,0,63.37
高雄市,小港區,鳳鳴里,825,5,923,10,933,1238,2,1,2,0,1,0,75.36
高雄市,小港區,鳳鳴里,826,5,864,13,877,1186,2,1,2,0,1,0,73.95
高雄市,小港區,龍鳳里,827,5,766,13,779,1086,2,1,2,0,1,0,71.73
高雄市,小港區,龍鳳里,828,5,838,16,854,1191,2,1,2,0,1,0,71.7
高雄市,小港區,鳳森里,829,5,1179,19,1198,1727,2,1,2,0,1,0,69.37
高雄市,小港區,鳳林里,830,5,778,20,798,1150,2,1,2,0,1,0,69.39
高雄市,小港區,鳳林里,831,5,799,18,817,1165,2,1,2,0,1,0,70.13
高雄市,小港區,鳳興里,832,5,1299,23,1322,1787,2,1,2,0,1,0,73.98
高雄市,小港區,鳳源里,833,5,789,11,800,1088,2,1,2,0,1,0,73.53
高雄市,小港區,鳳源里,834,5,1048,19,1067,1602,2,1,2,0,1,0,66.6
高雄市,小港區,海澄里,835,5,680,8,688,988,2,1,2,0,1,0,69.64
高雄市,小港區,海昌里,836,5,377,1,378,548,2,1,2,0,1,0,68.98
高雄市,小港區,海豐里,837,5,263,5,268,409,2,1,2,0,1,0,65.53
高雄市,小港區,海原里,838,5,354,5,359,549,2,1,2,0,1,0,65.39
高雄市,小港區,海城里,839,5,408,7,415,615,2,1,2,0,1,0,67.48
