CountyCityName,TownshipName,VillageName,PollStationNo,DistrictName,BallotsAccepted,BallotsRejected,BallotsCast,Voters,CandidateCounts,ElectedCounts,CandidateMaleCounts,CandidateFemaleCounts,ElectedMaleCounts,ElectedFemaleCounts,BallotsRate
全國,,,0,0,56363,1246,57609,106061,69,23,60,9,20,3,54.75
臺北縣,,,0,11,3983,103,4086,10170,3,1,3,0,1,0,40.18
桃園縣,,,0,13,4001,130,4131,7990,6,2,5,1,1,1,51.70
苗栗縣,,,0,7,1242,37,1279,2047,2,1,2,0,1,0,62.48
臺中縣,,,0,8,1070,37,1107,1879,2,1,2,0,1,0,58.91
高雄縣,,,0,9,722,20,742,1121,7,1,5,2,1,0,66.19
屏東縣,,,0,8,1180,45,1225,1637,2,1,2,0,1,0,74.83
臺東縣,,,0,9,22544,397,22941,41260,23,8,20,3,7,1,55.60
花蓮縣,,,0,7,19856,458,20314,36886,22,7,19,3,6,1,55.07
基隆市,,,0,8,1765,19,1784,3071,2,1,2,0,1,0,58.09
臺北縣,,,0,11,3983,103,4086,10170,3,1,3,0,1,0,40.18
桃園縣,,,0,13,4001,130,4131,7990,6,2,5,1,1,1,51.70
苗栗縣,,,0,7,1242,37,1279,2047,2,1,2,0,1,0,62.48
臺中縣,,,0,8,1070,37,1107,1879,2,1,2,0,1,0,58.91
高雄縣,,,0,9,722,20,742,1121,7,1,5,2,1,0,66.19
屏東縣,,,0,8,1180,45,1225,1637,2,1,2,0,1,0,74.83
臺東縣,,,0,9,6084,124,6208,10458,6,2,5,1,2,0,59.36
臺東縣,,,0,9,5425,117,5542,8998,6,2,6,0,2,0,61.59
臺東縣,,,0,9,2687,50,2737,4991,3,1,3,0,1,0,54.84
臺東縣,,,0,9,8348,106,8454,16813,8,3,6,2,2,1,50.28
花蓮縣,,,0,7,6328,162,6490,11852,6,2,5,1,1,1,54.76
花蓮縣,,,0,7,8273,144,8417,14496,9,3,9,0,3,0,58.06
花蓮縣,,,0,7,5255,152,5407,10538,7,2,5,2,2,0,51.31
基隆市,,,0,8,1765,19,1784,3071,2,1,2,0,1,0,58.09
臺北縣,板橋市,,0,11,220,5,225,684,11,4,7,4,3,1,32.89
臺北縣,三重市,,0,11,92,2,94,284,23,9,18,5,6,3,33.10
臺北縣,中和市,,0,11,182,10,192,504,18,10,14,4,8,2,38.10
臺北縣,永和市,,0,11,53,2,55,141,33,10,27,6,8,2,39.01
臺北縣,新莊市,,0,11,310,9,319,1003,7,3,6,1,3,0,31.80
臺北縣,新店市,,0,11,242,7,249,643,12,4,9,3,3,1,38.72
臺北縣,樹林市,,0,11,607,13,620,1359,2,1,2,0,1,0,45.62
臺北縣,鶯歌鎮,,0,11,119,4,123,362,11,5,8,3,4,1,33.98
臺北縣,三峽鎮,,0,11,116,3,119,329,11,6,8,3,5,1,36.17
臺北縣,淡水鎮,,0,11,69,0,69,226,3,2,1,2,1,1,30.53
臺北縣,汐止市,,0,11,586,9,595,1376,5,3,5,0,3,0,43.24
臺北縣,瑞芳鎮,,0,11,273,6,279,508,5,2,3,2,2,0,54.92
臺北縣,土城市,,0,11,521,12,533,1309,4,2,4,0,2,0,40.72
臺北縣,蘆洲市,,0,11,160,5,165,436,9,5,7,2,4,1,37.84
臺北縣,五股鄉,,0,11,86,1,87,237,7,3,6,1,3,0,36.71
臺北縣,泰山鄉,,0,11,88,2,90,193,8,4,4,4,3,1,46.63
臺北縣,林口鄉,,0,11,100,7,107,237,3,2,3,0,2,0,45.15
臺北縣,深坑鄉,,0,11,13,1,14,33,5,3,4,1,3,0,42.42
臺北縣,石碇鄉,,0,11,1,0,1,3,32,11,27,5,8,3,33.33
臺北縣,坪林鄉,,0,11,1,1,2,3,9,4,6,3,3,1,66.67
臺北縣,三芝鄉,,0,11,13,1,14,46,18,5,16,2,3,2,30.43
臺北縣,石門鄉,,0,11,4,0,4,11,6,3,5,1,3,0,36.36
臺北縣,八里鄉,,0,11,27,1,28,77,6,2,5,1,2,0,36.36
臺北縣,平溪鄉,,0,11,11,0,11,13,10,3,9,1,3,0,84.62
臺北縣,雙溪鄉,,0,11,3,1,4,4,30,10,26,4,8,2,100.00
臺北縣,貢寮鄉,,0,11,4,0,4,10,21,6,17,4,4,2,40.00
臺北縣,金山鄉,,0,11,8,1,9,14,13,4,8,5,3,1,64.29
臺北縣,萬里鄉,,0,11,49,0,49,88,6,3,5,1,2,1,55.68
臺北縣,烏來鄉,,0,11,25,0,25,37,5,2,5,0,2,0,67.57
桃園縣,桃園市,,0,13,298,8,306,721,5,2,5,0,2,0,42.44
桃園縣,中壢市,,0,13,340,8,348,767,15,7,13,2,5,2,45.37
桃園縣,大溪鎮,,0,13,784,23,807,1302,11,5,7,4,3,2,61.98
桃園縣,楊梅鎮,,0,13,115,4,119,315,9,4,5,4,3,1,37.78
桃園縣,蘆竹鄉,,0,13,151,8,159,383,3,2,3,0,2,0,41.51
桃園縣,大園鄉,,0,13,356,12,368,653,6,3,6,0,3,0,56.36
桃園縣,龜山鄉,,0,13,567,19,586,1139,1,1,1,0,1,0,51.45
桃園縣,八德市,,0,13,697,20,717,1299,6,2,6,0,2,0,55.20
桃園縣,龍潭鄉,,0,13,219,9,228,436,21,7,18,3,6,1,52.29
桃園縣,平鎮市,,0,13,379,15,394,796,3,1,3,0,1,0,49.50
桃園縣,新屋鄉,,0,13,31,0,31,56,24,9,19,5,7,2,55.36
桃園縣,觀音鄉,,0,13,26,2,28,59,7,3,7,0,3,0,47.46
桃園縣,復興鄉,,0,13,38,2,40,64,12,6,10,2,5,1,62.50
苗栗縣,苗栗市,,0,7,11,0,11,34,16,8,13,3,6,2,32.35
苗栗縣,苑裡鎮,,0,7,5,0,5,9,21,7,17,4,6,1,55.56
苗栗縣,通霄鎮,,0,7,11,1,12,24,9,3,7,2,3,0,50.00
苗栗縣,竹南鎮,,0,7,19,1,20,51,21,8,16,5,6,2,39.22
苗栗縣,頭份鎮,,0,7,111,9,120,215,18,8,13,5,6,2,55.81
苗栗縣,後龍鎮,,0,7,8,0,8,16,9,4,7,2,3,1,50.00
苗栗縣,卓蘭鎮,,0,7,3,1,4,4,11,5,9,2,4,1,100.00
苗栗縣,大湖鄉,,0,7,2,0,2,6,20,8,16,4,6,2,33.33
苗栗縣,公館鄉,,0,7,7,0,7,13,15,7,13,2,5,2,53.85
苗栗縣,銅鑼鄉,,0,7,6,0,6,14,24,9,19,5,6,3,42.86
苗栗縣,南庄鄉,,0,7,959,25,984,1492,13,6,11,2,5,1,65.95
苗栗縣,頭屋鄉,,0,7,2,0,2,3,24,12,17,7,9,3,66.67
苗栗縣,三義鄉,,0,7,5,0,5,11,11,7,9,2,5,2,45.45
苗栗縣,西湖鄉,,0,7,5,0,5,7,12,6,9,3,5,1,71.43
苗栗縣,造橋鄉,,0,7,6,0,6,15,17,8,14,3,6,2,40.00
苗栗縣,三灣鄉,,0,7,6,0,6,8,9,5,6,3,4,1,75.00
苗栗縣,獅潭鄉,,0,7,64,0,64,109,10,5,7,3,4,1,58.72
苗栗縣,泰安鄉,,0,7,12,0,12,16,9,5,7,2,4,1,75.00
臺中縣,豐原市,,0,8,49,1,50,89,10,5,8,2,4,1,56.18
臺中縣,東勢鎮,,0,8,17,1,18,28,27,10,23,4,8,2,64.29
臺中縣,大甲鎮,,0,8,4,0,4,19,17,8,12,5,6,2,21.05
臺中縣,清水鎮,,0,8,18,0,18,44,6,4,4,2,3,1,40.91
臺中縣,沙鹿鎮,,0,8,35,1,36,51,12,5,9,3,4,1,70.59
臺中縣,梧棲鎮,,0,8,118,4,122,165,28,8,21,7,6,2,73.94
臺中縣,后里鄉,,0,8,30,1,31,50,20,9,14,6,7,2,62.00
臺中縣,神岡鄉,,0,8,39,0,39,73,11,6,9,2,5,1,53.42
臺中縣,潭子鄉,,0,8,77,2,79,143,16,9,12,4,7,2,55.24
臺中縣,大雅鄉,,0,8,131,2,133,225,10,7,8,2,5,2,59.11
臺中縣,新社鄉,,0,8,11,0,11,12,12,6,11,1,5,1,91.67
臺中縣,石岡鄉,,0,8,0,0,0,2,9,6,6,3,5,1,0.00
臺中縣,外埔鄉,,0,8,14,0,14,16,12,7,7,5,6,1,87.50
臺中縣,大安鄉,,0,8,3,0,3,3,14,7,11,3,4,3,100.00
臺中縣,烏日鄉,,0,8,27,1,28,53,10,5,6,4,3,2,52.83
臺中縣,大肚鄉,,0,8,115,5,120,201,11,6,7,4,4,2,59.70
臺中縣,龍井鄉,,0,8,59,4,63,82,7,4,4,3,2,2,76.83
臺中縣,霧峰鄉,,0,8,19,1,20,43,11,7,8,3,5,2,46.51
臺中縣,太平市,,0,8,165,10,175,349,12,6,9,3,5,1,50.14
臺中縣,大里市,,0,8,71,4,75,133,9,4,7,2,2,2,56.39
臺中縣,和平鄉,,0,8,68,0,68,98,12,6,7,5,4,2,69.39
高雄縣,鳳山市,,0,9,234,4,238,404,4,3,4,0,3,0,58.91
高雄縣,林園鄉,,0,9,54,0,54,77,2,1,0,2,0,1,70.13
高雄縣,大寮鄉,,0,9,142,3,145,196,28,10,23,5,8,2,73.98
高雄縣,大樹鄉,,0,9,12,0,12,19,3,1,2,1,1,0,63.16
高雄縣,大社鄉,,0,9,11,0,11,14,5,2,5,0,2,0,78.57
高雄縣,仁武鄉,,0,9,94,6,100,132,6,3,5,1,2,1,75.76
高雄縣,鳥松鄉,,0,9,9,0,9,16,3,1,2,1,1,0,56.25
高雄縣,岡山鎮,,0,9,33,0,33,55,14,9,10,4,7,2,60.00
高雄縣,橋頭鄉,,0,9,7,0,7,12,2,1,2,0,1,0,58.33
高雄縣,燕巢鄉,,0,9,4,0,4,5,19,9,15,4,6,3,80.00
高雄縣,田寮鄉,,0,9,1,0,1,3,8,4,6,2,3,1,33.33
高雄縣,阿蓮鄉,,0,9,2,0,2,5,26,11,18,8,9,2,40.00
高雄縣,路竹鄉,,0,9,4,2,6,9,6,2,6,0,2,0,66.67
高雄縣,湖內鄉,,0,9,18,0,18,22,3,2,3,0,2,0,81.82
高雄縣,茄萣鄉,,0,9,5,0,5,11,5,2,4,1,1,1,45.45
高雄縣,永安鄉,,0,9,2,1,3,6,2,1,2,0,1,0,50.00
高雄縣,彌陀鄉,,0,9,5,0,5,9,2,1,2,0,1,0,55.56
高雄縣,梓官鄉,,0,9,17,2,19,28,13,5,9,4,4,1,67.86
高雄縣,旗山鎮,,0,9,2,0,2,5,9,4,6,3,3,1,40.00
高雄縣,美濃鎮,,0,9,8,0,8,15,9,4,7,2,3,1,53.33
高雄縣,六龜鄉,,0,9,4,0,4,7,7,4,5,2,3,1,57.14
高雄縣,甲仙鄉,,0,9,11,0,11,13,12,7,10,2,5,2,84.62
高雄縣,杉林鄉,,0,9,4,0,4,7,5,3,5,0,3,0,57.14
高雄縣,內門鄉,,0,9,1,1,2,5,13,4,10,3,3,1,40.00
高雄縣,茂林鄉,,0,9,24,1,25,30,25,10,20,5,7,3,83.33
高雄縣,桃源鄉,,0,9,7,0,7,8,8,4,5,3,3,1,87.50
高雄縣,三民鄉,,0,9,7,0,7,8,6,3,5,1,3,0,87.50
屏東縣,屏東市,,0,8,132,3,135,192,28,8,21,7,6,2,70.31
屏東縣,潮州鎮,,0,8,24,1,25,39,14,6,10,4,4,2,64.10
屏東縣,東港鎮,,0,8,10,0,10,20,11,6,9,2,5,1,50.00
屏東縣,恆春鎮,,0,8,88,2,90,116,17,7,14,3,6,1,77.59
屏東縣,萬丹鄉,,0,8,7,0,7,10,18,8,12,6,6,2,70.00
屏東縣,長治鄉,,0,8,7,1,8,10,19,8,12,7,5,3,80.00
屏東縣,麟洛鄉,,0,8,3,0,3,3,14,6,12,2,5,1,100.00
屏東縣,九如鄉,,0,8,5,0,5,7,24,11,19,5,9,2,71.43
屏東縣,里港鄉,,0,8,3,1,4,8,31,11,22,9,9,2,50.00
屏東縣,鹽埔鄉,,0,8,4,0,4,5,30,12,22,8,9,3,80.00
屏東縣,高樹鄉,,0,8,5,0,5,6,21,10,15,6,8,2,83.33
屏東縣,萬巒鄉,,0,8,17,0,17,23,16,7,13,3,4,3,73.91
屏東縣,內埔鄉,,0,8,18,1,19,40,8,5,6,2,3,2,47.50
屏東縣,竹田鄉,,0,8,4,0,4,5,20,7,17,3,6,1,80.00
屏東縣,新埤鄉,,0,8,4,0,4,12,27,9,22,5,7,2,33.33
屏東縣,枋寮鄉,,0,8,20,4,24,33,7,3,7,0,3,0,72.73
屏東縣,新園鄉,,0,8,8,1,9,18,48,18,31,17,14,4,50.00
屏東縣,崁頂鄉,,0,8,2,0,2,2,11,5,9,2,4,1,100.00
屏東縣,林邊鄉,,0,8,4,1,5,11,2,1,2,0,1,0,45.45
屏東縣,南州鄉,,0,8,1,0,1,1,2,1,2,0,1,0,100.00
屏東縣,佳冬鄉,,0,8,4,0,4,6,3,1,3,0,1,0,66.67
屏東縣,琉球鄉,,0,8,8,1,9,10,6,1,6,0,1,0,90.00
屏東縣,車城鄉,,0,8,28,2,30,33,6,1,6,0,1,0,90.91
屏東縣,滿州鄉,,0,8,588,16,604,737,6,1,6,0,1,0,81.95
屏東縣,枋山鄉,,0,8,21,2,23,24,6,1,6,0,1,0,95.83
屏東縣,三地門鄉,,0,8,14,2,16,26,6,1,6,0,1,0,61.54
屏東縣,霧臺鄉,,0,8,27,0,27,28,6,1,6,0,1,0,96.43
屏東縣,瑪家鄉,,0,8,16,1,17,33,6,1,6,0,1,0,51.52
屏東縣,泰武鄉,,0,8,4,1,5,6,6,1,6,0,1,0,83.33
屏東縣,來義鄉,,0,8,9,2,11,25,6,1,6,0,1,0,44.00
屏東縣,春日鄉,,0,8,34,0,34,48,6,1,6,0,1,0,70.83
屏東縣,獅子鄉,,0,8,24,0,24,36,6,1,6,0,1,0,66.67
屏東縣,牡丹鄉,,0,8,37,3,40,64,6,1,6,0,1,0,62.50
臺東縣,臺東市,,0,6,6084,124,6208,10458,6,1,6,0,1,0,59.36
臺東縣,卑南鄉,,0,7,2043,49,2092,3396,6,1,6,0,1,0,61.60
臺東縣,太麻里鄉,,0,7,1895,45,1940,3260,6,1,6,0,1,0,59.51
臺東縣,大武鄉,,0,7,1341,18,1359,2093,6,1,6,0,1,0,64.93
臺東縣,金峰鄉,,0,7,92,5,97,125,6,1,6,0,1,0,77.60
臺東縣,達仁鄉,,0,7,41,0,41,98,6,1,6,0,1,0,41.84
臺東縣,蘭嶼鄉,,0,7,13,0,13,26,6,1,6,0,1,0,50.00
臺東縣,關山鎮,,0,8,790,17,807,1562,6,1,6,0,1,0,51.66
臺東縣,鹿野鄉,,0,8,989,21,1010,1728,6,1,6,0,1,0,58.45
臺東縣,池上鄉,,0,8,812,10,822,1521,6,1,6,0,1,0,54.04
臺東縣,海端鄉,,0,8,48,1,49,98,6,1,6,0,1,0,50.00
臺東縣,延平鄉,,0,8,48,1,49,82,6,1,6,0,1,0,59.76
臺東縣,成功鎮,,0,9,3564,40,3604,7364,6,1,6,0,1,0,48.94
臺東縣,東河鄉,,0,9,2381,35,2416,4708,6,1,6,0,1,0,51.32
臺東縣,長濱鄉,,0,9,2394,31,2425,4728,6,1,6,0,1,0,51.29
臺東縣,綠島鄉,,0,9,9,0,9,13,6,1,6,0,1,0,69.23
花蓮縣,花蓮市,,0,5,1744,54,1798,3535,6,1,6,0,1,0,50.86
花蓮縣,新城鄉,,0,5,995,18,1013,1926,6,1,6,0,1,0,52.60
花蓮縣,吉安鄉,,0,5,3492,81,3573,6209,6,1,6,0,1,0,57.55
花蓮縣,秀林鄉,,0,5,97,9,106,182,6,1,6,0,1,0,58.24
花蓮縣,鳳林鎮,,0,6,658,6,664,1248,6,1,6,0,1,0,53.21
花蓮縣,壽豐鄉,,0,6,2379,48,2427,3767,6,1,6,0,1,0,64.43
花蓮縣,光復鄉,,0,6,3232,52,3284,5740,6,1,6,0,1,0,57.21
花蓮縣,豐濱鄉,,0,6,1965,29,1994,3653,6,1,6,0,1,0,54.59
花蓮縣,萬榮鄉,,0,7,39,9,48,88,6,1,6,0,1,0,54.55
花蓮縣,玉里鎮,,0,7,2939,79,3018,5752,6,1,6,0,1,0,52.47
花蓮縣,瑞穗鄉,,0,7,1744,55,1799,3497,6,1,6,0,1,0,51.44
花蓮縣,富里鄉,,0,7,517,16,533,1194,6,1,6,0,1,0,44.64
花蓮縣,卓溪鄉,,0,7,55,2,57,95,6,1,6,0,1,0,60.00
基隆市,中正區,,0,8,1155,10,1165,1927,6,1,6,0,1,0,60.46
基隆市,七堵區,,0,8,336,5,341,566,6,1,6,0,1,0,60.25
基隆市,暖暖區,,0,8,80,2,82,151,6,1,6,0,1,0,54.30
基隆市,仁愛區,,0,8,32,0,32,69,6,1,6,0,1,0,46.38
基隆市,中山區,,0,8,29,1,30,80,6,1,6,0,1,0,37.50
基隆市,安樂區,,0,8,90,1,91,182,6,1,6,0,1,0,50.00
基隆市,信義區,,0,8,43,0,43,96,6,1,6,0,1,0,44.79
