CountyCityName,TownshipName,VillageName,PollStationNo,DistrictName,BallotsAccepted,BallotsRejected,BallotsCast,Voters,CandidateCounts,ElectedCounts,CandidateMaleCounts,CandidateFemaleCounts,ElectedMaleCounts,ElectedFemaleCounts,BallotsRate
全國,,,0,0,10284454,335176,10619630,13897056,420,228,341,79,185,43,76.42
臺北市,,,0,3,1330739,51646,1382385,1807897,50,27,42,8,23,4,76.46
高雄市,,,0,2,707065,22034,729099,934369,29,15,24,5,12,3,78.03
臺北縣,,,0,7,1572400,56309,1628709,2116627,59,33,49,10,28,5,76.95
宜蘭縣,,,0,2,221424,5220,226644,305335,8,5,5,3,3,2,74.23
桃園縣,,,0,5,723056,24362,747418,953883,28,16,24,4,15,1,78.36
新竹縣,,,0,1,201565,5901,207466,259188,8,5,5,3,3,2,80.04
苗栗縣,,,0,2,279816,9179,288995,368940,13,6,11,2,4,2,78.33
臺中縣,,,0,4,686929,21717,708646,882151,25,14,19,6,10,4,80.33
彰化縣,,,0,4,617662,27829,645491,834434,25,13,20,5,9,4,77.36
南投縣,,,0,2,257562,7709,265271,354246,11,6,9,2,5,1,74.88
雲林縣,,,0,2,349169,12154,361323,517484,16,8,13,3,7,1,69.82
嘉義縣,,,0,2,264888,9535,274423,391771,10,6,6,4,4,2,70.05
臺南縣,,,0,2,537586,15469,553055,735331,18,11,14,4,9,2,75.21
高雄縣,,,0,4,600600,18578,619178,790585,26,12,23,3,10,2,78.32
屏東縣,,,0,2,431385,8393,439778,585772,16,10,14,2,8,2,75.08
臺東縣,,,0,1,77414,1608,79022,122114,5,3,4,1,2,1,64.71
花蓮縣,,,0,1,126809,3850,130659,189412,7,4,7,0,4,0,68.98
澎湖縣,,,0,1,39701,1222,40923,63104,4,2,3,1,2,0,64.85
基隆市,,,0,1,185787,5744,191531,248554,7,4,4,3,3,1,77.06
新竹市,,,0,1,172296,2854,175150,223899,9,4,8,1,4,0,78.23
臺中市,,,0,2,407286,10182,417468,542764,15,9,11,4,8,1,76.92
嘉義市,,,0,1,125865,3002,128867,173063,7,3,6,1,2,1,74.46
臺南市,,,0,2,344586,9983,354569,462166,15,8,12,3,6,2,76.72
金門縣,,,0,1,20275,663,20938,30173,5,2,4,1,2,0,69.39
連江縣,,,0,1,2589,33,2622,3794,4,2,4,0,2,0,69.11
臺北市,,,0,3,456603,18678,475281,618917,17,9,15,2,7,2,76.79
臺北市,,,0,3,399078,15665,414743,534664,16,8,14,2,8,0,77.57
臺北市,,,0,3,475058,17303,492361,654316,17,10,13,4,8,2,75.25
高雄市,,,0,2,387202,11809,399011,508901,15,8,13,2,7,1,78.41
高雄市,,,0,2,319863,10225,330088,425468,14,7,11,3,5,2,77.58
臺北縣,,,0,7,211394,6417,217811,281630,9,5,8,1,4,1,77.34
臺北縣,,,0,7,247908,8755,256663,334033,9,5,7,2,4,1,76.84
臺北縣,,,0,7,255569,9464,265033,341528,9,5,7,2,4,1,77.60
臺北縣,,,0,7,220382,8340,228722,296988,10,5,7,3,4,1,77.01
臺北縣,,,0,7,309071,10591,319662,415093,10,6,9,1,6,0,77.01
臺北縣,,,0,7,143048,4711,147759,196659,5,3,4,1,2,1,75.13
臺北縣,,,0,7,185028,8031,193059,250696,7,4,7,0,4,0,77.01
宜蘭縣,,,0,2,109130,2430,111560,150080,4,2,3,1,2,0,74.33
宜蘭縣,,,0,2,112294,2790,115084,155255,4,3,2,2,1,2,74.13
桃園縣,,,0,5,126028,4751,130779,167178,5,3,5,0,3,0,78.23
桃園縣,,,0,5,145941,4951,150892,192716,6,3,5,1,3,0,78.30
桃園縣,,,0,5,158033,5755,163788,212577,6,4,6,0,4,0,77.05
桃園縣,,,0,5,117069,3422,120491,151683,4,2,3,1,2,0,79.44
桃園縣,,,0,5,175985,5483,181468,229729,7,4,5,2,3,1,78.99
新竹縣,,,0,1,201565,5901,207466,259188,8,5,5,3,3,2,80.04
苗栗縣,,,0,2,176305,6338,182643,235738,9,4,7,2,2,2,77.48
苗栗縣,,,0,2,103511,2841,106352,133202,4,2,4,0,2,0,79.84
臺中縣,,,0,4,236079,6615,242694,303270,7,5,4,3,3,2,80.03
臺中縣,,,0,4,92943,3630,96573,116526,5,2,5,0,2,0,82.88
臺中縣,,,0,4,184299,4894,189193,231606,6,3,4,2,1,2,81.69
臺中縣,,,0,4,173608,6578,180186,230749,7,4,6,1,4,0,78.09
彰化縣,,,0,4,203665,8136,211801,267944,9,4,6,3,1,3,79.05
彰化縣,,,0,4,134977,7896,142873,183770,4,3,3,1,2,1,77.75
彰化縣,,,0,4,151281,6483,157764,200397,7,3,6,1,3,0,78.73
彰化縣,,,0,4,127739,5314,133053,182323,5,3,5,0,3,0,72.98
南投縣,,,0,2,135337,3682,139019,186166,6,3,4,2,2,1,74.67
南投縣,,,0,2,122225,4027,126252,168080,5,3,5,0,3,0,75.11
雲林縣,,,0,2,181485,5678,187163,252339,10,4,7,3,3,1,74.17
雲林縣,,,0,2,167684,6476,174160,265145,6,4,6,0,4,0,65.68
嘉義縣,,,0,2,137635,5368,143003,201919,4,3,2,2,1,2,70.82
嘉義縣,,,0,2,127253,4167,131420,189852,6,3,4,2,3,0,69.22
臺南縣,,,0,2,268705,8008,276713,377034,9,6,8,1,5,1,73.39
臺南縣,,,0,2,268881,7461,276342,358297,9,5,6,3,4,1,77.13
高雄縣,,,0,4,148502,4708,153210,197984,6,3,6,0,3,0,77.39
高雄縣,,,0,4,167168,5094,172262,220535,7,3,6,1,3,0,78.11
高雄縣,,,0,4,201617,7163,208780,259897,9,4,9,0,4,0,80.33
高雄縣,,,0,4,83313,1613,84926,112169,4,2,2,2,0,2,75.71
屏東縣,,,0,2,242762,4641,247403,323957,8,5,7,1,4,1,76.37
屏東縣,,,0,2,188623,3752,192375,261815,8,5,7,1,4,1,73.48
臺東縣,,,0,1,77414,1608,79022,122114,5,3,4,1,2,1,64.71
花蓮縣,,,0,1,126809,3850,130659,189412,7,4,7,0,4,0,68.98
澎湖縣,,,0,1,39701,1222,40923,63104,4,2,3,1,2,0,64.85
基隆市,,,0,1,185787,5744,191531,248554,7,4,4,3,3,1,77.06
新竹市,,,0,1,172296,2854,175150,223899,9,4,8,1,4,0,78.23
臺中市,,,0,2,206364,6173,212537,279711,8,5,5,3,5,0,75.98
臺中市,,,0,2,200922,4009,204931,263053,7,4,6,1,3,1,77.90
嘉義市,,,0,1,125865,3002,128867,173063,7,3,6,1,2,1,74.46
臺南市,,,0,2,189966,5546,195512,256023,6,4,5,1,3,1,76.37
臺南市,,,0,2,154620,4437,159057,206143,9,4,7,2,3,1,77.16
金門縣,,,0,1,20275,663,20938,30173,5,2,4,1,2,0,69.39
連江縣,,,0,1,2589,33,2622,3794,4,2,4,0,2,0,69.11
臺北市,中山區,,0,1,109370,4772,114142,157057,2,1,2,0,1,0,72.68
臺北市,大同區,,0,1,69998,2898,72896,93344,4,1,4,0,1,0,78.09
臺北市,士林區,,0,1,152390,5748,158138,203841,5,1,5,0,1,0,77.58
臺北市,北投區,,0,1,124845,5260,130105,164675,3,1,3,0,1,0,79.01
臺北市,松山區,,0,2,104416,3927,108343,145659,3,1,3,0,1,0,74.38
臺北市,信義區,,0,2,126286,5039,131325,170451,5,1,5,0,1,0,77.05
臺北市,南港區,,0,2,56856,2335,59191,73897,4,1,4,0,1,0,80.10
臺北市,內湖區,,0,2,111520,4364,115884,144657,4,1,4,0,1,0,80.11
臺北市,大安區,,0,3,161611,5946,167557,231876,2,1,2,0,1,0,72.26
臺北市,中正區,,0,3,84595,3087,87682,115892,3,1,3,0,1,0,75.66
臺北市,萬華區,,0,3,111640,4305,115945,150507,3,1,3,0,1,0,77.04
臺北市,文山區,,0,3,117212,3965,121177,156041,5,1,3,2,0,1,77.66
高雄市,鹽埕區,,0,1,17932,509,18441,23626,2,1,2,0,1,0,78.05
高雄市,鼓山區,,0,1,56786,1562,58348,74611,2,1,2,0,1,0,78.20
高雄市,左營區,,0,1,65332,1918,67250,85152,4,1,4,0,1,0,78.98
高雄市,楠梓區,,0,1,68162,2024,70186,87944,2,1,2,0,1,0,79.81
高雄市,三民區,,0,1,162746,5232,167978,215198,2,1,2,0,1,0,78.06
高雄市,旗津區,,0,1,16244,564,16808,22370,2,1,2,0,1,0,75.14
高雄市,新興區,,0,2,33663,1039,34702,44568,3,1,3,0,1,0,77.86
高雄市,前金區,,0,2,19160,541,19701,25572,2,1,2,0,1,0,77.04
高雄市,苓雅區,,0,2,105554,3606,109160,140313,2,1,2,0,1,0,77.80
高雄市,前鎮區,,0,2,98128,3064,101192,130811,2,1,2,0,1,0,77.36
高雄市,小港區,,0,2,63358,1975,65333,84204,2,1,2,0,1,0,77.59
臺北縣,樹林市,,0,1,61217,1690,62907,80359,1,1,1,0,1,0,78.28
臺北縣,鶯歌鎮,,0,1,33155,1053,34208,43184,2,1,2,0,1,0,79.21
臺北縣,三峽鎮,,0,1,33334,1012,34346,44836,2,1,2,0,1,0,76.60
臺北縣,土城市,,0,1,83688,2662,86350,113251,4,1,4,0,1,0,76.25
臺北縣,板橋市,,0,2,247908,8755,256663,334033,3,1,3,0,1,0,76.84
臺北縣,三重市,,0,3,182974,6827,189801,244603,4,1,3,1,1,0,77.60
臺北縣,蘆洲市,,0,3,61727,2223,63950,82555,2,1,1,1,1,0,77.46
臺北縣,八里鄉,,0,3,10868,414,11282,14370,2,1,2,0,1,0,78.51
臺北縣,新莊市,,0,4,147186,5901,153087,200236,4,1,4,0,1,0,76.45
臺北縣,五股鄉,,0,4,26672,713,27385,35196,3,1,3,0,1,0,77.81
臺北縣,泰山鄉,,0,4,27549,938,28487,35857,2,1,2,0,1,0,79.45
臺北縣,林口鄉,,0,4,18975,788,19763,25699,2,1,2,0,1,0,76.90
臺北縣,中和市,,0,5,191374,6829,198203,258114,4,1,3,1,1,0,76.79
臺北縣,永和市,,0,5,117697,3762,121459,156979,1,1,1,0,1,0,77.37
臺北縣,新店市,,0,6,125958,3988,129946,172907,2,1,1,1,1,0,75.15
臺北縣,深坑鄉,,0,6,8739,383,9122,11764,6,1,5,1,1,0,77.54
臺北縣,石碇鄉,,0,6,4305,147,4452,5966,3,1,2,1,0,1,74.62
臺北縣,坪林鄉,,0,6,3026,159,3185,4623,3,1,3,0,1,0,68.89
臺北縣,烏來鄉,,0,6,1020,34,1054,1399,2,1,1,1,1,0,75.34
臺北縣,淡水鎮,,0,7,48091,2823,50914,63957,3,1,3,0,1,0,79.61
臺北縣,汐止市,,0,7,59062,2236,61298,79636,4,1,4,0,1,0,76.97
臺北縣,瑞芳鎮,,0,7,25970,885,26855,36275,2,1,2,0,1,0,74.03
臺北縣,三芝鄉,,0,7,10405,689,11094,12946,2,1,0,2,0,1,85.69
臺北縣,石門鄉,,0,7,5524,210,5734,7053,3,1,3,0,1,0,81.30
臺北縣,平溪鄉,,0,7,3468,125,3593,5100,5,1,4,1,1,0,70.45
臺北縣,雙溪鄉,,0,7,5908,114,6022,8347,3,1,3,0,1,0,72.15
臺北縣,貢寮鄉,,0,7,6826,229,7055,10348,4,1,4,0,1,0,68.18
臺北縣,金山鄉,,0,7,9952,359,10311,13439,5,1,4,1,0,1,76.72
臺北縣,萬里鄉,,0,7,9822,361,10183,13595,4,1,3,1,1,0,74.90
宜蘭縣,宜蘭市,,0,1,44284,1028,45312,59681,2,1,2,0,1,0,75.92
宜蘭縣,頭城鎮,,0,1,16671,330,17001,23171,4,1,4,0,1,0,73.37
宜蘭縣,礁溪鄉,,0,1,18984,382,19366,25838,3,1,3,0,1,0,74.95
宜蘭縣,壯圍鄉,,0,1,12505,292,12797,17585,2,1,2,0,1,0,72.77
宜蘭縣,員山鄉,,0,1,16070,385,16455,22849,4,1,4,0,1,0,72.02
宜蘭縣,大同鄉,,0,1,616,13,629,956,3,1,2,1,1,0,65.79
宜蘭縣,羅東鎮,,0,2,32183,764,32947,43238,3,1,3,0,1,0,76.20
宜蘭縣,蘇澳鎮,,0,2,23863,573,24436,33586,2,1,1,1,1,0,72.76
宜蘭縣,冬山鄉,,0,2,25316,661,25977,34921,2,1,1,1,1,0,74.39
宜蘭縣,五結鄉,,0,2,19282,447,19729,26347,2,1,1,1,1,0,74.88
宜蘭縣,三星鄉,,0,2,11098,326,11424,16267,2,1,1,1,1,0,70.23
宜蘭縣,南澳鄉,,0,2,552,19,571,896,2,1,1,1,1,0,63.73
桃園縣,桃園市,,0,1,126028,4751,130779,167178,2,1,1,1,1,0,78.23
桃園縣,中壢市,,0,2,145941,4951,150892,192716,2,1,1,1,1,0,78.30
桃園縣,大溪鎮,,0,3,39471,1200,40671,51448,2,1,1,1,1,0,79.05
桃園縣,龜山鄉,,0,3,48027,1721,49748,66021,2,1,1,1,1,0,75.35
桃園縣,八德市,,0,3,68748,2768,71516,92420,2,1,1,1,1,0,77.38
桃園縣,復興鄉,,0,3,1787,66,1853,2688,2,1,1,1,1,0,68.94
桃園縣,蘆竹鄉,,0,4,33762,1136,34898,43141,2,1,1,1,1,0,80.89
桃園縣,大園鄉,,0,4,33745,882,34627,43234,2,1,1,1,1,0,80.09
桃園縣,新屋鄉,,0,4,24854,760,25614,32632,2,1,1,1,1,0,78.49
桃園縣,觀音鄉,,0,4,24708,644,25352,32676,3,1,3,0,1,0,77.59
桃園縣,楊梅鎮,,0,5,53055,1529,54584,69078,3,1,3,0,1,0,79.02
桃園縣,龍潭鄉,,0,5,44165,1153,45318,57057,3,1,3,0,1,0,79.43
桃園縣,平鎮市,,0,5,78765,2801,81566,103594,4,1,4,0,1,0,78.74
新竹縣,竹北市,,0,1,37019,1265,38284,48272,2,1,2,0,1,0,79.31
新竹縣,竹東鎮,,0,1,41239,1207,42446,52661,5,1,5,0,1,0,80.60
新竹縣,新埔鎮,,0,1,19156,659,19815,24475,3,1,3,0,1,0,80.96
新竹縣,關西鎮,,0,1,17588,482,18070,22520,4,1,4,0,1,0,80.24
新竹縣,湖口鄉,,0,1,30380,895,31275,38952,4,1,3,1,1,0,80.29
新竹縣,新豐鄉,,0,1,19830,460,20290,25900,2,1,2,0,1,0,78.34
新竹縣,芎林鄉,,0,1,10230,251,10481,12838,2,1,2,0,1,0,81.64
新竹縣,橫山鄉,,0,1,8761,226,8987,11072,3,1,3,0,1,0,81.17
新竹縣,北埔鄉,,0,1,5971,158,6129,7587,3,1,3,0,1,0,80.78
新竹縣,寶山鄉,,0,1,6550,180,6730,8417,2,1,2,0,1,0,79.96
新竹縣,峨眉鄉,,0,1,3824,76,3900,5000,4,1,4,0,1,0,78.00
新竹縣,尖石鄉,,0,1,779,23,802,1090,3,1,2,1,0,1,73.58
新竹縣,五峰鄉,,0,1,238,19,257,404,5,1,5,0,1,0,63.61
苗栗縣,苗栗市,,0,1,44715,1789,46504,59421,2,1,2,0,1,0,78.26
苗栗縣,頭份鎮,,0,1,40646,1257,41903,53692,3,1,3,0,1,0,78.04
苗栗縣,卓蘭鎮,,0,1,10529,361,10890,13899,2,1,2,0,1,0,78.35
苗栗縣,大湖鄉,,0,1,9247,360,9607,13054,3,1,3,0,1,0,73.59
苗栗縣,公館鄉,,0,1,17414,579,17993,23113,2,1,2,0,1,0,77.85
苗栗縣,銅鑼鄉,,0,1,10626,401,11027,14378,3,1,3,0,1,0,76.69
苗栗縣,南庄鄉,,0,1,5984,178,6162,8331,2,1,1,1,0,1,73.96
苗栗縣,頭屋鄉,,0,1,6776,247,7023,8836,2,1,1,1,1,0,79.48
苗栗縣,三義鄉,,0,1,9130,419,9549,12022,4,1,4,0,1,0,79.43
苗栗縣,西湖鄉,,0,1,4905,169,5074,6976,5,1,4,1,1,0,72.74
苗栗縣,造橋鄉,,0,1,7699,242,7941,9974,3,1,2,1,0,1,79.62
苗栗縣,三灣鄉,,0,1,4561,139,4700,5990,2,1,2,0,1,0,78.46
苗栗縣,獅潭鄉,,0,1,3099,150,3249,4526,2,1,2,0,1,0,71.79
苗栗縣,泰安鄉,,0,1,974,47,1021,1526,3,1,2,1,1,0,66.91
苗栗縣,苑裡鎮,,0,2,25581,551,26132,32515,2,1,2,0,1,0,80.37
苗栗縣,通霄鎮,,0,2,22194,580,22774,28749,3,1,3,0,1,0,79.22
苗栗縣,竹南鎮,,0,2,33317,1043,34360,41959,4,1,4,0,1,0,81.89
苗栗縣,後龍鎮,,0,2,22419,667,23086,29979,5,1,3,2,0,1,77.01
臺中縣,豐原市,,0,1,78245,2198,80443,99985,2,1,2,0,1,0,80.46
臺中縣,東勢鎮,,0,1,31452,750,32202,40943,3,1,3,0,1,0,78.65
臺中縣,神岡鄉,,0,1,29182,837,30019,36983,2,1,2,0,1,0,81.17
臺中縣,潭子鄉,,0,1,37560,986,38546,47739,5,1,5,0,1,0,80.74
臺中縣,大雅鄉,,0,1,32264,1087,33351,41885,1,1,1,0,1,0,79.63
臺中縣,新社鄉,,0,1,14843,430,15273,19038,4,1,4,0,1,0,80.22
臺中縣,石岡鄉,,0,1,8439,248,8687,10815,3,1,3,0,1,0,80.32
臺中縣,和平鄉,,0,1,4094,79,4173,5882,2,1,2,0,1,0,70.95
臺中縣,大甲鎮,,0,2,37761,1573,39334,47845,3,1,3,0,1,0,82.21
臺中縣,后里鄉,,0,2,28545,1184,29729,35740,4,1,4,0,1,0,83.18
臺中縣,外埔鄉,,0,2,15307,522,15829,18870,4,1,3,1,1,0,83.88
臺中縣,大安鄉,,0,2,11330,351,11681,14071,4,1,4,0,1,0,83.01
臺中縣,清水鎮,,0,3,42721,890,43611,53761,2,1,2,0,1,0,81.12
臺中縣,沙鹿鎮,,0,3,34555,947,35502,43170,3,1,3,0,1,0,82.24
臺中縣,梧棲鎮,,0,3,23339,534,23873,28808,3,1,2,1,0,1,82.87
臺中縣,烏日鄉,,0,3,30451,976,31427,38476,1,1,1,0,1,0,81.68
臺中縣,大肚鄉,,0,3,25411,786,26197,31895,2,1,1,1,1,0,82.14
臺中縣,龍井鄉,,0,3,27822,761,28583,35496,3,1,2,1,0,1,80.52
臺中縣,霧峰鄉,,0,4,33921,904,34825,42816,4,1,4,0,1,0,81.34
臺中縣,太平市,,0,4,68017,2769,70786,92262,2,1,2,0,1,0,76.72
臺中縣,大里市,,0,4,71670,2905,74575,95671,4,1,3,1,1,0,77.95
彰化縣,彰化市,,0,1,105964,4605,110569,139943,2,1,2,0,1,0,79.01
彰化縣,和美鎮,,0,1,39570,1337,40907,51073,2,1,2,0,1,0,80.10
彰化縣,線西鄉,,0,1,8238,254,8492,10535,5,1,5,0,1,0,80.61
彰化縣,伸港鄉,,0,1,14805,566,15371,19952,4,1,4,0,1,0,77.04
彰化縣,花壇鄉,,0,1,21420,899,22319,28312,4,1,4,0,1,0,78.83
彰化縣,芬園鄉,,0,1,13668,475,14143,18129,2,1,2,0,1,0,78.01
彰化縣,鹿港鎮,,0,2,37062,2623,39685,51463,3,1,3,0,1,0,77.11
彰化縣,福興鄉,,0,2,22446,949,23395,29890,2,1,2,0,1,0,78.27
彰化縣,秀水鄉,,0,2,16825,1108,17933,22521,3,1,3,0,1,0,79.63
彰化縣,溪湖鎮,,0,2,24962,1275,26237,33994,2,1,2,0,1,0,77.18
彰化縣,埔鹽鄉,,0,2,17506,903,18409,23588,2,1,2,0,1,0,78.04
彰化縣,埔心鄉,,0,2,16176,1038,17214,22314,2,1,1,1,0,1,77.14
彰化縣,員林鎮,,0,3,59098,2655,61753,77985,2,1,2,0,1,0,79.19
彰化縣,田中鎮,,0,3,22847,1103,23950,31575,2,1,1,1,1,0,75.85
彰化縣,大村鄉,,0,3,17569,589,18158,22448,2,1,2,0,1,0,80.89
彰化縣,永靖鄉,,0,3,19883,741,20624,25989,3,1,3,0,1,0,79.36
彰化縣,社頭鄉,,0,3,21634,1066,22700,28778,2,1,2,0,1,0,78.88
彰化縣,二水鄉,,0,3,10250,329,10579,13622,2,1,2,0,1,0,77.66
彰化縣,北斗鎮,,0,4,15527,793,16320,21271,2,1,2,0,1,0,76.72
彰化縣,二林鎮,,0,4,27576,1252,28828,38232,2,1,2,0,1,0,75.40
彰化縣,田尾鄉,,0,4,14676,470,15146,19400,3,1,3,0,1,0,78.07
彰化縣,埤頭鄉,,0,4,15809,774,16583,22370,3,1,2,1,1,0,74.13
彰化縣,芳苑鄉,,0,4,18496,748,19244,28808,3,1,3,0,1,0,66.80
彰化縣,大城鄉,,0,4,10069,442,10511,16255,2,1,2,0,1,0,64.66
彰化縣,竹塘鄉,,0,4,8871,280,9151,12751,2,1,2,0,1,0,71.77
彰化縣,溪州鄉,,0,4,16715,555,17270,23236,1,1,1,0,1,0,74.32
南投縣,南投市,,0,1,51193,1226,52419,66479,3,1,3,0,1,0,78.85
南投縣,竹山鎮,,0,1,29577,866,30443,42541,1,1,1,0,1,0,71.56
南投縣,集集鎮,,0,1,6583,157,6740,9011,2,1,2,0,1,0,74.80
南投縣,名間鄉,,0,1,21112,637,21749,29548,2,1,2,0,1,0,73.61
南投縣,鹿谷鄉,,0,1,10951,334,11285,15437,2,1,2,0,1,0,73.10
南投縣,水里鄉,,0,1,11871,348,12219,16999,4,1,4,0,1,0,71.88
南投縣,信義鄉,,0,1,4050,114,4164,6151,6,1,6,0,1,0,67.70
南投縣,埔里鎮,,0,2,41721,1359,43080,58233,3,1,2,1,0,1,73.98
南投縣,草屯鎮,,0,2,46649,1501,48150,61712,6,1,6,0,1,0,78.02
南投縣,中寮鄉,,0,2,9962,418,10380,13957,2,1,2,0,1,0,74.37
南投縣,魚池鄉,,0,2,9564,167,9731,13223,1,1,1,0,1,0,73.59
南投縣,國姓鄉,,0,2,12490,512,13002,18240,4,1,4,0,1,0,71.28
南投縣,仁愛鄉,,0,2,1839,70,1909,2715,2,1,2,0,1,0,70.31
雲林縣,斗六市,,0,1,46374,1905,48279,62474,2,1,2,0,1,0,77.28
雲林縣,斗南鎮,,0,1,23417,933,24350,31985,4,1,2,2,0,1,76.13
雲林縣,西螺鎮,,0,1,24539,565,25104,34305,2,1,2,0,1,0,73.18
雲林縣,古坑鄉,,0,1,18432,540,18972,26005,3,1,2,1,1,0,72.96
雲林縣,大埤鄉,,0,1,11884,387,12271,17016,2,1,2,0,1,0,72.11
雲林縣,莿桐鄉,,0,1,15807,358,16165,21509,1,1,1,0,1,0,75.15
雲林縣,林內鄉,,0,1,10792,303,11095,14450,2,1,2,0,1,0,76.78
雲林縣,二崙鄉,,0,1,16184,319,16503,23868,1,1,1,0,1,0,69.14
雲林縣,崙背鄉,,0,1,14056,368,14424,20727,3,1,3,0,1,0,69.59
雲林縣,虎尾鎮,,0,2,30557,1765,32322,44332,1,1,1,0,1,0,72.91
雲林縣,土庫鎮,,0,2,15203,634,15837,22639,2,1,2,0,1,0,69.95
雲林縣,北港鎮,,0,2,21253,1230,22483,33125,2,1,2,0,1,0,67.87
雲林縣,麥寮鄉,,0,2,14326,337,14663,21513,2,1,2,0,1,0,68.16
雲林縣,東勢鄉,,0,2,8764,146,8910,14200,3,1,3,0,1,0,62.75
雲林縣,褒忠鄉,,0,2,7224,210,7434,10734,1,1,1,0,1,0,69.26
雲林縣,臺西鄉,,0,2,13026,258,13284,21412,2,1,2,0,1,0,62.04
雲林縣,元長鄉,,0,2,14930,434,15364,24349,2,1,2,0,1,0,63.10
雲林縣,四湖鄉,,0,2,12890,420,13310,23645,3,1,3,0,1,0,56.29
雲林縣,口湖鄉,,0,2,14510,394,14904,24063,1,1,1,0,1,0,61.94
雲林縣,水林鄉,,0,2,15001,648,15649,25133,7,1,7,0,1,0,62.26
嘉義縣,太保市,,0,1,13743,527,14270,19894,2,1,2,0,1,0,71.73
嘉義縣,大林鎮,,0,1,17649,819,18468,26018,4,1,3,1,1,0,70.98
嘉義縣,溪口鄉,,0,1,8648,422,9070,13650,5,1,4,1,1,0,66.45
嘉義縣,鹿草鄉,,0,1,9379,397,9776,14337,3,1,3,0,1,0,68.19
嘉義縣,水上鄉,,0,1,25993,1039,27032,36776,2,1,2,0,1,0,73.50
嘉義縣,中埔鄉,,0,1,21716,807,22523,31728,3,1,3,0,1,0,70.99
嘉義縣,竹崎鄉,,0,1,19709,666,20375,28970,4,1,3,1,0,1,70.33
嘉義縣,梅山鄉,,0,1,12085,372,12457,17274,2,1,2,0,1,0,72.11
嘉義縣,番路鄉,,0,1,5808,245,6053,8515,3,1,3,0,1,0,71.09
嘉義縣,大埔鄉,,0,1,1724,44,1768,2807,2,1,2,0,1,0,62.99
嘉義縣,里山鄉,,0,1,1181,30,1211,1950,2,1,2,0,1,0,62.10
嘉義縣,朴子市,,0,2,20585,772,21357,30540,3,1,3,0,1,0,69.93
嘉義縣,布袋鎮,,0,2,16265,527,16792,24905,2,1,2,0,1,0,67.42
嘉義縣,民雄鄉,,0,2,31698,882,32580,43860,2,1,2,0,1,0,74.28
嘉義縣,新港鄉,,0,2,16934,538,17472,25637,2,1,2,0,1,0,68.15
嘉義縣,六腳鄉,,0,2,14722,510,15232,23174,1,1,1,0,1,0,65.73
嘉義縣,東石鄉,,0,2,14677,520,15197,23476,2,1,2,0,1,0,64.73
嘉義縣,義竹鄉,,0,2,12372,418,12790,18260,3,1,3,0,1,0,70.04
臺南縣,新營市,,0,1,35506,1073,36579,49591,3,1,2,1,1,0,73.76
臺南縣,鹽水鎮,,0,1,14299,490,14789,20881,4,1,4,0,1,0,70.83
臺南縣,白河鎮,,0,1,18409,642,19051,27182,4,1,4,0,1,0,70.09
臺南縣,柳營鄉,,0,1,12648,396,13044,17588,2,1,2,0,1,0,74.16
臺南縣,後壁鄉,,0,1,15442,486,15928,21800,3,1,3,0,1,0,73.06
臺南縣,東山鄉,,0,1,12861,357,13218,19724,2,1,2,0,1,0,67.01
臺南縣,麻豆鎮,,0,1,24517,730,25247,32894,2,1,2,0,1,0,76.75
臺南縣,下營鄉,,0,1,14590,481,15071,20202,3,1,3,0,1,0,74.60
臺南縣,六甲鄉,,0,1,12405,382,12787,17221,2,1,2,0,1,0,74.25
臺南縣,官田鄉,,0,1,13226,268,13494,17389,3,1,3,0,1,0,77.60
臺南縣,大內鄉,,0,1,6823,170,6993,9512,5,1,5,0,1,0,73.52
臺南縣,佳里鎮,,0,1,26821,964,27785,37071,3,1,3,0,1,0,74.95
臺南縣,學甲鎮,,0,1,15263,376,15639,21274,4,1,4,0,1,0,73.51
臺南縣,西港鄉,,0,1,12602,410,13012,17014,2,1,2,0,1,0,76.48
臺南縣,七股鄉,,0,1,14202,361,14563,19634,3,1,3,0,1,0,74.17
臺南縣,將軍鄉,,0,1,12229,278,12507,17722,2,1,2,0,1,0,70.57
臺南縣,北門鄉,,0,1,6862,144,7006,10335,4,1,3,1,1,0,67.79
臺南縣,新化鎮,,0,2,22075,703,22778,29373,2,1,2,0,1,0,77.55
臺南縣,善化鎮,,0,2,21635,494,22129,28638,4,1,4,0,1,0,77.27
臺南縣,新市鄉,,0,2,15294,465,15759,19947,2,1,2,0,1,0,79.00
臺南縣,安定鄉,,0,2,14736,552,15288,19925,3,1,3,0,1,0,76.73
臺南縣,山上鄉,,0,2,4346,117,4463,5842,3,1,3,0,1,0,76.40
臺南縣,玉井鄉,,0,2,9067,217,9284,12584,2,1,1,1,1,0,73.78
臺南縣,楠西鄉,,0,2,6384,166,6550,9191,3,1,2,1,0,1,71.27
臺南縣,南化鄉,,0,2,5280,109,5389,7339,2,1,2,0,1,0,73.43
臺南縣,左鎮鄉,,0,2,3617,80,3697,5060,2,1,2,0,1,0,73.06
臺南縣,仁德鄉,,0,2,32367,848,33215,42172,5,1,5,0,1,0,78.76
臺南縣,歸仁鄉,,0,2,28647,847,29494,37728,2,1,2,0,1,0,78.18
臺南縣,關廟鄉,,0,2,20708,465,21173,26707,3,1,3,0,1,0,79.28
臺南縣,龍崎鄉,,0,2,2850,72,2922,3825,2,1,2,0,1,0,76.39
臺南縣,永康市,,0,2,81875,2326,84201,109966,2,1,2,0,1,0,76.57
高雄縣,鳳山市,,0,1,148502,4708,153210,197984,4,1,4,0,1,0,77.39
高雄縣,林園鄉,,0,2,32906,1099,34005,44615,4,1,4,0,1,0,76.22
高雄縣,大寮鄉,,0,2,56187,1489,57676,73052,2,1,2,0,1,0,78.95
高雄縣,大樹鄉,,0,2,24197,633,24830,31601,2,1,2,0,1,0,78.57
高雄縣,大社鄉,,0,2,15682,507,16189,20598,2,1,2,0,1,0,78.60
高雄縣,仁武鄉,,0,2,21350,799,22149,28493,2,1,2,0,1,0,77.73
高雄縣,鳥松鄉,,0,2,16846,567,17413,22176,2,1,2,0,1,0,78.52
高雄縣,岡山鎮,,0,3,45963,1885,47848,59168,2,1,2,0,1,0,80.87
高雄縣,橋頭鄉,,0,3,20285,804,21089,25578,1,1,1,0,1,0,82.45
高雄縣,燕巢鄉,,0,3,17551,607,18158,22864,2,1,2,0,1,0,79.42
高雄縣,田寮鄉,,0,3,5610,134,5744,7718,2,1,2,0,1,0,74.42
高雄縣,阿蓮鄉,,0,3,15541,427,15968,20015,2,1,2,0,1,0,79.78
高雄縣,路竹鄉,,0,3,27770,879,28649,34736,2,1,2,0,1,0,82.48
高雄縣,湖內鄉,,0,3,13882,583,14465,18267,2,1,2,0,1,0,79.19
高雄縣,茄萣鄉,,0,3,16588,553,17141,22315,2,1,2,0,1,0,76.81
高雄縣,永安鄉,,0,3,6930,204,7134,8988,3,1,2,1,1,0,79.37
高雄縣,彌陀鄉,,0,3,11513,367,11880,14480,2,1,2,0,1,0,82.04
高雄縣,梓官鄉,,0,3,19984,720,20704,25768,2,1,2,0,1,0,80.35
高雄縣,旗山鎮,,0,4,24784,604,25388,32729,3,1,3,0,1,0,77.57
高雄縣,美濃鎮,,0,4,26392,416,26808,35377,1,1,1,0,1,0,75.78
高雄縣,六龜鄉,,0,4,9061,204,9265,13185,2,1,2,0,1,0,70.27
高雄縣,甲仙鄉,,0,4,4834,68,4902,6460,1,1,1,0,1,0,75.88
高雄縣,杉林鄉,,0,4,7366,119,7485,10301,2,1,2,0,1,0,72.66
高雄縣,內門鄉,,0,4,10427,193,10620,13445,2,1,2,0,1,0,78.99
高雄縣,茂林鄉,,0,4,58,2,60,90,2,1,2,0,1,0,66.67
高雄縣,桃源鄉,,0,4,224,4,228,339,2,1,2,0,1,0,67.26
高雄縣,三民鄉,,0,4,167,3,170,243,2,1,2,0,1,0,69.96
屏東縣,屏東市,,0,1,105403,1793,107196,140853,2,1,2,0,1,0,76.10
屏東縣,萬丹鄉,,0,1,27390,641,28031,35078,3,1,3,0,1,0,79.91
屏東縣,長治鄉,,0,1,15238,314,15552,20078,4,1,3,1,1,0,77.46
屏東縣,麟洛鄉,,0,1,6348,81,6429,8133,3,1,2,1,1,0,79.05
屏東縣,九如鄉,,0,1,11694,207,11901,15204,2,1,2,0,1,0,78.28
屏東縣,里港鄉,,0,1,14183,245,14428,18608,2,1,1,1,0,1,77.54
屏東縣,鹽埔鄉,,0,1,14469,343,14812,19357,2,1,2,0,1,0,76.52
屏東縣,高樹鄉,,0,1,15767,405,16172,22714,3,1,2,1,1,0,71.20
屏東縣,內埔鄉,,0,1,31765,588,32353,43167,3,1,3,0,1,0,74.95
屏東縣,地門鄉,,0,1,246,11,257,372,2,1,2,0,1,0,69.09
屏東縣,霧臺鄉,,0,1,26,1,27,49,3,1,2,1,1,0,55.10
屏東縣,瑪家鄉,,0,1,233,12,245,344,3,1,3,0,1,0,71.22
屏東縣,潮州鎮,,0,2,27402,488,27890,37387,2,1,2,0,1,0,74.60
屏東縣,東港鎮,,0,2,23250,595,23845,31315,1,1,1,0,1,0,76.15
屏東縣,恆春鎮,,0,2,13815,303,14118,21921,3,1,2,1,1,0,64.40
屏東縣,萬巒鄉,,0,2,12812,245,13057,17380,3,1,3,0,1,0,75.13
屏東縣,竹田鄉,,0,2,10780,225,11005,14075,2,1,2,0,1,0,78.19
屏東縣,新埤鄉,,0,2,6467,124,6591,9087,2,1,2,0,1,0,72.53
屏東縣,枋寮鄉,,0,2,15463,237,15700,21231,3,1,3,0,1,0,73.95
屏東縣,新園鄉,,0,2,21661,353,22014,27515,9,1,8,1,1,0,80.01
屏東縣,崁頂鄉,,0,2,7304,134,7438,9528,3,1,3,0,1,0,78.06
屏東縣,林邊鄉,,0,2,12085,235,12320,16191,1,1,1,0,1,0,76.09
屏東縣,南州鄉,,0,2,7330,123,7453,9712,3,1,3,0,1,0,76.74
屏東縣,佳冬鄉,,0,2,12745,281,13026,17395,3,1,3,0,1,0,74.88
屏東縣,琉球鄉,,0,2,4726,102,4828,8495,3,1,3,0,1,0,56.83
屏東縣,車城鄉,,0,2,5290,138,5428,8488,3,1,3,0,1,0,63.95
屏東縣,滿州鄉,,0,2,3227,84,3311,5419,1,1,1,0,1,0,61.10
屏東縣,枋山鄉,,0,2,3157,57,3214,4970,2,1,2,0,1,0,64.67
屏東縣,泰武鄉,,0,2,105,4,109,165,2,1,2,0,1,0,66.06
屏東縣,來義鄉,,0,2,294,11,305,422,2,1,2,0,1,0,72.27
屏東縣,春日鄉,,0,2,285,6,291,427,2,1,2,0,1,0,68.15
屏東縣,獅子鄉,,0,2,182,2,184,293,2,1,2,0,1,0,62.80
屏東縣,牡丹鄉,,0,2,243,5,248,399,2,1,2,0,1,0,62.16
臺東縣,臺東市,,0,1,42387,904,43291,63734,2,1,2,0,1,0,67.92
臺東縣,成功鎮,,0,1,4090,63,4153,6532,2,1,2,0,1,0,63.58
臺東縣,關山鎮,,0,1,4091,83,4174,6483,2,1,2,0,1,0,64.38
臺東縣,卑南鄉,,0,1,7333,168,7501,11639,2,1,2,0,1,0,64.45
臺東縣,鹿野鄉,,0,1,3491,92,3583,5923,2,1,2,0,1,0,60.49
臺東縣,池上鄉,,0,1,4183,77,4260,6811,2,1,2,0,1,0,62.55
臺東縣,東河鄉,,0,1,2483,45,2528,4941,2,1,2,0,1,0,51.16
臺東縣,長濱鄉,,0,1,1999,43,2042,3753,2,1,2,0,1,0,54.41
臺東縣,太麻里鄉,,0,1,4072,66,4138,6654,2,1,2,0,1,0,62.19
臺東縣,大武鄉,,0,1,1461,42,1503,2544,2,1,2,0,1,0,59.08
臺東縣,綠島鄉,,0,1,1013,9,1022,1712,2,1,2,0,1,0,59.70
臺東縣,海端鄉,,0,1,222,7,229,354,2,1,2,0,1,0,64.69
臺東縣,延平鄉,,0,1,182,4,186,295,2,1,2,0,1,0,63.05
臺東縣,金峰鄉,,0,1,125,1,126,227,2,1,2,0,1,0,55.51
臺東縣,達仁鄉,,0,1,198,3,201,353,2,1,2,0,1,0,56.94
臺東縣,蘭嶼鄉,,0,1,84,1,85,159,2,1,2,0,1,0,53.46
花蓮縣,花蓮市,,0,1,47650,1196,48846,67634,2,1,2,0,1,0,72.22
花蓮縣,鳳林鎮,,0,1,6771,115,6886,9944,2,1,2,0,1,0,69.25
花蓮縣,玉里鎮,,0,1,10869,596,11465,18570,2,1,2,0,1,0,61.74
花蓮縣,新城鄉,,0,1,8187,241,8428,11797,2,1,2,0,1,0,71.44
花蓮縣,吉安鄉,,0,1,27936,885,28821,40587,2,1,2,0,1,0,71.01
花蓮縣,壽豐鄉,,0,1,7598,235,7833,11537,2,1,2,0,1,0,67.89
花蓮縣,光復鄉,,0,1,4503,117,4620,7093,2,1,2,0,1,0,65.13
花蓮縣,豐濱鄉,,0,1,765,28,793,1364,2,1,2,0,1,0,58.14
花蓮縣,瑞穗鄉,,0,1,4858,144,5002,7734,2,1,2,0,1,0,64.68
花蓮縣,富里鄉,,0,1,5988,233,6221,10408,2,1,2,0,1,0,59.77
花蓮縣,秀林鄉,,0,1,1245,42,1287,1991,2,1,2,0,1,0,64.64
花蓮縣,萬榮鄉,,0,1,205,8,213,351,2,1,2,0,1,0,60.68
花蓮縣,卓溪鄉,,0,1,234,10,244,402,2,1,2,0,1,0,60.70
澎湖縣,馬公市,,0,1,23484,755,24239,35171,2,1,2,0,1,0,68.92
澎湖縣,湖西鄉,,0,1,6212,174,6386,9666,2,1,2,0,1,0,66.07
澎湖縣,白沙鄉,,0,1,3928,94,4022,6788,2,1,2,0,1,0,59.25
澎湖縣,西嶼鄉,,0,1,3723,101,3824,6500,2,1,2,0,1,0,58.83
澎湖縣,望安鄉,,0,1,1184,61,1245,2739,2,1,2,0,1,0,45.45
澎湖縣,七美鄉,,0,1,1170,37,1207,2240,2,1,2,0,1,0,53.88
基隆市,中正區,,0,1,29259,973,30232,40179,2,1,2,0,1,0,75.24
基隆市,七堵區,,0,1,27541,831,28372,36270,2,1,2,0,1,0,78.22
基隆市,暖暖區,,0,1,15659,510,16169,20913,2,1,2,0,1,0,77.32
基隆市,仁愛區,,0,1,30314,899,31213,40254,2,1,2,0,1,0,77.54
基隆市,中山區,,0,1,26059,823,26882,35026,2,1,2,0,1,0,76.75
基隆市,安樂區,,0,1,33301,1073,34374,44459,2,1,2,0,1,0,77.32
基隆市,信義區,,0,1,23654,635,24289,31453,2,1,2,0,1,0,77.22
新竹市,東區,,0,1,81813,1333,83146,106409,2,1,2,0,1,0,78.14
新竹市,北區,,0,1,62587,989,63576,81282,2,1,2,0,1,0,78.22
新竹市,香山區,,0,1,27896,532,28428,36208,2,1,2,0,1,0,78.51
臺中市,中區,,0,1,12560,378,12938,17204,2,1,2,0,1,0,75.20
臺中市,東區,,0,1,35002,987,35989,46845,2,1,2,0,1,0,76.83
臺中市,南區,,0,1,38103,1253,39356,51314,2,1,2,0,1,0,76.70
臺中市,西區,,0,1,52165,1514,53679,70057,2,1,2,0,1,0,76.62
臺中市,北區,,0,1,68534,2041,70575,94291,2,1,2,0,1,0,74.85
臺中市,西屯區,,0,2,66953,1338,68291,87863,2,1,2,0,1,0,77.72
臺中市,南屯區,,0,2,42628,926,43554,55567,2,1,2,0,1,0,78.38
臺中市,北屯區,,0,2,91341,1745,93086,119623,2,1,2,0,1,0,77.82
嘉義市,東區,,0,1,62617,1520,64137,86034,2,1,2,0,1,0,74.55
嘉義市,西區,,0,1,63248,1482,64730,87029,2,1,2,0,1,0,74.38
臺南市,東區,,0,1,80939,2452,83391,108629,2,1,2,0,1,0,76.77
臺南市,南區,,0,1,68418,1918,70336,92713,2,1,2,0,1,0,75.86
臺南市,中區,,0,1,25127,753,25880,33631,2,1,2,0,1,0,76.95
臺南市,安平區,,0,1,15482,423,15905,21050,2,1,2,0,1,0,75.56
臺南市,區西區,,0,2,24873,797,25670,32674,2,1,2,0,1,0,78.56
臺南市,區北區,,0,2,60436,1790,62226,80762,2,1,2,0,1,0,77.05
臺南市,安南區,,0,2,69311,1850,71161,92707,2,1,2,0,1,0,76.76
金門縣,金城鎮,,0,1,6679,188,6867,9640,2,1,2,0,1,0,71.23
金門縣,金沙鎮,,0,1,3494,146,3640,5326,2,1,2,0,1,0,68.34
金門縣,金湖鎮,,0,1,4609,151,4760,6703,2,1,2,0,1,0,71.01
金門縣,金寧鄉,,0,1,3542,110,3652,5387,2,1,2,0,1,0,67.79
金門縣,烈嶼鄉,,0,1,1938,68,2006,3037,2,1,2,0,1,0,66.05
金門縣,烏坵鄉,,0,1,13,0,13,80,2,1,2,0,1,0,16.25
連江縣,南竿鄉,,0,1,1650,15,1665,2239,2,1,2,0,1,0,74.36
連江縣,北竿鄉,,0,1,479,9,488,755,2,1,2,0,1,0,64.64
連江縣,莒光鄉,,0,1,165,4,169,376,2,1,2,0,1,0,44.95
連江縣,東引鄉,,0,1,295,5,300,424,2,1,2,0,1,0,70.75
