CountyCityName,TownshipName,VillageName,PollStationNo,DistrictName,BallotsAccepted,BallotsRejected,BallotsCast,Voters,CandidateCounts,ElectedCounts,CandidateMaleCounts,CandidateFemaleCounts,ElectedMaleCounts,ElectedFemaleCounts,BallotsRate
全國,,,0,0,9311367,129318,9440685,13922373,314,122,276,38,104,18,67.81
臺北市,,,0,2,1186799,13753,1200552,1818771,59,18,46,13,12,6,66.01
臺北市,,,0,2,602350,6663,609013,904686,23,9,17,6,6,3,67.32
臺北市,,,0,2,584449,7090,591539,914085,36,9,29,7,6,3,64.71
高雄市,,,0,2,660723,10007,670730,933732,28,12,25,3,11,1,71.83
高雄市,,,0,2,361828,5200,367028,506789,12,6,11,1,5,1,72.42
高雄市,,,0,2,298895,4807,303702,426943,16,6,14,2,6,0,71.13
臺北縣,,,0,0,1414946,20531,1435477,2118533,50,17,46,4,15,2,67.76
宜蘭縣,,,0,0,170767,2301,173068,305581,3,2,3,0,2,0,56.64
桃園縣,,,0,0,638291,10352,648643,956002,16,8,15,1,7,1,67.85
新竹縣,,,0,0,169713,2961,172674,258952,4,2,3,1,2,0,66.68
苗栗縣,,,0,0,271135,3965,275100,369518,7,3,5,2,2,1,74.45
臺中縣,,,0,0,638502,10687,649189,881636,13,7,12,1,7,0,73.63
彰化縣,,,0,0,593242,10021,603263,835007,13,7,11,2,6,1,72.25
南投縣,,,0,0,221102,2648,223750,355190,7,3,7,0,3,0,62.99
雲林縣,,,0,0,344426,5055,349481,518878,8,4,7,1,4,0,67.35
嘉義縣,,,0,0,233647,3642,237289,393148,7,3,7,0,3,0,60.36
臺南縣,,,0,0,495634,6176,501810,736214,13,6,11,2,5,1,68.16
高雄縣,,,0,0,544208,7191,551399,790659,17,6,15,2,4,2,69.74
屏東縣,,,0,0,389174,3803,392977,586043,8,5,8,0,5,0,67.06
臺東縣,,,0,0,69137,980,70117,122477,4,1,4,0,1,0,57.25
花蓮縣,,,0,0,112149,1847,113996,189805,9,2,8,1,2,0,60.06
澎湖縣,,,0,0,39566,482,40048,63605,4,1,4,0,1,0,62.96
基隆市,,,0,0,160412,2324,162736,247729,7,2,6,1,1,1,65.69
新竹市,,,0,0,131502,1749,133251,223618,4,2,4,0,2,0,59.59
臺中市,,,0,0,353416,3932,357348,545276,10,4,6,4,2,2,65.54
嘉義市,,,0,0,129626,929,130555,173433,3,1,3,0,1,0,75.28
臺南市,,,0,0,319203,3700,322903,464933,11,4,11,0,4,0,69.45
金門縣,,,0,0,20934,242,21176,29852,5,1,5,0,1,0,70.94
連江縣,,,0,0,3113,40,3153,3781,4,1,4,0,1,0,83.39
臺北縣,,,0,0,1414946,20531,1435477,2118533,50,17,46,4,15,2,67.76
宜蘭縣,,,0,0,170767,2301,173068,305581,3,2,3,0,2,0,56.64
桃園縣,,,0,0,638291,10352,648643,956002,16,8,15,1,7,1,67.85
新竹縣,,,0,0,169713,2961,172674,258952,4,2,3,1,2,0,66.68
苗栗縣,,,0,0,271135,3965,275100,369518,7,3,5,2,2,1,74.45
臺中縣,,,0,0,638502,10687,649189,881636,13,7,12,1,7,0,73.63
彰化縣,,,0,0,593242,10021,603263,835007,13,7,11,2,6,1,72.25
南投縣,,,0,0,221102,2648,223750,355190,7,3,7,0,3,0,62.99
雲林縣,,,0,0,344426,5055,349481,518878,8,4,7,1,4,0,67.35
嘉義縣,,,0,0,233647,3642,237289,393148,7,3,7,0,3,0,60.36
臺南縣,,,0,0,495634,6176,501810,736214,13,6,11,2,5,1,68.16
高雄縣,,,0,0,544208,7191,551399,790659,17,6,15,2,4,2,69.74
屏東縣,,,0,0,389174,3803,392977,586043,8,5,8,0,5,0,67.06
臺東縣,,,0,0,69137,980,70117,122477,4,1,4,0,1,0,57.25
花蓮縣,,,0,0,112149,1847,113996,189805,9,2,8,1,2,0,60.06
澎湖縣,,,0,0,39566,482,40048,63605,4,1,4,0,1,0,62.96
基隆市,,,0,0,160412,2324,162736,247729,7,2,6,1,1,1,65.69
新竹市,,,0,0,131502,1749,133251,223618,4,2,4,0,2,0,59.59
臺中市,,,0,0,353416,3932,357348,545276,10,4,6,4,2,2,65.54
嘉義市,,,0,0,129626,929,130555,173433,3,1,3,0,1,0,75.28
臺南市,,,0,0,319203,3700,322903,464933,11,4,11,0,4,0,69.45
金門縣,,,0,0,20934,242,21176,29852,5,1,5,0,1,0,70.94
連江縣,,,0,0,3113,40,3153,3781,4,1,4,0,1,0,83.39
臺北市,北投區,,0,1,109871,1257,111128,164413,3,1,3,0,1,0,67.59
臺北市,士林區,,0,1,133774,1451,135225,203855,3,1,3,0,1,0,66.33
臺北市,松山區,,0,1,94762,889,95651,145600,3,1,3,0,1,0,65.69
臺北市,信義區,,0,1,114323,1300,115623,172233,3,1,3,0,1,0,67.13
臺北市,內湖區,,0,1,99451,1067,100518,144539,3,1,3,0,1,0,69.54
臺北市,南港區,,0,1,50169,699,50868,74046,3,1,3,0,1,0,68.70
臺北市,中山區,,0,2,95903,1309,97212,157656,3,1,3,0,1,0,61.66
臺北市,大同區,,0,2,60913,809,61722,93717,3,1,3,0,1,0,65.86
臺北市,大安區,,0,2,148753,1424,150177,237251,3,1,3,0,1,0,63.30
臺北市,中正區,,0,2,76895,862,77757,119294,3,1,3,0,1,0,65.18
臺北市,萬華區,,0,2,97436,1414,98850,150735,3,1,3,0,1,0,65.58
臺北市,文山區,,0,2,104549,1272,105821,155432,3,1,3,0,1,0,68.08
高雄市,鹽埕區,,0,1,16858,294,17152,23766,3,1,3,0,1,0,72.17
高雄市,鼓山區,,0,1,53941,725,54666,74484,3,1,3,0,1,0,73.39
高雄市,旗津區,,0,1,16130,326,16456,22624,3,1,3,0,1,0,72.74
高雄市,左營區,,0,1,61397,799,62196,83928,3,1,3,0,1,0,74.11
高雄市,楠梓區,,0,1,64754,902,65656,87407,3,1,3,0,1,0,75.12
高雄市,三民區,,0,1,148748,2154,150902,214580,3,1,3,0,1,0,70.32
高雄市,新興區,,0,2,31713,402,32115,44916,3,1,3,0,1,0,71.50
高雄市,前金區,,0,2,17890,255,18145,25809,3,1,3,0,1,0,70.30
高雄市,苓雅區,,0,2,97098,1670,98768,140803,3,1,3,0,1,0,70.15
高雄市,前鎮區,,0,2,92219,1661,93880,131711,3,1,3,0,1,0,71.28
高雄市,小港區,,0,2,59975,819,60794,83704,3,1,3,0,1,0,72.63
臺北縣,板橋市,,0,1,224181,3282,227463,336079,3,1,3,0,1,0,67.68
臺北縣,三重市,,0,1,161495,2359,163854,245179,3,1,3,0,1,0,66.83
臺北縣,中和市,,0,1,174393,2474,176867,259323,3,1,3,0,1,0,68.20
臺北縣,永和市,,0,1,107497,1375,108872,157936,3,1,3,0,1,0,68.93
臺北縣,新莊市,,0,1,127684,1765,129449,200137,3,1,3,0,1,0,64.68
臺北縣,新店市,,0,1,115596,1485,117081,173184,3,1,3,0,1,0,67.60
臺北縣,土城市,,0,1,73512,1207,74719,113072,3,1,3,0,1,0,66.08
臺北縣,樹林鎮,,0,1,52871,841,53712,80507,3,1,3,0,1,0,66.72
臺北縣,鶯歌鎮,,0,1,29847,532,30379,43216,3,1,3,0,1,0,70.30
臺北縣,三峽鎮,,0,1,30446,540,30986,44816,3,1,3,0,1,0,69.14
臺北縣,淡水鎮,,0,1,43593,737,44330,63428,3,1,3,0,1,0,69.89
臺北縣,汐止鎮,,0,1,55780,627,56407,78168,3,1,3,0,1,0,72.16
臺北縣,瑞芳鎮,,0,1,24743,366,25109,36543,3,1,3,0,1,0,68.71
臺北縣,蘆洲市,,0,1,53958,808,54766,81809,3,1,3,0,1,0,66.94
臺北縣,五股鄉,,0,1,23308,346,23654,35152,3,1,3,0,1,0,67.29
臺北縣,泰山鄉,,0,1,24132,343,24475,35892,3,1,3,0,1,0,68.19
臺北縣,林口鄉,,0,1,17308,257,17565,25346,3,1,3,0,1,0,69.30
臺北縣,深坑鄉,,0,1,7671,118,7789,11472,3,1,3,0,1,0,67.90
臺北縣,石碇鄉,,0,1,4128,72,4200,6010,3,1,3,0,1,0,69.88
臺北縣,坪林鄉,,0,1,2905,30,2935,4617,3,1,3,0,1,0,63.57
臺北縣,三芝鄉,,0,1,8956,166,9122,12829,3,1,3,0,1,0,71.10
臺北縣,石門鄉,,0,1,4905,76,4981,7021,3,1,3,0,1,0,70.94
臺北縣,八里鄉,,0,1,9869,200,10069,14178,3,1,3,0,1,0,71.02
臺北縣,平溪鄉,,0,1,3671,42,3713,5190,3,1,3,0,1,0,71.54
臺北縣,雙溪鄉,,0,1,6026,59,6085,8443,3,1,3,0,1,0,72.07
臺北縣,貢寮鄉,,0,1,7083,108,7191,10456,3,1,3,0,1,0,68.77
臺北縣,金山鄉,,0,1,9142,135,9277,13440,3,1,3,0,1,0,69.03
臺北縣,萬里鄉,,0,1,9299,171,9470,13685,3,1,3,0,1,0,69.20
臺北縣,烏來鄉,,0,1,947,10,957,1405,3,1,3,0,1,0,68.11
宜蘭縣,宜蘭市,,0,1,33927,570,34497,59670,3,1,3,0,1,0,57.81
宜蘭縣,羅東鎮,,0,1,24873,311,25184,43167,3,1,3,0,1,0,58.34
宜蘭縣,蘇澳鎮,,0,1,17672,232,17904,33660,3,1,3,0,1,0,53.19
宜蘭縣,頭城鎮,,0,1,11852,153,12005,23238,3,1,3,0,1,0,51.66
宜蘭縣,礁溪鄉,,0,1,14444,198,14642,25877,3,1,3,0,1,0,56.58
宜蘭縣,壯圍鄉,,0,1,9240,111,9351,17566,3,1,3,0,1,0,53.23
宜蘭縣,員山鄉,,0,1,12532,168,12700,22853,3,1,3,0,1,0,55.57
宜蘭縣,冬山鄉,,0,1,20247,260,20507,35018,3,1,3,0,1,0,58.56
宜蘭縣,五結鄉,,0,1,15713,163,15876,26337,3,1,3,0,1,0,60.28
宜蘭縣,三星鄉,,0,1,9343,123,9466,16280,3,1,3,0,1,0,58.14
宜蘭縣,大同鄉,,0,1,489,6,495,994,3,1,3,0,1,0,49.80
宜蘭縣,南澳鄉,,0,1,435,6,441,921,3,1,3,0,1,0,47.88
桃園縣,桃園市,,0,1,107261,1561,108822,167208,3,1,3,0,1,0,65.08
桃園縣,龜山鄉,,0,1,40388,685,41073,66748,3,1,3,0,1,0,61.53
桃園縣,八德市,,0,1,62112,1123,63235,93056,3,1,3,0,1,0,67.95
桃園縣,蘆竹鄉,,0,1,29289,528,29817,42992,3,1,3,0,1,0,69.35
桃園縣,大園鄉,,0,1,30195,435,30630,43212,3,1,3,0,1,0,70.88
桃園縣,大溪鎮,,0,1,34877,615,35492,51638,3,1,3,0,1,0,68.73
桃園縣,復興鄉,,0,1,1584,18,1602,2720,3,1,3,0,1,0,58.90
桃園縣,中壢市,,0,1,130878,2026,132904,193143,3,1,3,0,1,0,68.81
桃園縣,平鎮市,,0,1,70926,1265,72191,103743,3,1,3,0,1,0,69.59
桃園縣,楊梅鎮,,0,1,46096,814,46910,68890,3,1,3,0,1,0,68.09
桃園縣,龍潭鄉,,0,1,39186,643,39829,57015,3,1,3,0,1,0,69.86
桃園縣,新屋鄉,,0,1,23018,307,23325,32780,3,1,3,0,1,0,71.16
桃園縣,觀音鄉,,0,1,22481,332,22813,32857,3,1,3,0,1,0,69.43
新竹縣,竹北市,,0,1,29616,520,30136,48194,3,1,3,0,1,0,62.53
新竹縣,竹東鎮,,0,1,35580,591,36171,52581,3,1,3,0,1,0,68.79
新竹縣,新埔鎮,,0,1,16701,288,16989,24518,3,1,3,0,1,0,69.29
新竹縣,關西鎮,,0,1,15102,259,15361,22567,3,1,3,0,1,0,68.07
新竹縣,湖口鄉,,0,1,25391,491,25882,38838,3,1,3,0,1,0,66.64
新竹縣,新豐鄉,,0,1,16290,283,16573,25837,3,1,3,0,1,0,64.14
新竹縣,芎林鄉,,0,1,8638,169,8807,12802,3,1,3,0,1,0,68.79
新竹縣,橫山鄉,,0,1,7688,131,7819,11102,3,1,3,0,1,0,70.43
新竹縣,北埔鄉,,0,1,5150,85,5235,7629,3,1,3,0,1,0,68.62
新竹縣,寶山鄉,,0,1,5405,83,5488,8363,3,1,3,0,1,0,65.62
新竹縣,峨眉鄉,,0,1,3283,42,3325,5026,3,1,3,0,1,0,66.16
新竹縣,尖石鄉,,0,1,655,15,670,1087,3,1,3,0,1,0,61.64
新竹縣,五峰鄉,,0,1,214,4,218,408,3,1,3,0,1,0,53.43
苗栗縣,苗栗市,,0,1,42609,633,43242,59480,3,1,3,0,1,0,72.70
苗栗縣,苑裡鎮,,0,1,23600,325,23925,32563,3,1,3,0,1,0,73.47
苗栗縣,通霄鎮,,0,1,21169,248,21417,28815,3,1,3,0,1,0,74.33
苗栗縣,竹南鎮,,0,1,31071,532,31603,41964,3,1,3,0,1,0,75.31
苗栗縣,頭份鎮,,0,1,38634,597,39231,53630,3,1,3,0,1,0,73.15
苗栗縣,後龍鎮,,0,1,21664,294,21958,30166,3,1,3,0,1,0,72.79
苗栗縣,卓蘭鎮,,0,1,10963,144,11107,13942,3,1,3,0,1,0,79.67
苗栗縣,大湖鄉,,0,1,9549,130,9679,13059,3,1,3,0,1,0,74.12
苗栗縣,公舘鄉,,0,1,17299,225,17524,23122,3,1,3,0,1,0,75.79
苗栗縣,銅鑼鄉,,0,1,10687,176,10863,14438,3,1,3,0,1,0,75.24
苗栗縣,南庄鄉,,0,1,5887,72,5959,8378,3,1,3,0,1,0,71.13
苗栗縣,頭屋鄉,,0,1,6765,134,6899,8801,3,1,3,0,1,0,78.39
苗栗縣,三義鄉,,0,1,9406,124,9530,12028,3,1,3,0,1,0,79.23
苗栗縣,西湖鄉,,0,1,5141,113,5254,7003,3,1,3,0,1,0,75.02
苗栗縣,造橋鄉,,0,1,7979,95,8074,10055,3,1,3,0,1,0,80.30
苗栗縣,三灣鄉,,0,1,4470,55,4525,5985,3,1,3,0,1,0,75.61
苗栗縣,獅潭鄉,,0,1,3167,55,3222,4555,3,1,3,0,1,0,70.74
苗栗縣,泰安鄉,,0,1,1075,13,1088,1534,3,1,3,0,1,0,70.93
臺中縣,豐原市,,0,1,71239,1217,72456,99767,3,1,3,0,1,0,72.63
臺中縣,東勢鎮,,0,1,29449,445,29894,40901,3,1,3,0,1,0,73.09
臺中縣,大甲鎮,,0,1,35524,565,36089,47854,3,1,3,0,1,0,75.41
臺中縣,清水鎮,,0,1,40042,603,40645,53824,3,1,3,0,1,0,75.51
臺中縣,沙鹿鎮,,0,1,32653,467,33120,43133,3,1,3,0,1,0,76.79
臺中縣,梧棲鎮,,0,1,20813,336,21149,28720,3,1,3,0,1,0,73.64
臺中縣,后里鄉,,0,1,27910,500,28410,35824,3,1,3,0,1,0,79.30
臺中縣,神岡鄉,,0,1,27835,532,28367,36940,3,1,3,0,1,0,76.79
臺中縣,潭子鄉,,0,1,33500,584,34084,47496,3,1,3,0,1,0,71.76
臺中縣,大雅鄉,,0,1,29885,609,30494,41762,3,1,3,0,1,0,73.02
臺中縣,新社鄉,,0,1,14860,238,15098,19112,3,1,3,0,1,0,79.00
臺中縣,石岡鄉,,0,1,8345,145,8490,10868,3,1,3,0,1,0,78.12
臺中縣,外埔鄉,,0,1,14873,280,15153,18863,3,1,3,0,1,0,80.33
臺中縣,大安鄉,,0,1,10712,131,10843,14108,3,1,3,0,1,0,76.86
臺中縣,烏日鄉,,0,1,28088,479,28567,38624,3,1,3,0,1,0,73.96
臺中縣,大肚鄉,,0,1,24172,375,24547,31970,3,1,3,0,1,0,76.78
臺中縣,龍井鄉,,0,1,25571,428,25999,35268,3,1,3,0,1,0,73.72
臺中縣,霧峰鄉,,0,1,31319,493,31812,42787,3,1,3,0,1,0,74.35
臺中縣,太平市,,0,1,63204,1199,64403,92244,3,1,3,0,1,0,69.82
臺中縣,大里市,,0,1,64535,997,65532,95736,3,1,3,0,1,0,68.45
臺中縣,和平鄉,,0,1,3973,64,4037,5835,3,1,3,0,1,0,69.19
彰化縣,彰化市,,0,1,99231,1676,100907,139867,3,1,3,0,1,0,72.14
彰化縣,花壇鄉,,0,1,20766,290,21056,28258,3,1,3,0,1,0,74.51
彰化縣,芬園鄉,,0,1,13897,201,14098,18213,3,1,3,0,1,0,77.41
彰化縣,鹿港鎮,,0,1,35121,526,35647,51466,3,1,3,0,1,0,69.26
彰化縣,福興鄉,,0,1,20749,358,21107,29920,3,1,3,0,1,0,70.54
彰化縣,秀水鄉,,0,1,17065,295,17360,22610,3,1,3,0,1,0,76.78
彰化縣,和美鎮,,0,1,37815,680,38495,50986,3,1,3,0,1,0,75.50
彰化縣,線西鄉,,0,1,7919,129,8048,10511,3,1,3,0,1,0,76.57
彰化縣,伸港鄉,,0,1,14638,222,14860,19925,3,1,3,0,1,0,74.58
彰化縣,員林鎮,,0,1,54723,916,55639,77921,3,1,3,0,1,0,71.40
彰化縣,大村鄉,,0,1,16764,316,17080,22463,3,1,3,0,1,0,76.04
彰化縣,永靖鄉,,0,1,18873,370,19243,26022,3,1,3,0,1,0,73.95
彰化縣,溪湖鎮,,0,1,24333,353,24686,33977,3,1,3,0,1,0,72.66
彰化縣,埔鹽鄉,,0,1,18008,288,18296,23625,3,1,3,0,1,0,77.44
彰化縣,埔心鄉,,0,1,16727,264,16991,22467,3,1,3,0,1,0,75.63
彰化縣,田中鎮,,0,1,21667,436,22103,31648,3,1,3,0,1,0,69.84
彰化縣,社頭鄉,,0,1,21006,398,21404,28695,3,1,3,0,1,0,74.59
彰化縣,二水鄉,,0,1,9865,177,10042,13685,3,1,3,0,1,0,73.38
彰化縣,北斗鎮,,0,1,15036,266,15302,21328,3,1,3,0,1,0,71.75
彰化縣,溪州鄉,,0,1,15654,325,15979,23295,3,1,3,0,1,0,68.59
彰化縣,田尾鄉,,0,1,14077,231,14308,19383,3,1,3,0,1,0,73.82
彰化縣,埤頭鄉,,0,1,15436,313,15749,22426,3,1,3,0,1,0,70.23
彰化縣,二林鎮,,0,1,27029,411,27440,38276,3,1,3,0,1,0,71.69
彰化縣,芳苑鄉,,0,1,18261,297,18558,28977,3,1,3,0,1,0,64.04
彰化縣,大城鄉,,0,1,9809,173,9982,16266,3,1,3,0,1,0,61.37
彰化縣,竹塘鄉,,0,1,8773,110,8883,12797,3,1,3,0,1,0,69.41
南投縣,南投市,,0,1,43270,574,43844,66572,3,1,3,0,1,0,65.86
南投縣,埔里鎮,,0,1,37018,379,37397,58340,3,1,3,0,1,0,64.10
南投縣,草屯鎮,,0,1,41665,479,42144,61843,3,1,3,0,1,0,68.15
南投縣,竹山鎮,,0,1,24354,297,24651,42615,3,1,3,0,1,0,57.85
南投縣,集集鎮,,0,1,5537,78,5615,9036,3,1,3,0,1,0,62.14
南投縣,名間鄉,,0,1,18104,222,18326,29583,3,1,3,0,1,0,61.95
南投縣,鹿谷鄉,,0,1,8853,82,8935,15493,3,1,3,0,1,0,57.67
南投縣,中寮鄉,,0,1,8630,118,8748,14102,3,1,3,0,1,0,62.03
南投縣,魚池鄉,,0,1,7513,68,7581,13279,3,1,3,0,1,0,57.09
南投縣,國姓鄉,,0,1,11213,137,11350,18345,3,1,3,0,1,0,61.87
南投縣,水里鄉,,0,1,9912,142,10054,17112,3,1,3,0,1,0,58.75
南投縣,信義鄉,,0,1,3523,38,3561,6184,3,1,3,0,1,0,57.58
南投縣,仁愛鄉,,0,1,1510,34,1544,2686,3,1,3,0,1,0,57.48
雲林縣,斗六市,,0,1,44973,838,45811,62505,3,1,3,0,1,0,73.29
雲林縣,斗南鎮,,0,1,22733,371,23104,32095,3,1,3,0,1,0,71.99
雲林縣,虎尾鎮,,0,1,30487,455,30942,44471,3,1,3,0,1,0,69.58
雲林縣,西螺鎮,,0,1,24046,259,24305,34430,3,1,3,0,1,0,70.59
雲林縣,土庫鎮,,0,1,14808,201,15009,22668,3,1,3,0,1,0,66.21
雲林縣,北港鎮,,0,1,21420,333,21753,33281,3,1,3,0,1,0,65.36
雲林縣,古坑鄉,,0,1,18577,243,18820,26048,3,1,3,0,1,0,72.25
雲林縣,大埤鄉,,0,1,11558,165,11723,17040,3,1,3,0,1,0,68.80
雲林縣,莿桐鄉,,0,1,14896,248,15144,21451,3,1,3,0,1,0,70.60
雲林縣,林內鄉,,0,1,10506,219,10725,14496,3,1,3,0,1,0,73.99
雲林縣,二崙鄉,,0,1,15692,185,15877,23917,3,1,3,0,1,0,66.38
雲林縣,崙背鄉,,0,1,13888,203,14091,20748,3,1,3,0,1,0,67.91
雲林縣,麥寮鄉,,0,1,13468,196,13664,21573,3,1,3,0,1,0,63.34
雲林縣,東勢鄉,,0,1,8409,107,8516,14235,3,1,3,0,1,0,59.82
雲林縣,褒忠鄉,,0,1,7030,92,7122,10767,3,1,3,0,1,0,66.15
雲林縣,台西鄉,,0,1,14976,205,15181,21521,3,1,3,0,1,0,70.54
雲林縣,元長鄉,,0,1,14376,137,14513,24433,3,1,3,0,1,0,59.40
雲林縣,四湖鄉,,0,1,12862,178,13040,23776,3,1,3,0,1,0,54.85
雲林縣,口湖鄉,,0,1,14391,184,14575,24159,3,1,3,0,1,0,60.33
雲林縣,水林鄉,,0,1,15330,236,15566,25264,3,1,3,0,1,0,61.61
嘉義縣,太保市,,0,1,11751,190,11941,19937,3,1,3,0,1,0,59.89
嘉義縣,朴子市,,0,1,18666,259,18925,30657,3,1,3,0,1,0,61.73
嘉義縣,布袋鎮,,0,1,14537,222,14759,25075,3,1,3,0,1,0,58.86
嘉義縣,大林鎮,,0,1,15929,238,16167,26125,3,1,3,0,1,0,61.88
嘉義縣,民雄鄉,,0,1,25993,422,26415,43852,3,1,3,0,1,0,60.24
嘉義縣,溪口鄉,,0,1,7723,113,7836,13715,3,1,3,0,1,0,57.13
嘉義縣,新港鄉,,0,1,13536,234,13770,25703,3,1,3,0,1,0,53.57
嘉義縣,六腳鄉,,0,1,13042,193,13235,23278,3,1,3,0,1,0,56.86
嘉義縣,東石鄉,,0,1,13482,175,13657,23501,3,1,3,0,1,0,58.11
嘉義縣,義竹鄉,,0,1,12116,160,12276,18366,3,1,3,0,1,0,66.84
嘉義縣,鹿草鄉,,0,1,8697,143,8840,14427,3,1,3,0,1,0,61.27
嘉義縣,水上鄉,,0,1,23192,412,23604,36839,3,1,3,0,1,0,64.07
嘉義縣,中埔鄉,,0,1,18840,276,19116,31866,3,1,3,0,1,0,59.99
嘉義縣,竹崎鄉,,0,1,17901,224,18125,29099,3,1,3,0,1,0,62.29
嘉義縣,梅山鄉,,0,1,10458,174,10632,17344,3,1,3,0,1,0,61.30
嘉義縣,番路鄉,,0,1,5400,61,5461,8557,3,1,3,0,1,0,63.82
嘉義縣,大埔鄉,,0,1,1385,136,1521,2834,3,1,3,0,1,0,53.67
嘉義縣,阿里山鄉,,0,1,999,10,1009,1973,3,1,3,0,1,0,51.14
臺南縣,新營市,,0,1,30944,406,31350,49572,3,1,3,0,1,0,63.24
臺南縣,鹽水鎮,,0,1,13280,202,13482,20889,3,1,3,0,1,0,64.54
臺南縣,白河鎮,,0,1,17471,242,17713,27363,3,1,3,0,1,0,64.73
臺南縣,柳營鄉,,0,1,11707,151,11858,17598,3,1,3,0,1,0,67.38
臺南縣,後壁鄉,,0,1,14563,196,14759,21850,3,1,3,0,1,0,67.55
臺南縣,東山鄉,,0,1,11544,128,11672,19767,3,1,3,0,1,0,59.05
臺南縣,麻豆鎮,,0,1,23814,267,24081,32861,3,1,3,0,1,0,73.28
臺南縣,下營鄉,,0,1,13961,171,14132,20214,3,1,3,0,1,0,69.91
臺南縣,六甲鄉,,0,1,11733,160,11893,17228,3,1,3,0,1,0,69.03
臺南縣,官田鄉,,0,1,12254,157,12411,17389,3,1,3,0,1,0,71.37
臺南縣,大內鄉,,0,1,6652,72,6724,9609,3,1,3,0,1,0,69.98
臺南縣,佳里鎮,,0,1,25144,252,25396,36928,3,1,3,0,1,0,68.77
臺南縣,學甲鎮,,0,1,13861,139,14000,21346,3,1,3,0,1,0,65.59
臺南縣,西港鄉,,0,1,12091,139,12230,17025,3,1,3,0,1,0,71.84
臺南縣,七股鄉,,0,1,13992,126,14118,19774,3,1,3,0,1,0,71.40
臺南縣,將軍鄉,,0,1,12256,105,12361,17800,3,1,3,0,1,0,69.44
臺南縣,北門鄉,,0,1,6807,60,6867,10423,3,1,3,0,1,0,65.88
臺南縣,新化鎮,,0,1,20521,315,20836,29360,3,1,3,0,1,0,70.97
臺南縣,善化鎮,,0,1,20159,280,20439,28680,3,1,3,0,1,0,71.27
臺南縣,新市鄉,,0,1,13797,195,13992,19904,3,1,3,0,1,0,70.30
臺南縣,安定鄉,,0,1,14757,174,14931,20034,3,1,3,0,1,0,74.53
臺南縣,山上鄉,,0,1,4172,46,4218,5855,3,1,3,0,1,0,72.04
臺南縣,玉井鄉,,0,1,8633,75,8708,12657,3,1,3,0,1,0,68.80
臺南縣,楠西鄉,,0,1,5962,68,6030,9215,3,1,3,0,1,0,65.44
臺南縣,南化鄉,,0,1,4936,58,4994,7375,3,1,3,0,1,0,67.72
臺南縣,左鎮鄉,,0,1,3506,51,3557,5072,3,1,3,0,1,0,70.13
臺南縣,仁德鄉,,0,1,28071,414,28485,42261,3,1,3,0,1,0,67.40
臺南縣,歸仁鄉,,0,1,25949,319,26268,37596,3,1,3,0,1,0,69.87
臺南縣,關廟鄉,,0,1,18559,190,18749,26724,3,1,3,0,1,0,70.16
臺南縣,龍崎鄉,,0,1,2665,26,2691,3841,3,1,3,0,1,0,70.06
臺南縣,永康市,,0,1,71873,992,72865,110004,3,1,3,0,1,0,66.24
高雄縣,鳳山市,,0,1,128168,1592,129760,197859,3,1,3,0,1,0,65.58
高雄縣,林園鄉,,0,1,30974,452,31426,44511,3,1,3,0,1,0,70.60
高雄縣,大寮鄉,,0,1,49998,660,50658,73330,3,1,3,0,1,0,69.08
高雄縣,大樹鄉,,0,1,23013,254,23267,31668,3,1,3,0,1,0,73.47
高雄縣,仁武鄉,,0,1,18790,302,19092,28272,3,1,3,0,1,0,67.53
高雄縣,大社鄉,,0,1,13850,196,14046,20493,3,1,3,0,1,0,68.54
高雄縣,鳥松鄉,,0,1,14741,190,14931,22130,3,1,3,0,1,0,67.47
高雄縣,岡山鎮,,0,1,41737,516,42253,59203,3,1,3,0,1,0,71.37
高雄縣,橋頭鄉,,0,1,18741,231,18972,25519,3,1,3,0,1,0,74.34
高雄縣,燕巢鄉,,0,1,16610,274,16884,22964,3,1,3,0,1,0,73.52
高雄縣,田寮鄉,,0,1,5244,91,5335,7770,3,1,3,0,1,0,68.66
高雄縣,阿蓮鄉,,0,1,13855,217,14072,19958,3,1,3,0,1,0,70.51
高雄縣,路竹鄉,,0,1,26535,304,26839,34699,3,1,3,0,1,0,77.35
高雄縣,湖內鄉,,0,1,12834,184,13018,18211,3,1,3,0,1,0,71.48
高雄縣,茄萣鄉,,0,1,14828,173,15001,22340,3,1,3,0,1,0,67.15
高雄縣,彌陀鄉,,0,1,11019,144,11163,14533,3,1,3,0,1,0,76.81
高雄縣,永安鄉,,0,1,6592,58,6650,8909,3,1,3,0,1,0,74.64
高雄縣,梓官鄉,,0,1,18323,259,18582,25661,3,1,3,0,1,0,72.41
高雄縣,旗山鎮,,0,1,23485,291,23776,32908,3,1,3,0,1,0,72.25
高雄縣,美濃鎮,,0,1,24763,351,25114,35516,3,1,3,0,1,0,70.71
高雄縣,六龜鄉,,0,1,8492,157,8649,13240,3,1,3,0,1,0,65.32
高雄縣,甲仙鄉,,0,1,4593,45,4638,6491,3,1,3,0,1,0,71.45
高雄縣,杉林鄉,,0,1,6610,106,6716,10329,3,1,3,0,1,0,65.02
高雄縣,內門鄉,,0,1,10045,140,10185,13468,3,1,3,0,1,0,75.62
高雄縣,茂林鄉,,0,1,48,1,49,94,3,1,3,0,1,0,52.13
高雄縣,桃源鄉,,0,1,203,3,206,340,3,1,3,0,1,0,60.59
高雄縣,三民鄉,,0,1,117,0,117,243,3,1,3,0,1,0,48.15
屏東縣,屏東市,,0,1,92406,812,93218,140730,3,1,3,0,1,0,66.24
屏東縣,潮州鎮,,0,1,23647,197,23844,37382,3,1,3,0,1,0,63.78
屏東縣,東港鎮,,0,1,21012,214,21226,31273,3,1,3,0,1,0,67.87
屏東縣,恆春鎮,,0,1,12306,164,12470,21971,3,1,3,0,1,0,56.76
屏東縣,萬丹鄉,,0,1,25553,235,25788,34964,3,1,3,0,1,0,73.76
屏東縣,長治鄉,,0,1,13965,136,14101,20007,3,1,3,0,1,0,70.48
屏東縣,麟洛鄉,,0,1,5955,54,6009,8105,3,1,3,0,1,0,74.14
屏東縣,九如鄉,,0,1,10894,123,11017,15110,3,1,3,0,1,0,72.91
屏東縣,里港鄉,,0,1,13041,126,13167,18590,3,1,3,0,1,0,70.83
屏東縣,鹽埔鄉,,0,1,14539,195,14734,19344,3,1,3,0,1,0,76.17
屏東縣,高樹鄉,,0,1,14626,139,14765,22758,3,1,3,0,1,0,64.88
屏東縣,萬巒鄉,,0,1,11607,124,11731,17467,3,1,3,0,1,0,67.16
屏東縣,內埔鄉,,0,1,28357,304,28661,43250,3,1,3,0,1,0,66.27
屏東縣,竹田鄉,,0,1,9887,96,9983,14157,3,1,3,0,1,0,70.52
屏東縣,新埤鄉,,0,1,5812,58,5870,9083,3,1,3,0,1,0,64.63
屏東縣,枋寮鄉,,0,1,13413,113,13526,21304,3,1,3,0,1,0,63.49
屏東縣,新園鄉,,0,1,18886,162,19048,27516,3,1,3,0,1,0,69.23
屏東縣,崁頂鄉,,0,1,6725,72,6797,9571,3,1,3,0,1,0,71.02
屏東縣,林邊鄉,,0,1,11366,96,11462,16217,3,1,3,0,1,0,70.68
屏東縣,南州鄉,,0,1,6795,65,6860,9753,3,1,3,0,1,0,70.34
屏東縣,佳冬鄉,,0,1,11785,119,11904,17417,3,1,3,0,1,0,68.35
屏東縣,琉球鄉,,0,1,4380,53,4433,8509,3,1,3,0,1,0,52.10
屏東縣,車城鄉,,0,1,4871,58,4929,8562,3,1,3,0,1,0,57.57
屏東縣,滿州鄉,,0,1,3007,35,3042,5487,3,1,3,0,1,0,55.44
屏東縣,枋山鄉,,0,1,2890,32,2922,5005,3,1,3,0,1,0,58.38
屏東縣,三地門鄉,,0,1,208,3,211,372,3,1,3,0,1,0,56.72
屏東縣,霧台鄉,,0,1,28,0,28,51,3,1,3,0,1,0,54.90
屏東縣,瑪家鄉,,0,1,221,4,225,362,3,1,3,0,1,0,62.15
屏東縣,泰武鄉,,0,1,83,0,83,169,3,1,3,0,1,0,49.11
屏東縣,來義鄉,,0,1,250,7,257,431,3,1,3,0,1,0,59.63
屏東縣,春日鄉,,0,1,259,3,262,433,3,1,3,0,1,0,60.51
屏東縣,獅子鄉,,0,1,165,0,165,292,3,1,3,0,1,0,56.51
屏東縣,牡丹鄉,,0,1,235,4,239,401,3,1,3,0,1,0,59.60
臺東縣,台東市,,0,1,37795,547,38342,63691,3,1,3,0,1,0,60.20
臺東縣,成功鎮,,0,1,3493,44,3537,6521,3,1,3,0,1,0,54.24
臺東縣,關山鎮,,0,1,3497,52,3549,6507,3,1,3,0,1,0,54.54
臺東縣,卑南鄉,,0,1,6936,103,7039,11723,3,1,3,0,1,0,60.04
臺東縣,鹿野鄉,,0,1,3093,46,3139,5961,3,1,3,0,1,0,52.66
臺東縣,池上鄉,,0,1,3688,57,3745,6861,3,1,3,0,1,0,54.58
臺東縣,東河鄉,,0,1,2278,25,2303,5107,3,1,3,0,1,0,45.09
臺東縣,長濱鄉,,0,1,1842,28,1870,3809,3,1,3,0,1,0,49.09
臺東縣,太麻里鄉,,0,1,3549,38,3587,6655,3,1,3,0,1,0,53.90
臺東縣,大武鄉,,0,1,1368,17,1385,2551,3,1,3,0,1,0,54.29
臺東縣,綠島鄉,,0,1,899,13,912,1718,3,1,3,0,1,0,53.08
臺東縣,海端鄉,,0,1,194,6,200,349,3,1,3,0,1,0,57.31
臺東縣,延平鄉,,0,1,174,2,176,297,3,1,3,0,1,0,59.26
臺東縣,金峰鄉,,0,1,109,0,109,231,3,1,3,0,1,0,47.19
臺東縣,達仁鄉,,0,1,160,1,161,344,3,1,3,0,1,0,46.80
臺東縣,蘭嶼鄉,,0,1,62,1,63,152,3,1,3,0,1,0,41.45
花蓮縣,花蓮市,,0,1,42248,544,42792,67706,3,1,3,0,1,0,63.20
花蓮縣,新城鄉,,0,1,7276,125,7401,11837,3,1,3,0,1,0,62.52
花蓮縣,秀林鄉,,0,1,1069,22,1091,2018,3,1,3,0,1,0,54.06
花蓮縣,吉安鄉,,0,1,24433,368,24801,40434,3,1,3,0,1,0,61.34
花蓮縣,壽豐鄉,,0,1,6648,122,6770,11634,3,1,3,0,1,0,58.19
花蓮縣,鳳林鎮,,0,1,6127,80,6207,9990,3,1,3,0,1,0,62.13
花蓮縣,光復鄉,,0,1,3864,53,3917,7123,3,1,3,0,1,0,54.99
花蓮縣,豐濱鄉,,0,1,692,10,702,1376,3,1,3,0,1,0,51.02
花蓮縣,萬榮鄉,,0,1,176,4,180,348,3,1,3,0,1,0,51.72
花蓮縣,瑞穗鄉,,0,1,4340,60,4400,7768,3,1,3,0,1,0,56.64
花蓮縣,玉里鎮,,0,1,9584,329,9913,18689,3,1,3,0,1,0,53.04
花蓮縣,富里鄉,,0,1,5495,122,5617,10478,3,1,3,0,1,0,53.61
花蓮縣,卓溪鄉,,0,1,197,8,205,404,3,1,3,0,1,0,50.74
澎湖縣,馬公市,,0,1,23779,280,24059,35450,3,1,3,0,1,0,67.87
澎湖縣,湖西鄉,,0,1,5987,86,6073,9765,3,1,3,0,1,0,62.19
澎湖縣,白沙鄉,,0,1,3913,37,3950,6857,3,1,3,0,1,0,57.61
澎湖縣,西嶼鄉,,0,1,3571,40,3611,6542,3,1,3,0,1,0,55.20
澎湖縣,望安鄉,,0,1,1222,23,1245,2747,3,1,3,0,1,0,45.32
澎湖縣,七美鄉,,0,1,1094,16,1110,2244,3,1,3,0,1,0,49.47
基隆市,中正區,,0,1,25084,339,25423,40141,3,1,3,0,1,0,63.33
基隆市,七堵區,,0,1,22687,334,23021,36340,3,1,3,0,1,0,63.35
基隆市,暖暖區,,0,1,13355,220,13575,20630,3,1,3,0,1,0,65.80
基隆市,仁愛區,,0,1,27083,368,27451,40602,3,1,3,0,1,0,67.61
基隆市,中山區,,0,1,22905,360,23265,34771,3,1,3,0,1,0,66.91
基隆市,安樂區,,0,1,28315,432,28747,44119,3,1,3,0,1,0,65.16
基隆市,信義區,,0,1,20983,271,21254,31126,3,1,3,0,1,0,68.28
新竹市,東區,,0,1,63774,813,64587,106437,3,1,3,0,1,0,60.68
新竹市,北區,,0,1,47697,649,48346,81221,3,1,3,0,1,0,59.52
新竹市,香山區,,0,1,20031,287,20318,35960,3,1,3,0,1,0,56.50
臺中市,中區,,0,1,11092,119,11211,17416,3,1,3,0,1,0,64.37
臺中市,東區,,0,1,30618,389,31007,47227,3,1,3,0,1,0,65.66
臺中市,西區,,0,1,45711,456,46167,70703,3,1,3,0,1,0,65.30
臺中市,南區,,0,1,32515,373,32888,51164,3,1,3,0,1,0,64.28
臺中市,北區,,0,1,59936,607,60543,95245,3,1,3,0,1,0,63.57
臺中市,西屯區,,0,1,58481,665,59146,87816,3,1,3,0,1,0,67.35
臺中市,南屯區,,0,1,36802,421,37223,55613,3,1,3,0,1,0,66.93
臺中市,北屯區,,0,1,78261,902,79163,120092,3,1,3,0,1,0,65.92
嘉義市,東區,,0,1,64303,439,64742,86419,3,1,3,0,1,0,74.92
嘉義市,西區,,0,1,65323,490,65813,87014,3,1,3,0,1,0,75.63
臺南市,東區,,0,1,73256,893,74149,108854,3,1,3,0,1,0,68.12
臺南市,南區,,0,1,64773,692,65465,93562,3,1,3,0,1,0,69.97
臺南市,西區,,0,1,23072,291,23363,33280,3,1,3,0,1,0,70.20
臺南市,北區,,0,1,56131,637,56768,81699,3,1,3,0,1,0,69.48
臺南市,中區,,0,1,23494,227,23721,34146,3,1,3,0,1,0,69.47
臺南市,安南區,,0,1,64851,804,65655,92681,3,1,3,0,1,0,70.84
臺南市,安平區,,0,1,13626,156,13782,20711,3,1,3,0,1,0,66.54
金門縣,金城鎮,,0,1,6720,72,6792,9546,3,1,3,0,1,0,71.15
金門縣,金寧鄉,,0,1,3570,52,3622,5341,3,1,3,0,1,0,67.82
金門縣,金湖鎮,,0,1,4846,45,4891,6612,3,1,3,0,1,0,73.97
金門縣,金沙鎮,,0,1,3582,50,3632,5274,3,1,3,0,1,0,68.87
金門縣,烈嶼鄉,,0,1,2183,23,2206,2997,3,1,3,0,1,0,73.61
金門縣,烏坵鄉,,0,1,33,0,33,82,3,1,3,0,1,0,40.24
連江縣,南竿鄉,,0,1,1898,28,1926,2232,3,1,3,0,1,0,86.29
連江縣,北竿鄉,,0,1,603,7,610,749,3,1,3,0,1,0,81.44
連江縣,莒光鄉,,0,1,304,1,305,374,3,1,3,0,1,0,81.55
連江縣,東引鄉,,0,1,308,4,312,426,4,2,4,1,2,1,73.24
臺北市,北投區,建民里,0,1,2458,24,2482,3636,3,1,3,0,1,0,68.26
臺北市,北投區,文林里,0,1,2117,22,2139,3132,3,1,3,0,1,0,68.30
臺北市,北投區,石牌里,0,1,2644,31,2675,4161,3,1,3,0,1,0,64.29
臺北市,北投區,榮光里,0,1,3453,23,3476,5216,3,1,3,0,1,0,66.64
臺北市,北投區,福興里,0,1,3240,30,3270,4728,3,1,3,0,1,0,69.16
臺北市,北投區,洲美里,0,1,854,6,860,1149,3,1,3,0,1,0,74.85
臺北市,北投區,吉慶里,0,1,2578,20,2598,3697,3,1,3,0,1,0,70.27
臺北市,北投區,吉利里,0,1,2967,37,3004,4382,3,1,3,0,1,0,68.55
臺北市,北投區,尊賢里,0,1,2296,27,2323,3507,3,1,3,0,1,0,66.24
臺北市,北投區,立賢里,0,1,2508,25,2533,3687,3,1,3,0,1,0,68.70
臺北市,北投區,立農里,0,1,4062,48,4110,5907,3,1,3,0,1,0,69.58
臺北市,北投區,永和里,0,1,3325,37,3362,5250,3,1,3,0,1,0,64.04
臺北市,北投區,永欣里,0,1,3072,26,3098,4368,3,1,3,0,1,0,70.92
臺北市,北投區,榮華里,0,1,3493,29,3522,5174,3,1,3,0,1,0,68.07
臺北市,北投區,裕民里,0,1,3253,34,3287,4729,3,1,3,0,1,0,69.51
臺北市,北投區,振華里,0,1,4077,38,4115,5984,3,1,3,0,1,0,68.77
臺北市,北投區,永明里,0,1,2115,33,2148,3018,3,1,3,0,1,0,71.17
臺北市,北投區,東華里,0,1,2647,34,2681,3646,3,1,3,0,1,0,73.53
臺北市,北投區,八仙里,0,1,2041,30,2071,3190,3,1,3,0,1,0,64.92
臺北市,北投區,清江里,0,1,4196,40,4236,6146,3,1,3,0,1,0,68.92
臺北市,北投區,中央里,0,1,3691,44,3735,5652,3,1,3,0,1,0,66.08
臺北市,北投區,大同里,0,1,2400,29,2429,3640,3,1,3,0,1,0,66.73
臺北市,北投區,長安里,0,1,2613,31,2644,4028,3,1,3,0,1,0,65.64
臺北市,北投區,奇岩里,0,1,4389,49,4438,6426,3,1,3,0,1,0,69.06
臺北市,北投區,溫泉里,0,1,3130,45,3175,4766,3,1,3,0,1,0,66.62
臺北市,北投區,林泉里,0,1,1746,17,1763,2758,3,1,3,0,1,0,63.92
臺北市,北投區,中心里,0,1,2632,21,2653,4229,3,1,3,0,1,0,62.73
臺北市,北投區,開明里,0,1,2881,27,2908,4419,3,1,3,0,1,0,65.81
臺北市,北投區,中庸里,0,1,2233,44,2277,3330,3,1,3,0,1,0,68.38
臺北市,北投區,中和里,0,1,2652,32,2684,4115,3,1,3,0,1,0,65.22
臺北市,北投區,秀山里,0,1,2025,29,2054,3016,3,1,3,0,1,0,68.10
臺北市,北投區,智仁里,0,1,3141,49,3190,4560,3,1,3,0,1,0,69.96
臺北市,北投區,文化里,0,1,2067,22,2089,2942,3,1,3,0,1,0,71.01
臺北市,北投區,豐年里,0,1,2117,23,2140,3169,3,1,3,0,1,0,67.53
臺北市,北投區,稻香里,0,1,2270,23,2293,3452,3,1,3,0,1,0,66.43
臺北市,北投區,桃源里,0,1,2444,21,2465,3749,3,1,3,0,1,0,65.75
臺北市,北投區,一德里,0,1,2773,46,2819,4405,3,1,3,0,1,0,64.00
臺北市,北投區,關渡里,0,1,4581,85,4666,6972,3,1,3,0,1,0,66.92
臺北市,北投區,泉源里,0,1,1166,8,1174,1764,3,1,3,0,1,0,66.55
臺北市,北投區,湖山里,0,1,1524,18,1542,2314,3,1,3,0,1,0,66.64
臺北市,士林區,仁勇里,0,1,2589,30,2619,3790,3,1,3,0,1,0,69.10
臺北市,士林區,義信里,0,1,1440,22,1462,2249,3,1,3,0,1,0,65.01
臺北市,士林區,福林里,0,1,2416,26,2442,3639,3,1,3,0,1,0,67.11
臺北市,士林區,福德里,0,1,2142,19,2161,3253,3,1,3,0,1,0,66.43
臺北市,士林區,福志里,0,1,4167,32,4199,6079,3,1,3,0,1,0,69.07
臺北市,士林區,舊佳里,0,1,3662,29,3691,5391,3,1,3,0,1,0,68.47
臺北市,士林區,福佳里,0,1,3869,39,3908,5803,3,1,3,0,1,0,67.34
臺北市,士林區,後港里,0,1,3820,43,3863,6101,3,1,3,0,1,0,63.32
臺北市,士林區,福中里,0,1,2574,34,2608,4030,3,1,3,0,1,0,64.71
臺北市,士林區,前港里,0,1,1888,27,1915,3038,3,1,3,0,1,0,63.03
臺北市,士林區,百齡里,0,1,3593,42,3635,5381,3,1,3,0,1,0,67.55
臺北市,士林區,承德里,0,1,2063,17,2080,3096,3,1,3,0,1,0,67.18
臺北市,士林區,福華里,0,1,3459,60,3519,5546,3,1,3,0,1,0,63.45
臺北市,士林區,明勝里,0,1,2519,40,2559,4010,3,1,3,0,1,0,63.82
臺北市,士林區,福順里,0,1,2850,37,2887,4278,3,1,3,0,1,0,67.48
臺北市,士林區,富光里,0,1,2874,45,2919,4499,3,1,3,0,1,0,64.88
臺北市,士林區,葫蘆里,0,1,3776,48,3824,5656,3,1,3,0,1,0,67.61
臺北市,士林區,葫東里,0,1,2016,19,2035,2992,3,1,3,0,1,0,68.01
臺北市,士林區,社子里,0,1,3056,39,3095,4616,3,1,3,0,1,0,67.05
臺北市,士林區,社新里,0,1,3730,66,3796,6038,3,1,3,0,1,0,62.87
臺北市,士林區,社園里,0,1,3295,35,3330,4881,3,1,3,0,1,0,68.22
臺北市,士林區,永倫里,0,1,3636,30,3666,5594,3,1,3,0,1,0,65.53
臺北市,士林區,福安里,0,1,2434,35,2469,3632,3,1,3,0,1,0,67.98
臺北市,士林區,富洲里,0,1,2608,32,2640,3995,3,1,3,0,1,0,66.08
臺北市,士林區,岩山里,0,1,2244,27,2271,3476,3,1,3,0,1,0,65.33
臺北市,士林區,名山里,0,1,3306,35,3341,5000,3,1,3,0,1,0,66.82
臺北市,士林區,德行里,0,1,2059,18,2077,3174,3,1,3,0,1,0,65.44
臺北市,士林區,德華里,0,1,2831,28,2859,4280,3,1,3,0,1,0,66.80
臺北市,士林區,聖山里,0,1,2562,18,2580,3724,3,1,3,0,1,0,69.28
臺北市,士林區,忠誠里,0,1,3072,31,3103,4356,3,1,3,0,1,0,71.24
臺北市,士林區,芝山里,0,1,3296,27,3323,5011,3,1,3,0,1,0,66.31
臺北市,士林區,東山里,0,1,2659,31,2690,3798,3,1,3,0,1,0,70.83
臺北市,士林區,三玉里,0,1,2754,25,2779,4127,3,1,3,0,1,0,67.34
臺北市,士林區,天母里,0,1,3223,23,3246,4857,3,1,3,0,1,0,66.83
臺北市,士林區,蘭雅里,0,1,4030,34,4064,6260,3,1,3,0,1,0,64.92
臺北市,士林區,蘭興里,0,1,2899,28,2927,4481,3,1,3,0,1,0,65.32
臺北市,士林區,天福里,0,1,3147,30,3177,4625,3,1,3,0,1,0,68.69
臺北市,士林區,天祿里,0,1,2462,24,2486,3827,3,1,3,0,1,0,64.96
臺北市,士林區,天壽里,0,1,2162,16,2178,3310,3,1,3,0,1,0,65.80
臺北市,士林區,天和里,0,1,3485,27,3512,5442,3,1,3,0,1,0,64.54
臺北市,士林區,天山里,0,1,3295,20,3315,5277,3,1,3,0,1,0,62.82
臺北市,士林區,天玉里,0,1,3977,37,4014,6080,3,1,3,0,1,0,66.02
臺北市,士林區,永福里,0,1,671,6,677,1048,3,1,3,0,1,0,64.60
臺北市,士林區,公舘里,0,1,735,5,740,1108,3,1,3,0,1,0,66.79
臺北市,士林區,新安里,0,1,1031,26,1057,1663,3,1,3,0,1,0,63.56
臺北市,士林區,陽明里,0,1,1570,28,1598,2640,3,1,3,0,1,0,60.53
臺北市,士林區,菁山里,0,1,853,9,862,1262,3,1,3,0,1,0,68.30
臺北市,士林區,平等里,0,1,833,6,839,1137,3,1,3,0,1,0,73.79
臺北市,士林區,溪山里,0,1,791,13,804,1218,3,1,3,0,1,0,66.01
臺北市,士林區,翠山里,0,1,3351,33,3384,5087,3,1,3,0,1,0,66.52
臺北市,松山區,莊敬里,0,1,3236,20,3256,4775,3,1,3,0,1,0,68.19
臺北市,松山區,東榮里,0,1,4569,28,4597,6947,3,1,3,0,1,0,66.17
臺北市,松山區,三民里,0,1,3483,25,3508,5441,3,1,3,0,1,0,64.47
臺北市,松山區,新益里,0,1,2459,23,2482,3791,3,1,3,0,1,0,65.47
臺北市,松山區,富錦里,0,1,2829,23,2852,4298,3,1,3,0,1,0,66.36
臺北市,松山區,新東里,0,1,2469,25,2494,3757,3,1,3,0,1,0,66.38
臺北市,松山區,富泰里,0,1,2228,15,2243,3541,3,1,3,0,1,0,63.34
臺北市,松山區,介壽里,0,1,2518,18,2536,3985,3,1,3,0,1,0,63.64
臺北市,松山區,精忠里,0,1,2389,15,2404,3730,3,1,3,0,1,0,64.45
臺北市,松山區,東光里,0,1,4042,48,4090,6154,3,1,3,0,1,0,66.46
臺北市,松山區,龍田里,0,1,2159,16,2175,3317,3,1,3,0,1,0,65.57
臺北市,松山區,東昌里,0,1,2500,19,2519,3880,3,1,3,0,1,0,64.92
臺北市,松山區,東勢里,0,1,1757,21,1778,2759,3,1,3,0,1,0,64.44
臺北市,松山區,中華里,0,1,2446,16,2462,3618,3,1,3,0,1,0,68.05
臺北市,松山區,民有里,0,1,4224,37,4261,6728,3,1,3,0,1,0,63.33
臺北市,松山區,民福里,0,1,3425,31,3456,5189,3,1,3,0,1,0,66.60
臺北市,松山區,松基里,0,1,1847,26,1873,3005,3,1,3,0,1,0,62.33
臺北市,松山區,慈祐里,0,1,3087,36,3123,4569,3,1,3,0,1,0,68.35
臺北市,松山區,安平里,0,1,4738,58,4796,7104,3,1,3,0,1,0,67.51
臺北市,松山區,鵬程里,0,1,2788,30,2818,3947,3,1,3,0,1,0,71.40
臺北市,松山區,自強里,0,1,3845,32,3877,5595,3,1,3,0,1,0,69.29
臺北市,松山區,吉祥里,0,1,3737,45,3782,5892,3,1,3,0,1,0,64.19
臺北市,松山區,新聚里,0,1,3629,34,3663,5631,3,1,3,0,1,0,65.05
臺北市,松山區,復盛里,0,1,3266,30,3296,5053,3,1,3,0,1,0,65.23
臺北市,松山區,中正里,0,1,3652,38,3690,5997,3,1,3,0,1,0,61.53
臺北市,松山區,中崙里,0,1,2033,20,2053,3158,3,1,3,0,1,0,65.01
臺北市,松山區,美仁里,0,1,1762,20,1782,2795,3,1,3,0,1,0,63.76
臺北市,松山區,吉仁里,0,1,1925,21,1946,2989,3,1,3,0,1,0,65.11
臺北市,松山區,敦化里,0,1,3749,35,3784,5687,3,1,3,0,1,0,66.54
臺北市,松山區,復源里,0,1,1708,13,1721,2591,3,1,3,0,1,0,66.42
臺北市,松山區,復建里,0,1,1727,22,1749,2709,3,1,3,0,1,0,64.56
臺北市,松山區,復勢里,0,1,3163,35,3198,4739,3,1,3,0,1,0,67.48
臺北市,松山區,福成里,0,1,1373,14,1387,2229,3,1,3,0,1,0,62.23
臺北市,信義區,西村里,0,1,2690,19,2709,3795,3,1,3,0,1,0,71.38
臺北市,信義區,正和里,0,1,2628,21,2649,3973,3,1,3,0,1,0,66.68
臺北市,信義區,興隆里,0,1,1591,14,1605,2535,3,1,3,0,1,0,63.31
臺北市,信義區,中興里,0,1,1446,14,1460,2302,3,1,3,0,1,0,63.42
臺北市,信義區,新仁里,0,1,2283,18,2301,3520,3,1,3,0,1,0,65.37
臺北市,信義區,興雅里,0,1,3209,35,3244,4908,3,1,3,0,1,0,66.10
臺北市,信義區,敦厚里,0,1,2267,19,2286,3722,3,1,3,0,1,0,61.42
臺北市,信義區,廣居里,0,1,3137,27,3164,4823,3,1,3,0,1,0,65.60
臺北市,信義區,安康里,0,1,3457,36,3493,5246,3,1,3,0,1,0,66.58
臺北市,信義區,六藝里,0,1,1910,26,1936,2862,3,1,3,0,1,0,67.65
臺北市,信義區,雅祥里,0,1,2456,28,2484,3775,3,1,3,0,1,0,65.80
臺北市,信義區,五常里,0,1,1890,23,1913,2914,3,1,3,0,1,0,65.65
臺北市,信義區,五全里,0,1,2770,32,2802,4193,3,1,3,0,1,0,66.83
臺北市,信義區,永吉里,0,1,2174,26,2200,3622,3,1,3,0,1,0,60.74
臺北市,信義區,長春里,0,1,2495,32,2527,3772,3,1,3,0,1,0,66.99
臺北市,信義區,四育里,0,1,3093,39,3132,4497,3,1,3,0,1,0,69.65
臺北市,信義區,四維里,0,1,2927,37,2964,4492,3,1,3,0,1,0,65.98
臺北市,信義區,永春里,0,1,2958,23,2981,4377,3,1,3,0,1,0,68.11
臺北市,信義區,富台里,0,1,2134,22,2156,3092,3,1,3,0,1,0,69.73
臺北市,信義區,國業里,0,1,3597,43,3640,5310,3,1,3,0,1,0,68.55
臺北市,信義區,松隆里,0,1,1415,24,1439,2233,3,1,3,0,1,0,64.44
臺北市,信義區,松友里,0,1,3126,31,3157,4696,3,1,3,0,1,0,67.23
臺北市,信義區,松光里,0,1,3061,31,3092,4633,3,1,3,0,1,0,66.74
臺北市,信義區,中坡里,0,1,2501,37,2538,3723,3,1,3,0,1,0,68.17
臺北市,信義區,中行里,0,1,4213,51,4264,6274,3,1,3,0,1,0,67.96
臺北市,信義區,大道里,0,1,3384,49,3433,5116,3,1,3,0,1,0,67.10
臺北市,信義區,大仁里,0,1,3391,66,3457,5118,3,1,3,0,1,0,67.55
臺北市,信義區,景新里,0,1,3128,21,3149,4430,3,1,3,0,1,0,71.08
臺北市,信義區,惠安里,0,1,3850,46,3896,5549,3,1,3,0,1,0,70.21
臺北市,信義區,三張里,0,1,4555,40,4595,6877,3,1,3,0,1,0,66.82
臺北市,信義區,三犁里,0,1,2432,31,2463,3710,3,1,3,0,1,0,66.39
臺北市,信義區,六合里,0,1,3253,33,3286,5014,3,1,3,0,1,0,65.54
臺北市,信義區,泰和里,0,1,4312,34,4346,6389,3,1,3,0,1,0,68.02
臺北市,信義區,景聯里,0,1,2625,32,2657,3968,3,1,3,0,1,0,66.96
臺北市,信義區,景勤里,0,1,2619,34,2653,3860,3,1,3,0,1,0,68.73
臺北市,信義區,雙和里,0,1,3581,35,3616,5191,3,1,3,0,1,0,69.66
臺北市,信義區,嘉興里,0,1,1649,21,1670,2535,3,1,3,0,1,0,65.88
臺北市,信義區,黎順里,0,1,2302,27,2329,3505,3,1,3,0,1,0,66.45
臺北市,信義區,黎平里,0,1,3558,44,3602,5374,3,1,3,0,1,0,67.03
臺北市,信義區,黎忠里,0,1,2545,34,2579,3847,3,1,3,0,1,0,67.04
臺北市,信義區,黎安里,0,1,1711,45,1756,2461,3,1,3,0,1,0,71.35
臺北市,內湖區,西康里,0,1,3750,48,3798,5357,3,1,3,0,1,0,70.90
臺北市,內湖區,西安里,0,1,2939,33,2972,4126,3,1,3,0,1,0,72.03
臺北市,內湖區,西湖里,0,1,3974,39,4013,5819,3,1,3,0,1,0,68.96
臺北市,內湖區,港墘里,0,1,2333,27,2360,3270,3,1,3,0,1,0,72.17
臺北市,內湖區,港華里,0,1,3789,35,3824,5448,3,1,3,0,1,0,70.19
臺北市,內湖區,港都里,0,1,5310,44,5354,7654,3,1,3,0,1,0,69.95
臺北市,內湖區,港富里,0,1,4382,63,4445,6404,3,1,3,0,1,0,69.41
臺北市,內湖區,瑞光里,0,1,2369,19,2388,3268,3,1,3,0,1,0,73.07
臺北市,內湖區,瑞陽里,0,1,4065,49,4114,5428,3,1,3,0,1,0,75.79
臺北市,內湖區,紫陽里,0,1,3198,30,3228,4646,3,1,3,0,1,0,69.48
臺北市,內湖區,湖濱里,0,1,3559,42,3601,5115,3,1,3,0,1,0,70.40
臺北市,內湖區,湖元里,0,1,2135,19,2154,3078,3,1,3,0,1,0,69.98
臺北市,內湖區,石潭里,0,1,1656,22,1678,2475,3,1,3,0,1,0,67.80
臺北市,內湖區,內湖里,0,1,2101,32,2133,3305,3,1,3,0,1,0,64.54
臺北市,內湖區,金龍里,0,1,2953,24,2977,4142,3,1,3,0,1,0,71.87
臺北市,內湖區,金瑞里,0,1,3064,35,3099,4367,3,1,3,0,1,0,70.96
臺北市,內湖區,碧山里,0,1,3161,39,3200,4536,3,1,3,0,1,0,70.55
臺北市,內湖區,行善里,0,1,1714,25,1739,2441,3,1,3,0,1,0,71.24
臺北市,內湖區,週美里,0,1,2420,34,2454,3483,3,1,3,0,1,0,70.46
臺北市,內湖區,紫星里,0,1,4026,57,4083,5840,3,1,3,0,1,0,69.91
臺北市,內湖區,紫雲里,0,1,2673,27,2700,3772,3,1,3,0,1,0,71.58
臺北市,內湖區,清白里,0,1,2007,24,2031,2827,3,1,3,0,1,0,71.84
臺北市,內湖區,大湖里,0,1,4056,32,4088,6190,3,1,3,0,1,0,66.04
臺北市,內湖區,湖興里,0,1,3102,27,3129,4464,3,1,3,0,1,0,70.09
臺北市,內湖區,葫洲里,0,1,8475,67,8542,12520,3,1,3,0,1,0,68.23
臺北市,內湖區,五分里,0,1,3526,42,3568,5343,3,1,3,0,1,0,66.78
臺北市,內湖區,樂康里,0,1,3210,43,3253,4868,3,1,3,0,1,0,66.82
臺北市,內湖區,東湖里,0,1,6014,56,6070,9127,3,1,3,0,1,0,66.51
臺北市,內湖區,內溝里,0,1,3490,33,3523,5226,3,1,3,0,1,0,67.41
臺北市,南港區,南港里,0,1,2696,36,2732,4053,3,1,3,0,1,0,67.41
臺北市,南港區,中南里,0,1,2067,34,2101,3220,3,1,3,0,1,0,65.25
臺北市,南港區,新富里,0,1,2152,43,2195,3180,3,1,3,0,1,0,69.03
臺北市,南港區,三重里,0,1,1670,24,1694,2609,3,1,3,0,1,0,64.93
臺北市,南港區,東新里,0,1,3341,43,3384,5079,3,1,3,0,1,0,66.63
臺北市,南港區,新光里,0,1,2457,32,2489,3514,3,1,3,0,1,0,70.83
臺北市,南港區,東明里,0,1,2165,39,2204,3261,3,1,3,0,1,0,67.59
臺北市,南港區,西新里,0,1,2336,28,2364,3485,3,1,3,0,1,0,67.83
臺北市,南港區,玉成里,0,1,2392,25,2417,3574,3,1,3,0,1,0,67.63
臺北市,南港區,合成里,0,1,3207,39,3246,4643,3,1,3,0,1,0,69.91
臺北市,南港區,成福里,0,1,3746,47,3793,5337,3,1,3,0,1,0,71.07
臺北市,南港區,鴻福里,0,1,2417,41,2458,3546,3,1,3,0,1,0,69.32
臺北市,南港區,萬福里,0,1,2374,26,2400,3285,3,1,3,0,1,0,73.06
臺北市,南港區,百福里,0,1,2560,41,2601,3814,3,1,3,0,1,0,68.20
臺北市,南港區,聯成里,0,1,2805,50,2855,3996,3,1,3,0,1,0,71.45
臺北市,南港區,舊莊里,0,1,3807,66,3873,6024,3,1,3,0,1,0,64.29
臺北市,南港區,中研里,0,1,4705,54,4759,6670,3,1,3,0,1,0,71.35
臺北市,南港區,九如里,0,1,3272,31,3303,4756,3,1,3,0,1,0,69.45
臺北市,中山區,正守里,0,2,1850,31,1881,3114,3,1,3,0,1,0,60.40
臺北市,中山區,正義里,0,2,1739,24,1763,3344,3,1,3,0,1,0,52.72
臺北市,中山區,正得里,0,2,1507,21,1528,2762,3,1,3,0,1,0,55.32
臺北市,中山區,民安里,0,2,2491,30,2521,4225,3,1,3,0,1,0,59.67
臺北市,中山區,康樂里,0,2,2470,40,2510,4406,3,1,3,0,1,0,56.97
臺北市,中山區,中山里,0,2,2113,24,2137,3876,3,1,3,0,1,0,55.13
臺北市,中山區,聚盛里,0,2,1353,24,1377,2637,3,1,3,0,1,0,52.22
臺北市,中山區,集英里,0,2,2713,39,2752,4575,3,1,3,0,1,0,60.15
臺北市,中山區,聚葉里,0,2,1713,41,1754,2987,3,1,3,0,1,0,58.72
臺北市,中山區,恆安里,0,2,1382,18,1400,2435,3,1,3,0,1,0,57.49
臺北市,中山區,晴光里,0,2,1565,29,1594,3152,3,1,3,0,1,0,50.57
臺北市,中山區,圓山里,0,2,2273,31,2304,3922,3,1,3,0,1,0,58.75
臺北市,中山區,新庄里,0,2,2380,32,2412,4045,3,1,3,0,1,0,59.63
臺北市,中山區,劍潭里,0,2,1604,13,1617,2358,3,1,3,0,1,0,68.58
臺北市,中山區,大直里,0,2,5238,65,5303,7705,3,1,3,0,1,0,68.83
臺北市,中山區,成功里,0,2,2668,31,2699,3824,3,1,3,0,1,0,70.58
臺北市,中山區,永安里,0,2,2657,25,2682,3881,3,1,3,0,1,0,69.11
臺北市,中山區,新喜里,0,2,2370,36,2406,3798,3,1,3,0,1,0,63.35
臺北市,中山區,大佳里,0,2,573,8,581,874,3,1,3,0,1,0,66.48
臺北市,中山區,新福里,0,2,2450,52,2502,4094,3,1,3,0,1,0,61.11
臺北市,中山區,松江里,0,2,3136,43,3179,5085,3,1,3,0,1,0,62.52
臺北市,中山區,新生里,0,2,2273,26,2299,3892,3,1,3,0,1,0,59.07
臺北市,中山區,中庄里,0,2,2656,46,2702,4529,3,1,3,0,1,0,59.66
臺北市,中山區,行政里,0,2,2455,24,2479,3977,3,1,3,0,1,0,62.33
臺北市,中山區,行仁里,0,2,3902,55,3957,6245,3,1,3,0,1,0,63.36
臺北市,中山區,行孝里,0,2,1845,39,1884,3054,3,1,3,0,1,0,61.69
臺北市,中山區,下埤里,0,2,3449,36,3485,5545,3,1,3,0,1,0,62.85
臺北市,中山區,江寧里,0,2,3047,27,3074,4887,3,1,3,0,1,0,62.90
臺北市,中山區,江山里,0,2,3713,41,3754,5884,3,1,3,0,1,0,63.80
臺北市,中山區,中吉里,0,2,2457,33,2490,4140,3,1,3,0,1,0,60.14
臺北市,中山區,中原里,0,2,2119,32,2151,3635,3,1,3,0,1,0,59.17
臺北市,中山區,興亞里,0,2,2472,24,2496,4188,3,1,3,0,1,0,59.60
臺北市,中山區,中央里,0,2,1820,24,1844,2976,3,1,3,0,1,0,61.96
臺北市,中山區,朱馥里,0,2,3143,49,3192,5135,3,1,3,0,1,0,62.16
臺北市,中山區,龍洲里,0,2,3130,33,3163,4447,3,1,3,0,1,0,71.13
臺北市,中山區,朱園里,0,2,2146,24,2170,3403,3,1,3,0,1,0,63.77
臺北市,中山區,埤頭里,0,2,2339,31,2370,3651,3,1,3,0,1,0,64.91
臺北市,中山區,朱崙里,0,2,1705,37,1742,2757,3,1,3,0,1,0,63.18
臺北市,中山區,力行里,0,2,3143,35,3178,5180,3,1,3,0,1,0,61.35
臺北市,中山區,復華里,0,2,1844,36,1880,3032,3,1,3,0,1,0,62.01
臺北市,大同區,玉泉里,0,2,2023,33,2056,3231,3,1,3,0,1,0,63.63
臺北市,大同區,建明里,0,2,1917,26,1943,3094,3,1,3,0,1,0,62.80
臺北市,大同區,建功里,0,2,2063,29,2092,3208,3,1,3,0,1,0,65.21
臺北市,大同區,建泰里,0,2,1789,28,1817,2777,3,1,3,0,1,0,65.43
臺北市,大同區,永樂里,0,2,2635,26,2661,3979,3,1,3,0,1,0,66.88
臺北市,大同區,朝陽里,0,2,1751,19,1770,2775,3,1,3,0,1,0,63.78
臺北市,大同區,星明里,0,2,2172,24,2196,3330,3,1,3,0,1,0,65.95
臺北市,大同區,光能里,0,2,2883,47,2930,4291,3,1,3,0,1,0,68.28
臺北市,大同區,大有里,0,2,2704,30,2734,3955,3,1,3,0,1,0,69.13
臺北市,大同區,延平里,0,2,1844,23,1867,2977,3,1,3,0,1,0,62.71
臺北市,大同區,雙連里,0,2,4419,65,4484,6907,3,1,3,0,1,0,64.92
臺北市,大同區,南芳里,0,2,2071,31,2102,3250,3,1,3,0,1,0,64.68
臺北市,大同區,民權里,0,2,3341,45,3386,5192,3,1,3,0,1,0,65.22
臺北市,大同區,景星里,0,2,1577,26,1603,2507,3,1,3,0,1,0,63.94
臺北市,大同區,隆和里,0,2,1680,22,1702,2550,3,1,3,0,1,0,66.75
臺北市,大同區,蓬萊里,0,2,2406,32,2438,3835,3,1,3,0,1,0,63.57
臺北市,大同區,國順里,0,2,2329,41,2370,3525,3,1,3,0,1,0,67.23
臺北市,大同區,國慶里,0,2,1293,16,1309,1919,3,1,3,0,1,0,68.21
臺北市,大同區,揚雅里,0,2,1593,27,1620,2518,3,1,3,0,1,0,64.34
臺北市,大同區,斯文里,0,2,2614,36,2650,4137,3,1,3,0,1,0,64.06
臺北市,大同區,鄰江里,0,2,3430,44,3474,5119,3,1,3,0,1,0,67.86
臺北市,大同區,至聖里,0,2,4133,45,4178,6296,3,1,3,0,1,0,66.36
臺北市,大同區,文昌里,0,2,644,5,649,967,3,1,3,0,1,0,67.11
臺北市,大同區,老師里,0,2,2325,22,2347,3585,3,1,3,0,1,0,65.47
臺北市,大同區,重慶里,0,2,2127,29,2156,3140,3,1,3,0,1,0,68.66
臺北市,大同區,保安里,0,2,3150,38,3188,4653,3,1,3,0,1,0,68.51
臺北市,大安區,德安里,0,2,2458,24,2482,4209,3,1,3,0,1,0,58.97
臺北市,大安區,仁慈里,0,2,2295,17,2312,3742,3,1,3,0,1,0,61.79
臺北市,大安區,和安里,0,2,3305,36,3341,5193,3,1,3,0,1,0,64.34
臺北市,大安區,民炤里,0,2,3913,39,3952,6339,3,1,3,0,1,0,62.34
臺北市,大安區,仁愛里,0,2,2592,18,2610,4812,3,1,3,0,1,0,54.24
臺北市,大安區,義村里,0,2,3777,29,3806,5678,3,1,3,0,1,0,67.03
臺北市,大安區,民輝里,0,2,2855,23,2878,4730,3,1,3,0,1,0,60.85
臺北市,大安區,昌隆里,0,2,2127,23,2150,3564,3,1,3,0,1,0,60.33
臺北市,大安區,誠安里,0,2,2330,27,2357,3719,3,1,3,0,1,0,63.38
臺北市,大安區,光武里,0,2,3551,46,3597,6174,3,1,3,0,1,0,58.26
臺北市,大安區,龍坡里,0,2,2838,20,2858,4348,3,1,3,0,1,0,65.73
臺北市,大安區,龍泉里,0,2,2125,17,2142,3549,3,1,3,0,1,0,60.36
臺北市,大安區,古風里,0,2,2077,17,2094,3305,3,1,3,0,1,0,63.36
臺北市,大安區,古莊里,0,2,3186,32,3218,5069,3,1,3,0,1,0,63.48
臺北市,大安區,龍安里,0,2,2594,18,2612,4039,3,1,3,0,1,0,64.67
臺北市,大安區,錦安里,0,2,2542,16,2558,4054,3,1,3,0,1,0,63.10
臺北市,大安區,福住里,0,2,2243,12,2255,3671,3,1,3,0,1,0,61.43
臺北市,大安區,永康里,0,2,1742,18,1760,2679,3,1,3,0,1,0,65.70
臺北市,大安區,光明里,0,2,2238,22,2260,3398,3,1,3,0,1,0,66.51
臺北市,大安區,錦泰里,0,2,2881,20,2901,4233,3,1,3,0,1,0,68.53
臺北市,大安區,錦華里,0,2,2850,26,2876,4168,3,1,3,0,1,0,69.00
臺北市,大安區,龍圖里,0,2,3267,33,3300,5147,3,1,3,0,1,0,64.12
臺北市,大安區,新龍里,0,2,3409,22,3431,5037,3,1,3,0,1,0,68.12
臺北市,大安區,龍陣里,0,2,1926,20,1946,3179,3,1,3,0,1,0,61.21
臺北市,大安區,龍雲里,0,2,2692,18,2710,4189,3,1,3,0,1,0,64.69
臺北市,大安區,龍生里,0,2,3208,33,3241,4929,3,1,3,0,1,0,65.75
臺北市,大安區,住安里,0,2,2942,36,2978,4665,3,1,3,0,1,0,63.84
臺北市,大安區,義安里,0,2,2752,21,2773,4432,3,1,3,0,1,0,62.57
臺北市,大安區,通化里,0,2,3168,53,3221,5102,3,1,3,0,1,0,63.13
臺北市,大安區,通安里,0,2,3138,36,3174,4873,3,1,3,0,1,0,65.13
臺北市,大安區,臨江里,0,2,2278,39,2317,3695,3,1,3,0,1,0,62.71
臺北市,大安區,法治里,0,2,2085,19,2104,3333,3,1,3,0,1,0,63.13
臺北市,大安區,全安里,0,2,2202,24,2226,3484,3,1,3,0,1,0,63.89
臺北市,大安區,群賢里,0,2,3133,31,3164,5031,3,1,3,0,1,0,62.89
臺北市,大安區,群英里,0,2,4223,27,4250,6038,3,1,3,0,1,0,70.39
臺北市,大安區,虎嘯里,0,2,1741,9,1750,2761,3,1,3,0,1,0,63.38
臺北市,大安區,臥龍里,0,2,1750,20,1770,2725,3,1,3,0,1,0,64.95
臺北市,大安區,龍淵里,0,2,4398,33,4431,6885,3,1,3,0,1,0,64.36
臺北市,大安區,龍門里,0,2,2360,34,2394,4007,3,1,3,0,1,0,59.75
臺北市,大安區,農場里,0,2,1412,6,1418,2326,3,1,3,0,1,0,60.96
臺北市,大安區,大學里,0,2,4136,26,4162,6587,3,1,3,0,1,0,63.19
臺北市,大安區,芳和里,0,2,3499,39,3538,5182,3,1,3,0,1,0,68.27
臺北市,大安區,青峰里,0,2,1287,20,1307,2078,3,1,3,0,1,0,62.90
臺北市,大安區,黎元里,0,2,2888,31,2919,4464,3,1,3,0,1,0,65.39
臺北市,大安區,黎孝里,0,2,3901,58,3959,5869,3,1,3,0,1,0,67.46
臺北市,大安區,黎和里,0,2,2132,34,2166,3265,3,1,3,0,1,0,66.34
臺北市,大安區,建安里,0,2,2362,30,2392,4133,3,1,3,0,1,0,57.88
臺北市,大安區,建倫里,0,2,2788,23,2811,4783,3,1,3,0,1,0,58.77
臺北市,大安區,敦安里,0,2,2962,34,2996,5001,3,1,3,0,1,0,59.91
臺北市,大安區,正聲里,0,2,2316,16,2332,3964,3,1,3,0,1,0,58.83
臺北市,大安區,敦煌里,0,2,2922,26,2948,4763,3,1,3,0,1,0,61.89
臺北市,大安區,華聲里,0,2,2167,23,2190,3547,3,1,3,0,1,0,61.74
臺北市,大安區,車層里,0,2,3199,21,3220,5386,3,1,3,0,1,0,59.78
臺北市,大安區,光信里,0,2,3591,29,3620,5718,3,1,3,0,1,0,63.31
臺北市,中正區,水源里,0,2,1926,24,1950,2951,3,1,3,0,1,0,66.08
臺北市,中正區,富水里,0,2,1467,16,1483,2383,3,1,3,0,1,0,62.23
臺北市,中正區,文盛里,0,2,1425,15,1440,2150,3,1,3,0,1,0,66.98
臺北市,中正區,林興里,0,2,2607,28,2635,3969,3,1,3,0,1,0,66.39
臺北市,中正區,河堤里,0,2,2567,27,2594,4126,3,1,3,0,1,0,62.87
臺北市,中正區,頂東里,0,2,2944,25,2969,4611,3,1,3,0,1,0,64.39
臺北市,中正區,網溪里,0,2,2990,37,3027,4579,3,1,3,0,1,0,66.11
臺北市,中正區,板溪里,0,2,1816,26,1842,2860,3,1,3,0,1,0,64.41
臺北市,中正區,螢圃里,0,2,2811,23,2834,4122,3,1,3,0,1,0,68.75
臺北市,中正區,螢雪里,0,2,2355,25,2380,3616,3,1,3,0,1,0,65.82
臺北市,中正區,永功里,0,2,3558,35,3593,5525,3,1,3,0,1,0,65.03
臺北市,中正區,永昌里,0,2,2916,38,2954,4437,3,1,3,0,1,0,66.58
臺北市,中正區,龍興里,0,2,2515,35,2550,3783,3,1,3,0,1,0,67.41
臺北市,中正區,忠勤里,0,2,3779,77,3856,6025,3,1,3,0,1,0,64.00
臺北市,中正區,廈安里,0,2,1772,20,1792,2635,3,1,3,0,1,0,68.01
臺北市,中正區,愛國里,0,2,1830,22,1852,2852,3,1,3,0,1,0,64.94
臺北市,中正區,南門里,0,2,2206,27,2233,3471,3,1,3,0,1,0,64.33
臺北市,中正區,龍光里,0,2,2385,23,2408,3645,3,1,3,0,1,0,66.06
臺北市,中正區,南福里,0,2,4005,39,4044,5951,3,1,3,0,1,0,67.95
臺北市,中正區,龍福里,0,2,2977,32,3009,4449,3,1,3,0,1,0,67.63
臺北市,中正區,新營里,0,2,4443,46,4489,6360,3,1,3,0,1,0,70.58
臺北市,中正區,建國里,0,2,714,5,719,1274,3,1,3,0,1,0,56.44
臺北市,中正區,光復里,0,2,1712,19,1731,3018,3,1,3,0,1,0,57.36
臺北市,中正區,黎明里,0,2,1176,16,1192,2076,3,1,3,0,1,0,57.42
臺北市,中正區,梅花里,0,2,1940,21,1961,2946,3,1,3,0,1,0,66.56
臺北市,中正區,幸福里,0,2,2197,22,2219,3651,3,1,3,0,1,0,60.78
臺北市,中正區,幸市里,0,2,2209,29,2238,3689,3,1,3,0,1,0,60.67
臺北市,中正區,東門里,0,2,1633,26,1659,2725,3,1,3,0,1,0,60.88
臺北市,中正區,文北里,0,2,2494,21,2515,4005,3,1,3,0,1,0,62.80
臺北市,中正區,文祥里,0,2,3550,26,3576,5227,3,1,3,0,1,0,68.41
臺北市,中正區,三愛里,0,2,3976,37,4013,6183,3,1,3,0,1,0,64.90
臺北市,萬華區,福星里,0,2,2238,34,2272,3907,3,1,3,0,1,0,58.15
臺北市,萬華區,萬壽里,0,2,1469,23,1492,2570,3,1,3,0,1,0,58.05
臺北市,萬華區,西門里,0,2,1628,27,1655,2820,3,1,3,0,1,0,58.69
臺北市,萬華區,新起里,0,2,3573,57,3630,5408,3,1,3,0,1,0,67.12
臺北市,萬華區,菜園里,0,2,2874,60,2934,4514,3,1,3,0,1,0,65.00
臺北市,萬華區,青山里,0,2,2631,43,2674,4195,3,1,3,0,1,0,63.74
臺北市,萬華區,富民里,0,2,2567,33,2600,3921,3,1,3,0,1,0,66.31
臺北市,萬華區,福音里,0,2,2186,20,2206,3252,3,1,3,0,1,0,67.84
臺北市,萬華區,仁德里,0,2,2513,40,2553,3599,3,1,3,0,1,0,70.94
臺北市,萬華區,富福里,0,2,2538,27,2565,3750,3,1,3,0,1,0,68.40
臺北市,萬華區,頂碩里,0,2,4283,78,4361,6497,3,1,3,0,1,0,67.12
臺北市,萬華區,雙園里,0,2,2610,43,2653,4032,3,1,3,0,1,0,65.80
臺北市,萬華區,新忠里,0,2,2386,19,2405,3523,3,1,3,0,1,0,68.27
臺北市,萬華區,新和里,0,2,5025,49,5074,7199,3,1,3,0,1,0,70.48
臺北市,萬華區,糖廍里,0,2,2214,37,2251,3508,3,1,3,0,1,0,64.17
臺北市,萬華區,和平里,0,2,3903,51,3954,5999,3,1,3,0,1,0,65.91
臺北市,萬華區,綠堤里,0,2,3008,36,3044,4917,3,1,3,0,1,0,61.91
臺北市,萬華區,華江里,0,2,4474,57,4531,6886,3,1,3,0,1,0,65.80
臺北市,萬華區,柳鄉里,0,2,2911,39,2950,4613,3,1,3,0,1,0,63.95
臺北市,萬華區,日善里,0,2,1949,34,1983,3033,3,1,3,0,1,0,65.38
臺北市,萬華區,新安里,0,2,3718,61,3779,5723,3,1,3,0,1,0,66.03
臺北市,萬華區,忠德里,0,2,2339,25,2364,3565,3,1,3,0,1,0,66.31
臺北市,萬華區,孝德里,0,2,1754,18,1772,2673,3,1,3,0,1,0,66.29
臺北市,萬華區,和德里,0,2,3629,69,3698,5838,3,1,3,0,1,0,63.34
臺北市,萬華區,錦德里,0,2,2693,42,2735,4194,3,1,3,0,1,0,65.21
臺北市,萬華區,全德里,0,2,2095,28,2123,3286,3,1,3,0,1,0,64.61
臺北市,萬華區,保德里,0,2,1676,24,1700,2496,3,1,3,0,1,0,68.11
臺北市,萬華區,銘德里,0,2,2488,42,2530,3844,3,1,3,0,1,0,65.82
臺北市,萬華區,榮德里,0,2,2154,40,2194,3268,3,1,3,0,1,0,67.14
臺北市,萬華區,壽德里,0,2,2613,35,2648,3994,3,1,3,0,1,0,66.30
臺北市,萬華區,興德里,0,2,2359,40,2399,3808,3,1,3,0,1,0,63.00
臺北市,萬華區,華中里,0,2,3368,50,3418,5308,3,1,3,0,1,0,64.39
臺北市,萬華區,日祥里,0,2,2654,24,2678,4008,3,1,3,0,1,0,66.82
臺北市,萬華區,忠貞里,0,2,2815,52,2867,4426,3,1,3,0,1,0,64.78
臺北市,萬華區,凌霄里,0,2,2469,39,2508,3731,3,1,3,0,1,0,67.22
臺北市,萬華區,騰雲里,0,2,1632,18,1650,2430,3,1,3,0,1,0,67.90
臺北市,文山區,景行里,0,2,2481,38,2519,3765,3,1,3,0,1,0,66.91
臺北市,文山區,景東里,0,2,2757,20,2777,4197,3,1,3,0,1,0,66.17
臺北市,文山區,景美里,0,2,2185,25,2210,3288,3,1,3,0,1,0,67.21
臺北市,文山區,景慶里,0,2,3124,33,3157,4566,3,1,3,0,1,0,69.14
臺北市,文山區,景仁里,0,2,2118,26,2144,3167,3,1,3,0,1,0,67.70
臺北市,文山區,景華里,0,2,2907,26,2933,4410,3,1,3,0,1,0,66.51
臺北市,文山區,萬有里,0,2,2438,22,2460,3561,3,1,3,0,1,0,69.08
臺北市,文山區,萬祥里,0,2,2540,32,2572,3728,3,1,3,0,1,0,68.99
臺北市,文山區,萬隆里,0,2,2795,18,2813,4128,3,1,3,0,1,0,68.14
臺北市,文山區,萬年里,0,2,2714,25,2739,4202,3,1,3,0,1,0,65.18
臺北市,文山區,萬和里,0,2,2208,22,2230,2936,3,1,3,0,1,0,75.95
臺北市,文山區,萬盛里,0,2,2451,23,2474,3679,3,1,3,0,1,0,67.25
臺北市,文山區,興豐里,0,2,3444,27,3471,5029,3,1,3,0,1,0,69.02
臺北市,文山區,興光里,0,2,1980,20,2000,3146,3,1,3,0,1,0,63.57
臺北市,文山區,興家里,0,2,1837,18,1855,2695,3,1,3,0,1,0,68.83
臺北市,文山區,興得里,0,2,3953,52,4005,6084,3,1,3,0,1,0,65.83
臺北市,文山區,興業里,0,2,2683,27,2710,3931,3,1,3,0,1,0,68.94
臺北市,文山區,興安里,0,2,2429,37,2466,3722,3,1,3,0,1,0,66.25
臺北市,文山區,興福里,0,2,2967,43,3010,4360,3,1,3,0,1,0,69.04
臺北市,文山區,興旺里,0,2,2566,31,2597,3813,3,1,3,0,1,0,68.11
臺北市,文山區,興泰里,0,2,1730,25,1755,2575,3,1,3,0,1,0,68.16
臺北市,文山區,興昌里,0,2,1985,17,2002,2962,3,1,3,0,1,0,67.59
臺北市,文山區,試院里,0,2,3063,30,3093,4432,3,1,3,0,1,0,69.79
臺北市,文山區,華興里,0,2,3388,34,3422,5010,3,1,3,0,1,0,68.30
臺北市,文山區,明義里,0,2,2132,69,2201,3433,3,1,3,0,1,0,64.11
臺北市,文山區,明興里,0,2,2875,37,2912,4246,3,1,3,0,1,0,68.58
臺北市,文山區,木柵里,0,2,3654,41,3695,5163,3,1,3,0,1,0,71.57
臺北市,文山區,木新里,0,2,3797,59,3856,5819,3,1,3,0,1,0,66.27
臺北市,文山區,順興里,0,2,4782,54,4836,6889,3,1,3,0,1,0,70.20
臺北市,文山區,樟林里,0,2,4179,41,4220,6104,3,1,3,0,1,0,69.13
臺北市,文山區,樟新里,0,2,4782,87,4869,7066,3,1,3,0,1,0,68.91
臺北市,文山區,樟腳里,0,2,4423,55,4478,6446,3,1,3,0,1,0,69.47
臺北市,文山區,萬芳里,0,2,4714,47,4761,6816,3,1,3,0,1,0,69.85
臺北市,文山區,博嘉里,0,2,1793,40,1833,2839,3,1,3,0,1,0,64.56
臺北市,文山區,萬興里,0,2,3086,45,3131,4777,3,1,3,0,1,0,65.54
臺北市,文山區,指南里,0,2,1211,20,1231,1870,3,1,3,0,1,0,65.83
臺北市,文山區,老泉里,0,2,378,6,384,578,3,1,3,0,1,0,66.44
高雄市,鹽埕區,藍橋里,0,1,704,13,717,978,3,1,3,0,1,0,73.31
高雄市,鹽埕區,壽星里,0,1,933,23,956,1302,3,1,3,0,1,0,73.43
高雄市,鹽埕區,慈愛里,0,1,497,12,509,691,3,1,3,0,1,0,73.66
高雄市,鹽埕區,博愛里,0,1,587,8,595,749,3,1,3,0,1,0,79.44
高雄市,鹽埕區,陸橋里,0,1,982,15,997,1384,3,1,3,0,1,0,72.04
高雄市,鹽埕區,中山里,0,1,869,14,883,1239,3,1,3,0,1,0,71.27
高雄市,鹽埕區,中原里,0,1,498,16,514,705,3,1,3,0,1,0,72.91
高雄市,鹽埕區,府北里,0,1,1162,13,1175,1742,3,1,3,0,1,0,67.45
高雄市,鹽埕區,瀨南里,0,1,571,7,578,760,3,1,3,0,1,0,76.05
高雄市,鹽埕區,新樂里,0,1,556,9,565,760,3,1,3,0,1,0,74.34
高雄市,鹽埕區,教仁里,0,1,1583,27,1610,2212,3,1,3,0,1,0,72.78
高雄市,鹽埕區,江西里,0,1,895,12,907,1307,3,1,3,0,1,0,69.40
高雄市,鹽埕區,新豐里,0,1,532,8,540,716,3,1,3,0,1,0,75.42
高雄市,鹽埕區,港都里,0,1,880,20,900,1223,3,1,3,0,1,0,73.59
高雄市,鹽埕區,江南里,0,1,664,11,675,942,3,1,3,0,1,0,71.66
高雄市,鹽埕區,新化里,0,1,613,21,634,853,3,1,3,0,1,0,74.33
高雄市,鹽埕區,河濱里,0,1,1340,15,1355,1908,3,1,3,0,1,0,71.02
高雄市,鹽埕區,南端里,0,1,851,10,861,1209,3,1,3,0,1,0,71.22
高雄市,鹽埕區,沙地里,0,1,782,11,793,1155,3,1,3,0,1,0,68.66
高雄市,鹽埕區,育仁里,0,1,632,16,648,911,3,1,3,0,1,0,71.13
高雄市,鹽埕區,光明里,0,1,727,13,740,1020,3,1,3,0,1,0,72.55
高雄市,鼓山區,鼓峰里,0,1,1465,31,1496,2083,3,1,3,0,1,0,71.82
高雄市,鼓山區,雄峰里,0,1,1509,15,1524,2038,3,1,3,0,1,0,74.78
高雄市,鼓山區,前峰里,0,1,3123,31,3154,4016,3,1,3,0,1,0,78.54
高雄市,鼓山區,光榮里,0,1,2917,30,2947,3907,3,1,3,0,1,0,75.43
高雄市,鼓山區,民族里,0,1,1067,29,1096,1494,3,1,3,0,1,0,73.36
高雄市,鼓山區,自強里,0,1,658,5,663,876,3,1,3,0,1,0,75.68
高雄市,鼓山區,內惟里,0,1,899,12,911,1206,3,1,3,0,1,0,75.54
高雄市,鼓山區,建國里,0,1,1582,20,1602,2059,3,1,3,0,1,0,77.80
高雄市,鼓山區,龍井里,0,1,1169,13,1182,1555,3,1,3,0,1,0,76.01
高雄市,鼓山區,忠正里,0,1,3237,42,3279,4489,3,1,3,0,1,0,73.05
高雄市,鼓山區,正德里,0,1,1087,11,1098,1499,3,1,3,0,1,0,73.25
高雄市,鼓山區,平和里,0,1,2100,27,2127,2820,3,1,3,0,1,0,75.43
高雄市,鼓山區,民強里,0,1,1519,23,1542,2042,3,1,3,0,1,0,75.51
高雄市,鼓山區,厚生里,0,1,1497,11,1508,1968,3,1,3,0,1,0,76.63
高雄市,鼓山區,龍子里,0,1,2566,43,2609,3670,3,1,3,0,1,0,71.09
高雄市,鼓山區,明誠里,0,1,3713,47,3760,5176,3,1,3,0,1,0,72.64
高雄市,鼓山區,龍水里,0,1,937,7,944,1349,3,1,3,0,1,0,69.98
高雄市,鼓山區,華豐里,0,1,2283,18,2301,3093,3,1,3,0,1,0,74.39
高雄市,鼓山區,裕豐里,0,1,1633,8,1641,2228,3,1,3,0,1,0,73.65
高雄市,鼓山區,裕興里,0,1,1585,21,1606,2192,3,1,3,0,1,0,73.27
高雄市,鼓山區,鼓岩里,0,1,1336,17,1353,1805,3,1,3,0,1,0,74.96
高雄市,鼓山區,樹德里,0,1,759,6,765,1006,3,1,3,0,1,0,76.04
高雄市,鼓山區,寶樹里,0,1,688,10,698,961,3,1,3,0,1,0,72.63
高雄市,鼓山區,興宗里,0,1,1258,18,1276,1722,3,1,3,0,1,0,74.10
高雄市,鼓山區,綠川里,0,1,1301,15,1316,1901,3,1,3,0,1,0,69.23
高雄市,鼓山區,河邊里,0,1,1151,15,1166,1561,3,1,3,0,1,0,74.70
高雄市,鼓山區,光化里,0,1,1175,15,1190,1702,3,1,3,0,1,0,69.92
高雄市,鼓山區,山下里,0,1,1140,14,1154,1609,3,1,3,0,1,0,71.72
高雄市,鼓山區,登山里,0,1,592,12,604,878,3,1,3,0,1,0,68.79
高雄市,鼓山區,峰南里,0,1,857,48,905,1265,3,1,3,0,1,0,71.54
高雄市,鼓山區,新民里,0,1,929,14,943,1296,3,1,3,0,1,0,72.76
高雄市,鼓山區,延平里,0,1,773,25,798,1128,3,1,3,0,1,0,70.74
高雄市,鼓山區,維生里,0,1,1160,17,1177,1672,3,1,3,0,1,0,70.39
高雄市,鼓山區,麗興里,0,1,886,11,897,1295,3,1,3,0,1,0,69.27
高雄市,鼓山區,惠安里,0,1,981,17,998,1493,3,1,3,0,1,0,66.85
高雄市,鼓山區,壽山里,0,1,1232,18,1250,1772,3,1,3,0,1,0,70.54
高雄市,鼓山區,哨船頭里,0,1,779,5,784,1133,3,1,3,0,1,0,69.20
高雄市,鼓山區,桃源里,0,1,398,4,402,525,3,1,3,0,1,0,76.57
高雄市,旗津區,旗下里,0,1,972,28,1000,1328,3,1,3,0,1,0,75.30
高雄市,旗津區,永安里,0,1,845,13,858,1231,3,1,3,0,1,0,69.70
高雄市,旗津區,振興里,0,1,1269,30,1299,1745,3,1,3,0,1,0,74.44
高雄市,旗津區,慈愛里,0,1,1505,25,1530,2145,3,1,3,0,1,0,71.33
高雄市,旗津區,復興里,0,1,1900,33,1933,2624,3,1,3,0,1,0,73.67
高雄市,旗津區,中華里,0,1,806,13,819,1060,3,1,3,0,1,0,77.26
高雄市,旗津區,實踐里,0,1,1171,14,1185,1687,3,1,3,0,1,0,70.24
高雄市,旗津區,北汕里,0,1,1656,40,1696,2355,3,1,3,0,1,0,72.02
高雄市,旗津區,南汕里,0,1,1145,37,1182,1621,3,1,3,0,1,0,72.92
高雄市,旗津區,上竹里,0,1,1571,32,1603,2306,3,1,3,0,1,0,69.51
高雄市,旗津區,中洲里,0,1,1147,16,1163,1565,3,1,3,0,1,0,74.31
高雄市,旗津區,安順里,0,1,725,15,740,1088,3,1,3,0,1,0,68.01
高雄市,旗津區,中興里,0,1,1418,30,1448,1869,3,1,3,0,1,0,77.47
高雄市,左營區,進學里,0,1,1317,21,1338,1823,3,1,3,0,1,0,73.40
高雄市,左營區,尾西里,0,1,1024,17,1041,1389,3,1,3,0,1,0,74.95
高雄市,左營區,頂北里,0,1,569,9,578,790,3,1,3,0,1,0,73.16
高雄市,左營區,中北里,0,1,586,6,592,735,3,1,3,0,1,0,80.54
高雄市,左營區,中南里,0,1,501,4,505,666,3,1,3,0,1,0,75.83
高雄市,左營區,廟東里,0,1,745,9,754,1010,3,1,3,0,1,0,74.65
高雄市,左營區,廟北里,0,1,776,16,792,1109,3,1,3,0,1,0,71.42
高雄市,左營區,尾南里,0,1,717,6,723,963,3,1,3,0,1,0,75.08
高雄市,左營區,尾北里,0,1,1864,29,1893,2602,3,1,3,0,1,0,72.75
高雄市,左營區,海光里,0,1,1322,21,1343,1752,3,1,3,0,1,0,76.66
高雄市,左營區,屏山里,0,1,1486,22,1508,1993,3,1,3,0,1,0,75.66
高雄市,左營區,祥和里,0,1,685,15,700,851,3,1,3,0,1,0,82.26
高雄市,左營區,永清里,0,1,1392,24,1416,1769,3,1,3,0,1,0,80.05
高雄市,左營區,復興里,0,1,1036,22,1058,1369,3,1,3,0,1,0,77.28
高雄市,左營區,莒光里,0,1,1277,11,1288,1772,3,1,3,0,1,0,72.69
高雄市,左營區,光輝里,0,1,1890,26,1916,2548,3,1,3,0,1,0,75.20
高雄市,左營區,合群里,0,1,1114,8,1122,1438,3,1,3,0,1,0,78.03
高雄市,左營區,自治里,0,1,1556,17,1573,1964,3,1,3,0,1,0,80.09
高雄市,左營區,明建里,0,1,1234,16,1250,1588,3,1,3,0,1,0,78.72
高雄市,左營區,自立里,0,1,782,16,798,1003,3,1,3,0,1,0,79.56
高雄市,左營區,頂西里,0,1,985,6,991,1291,3,1,3,0,1,0,76.76
高雄市,左營區,聖后里,0,1,756,13,769,1042,3,1,3,0,1,0,73.80
高雄市,左營區,聖西里,0,1,361,2,363,487,3,1,3,0,1,0,74.54
高雄市,左營區,聖南里,0,1,463,12,475,598,3,1,3,0,1,0,79.43
高雄市,左營區,城南里,0,1,473,5,478,609,3,1,3,0,1,0,78.49
高雄市,左營區,路東里,0,1,620,5,625,814,3,1,3,0,1,0,76.78
高雄市,左營區,廍北里,0,1,453,6,459,584,3,1,3,0,1,0,78.60
高雄市,左營區,廍南里,0,1,642,10,652,822,3,1,3,0,1,0,79.32
高雄市,左營區,埤西里,0,1,952,9,961,1255,3,1,3,0,1,0,76.57
高雄市,左營區,埤北里,0,1,1142,16,1158,1567,3,1,3,0,1,0,73.90
高雄市,左營區,埤東里,0,1,1077,15,1092,1436,3,1,3,0,1,0,76.04
高雄市,左營區,海勝里,0,1,1146,9,1155,1470,3,1,3,0,1,0,78.57
高雄市,左營區,自勉里,0,1,1525,16,1541,1887,3,1,3,0,1,0,81.66
高雄市,左營區,崇實里,0,1,982,7,989,1224,3,1,3,0,1,0,80.80
高雄市,左營區,自助里,0,1,1989,32,2021,2617,3,1,3,0,1,0,77.23
高雄市,左營區,果貿里,0,1,1641,18,1659,2192,3,1,3,0,1,0,75.68
高雄市,左營區,果惠里,0,1,1176,18,1194,1662,3,1,3,0,1,0,71.84
高雄市,左營區,果峰里,0,1,1531,12,1543,1960,3,1,3,0,1,0,78.72
高雄市,左營區,新下里,0,1,3813,51,3864,5268,3,1,3,0,1,0,73.35
高雄市,左營區,新上里,0,1,6620,76,6696,10035,3,1,3,0,1,0,66.73
高雄市,左營區,新中里,0,1,2761,29,2790,3729,3,1,3,0,1,0,74.82
高雄市,左營區,新光里,0,1,2661,31,2692,3618,3,1,3,0,1,0,74.41
高雄市,左營區,菜公里,0,1,3090,51,3141,4597,3,1,3,0,1,0,68.33
高雄市,左營區,福山里,0,1,2665,35,2700,4030,3,1,3,0,1,0,67.00
高雄市,楠梓區,清豐里,0,1,3975,52,4027,5649,3,1,3,0,1,0,71.29
高雄市,楠梓區,東寧里,0,1,1317,14,1331,1930,3,1,3,0,1,0,68.96
高雄市,楠梓區,五常里,0,1,2143,26,2169,3226,3,1,3,0,1,0,67.23
高雄市,楠梓區,享平里,0,1,1533,12,1545,1996,3,1,3,0,1,0,77.40
高雄市,楠梓區,中陽里,0,1,1748,61,1809,2558,3,1,3,0,1,0,70.72
高雄市,楠梓區,惠楠里,0,1,1342,17,1359,1844,3,1,3,0,1,0,73.70
高雄市,楠梓區,惠民里,0,1,2132,28,2160,2796,3,1,3,0,1,0,77.25
高雄市,楠梓區,惠豐里,0,1,1141,17,1158,1643,3,1,3,0,1,0,70.48
高雄市,楠梓區,錦屏里,0,1,2245,21,2266,3016,3,1,3,0,1,0,75.13
高雄市,楠梓區,玉屏里,0,1,1526,56,1582,2006,3,1,3,0,1,0,78.86
高雄市,楠梓區,瑞屏里,0,1,1991,31,2022,2611,3,1,3,0,1,0,77.44
高雄市,楠梓區,翠屏里,0,1,4241,58,4299,6017,3,1,3,0,1,0,71.45
高雄市,楠梓區,金田里,0,1,2002,25,2027,2727,3,1,3,0,1,0,74.33
高雄市,楠梓區,稔田里,0,1,1050,13,1063,1455,3,1,3,0,1,0,73.06
高雄市,楠梓區,宏南里,0,1,1386,16,1402,1761,3,1,3,0,1,0,79.61
高雄市,楠梓區,宏毅里,0,1,2401,24,2425,3015,3,1,3,0,1,0,80.43
高雄市,楠梓區,宏榮里,0,1,1244,9,1253,1556,3,1,3,0,1,0,80.53
高雄市,楠梓區,廣昌里,0,1,2231,48,2279,2874,3,1,3,0,1,0,79.30
高雄市,楠梓區,久昌里,0,1,1330,20,1350,1929,3,1,3,0,1,0,69.98
高雄市,楠梓區,大昌里,0,1,1575,17,1592,2125,3,1,3,0,1,0,74.92
高雄市,楠梓區,福昌里,0,1,1325,13,1338,1674,3,1,3,0,1,0,79.93
高雄市,楠梓區,盛昌里,0,1,1895,22,1917,2562,3,1,3,0,1,0,74.82
高雄市,楠梓區,泰昌里,0,1,1164,16,1180,1481,3,1,3,0,1,0,79.68
高雄市,楠梓區,興昌里,0,1,1684,17,1701,2150,3,1,3,0,1,0,79.12
高雄市,楠梓區,建昌里,0,1,1671,14,1685,2279,3,1,3,0,1,0,73.94
高雄市,楠梓區,宏昌里,0,1,1255,12,1267,1647,3,1,3,0,1,0,76.93
高雄市,楠梓區,和昌里,0,1,1601,14,1615,2102,3,1,3,0,1,0,76.83
高雄市,楠梓區,慶昌里,0,1,2054,38,2092,2759,3,1,3,0,1,0,75.82
高雄市,楠梓區,隆昌里,0,1,2384,23,2407,3066,3,1,3,0,1,0,78.51
高雄市,楠梓區,秀昌里,0,1,1278,20,1298,1705,3,1,3,0,1,0,76.13
高雄市,楠梓區,裕昌里,0,1,1197,20,1217,1638,3,1,3,0,1,0,74.30
高雄市,楠梓區,國昌里,0,1,1624,16,1640,2220,3,1,3,0,1,0,73.87
高雄市,楠梓區,加昌里,0,1,2894,57,2951,3963,3,1,3,0,1,0,74.46
高雄市,楠梓區,仁昌里,0,1,1920,32,1952,2537,3,1,3,0,1,0,76.94
高雄市,楠梓區,藍田里,0,1,667,5,672,802,3,1,3,0,1,0,83.79
高雄市,楠梓區,中和里,0,1,970,12,982,1297,3,1,3,0,1,0,75.71
高雄市,楠梓區,中興里,0,1,618,6,624,791,3,1,3,0,1,0,78.89
高雄市,三民區,鼎金里,0,1,1659,25,1684,2445,3,1,3,0,1,0,68.88
高雄市,三民區,鼎盛里,0,1,2503,23,2526,3625,3,1,3,0,1,0,69.68
高雄市,三民區,鼎強里,0,1,2005,32,2037,2841,3,1,3,0,1,0,71.70
高雄市,三民區,鼎力里,0,1,1937,42,1979,2823,3,1,3,0,1,0,70.10
高雄市,三民區,鼎西里,0,1,2271,46,2317,3269,3,1,3,0,1,0,70.88
高雄市,三民區,鼎中里,0,1,1928,36,1964,2597,3,1,3,0,1,0,75.63
高雄市,三民區,鼎泰里,0,1,4062,62,4124,5866,3,1,3,0,1,0,70.30
高雄市,三民區,本舘里,0,1,4058,41,4099,5676,3,1,3,0,1,0,72.22
高雄市,三民區,本和里,0,1,2690,41,2731,3654,3,1,3,0,1,0,74.74
高雄市,三民區,本文里,0,1,1260,12,1272,1743,3,1,3,0,1,0,72.98
高雄市,三民區,本武里,0,1,993,14,1007,1412,3,1,3,0,1,0,71.32
高雄市,三民區,本元里,0,1,2693,56,2749,3791,3,1,3,0,1,0,72.51
高雄市,三民區,本安里,0,1,2134,23,2157,2943,3,1,3,0,1,0,73.29
高雄市,三民區,本上里,0,1,2265,17,2282,3295,3,1,3,0,1,0,69.26
高雄市,三民區,本揚里,0,1,3099,38,3137,4573,3,1,3,0,1,0,68.60
高雄市,三民區,寶獅里,0,1,1996,16,2012,2992,3,1,3,0,1,0,67.25
高雄市,三民區,寶德里,0,1,2319,26,2345,3483,3,1,3,0,1,0,67.33
高雄市,三民區,寶泰里,0,1,1371,12,1383,2062,3,1,3,0,1,0,67.07
高雄市,三民區,寶興里,0,1,2709,24,2733,4014,3,1,3,0,1,0,68.09
高雄市,三民區,寶中里,0,1,1762,29,1791,2487,3,1,3,0,1,0,72.01
高雄市,三民區,寶華里,0,1,1520,14,1534,2227,3,1,3,0,1,0,68.88
高雄市,三民區,寶國里,0,1,2796,33,2829,4196,3,1,3,0,1,0,67.42
高雄市,三民區,寶民里,0,1,1393,19,1412,1998,3,1,3,0,1,0,70.67
高雄市,三民區,寶慶里,0,1,1554,18,1572,2228,3,1,3,0,1,0,70.56
高雄市,三民區,寶業里,0,1,2168,20,2188,3176,3,1,3,0,1,0,68.89
高雄市,三民區,寶盛里,0,1,1980,19,1999,2812,3,1,3,0,1,0,71.09
高雄市,三民區,寶安里,0,1,2696,40,2736,3975,3,1,3,0,1,0,68.83
高雄市,三民區,寶龍里,0,1,2216,42,2258,3199,3,1,3,0,1,0,70.58
高雄市,三民區,寶珠里,0,1,2570,45,2615,3757,3,1,3,0,1,0,69.60
高雄市,三民區,寶玉里,0,1,2907,48,2955,4402,3,1,3,0,1,0,67.13
高雄市,三民區,灣子里,0,1,1624,13,1637,2438,3,1,3,0,1,0,67.15
高雄市,三民區,灣愛里,0,1,1699,36,1735,2503,3,1,3,0,1,0,69.32
高雄市,三民區,灣中里,0,1,2269,37,2306,3454,3,1,3,0,1,0,66.76
高雄市,三民區,灣華里,0,1,1411,20,1431,1898,3,1,3,0,1,0,75.40
高雄市,三民區,灣勝里,0,1,1418,14,1432,1942,3,1,3,0,1,0,73.74
高雄市,三民區,灣利里,0,1,2275,26,2301,3172,3,1,3,0,1,0,72.54
高雄市,三民區,灣復里,0,1,1612,23,1635,2444,3,1,3,0,1,0,66.90
高雄市,三民區,正興里,0,1,3447,42,3489,5088,3,1,3,0,1,0,68.57
高雄市,三民區,正順里,0,1,2036,17,2053,2946,3,1,3,0,1,0,69.69
高雄市,三民區,灣興里,0,1,995,15,1010,1441,3,1,3,0,1,0,70.09
高雄市,三民區,灣成里,0,1,967,10,977,1366,3,1,3,0,1,0,71.52
高雄市,三民區,安康里,0,1,1953,83,2036,3148,3,1,3,0,1,0,64.68
高雄市,三民區,安寧里,0,1,1448,33,1481,2264,3,1,3,0,1,0,65.42
高雄市,三民區,安吉里,0,1,1938,29,1967,2952,3,1,3,0,1,0,66.63
高雄市,三民區,安發里,0,1,2335,31,2366,3571,3,1,3,0,1,0,66.26
高雄市,三民區,安東里,0,1,2346,28,2374,3292,3,1,3,0,1,0,72.11
高雄市,三民區,安和里,0,1,1911,23,1934,2676,3,1,3,0,1,0,72.27
高雄市,三民區,達德里,0,1,1150,7,1157,1572,3,1,3,0,1,0,73.60
高雄市,三民區,達明里,0,1,1305,19,1324,1809,3,1,3,0,1,0,73.19
高雄市,三民區,達仁里,0,1,1064,11,1075,1541,3,1,3,0,1,0,69.76
高雄市,三民區,達勇里,0,1,857,11,868,1143,3,1,3,0,1,0,75.94
高雄市,三民區,同德里,0,1,2114,14,2128,2956,3,1,3,0,1,0,71.99
高雄市,三民區,德智里,0,1,1644,9,1653,2362,3,1,3,0,1,0,69.98
高雄市,三民區,德仁里,0,1,1192,108,1300,1902,3,1,3,0,1,0,68.35
高雄市,三民區,安生里,0,1,1252,20,1272,1856,3,1,3,0,1,0,68.53
高雄市,三民區,德東里,0,1,681,13,694,952,3,1,3,0,1,0,72.90
高雄市,三民區,德行里,0,1,888,7,895,1197,3,1,3,0,1,0,74.77
高雄市,三民區,精華里,0,1,1323,17,1340,1874,3,1,3,0,1,0,71.50
高雄市,三民區,民享里,0,1,1529,14,1543,2119,3,1,3,0,1,0,72.82
高雄市,三民區,安宜里,0,1,2238,24,2262,3185,3,1,3,0,1,0,71.02
高雄市,三民區,安泰里,0,1,2688,62,2750,3800,3,1,3,0,1,0,72.37
高雄市,三民區,安邦里,0,1,2480,33,2513,3412,3,1,3,0,1,0,73.65
高雄市,三民區,十全里,0,1,1026,11,1037,1421,3,1,3,0,1,0,72.98
高雄市,三民區,十美里,0,1,1245,14,1259,1699,3,1,3,0,1,0,74.10
高雄市,三民區,德北里,0,1,1399,22,1421,1938,3,1,3,0,1,0,73.32
高雄市,三民區,立誠里,0,1,859,10,869,1165,3,1,3,0,1,0,74.59
高雄市,三民區,立業里,0,1,821,10,831,1143,3,1,3,0,1,0,72.70
高雄市,三民區,港東里,0,1,942,14,956,1428,3,1,3,0,1,0,66.95
高雄市,三民區,港新里,0,1,1042,10,1052,1556,3,1,3,0,1,0,67.61
高雄市,三民區,港西里,0,1,602,10,612,924,3,1,3,0,1,0,66.23
高雄市,三民區,港北里,0,1,477,5,482,597,3,1,3,0,1,0,80.74
高雄市,三民區,博愛里,0,1,773,12,785,1188,3,1,3,0,1,0,66.08
高雄市,三民區,博惠里,0,1,2664,31,2695,3987,3,1,3,0,1,0,67.59
高雄市,三民區,長明里,0,1,926,13,939,1321,3,1,3,0,1,0,71.08
高雄市,三民區,建東里,0,1,673,11,684,1037,3,1,3,0,1,0,65.96
高雄市,三民區,興德里,0,1,871,8,879,1285,3,1,3,0,1,0,68.40
高雄市,三民區,鳳南里,0,1,815,5,820,1148,3,1,3,0,1,0,71.43
高雄市,三民區,鳳北里,0,1,1535,29,1564,2154,3,1,3,0,1,0,72.61
高雄市,三民區,德西里,0,1,851,8,859,1212,3,1,3,0,1,0,70.87
高雄市,三民區,九如里,0,1,317,6,323,440,3,1,3,0,1,0,73.41
高雄市,三民區,豐裕里,0,1,1995,22,2017,2761,3,1,3,0,1,0,73.05
高雄市,三民區,川東里,0,1,1272,22,1294,1819,3,1,3,0,1,0,71.14
高雄市,三民區,裕民里,0,1,601,14,615,801,3,1,3,0,1,0,76.78
高雄市,三民區,力行里,0,1,991,4,995,1312,3,1,3,0,1,0,75.84
高雄市,三民區,千歲里,0,1,863,16,879,1241,3,1,3,0,1,0,70.83
高雄市,三民區,立德里,0,1,943,13,956,1365,3,1,3,0,1,0,70.04
高雄市,三民區,千北里,0,1,920,13,933,1281,3,1,3,0,1,0,72.83
高雄市,三民區,千秋里,0,1,1722,59,1781,2521,3,1,3,0,1,0,70.65
高雄市,新興區,興昌里,0,2,1438,11,1449,1900,3,1,3,0,1,0,76.26
高雄市,新興區,南港里,0,2,1570,15,1585,2247,3,1,3,0,1,0,70.54
高雄市,新興區,仁聲里,0,2,471,6,477,706,3,1,3,0,1,0,67.56
高雄市,新興區,振成里,0,2,822,15,837,1224,3,1,3,0,1,0,68.38
高雄市,新興區,華聲里,0,2,739,7,746,1038,3,1,3,0,1,0,71.87
高雄市,新興區,漢民里,0,2,748,11,759,1009,3,1,3,0,1,0,75.22
高雄市,新興區,愛平里,0,2,700,9,709,978,3,1,3,0,1,0,72.49
高雄市,新興區,振華里,0,2,920,9,929,1295,3,1,3,0,1,0,71.74
高雄市,新興區,東坡里,0,2,1026,13,1039,1405,3,1,3,0,1,0,73.95
高雄市,新興區,大明里,0,2,849,11,860,1222,3,1,3,0,1,0,70.38
高雄市,新興區,明莊里,0,2,671,22,693,916,3,1,3,0,1,0,75.66
高雄市,新興區,建興里,0,2,650,13,663,934,3,1,3,0,1,0,70.99
高雄市,新興區,建華里,0,2,587,3,590,881,3,1,3,0,1,0,66.97
高雄市,新興區,黎明里,0,2,627,10,637,915,3,1,3,0,1,0,69.62
高雄市,新興區,中東里,0,2,1575,15,1590,2430,3,1,3,0,1,0,65.43
高雄市,新興區,順昌里,0,2,1648,24,1672,2242,3,1,3,0,1,0,74.58
高雄市,新興區,德望里,0,2,1235,15,1250,1800,3,1,3,0,1,0,69.44
高雄市,新興區,榮治里,0,2,406,6,412,573,3,1,3,0,1,0,71.90
高雄市,新興區,德生里,0,2,1375,9,1384,2018,3,1,3,0,1,0,68.58
高雄市,新興區,永寧里,0,2,1046,20,1066,1468,3,1,3,0,1,0,72.62
高雄市,新興區,文昌里,0,2,1578,18,1596,2231,3,1,3,0,1,0,71.54
高雄市,新興區,秋山里,0,2,645,10,655,944,3,1,3,0,1,0,69.39
高雄市,新興區,長驛里,0,2,570,7,577,819,3,1,3,0,1,0,70.45
高雄市,新興區,開平里,0,2,1642,17,1659,2206,3,1,3,0,1,0,75.20
高雄市,新興區,成功里,0,2,851,7,858,1170,3,1,3,0,1,0,73.33
高雄市,新興區,德政里,0,2,532,15,547,763,3,1,3,0,1,0,71.69
高雄市,新興區,玉衡里,0,2,890,16,906,1202,3,1,3,0,1,0,75.37
高雄市,新興區,正氣里,0,2,1173,15,1188,1614,3,1,3,0,1,0,73.61
高雄市,新興區,新江里,0,2,837,8,845,1265,3,1,3,0,1,0,66.80
高雄市,新興區,蕉園里,0,2,599,8,607,833,3,1,3,0,1,0,72.87
高雄市,新興區,浩然里,0,2,1471,16,1487,2073,3,1,3,0,1,0,71.73
高雄市,新興區,光耀里,0,2,1822,21,1843,2595,3,1,3,0,1,0,71.02
高雄市,前金區,三川里,0,2,630,14,644,921,3,1,3,0,1,0,69.92
高雄市,前金區,草江里,0,2,830,13,843,1190,3,1,3,0,1,0,70.84
高雄市,前金區,長城里,0,2,1092,13,1105,1600,3,1,3,0,1,0,69.06
高雄市,前金區,長興里,0,2,710,10,720,1064,3,1,3,0,1,0,67.67
高雄市,前金區,青山里,0,2,922,5,927,1322,3,1,3,0,1,0,70.12
高雄市,前金區,東金里,0,2,632,11,643,991,3,1,3,0,1,0,64.88
高雄市,前金區,北金里,0,2,558,9,567,814,3,1,3,0,1,0,69.66
高雄市,前金區,新生里,0,2,1859,26,1885,2740,3,1,3,0,1,0,68.80
高雄市,前金區,後金里,0,2,826,13,839,1122,3,1,3,0,1,0,74.78
高雄市,前金區,林投里,0,2,1036,12,1048,1436,3,1,3,0,1,0,72.98
高雄市,前金區,民生里,0,2,512,2,514,766,3,1,3,0,1,0,67.10
高雄市,前金區,復元里,0,2,714,7,721,995,3,1,3,0,1,0,72.46
高雄市,前金區,國民里,0,2,729,22,751,1063,3,1,3,0,1,0,70.65
高雄市,前金區,社東里,0,2,1295,13,1308,1805,3,1,3,0,1,0,72.47
高雄市,前金區,社西里,0,2,882,9,891,1220,3,1,3,0,1,0,73.03
高雄市,前金區,長生里,0,2,1207,14,1221,1724,3,1,3,0,1,0,70.82
高雄市,前金區,榮復里,0,2,989,22,1011,1350,3,1,3,0,1,0,74.89
高雄市,前金區,博孝里,0,2,639,6,645,1045,3,1,3,0,1,0,61.72
高雄市,前金區,文西里,0,2,874,22,896,1271,3,1,3,0,1,0,70.50
高雄市,前金區,文東里,0,2,954,12,966,1370,3,1,3,0,1,0,70.51
高雄市,苓雅區,博仁里,0,2,454,3,457,650,3,1,3,0,1,0,70.31
高雄市,苓雅區,苓洲里,0,2,920,20,940,1351,3,1,3,0,1,0,69.58
高雄市,苓雅區,苓昇里,0,2,956,13,969,1419,3,1,3,0,1,0,68.29
高雄市,苓雅區,苓中里,0,2,1078,17,1095,1529,3,1,3,0,1,0,71.62
高雄市,苓雅區,苓雅里,0,2,863,14,877,1291,3,1,3,0,1,0,67.93
高雄市,苓雅區,苓東里,0,2,928,58,986,1468,3,1,3,0,1,0,67.17
高雄市,苓雅區,城北里,0,2,1034,20,1054,1518,3,1,3,0,1,0,69.43
高雄市,苓雅區,城西里,0,2,565,9,574,798,3,1,3,0,1,0,71.93
高雄市,苓雅區,城東里,0,2,1137,11,1148,1658,3,1,3,0,1,0,69.24
高雄市,苓雅區,意誠里,0,2,987,15,1002,1591,3,1,3,0,1,0,62.98
高雄市,苓雅區,鼓中里,0,2,987,20,1007,1352,3,1,3,0,1,0,74.48
高雄市,苓雅區,田西里,0,2,1119,49,1168,1537,3,1,3,0,1,0,75.99
高雄市,苓雅區,人和里,0,2,1202,14,1216,1737,3,1,3,0,1,0,70.01
高雄市,苓雅區,仁政里,0,2,1118,30,1148,1709,3,1,3,0,1,0,67.17
高雄市,苓雅區,廣澤里,0,2,1440,17,1457,2031,3,1,3,0,1,0,71.74
高雄市,苓雅區,美田里,0,2,871,16,887,1299,3,1,3,0,1,0,68.28
高雄市,苓雅區,華堂里,0,2,1859,27,1886,2938,3,1,3,0,1,0,64.19
高雄市,苓雅區,日中里,0,2,1658,34,1692,2398,3,1,3,0,1,0,70.56
高雄市,苓雅區,普照里,0,2,1675,17,1692,2372,3,1,3,0,1,0,71.33
高雄市,苓雅區,和煦里,0,2,1522,28,1550,2215,3,1,3,0,1,0,69.98
高雄市,苓雅區,晴朗里,0,2,692,11,703,997,3,1,3,0,1,0,70.51
高雄市,苓雅區,普天里,0,2,1752,16,1768,2619,3,1,3,0,1,0,67.51
高雄市,苓雅區,林富里,0,2,1046,30,1076,1493,3,1,3,0,1,0,72.07
高雄市,苓雅區,林圍里,0,2,1336,15,1351,1877,3,1,3,0,1,0,71.98
高雄市,苓雅區,林安里,0,2,1081,8,1089,1496,3,1,3,0,1,0,72.79
高雄市,苓雅區,光華里,0,2,606,5,611,852,3,1,3,0,1,0,71.71
高雄市,苓雅區,林興里,0,2,997,6,1003,1402,3,1,3,0,1,0,71.54
高雄市,苓雅區,林華里,0,2,2168,28,2196,3161,3,1,3,0,1,0,69.47
高雄市,苓雅區,林西里,0,2,1433,28,1461,2055,3,1,3,0,1,0,71.09
高雄市,苓雅區,林中里,0,2,2449,45,2494,3405,3,1,3,0,1,0,73.25
高雄市,苓雅區,林泉里,0,2,1154,7,1161,1646,3,1,3,0,1,0,70.53
高雄市,苓雅區,林南里,0,2,1859,22,1881,2763,3,1,3,0,1,0,68.08
高雄市,苓雅區,中正里,0,2,1568,14,1582,2347,3,1,3,0,1,0,67.41
高雄市,苓雅區,尚義里,0,2,998,28,1026,1477,3,1,3,0,1,0,69.47
高雄市,苓雅區,同慶里,0,2,1117,13,1130,1623,3,1,3,0,1,0,69.62
高雄市,苓雅區,凱旋里,0,2,1439,26,1465,1942,3,1,3,0,1,0,75.44
高雄市,苓雅區,安祥里,0,2,1539,27,1566,2341,3,1,3,0,1,0,66.89
高雄市,苓雅區,奏捷里,0,2,1269,24,1293,1803,3,1,3,0,1,0,71.71
高雄市,苓雅區,福壽里,0,2,1138,43,1181,1582,3,1,3,0,1,0,74.65
高雄市,苓雅區,福南里,0,2,1660,20,1680,2393,3,1,3,0,1,0,70.20
高雄市,苓雅區,五權里,0,2,1208,21,1229,1783,3,1,3,0,1,0,68.93
高雄市,苓雅區,民主里,0,2,2332,28,2360,3462,3,1,3,0,1,0,68.17
高雄市,苓雅區,林德里,0,2,1332,53,1385,1938,3,1,3,0,1,0,71.47
高雄市,苓雅區,林貴里,0,2,1000,10,1010,1439,3,1,3,0,1,0,70.19
高雄市,苓雅區,林榮里,0,2,2636,31,2667,3831,3,1,3,0,1,0,69.62
高雄市,苓雅區,英明里,0,2,1413,29,1442,2116,3,1,3,0,1,0,68.15
高雄市,苓雅區,林靖里,0,2,886,16,902,1229,3,1,3,0,1,0,73.39
高雄市,苓雅區,朝陽里,0,2,1118,12,1130,1574,3,1,3,0,1,0,71.79
高雄市,苓雅區,福隆里,0,2,1925,79,2004,2852,3,1,3,0,1,0,70.27
高雄市,苓雅區,福祥里,0,2,1034,9,1043,1422,3,1,3,0,1,0,73.35
高雄市,苓雅區,福海里,0,2,741,21,762,1077,3,1,3,0,1,0,70.75
高雄市,苓雅區,福康里,0,2,1334,19,1353,1948,3,1,3,0,1,0,69.46
高雄市,苓雅區,福人里,0,2,1621,26,1647,2248,3,1,3,0,1,0,73.27
高雄市,苓雅區,福地里,0,2,1908,27,1935,2850,3,1,3,0,1,0,67.89
高雄市,苓雅區,福居里,0,2,2092,45,2137,2963,3,1,3,0,1,0,72.12
高雄市,苓雅區,福東里,0,2,1387,27,1414,2162,3,1,3,0,1,0,65.40
高雄市,苓雅區,福西里,0,2,1658,22,1680,2419,3,1,3,0,1,0,69.45
高雄市,苓雅區,永康里,0,2,1449,39,1488,2146,3,1,3,0,1,0,69.34
高雄市,苓雅區,正文里,0,2,1082,12,1094,1503,3,1,3,0,1,0,72.79
高雄市,苓雅區,正言里,0,2,1397,13,1410,2149,3,1,3,0,1,0,65.61
高雄市,苓雅區,正大里,0,2,2431,34,2465,3640,3,1,3,0,1,0,67.72
高雄市,苓雅區,五福里,0,2,2520,41,2561,3746,3,1,3,0,1,0,68.37
高雄市,苓雅區,正心里,0,2,2246,51,2297,3243,3,1,3,0,1,0,70.83
高雄市,苓雅區,正道里,0,2,2380,35,2415,3436,3,1,3,0,1,0,70.29
高雄市,苓雅區,正義里,0,2,1392,22,1414,1942,3,1,3,0,1,0,72.81
高雄市,苓雅區,正仁里,0,2,1622,26,1648,2186,3,1,3,0,1,0,75.39
高雄市,苓雅區,文昌里,0,2,2504,30,2534,3463,3,1,3,0,1,0,73.17
高雄市,苓雅區,建軍里,0,2,1298,10,1308,1791,3,1,3,0,1,0,73.03
高雄市,苓雅區,衛武里,0,2,1478,34,1512,2110,3,1,3,0,1,0,71.66
高雄市,前鎮區,草衙里,0,2,4147,63,4210,6348,3,1,3,0,1,0,66.32
高雄市,前鎮區,明孝里,0,2,1537,28,1565,2279,3,1,3,0,1,0,68.67
高雄市,前鎮區,明正里,0,2,2289,34,2323,3238,3,1,3,0,1,0,71.74
高雄市,前鎮區,明義里,0,2,1346,19,1365,1802,3,1,3,0,1,0,75.75
高雄市,前鎮區,仁愛里,0,2,1067,17,1084,1509,3,1,3,0,1,0,71.84
高雄市,前鎮區,德昌里,0,2,1430,27,1457,2073,3,1,3,0,1,0,70.28
高雄市,前鎮區,平等里,0,2,1083,24,1107,1624,3,1,3,0,1,0,68.17
高雄市,前鎮區,平昌里,0,2,645,7,652,913,3,1,3,0,1,0,71.41
高雄市,前鎮區,明禮里,0,2,1270,25,1295,1792,3,1,3,0,1,0,72.27
高雄市,前鎮區,信義里,0,2,1038,16,1054,1513,3,1,3,0,1,0,69.66
高雄市,前鎮區,信德里,0,2,1855,27,1882,2730,3,1,3,0,1,0,68.94
高雄市,前鎮區,明道里,0,2,1024,14,1038,1396,3,1,3,0,1,0,74.36
高雄市,前鎮區,興化里,0,2,592,10,602,814,3,1,3,0,1,0,73.96
高雄市,前鎮區,興仁里,0,2,718,11,729,980,3,1,3,0,1,0,74.39
高雄市,前鎮區,前鎮里,0,2,1359,34,1393,1759,3,1,3,0,1,0,79.19
高雄市,前鎮區,鎮東里,0,2,1407,26,1433,1897,3,1,3,0,1,0,75.54
高雄市,前鎮區,鎮榮里,0,2,1749,46,1795,2408,3,1,3,0,1,0,74.54
高雄市,前鎮區,鎮昌里,0,2,1373,42,1415,1951,3,1,3,0,1,0,72.53
高雄市,前鎮區,鎮海里,0,2,2273,27,2300,3205,3,1,3,0,1,0,71.76
高雄市,前鎮區,興邦里,0,2,655,9,664,841,3,1,3,0,1,0,78.95
高雄市,前鎮區,鎮中里,0,2,772,22,794,994,3,1,3,0,1,0,79.88
高雄市,前鎮區,鎮北里,0,2,919,15,934,1216,3,1,3,0,1,0,76.81
高雄市,前鎮區,鎮陽里,0,2,959,16,975,1233,3,1,3,0,1,0,79.08
高雄市,前鎮區,忠純里,0,2,1971,31,2002,2515,3,1,3,0,1,0,79.60
高雄市,前鎮區,忠誠里,0,2,1505,18,1523,1890,3,1,3,0,1,0,80.58
高雄市,前鎮區,君毅里,0,2,153,2,155,200,3,1,3,0,1,0,77.50
高雄市,前鎮區,壯勇里,0,2,29,1,30,58,3,1,3,0,1,0,51.72
高雄市,前鎮區,西山里,0,2,2139,26,2165,3014,3,1,3,0,1,0,71.83
高雄市,前鎮區,民權里,0,2,1386,21,1407,1801,3,1,3,0,1,0,78.12
高雄市,前鎮區,建隆里,0,2,703,19,722,969,3,1,3,0,1,0,74.51
高雄市,前鎮區,振興里,0,2,872,13,885,1169,3,1,3,0,1,0,75.71
高雄市,前鎮區,良和里,0,2,1411,95,1506,2105,3,1,3,0,1,0,71.54
高雄市,前鎮區,西甲里,0,2,1560,30,1590,2159,3,1,3,0,1,0,73.65
高雄市,前鎮區,盛興里,0,2,1333,14,1347,2130,3,1,3,0,1,0,63.24
高雄市,前鎮區,盛豐里,0,2,1976,29,2005,2979,3,1,3,0,1,0,67.30
高雄市,前鎮區,興中里,0,2,2089,31,2120,3127,3,1,3,0,1,0,67.80
高雄市,前鎮區,興東里,0,2,1184,15,1199,1776,3,1,3,0,1,0,67.51
高雄市,前鎮區,忠孝里,0,2,1746,24,1770,2544,3,1,3,0,1,0,69.58
高雄市,前鎮區,復國里,0,2,1876,14,1890,2654,3,1,3,0,1,0,71.21
高雄市,前鎮區,竹內里,0,2,1726,27,1753,2569,3,1,3,0,1,0,68.24
高雄市,前鎮區,竹東里,0,2,1263,14,1277,1912,3,1,3,0,1,0,66.79
高雄市,前鎮區,竹南里,0,2,1610,37,1647,2311,3,1,3,0,1,0,71.27
高雄市,前鎮區,竹北里,0,2,1350,8,1358,2048,3,1,3,0,1,0,66.31
高雄市,前鎮區,竹西里,0,2,2003,40,2043,2832,3,1,3,0,1,0,72.14
高雄市,前鎮區,竹中里,0,2,1832,31,1863,2550,3,1,3,0,1,0,73.06
高雄市,前鎮區,瑞竹里,0,2,876,81,957,1377,3,1,3,0,1,0,69.50
高雄市,前鎮區,瑞南里,0,2,3217,59,3276,4508,3,1,3,0,1,0,72.67
高雄市,前鎮區,瑞豐里,0,2,1642,18,1660,2310,3,1,3,0,1,0,71.86
高雄市,前鎮區,瑞祥里,0,2,2663,29,2692,3819,3,1,3,0,1,0,70.49
高雄市,前鎮區,瑞東里,0,2,1645,25,1670,2466,3,1,3,0,1,0,67.72
高雄市,前鎮區,瑞和里,0,2,1424,21,1445,2031,3,1,3,0,1,0,71.15
高雄市,前鎮區,瑞平里,0,2,1876,61,1937,2921,3,1,3,0,1,0,66.31
高雄市,前鎮區,瑞隆里,0,2,2005,20,2025,2997,3,1,3,0,1,0,67.57
高雄市,前鎮區,瑞北里,0,2,1947,35,1982,2719,3,1,3,0,1,0,72.89
高雄市,前鎮區,瑞西里,0,2,1979,40,2019,2627,3,1,3,0,1,0,76.86
高雄市,前鎮區,瑞崗里,0,2,1751,28,1779,2513,3,1,3,0,1,0,70.79
高雄市,前鎮區,瑞興里,0,2,1643,27,1670,2377,3,1,3,0,1,0,70.26
高雄市,前鎮區,瑞誠里,0,2,1236,15,1251,1790,3,1,3,0,1,0,69.89
高雄市,前鎮區,瑞文里,0,2,1306,32,1338,1932,3,1,3,0,1,0,69.25
高雄市,前鎮區,瑞華里,0,2,2073,32,2105,3001,3,1,3,0,1,0,70.14
高雄市,前鎮區,瑞昌里,0,2,1712,39,1751,2496,3,1,3,0,1,0,70.15
高雄市,小港區,小港里,0,2,1204,12,1216,1752,3,1,3,0,1,0,69.41
高雄市,小港區,港口里,0,2,1801,9,1810,2427,3,1,3,0,1,0,74.58
高雄市,小港區,港正里,0,2,1283,11,1294,1722,3,1,3,0,1,0,75.15
高雄市,小港區,港明里,0,2,1755,34,1789,2473,3,1,3,0,1,0,72.34
高雄市,小港區,港墘里,0,2,941,15,956,1339,3,1,3,0,1,0,71.40
高雄市,小港區,港南里,0,2,959,14,973,1341,3,1,3,0,1,0,72.56
高雄市,小港區,港后里,0,2,899,14,913,1295,3,1,3,0,1,0,70.50
高雄市,小港區,港興里,0,2,1229,15,1244,1686,3,1,3,0,1,0,73.78
高雄市,小港區,大苓里,0,2,1395,12,1407,1903,3,1,3,0,1,0,73.94
高雄市,小港區,二苓里,0,2,1735,22,1757,2445,3,1,3,0,1,0,71.86
高雄市,小港區,三苓里,0,2,1528,29,1557,2087,3,1,3,0,1,0,74.60
高雄市,小港區,鳳宮里,0,2,860,11,871,1280,3,1,3,0,1,0,68.05
高雄市,小港區,店鎮里,0,2,2466,31,2497,3531,3,1,3,0,1,0,70.72
高雄市,小港區,正苓里,0,2,1884,27,1911,2847,3,1,3,0,1,0,67.12
高雄市,小港區,順苓里,0,2,1651,24,1675,2411,3,1,3,0,1,0,69.47
高雄市,小港區,六苓里,0,2,523,3,526,703,3,1,3,0,1,0,74.82
高雄市,小港區,宏亮里,0,2,960,23,983,1415,3,1,3,0,1,0,69.47
高雄市,小港區,山明里,0,2,1920,40,1960,2774,3,1,3,0,1,0,70.66
高雄市,小港區,山東里,0,2,1580,19,1599,2261,3,1,3,0,1,0,70.72
高雄市,小港區,青島里,0,2,1014,9,1023,1387,3,1,3,0,1,0,73.76
高雄市,小港區,濟南里,0,2,1398,12,1410,1910,3,1,3,0,1,0,73.82
高雄市,小港區,泰山里,0,2,1061,14,1075,1454,3,1,3,0,1,0,73.93
高雄市,小港區,松金里,0,2,984,11,995,1370,3,1,3,0,1,0,72.63
高雄市,小港區,松山里,0,2,955,22,977,1252,3,1,3,0,1,0,78.04
高雄市,小港區,高松里,0,2,1966,44,2010,2564,3,1,3,0,1,0,78.39
高雄市,小港區,大坪里,0,2,715,12,727,938,3,1,3,0,1,0,77.51
高雄市,小港區,坪頂里,0,2,685,8,693,958,3,1,3,0,1,0,72.34
高雄市,小港區,孔宅里,0,2,1715,32,1747,2483,3,1,3,0,1,0,70.36
高雄市,小港區,合作里,0,2,1179,12,1191,1691,3,1,3,0,1,0,70.43
高雄市,小港區,廈莊里,0,2,926,17,943,1292,3,1,3,0,1,0,72.99
高雄市,小港區,桂林里,0,2,2739,41,2780,3889,3,1,3,0,1,0,71.48
高雄市,小港區,中厝里,0,2,1418,32,1450,1955,3,1,3,0,1,0,74.17
高雄市,小港區,龍鳳里,0,2,1392,15,1407,1722,3,1,3,0,1,0,81.71
高雄市,小港區,鳳鳴里,0,2,1500,13,1513,1859,3,1,3,0,1,0,81.39
高雄市,小港區,鳳興里,0,2,1075,11,1086,1374,3,1,3,0,1,0,79.04
高雄市,小港區,鳳源里,0,2,1534,21,1555,2067,3,1,3,0,1,0,75.23
高雄市,小港區,鳳林里,0,2,1417,17,1434,1964,3,1,3,0,1,0,73.01
高雄市,小港區,鳳森里,0,2,1056,12,1068,1358,3,1,3,0,1,0,78.65
高雄市,小港區,海澄里,0,2,2577,22,2599,3703,3,1,3,0,1,0,70.19
高雄市,小港區,海昌里,0,2,1372,18,1390,1986,3,1,3,0,1,0,69.99
高雄市,小港區,海豐里,0,2,1475,15,1490,2117,3,1,3,0,1,0,70.38
高雄市,小港區,海原里,0,2,1622,18,1640,2357,3,1,3,0,1,0,69.58
高雄市,小港區,海城里,0,2,1627,26,1653,2362,3,1,3,0,1,0,69.98
臺北縣,板橋市,留侯里,0,1,842,10,852,1239,3,1,3,0,1,0,68.77
臺北縣,板橋市,流芳里,0,1,907,10,917,1292,3,1,3,0,1,0,70.98
臺北縣,板橋市,赤松里,0,1,403,6,409,553,3,1,3,0,1,0,73.96
臺北縣,板橋市,黃石里,0,1,781,11,792,1133,3,1,3,0,1,0,69.90
臺北縣,板橋市,挹秀里,0,1,1110,9,1119,1644,3,1,3,0,1,0,68.07
臺北縣,板橋市,湳興里,0,1,2553,49,2602,3889,3,1,3,0,1,0,66.91
臺北縣,板橋市,新興里,0,1,1694,19,1713,2490,3,1,3,0,1,0,68.80
臺北縣,板橋市,社後里,0,1,2957,48,3005,4492,3,1,3,0,1,0,66.90
臺北縣,板橋市,香社里,0,1,2067,29,2096,3052,3,1,3,0,1,0,68.68
臺北縣,板橋市,香雅里,0,1,1322,12,1334,1996,3,1,3,0,1,0,66.83
臺北縣,板橋市,中正里,0,1,2268,56,2324,3549,3,1,3,0,1,0,65.48
臺北縣,板橋市,自強里,0,1,3062,29,3091,4302,3,1,3,0,1,0,71.85
臺北縣,板橋市,自立里,0,1,1584,15,1599,2382,3,1,3,0,1,0,67.13
臺北縣,板橋市,光華里,0,1,1413,13,1426,2108,3,1,3,0,1,0,67.65
臺北縣,板橋市,光榮里,0,1,1508,24,1532,2175,3,1,3,0,1,0,70.44
臺北縣,板橋市,國光里,0,1,1836,13,1849,2442,3,1,3,0,1,0,75.72
臺北縣,板橋市,港尾里,0,1,956,9,965,1434,3,1,3,0,1,0,67.29
臺北縣,板橋市,新生里,0,1,2258,34,2292,3349,3,1,3,0,1,0,68.44
臺北縣,板橋市,金華里,0,1,2003,34,2037,3091,3,1,3,0,1,0,65.90
臺北縣,板橋市,港德里,0,1,2546,37,2583,3951,3,1,3,0,1,0,65.38
臺北縣,板橋市,民權里,0,1,1750,21,1771,2496,3,1,3,0,1,0,70.95
臺北縣,板橋市,民安里,0,1,1243,14,1257,1815,3,1,3,0,1,0,69.26
臺北縣,板橋市,建國里,0,1,2122,30,2152,3209,3,1,3,0,1,0,67.06
臺北縣,板橋市,漢生里,0,1,2660,28,2688,3748,3,1,3,0,1,0,71.72
臺北縣,板橋市,公舘里,0,1,2144,36,2180,3007,3,1,3,0,1,0,72.50
臺北縣,板橋市,新民里,0,1,2511,30,2541,3644,3,1,3,0,1,0,69.73
臺北縣,板橋市,幸福里,0,1,2054,28,2082,3019,3,1,3,0,1,0,68.96
臺北縣,板橋市,文德里,0,1,1217,22,1239,1808,3,1,3,0,1,0,68.53
臺北縣,板橋市,忠誠里,0,1,1463,5,1468,1953,3,1,3,0,1,0,75.17
臺北縣,板橋市,陽明里,0,1,1552,21,1573,2233,3,1,3,0,1,0,70.44
臺北縣,板橋市,百壽里,0,1,1381,20,1401,1949,3,1,3,0,1,0,71.88
臺北縣,板橋市,介壽里,0,1,1569,8,1577,2336,3,1,3,0,1,0,67.51
臺北縣,板橋市,新埔里,0,1,1360,21,1381,1991,3,1,3,0,1,0,69.36
臺北縣,板橋市,華江里,0,1,1745,20,1765,2637,3,1,3,0,1,0,66.93
臺北縣,板橋市,江翠里,0,1,2336,23,2359,3504,3,1,3,0,1,0,67.32
臺北縣,板橋市,純翠里,0,1,1999,29,2028,2967,3,1,3,0,1,0,68.35
臺北縣,板橋市,溪頭里,0,1,2470,32,2502,3860,3,1,3,0,1,0,64.82
臺北縣,板橋市,聯翠里,0,1,1351,16,1367,2043,3,1,3,0,1,0,66.91
臺北縣,板橋市,文化里,0,1,1670,24,1694,2486,3,1,3,0,1,0,68.14
臺北縣,板橋市,宏翠里,0,1,1463,29,1492,2166,3,1,3,0,1,0,68.88
臺北縣,板橋市,仁翠里,0,1,1658,32,1690,2442,3,1,3,0,1,0,69.21
臺北縣,板橋市,新翠里,0,1,2345,35,2380,3491,3,1,3,0,1,0,68.18
臺北縣,板橋市,朝陽里,0,1,1682,25,1707,2586,3,1,3,0,1,0,66.01
臺北縣,板橋市,吉翠里,0,1,1818,26,1844,2697,3,1,3,0,1,0,68.37
臺北縣,板橋市,德翠里,0,1,1499,19,1518,2332,3,1,3,0,1,0,65.09
臺北縣,板橋市,新海里,0,1,1594,26,1620,2598,3,1,3,0,1,0,62.36
臺北縣,板橋市,滿翠里,0,1,1781,26,1807,2635,3,1,3,0,1,0,68.58
臺北縣,板橋市,明翠里,0,1,2805,27,2832,4159,3,1,3,0,1,0,68.09
臺北縣,板橋市,松翠里,0,1,1571,21,1592,2445,3,1,3,0,1,0,65.11
臺北縣,板橋市,柏翠里,0,1,1745,22,1767,2557,3,1,3,0,1,0,69.10
臺北縣,板橋市,龍翠里,0,1,1987,23,2010,3004,3,1,3,0,1,0,66.91
臺北縣,板橋市,松柏里,0,1,1330,7,1337,2021,3,1,3,0,1,0,66.16
臺北縣,板橋市,華翠里,0,1,1642,18,1660,2438,3,1,3,0,1,0,68.09
臺北縣,板橋市,莒光里,0,1,1425,12,1437,2181,3,1,3,0,1,0,65.89
臺北縣,板橋市,忠翠里,0,1,2242,40,2282,3344,3,1,3,0,1,0,68.24
臺北縣,板橋市,嵐翠里,0,1,1375,23,1398,2195,3,1,3,0,1,0,63.69
臺北縣,板橋市,文聖里,0,1,1329,22,1351,1970,3,1,3,0,1,0,68.58
臺北縣,板橋市,文翠里,0,1,1962,30,1992,2884,3,1,3,0,1,0,69.07
臺北縣,板橋市,青翠里,0,1,1635,24,1659,2589,3,1,3,0,1,0,64.08
臺北縣,板橋市,懷翠里,0,1,2187,37,2224,3493,3,1,3,0,1,0,63.67
臺北縣,板橋市,福翠里,0,1,1176,19,1195,1760,3,1,3,0,1,0,67.90
臺北縣,板橋市,港嘴里,0,1,2744,34,2778,4147,3,1,3,0,1,0,66.99
臺北縣,板橋市,振興里,0,1,2287,40,2327,3255,3,1,3,0,1,0,71.49
臺北縣,板橋市,振義里,0,1,2006,37,2043,3041,3,1,3,0,1,0,67.18
臺北縣,板橋市,光復里,0,1,1564,34,1598,2394,3,1,3,0,1,0,66.75
臺北縣,板橋市,埔墘里,0,1,2492,44,2536,3782,3,1,3,0,1,0,67.05
臺北縣,板橋市,富貴里,0,1,1032,11,1043,1576,3,1,3,0,1,0,66.18
臺北縣,板橋市,長壽里,0,1,1475,31,1506,2180,3,1,3,0,1,0,69.08
臺北縣,板橋市,福壽里,0,1,1363,20,1383,2005,3,1,3,0,1,0,68.98
臺北縣,板橋市,居仁里,0,1,1651,30,1681,2339,3,1,3,0,1,0,71.87
臺北縣,板橋市,海山里,0,1,2667,43,2710,3881,3,1,3,0,1,0,69.83
臺北縣,板橋市,九如里,0,1,1517,22,1539,2340,3,1,3,0,1,0,65.77
臺北縣,板橋市,正泰里,0,1,1471,18,1489,2124,3,1,3,0,1,0,70.10
臺北縣,板橋市,玉光里,0,1,2236,31,2267,3368,3,1,3,0,1,0,67.31
臺北縣,板橋市,光仁里,0,1,1633,15,1648,2341,3,1,3,0,1,0,70.40
臺北縣,板橋市,埤墘里,0,1,1726,23,1749,2630,3,1,3,0,1,0,66.50
臺北縣,板橋市,莊敬里,0,1,917,9,926,1359,3,1,3,0,1,0,68.14
臺北縣,板橋市,永安里,0,1,1325,17,1342,2080,3,1,3,0,1,0,64.52
臺北縣,板橋市,雙玉里,0,1,1510,31,1541,2489,3,1,3,0,1,0,61.91
臺北縣,板橋市,廣新里,0,1,1820,26,1846,2887,3,1,3,0,1,0,63.94
臺北縣,板橋市,深丘里,0,1,2684,18,2702,3915,3,1,3,0,1,0,69.02
臺北縣,板橋市,香丘里,0,1,1855,27,1882,2689,3,1,3,0,1,0,69.99
臺北縣,板橋市,西安里,0,1,1268,15,1283,1892,3,1,3,0,1,0,67.81
臺北縣,板橋市,東丘里,0,1,2120,34,2154,3199,3,1,3,0,1,0,67.33
臺北縣,板橋市,民生里,0,1,894,12,906,1398,3,1,3,0,1,0,64.81
臺北縣,板橋市,長安里,0,1,1603,23,1626,2462,3,1,3,0,1,0,66.04
臺北縣,板橋市,東安里,0,1,1293,20,1313,1918,3,1,3,0,1,0,68.46
臺北縣,板橋市,福丘里,0,1,1060,16,1076,1604,3,1,3,0,1,0,67.08
臺北縣,板橋市,福祿里,0,1,1580,29,1609,2351,3,1,3,0,1,0,68.44
臺北縣,板橋市,民族里,0,1,2158,19,2177,3174,3,1,3,0,1,0,68.59
臺北縣,板橋市,國泰里,0,1,1404,25,1429,2175,3,1,3,0,1,0,65.70
臺北縣,板橋市,後埔里,0,1,1569,17,1586,2354,3,1,3,0,1,0,67.37
臺北縣,板橋市,福德里,0,1,2461,34,2495,3626,3,1,3,0,1,0,68.81
臺北縣,板橋市,景星里,0,1,1656,16,1672,2422,3,1,3,0,1,0,69.03
臺北縣,板橋市,福星里,0,1,1471,17,1488,2194,3,1,3,0,1,0,67.82
臺北縣,板橋市,鄉雲里,0,1,1719,33,1752,2373,3,1,3,0,1,0,73.83
臺北縣,板橋市,廣德里,0,1,2636,26,2662,3851,3,1,3,0,1,0,69.12
臺北縣,板橋市,大豐里,0,1,2322,43,2365,3518,3,1,3,0,1,0,67.23
臺北縣,板橋市,重慶里,0,1,2903,53,2956,4289,3,1,3,0,1,0,68.92
臺北縣,板橋市,仁愛里,0,1,1950,19,1969,2745,3,1,3,0,1,0,71.73
臺北縣,板橋市,和平里,0,1,596,12,608,880,3,1,3,0,1,0,69.09
臺北縣,板橋市,廣福里,0,1,1351,26,1377,2086,3,1,3,0,1,0,66.01
臺北縣,板橋市,五權里,0,1,2320,27,2347,3464,3,1,3,0,1,0,67.75
臺北縣,板橋市,華興里,0,1,1426,17,1443,2207,3,1,3,0,1,0,65.38
臺北縣,板橋市,華貴里,0,1,1553,14,1567,2240,3,1,3,0,1,0,69.96
臺北縣,板橋市,華福里,0,1,1113,22,1135,1637,3,1,3,0,1,0,69.33
臺北縣,板橋市,華德里,0,1,2366,37,2403,3667,3,1,3,0,1,0,65.53
臺北縣,板橋市,華東里,0,1,2349,32,2381,3336,3,1,3,0,1,0,71.37
臺北縣,板橋市,信義里,0,1,2166,40,2206,3141,3,1,3,0,1,0,70.23
臺北縣,板橋市,浮洲里,0,1,1986,29,2015,3551,3,1,3,0,1,0,56.74
臺北縣,板橋市,華中里,0,1,2219,42,2261,3630,3,1,3,0,1,0,62.29
臺北縣,板橋市,僑中里,0,1,1762,25,1787,2551,3,1,3,0,1,0,70.05
臺北縣,板橋市,大觀里,0,1,1593,30,1623,2392,3,1,3,0,1,0,67.85
臺北縣,板橋市,歡園里,0,1,731,13,744,1058,3,1,3,0,1,0,70.32
臺北縣,板橋市,中山里,0,1,2551,49,2600,3991,3,1,3,0,1,0,65.15
臺北縣,板橋市,復興里,0,1,2282,63,2345,3271,3,1,3,0,1,0,71.69
臺北縣,板橋市,大安里,0,1,2157,31,2188,3295,3,1,3,0,1,0,66.40
臺北縣,板橋市,福安里,0,1,1483,31,1514,2336,3,1,3,0,1,0,64.81
臺北縣,板橋市,聚安里,0,1,2310,40,2350,3685,3,1,3,0,1,0,63.77
臺北縣,板橋市,龍安里,0,1,1559,33,1592,2407,3,1,3,0,1,0,66.14
臺北縣,板橋市,崑崙里,0,1,2383,49,2432,3665,3,1,3,0,1,0,66.36
臺北縣,板橋市,成和里,0,1,1455,37,1492,2335,3,1,3,0,1,0,63.90
臺北縣,板橋市,溪洲里,0,1,2282,33,2315,3594,3,1,3,0,1,0,64.41
臺北縣,板橋市,溪福里,0,1,2203,40,2243,3421,3,1,3,0,1,0,65.57
臺北縣,板橋市,溪北里,0,1,1547,30,1577,2306,3,1,3,0,1,0,68.39
臺北縣,板橋市,堂春里,0,1,1478,30,1508,2311,3,1,3,0,1,0,65.25
臺北縣,三重市,大有里,0,1,1988,32,2020,2971,3,1,3,0,1,0,67.99
臺北縣,三重市,博愛里,0,1,1999,27,2026,2933,3,1,3,0,1,0,69.08
臺北縣,三重市,二重里,0,1,1104,22,1126,1754,3,1,3,0,1,0,64.20
臺北縣,三重市,頂崁里,0,1,938,19,957,1456,3,1,3,0,1,0,65.73
臺北縣,三重市,谷王里,0,1,856,12,868,1233,3,1,3,0,1,0,70.40
臺北縣,三重市,五谷里,0,1,1323,21,1344,1885,3,1,3,0,1,0,71.30
臺北縣,三重市,中興里,0,1,1839,33,1872,2753,3,1,3,0,1,0,68.00
臺北縣,三重市,德厚里,0,1,293,6,299,382,3,1,3,0,1,0,78.27
臺北縣,三重市,成功里,0,1,1468,23,1491,2310,3,1,3,0,1,0,64.55
臺北縣,三重市,福祉里,0,1,1786,19,1805,2678,3,1,3,0,1,0,67.40
臺北縣,三重市,福德里,0,1,1563,20,1583,2427,3,1,3,0,1,0,65.22
臺北縣,三重市,福民里,0,1,1679,14,1693,2422,3,1,3,0,1,0,69.90
臺北縣,三重市,過田里,0,1,1984,35,2019,3061,3,1,3,0,1,0,65.96
臺北縣,三重市,錦田里,0,1,1295,16,1311,1899,3,1,3,0,1,0,69.04
臺北縣,三重市,重明里,0,1,1391,18,1409,2064,3,1,3,0,1,0,68.27
臺北縣,三重市,光田里,0,1,1981,16,1997,2915,3,1,3,0,1,0,68.51
臺北縣,三重市,光陽里,0,1,2294,31,2325,3390,3,1,3,0,1,0,68.58
臺北縣,三重市,田心里,0,1,2284,21,2305,3449,3,1,3,0,1,0,66.83
臺北縣,三重市,福田里,0,1,1511,19,1530,2270,3,1,3,0,1,0,67.40
臺北縣,三重市,田中里,0,1,2615,30,2645,3977,3,1,3,0,1,0,66.51
臺北縣,三重市,田安里,0,1,2365,36,2401,3633,3,1,3,0,1,0,66.09
臺北縣,三重市,三民里,0,1,1316,18,1334,1938,3,1,3,0,1,0,68.83
臺北縣,三重市,光明里,0,1,2195,29,2224,3525,3,1,3,0,1,0,63.09
臺北縣,三重市,光正里,0,1,691,10,701,1151,3,1,3,0,1,0,60.90
臺北縣,三重市,同安里,0,1,967,16,983,1570,3,1,3,0,1,0,62.61
臺北縣,三重市,同慶里,0,1,862,19,881,1429,3,1,3,0,1,0,61.65
臺北縣,三重市,菜寮里,0,1,1174,17,1191,1735,3,1,3,0,1,0,68.65
臺北縣,三重市,永春里,0,1,815,17,832,1188,3,1,3,0,1,0,70.03
臺北縣,三重市,中正里,0,1,752,12,764,1105,3,1,3,0,1,0,69.14
臺北縣,三重市,吉利里,0,1,875,20,895,1380,3,1,3,0,1,0,64.86
臺北縣,三重市,大同里,0,1,879,15,894,1368,3,1,3,0,1,0,65.35
臺北縣,三重市,中民里,0,1,819,14,833,1232,3,1,3,0,1,0,67.61
臺北縣,三重市,平和里,0,1,1049,18,1067,1545,3,1,3,0,1,0,69.06
臺北縣,三重市,大安里,0,1,864,17,881,1385,3,1,3,0,1,0,63.61
臺北縣,三重市,仁德里,0,1,1317,20,1337,2005,3,1,3,0,1,0,66.68
臺北縣,三重市,忠孝里,0,1,1034,15,1049,1630,3,1,3,0,1,0,64.36
臺北縣,三重市,仁義里,0,1,745,14,759,1100,3,1,3,0,1,0,69.00
臺北縣,三重市,光榮里,0,1,658,11,669,1000,3,1,3,0,1,0,66.90
臺北縣,三重市,光輝里,0,1,1177,9,1186,1683,3,1,3,0,1,0,70.47
臺北縣,三重市,福星里,0,1,642,9,651,896,3,1,3,0,1,0,72.66
臺北縣,三重市,福利里,0,1,539,13,552,885,3,1,3,0,1,0,62.37
臺北縣,三重市,清和里,0,1,1021,12,1033,1542,3,1,3,0,1,0,66.99
臺北縣,三重市,永興里,0,1,485,7,492,737,3,1,3,0,1,0,66.76
臺北縣,三重市,中山里,0,1,1374,18,1392,2034,3,1,3,0,1,0,68.44
臺北縣,三重市,大園里,0,1,1323,13,1336,2047,3,1,3,0,1,0,65.27
臺北縣,三重市,國隆里,0,1,1033,10,1043,1575,3,1,3,0,1,0,66.22
臺北縣,三重市,重陽里,0,1,1607,22,1629,2488,3,1,3,0,1,0,65.47
臺北縣,三重市,民生里,0,1,2360,19,2379,3423,3,1,3,0,1,0,69.50
臺北縣,三重市,重新里,0,1,1017,10,1027,1442,3,1,3,0,1,0,71.22
臺北縣,三重市,正德里,0,1,764,8,772,1105,3,1,3,0,1,0,69.86
臺北縣,三重市,正義里,0,1,854,4,858,1231,3,1,3,0,1,0,69.70
臺北縣,三重市,正安里,0,1,1072,12,1084,1618,3,1,3,0,1,0,67.00
臺北縣,三重市,自強里,0,1,995,10,1005,1518,3,1,3,0,1,0,66.21
臺北縣,三重市,文化里,0,1,1579,18,1597,2386,3,1,3,0,1,0,66.93
臺北縣,三重市,中央里,0,1,909,14,923,1390,3,1,3,0,1,0,66.40
臺北縣,三重市,雙園里,0,1,674,15,689,1011,3,1,3,0,1,0,68.15
臺北縣,三重市,錦通里,0,1,1031,34,1065,1621,3,1,3,0,1,0,65.70
臺北縣,三重市,錦安里,0,1,1235,11,1246,1798,3,1,3,0,1,0,69.30
臺北縣,三重市,長安里,0,1,1169,16,1185,1844,3,1,3,0,1,0,64.26
臺北縣,三重市,光華里,0,1,1029,17,1046,1535,3,1,3,0,1,0,68.14
臺北縣,三重市,長生里,0,1,445,4,449,694,3,1,3,0,1,0,64.70
臺北縣,三重市,開元里,0,1,1039,16,1055,1552,3,1,3,0,1,0,67.98
臺北縣,三重市,大德里,0,1,418,4,422,616,3,1,3,0,1,0,68.51
臺北縣,三重市,長元里,0,1,1122,18,1140,1688,3,1,3,0,1,0,67.54
臺北縣,三重市,長江里,0,1,1012,10,1022,1555,3,1,3,0,1,0,65.72
臺北縣,三重市,長泰里,0,1,1289,19,1308,1896,3,1,3,0,1,0,68.99
臺北縣,三重市,長福里,0,1,998,14,1012,1451,3,1,3,0,1,0,69.75
臺北縣,三重市,介壽里,0,1,694,14,708,1060,3,1,3,0,1,0,66.79
臺北縣,三重市,萬壽里,0,1,935,10,945,1398,3,1,3,0,1,0,67.60
臺北縣,三重市,錦江里,0,1,1413,30,1443,2209,3,1,3,0,1,0,65.32
臺北縣,三重市,龍濱里,0,1,1475,27,1502,2300,3,1,3,0,1,0,65.30
臺北縣,三重市,龍門里,0,1,982,14,996,1519,3,1,3,0,1,0,65.57
臺北縣,三重市,秀江里,0,1,821,8,829,1176,3,1,3,0,1,0,70.49
臺北縣,三重市,奕壽里,0,1,993,11,1004,1448,3,1,3,0,1,0,69.34
臺北縣,三重市,三安里,0,1,1506,24,1530,2300,3,1,3,0,1,0,66.52
臺北縣,三重市,福安里,0,1,1466,25,1491,2198,3,1,3,0,1,0,67.83
臺北縣,三重市,信安里,0,1,774,14,788,1125,3,1,3,0,1,0,70.04
臺北縣,三重市,安慶里,0,1,1198,22,1220,1742,3,1,3,0,1,0,70.03
臺北縣,三重市,幸福里,0,1,2337,37,2374,3596,3,1,3,0,1,0,66.02
臺北縣,三重市,六合里,0,1,1969,21,1990,3022,3,1,3,0,1,0,65.85
臺北縣,三重市,六福里,0,1,2396,33,2429,3601,3,1,3,0,1,0,67.45
臺北縣,三重市,順德里,0,1,1382,12,1394,2034,3,1,3,0,1,0,68.53
臺北縣,三重市,承德里,0,1,1160,15,1175,1685,3,1,3,0,1,0,69.73
臺北縣,三重市,瑞德里,0,1,1449,22,1471,2114,3,1,3,0,1,0,69.58
臺北縣,三重市,崇德里,0,1,2199,32,2231,3461,3,1,3,0,1,0,64.46
臺北縣,三重市,厚德里,0,1,1552,20,1572,2219,3,1,3,0,1,0,70.84
臺北縣,三重市,維德里,0,1,1410,24,1434,2193,3,1,3,0,1,0,65.39
臺北縣,三重市,尚德里,0,1,1768,32,1800,2647,3,1,3,0,1,0,68.00
臺北縣,三重市,培德里,0,1,1647,17,1664,2478,3,1,3,0,1,0,67.15
臺北縣,三重市,立德里,0,1,1502,14,1516,2295,3,1,3,0,1,0,66.06
臺北縣,三重市,永德里,0,1,2662,36,2698,3923,3,1,3,0,1,0,68.77
臺北縣,三重市,永煇里,0,1,1309,16,1325,1985,3,1,3,0,1,0,66.75
臺北縣,三重市,永發里,0,1,1834,29,1863,2776,3,1,3,0,1,0,67.11
臺北縣,三重市,永盛里,0,1,1735,24,1759,2554,3,1,3,0,1,0,68.87
臺北縣,三重市,永吉里,0,1,1312,17,1329,2047,3,1,3,0,1,0,64.92
臺北縣,三重市,永安里,0,1,1305,19,1324,1972,3,1,3,0,1,0,67.14
臺北縣,三重市,永豐里,0,1,1886,32,1918,2984,3,1,3,0,1,0,64.28
臺北縣,三重市,永福里,0,1,2070,32,2102,3291,3,1,3,0,1,0,63.87
臺北縣,三重市,永清里,0,1,2285,43,2328,3728,3,1,3,0,1,0,62.45
臺北縣,三重市,永順里,0,1,1689,20,1709,2662,3,1,3,0,1,0,64.20
臺北縣,三重市,溪美里,0,1,2606,35,2641,3967,3,1,3,0,1,0,66.57
臺北縣,三重市,福隆里,0,1,2981,28,3009,4649,3,1,3,0,1,0,64.72
臺北縣,三重市,五常里,0,1,3138,50,3188,4786,3,1,3,0,1,0,66.61
臺北縣,三重市,五福里,0,1,1313,24,1337,2126,3,1,3,0,1,0,62.89
臺北縣,三重市,仁忠里,0,1,1572,27,1599,2511,3,1,3,0,1,0,63.68
臺北縣,三重市,慈福里,0,1,1244,25,1269,1959,3,1,3,0,1,0,64.78
臺北縣,三重市,慈生里,0,1,1404,22,1426,2092,3,1,3,0,1,0,68.16
臺北縣,三重市,慈惠里,0,1,1242,20,1262,1792,3,1,3,0,1,0,70.42
臺北縣,三重市,慈愛里,0,1,2004,34,2038,2910,3,1,3,0,1,0,70.03
臺北縣,三重市,慈化里,0,1,1261,28,1289,1853,3,1,3,0,1,0,69.56
臺北縣,三重市,慈祐里,0,1,2099,39,2138,3211,3,1,3,0,1,0,66.58
臺北縣,三重市,富華里,0,1,1354,23,1377,2070,3,1,3,0,1,0,66.52
臺北縣,三重市,富貴里,0,1,1399,32,1431,2179,3,1,3,0,1,0,65.67
臺北縣,三重市,富福里,0,1,1043,17,1060,1654,3,1,3,0,1,0,64.09
臺北縣,三重市,五華里,0,1,1436,30,1466,2136,3,1,3,0,1,0,68.63
臺北縣,三重市,碧華里,0,1,2504,41,2545,4133,3,1,3,0,1,0,61.58
臺北縣,中和市,中原里,0,1,1603,25,1628,2562,3,1,3,0,1,0,63.54
臺北縣,中和市,連和里,0,1,872,9,881,1335,3,1,3,0,1,0,65.99
臺北縣,中和市,連城里,0,1,2751,25,2776,3964,3,1,3,0,1,0,70.03
臺北縣,中和市,力行里,0,1,1733,18,1751,2618,3,1,3,0,1,0,66.88
臺北縣,中和市,正行里,0,1,1260,18,1278,1853,3,1,3,0,1,0,68.97
臺北縣,中和市,德行里,0,1,1732,36,1768,2601,3,1,3,0,1,0,67.97
臺北縣,中和市,枋寮里,0,1,1908,16,1924,2814,3,1,3,0,1,0,68.37
臺北縣,中和市,漳和里,0,1,1794,29,1823,2623,3,1,3,0,1,0,69.50
臺北縣,中和市,廟美里,0,1,2515,27,2542,3609,3,1,3,0,1,0,70.44
臺北縣,中和市,福真里,0,1,1959,38,1997,3033,3,1,3,0,1,0,65.84
臺北縣,中和市,福善里,0,1,2030,27,2057,3035,3,1,3,0,1,0,67.78
臺北縣,中和市,福美里,0,1,2653,44,2697,3798,3,1,3,0,1,0,71.01
臺北縣,中和市,福祥里,0,1,2036,47,2083,3034,3,1,3,0,1,0,68.66
臺北縣,中和市,瓦窯里,0,1,2499,38,2537,3739,3,1,3,0,1,0,67.85
臺北縣,中和市,福和里,0,1,2077,28,2105,3001,3,1,3,0,1,0,70.14
臺北縣,中和市,佳和里,0,1,2467,39,2506,3653,3,1,3,0,1,0,68.60
臺北縣,中和市,新南里,0,1,2241,26,2267,3393,3,1,3,0,1,0,66.81
臺北縣,中和市,南山里,0,1,2085,23,2108,2944,3,1,3,0,1,0,71.60
臺北縣,中和市,宜安里,0,1,1031,10,1041,1571,3,1,3,0,1,0,66.26
臺北縣,中和市,安樂里,0,1,1676,21,1697,2373,3,1,3,0,1,0,71.51
臺北縣,中和市,安和里,0,1,1329,17,1346,1920,3,1,3,0,1,0,70.10
臺北縣,中和市,安順里,0,1,1829,24,1853,2714,3,1,3,0,1,0,68.28
臺北縣,中和市,安平里,0,1,2640,30,2670,3874,3,1,3,0,1,0,68.92
臺北縣,中和市,中安里,0,1,1792,16,1808,2678,3,1,3,0,1,0,67.51
臺北縣,中和市,泰安里,0,1,2188,35,2223,3247,3,1,3,0,1,0,68.46
臺北縣,中和市,秀山里,0,1,2175,25,2200,3203,3,1,3,0,1,0,68.69
臺北縣,中和市,秀成里,0,1,1902,26,1928,2807,3,1,3,0,1,0,68.69
臺北縣,中和市,秀義里,0,1,1520,36,1556,2225,3,1,3,0,1,0,69.93
臺北縣,中和市,秀福里,0,1,2396,24,2420,3535,3,1,3,0,1,0,68.46
臺北縣,中和市,秀景里,0,1,2385,38,2423,3555,3,1,3,0,1,0,68.16
臺北縣,中和市,秀明里,0,1,1994,26,2020,2924,3,1,3,0,1,0,69.08
臺北縣,中和市,秀峰里,0,1,1425,13,1438,2027,3,1,3,0,1,0,70.94
臺北縣,中和市,秀士里,0,1,1439,20,1459,2159,3,1,3,0,1,0,67.58
臺北縣,中和市,秀水里,0,1,2480,36,2516,3676,3,1,3,0,1,0,68.44
臺北縣,中和市,秀仁里,0,1,1641,20,1661,2372,3,1,3,0,1,0,70.03
臺北縣,中和市,正南里,0,1,2118,41,2159,3278,3,1,3,0,1,0,65.86
臺北縣,中和市,頂南里,0,1,1603,23,1626,2402,3,1,3,0,1,0,67.69
臺北縣,中和市,華新里,0,1,1860,30,1890,2895,3,1,3,0,1,0,65.28
臺北縣,中和市,東南里,0,1,2950,40,2990,4242,3,1,3,0,1,0,70.49
臺北縣,中和市,華南里,0,1,1943,47,1990,2898,3,1,3,0,1,0,68.67
臺北縣,中和市,忠孝里,0,1,2735,42,2777,4299,3,1,3,0,1,0,64.60
臺北縣,中和市,崇南里,0,1,1333,12,1345,1923,3,1,3,0,1,0,69.94
臺北縣,中和市,興南里,0,1,2121,33,2154,3205,3,1,3,0,1,0,67.21
臺北縣,中和市,景南里,0,1,1885,22,1907,2771,3,1,3,0,1,0,68.82
臺北縣,中和市,景本里,0,1,1350,13,1363,1938,3,1,3,0,1,0,70.33
臺北縣,中和市,橫路里,0,1,167,1,168,232,3,1,3,0,1,0,72.41
臺北縣,中和市,內南里,0,1,2744,44,2788,4140,3,1,3,0,1,0,67.34
臺北縣,中和市,壽南里,0,1,1531,26,1557,2274,3,1,3,0,1,0,68.47
臺北縣,中和市,福南里,0,1,1847,25,1872,2883,3,1,3,0,1,0,64.93
臺北縣,中和市,外南里,0,1,1764,27,1791,2594,3,1,3,0,1,0,69.04
臺北縣,中和市,中興里,0,1,1813,18,1831,2645,3,1,3,0,1,0,69.22
臺北縣,中和市,吉興里,0,1,1229,22,1251,1958,3,1,3,0,1,0,63.89
臺北縣,中和市,復興里,0,1,3060,43,3103,4548,3,1,3,0,1,0,68.23
臺北縣,中和市,和興里,0,1,1893,36,1929,2812,3,1,3,0,1,0,68.60
臺北縣,中和市,景平里,0,1,2153,26,2179,3336,3,1,3,0,1,0,65.32
臺北縣,中和市,景新里,0,1,1963,33,1996,3088,3,1,3,0,1,0,64.64
臺北縣,中和市,景福里,0,1,2805,60,2865,4306,3,1,3,0,1,0,66.54
臺北縣,中和市,景安里,0,1,2718,41,2759,3974,3,1,3,0,1,0,69.43
臺北縣,中和市,景文里,0,1,1472,25,1497,2192,3,1,3,0,1,0,68.29
臺北縣,中和市,平河里,0,1,1987,33,2020,3020,3,1,3,0,1,0,66.89
臺北縣,中和市,信和里,0,1,1941,33,1974,2887,3,1,3,0,1,0,68.38
臺北縣,中和市,仁和里,0,1,2319,30,2349,3408,3,1,3,0,1,0,68.93
臺北縣,中和市,中正里,0,1,2020,31,2051,3030,3,1,3,0,1,0,67.69
臺北縣,中和市,中山里,0,1,1167,11,1178,1846,3,1,3,0,1,0,63.81
臺北縣,中和市,建和里,0,1,2342,34,2376,3344,3,1,3,0,1,0,71.05
臺北縣,中和市,碧河里,0,1,1454,11,1465,2178,3,1,3,0,1,0,67.26
臺北縣,中和市,錦和里,0,1,1460,9,1469,2125,3,1,3,0,1,0,69.13
臺北縣,中和市,錦中里,0,1,1805,27,1832,2700,3,1,3,0,1,0,67.85
臺北縣,中和市,錦昌里,0,1,997,11,1008,1441,3,1,3,0,1,0,69.95
臺北縣,中和市,錦盛里,0,1,1751,18,1769,2656,3,1,3,0,1,0,66.60
臺北縣,中和市,灰窯里,0,1,320,5,325,466,3,1,3,0,1,0,69.74
臺北縣,中和市,積穗里,0,1,2225,28,2253,3416,3,1,3,0,1,0,65.95
臺北縣,中和市,民享里,0,1,1492,18,1510,1996,3,1,3,0,1,0,75.65
臺北縣,中和市,民有里,0,1,1788,18,1806,2561,3,1,3,0,1,0,70.52
臺北縣,中和市,員山里,0,1,1933,28,1961,2861,3,1,3,0,1,0,68.54
臺北縣,中和市,員富里,0,1,1244,20,1264,1936,3,1,3,0,1,0,65.29
臺北縣,中和市,嘉穗里,0,1,1399,20,1419,2118,3,1,3,0,1,0,67.00
臺北縣,中和市,嘉慶里,0,1,1667,28,1695,2725,3,1,3,0,1,0,62.20
臺北縣,中和市,文元里,0,1,2675,33,2708,4033,3,1,3,0,1,0,67.15
臺北縣,中和市,嘉新里,0,1,1705,26,1731,2623,3,1,3,0,1,0,65.99
臺北縣,中和市,民安里,0,1,2284,31,2315,3495,3,1,3,0,1,0,66.24
臺北縣,中和市,安穗里,0,1,1750,27,1777,2756,3,1,3,0,1,0,64.48
臺北縣,中和市,瑞穗里,0,1,1311,12,1323,1816,3,1,3,0,1,0,72.85
臺北縣,中和市,冠穗里,0,1,1869,31,1900,2748,3,1,3,0,1,0,69.14
臺北縣,中和市,明穗里,0,1,2114,38,2152,3039,3,1,3,0,1,0,70.81
臺北縣,中和市,清穗里,0,1,1597,25,1622,2334,3,1,3,0,1,0,69.49
臺北縣,中和市,自強里,0,1,2294,39,2333,3386,3,1,3,0,1,0,68.90
臺北縣,中和市,德穗里,0,1,2739,37,2776,3862,3,1,3,0,1,0,71.88
臺北縣,中和市,民生里,0,1,1694,22,1716,2424,3,1,3,0,1,0,70.79
臺北縣,中和市,國光里,0,1,1655,18,1673,2443,3,1,3,0,1,0,68.48
臺北縣,中和市,國華里,0,1,1298,15,1313,1906,3,1,3,0,1,0,68.89
臺北縣,中和市,壽德里,0,1,1018,14,1032,1520,3,1,3,0,1,0,67.89
臺北縣,中和市,明德里,0,1,1965,33,1998,2922,3,1,3,0,1,0,68.38
臺北縣,永和市,光復里,0,1,1142,16,1158,1640,3,1,3,0,1,0,70.61
臺北縣,永和市,網溪里,0,1,752,11,763,1147,3,1,3,0,1,0,66.52
臺北縣,永和市,復興里,0,1,1390,14,1404,2111,3,1,3,0,1,0,66.51
臺北縣,永和市,竹林里,0,1,2290,30,2320,3429,3,1,3,0,1,0,67.66
臺北縣,永和市,桂林里,0,1,1995,33,2028,2936,3,1,3,0,1,0,69.07
臺北縣,永和市,上林里,0,1,2249,22,2271,3351,3,1,3,0,1,0,67.77
臺北縣,永和市,福林里,0,1,2151,21,2172,3186,3,1,3,0,1,0,68.17
臺北縣,永和市,勵行里,0,1,871,15,886,1245,3,1,3,0,1,0,71.16
臺北縣,永和市,中興里,0,1,1960,22,1982,2903,3,1,3,0,1,0,68.27
臺北縣,永和市,永興里,0,1,2123,36,2159,3268,3,1,3,0,1,0,66.06
臺北縣,永和市,正興里,0,1,1318,15,1333,1994,3,1,3,0,1,0,66.85
臺北縣,永和市,豫溪里,0,1,1901,34,1935,2954,3,1,3,0,1,0,65.50
臺北縣,永和市,光明里,0,1,1705,15,1720,2535,3,1,3,0,1,0,67.85
臺北縣,永和市,福和里,0,1,2404,29,2433,3622,3,1,3,0,1,0,67.17
臺北縣,永和市,得和里,0,1,2399,23,2422,3389,3,1,3,0,1,0,71.47
臺北縣,永和市,永貞里,0,1,2163,19,2182,3118,3,1,3,0,1,0,69.98
臺北縣,永和市,永福里,0,1,1850,21,1871,2622,3,1,3,0,1,0,71.36
臺北縣,永和市,河濱里,0,1,1773,26,1799,2610,3,1,3,0,1,0,68.93
臺北縣,永和市,秀和里,0,1,2291,25,2316,3377,3,1,3,0,1,0,68.58
臺北縣,永和市,永元里,0,1,2703,38,2741,3875,3,1,3,0,1,0,70.74
臺北縣,永和市,民權里,0,1,2151,22,2173,3015,3,1,3,0,1,0,72.07
臺北縣,永和市,民族里,0,1,2564,24,2588,3635,3,1,3,0,1,0,71.20
臺北縣,永和市,秀朗里,0,1,2069,39,2108,3147,3,1,3,0,1,0,66.98
臺北縣,永和市,秀成里,0,1,1646,20,1666,2421,3,1,3,0,1,0,68.81
臺北縣,永和市,秀林里,0,1,2006,21,2027,2905,3,1,3,0,1,0,69.78
臺北縣,永和市,秀得里,0,1,3202,38,3240,4665,3,1,3,0,1,0,69.45
臺北縣,永和市,民生里,0,1,2487,25,2512,3562,3,1,3,0,1,0,70.52
臺北縣,永和市,民本里,0,1,3129,44,3173,4588,3,1,3,0,1,0,69.16
臺北縣,永和市,民樂里,0,1,2258,30,2288,3239,3,1,3,0,1,0,70.64
臺北縣,永和市,民治里,0,1,1602,27,1629,2398,3,1,3,0,1,0,67.93
臺北縣,永和市,智光里,0,1,2221,31,2252,3298,3,1,3,0,1,0,68.28
臺北縣,永和市,潭安里,0,1,2361,25,2386,3561,3,1,3,0,1,0,67.00
臺北縣,永和市,潭墘里,0,1,2347,34,2381,3493,3,1,3,0,1,0,68.16
臺北縣,永和市,店街里,0,1,1898,22,1920,2877,3,1,3,0,1,0,66.74
臺北縣,永和市,大新里,0,1,1201,9,1210,1861,3,1,3,0,1,0,65.02
臺北縣,永和市,永安里,0,1,2617,24,2641,3847,3,1,3,0,1,0,68.65
臺北縣,永和市,水源里,0,1,2168,29,2197,3148,3,1,3,0,1,0,69.79
臺北縣,永和市,協和里,0,1,1821,28,1849,2763,3,1,3,0,1,0,66.92
臺北縣,永和市,雙和里,0,1,1814,20,1834,2629,3,1,3,0,1,0,69.76
臺北縣,永和市,安和里,0,1,1876,30,1906,2753,3,1,3,0,1,0,69.23
臺北縣,永和市,前溪里,0,1,1203,16,1219,1727,3,1,3,0,1,0,70.58
臺北縣,永和市,和平里,0,1,2210,27,2237,3325,3,1,3,0,1,0,67.28
臺北縣,永和市,保平里,0,1,2330,18,2348,3318,3,1,3,0,1,0,70.77
臺北縣,永和市,中溪里,0,1,2247,27,2274,3324,3,1,3,0,1,0,68.41
臺北縣,永和市,保安里,0,1,2856,30,2886,4299,3,1,3,0,1,0,67.13
臺北縣,永和市,下溪里,0,1,1917,28,1945,2841,3,1,3,0,1,0,68.46
臺北縣,永和市,大同里,0,1,808,27,835,1055,3,1,3,0,1,0,79.15
臺北縣,永和市,新生里,0,1,640,18,658,855,3,1,3,0,1,0,76.96
臺北縣,永和市,永成里,0,1,750,18,768,1034,3,1,3,0,1,0,74.27
臺北縣,永和市,忠義里,0,1,586,9,595,789,3,1,3,0,1,0,75.41
臺北縣,永和市,文化里,0,1,1783,28,1811,2545,3,1,3,0,1,0,71.16
臺北縣,永和市,仁愛里,0,1,1377,18,1395,2121,3,1,3,0,1,0,65.77
臺北縣,永和市,信義里,0,1,1299,15,1314,1921,3,1,3,0,1,0,68.40
臺北縣,永和市,後溪里,0,1,1001,13,1014,1531,3,1,3,0,1,0,66.23
臺北縣,永和市,上溪里,0,1,1259,30,1289,1895,3,1,3,0,1,0,68.02
臺北縣,永和市,頂溪里,0,1,1494,15,1509,2151,3,1,3,0,1,0,70.15
臺北縣,永和市,河堤里,0,1,1271,11,1282,1797,3,1,3,0,1,0,71.34
臺北縣,永和市,新廍里,0,1,1598,20,1618,2291,3,1,3,0,1,0,70.62
臺北縣,新莊市,海山里,0,1,2712,30,2742,4092,3,1,3,0,1,0,67.01
臺北縣,新莊市,全安里,0,1,2013,24,2037,2963,3,1,3,0,1,0,68.75
臺北縣,新莊市,忠孝里,0,1,2336,23,2359,3492,3,1,3,0,1,0,67.55
臺北縣,新莊市,文衡里,0,1,1019,10,1029,1437,3,1,3,0,1,0,71.61
臺北縣,新莊市,文聖里,0,1,2082,19,2101,3094,3,1,3,0,1,0,67.91
臺北縣,新莊市,興漢里,0,1,1945,23,1968,2841,3,1,3,0,1,0,69.27
臺北縣,新莊市,榮和里,0,1,1830,23,1853,2668,3,1,3,0,1,0,69.45
臺北縣,新莊市,文明里,0,1,1007,12,1019,1448,3,1,3,0,1,0,70.37
臺北縣,新莊市,文德里,0,1,739,5,744,1083,3,1,3,0,1,0,68.70
臺北縣,新莊市,全泰里,0,1,2273,19,2292,3404,3,1,3,0,1,0,67.33
臺北縣,新莊市,思賢里,0,1,1676,22,1698,2529,3,1,3,0,1,0,67.14
臺北縣,新莊市,思源里,0,1,2213,33,2246,3480,3,1,3,0,1,0,64.54
臺北縣,新莊市,自立里,0,1,2324,36,2360,3557,3,1,3,0,1,0,66.35
臺北縣,新莊市,自強里,0,1,1584,27,1611,2395,3,1,3,0,1,0,67.27
臺北縣,新莊市,仁愛里,0,1,1405,17,1422,2253,3,1,3,0,1,0,63.12
臺北縣,新莊市,仁義里,0,1,1470,32,1502,2393,3,1,3,0,1,0,62.77
臺北縣,新莊市,信義里,0,1,1937,32,1969,3234,3,1,3,0,1,0,60.88
臺北縣,新莊市,幸福里,0,1,2069,34,2103,3409,3,1,3,0,1,0,61.69
臺北縣,新莊市,昌明里,0,1,1965,36,2001,3028,3,1,3,0,1,0,66.08
臺北縣,新莊市,昌平里,0,1,1137,18,1155,1878,3,1,3,0,1,0,61.50
臺北縣,新莊市,和平里,0,1,1795,30,1825,2920,3,1,3,0,1,0,62.50
臺北縣,新莊市,自信里,0,1,939,15,954,1478,3,1,3,0,1,0,64.55
臺北縣,新莊市,化成里,0,1,1328,20,1348,1998,3,1,3,0,1,0,67.47
臺北縣,新莊市,頭前里,0,1,1949,35,1984,2943,3,1,3,0,1,0,67.41
臺北縣,新莊市,福基里,0,1,2276,47,2323,3380,3,1,3,0,1,0,68.73
臺北縣,新莊市,恆安里,0,1,2200,23,2223,3343,3,1,3,0,1,0,66.50
臺北縣,新莊市,立人里,0,1,1097,15,1112,1574,3,1,3,0,1,0,70.65
臺北縣,新莊市,中美里,0,1,2578,30,2608,3962,3,1,3,0,1,0,65.83
臺北縣,新莊市,中華里,0,1,731,12,743,1139,3,1,3,0,1,0,65.23
臺北縣,新莊市,中隆里,0,1,959,15,974,1531,3,1,3,0,1,0,63.62
臺北縣,新莊市,中原里,0,1,2237,45,2282,3478,3,1,3,0,1,0,65.61
臺北縣,新莊市,中信里,0,1,2535,26,2561,3993,3,1,3,0,1,0,64.14
臺北縣,新莊市,中港里,0,1,2150,39,2189,3596,3,1,3,0,1,0,60.87
臺北縣,新莊市,中誠里,0,1,1009,21,1030,1626,3,1,3,0,1,0,63.35
臺北縣,新莊市,中泰里,0,1,2457,35,2492,3840,3,1,3,0,1,0,64.90
臺北縣,新莊市,中宏里,0,1,1095,15,1110,1748,3,1,3,0,1,0,63.50
臺北縣,新莊市,中全里,0,1,1519,18,1537,2452,3,1,3,0,1,0,62.68
臺北縣,新莊市,中和里,0,1,2298,42,2340,3506,3,1,3,0,1,0,66.74
臺北縣,新莊市,立志里,0,1,1849,13,1862,2859,3,1,3,0,1,0,65.13
臺北縣,新莊市,立基里,0,1,2447,22,2469,3830,3,1,3,0,1,0,64.46
臺北縣,新莊市,立功里,0,1,1883,27,1910,3017,3,1,3,0,1,0,63.31
臺北縣,新莊市,立泰里,0,1,1771,26,1797,2666,3,1,3,0,1,0,67.40
臺北縣,新莊市,立德里,0,1,1250,12,1262,1911,3,1,3,0,1,0,66.04
臺北縣,新莊市,立言里,0,1,2190,27,2217,3357,3,1,3,0,1,0,66.04
臺北縣,新莊市,豐年里,0,1,2563,49,2612,4037,3,1,3,0,1,0,64.70
臺北縣,新莊市,國泰里,0,1,1002,18,1020,1436,3,1,3,0,1,0,71.03
臺北縣,新莊市,營盤里,0,1,1233,17,1250,2146,3,1,3,0,1,0,58.25
臺北縣,新莊市,福營里,0,1,1322,17,1339,1897,3,1,3,0,1,0,70.59
臺北縣,新莊市,富國里,0,1,2209,30,2239,3607,3,1,3,0,1,0,62.07
臺北縣,新莊市,瓊林里,0,1,2846,43,2889,4299,3,1,3,0,1,0,67.20
臺北縣,新莊市,丹鳳里,0,1,1844,35,1879,3012,3,1,3,0,1,0,62.38
臺北縣,新莊市,合鳳里,0,1,2775,42,2817,4358,3,1,3,0,1,0,64.64
臺北縣,新莊市,雙鳳里,0,1,1789,19,1808,2792,3,1,3,0,1,0,64.76
臺北縣,新莊市,龍鳳里,0,1,2304,27,2331,3740,3,1,3,0,1,0,62.33
臺北縣,新莊市,裕民里,0,1,2355,45,2400,3840,3,1,3,0,1,0,62.50
臺北縣,新莊市,龍安里,0,1,1018,7,1025,1566,3,1,3,0,1,0,65.45
臺北縣,新莊市,南港里,0,1,1706,15,1721,2730,3,1,3,0,1,0,63.04
臺北縣,新莊市,四維里,0,1,1863,29,1892,3158,3,1,3,0,1,0,59.91
臺北縣,新莊市,後港里,0,1,1947,21,1968,3279,3,1,3,0,1,0,60.02
臺北縣,新莊市,後德里,0,1,1117,9,1126,1769,3,1,3,0,1,0,63.65
臺北縣,新莊市,萬安里,0,1,1390,23,1413,2284,3,1,3,0,1,0,61.87
臺北縣,新莊市,建福里,0,1,1115,11,1126,1699,3,1,3,0,1,0,66.27
臺北縣,新莊市,八德里,0,1,1314,11,1325,2124,3,1,3,0,1,0,62.38
臺北縣,新莊市,建安里,0,1,1401,19,1420,2316,3,1,3,0,1,0,61.31
臺北縣,新莊市,民本里,0,1,2235,29,2264,3741,3,1,3,0,1,0,60.52
臺北縣,新莊市,民安里,0,1,2578,38,2616,4115,3,1,3,0,1,0,63.57
臺北縣,新莊市,成德里,0,1,1422,23,1445,2310,3,1,3,0,1,0,62.55
臺北縣,新莊市,光明里,0,1,1207,17,1224,1957,3,1,3,0,1,0,62.54
臺北縣,新莊市,光華里,0,1,1687,22,1709,2861,3,1,3,0,1,0,59.73
臺北縣,新莊市,光榮里,0,1,3064,41,3105,4814,3,1,3,0,1,0,64.50
臺北縣,新莊市,西盛里,0,1,2100,23,2123,3425,3,1,3,0,1,0,61.99
臺北縣,新店市,新店里,0,1,935,19,954,1339,3,1,3,0,1,0,71.25
臺北縣,新店市,張南里,0,1,758,14,772,1095,3,1,3,0,1,0,70.50
臺北縣,新店市,國校里,0,1,1257,17,1274,1990,3,1,3,0,1,0,64.02
臺北縣,新店市,文中里,0,1,812,8,820,1259,3,1,3,0,1,0,65.13
臺北縣,新店市,廣明里,0,1,587,11,598,882,3,1,3,0,1,0,67.80
臺北縣,新店市,文明里,0,1,1558,14,1572,2158,3,1,3,0,1,0,72.85
臺北縣,新店市,中興里,0,1,2645,23,2668,3931,3,1,3,0,1,0,67.87
臺北縣,新店市,新生里,0,1,2783,38,2821,3943,3,1,3,0,1,0,71.54
臺北縣,新店市,新德里,0,1,1723,24,1747,2489,3,1,3,0,1,0,70.19
臺北縣,新店市,張北里,0,1,3561,48,3609,5341,3,1,3,0,1,0,67.57
臺北縣,新店市,五峰里,0,1,3874,28,3902,5844,3,1,3,0,1,0,66.77
臺北縣,新店市,新安里,0,1,2019,27,2046,3085,3,1,3,0,1,0,66.32
臺北縣,新店市,忠誠里,0,1,1425,7,1432,2113,3,1,3,0,1,0,67.77
臺北縣,新店市,中正里,0,1,3713,34,3747,5451,3,1,3,0,1,0,68.74
臺北縣,新店市,中華里,0,1,2354,30,2384,3538,3,1,3,0,1,0,67.38
臺北縣,新店市,仁愛里,0,1,3358,44,3402,5096,3,1,3,0,1,0,66.76
臺北縣,新店市,百忍里,0,1,2423,18,2441,3559,3,1,3,0,1,0,68.59
臺北縣,新店市,百和里,0,1,1550,20,1570,2388,3,1,3,0,1,0,65.75
臺北縣,新店市,福德里,0,1,2203,23,2226,3241,3,1,3,0,1,0,68.68
臺北縣,新店市,百福里,0,1,1728,19,1747,2506,3,1,3,0,1,0,69.71
臺北縣,新店市,福民里,0,1,1882,22,1904,2816,3,1,3,0,1,0,67.61
臺北縣,新店市,中山里,0,1,865,15,880,1359,3,1,3,0,1,0,64.75
臺北縣,新店市,和平里,0,1,635,13,648,863,3,1,3,0,1,0,75.09
臺北縣,新店市,中央里,0,1,1640,14,1654,2498,3,1,3,0,1,0,66.21
臺北縣,新店市,國豐里,0,1,2195,24,2219,3314,3,1,3,0,1,0,66.96
臺北縣,新店市,明德里,0,1,2261,21,2282,3391,3,1,3,0,1,0,67.30
臺北縣,新店市,大豐里,0,1,2029,18,2047,2901,3,1,3,0,1,0,70.56
臺北縣,新店市,大同里,0,1,2225,18,2243,3190,3,1,3,0,1,0,70.31
臺北縣,新店市,江陵里,0,1,3793,64,3857,5798,3,1,3,0,1,0,66.52
臺北縣,新店市,寶興里,0,1,2110,32,2142,3137,3,1,3,0,1,0,68.28
臺北縣,新店市,寶福里,0,1,2525,31,2556,3748,3,1,3,0,1,0,68.20
臺北縣,新店市,寶安里,0,1,2874,29,2903,4284,3,1,3,0,1,0,67.76
臺北縣,新店市,信義里,0,1,2832,37,2869,4273,3,1,3,0,1,0,67.14
臺北縣,新店市,忠孝里,0,1,1371,18,1389,1994,3,1,3,0,1,0,69.66
臺北縣,新店市,大鵬里,0,1,319,6,325,524,3,1,3,0,1,0,62.02
臺北縣,新店市,太平里,0,1,2754,35,2789,4028,3,1,3,0,1,0,69.24
臺北縣,新店市,頂城里,0,1,888,23,911,1484,3,1,3,0,1,0,61.39
臺北縣,新店市,下城里,0,1,1114,21,1135,1704,3,1,3,0,1,0,66.61
臺北縣,新店市,柴埕里,0,1,2153,43,2196,3253,3,1,3,0,1,0,67.51
臺北縣,新店市,安和里,0,1,2238,33,2271,3413,3,1,3,0,1,0,66.54
臺北縣,新店市,永安里,0,1,4898,78,4976,7539,3,1,3,0,1,0,66.00
臺北縣,新店市,公崙里,0,1,3701,49,3750,5760,3,1,3,0,1,0,65.10
臺北縣,新店市,德安里,0,1,2357,40,2397,3556,3,1,3,0,1,0,67.41
臺北縣,新店市,明城里,0,1,3193,25,3218,4677,3,1,3,0,1,0,68.80
臺北縣,新店市,雙城里,0,1,3567,47,3614,5485,3,1,3,0,1,0,65.89
臺北縣,新店市,日興里,0,1,2412,37,2449,3667,3,1,3,0,1,0,66.78
臺北縣,新店市,玫瑰里,0,1,2468,23,2491,3686,3,1,3,0,1,0,67.58
臺北縣,新店市,吉祥里,0,1,2066,14,2080,3089,3,1,3,0,1,0,67.34
臺北縣,新店市,塗潭里,0,1,655,9,664,1058,3,1,3,0,1,0,62.76
臺北縣,新店市,青潭里,0,1,1800,26,1826,2710,3,1,3,0,1,0,67.38
臺北縣,新店市,美潭里,0,1,2064,35,2099,2967,3,1,3,0,1,0,70.74
臺北縣,新店市,員潭里,0,1,1251,24,1275,1961,3,1,3,0,1,0,65.02
臺北縣,新店市,雙坑里,0,1,485,5,490,790,3,1,3,0,1,0,62.03
臺北縣,新店市,粗坑里,0,1,1254,12,1266,1934,3,1,3,0,1,0,65.46
臺北縣,新店市,屈尺里,0,1,1444,35,1479,2079,3,1,3,0,1,0,71.14
臺北縣,新店市,龜山里,0,1,913,23,936,1365,3,1,3,0,1,0,68.57
臺北縣,新店市,廣興里,0,1,717,10,727,1043,3,1,3,0,1,0,69.70
臺北縣,新店市,直潭里,0,1,382,10,392,598,3,1,3,0,1,0,65.55
臺北縣,土城市,祖田里,0,1,702,12,714,1081,3,1,3,0,1,0,66.05
臺北縣,土城市,頂新里,0,1,880,13,893,1178,3,1,3,0,1,0,75.81
臺北縣,土城市,頂福里,0,1,1882,41,1923,2790,3,1,3,0,1,0,68.92
臺北縣,土城市,頂埔里,0,1,1415,30,1445,2221,3,1,3,0,1,0,65.06
臺北縣,土城市,沛陂里,0,1,1239,38,1277,1942,3,1,3,0,1,0,65.76
臺北縣,土城市,永寧里,0,1,2446,43,2489,3796,3,1,3,0,1,0,65.57
臺北縣,土城市,大安里,0,1,1649,26,1675,2473,3,1,3,0,1,0,67.73
臺北縣,土城市,員仁里,0,1,2006,32,2038,3250,3,1,3,0,1,0,62.71
臺北縣,土城市,埤塘里,0,1,1188,19,1207,1764,3,1,3,0,1,0,68.42
臺北縣,土城市,土城里,0,1,877,8,885,1311,3,1,3,0,1,0,67.51
臺北縣,土城市,長風里,0,1,602,6,608,805,3,1,3,0,1,0,75.53
臺北縣,土城市,員信里,0,1,1510,25,1535,2347,3,1,3,0,1,0,65.40
臺北縣,土城市,員林里,0,1,2164,28,2192,3372,3,1,3,0,1,0,65.01
臺北縣,土城市,員福里,0,1,2369,37,2406,3545,3,1,3,0,1,0,67.87
臺北縣,土城市,日和里,0,1,2299,48,2347,3377,3,1,3,0,1,0,69.50
臺北縣,土城市,日新里,0,1,2102,46,2148,3173,3,1,3,0,1,0,67.70
臺北縣,土城市,裕生里,0,1,2098,37,2135,3160,3,1,3,0,1,0,67.56
臺北縣,土城市,貨饒里,0,1,1741,30,1771,2751,3,1,3,0,1,0,64.38
臺北縣,土城市,瑞興里,0,1,1449,22,1471,2091,3,1,3,0,1,0,70.35
臺北縣,土城市,復興里,0,1,1752,22,1774,2724,3,1,3,0,1,0,65.12
臺北縣,土城市,廣福里,0,1,1897,30,1927,2856,3,1,3,0,1,0,67.47
臺北縣,土城市,學成里,0,1,1285,15,1300,1992,3,1,3,0,1,0,65.26
臺北縣,土城市,埤林里,0,1,3040,43,3083,4823,3,1,3,0,1,0,63.92
臺北縣,土城市,樂利里,0,1,2041,24,2065,3108,3,1,3,0,1,0,66.44
臺北縣,土城市,學府里,0,1,1312,29,1341,2080,3,1,3,0,1,0,64.47
臺北縣,土城市,柑林里,0,1,3136,47,3183,5211,3,1,3,0,1,0,61.08
臺北縣,土城市,青雲里,0,1,1100,16,1116,1557,3,1,3,0,1,0,71.68
臺北縣,土城市,清和里,0,1,2386,49,2435,3699,3,1,3,0,1,0,65.83
臺北縣,土城市,清化里,0,1,658,8,666,984,3,1,3,0,1,0,67.68
臺北縣,土城市,清溪里,0,1,2557,38,2595,3885,3,1,3,0,1,0,66.80
臺北縣,土城市,清水里,0,1,3591,49,3640,5591,3,1,3,0,1,0,65.10
臺北縣,土城市,永豐里,0,1,1365,19,1384,1950,3,1,3,0,1,0,70.97
臺北縣,土城市,永富里,0,1,1894,35,1929,2985,3,1,3,0,1,0,64.62
臺北縣,土城市,延和里,0,1,2015,30,2045,3087,3,1,3,0,1,0,66.25
臺北縣,土城市,廷寮里,0,1,1862,26,1888,2979,3,1,3,0,1,0,63.38
臺北縣,土城市,峰廷里,0,1,2536,39,2575,4048,3,1,3,0,1,0,63.61
臺北縣,土城市,延吉里,0,1,1661,36,1697,2566,3,1,3,0,1,0,66.13
臺北縣,土城市,延壽里,0,1,2681,36,2717,4196,3,1,3,0,1,0,64.75
臺北縣,土城市,平和里,0,1,2570,42,2612,3946,3,1,3,0,1,0,66.19
臺北縣,土城市,安和里,0,1,1555,33,1588,2378,3,1,3,0,1,0,66.78
臺北縣,樹林鎮,保安里,0,1,2580,32,2612,3804,3,1,3,0,1,0,68.66
臺北縣,樹林鎮,圳福里,0,1,1623,26,1649,2485,3,1,3,0,1,0,66.36
臺北縣,樹林鎮,圳安里,0,1,1815,30,1845,3090,3,1,3,0,1,0,59.71
臺北縣,樹林鎮,三多里,0,1,2245,36,2281,3551,3,1,3,0,1,0,64.24
臺北縣,樹林鎮,三福里,0,1,1832,32,1864,2789,3,1,3,0,1,0,66.83
臺北縣,樹林鎮,三興里,0,1,1981,37,2018,3373,3,1,3,0,1,0,59.83
臺北縣,樹林鎮,羌寮里,0,1,1363,21,1384,2164,3,1,3,0,1,0,63.96
臺北縣,樹林鎮,光興里,0,1,1127,16,1143,1822,3,1,3,0,1,0,62.73
臺北縣,樹林鎮,金寮里,0,1,1199,27,1226,1810,3,1,3,0,1,0,67.73
臺北縣,樹林鎮,潭底里,0,1,1921,30,1951,2898,3,1,3,0,1,0,67.32
臺北縣,樹林鎮,文林里,0,1,1240,19,1259,1938,3,1,3,0,1,0,64.96
臺北縣,樹林鎮,樹東里,0,1,639,7,646,878,3,1,3,0,1,0,73.58
臺北縣,樹林鎮,樹北里,0,1,752,16,768,1064,3,1,3,0,1,0,72.18
臺北縣,樹林鎮,樹福里,0,1,1220,18,1238,1756,3,1,3,0,1,0,70.50
臺北縣,樹林鎮,樹德里,0,1,1744,27,1771,2513,3,1,3,0,1,0,70.47
臺北縣,樹林鎮,樹西里,0,1,2407,32,2439,3388,3,1,3,0,1,0,71.99
臺北縣,樹林鎮,育英里,0,1,1358,17,1375,1950,3,1,3,0,1,0,70.51
臺北縣,樹林鎮,樹南里,0,1,1743,18,1761,2490,3,1,3,0,1,0,70.72
臺北縣,樹林鎮,樹人里,0,1,1445,31,1476,2161,3,1,3,0,1,0,68.30
臺北縣,樹林鎮,樹興里,0,1,1683,17,1700,2497,3,1,3,0,1,0,68.08
臺北縣,樹林鎮,坡內里,0,1,745,9,754,1048,3,1,3,0,1,0,71.95
臺北縣,樹林鎮,大同里,0,1,2298,33,2331,3703,3,1,3,0,1,0,62.95
臺北縣,樹林鎮,和平里,0,1,1852,30,1882,2700,3,1,3,0,1,0,69.70
臺北縣,樹林鎮,彭興里,0,1,1806,41,1847,3051,3,1,3,0,1,0,60.54
臺北縣,樹林鎮,彭厝里,0,1,1363,26,1389,2234,3,1,3,0,1,0,62.18
臺北縣,樹林鎮,彭福里,0,1,1594,33,1627,2405,3,1,3,0,1,0,67.65
臺北縣,樹林鎮,東昇里,0,1,1503,21,1524,2289,3,1,3,0,1,0,66.58
臺北縣,樹林鎮,東陽里,0,1,1691,23,1714,2627,3,1,3,0,1,0,65.25
臺北縣,樹林鎮,東山里,0,1,1200,17,1217,1834,3,1,3,0,1,0,66.36
臺北縣,樹林鎮,山佳里,0,1,1124,21,1145,1797,3,1,3,0,1,0,63.72
臺北縣,樹林鎮,中山里,0,1,1591,25,1616,2381,3,1,3,0,1,0,67.87
臺北縣,樹林鎮,樂山里,0,1,717,13,730,1029,3,1,3,0,1,0,70.94
臺北縣,樹林鎮,東園里,0,1,735,13,748,1045,3,1,3,0,1,0,71.58
臺北縣,樹林鎮,北園里,0,1,738,9,747,1073,3,1,3,0,1,0,69.62
臺北縣,樹林鎮,柑園里,0,1,743,18,761,1083,3,1,3,0,1,0,70.27
臺北縣,樹林鎮,南園里,0,1,539,4,543,740,3,1,3,0,1,0,73.38
臺北縣,樹林鎮,西園里,0,1,715,16,731,1047,3,1,3,0,1,0,69.82
臺北縣,鶯歌鎮,建德里,0,1,328,5,333,438,3,1,3,0,1,0,76.03
臺北縣,鶯歌鎮,東鶯里,0,1,555,5,560,762,3,1,3,0,1,0,73.49
臺北縣,鶯歌鎮,北鶯里,0,1,950,10,960,1254,3,1,3,0,1,0,76.56
臺北縣,鶯歌鎮,西鶯里,0,1,1191,21,1212,1594,3,1,3,0,1,0,76.04
臺北縣,鶯歌鎮,中鶯里,0,1,587,12,599,772,3,1,3,0,1,0,77.59
臺北縣,鶯歌鎮,南鶯里,0,1,2312,38,2350,3206,3,1,3,0,1,0,73.30
臺北縣,鶯歌鎮,建國里,0,1,1761,35,1796,2697,3,1,3,0,1,0,66.59
臺北縣,鶯歌鎮,南靖里,0,1,1655,36,1691,2239,3,1,3,0,1,0,75.52
臺北縣,鶯歌鎮,尖山里,0,1,1808,18,1826,2436,3,1,3,0,1,0,74.96
臺北縣,鶯歌鎮,二橋里,0,1,2469,46,2515,3349,3,1,3,0,1,0,75.10
臺北縣,鶯歌鎮,二甲里,0,1,542,12,554,688,3,1,3,0,1,0,80.52
臺北縣,鶯歌鎮,同慶里,0,1,743,8,751,1021,3,1,3,0,1,0,73.56
臺北縣,鶯歌鎮,永昌里,0,1,2738,40,2778,4184,3,1,3,0,1,0,66.40
臺北縣,鶯歌鎮,永吉里,0,1,2025,47,2072,2894,3,1,3,0,1,0,71.60
臺北縣,鶯歌鎮,鳳鳴里,0,1,1745,35,1780,2596,3,1,3,0,1,0,68.57
臺北縣,鶯歌鎮,鳳祥里,0,1,1789,39,1828,2896,3,1,3,0,1,0,63.12
臺北縣,鶯歌鎮,鳳福里,0,1,1808,36,1844,2772,3,1,3,0,1,0,66.52
臺北縣,鶯歌鎮,大湖里,0,1,2310,37,2347,3556,3,1,3,0,1,0,66.00
臺北縣,鶯歌鎮,中湖里,0,1,2354,48,2402,3608,3,1,3,0,1,0,66.57
臺北縣,鶯歌鎮,東湖里,0,1,177,4,181,254,3,1,3,0,1,0,71.26
臺北縣,三峽鎮,三峽里,0,1,295,5,300,403,3,1,3,0,1,0,74.44
臺北縣,三峽鎮,秀川里,0,1,347,4,351,465,3,1,3,0,1,0,75.48
臺北縣,三峽鎮,八張里,0,1,1256,25,1281,1838,3,1,3,0,1,0,69.70
臺北縣,三峽鎮,中埔里,0,1,516,10,526,700,3,1,3,0,1,0,75.14
臺北縣,三峽鎮,弘道里,0,1,637,13,650,842,3,1,3,0,1,0,77.20
臺北縣,三峽鎮,永舘里,0,1,2354,32,2386,3384,3,1,3,0,1,0,70.51
臺北縣,三峽鎮,中正里,0,1,1447,27,1474,2301,3,1,3,0,1,0,64.06
臺北縣,三峽鎮,礁溪里,0,1,1077,13,1090,1529,3,1,3,0,1,0,71.29
臺北縣,三峽鎮,介壽里,0,1,1394,19,1413,2144,3,1,3,0,1,0,65.90
臺北縣,三峽鎮,安溪里,0,1,1707,35,1742,2595,3,1,3,0,1,0,67.13
臺北縣,三峽鎮,龍埔里,0,1,2827,45,2872,4288,3,1,3,0,1,0,66.98
臺北縣,三峽鎮,鳶山里,0,1,2795,62,2857,4350,3,1,3,0,1,0,65.68
臺北縣,三峽鎮,大埔里,0,1,3010,58,3068,4575,3,1,3,0,1,0,67.06
臺北縣,三峽鎮,嘉添里,0,1,1952,31,1983,2728,3,1,3,0,1,0,72.69
臺北縣,三峽鎮,添福里,0,1,593,13,606,819,3,1,3,0,1,0,73.99
臺北縣,三峽鎮,五寮里,0,1,696,14,710,954,3,1,3,0,1,0,74.42
臺北縣,三峽鎮,金圳里,0,1,331,6,337,464,3,1,3,0,1,0,72.63
臺北縣,三峽鎮,插角里,0,1,577,12,589,872,3,1,3,0,1,0,67.55
臺北縣,三峽鎮,有木里,0,1,544,9,553,837,3,1,3,0,1,0,66.07
臺北縣,三峽鎮,溪南里,0,1,824,13,837,1108,3,1,3,0,1,0,75.54
臺北縣,三峽鎮,溪北里,0,1,1210,17,1227,1714,3,1,3,0,1,0,71.59
臺北縣,三峽鎮,溪東里,0,1,1568,32,1600,2195,3,1,3,0,1,0,72.89
臺北縣,三峽鎮,成福里,0,1,627,5,632,838,3,1,3,0,1,0,75.42
臺北縣,三峽鎮,安坑里,0,1,846,19,865,1296,3,1,3,0,1,0,66.74
臺北縣,三峽鎮,竹崙里,0,1,1016,21,1037,1577,3,1,3,0,1,0,65.76
臺北縣,淡水鎮,中和里,0,1,472,6,478,591,3,1,3,0,1,0,80.88
臺北縣,淡水鎮,屯山里,0,1,747,7,754,926,3,1,3,0,1,0,81.43
臺北縣,淡水鎮,賢孝里,0,1,915,21,936,1211,3,1,3,0,1,0,77.29
臺北縣,淡水鎮,興仁里,0,1,967,16,983,1328,3,1,3,0,1,0,74.02
臺北縣,淡水鎮,蕃薯里,0,1,389,3,392,559,3,1,3,0,1,0,70.13
臺北縣,淡水鎮,義山里,0,1,1540,29,1569,2231,3,1,3,0,1,0,70.33
臺北縣,淡水鎮,忠山里,0,1,552,15,567,698,3,1,3,0,1,0,81.23
臺北縣,淡水鎮,崁頂里,0,1,894,13,907,1236,3,1,3,0,1,0,73.38
臺北縣,淡水鎮,埤島里,0,1,832,9,841,1105,3,1,3,0,1,0,76.11
臺北縣,淡水鎮,新興里,0,1,4512,72,4584,6771,3,1,3,0,1,0,67.70
臺北縣,淡水鎮,水碓里,0,1,3318,56,3374,4790,3,1,3,0,1,0,70.44
臺北縣,淡水鎮,北投里,0,1,910,13,923,1275,3,1,3,0,1,0,72.39
臺北縣,淡水鎮,水源里,0,1,953,13,966,1447,3,1,3,0,1,0,66.76
臺北縣,淡水鎮,忠寮里,0,1,652,14,666,880,3,1,3,0,1,0,75.68
臺北縣,淡水鎮,樹興里,0,1,443,11,454,665,3,1,3,0,1,0,68.27
臺北縣,淡水鎮,坪頂里,0,1,537,9,546,765,3,1,3,0,1,0,71.37
臺北縣,淡水鎮,福德里,0,1,2223,23,2246,3354,3,1,3,0,1,0,66.96
臺北縣,淡水鎮,竹圍里,0,1,2354,37,2391,3621,3,1,3,0,1,0,66.03
臺北縣,淡水鎮,民生里,0,1,1984,42,2026,2892,3,1,3,0,1,0,70.06
臺北縣,淡水鎮,八勢里,0,1,598,10,608,864,3,1,3,0,1,0,70.37
臺北縣,淡水鎮,竿蓁里,0,1,1061,16,1077,1780,3,1,3,0,1,0,60.51
臺北縣,淡水鎮,鄧公里,0,1,4719,87,4806,7084,3,1,3,0,1,0,67.84
臺北縣,淡水鎮,中興里,0,1,2417,49,2466,3664,3,1,3,0,1,0,67.30
臺北縣,淡水鎮,長庚里,0,1,1187,18,1205,1672,3,1,3,0,1,0,72.07
臺北縣,淡水鎮,清文里,0,1,689,12,701,991,3,1,3,0,1,0,70.74
臺北縣,淡水鎮,草東里,0,1,610,10,620,844,3,1,3,0,1,0,73.46
臺北縣,淡水鎮,協元里,0,1,888,21,909,1361,3,1,3,0,1,0,66.79
臺北縣,淡水鎮,永吉里,0,1,538,7,545,741,3,1,3,0,1,0,73.55
臺北縣,淡水鎮,民安里,0,1,558,7,565,775,3,1,3,0,1,0,72.90
臺北縣,淡水鎮,新生里,0,1,427,6,433,600,3,1,3,0,1,0,72.17
臺北縣,淡水鎮,文化里,0,1,753,11,764,1082,3,1,3,0,1,0,70.61
臺北縣,淡水鎮,油車里,0,1,1862,29,1891,2636,3,1,3,0,1,0,71.74
臺北縣,淡水鎮,沙崙里,0,1,2092,45,2137,2989,3,1,3,0,1,0,71.50
臺北縣,汐止鎮,仁德里,0,1,982,15,997,1253,3,1,3,0,1,0,79.57
臺北縣,汐止鎮,義民里,0,1,883,4,887,1238,3,1,3,0,1,0,71.65
臺北縣,汐止鎮,禮門里,0,1,741,7,748,987,3,1,3,0,1,0,75.79
臺北縣,汐止鎮,智慧里,0,1,1721,14,1735,2496,3,1,3,0,1,0,69.51
臺北縣,汐止鎮,信望里,0,1,441,4,445,596,3,1,3,0,1,0,74.66
臺北縣,汐止鎮,新昌里,0,1,3396,36,3432,4371,3,1,3,0,1,0,78.52
臺北縣,汐止鎮,秀峰里,0,1,3218,34,3252,4248,3,1,3,0,1,0,76.55
臺北縣,汐止鎮,復興里,0,1,1534,13,1547,1996,3,1,3,0,1,0,77.51
臺北縣,汐止鎮,自強里,0,1,1783,15,1798,2332,3,1,3,0,1,0,77.10
臺北縣,汐止鎮,文化里,0,1,1563,24,1587,2161,3,1,3,0,1,0,73.44
臺北縣,汐止鎮,白雲里,0,1,1126,17,1143,1598,3,1,3,0,1,0,71.53
臺北縣,汐止鎮,茄苳里,0,1,3288,37,3325,4473,3,1,3,0,1,0,74.33
臺北縣,汐止鎮,橋東里,0,1,1812,14,1826,2368,3,1,3,0,1,0,77.11
臺北縣,汐止鎮,長安里,0,1,960,12,972,1314,3,1,3,0,1,0,73.97
臺北縣,汐止鎮,保安里,0,1,859,6,865,1159,3,1,3,0,1,0,74.63
臺北縣,汐止鎮,東山里,0,1,311,3,314,407,3,1,3,0,1,0,77.15
臺北縣,汐止鎮,保長里,0,1,1699,25,1724,2226,3,1,3,0,1,0,77.45
臺北縣,汐止鎮,鄉長里,0,1,1027,14,1041,1369,3,1,3,0,1,0,76.04
臺北縣,汐止鎮,江北里,0,1,2408,21,2429,3254,3,1,3,0,1,0,74.65
臺北縣,汐止鎮,拱北里,0,1,1579,16,1595,2375,3,1,3,0,1,0,67.16
臺北縣,汐止鎮,烘內里,0,1,744,9,753,1105,3,1,3,0,1,0,68.14
臺北縣,汐止鎮,八連里,0,1,1064,9,1073,1547,3,1,3,0,1,0,69.36
臺北縣,汐止鎮,北峰里,0,1,2948,34,2982,4308,3,1,3,0,1,0,69.22
臺北縣,汐止鎮,樟樹里,0,1,1014,13,1027,1494,3,1,3,0,1,0,68.74
臺北縣,汐止鎮,忠孝里,0,1,1921,29,1950,2736,3,1,3,0,1,0,71.27
臺北縣,汐止鎮,厚德里,0,1,1117,17,1134,1639,3,1,3,0,1,0,69.19
臺北縣,汐止鎮,中興里,0,1,3675,54,3729,5379,3,1,3,0,1,0,69.33
臺北縣,汐止鎮,湖光里,0,1,2205,19,2224,3341,3,1,3,0,1,0,66.57
臺北縣,汐止鎮,北山里,0,1,3698,41,3739,5563,3,1,3,0,1,0,67.21
臺北縣,汐止鎮,橫科里,0,1,2591,42,2633,3811,3,1,3,0,1,0,69.09
臺北縣,汐止鎮,福山里,0,1,1385,14,1399,2030,3,1,3,0,1,0,68.92
臺北縣,汐止鎮,宜興里,0,1,2087,15,2102,2994,3,1,3,0,1,0,70.21
臺北縣,瑞芳鎮,龍潭里,0,1,631,5,636,847,3,1,3,0,1,0,75.09
臺北縣,瑞芳鎮,龍興里,0,1,1167,9,1176,1643,3,1,3,0,1,0,71.58
臺北縣,瑞芳鎮,龍鎮里,0,1,1025,11,1036,1494,3,1,3,0,1,0,69.34
臺北縣,瑞芳鎮,龍安里,0,1,451,8,459,646,3,1,3,0,1,0,71.05
臺北縣,瑞芳鎮,龍川里,0,1,1093,21,1114,1606,3,1,3,0,1,0,69.36
臺北縣,瑞芳鎮,龍山里,0,1,906,15,921,1304,3,1,3,0,1,0,70.63
臺北縣,瑞芳鎮,爪峰里,0,1,3982,44,4026,5803,3,1,3,0,1,0,69.38
臺北縣,瑞芳鎮,東和里,0,1,1539,16,1555,2199,3,1,3,0,1,0,70.71
臺北縣,瑞芳鎮,柑坪里,0,1,888,14,902,1255,3,1,3,0,1,0,71.87
臺北縣,瑞芳鎮,弓橋里,0,1,198,1,199,333,3,1,3,0,1,0,59.76
臺北縣,瑞芳鎮,侯硐里,0,1,378,4,382,598,3,1,3,0,1,0,63.88
臺北縣,瑞芳鎮,光復里,0,1,248,3,251,408,3,1,3,0,1,0,61.52
臺北縣,瑞芳鎮,碩仁里,0,1,78,1,79,114,3,1,3,0,1,0,69.30
臺北縣,瑞芳鎮,吉慶里,0,1,1194,21,1215,1755,3,1,3,0,1,0,69.23
臺北縣,瑞芳鎮,吉安里,0,1,1953,41,1994,3031,3,1,3,0,1,0,65.79
臺北縣,瑞芳鎮,上天里,0,1,967,18,985,1400,3,1,3,0,1,0,70.36
臺北縣,瑞芳鎮,傑魚里,0,1,1360,18,1378,1975,3,1,3,0,1,0,69.77
臺北縣,瑞芳鎮,基山里,0,1,412,3,415,631,3,1,3,0,1,0,65.77
臺北縣,瑞芳鎮,永慶里,0,1,460,6,466,709,3,1,3,0,1,0,65.73
臺北縣,瑞芳鎮,崇文里,0,1,329,7,336,543,3,1,3,0,1,0,61.88
臺北縣,瑞芳鎮,福住里,0,1,214,2,216,315,3,1,3,0,1,0,68.57
臺北縣,瑞芳鎮,頌德里,0,1,320,8,328,494,3,1,3,0,1,0,66.40
臺北縣,瑞芳鎮,瓜山里,0,1,241,6,247,364,3,1,3,0,1,0,67.86
臺北縣,瑞芳鎮,銅山里,0,1,231,8,239,327,3,1,3,0,1,0,73.09
臺北縣,瑞芳鎮,新山里,0,1,342,10,352,523,3,1,3,0,1,0,67.30
臺北縣,瑞芳鎮,石山里,0,1,344,8,352,502,3,1,3,0,1,0,70.12
臺北縣,瑞芳鎮,濂洞里,0,1,518,3,521,775,3,1,3,0,1,0,67.23
臺北縣,瑞芳鎮,濂新里,0,1,245,5,250,391,3,1,3,0,1,0,63.94
臺北縣,瑞芳鎮,南雅里,0,1,153,0,153,209,3,1,3,0,1,0,73.21
臺北縣,瑞芳鎮,鼻頭里,0,1,328,5,333,530,3,1,3,0,1,0,62.83
臺北縣,瑞芳鎮,海濱里,0,1,721,16,737,1051,3,1,3,0,1,0,70.12
臺北縣,瑞芳鎮,瑞濱里,0,1,1144,16,1160,1723,3,1,3,0,1,0,67.32
臺北縣,瑞芳鎮,深澳里,0,1,683,13,696,1045,3,1,3,0,1,0,66.60
臺北縣,蘆洲市,光華里,0,1,2113,33,2146,3080,3,1,3,0,1,0,69.68
臺北縣,蘆洲市,光明里,0,1,1630,23,1653,2557,3,1,3,0,1,0,64.65
臺北縣,蘆洲市,中華里,0,1,1459,16,1475,2021,3,1,3,0,1,0,72.98
臺北縣,蘆洲市,中路里,0,1,1611,18,1629,2246,3,1,3,0,1,0,72.53
臺北縣,蘆洲市,延平里,0,1,941,10,951,1332,3,1,3,0,1,0,71.40
臺北縣,蘆洲市,永安里,0,1,1323,25,1348,1957,3,1,3,0,1,0,68.88
臺北縣,蘆洲市,九芎里,0,1,1432,22,1454,2200,3,1,3,0,1,0,66.09
臺北縣,蘆洲市,忠義里,0,1,894,9,903,1317,3,1,3,0,1,0,68.56
臺北縣,蘆洲市,長安里,0,1,1450,21,1471,2184,3,1,3,0,1,0,67.35
臺北縣,蘆洲市,南港里,0,1,1831,25,1856,2934,3,1,3,0,1,0,63.26
臺北縣,蘆洲市,永樂里,0,1,3023,42,3065,4866,3,1,3,0,1,0,62.99
臺北縣,蘆洲市,永康里,0,1,2504,35,2539,3881,3,1,3,0,1,0,65.42
臺北縣,蘆洲市,正義里,0,1,444,3,447,615,3,1,3,0,1,0,72.68
臺北縣,蘆洲市,中原里,0,1,1605,29,1634,2453,3,1,3,0,1,0,66.61
臺北縣,蘆洲市,樓厝里,0,1,1322,21,1343,2169,3,1,3,0,1,0,61.92
臺北縣,蘆洲市,復興里,0,1,1053,15,1068,1612,3,1,3,0,1,0,66.25
臺北縣,蘆洲市,玉清里,0,1,1108,17,1125,1643,3,1,3,0,1,0,68.47
臺北縣,蘆洲市,信義里,0,1,1840,29,1869,2636,3,1,3,0,1,0,70.90
臺北縣,蘆洲市,福安里,0,1,919,17,936,1367,3,1,3,0,1,0,68.47
臺北縣,蘆洲市,鷺江里,0,1,1474,17,1491,2340,3,1,3,0,1,0,63.72
臺北縣,蘆洲市,恆德里,0,1,1976,28,2004,3082,3,1,3,0,1,0,65.02
臺北縣,蘆洲市,溪墘里,0,1,1540,19,1559,2256,3,1,3,0,1,0,69.10
臺北縣,蘆洲市,樹德里,0,1,1426,23,1449,2124,3,1,3,0,1,0,68.22
臺北縣,蘆洲市,得仁里,0,1,1149,13,1162,1779,3,1,3,0,1,0,65.32
臺北縣,蘆洲市,民和里,0,1,1375,24,1399,1959,3,1,3,0,1,0,71.41
臺北縣,蘆洲市,得勝里,0,1,1892,25,1917,2675,3,1,3,0,1,0,71.66
臺北縣,蘆洲市,仁復里,0,1,1027,16,1043,1474,3,1,3,0,1,0,70.76
臺北縣,蘆洲市,保和里,0,1,1114,14,1128,1665,3,1,3,0,1,0,67.75
臺北縣,蘆洲市,仁德里,0,1,2010,27,2037,3107,3,1,3,0,1,0,65.56
臺北縣,蘆洲市,仁義里,0,1,1020,11,1031,1668,3,1,3,0,1,0,61.81
臺北縣,蘆洲市,水河里,0,1,1984,46,2030,3087,3,1,3,0,1,0,65.76
臺北縣,蘆洲市,水湳里,0,1,2067,39,2106,3314,3,1,3,0,1,0,63.55
臺北縣,蘆洲市,保新里,0,1,1366,30,1396,2024,3,1,3,0,1,0,68.97
臺北縣,蘆洲市,忠孝里,0,1,811,17,828,1291,3,1,3,0,1,0,64.14
臺北縣,蘆洲市,仁愛里,0,1,1585,26,1611,2398,3,1,3,0,1,0,67.18
臺北縣,蘆洲市,保佑里,0,1,1640,23,1663,2496,3,1,3,0,1,0,66.63
臺北縣,五股鄉,興珍村,0,1,2199,35,2234,3282,3,1,3,0,1,0,68.07
臺北縣,五股鄉,更寮村,0,1,750,18,768,1073,3,1,3,0,1,0,71.58
臺北縣,五股鄉,集福村,0,1,1482,24,1506,2394,3,1,3,0,1,0,62.91
臺北縣,五股鄉,觀音村,0,1,767,13,780,1141,3,1,3,0,1,0,68.36
臺北縣,五股鄉,成德村,0,1,1368,27,1395,2109,3,1,3,0,1,0,66.15
臺北縣,五股鄉,成州村,0,1,2082,28,2110,3215,3,1,3,0,1,0,65.63
臺北縣,五股鄉,成功村,0,1,2091,32,2123,3586,3,1,3,0,1,0,59.20
臺北縣,五股鄉,五福村,0,1,2282,34,2316,3558,3,1,3,0,1,0,65.09
臺北縣,五股鄉,五龍村,0,1,606,9,615,873,3,1,3,0,1,0,70.45
臺北縣,五股鄉,五股村,0,1,2697,26,2723,3834,3,1,3,0,1,0,71.02
臺北縣,五股鄉,德音村,0,1,2993,40,3033,4484,3,1,3,0,1,0,67.64
臺北縣,五股鄉,德泰村,0,1,1483,25,1508,2228,3,1,3,0,1,0,67.68
臺北縣,五股鄉,陸一村,0,1,1625,25,1650,2201,3,1,3,0,1,0,74.97
臺北縣,五股鄉,貿商村,0,1,883,10,893,1174,3,1,3,0,1,0,76.06
臺北縣,泰山鄉,大科村,0,1,574,10,584,862,3,1,3,0,1,0,67.75
臺北縣,泰山鄉,黎明村,0,1,1348,23,1371,2011,3,1,3,0,1,0,68.18
臺北縣,泰山鄉,山腳村,0,1,2531,42,2573,3945,3,1,3,0,1,0,65.22
臺北縣,泰山鄉,福泰村,0,1,2582,42,2624,3781,3,1,3,0,1,0,69.40
臺北縣,泰山鄉,楓樹村,0,1,1642,20,1662,2445,3,1,3,0,1,0,67.98
臺北縣,泰山鄉,同榮村,0,1,1633,17,1650,2417,3,1,3,0,1,0,68.27
臺北縣,泰山鄉,同興村,0,1,1273,15,1288,1731,3,1,3,0,1,0,74.41
臺北縣,泰山鄉,義學村,0,1,1549,20,1569,2238,3,1,3,0,1,0,70.11
臺北縣,泰山鄉,義仁村,0,1,1780,17,1797,2664,3,1,3,0,1,0,67.45
臺北縣,泰山鄉,明志村,0,1,1576,27,1603,2391,3,1,3,0,1,0,67.04
臺北縣,泰山鄉,泰友村,0,1,1047,13,1060,1612,3,1,3,0,1,0,65.76
臺北縣,泰山鄉,新明村,0,1,1436,25,1461,2140,3,1,3,0,1,0,68.27
臺北縣,泰山鄉,貴子村,0,1,1628,21,1649,2509,3,1,3,0,1,0,65.72
臺北縣,泰山鄉,貴賢村,0,1,1656,26,1682,2335,3,1,3,0,1,0,72.03
臺北縣,泰山鄉,貴和村,0,1,1877,25,1902,2811,3,1,3,0,1,0,67.66
臺北縣,林口鄉,東林村,0,1,2046,17,2063,3071,3,1,3,0,1,0,67.18
臺北縣,林口鄉,林口村,0,1,1953,26,1979,3001,3,1,3,0,1,0,65.94
臺北縣,林口鄉,西林村,0,1,1842,33,1875,2747,3,1,3,0,1,0,68.26
臺北縣,林口鄉,菁湖村,0,1,1858,39,1897,2559,3,1,3,0,1,0,74.13
臺北縣,林口鄉,中湖村,0,1,1679,18,1697,2313,3,1,3,0,1,0,73.37
臺北縣,林口鄉,湖北村,0,1,761,14,775,1049,3,1,3,0,1,0,73.88
臺北縣,林口鄉,湖南村,0,1,953,22,975,1303,3,1,3,0,1,0,74.83
臺北縣,林口鄉,南勢村,0,1,1855,26,1881,2978,3,1,3,0,1,0,63.16
臺北縣,林口鄉,東勢村,0,1,1695,25,1720,2663,3,1,3,0,1,0,64.59
臺北縣,林口鄉,頂福村,0,1,669,7,676,895,3,1,3,0,1,0,75.53
臺北縣,林口鄉,下福村,0,1,686,9,695,904,3,1,3,0,1,0,76.88
臺北縣,林口鄉,嘉寶村,0,1,467,8,475,608,3,1,3,0,1,0,78.13
臺北縣,林口鄉,瑞平村,0,1,345,8,353,472,3,1,3,0,1,0,74.79
臺北縣,林口鄉,太平村,0,1,499,5,504,783,3,1,3,0,1,0,64.37
臺北縣,深坑鄉,深坑村,0,1,2817,34,2851,4171,3,1,3,0,1,0,68.35
臺北縣,深坑鄉,萬順村,0,1,2022,41,2063,3065,3,1,3,0,1,0,67.31
臺北縣,深坑鄉,土庫村,0,1,1755,30,1785,2647,3,1,3,0,1,0,67.43
臺北縣,深坑鄉,昇高村,0,1,766,10,776,1157,3,1,3,0,1,0,67.07
臺北縣,深坑鄉,阿柔村,0,1,311,3,314,432,3,1,3,0,1,0,72.69
臺北縣,石碇鄉,石碇村,0,1,294,2,296,395,3,1,3,0,1,0,74.94
臺北縣,石碇鄉,潭邊村,0,1,417,6,423,622,3,1,3,0,1,0,68.01
臺北縣,石碇鄉,烏塗村,0,1,399,10,409,569,3,1,3,0,1,0,71.88
臺北縣,石碇鄉,彭山村,0,1,173,0,173,256,3,1,3,0,1,0,67.58
臺北縣,石碇鄉,豐田村,0,1,245,5,250,366,3,1,3,0,1,0,68.31
臺北縣,石碇鄉,隆盛村,0,1,488,16,504,709,3,1,3,0,1,0,71.09
臺北縣,石碇鄉,豐林村,0,1,175,1,176,254,3,1,3,0,1,0,69.29
臺北縣,石碇鄉,中民村,0,1,544,14,558,756,3,1,3,0,1,0,73.81
臺北縣,石碇鄉,永定村,0,1,374,4,378,530,3,1,3,0,1,0,71.32
臺北縣,石碇鄉,光明村,0,1,137,1,138,203,3,1,3,0,1,0,67.98
臺北縣,石碇鄉,永安村,0,1,268,3,271,399,3,1,3,0,1,0,67.92
臺北縣,石碇鄉,格頭村,0,1,400,6,406,572,3,1,3,0,1,0,70.98
臺北縣,石碇鄉,碧山村,0,1,214,4,218,379,3,1,3,0,1,0,57.52
臺北縣,坪林鄉,坪林村,0,1,676,3,679,944,3,1,3,0,1,0,71.93
臺北縣,坪林鄉,水德村,0,1,301,0,301,468,3,1,3,0,1,0,64.32
臺北縣,坪林鄉,大林村,0,1,498,5,503,878,3,1,3,0,1,0,57.29
臺北縣,坪林鄉,石曹村,0,1,219,2,221,369,3,1,3,0,1,0,59.89
臺北縣,坪林鄉,粗窟村,0,1,400,10,410,654,3,1,3,0,1,0,62.69
臺北縣,坪林鄉,上德村,0,1,444,4,448,702,3,1,3,0,1,0,63.82
臺北縣,坪林鄉,漁光村,0,1,367,6,373,602,3,1,3,0,1,0,61.96
臺北縣,三芝鄉,八賢村,0,1,228,3,231,312,3,1,3,0,1,0,74.04
臺北縣,三芝鄉,埔頭村,0,1,1726,35,1761,2470,3,1,3,0,1,0,71.30
臺北縣,三芝鄉,古庄村,0,1,532,8,540,733,3,1,3,0,1,0,73.67
臺北縣,三芝鄉,新庄村,0,1,535,11,546,783,3,1,3,0,1,0,69.73
臺北縣,三芝鄉,埔坪村,0,1,2188,40,2228,3133,3,1,3,0,1,0,71.11
臺北縣,三芝鄉,茂長村,0,1,234,3,237,359,3,1,3,0,1,0,66.02
臺北縣,三芝鄉,橫山村,0,1,406,1,407,549,3,1,3,0,1,0,74.13
臺北縣,三芝鄉,錫板村,0,1,527,8,535,784,3,1,3,0,1,0,68.24
臺北縣,三芝鄉,後厝村,0,1,805,12,817,1093,3,1,3,0,1,0,74.75
臺北縣,三芝鄉,福德村,0,1,332,16,348,463,3,1,3,0,1,0,75.16
臺北縣,三芝鄉,圓山村,0,1,311,3,314,465,3,1,3,0,1,0,67.53
臺北縣,三芝鄉,店子村,0,1,419,7,426,634,3,1,3,0,1,0,67.19
臺北縣,三芝鄉,興華村,0,1,713,19,732,1051,3,1,3,0,1,0,69.65
臺北縣,石門鄉,德茂村,0,1,505,7,512,692,3,1,3,0,1,0,73.99
臺北縣,石門鄉,富基村,0,1,681,11,692,940,3,1,3,0,1,0,73.62
臺北縣,石門鄉,老梅村,0,1,989,27,1016,1453,3,1,3,0,1,0,69.92
臺北縣,石門鄉,山溪村,0,1,384,5,389,579,3,1,3,0,1,0,67.18
臺北縣,石門鄉,石門村,0,1,710,9,719,1026,3,1,3,0,1,0,70.08
臺北縣,石門鄉,尖鹿村,0,1,763,8,771,1074,3,1,3,0,1,0,71.79
臺北縣,石門鄉,乾華村,0,1,135,1,136,212,3,1,3,0,1,0,64.15
臺北縣,石門鄉,茂林村,0,1,327,2,329,427,3,1,3,0,1,0,77.05
臺北縣,石門鄉,草里村,0,1,411,6,417,618,3,1,3,0,1,0,67.48
臺北縣,八里鄉,龍源村,0,1,1807,37,1844,2640,3,1,3,0,1,0,69.85
臺北縣,八里鄉,米倉村,0,1,1120,25,1145,1665,3,1,3,0,1,0,68.77
臺北縣,八里鄉,大崁村,0,1,671,15,686,928,3,1,3,0,1,0,73.92
臺北縣,八里鄉,埤頭村,0,1,1023,27,1050,1561,3,1,3,0,1,0,67.26
臺北縣,八里鄉,頂罟村,0,1,563,15,578,780,3,1,3,0,1,0,74.10
臺北縣,八里鄉,舊城村,0,1,1286,17,1303,1940,3,1,3,0,1,0,67.16
臺北縣,八里鄉,訊塘村,0,1,1292,30,1322,1855,3,1,3,0,1,0,71.27
臺北縣,八里鄉,荖阡村,0,1,625,10,635,882,3,1,3,0,1,0,72.00
臺北縣,八里鄉,下罟村,0,1,748,12,760,922,3,1,3,0,1,0,82.43
臺北縣,八里鄉,長坑村,0,1,734,12,746,1005,3,1,3,0,1,0,74.23
臺北縣,平溪鄉,薯榔村,0,1,336,3,339,457,3,1,3,0,1,0,74.18
臺北縣,平溪鄉,菁桐村,0,1,239,1,240,315,3,1,3,0,1,0,76.19
臺北縣,平溪鄉,白石村,0,1,266,8,274,352,3,1,3,0,1,0,77.84
臺北縣,平溪鄉,石底村,0,1,381,4,385,564,3,1,3,0,1,0,68.26
臺北縣,平溪鄉,平溪村,0,1,238,2,240,326,3,1,3,0,1,0,73.62
臺北縣,平溪鄉,嶺腳村,0,1,536,1,537,717,3,1,3,0,1,0,74.90
臺北縣,平溪鄉,東勢村,0,1,239,5,244,350,3,1,3,0,1,0,69.71
臺北縣,平溪鄉,十分村,0,1,813,7,820,1185,3,1,3,0,1,0,69.20
臺北縣,平溪鄉,望古村,0,1,72,1,73,103,3,1,3,0,1,0,70.87
臺北縣,平溪鄉,南山村,0,1,366,8,374,530,3,1,3,0,1,0,70.57
臺北縣,平溪鄉,新寮村,0,1,105,2,107,171,3,1,3,0,1,0,62.57
臺北縣,平溪鄉,平湖村,0,1,80,0,80,120,3,1,3,0,1,0,66.67
臺北縣,雙溪鄉,雙溪村,0,1,460,6,466,623,3,1,3,0,1,0,74.80
臺北縣,雙溪鄉,新基村,0,1,773,11,784,1049,3,1,3,0,1,0,74.74
臺北縣,雙溪鄉,三港村,0,1,321,5,326,477,3,1,3,0,1,0,68.34
臺北縣,雙溪鄉,牡丹村,0,1,1434,13,1447,1959,3,1,3,0,1,0,73.86
臺北縣,雙溪鄉,三貂村,0,1,223,4,227,325,3,1,3,0,1,0,69.85
臺北縣,雙溪鄉,平林村,0,1,664,3,667,892,3,1,3,0,1,0,74.78
臺北縣,雙溪鄉,上林村,0,1,540,6,546,763,3,1,3,0,1,0,71.56
臺北縣,雙溪鄉,外柑村,0,1,308,2,310,526,3,1,3,0,1,0,58.94
臺北縣,雙溪鄉,長源村,0,1,292,1,293,395,3,1,3,0,1,0,74.18
臺北縣,雙溪鄉,共和村,0,1,382,4,386,517,3,1,3,0,1,0,74.66
臺北縣,雙溪鄉,魚行村,0,1,427,4,431,614,3,1,3,0,1,0,70.20
臺北縣,雙溪鄉,泰平村,0,1,202,0,202,303,3,1,3,0,1,0,66.67
臺北縣,貢寮鄉,貢寮村,0,1,701,10,711,968,3,1,3,0,1,0,73.45
臺北縣,貢寮鄉,龍崗村,0,1,276,7,283,422,3,1,3,0,1,0,67.06
臺北縣,貢寮鄉,吉林村,0,1,259,4,263,414,3,1,3,0,1,0,63.53
臺北縣,貢寮鄉,雙玉村,0,1,557,9,566,807,3,1,3,0,1,0,70.14
臺北縣,貢寮鄉,福隆村,0,1,1085,23,1108,1527,3,1,3,0,1,0,72.56
臺北縣,貢寮鄉,福連村,0,1,455,7,462,730,3,1,3,0,1,0,63.29
臺北縣,貢寮鄉,龍門村,0,1,435,5,440,652,3,1,3,0,1,0,67.48
臺北縣,貢寮鄉,仁里村,0,1,1003,13,1016,1392,3,1,3,0,1,0,72.99
臺北縣,貢寮鄉,真理村,0,1,1223,18,1241,1809,3,1,3,0,1,0,68.60
臺北縣,貢寮鄉,美豐村,0,1,531,4,535,819,3,1,3,0,1,0,65.32
臺北縣,貢寮鄉,和美村,0,1,558,8,566,916,3,1,3,0,1,0,61.79
臺北縣,金山鄉,和平村,0,1,289,5,294,425,3,1,3,0,1,0,69.18
臺北縣,金山鄉,大同村,0,1,493,7,500,674,3,1,3,0,1,0,74.18
臺北縣,金山鄉,豐漁村,0,1,292,3,295,441,3,1,3,0,1,0,66.89
臺北縣,金山鄉,磺港村,0,1,861,6,867,1342,3,1,3,0,1,0,64.61
臺北縣,金山鄉,美田村,0,1,3550,47,3597,5117,3,1,3,0,1,0,70.30
臺北縣,金山鄉,五湖村,0,1,917,19,936,1355,3,1,3,0,1,0,69.08
臺北縣,金山鄉,重和村,0,1,513,9,522,749,3,1,3,0,1,0,69.69
臺北縣,金山鄉,兩湖村,0,1,222,7,229,338,3,1,3,0,1,0,67.75
臺北縣,金山鄉,六股村,0,1,343,7,350,510,3,1,3,0,1,0,68.63
臺北縣,金山鄉,三界村,0,1,373,5,378,567,3,1,3,0,1,0,66.67
臺北縣,金山鄉,清泉村,0,1,511,12,523,753,3,1,3,0,1,0,69.46
臺北縣,金山鄉,西湖村,0,1,141,0,141,216,3,1,3,0,1,0,65.28
臺北縣,金山鄉,萬壽村,0,1,307,4,311,426,3,1,3,0,1,0,73.00
臺北縣,金山鄉,永興村,0,1,330,4,334,527,3,1,3,0,1,0,63.38
臺北縣,萬里鄉,萬里村,0,1,2031,36,2067,2877,3,1,3,0,1,0,71.85
臺北縣,萬里鄉,龜吼村,0,1,1062,26,1088,1605,3,1,3,0,1,0,67.79
臺北縣,萬里鄉,野柳村,0,1,1557,24,1581,2127,3,1,3,0,1,0,74.33
臺北縣,萬里鄉,大鵬村,0,1,1430,21,1451,2085,3,1,3,0,1,0,69.59
臺北縣,萬里鄉,磺潭村,0,1,317,7,324,474,3,1,3,0,1,0,68.35
臺北縣,萬里鄉,雙興村,0,1,518,11,529,784,3,1,3,0,1,0,67.47
臺北縣,萬里鄉,溪底村,0,1,341,1,342,530,3,1,3,0,1,0,64.53
臺北縣,萬里鄉,崁腳村,0,1,352,6,358,561,3,1,3,0,1,0,63.81
臺北縣,萬里鄉,中幅村,0,1,511,17,528,800,3,1,3,0,1,0,66.00
臺北縣,萬里鄉,北基村,0,1,1180,22,1202,1842,3,1,3,0,1,0,65.26
臺北縣,烏來鄉,忠治村,0,1,250,2,252,366,3,1,3,0,1,0,68.85
臺北縣,烏來鄉,烏來村,0,1,519,7,526,773,3,1,3,0,1,0,68.05
臺北縣,烏來鄉,孝義村,0,1,47,0,47,64,3,1,3,0,1,0,73.44
臺北縣,烏來鄉,信賢村,0,1,95,1,96,148,3,1,3,0,1,0,64.86
臺北縣,烏來鄉,福山村,0,1,36,0,36,54,3,1,3,0,1,0,66.67
宜蘭縣,宜蘭市,南門里,0,1,460,12,472,864,3,1,3,0,1,0,54.63
宜蘭縣,宜蘭市,負郭里,0,1,1326,20,1346,2170,3,1,3,0,1,0,62.03
宜蘭縣,宜蘭市,民族里,0,1,1349,29,1378,2330,3,1,3,0,1,0,59.14
宜蘭縣,宜蘭市,建軍里,0,1,1216,26,1242,2213,3,1,3,0,1,0,56.12
宜蘭縣,宜蘭市,復興里,0,1,1656,28,1684,2862,3,1,3,0,1,0,58.84
宜蘭縣,宜蘭市,思源里,0,1,1459,31,1490,2529,3,1,3,0,1,0,58.92
宜蘭縣,宜蘭市,文化里,0,1,1417,31,1448,2372,3,1,3,0,1,0,61.05
宜蘭縣,宜蘭市,神農里,0,1,471,5,476,794,3,1,3,0,1,0,59.95
宜蘭縣,宜蘭市,民權里,0,1,834,14,848,1430,3,1,3,0,1,0,59.30
宜蘭縣,宜蘭市,民生里,0,1,326,3,329,533,3,1,3,0,1,0,61.73
宜蘭縣,宜蘭市,昇平里,0,1,457,6,463,747,3,1,3,0,1,0,61.98
宜蘭縣,宜蘭市,大東里,0,1,331,4,335,569,3,1,3,0,1,0,58.88
宜蘭縣,宜蘭市,新興里,0,1,357,5,362,648,3,1,3,0,1,0,55.86
宜蘭縣,宜蘭市,和睦里,0,1,1067,24,1091,1994,3,1,3,0,1,0,54.71
宜蘭縣,宜蘭市,進士里,0,1,2130,35,2165,3583,3,1,3,0,1,0,60.42
宜蘭縣,宜蘭市,南橋里,0,1,275,1,276,511,3,1,3,0,1,0,54.01
宜蘭縣,宜蘭市,建業里,0,1,519,7,526,1047,3,1,3,0,1,0,50.24
宜蘭縣,宜蘭市,南津里,0,1,406,7,413,763,3,1,3,0,1,0,54.13
宜蘭縣,宜蘭市,凱旋里,0,1,634,5,639,1169,3,1,3,0,1,0,54.66
宜蘭縣,宜蘭市,黎明里,0,1,618,12,630,1098,3,1,3,0,1,0,57.38
宜蘭縣,宜蘭市,東村里,0,1,1601,34,1635,2855,3,1,3,0,1,0,57.27
宜蘭縣,宜蘭市,延平里,0,1,1640,29,1669,2950,3,1,3,0,1,0,56.58
宜蘭縣,宜蘭市,七張里,0,1,606,3,609,1007,3,1,3,0,1,0,60.48
宜蘭縣,宜蘭市,慈安里,0,1,1876,32,1908,3589,3,1,3,0,1,0,53.16
宜蘭縣,宜蘭市,新民里,0,1,409,7,416,669,3,1,3,0,1,0,62.18
宜蘭縣,宜蘭市,東門里,0,1,375,7,382,590,3,1,3,0,1,0,64.75
宜蘭縣,宜蘭市,中正里,0,1,456,5,461,703,3,1,3,0,1,0,65.58
宜蘭縣,宜蘭市,小東里,0,1,748,21,769,1330,3,1,3,0,1,0,57.82
宜蘭縣,宜蘭市,菜園里,0,1,797,11,808,1346,3,1,3,0,1,0,60.03
宜蘭縣,宜蘭市,孝廉里,0,1,664,5,669,1152,3,1,3,0,1,0,58.07
宜蘭縣,宜蘭市,新生里,0,1,1088,14,1102,2011,3,1,3,0,1,0,54.80
宜蘭縣,宜蘭市,茭白里,0,1,763,9,772,1490,3,1,3,0,1,0,51.81
宜蘭縣,宜蘭市,北津里,0,1,691,12,703,1257,3,1,3,0,1,0,55.93
宜蘭縣,宜蘭市,梅洲里,0,1,1295,18,1313,2272,3,1,3,0,1,0,57.79
宜蘭縣,宜蘭市,北門里,0,1,543,10,553,977,3,1,3,0,1,0,56.60
宜蘭縣,宜蘭市,慶和里,0,1,521,15,536,818,3,1,3,0,1,0,65.53
宜蘭縣,宜蘭市,鄂王里,0,1,510,7,517,866,3,1,3,0,1,0,59.70
宜蘭縣,宜蘭市,西門里,0,1,768,10,778,1302,3,1,3,0,1,0,59.75
宜蘭縣,宜蘭市,中山里,0,1,520,5,525,891,3,1,3,0,1,0,58.92
宜蘭縣,宜蘭市,大道里,0,1,748,11,759,1369,3,1,3,0,1,0,55.44
宜蘭縣,羅東鎮,開羅里,0,1,312,0,312,474,3,1,3,0,1,0,65.82
宜蘭縣,羅東鎮,開元里,0,1,385,6,391,594,3,1,3,0,1,0,65.82
宜蘭縣,羅東鎮,東明里,0,1,338,3,341,581,3,1,3,0,1,0,58.69
宜蘭縣,羅東鎮,大新里,0,1,657,6,663,1179,3,1,3,0,1,0,56.23
宜蘭縣,羅東鎮,東安里,0,1,847,14,861,1467,3,1,3,0,1,0,58.69
宜蘭縣,羅東鎮,新群里,0,1,1027,12,1039,1707,3,1,3,0,1,0,60.87
宜蘭縣,羅東鎮,羅莊里,0,1,586,6,592,1138,3,1,3,0,1,0,52.02
宜蘭縣,羅東鎮,南昌里,0,1,1237,26,1263,2104,3,1,3,0,1,0,60.03
宜蘭縣,羅東鎮,南豪里,0,1,804,7,811,1395,3,1,3,0,1,0,58.14
宜蘭縣,羅東鎮,成功里,0,1,759,9,768,1228,3,1,3,0,1,0,62.54
宜蘭縣,羅東鎮,仁德里,0,1,522,5,527,862,3,1,3,0,1,0,61.14
宜蘭縣,羅東鎮,居仁里,0,1,424,4,428,709,3,1,3,0,1,0,60.37
宜蘭縣,羅東鎮,義和里,0,1,559,2,561,974,3,1,3,0,1,0,57.60
宜蘭縣,羅東鎮,羅東里,0,1,425,5,430,707,3,1,3,0,1,0,60.82
宜蘭縣,羅東鎮,浮崙里,0,1,438,11,449,713,3,1,3,0,1,0,62.97
宜蘭縣,羅東鎮,漢民里,0,1,1920,24,1944,3414,3,1,3,0,1,0,56.94
宜蘭縣,羅東鎮,西安里,0,1,2350,27,2377,4108,3,1,3,0,1,0,57.86
宜蘭縣,羅東鎮,北成里,0,1,2240,25,2265,3869,3,1,3,0,1,0,58.54
宜蘭縣,羅東鎮,賢文里,0,1,1862,20,1882,3309,3,1,3,0,1,0,56.88
宜蘭縣,羅東鎮,公正里,0,1,942,11,953,1720,3,1,3,0,1,0,55.41
宜蘭縣,羅東鎮,集祥里,0,1,571,8,579,1004,3,1,3,0,1,0,57.67
宜蘭縣,羅東鎮,信義里,0,1,1450,23,1473,2518,3,1,3,0,1,0,58.50
宜蘭縣,羅東鎮,樹林里,0,1,1582,17,1599,2797,3,1,3,0,1,0,57.17
宜蘭縣,羅東鎮,竹林里,0,1,1452,26,1478,2555,3,1,3,0,1,0,57.85
宜蘭縣,羅東鎮,仁愛里,0,1,1184,14,1198,2041,3,1,3,0,1,0,58.70
宜蘭縣,蘇澳鎮,龍德里,0,1,1512,17,1529,2788,3,1,3,0,1,0,54.84
宜蘭縣,蘇澳鎮,頂寮里,0,1,392,4,396,688,3,1,3,0,1,0,57.56
宜蘭縣,蘇澳鎮,永榮里,0,1,1413,15,1428,2516,3,1,3,0,1,0,56.76
宜蘭縣,蘇澳鎮,存仁里,0,1,607,4,611,1086,3,1,3,0,1,0,56.26
宜蘭縣,蘇澳鎮,港邊里,0,1,767,6,773,1373,3,1,3,0,1,0,56.30
宜蘭縣,蘇澳鎮,岳明里,0,1,129,15,144,390,3,1,3,0,1,0,36.92
宜蘭縣,蘇澳鎮,隘丁里,0,1,1073,9,1082,1906,3,1,3,0,1,0,56.77
宜蘭縣,蘇澳鎮,新城里,0,1,529,7,536,1024,3,1,3,0,1,0,52.34
宜蘭縣,蘇澳鎮,聖湖里,0,1,2304,32,2336,4378,3,1,3,0,1,0,53.36
宜蘭縣,蘇澳鎮,蘇西里,0,1,1200,13,1213,2186,3,1,3,0,1,0,55.49
宜蘭縣,蘇澳鎮,蘇北里,0,1,731,6,737,1315,3,1,3,0,1,0,56.05
宜蘭縣,蘇澳鎮,蘇南里,0,1,357,3,360,632,3,1,3,0,1,0,56.96
宜蘭縣,蘇澳鎮,蘇東里,0,1,293,7,300,607,3,1,3,0,1,0,49.42
宜蘭縣,蘇澳鎮,長安里,0,1,366,8,374,664,3,1,3,0,1,0,56.33
宜蘭縣,蘇澳鎮,永光里,0,1,415,6,421,678,3,1,3,0,1,0,62.09
宜蘭縣,蘇澳鎮,永春里,0,1,363,13,376,703,3,1,3,0,1,0,53.49
宜蘭縣,蘇澳鎮,永樂里,0,1,352,5,357,568,3,1,3,0,1,0,62.85
宜蘭縣,蘇澳鎮,南安里,0,1,613,9,622,1209,3,1,3,0,1,0,51.45
宜蘭縣,蘇澳鎮,南正里,0,1,573,10,583,1185,3,1,3,0,1,0,49.20
宜蘭縣,蘇澳鎮,南成里,0,1,614,11,625,1344,3,1,3,0,1,0,46.50
宜蘭縣,蘇澳鎮,南興里,0,1,750,6,756,1720,3,1,3,0,1,0,43.95
宜蘭縣,蘇澳鎮,南寧里,0,1,598,5,603,1259,3,1,3,0,1,0,47.90
宜蘭縣,蘇澳鎮,南建里,0,1,603,10,613,1353,3,1,3,0,1,0,45.31
宜蘭縣,蘇澳鎮,東澳里,0,1,209,1,210,369,3,1,3,0,1,0,56.91
宜蘭縣,蘇澳鎮,南強里,0,1,466,5,471,883,3,1,3,0,1,0,53.34
宜蘭縣,蘇澳鎮,朝陽里,0,1,443,5,448,836,3,1,3,0,1,0,53.59
宜蘭縣,頭城鎮,石城里,0,1,206,1,207,413,3,1,3,0,1,0,50.12
宜蘭縣,頭城鎮,大里里,0,1,239,5,244,696,3,1,3,0,1,0,35.06
宜蘭縣,頭城鎮,大溪里,0,1,607,8,615,1532,3,1,3,0,1,0,40.14
宜蘭縣,頭城鎮,合興里,0,1,196,7,203,428,3,1,3,0,1,0,47.43
宜蘭縣,頭城鎮,更新里,0,1,645,6,651,1307,3,1,3,0,1,0,49.81
宜蘭縣,頭城鎮,外澳里,0,1,438,6,444,880,3,1,3,0,1,0,50.45
宜蘭縣,頭城鎮,港口里,0,1,316,10,326,611,3,1,3,0,1,0,53.36
宜蘭縣,頭城鎮,武營里,0,1,686,6,692,1315,3,1,3,0,1,0,52.62
宜蘭縣,頭城鎮,大坑里,0,1,612,9,621,1099,3,1,3,0,1,0,56.51
宜蘭縣,頭城鎮,城東里,0,1,433,3,436,761,3,1,3,0,1,0,57.29
宜蘭縣,頭城鎮,城北里,0,1,350,5,355,651,3,1,3,0,1,0,54.53
宜蘭縣,頭城鎮,城西里,0,1,407,4,411,712,3,1,3,0,1,0,57.72
宜蘭縣,頭城鎮,城南里,0,1,325,5,330,615,3,1,3,0,1,0,53.66
宜蘭縣,頭城鎮,竹安里,0,1,936,11,947,1848,3,1,3,0,1,0,51.24
宜蘭縣,頭城鎮,新建里,0,1,909,19,928,1687,3,1,3,0,1,0,55.01
宜蘭縣,頭城鎮,拔雅里,0,1,646,7,653,1182,3,1,3,0,1,0,55.25
宜蘭縣,頭城鎮,福成里,0,1,509,6,515,980,3,1,3,0,1,0,52.55
宜蘭縣,頭城鎮,金面里,0,1,761,8,769,1576,3,1,3,0,1,0,48.79
宜蘭縣,頭城鎮,金盈里,0,1,374,5,379,720,3,1,3,0,1,0,52.64
宜蘭縣,頭城鎮,頂埔里,0,1,660,7,667,1298,3,1,3,0,1,0,51.39
宜蘭縣,頭城鎮,下埔里,0,1,489,3,492,945,3,1,3,0,1,0,52.06
宜蘭縣,頭城鎮,中崙里,0,1,546,4,550,913,3,1,3,0,1,0,60.24
宜蘭縣,頭城鎮,二城里,0,1,562,8,570,1069,3,1,3,0,1,0,53.32
宜蘭縣,礁溪鄉,白雲村,0,1,758,8,766,1400,3,1,3,0,1,0,54.71
宜蘭縣,礁溪鄉,玉石村,0,1,904,12,916,1621,3,1,3,0,1,0,56.51
宜蘭縣,礁溪鄉,德陽村,0,1,1770,32,1802,3262,3,1,3,0,1,0,55.24
宜蘭縣,礁溪鄉,大忠村,0,1,1125,12,1137,1897,3,1,3,0,1,0,59.94
宜蘭縣,礁溪鄉,大義村,0,1,427,3,430,676,3,1,3,0,1,0,63.61
宜蘭縣,礁溪鄉,六結村,0,1,789,7,796,1334,3,1,3,0,1,0,59.67
宜蘭縣,礁溪鄉,二龍村,0,1,594,8,602,1125,3,1,3,0,1,0,53.51
宜蘭縣,礁溪鄉,時潮村,0,1,606,4,610,1253,3,1,3,0,1,0,48.68
宜蘭縣,礁溪鄉,玉田村,0,1,940,14,954,1694,3,1,3,0,1,0,56.32
宜蘭縣,礁溪鄉,三民村,0,1,1217,27,1244,2166,3,1,3,0,1,0,57.43
宜蘭縣,礁溪鄉,林美村,0,1,594,9,603,1039,3,1,3,0,1,0,58.04
宜蘭縣,礁溪鄉,白鵝村,0,1,366,2,368,649,3,1,3,0,1,0,56.70
宜蘭縣,礁溪鄉,玉光村,0,1,474,8,482,877,3,1,3,0,1,0,54.96
宜蘭縣,礁溪鄉,光武村,0,1,586,9,595,1056,3,1,3,0,1,0,56.34
宜蘭縣,礁溪鄉,吳沙村,0,1,1204,9,1213,2029,3,1,3,0,1,0,59.78
宜蘭縣,礁溪鄉,龍潭村,0,1,1409,17,1426,2528,3,1,3,0,1,0,56.41
宜蘭縣,礁溪鄉,匏崙村,0,1,482,10,492,882,3,1,3,0,1,0,55.78
宜蘭縣,礁溪鄉,二結村,0,1,199,7,206,389,3,1,3,0,1,0,52.96
宜蘭縣,壯圍鄉,吉祥村,0,1,1270,21,1291,2416,3,1,3,0,1,0,53.44
宜蘭縣,壯圍鄉,美福村,0,1,742,10,752,1440,3,1,3,0,1,0,52.22
宜蘭縣,壯圍鄉,新南村,0,1,425,5,430,827,3,1,3,0,1,0,52.00
宜蘭縣,壯圍鄉,東港村,0,1,510,7,517,983,3,1,3,0,1,0,52.59
宜蘭縣,壯圍鄉,復興村,0,1,793,11,804,1547,3,1,3,0,1,0,51.97
宜蘭縣,壯圍鄉,過嶺村,0,1,719,4,723,1417,3,1,3,0,1,0,51.02
宜蘭縣,壯圍鄉,永鎮村,0,1,375,4,379,820,3,1,3,0,1,0,46.22
宜蘭縣,壯圍鄉,忠孝村,0,1,998,11,1009,1728,3,1,3,0,1,0,58.39
宜蘭縣,壯圍鄉,古亭村,0,1,603,12,615,1155,3,1,3,0,1,0,53.25
宜蘭縣,壯圍鄉,功勞村,0,1,540,6,546,936,3,1,3,0,1,0,58.33
宜蘭縣,壯圍鄉,美城村,0,1,924,4,928,1731,3,1,3,0,1,0,53.61
宜蘭縣,壯圍鄉,新社村,0,1,530,5,535,1079,3,1,3,0,1,0,49.58
宜蘭縣,壯圍鄉,大福村,0,1,811,11,822,1487,3,1,3,0,1,0,55.28
宜蘭縣,員山鄉,員山村,0,1,1927,22,1949,3558,3,1,3,0,1,0,54.78
宜蘭縣,員山鄉,尚德村,0,1,963,17,980,1729,3,1,3,0,1,0,56.68
宜蘭縣,員山鄉,惠好村,0,1,644,9,653,1110,3,1,3,0,1,0,58.83
宜蘭縣,員山鄉,七賢村,0,1,495,4,499,955,3,1,3,0,1,0,52.25
宜蘭縣,員山鄉,深溝村,0,1,709,9,718,1282,3,1,3,0,1,0,56.01
宜蘭縣,員山鄉,蓁巷村,0,1,581,9,590,1069,3,1,3,0,1,0,55.19
宜蘭縣,員山鄉,內城村,0,1,852,12,864,1455,3,1,3,0,1,0,59.38
宜蘭縣,員山鄉,中華村,0,1,350,4,354,758,3,1,3,0,1,0,46.70
宜蘭縣,員山鄉,永和村,0,1,804,14,818,1504,3,1,3,0,1,0,54.39
宜蘭縣,員山鄉,頭分村,0,1,606,8,614,1010,3,1,3,0,1,0,60.79
宜蘭縣,員山鄉,枕山村,0,1,1168,14,1182,2004,3,1,3,0,1,0,58.98
宜蘭縣,員山鄉,同樂村,0,1,1250,19,1269,2218,3,1,3,0,1,0,57.21
宜蘭縣,員山鄉,湖東村,0,1,439,6,445,835,3,1,3,0,1,0,53.29
宜蘭縣,員山鄉,逸仙村,0,1,445,4,449,828,3,1,3,0,1,0,54.23
宜蘭縣,員山鄉,湖北村,0,1,514,6,520,978,3,1,3,0,1,0,53.17
宜蘭縣,員山鄉,湖西村,0,1,785,11,796,1560,3,1,3,0,1,0,51.03
宜蘭縣,冬山鄉,武淵村,0,1,600,5,605,1046,3,1,3,0,1,0,57.84
宜蘭縣,冬山鄉,珍珠村,0,1,661,8,669,1093,3,1,3,0,1,0,61.21
宜蘭縣,冬山鄉,補城村,0,1,555,2,557,913,3,1,3,0,1,0,61.01
宜蘭縣,冬山鄉,三奇村,0,1,454,9,463,779,3,1,3,0,1,0,59.44
宜蘭縣,冬山鄉,大興村,0,1,564,10,574,905,3,1,3,0,1,0,63.43
宜蘭縣,冬山鄉,東城村,0,1,628,8,636,1112,3,1,3,0,1,0,57.19
宜蘭縣,冬山鄉,香和村,0,1,1034,14,1048,1689,3,1,3,0,1,0,62.05
宜蘭縣,冬山鄉,南興村,0,1,983,16,999,1697,3,1,3,0,1,0,58.87
宜蘭縣,冬山鄉,冬山村,0,1,539,7,546,855,3,1,3,0,1,0,63.86
宜蘭縣,冬山鄉,安平村,0,1,418,5,423,688,3,1,3,0,1,0,61.48
宜蘭縣,冬山鄉,太和村,0,1,758,10,768,1282,3,1,3,0,1,0,59.91
宜蘭縣,冬山鄉,八寶村,0,1,473,6,479,798,3,1,3,0,1,0,60.03
宜蘭縣,冬山鄉,丸山村,0,1,646,10,656,1187,3,1,3,0,1,0,55.27
宜蘭縣,冬山鄉,中山村,0,1,246,7,253,414,3,1,3,0,1,0,61.11
宜蘭縣,冬山鄉,順安村,0,1,2116,21,2137,3803,3,1,3,0,1,0,56.19
宜蘭縣,冬山鄉,永美村,0,1,1088,11,1099,1899,3,1,3,0,1,0,57.87
宜蘭縣,冬山鄉,群英村,0,1,2521,41,2562,4510,3,1,3,0,1,0,56.81
宜蘭縣,冬山鄉,清溝村,0,1,1482,17,1499,2554,3,1,3,0,1,0,58.69
宜蘭縣,冬山鄉,鹿埔村,0,1,1207,12,1219,2076,3,1,3,0,1,0,58.72
宜蘭縣,冬山鄉,得安村,0,1,562,8,570,1029,3,1,3,0,1,0,55.39
宜蘭縣,冬山鄉,廣興村,0,1,1148,12,1160,2049,3,1,3,0,1,0,56.61
宜蘭縣,冬山鄉,廣安村,0,1,643,8,651,1070,3,1,3,0,1,0,60.84
宜蘭縣,冬山鄉,柯林村,0,1,478,7,485,804,3,1,3,0,1,0,60.32
宜蘭縣,冬山鄉,大進村,0,1,443,6,449,766,3,1,3,0,1,0,58.62
宜蘭縣,五結鄉,三興村,0,1,991,6,997,1592,3,1,3,0,1,0,62.63
宜蘭縣,五結鄉,二結村,0,1,882,14,896,1396,3,1,3,0,1,0,64.18
宜蘭縣,五結鄉,鎮安村,0,1,1124,12,1136,1825,3,1,3,0,1,0,62.25
宜蘭縣,五結鄉,上四村,0,1,880,11,891,1438,3,1,3,0,1,0,61.96
宜蘭縣,五結鄉,中興村,0,1,538,6,544,890,3,1,3,0,1,0,61.12
宜蘭縣,五結鄉,四結村,0,1,1256,13,1269,2098,3,1,3,0,1,0,60.49
宜蘭縣,五結鄉,福興村,0,1,973,6,979,1533,3,1,3,0,1,0,63.86
宜蘭縣,五結鄉,五結村,0,1,1398,18,1416,2369,3,1,3,0,1,0,59.77
宜蘭縣,五結鄉,大吉村,0,1,1430,15,1445,2436,3,1,3,0,1,0,59.32
宜蘭縣,五結鄉,協和村,0,1,1159,13,1172,1919,3,1,3,0,1,0,61.07
宜蘭縣,五結鄉,孝威村,0,1,742,5,747,1216,3,1,3,0,1,0,61.43
宜蘭縣,五結鄉,錦眾村,0,1,810,4,814,1463,3,1,3,0,1,0,55.64
宜蘭縣,五結鄉,利澤村,0,1,1220,19,1239,2033,3,1,3,0,1,0,60.94
宜蘭縣,五結鄉,成興村,0,1,1256,15,1271,2241,3,1,3,0,1,0,56.72
宜蘭縣,五結鄉,季新村,0,1,1054,6,1060,1888,3,1,3,0,1,0,56.14
宜蘭縣,三星鄉,員山村,0,1,138,1,139,243,3,1,3,0,1,0,57.20
宜蘭縣,三星鄉,天山村,0,1,342,7,349,666,3,1,3,0,1,0,52.40
宜蘭縣,三星鄉,天福村,0,1,446,4,450,861,3,1,3,0,1,0,52.26
宜蘭縣,三星鄉,雙賢村,0,1,369,3,372,662,3,1,3,0,1,0,56.19
宜蘭縣,三星鄉,人和村,0,1,295,3,298,485,3,1,3,0,1,0,61.44
宜蘭縣,三星鄉,義德村,0,1,660,11,671,1180,3,1,3,0,1,0,56.86
宜蘭縣,三星鄉,集慶村,0,1,628,9,637,1095,3,1,3,0,1,0,58.17
宜蘭縣,三星鄉,月眉村,0,1,481,9,490,843,3,1,3,0,1,0,58.13
宜蘭縣,三星鄉,拱照村,0,1,557,3,560,1185,3,1,3,0,1,0,47.26
宜蘭縣,三星鄉,大隱村,0,1,1526,21,1547,2583,3,1,3,0,1,0,59.89
宜蘭縣,三星鄉,行健村,0,1,360,5,365,660,3,1,3,0,1,0,55.30
宜蘭縣,三星鄉,萬德村,0,1,306,10,316,555,3,1,3,0,1,0,56.94
宜蘭縣,三星鄉,貴林村,0,1,248,1,249,468,3,1,3,0,1,0,53.21
宜蘭縣,三星鄉,萬富村,0,1,363,3,366,658,3,1,3,0,1,0,55.62
宜蘭縣,三星鄉,大義村,0,1,644,12,656,1039,3,1,3,0,1,0,63.14
宜蘭縣,三星鄉,尚武村,0,1,461,4,465,790,3,1,3,0,1,0,58.86
宜蘭縣,三星鄉,大洲村,0,1,846,11,857,1232,3,1,3,0,1,0,69.56
宜蘭縣,三星鄉,尾塹村,0,1,673,6,679,1075,3,1,3,0,1,0,63.16
宜蘭縣,大同鄉,寒溪村,0,1,52,0,52,98,3,1,3,0,1,0,53.06
宜蘭縣,大同鄉,崙埤村,0,1,46,0,46,101,3,1,3,0,1,0,45.54
宜蘭縣,大同鄉,松羅村,0,1,109,1,110,223,3,1,3,0,1,0,49.33
宜蘭縣,大同鄉,復興村,0,1,118,2,120,222,3,1,3,0,1,0,54.05
宜蘭縣,大同鄉,英士村,0,1,39,0,39,89,3,1,3,0,1,0,43.82
宜蘭縣,大同鄉,樂水村,0,1,27,2,29,73,3,1,3,0,1,0,39.73
宜蘭縣,大同鄉,太平村,0,1,38,1,39,65,3,1,3,0,1,0,60.00
宜蘭縣,大同鄉,茂安村,0,1,11,0,11,14,3,1,3,0,1,0,78.57
宜蘭縣,大同鄉,四季村,0,1,22,0,22,49,3,1,3,0,1,0,44.90
宜蘭縣,大同鄉,南山村,0,1,27,0,27,60,3,1,3,0,1,0,45.00
宜蘭縣,南澳鄉,東岳村,0,1,46,1,47,82,3,1,3,0,1,0,57.32
宜蘭縣,南澳鄉,南澳村,0,1,144,3,147,299,3,1,3,0,1,0,49.16
宜蘭縣,南澳鄉,碧候村,0,1,38,0,38,105,3,1,3,0,1,0,36.19
宜蘭縣,南澳鄉,金岳村,0,1,32,1,33,57,3,1,3,0,1,0,57.89
宜蘭縣,南澳鄉,武塔村,0,1,66,1,67,143,3,1,3,0,1,0,46.85
宜蘭縣,南澳鄉,金洋村,0,1,21,0,21,41,3,1,3,0,1,0,51.22
宜蘭縣,南澳鄉,澳花村,0,1,88,0,88,194,3,1,3,0,1,0,45.36
桃園縣,桃園市,武陵里,0,1,955,9,964,1531,3,1,3,0,1,0,62.97
桃園縣,桃園市,民生里,0,1,955,11,966,1400,3,1,3,0,1,0,69.00
桃園縣,桃園市,東門里,0,1,1363,15,1378,2161,3,1,3,0,1,0,63.77
桃園縣,桃園市,東山里,0,1,1248,14,1262,1937,3,1,3,0,1,0,65.15
桃園縣,桃園市,萬壽里,0,1,665,12,677,1009,3,1,3,0,1,0,67.10
桃園縣,桃園市,雲林里,0,1,1805,19,1824,2820,3,1,3,0,1,0,64.68
桃園縣,桃園市,大豐里,0,1,2264,29,2293,3536,3,1,3,0,1,0,64.85
桃園縣,桃園市,建國里,0,1,2402,36,2438,3813,3,1,3,0,1,0,63.94
桃園縣,桃園市,豐林里,0,1,3102,46,3148,4634,3,1,3,0,1,0,67.93
桃園縣,桃園市,福林里,0,1,2767,38,2805,4058,3,1,3,0,1,0,69.12
桃園縣,桃園市,福安里,0,1,1940,19,1959,2846,3,1,3,0,1,0,68.83
桃園縣,桃園市,大林里,0,1,2702,39,2741,4234,3,1,3,0,1,0,64.74
桃園縣,桃園市,文化里,0,1,567,7,574,861,3,1,3,0,1,0,66.67
桃園縣,桃園市,文明里,0,1,1020,7,1027,1504,3,1,3,0,1,0,68.28
桃園縣,桃園市,文昌里,0,1,760,18,778,1154,3,1,3,0,1,0,67.42
桃園縣,桃園市,南門里,0,1,2606,41,2647,4042,3,1,3,0,1,0,65.49
桃園縣,桃園市,南華里,0,1,971,13,984,1495,3,1,3,0,1,0,65.82
桃園縣,桃園市,中路里,0,1,2874,47,2921,4587,3,1,3,0,1,0,63.68
桃園縣,桃園市,中山里,0,1,3864,44,3908,6332,3,1,3,0,1,0,61.72
桃園縣,桃園市,中德里,0,1,2076,32,2108,3077,3,1,3,0,1,0,68.51
桃園縣,桃園市,玉山里,0,1,2621,42,2663,4088,3,1,3,0,1,0,65.14
桃園縣,桃園市,泰山里,0,1,1711,24,1735,2632,3,1,3,0,1,0,65.92
桃園縣,桃園市,文中里,0,1,1672,17,1689,2618,3,1,3,0,1,0,64.51
桃園縣,桃園市,中正里,0,1,2482,38,2520,3765,3,1,3,0,1,0,66.93
桃園縣,桃園市,中成里,0,1,1866,29,1895,2731,3,1,3,0,1,0,69.39
桃園縣,桃園市,中興里,0,1,2818,32,2850,4324,3,1,3,0,1,0,65.91
桃園縣,桃園市,光興里,0,1,2877,37,2914,4345,3,1,3,0,1,0,67.07
桃園縣,桃園市,龍岡里,0,1,3438,50,3488,5382,3,1,3,0,1,0,64.81
桃園縣,桃園市,龍祥里,0,1,1870,26,1896,2798,3,1,3,0,1,0,67.76
桃園縣,桃園市,龍山里,0,1,2165,51,2216,3267,3,1,3,0,1,0,67.83
桃園縣,桃園市,長美里,0,1,731,9,740,1131,3,1,3,0,1,0,65.43
桃園縣,桃園市,永興里,0,1,1225,5,1230,1868,3,1,3,0,1,0,65.85
桃園縣,桃園市,西門里,0,1,952,6,958,1520,3,1,3,0,1,0,63.03
桃園縣,桃園市,西湖里,0,1,814,12,826,1208,3,1,3,0,1,0,68.38
桃園縣,桃園市,東埔里,0,1,2179,34,2213,3576,3,1,3,0,1,0,61.88
桃園縣,桃園市,信光里,0,1,2071,34,2105,3400,3,1,3,0,1,0,61.91
桃園縣,桃園市,永安里,0,1,2309,37,2346,3640,3,1,3,0,1,0,64.45
桃園縣,桃園市,長安里,0,1,2984,36,3020,4752,3,1,3,0,1,0,63.55
桃園縣,桃園市,西埔里,0,1,1301,17,1318,1876,3,1,3,0,1,0,70.26
桃園縣,桃園市,中埔里,0,1,3777,69,3846,6002,3,1,3,0,1,0,64.08
桃園縣,桃園市,中寧里,0,1,1778,23,1801,2862,3,1,3,0,1,0,62.93
桃園縣,桃園市,新埔里,0,1,1991,29,2020,3058,3,1,3,0,1,0,66.06
桃園縣,桃園市,同安里,0,1,1630,54,1684,2671,3,1,3,0,1,0,63.05
桃園縣,桃園市,莊敬里,0,1,1967,30,1997,3156,3,1,3,0,1,0,63.28
桃園縣,桃園市,慈文里,0,1,2217,42,2259,3580,3,1,3,0,1,0,63.10
桃園縣,桃園市,中和里,0,1,1079,11,1090,1614,3,1,3,0,1,0,67.53
桃園縣,桃園市,北門里,0,1,1019,15,1034,1582,3,1,3,0,1,0,65.36
桃園縣,桃園市,青溪里,0,1,2502,40,2542,4003,3,1,3,0,1,0,63.50
桃園縣,桃園市,朝陽里,0,1,1045,13,1058,1625,3,1,3,0,1,0,65.11
桃園縣,桃園市,成功里,0,1,1874,15,1889,2829,3,1,3,0,1,0,66.77
桃園縣,桃園市,三民里,0,1,1866,19,1885,2716,3,1,3,0,1,0,69.40
桃園縣,桃園市,會稽里,0,1,2402,35,2437,4099,3,1,3,0,1,0,59.45
桃園縣,桃園市,大興里,0,1,2224,41,2265,3668,3,1,3,0,1,0,61.75
桃園縣,桃園市,春日里,0,1,1562,33,1595,2446,3,1,3,0,1,0,65.21
桃園縣,桃園市,忠義里,0,1,1565,34,1599,2602,3,1,3,0,1,0,61.45
桃園縣,桃園市,汴洲里,0,1,1771,26,1797,2743,3,1,3,0,1,0,65.51
桃園縣,龜山鄉,龜山村,0,1,2639,34,2673,4079,3,1,3,0,1,0,65.53
桃園縣,龜山鄉,新路村,0,1,2148,37,2185,3164,3,1,3,0,1,0,69.06
桃園縣,龜山鄉,大同村,0,1,2466,32,2498,3676,3,1,3,0,1,0,67.95
桃園縣,龜山鄉,中興村,0,1,3967,66,4033,6245,3,1,3,0,1,0,64.58
桃園縣,龜山鄉,陸光村,0,1,1921,42,1963,2540,3,1,3,0,1,0,77.28
桃園縣,龜山鄉,精忠村,0,1,1793,22,1815,2386,3,1,3,0,1,0,76.07
桃園縣,龜山鄉,兔坑村,0,1,1524,39,1563,2563,3,1,3,0,1,0,60.98
桃園縣,龜山鄉,龍壽村,0,1,3244,60,3304,5877,3,1,3,0,1,0,56.22
桃園縣,龜山鄉,嶺頂村,0,1,2528,64,2592,4461,3,1,3,0,1,0,58.10
桃園縣,龜山鄉,舊路村,0,1,1107,13,1120,1729,3,1,3,0,1,0,64.78
桃園縣,龜山鄉,山德村,0,1,2869,58,2927,4544,3,1,3,0,1,0,64.41
桃園縣,龜山鄉,山頂村,0,1,1981,24,2005,5301,3,1,3,0,1,0,37.82
桃園縣,龜山鄉,山福村,0,1,3730,67,3797,6388,3,1,3,0,1,0,59.44
桃園縣,龜山鄉,大崗村,0,1,2542,37,2579,4013,3,1,3,0,1,0,64.27
桃園縣,龜山鄉,公西村,0,1,1210,20,1230,2010,3,1,3,0,1,0,61.19
桃園縣,龜山鄉,樂善村,0,1,1539,20,1559,2836,3,1,3,0,1,0,54.97
桃園縣,龜山鄉,大坑村,0,1,665,12,677,1037,3,1,3,0,1,0,65.28
桃園縣,龜山鄉,南上村,0,1,1303,20,1323,2065,3,1,3,0,1,0,64.07
桃園縣,龜山鄉,楓樹村,0,1,1212,18,1230,1834,3,1,3,0,1,0,67.07
桃園縣,八德市,興仁里,0,1,1491,27,1518,2343,3,1,3,0,1,0,64.79
桃園縣,八德市,福興里,0,1,1573,47,1620,2243,3,1,3,0,1,0,72.22
桃園縣,八德市,瑞豐里,0,1,1977,38,2015,2829,3,1,3,0,1,0,71.23
桃園縣,八德市,瑞泰里,0,1,1658,24,1682,2610,3,1,3,0,1,0,64.44
桃園縣,八德市,瑞發里,0,1,2135,33,2168,3025,3,1,3,0,1,0,71.67
桃園縣,八德市,瑞德里,0,1,2066,38,2104,2916,3,1,3,0,1,0,72.15
桃園縣,八德市,瑞祥里,0,1,1921,28,1949,2684,3,1,3,0,1,0,72.62
桃園縣,八德市,廣興里,0,1,2208,53,2261,3318,3,1,3,0,1,0,68.14
桃園縣,八德市,廣隆里,0,1,1814,31,1845,2517,3,1,3,0,1,0,73.30
桃園縣,八德市,竹園里,0,1,1414,27,1441,2161,3,1,3,0,1,0,66.68
桃園縣,八德市,霄裡里,0,1,2513,60,2573,3624,3,1,3,0,1,0,71.00
桃園縣,八德市,茄苳里,0,1,3029,66,3095,4697,3,1,3,0,1,0,65.89
桃園縣,八德市,高明里,0,1,2870,53,2923,4357,3,1,3,0,1,0,67.09
桃園縣,八德市,白鷺里,0,1,1278,33,1311,1826,3,1,3,0,1,0,71.80
桃園縣,八德市,大湳里,0,1,1223,20,1243,2016,3,1,3,0,1,0,61.66
桃園縣,八德市,大發里,0,1,883,7,890,1267,3,1,3,0,1,0,70.24
桃園縣,八德市,大仁里,0,1,1590,31,1621,2502,3,1,3,0,1,0,64.79
桃園縣,八德市,大明里,0,1,1094,19,1113,1832,3,1,3,0,1,0,60.75
桃園縣,八德市,大安里,0,1,806,20,826,1173,3,1,3,0,1,0,70.42
桃園縣,八德市,大竹里,0,1,713,7,720,1059,3,1,3,0,1,0,67.99
桃園縣,八德市,大興里,0,1,1981,38,2019,3082,3,1,3,0,1,0,65.51
桃園縣,八德市,大華里,0,1,2299,37,2336,3466,3,1,3,0,1,0,67.40
桃園縣,八德市,大信里,0,1,3673,78,3751,5989,3,1,3,0,1,0,62.63
桃園縣,八德市,大和里,0,1,1118,18,1136,1706,3,1,3,0,1,0,66.59
桃園縣,八德市,大昌里,0,1,1573,28,1601,2365,3,1,3,0,1,0,67.70
桃園縣,八德市,大同里,0,1,1483,25,1508,2073,3,1,3,0,1,0,72.74
桃園縣,八德市,大成里,0,1,3019,50,3069,4517,3,1,3,0,1,0,67.94
桃園縣,八德市,大義里,0,1,2655,30,2685,4001,3,1,3,0,1,0,67.11
桃園縣,八德市,大忠里,0,1,1249,19,1268,1797,3,1,3,0,1,0,70.56
桃園縣,八德市,大智里,0,1,2438,33,2471,3532,3,1,3,0,1,0,69.96
桃園縣,八德市,大正里,0,1,1573,28,1601,2315,3,1,3,0,1,0,69.16
桃園縣,八德市,大福里,0,1,1648,24,1672,2542,3,1,3,0,1,0,65.77
桃園縣,八德市,大強里,0,1,1316,22,1338,1934,3,1,3,0,1,0,69.18
桃園縣,八德市,大勇里,0,1,1831,31,1862,2738,3,1,3,0,1,0,68.01
桃園縣,蘆竹鄉,新興村,0,1,1567,25,1592,2371,3,1,3,0,1,0,67.14
桃園縣,蘆竹鄉,中福村,0,1,1487,29,1516,2148,3,1,3,0,1,0,70.58
桃園縣,蘆竹鄉,新莊村,0,1,1610,28,1638,2295,3,1,3,0,1,0,71.37
桃園縣,蘆竹鄉,富竹村,0,1,574,9,583,790,3,1,3,0,1,0,73.80
桃園縣,蘆竹鄉,上竹村,0,1,1019,14,1033,1471,3,1,3,0,1,0,70.22
桃園縣,蘆竹鄉,大竹村,0,1,1168,28,1196,1702,3,1,3,0,1,0,70.27
桃園縣,蘆竹鄉,宏竹村,0,1,1235,17,1252,1753,3,1,3,0,1,0,71.42
桃園縣,蘆竹鄉,大華村,0,1,1468,25,1493,1861,3,1,3,0,1,0,80.23
桃園縣,蘆竹鄉,蘆竹村,0,1,1937,35,1972,2666,3,1,3,0,1,0,73.97
桃園縣,蘆竹鄉,南崁村,0,1,1215,23,1238,1816,3,1,3,0,1,0,68.17
桃園縣,蘆竹鄉,南榮村,0,1,930,18,948,1464,3,1,3,0,1,0,64.75
桃園縣,蘆竹鄉,南興村,0,1,1222,29,1251,1875,3,1,3,0,1,0,66.72
桃園縣,蘆竹鄉,錦興村,0,1,1210,25,1235,1900,3,1,3,0,1,0,65.00
桃園縣,蘆竹鄉,錦中村,0,1,1042,22,1064,1551,3,1,3,0,1,0,68.60
桃園縣,蘆竹鄉,長興村,0,1,591,11,602,897,3,1,3,0,1,0,67.11
桃園縣,蘆竹鄉,五福村,0,1,2314,40,2354,3883,3,1,3,0,1,0,60.62
桃園縣,蘆竹鄉,內厝村,0,1,1116,16,1132,1579,3,1,3,0,1,0,71.69
桃園縣,蘆竹鄉,山鼻村,0,1,769,12,781,1155,3,1,3,0,1,0,67.62
桃園縣,蘆竹鄉,坑子村,0,1,1013,13,1026,1511,3,1,3,0,1,0,67.90
桃園縣,蘆竹鄉,外社村,0,1,822,12,834,1155,3,1,3,0,1,0,72.21
桃園縣,蘆竹鄉,山腳村,0,1,1896,46,1942,2720,3,1,3,0,1,0,71.40
桃園縣,蘆竹鄉,坑口村,0,1,1363,20,1383,1888,3,1,3,0,1,0,73.25
桃園縣,蘆竹鄉,海湖村,0,1,1721,31,1752,2541,3,1,3,0,1,0,68.95
桃園縣,大園鄉,大園村,0,1,3465,52,3517,4676,3,1,3,0,1,0,75.21
桃園縣,大園鄉,田心村,0,1,2418,21,2439,3430,3,1,3,0,1,0,71.11
桃園縣,大園鄉,溪海村,0,1,1440,26,1466,2174,3,1,3,0,1,0,67.43
桃園縣,大園鄉,和平村,0,1,968,8,976,1393,3,1,3,0,1,0,70.06
桃園縣,大園鄉,橫峰村,0,1,2860,39,2899,4233,3,1,3,0,1,0,68.49
桃園縣,大園鄉,五權村,0,1,2070,35,2105,2942,3,1,3,0,1,0,71.55
桃園縣,大園鄉,埔心村,0,1,2569,44,2613,3640,3,1,3,0,1,0,71.79
桃園縣,大園鄉,大海村,0,1,877,13,890,1178,3,1,3,0,1,0,75.55
桃園縣,大園鄉,建華村,0,1,779,12,791,984,3,1,3,0,1,0,80.39
桃園縣,大園鄉,三石村,0,1,1639,23,1662,2181,3,1,3,0,1,0,76.20
桃園縣,大園鄉,菓林村,0,1,2279,43,2322,3383,3,1,3,0,1,0,68.64
桃園縣,大園鄉,竹圍村,0,1,1447,11,1458,2068,3,1,3,0,1,0,70.50
桃園縣,大園鄉,海口村,0,1,854,22,876,1261,3,1,3,0,1,0,69.47
桃園縣,大園鄉,沙崙村,0,1,1421,22,1443,2147,3,1,3,0,1,0,67.21
桃園縣,大園鄉,后厝村,0,1,855,12,867,1244,3,1,3,0,1,0,69.69
桃園縣,大園鄉,圳頭村,0,1,1160,17,1177,1683,3,1,3,0,1,0,69.93
桃園縣,大園鄉,內海村,0,1,1125,13,1138,1609,3,1,3,0,1,0,70.73
桃園縣,大園鄉,北港村,0,1,952,13,965,1393,3,1,3,0,1,0,69.27
桃園縣,大園鄉,南港村,0,1,1017,9,1026,1593,3,1,3,0,1,0,64.41
桃園縣,大溪鎮,興和里,0,1,1180,12,1192,1710,3,1,3,0,1,0,69.71
桃園縣,大溪鎮,福仁里,0,1,796,15,811,1148,3,1,3,0,1,0,70.64
桃園縣,大溪鎮,一心里,0,1,3603,57,3660,5467,3,1,3,0,1,0,66.95
桃園縣,大溪鎮,一德里,0,1,2105,32,2137,3286,3,1,3,0,1,0,65.03
桃園縣,大溪鎮,月眉里,0,1,644,15,659,964,3,1,3,0,1,0,68.36
桃園縣,大溪鎮,永福里,0,1,601,10,611,891,3,1,3,0,1,0,68.57
桃園縣,大溪鎮,康安里,0,1,690,11,701,993,3,1,3,0,1,0,70.59
桃園縣,大溪鎮,義和里,0,1,1067,13,1080,1582,3,1,3,0,1,0,68.27
桃園縣,大溪鎮,美華里,0,1,1366,27,1393,2178,3,1,3,0,1,0,63.96
桃園縣,大溪鎮,福安里,0,1,1405,18,1423,2091,3,1,3,0,1,0,68.05
桃園縣,大溪鎮,復興里,0,1,586,16,602,950,3,1,3,0,1,0,63.37
桃園縣,大溪鎮,新峰里,0,1,645,11,656,1003,3,1,3,0,1,0,65.40
桃園縣,大溪鎮,中新里,0,1,1038,24,1062,1544,3,1,3,0,1,0,68.78
桃園縣,大溪鎮,瑞興里,0,1,1300,31,1331,1912,3,1,3,0,1,0,69.61
桃園縣,大溪鎮,仁善里,0,1,1474,30,1504,2199,3,1,3,0,1,0,68.39
桃園縣,大溪鎮,僑愛里,0,1,1107,13,1120,1446,3,1,3,0,1,0,77.46
桃園縣,大溪鎮,仁義里,0,1,1885,53,1938,2691,3,1,3,0,1,0,72.02
桃園縣,大溪鎮,仁愛里,0,1,2178,44,2222,3258,3,1,3,0,1,0,68.20
桃園縣,大溪鎮,仁武里,0,1,3632,55,3687,5335,3,1,3,0,1,0,69.11
桃園縣,大溪鎮,南興里,0,1,2306,50,2356,3398,3,1,3,0,1,0,69.33
桃園縣,大溪鎮,員林里,0,1,3662,56,3718,5155,3,1,3,0,1,0,72.12
桃園縣,大溪鎮,瑞源里,0,1,1607,22,1629,2437,3,1,3,0,1,0,66.84
桃園縣,復興鄉,三民村,0,1,711,12,723,1228,3,1,3,0,1,0,58.88
桃園縣,復興鄉,澤仁村,0,1,411,2,413,604,3,1,3,0,1,0,68.38
桃園縣,復興鄉,長興村,0,1,67,1,68,121,3,1,3,0,1,0,56.20
桃園縣,復興鄉,奎輝村,0,1,23,0,23,41,3,1,3,0,1,0,56.10
桃園縣,復興鄉,羅浮村,0,1,183,1,184,302,3,1,3,0,1,0,60.93
桃園縣,復興鄉,霞雲村,0,1,23,0,23,40,3,1,3,0,1,0,57.50
桃園縣,復興鄉,義盛村,0,1,26,1,27,42,3,1,3,0,1,0,64.29
桃園縣,復興鄉,高義村,0,1,25,1,26,53,3,1,3,0,1,0,49.06
桃園縣,復興鄉,三光村,0,1,26,0,26,58,3,1,3,0,1,0,44.83
桃園縣,復興鄉,華陵村,0,1,89,0,89,231,3,1,3,0,1,0,38.53
桃園縣,中壢市,後寮里,0,1,4556,66,4622,6927,3,1,3,0,1,0,66.72
桃園縣,中壢市,龍興里,0,1,3894,57,3951,5672,3,1,3,0,1,0,69.66
桃園縣,中壢市,龍岡里,0,1,2362,45,2407,3336,3,1,3,0,1,0,72.15
桃園縣,中壢市,龍東里,0,1,2789,46,2835,3882,3,1,3,0,1,0,73.03
桃園縣,中壢市,龍昌里,0,1,2524,52,2576,3605,3,1,3,0,1,0,71.46
桃園縣,中壢市,龍平里,0,1,3855,71,3926,5375,3,1,3,0,1,0,73.04
桃園縣,中壢市,仁美里,0,1,3718,71,3789,5431,3,1,3,0,1,0,69.77
桃園縣,中壢市,仁愛里,0,1,2009,42,2051,3045,3,1,3,0,1,0,67.36
桃園縣,中壢市,仁德里,0,1,2463,47,2510,3664,3,1,3,0,1,0,68.50
桃園縣,中壢市,仁祥里,0,1,3394,58,3452,5052,3,1,3,0,1,0,68.33
桃園縣,中壢市,中堅里,0,1,2745,48,2793,3750,3,1,3,0,1,0,74.48
桃園縣,中壢市,普仁里,0,1,4476,64,4540,6890,3,1,3,0,1,0,65.89
桃園縣,中壢市,普慶里,0,1,1552,24,1576,2342,3,1,3,0,1,0,67.29
桃園縣,中壢市,普義里,0,1,3704,53,3757,5506,3,1,3,0,1,0,68.23
桃園縣,中壢市,信義里,0,1,3622,44,3666,5535,3,1,3,0,1,0,66.23
桃園縣,中壢市,忠義里,0,1,946,13,959,1447,3,1,3,0,1,0,66.28
桃園縣,中壢市,興仁里,0,1,2406,38,2444,3537,3,1,3,0,1,0,69.10
桃園縣,中壢市,中正里,0,1,2737,44,2781,4102,3,1,3,0,1,0,67.80
桃園縣,中壢市,篤行里,0,1,1089,22,1111,1514,3,1,3,0,1,0,73.38
桃園縣,中壢市,內壢里,0,1,1773,39,1812,2530,3,1,3,0,1,0,71.62
桃園縣,中壢市,成功里,0,1,3162,41,3203,4598,3,1,3,0,1,0,69.66
桃園縣,中壢市,中原里,0,1,3408,51,3459,4819,3,1,3,0,1,0,71.78
桃園縣,中壢市,復興里,0,1,3834,54,3888,5609,3,1,3,0,1,0,69.32
桃園縣,中壢市,文化里,0,1,3320,68,3388,5000,3,1,3,0,1,0,67.76
桃園縣,中壢市,自立里,0,1,2142,23,2165,2831,3,1,3,0,1,0,76.47
桃園縣,中壢市,自強里,0,1,3250,35,3285,4399,3,1,3,0,1,0,74.68
桃園縣,中壢市,內定里,0,1,1640,28,1668,2298,3,1,3,0,1,0,72.58
桃園縣,中壢市,石頭里,0,1,1213,24,1237,2039,3,1,3,0,1,0,60.67
桃園縣,中壢市,中央里,0,1,2303,31,2334,3468,3,1,3,0,1,0,67.30
桃園縣,中壢市,新興里,0,1,2747,41,2788,4060,3,1,3,0,1,0,68.67
桃園縣,中壢市,振興里,0,1,2332,47,2379,3368,3,1,3,0,1,0,70.64
桃園縣,中壢市,東興里,0,1,3138,37,3175,4698,3,1,3,0,1,0,67.58
桃園縣,中壢市,水尾里,0,1,2188,25,2213,3312,3,1,3,0,1,0,66.82
桃園縣,中壢市,忠福里,0,1,6183,88,6271,9743,3,1,3,0,1,0,64.36
桃園縣,中壢市,青埔里,0,1,920,9,929,1283,3,1,3,0,1,0,72.41
桃園縣,中壢市,新街里,0,1,1189,15,1204,1762,3,1,3,0,1,0,68.33
桃園縣,中壢市,興南里,0,1,980,18,998,1493,3,1,3,0,1,0,66.85
桃園縣,中壢市,興國里,0,1,2755,27,2782,4198,3,1,3,0,1,0,66.27
桃園縣,中壢市,興和里,0,1,1583,27,1610,2285,3,1,3,0,1,0,70.46
桃園縣,中壢市,永興里,0,1,689,14,703,1099,3,1,3,0,1,0,63.97
桃園縣,中壢市,中壢里,0,1,644,11,655,979,3,1,3,0,1,0,66.91
桃園縣,中壢市,中榮里,0,1,752,6,758,1190,3,1,3,0,1,0,63.70
桃園縣,中壢市,中建里,0,1,803,2,805,1145,3,1,3,0,1,0,70.31
桃園縣,中壢市,舊明里,0,1,1615,19,1634,2276,3,1,3,0,1,0,71.79
桃園縣,中壢市,新明里,0,1,2348,33,2381,3528,3,1,3,0,1,0,67.49
桃園縣,中壢市,光明里,0,1,2743,35,2778,4147,3,1,3,0,1,0,66.99
桃園縣,中壢市,永光里,0,1,1737,22,1759,2616,3,1,3,0,1,0,67.24
桃園縣,中壢市,三民里,0,1,1527,25,1552,2309,3,1,3,0,1,0,67.22
桃園縣,中壢市,五權里,0,1,4317,81,4398,6716,3,1,3,0,1,0,65.49
桃園縣,中壢市,芝芭里,0,1,1280,19,1299,1776,3,1,3,0,1,0,73.14
桃園縣,中壢市,洽溪里,0,1,905,28,933,1277,3,1,3,0,1,0,73.06
桃園縣,中壢市,內厝里,0,1,1854,27,1881,2795,3,1,3,0,1,0,67.30
桃園縣,中壢市,月眉里,0,1,1674,20,1694,2382,3,1,3,0,1,0,71.12
桃園縣,中壢市,山東里,0,1,1644,35,1679,2398,3,1,3,0,1,0,70.02
桃園縣,中壢市,過嶺里,0,1,1445,16,1461,2105,3,1,3,0,1,0,69.41
桃園縣,平鎮市,新勢里,0,1,2058,30,2088,3021,3,1,3,0,1,0,69.12
桃園縣,平鎮市,新榮里,0,1,1892,39,1931,2713,3,1,3,0,1,0,71.18
桃園縣,平鎮市,新富里,0,1,1537,19,1556,2400,3,1,3,0,1,0,64.83
桃園縣,平鎮市,北華里,0,1,1187,21,1208,1728,3,1,3,0,1,0,69.91
桃園縣,平鎮市,北安里,0,1,1106,16,1122,1581,3,1,3,0,1,0,70.97
桃園縣,平鎮市,北勢里,0,1,1467,14,1481,2084,3,1,3,0,1,0,71.07
桃園縣,平鎮市,新貴里,0,1,1524,22,1546,2255,3,1,3,0,1,0,68.56
桃園縣,平鎮市,金陵里,0,1,1106,9,1115,1481,3,1,3,0,1,0,75.29
桃園縣,平鎮市,北興里,0,1,1961,32,1993,2834,3,1,3,0,1,0,70.32
桃園縣,平鎮市,北貴里,0,1,1744,21,1765,2430,3,1,3,0,1,0,72.63
桃園縣,平鎮市,北富里,0,1,1325,19,1344,1927,3,1,3,0,1,0,69.75
桃園縣,平鎮市,龍恩里,0,1,1660,48,1708,2391,3,1,3,0,1,0,71.43
桃園縣,平鎮市,東社里,0,1,1999,35,2034,2776,3,1,3,0,1,0,73.27
桃園縣,平鎮市,龍興里,0,1,1513,39,1552,2217,3,1,3,0,1,0,70.00
桃園縣,平鎮市,忠貞里,0,1,963,26,989,1339,3,1,3,0,1,0,73.86
桃園縣,平鎮市,中正里,0,1,903,12,915,1198,3,1,3,0,1,0,76.38
桃園縣,平鎮市,貿易里,0,1,1837,41,1878,2417,3,1,3,0,1,0,77.70
桃園縣,平鎮市,建安里,0,1,1755,28,1783,2559,3,1,3,0,1,0,69.68
桃園縣,平鎮市,華安里,0,1,1748,41,1789,2505,3,1,3,0,1,0,71.42
桃園縣,平鎮市,東安里,0,1,1335,25,1360,1917,3,1,3,0,1,0,70.94
桃園縣,平鎮市,新安里,0,1,1510,35,1545,2217,3,1,3,0,1,0,69.69
桃園縣,平鎮市,東勢里,0,1,2046,34,2080,2998,3,1,3,0,1,0,69.38
桃園縣,平鎮市,莊敬里,0,1,2548,47,2595,3759,3,1,3,0,1,0,69.03
桃園縣,平鎮市,湧豐里,0,1,895,18,913,1273,3,1,3,0,1,0,71.72
桃園縣,平鎮市,湧光里,0,1,2751,60,2811,3916,3,1,3,0,1,0,71.78
桃園縣,平鎮市,湧安里,0,1,1530,23,1553,2329,3,1,3,0,1,0,66.68
桃園縣,平鎮市,廣興里,0,1,2069,32,2101,3024,3,1,3,0,1,0,69.48
桃園縣,平鎮市,廣達里,0,1,1835,18,1853,2700,3,1,3,0,1,0,68.63
桃園縣,平鎮市,復旦里,0,1,2507,46,2553,3907,3,1,3,0,1,0,65.34
桃園縣,平鎮市,義興里,0,1,2468,49,2517,3695,3,1,3,0,1,0,68.12
桃園縣,平鎮市,義民里,0,1,1741,30,1771,2682,3,1,3,0,1,0,66.03
桃園縣,平鎮市,宋屋里,0,1,1581,29,1610,2385,3,1,3,0,1,0,67.51
桃園縣,平鎮市,廣仁里,0,1,1871,40,1911,3019,3,1,3,0,1,0,63.30
桃園縣,平鎮市,雙連里,0,1,2089,40,2129,3084,3,1,3,0,1,0,69.03
桃園縣,平鎮市,高雙里,0,1,1396,13,1409,2119,3,1,3,0,1,0,66.49
桃園縣,平鎮市,平鎮里,0,1,1991,46,2037,2902,3,1,3,0,1,0,70.19
桃園縣,平鎮市,鎮興里,0,1,1353,25,1378,1931,3,1,3,0,1,0,71.36
桃園縣,平鎮市,金星里,0,1,3485,64,3549,5279,3,1,3,0,1,0,67.23
桃園縣,平鎮市,南勢里,0,1,1858,22,1880,2773,3,1,3,0,1,0,67.80
桃園縣,平鎮市,福林里,0,1,1304,28,1332,1796,3,1,3,0,1,0,74.16
桃園縣,平鎮市,山峰里,0,1,1478,29,1507,2182,3,1,3,0,1,0,69.07
桃園縣,楊梅鎮,仁美里,0,1,2547,42,2589,3669,3,1,3,0,1,0,70.56
桃園縣,楊梅鎮,埔心里,0,1,1125,19,1144,1580,3,1,3,0,1,0,72.41
桃園縣,楊梅鎮,光華里,0,1,1761,34,1795,2485,3,1,3,0,1,0,72.23
桃園縣,楊梅鎮,金龍里,0,1,1247,24,1271,1661,3,1,3,0,1,0,76.52
桃園縣,楊梅鎮,四維里,0,1,1267,16,1283,1722,3,1,3,0,1,0,74.51
桃園縣,楊梅鎮,瑞塘里,0,1,3359,58,3417,5269,3,1,3,0,1,0,64.85
桃園縣,楊梅鎮,梅溪里,0,1,3087,50,3137,4993,3,1,3,0,1,0,62.83
桃園縣,楊梅鎮,大同里,0,1,2589,41,2630,3731,3,1,3,0,1,0,70.49
桃園縣,楊梅鎮,楊梅里,0,1,1950,22,1972,2745,3,1,3,0,1,0,71.84
桃園縣,楊梅鎮,楊江里,0,1,794,7,801,1140,3,1,3,0,1,0,70.26
桃園縣,楊梅鎮,梅新里,0,1,1044,19,1063,1639,3,1,3,0,1,0,64.86
桃園縣,楊梅鎮,紅梅里,0,1,1381,25,1406,2047,3,1,3,0,1,0,68.69
桃園縣,楊梅鎮,永寧里,0,1,2037,34,2071,2904,3,1,3,0,1,0,71.32
桃園縣,楊梅鎮,大平里,0,1,3565,66,3631,5243,3,1,3,0,1,0,69.25
桃園縣,楊梅鎮,東流里,0,1,998,16,1014,1406,3,1,3,0,1,0,72.12
桃園縣,楊梅鎮,豐野里,0,1,1810,31,1841,2721,3,1,3,0,1,0,67.66
桃園縣,楊梅鎮,富岡里,0,1,2569,44,2613,3844,3,1,3,0,1,0,67.98
桃園縣,楊梅鎮,員本里,0,1,956,21,977,1488,3,1,3,0,1,0,65.66
桃園縣,楊梅鎮,三湖里,0,1,1035,14,1049,1497,3,1,3,0,1,0,70.07
桃園縣,楊梅鎮,上湖里,0,1,1465,38,1503,2347,3,1,3,0,1,0,64.04
桃園縣,楊梅鎮,上田里,0,1,1192,22,1214,1842,3,1,3,0,1,0,65.91
桃園縣,楊梅鎮,高山里,0,1,2054,48,2102,3349,3,1,3,0,1,0,62.77
桃園縣,楊梅鎮,高榮里,0,1,2825,54,2879,4372,3,1,3,0,1,0,65.85
桃園縣,楊梅鎮,水美里,0,1,1813,33,1846,2678,3,1,3,0,1,0,68.93
桃園縣,楊梅鎮,瑞原里,0,1,1626,36,1662,2518,3,1,3,0,1,0,66.00
桃園縣,龍潭鄉,黃唐村,0,1,3161,52,3213,4772,3,1,3,0,1,0,67.33
桃園縣,龍潭鄉,中山村,0,1,2257,24,2281,3115,3,1,3,0,1,0,73.23
桃園縣,龍潭鄉,烏林村,0,1,2873,57,2930,4247,3,1,3,0,1,0,68.99
桃園縣,龍潭鄉,干城村,0,1,574,11,585,735,3,1,3,0,1,0,79.59
桃園縣,龍潭鄉,凌雲村,0,1,3219,42,3261,4685,3,1,3,0,1,0,69.61
桃園縣,龍潭鄉,八德村,0,1,2809,50,2859,4320,3,1,3,0,1,0,66.18
桃園縣,龍潭鄉,上林村,0,1,1329,30,1359,1979,3,1,3,0,1,0,68.67
桃園縣,龍潭鄉,龍潭村,0,1,1489,12,1501,2022,3,1,3,0,1,0,74.23
桃園縣,龍潭鄉,中正村,0,1,3700,65,3765,5283,3,1,3,0,1,0,71.27
桃園縣,龍潭鄉,九龍村,0,1,2266,48,2314,3497,3,1,3,0,1,0,66.17
桃園縣,龍潭鄉,中興村,0,1,4332,98,4430,6485,3,1,3,0,1,0,68.31
桃園縣,龍潭鄉,佳安村,0,1,1973,18,1991,2709,3,1,3,0,1,0,73.50
桃園縣,龍潭鄉,三坑村,0,1,840,14,854,1264,3,1,3,0,1,0,67.56
桃園縣,龍潭鄉,大平村,0,1,488,7,495,759,3,1,3,0,1,0,65.22
桃園縣,龍潭鄉,三林村,0,1,4341,48,4389,6007,3,1,3,0,1,0,73.06
桃園縣,龍潭鄉,高平村,0,1,1211,23,1234,1810,3,1,3,0,1,0,68.18
桃園縣,龍潭鄉,高原村,0,1,1253,23,1276,1855,3,1,3,0,1,0,68.79
桃園縣,龍潭鄉,三和村,0,1,579,13,592,818,3,1,3,0,1,0,72.37
桃園縣,龍潭鄉,三水村,0,1,492,8,500,653,3,1,3,0,1,0,76.57
桃園縣,新屋鄉,新屋村,0,1,1626,17,1643,2257,3,1,3,0,1,0,72.80
桃園縣,新屋鄉,新生村,0,1,1929,21,1950,2615,3,1,3,0,1,0,74.57
桃園縣,新屋鄉,後湖村,0,1,757,10,767,1036,3,1,3,0,1,0,74.03
桃園縣,新屋鄉,清華村,0,1,1717,24,1741,2429,3,1,3,0,1,0,71.68
桃園縣,新屋鄉,石磊村,0,1,1109,13,1122,1525,3,1,3,0,1,0,73.57
桃園縣,新屋鄉,東明村,0,1,742,10,752,1017,3,1,3,0,1,0,73.94
桃園縣,新屋鄉,社子村,0,1,972,12,984,1303,3,1,3,0,1,0,75.52
桃園縣,新屋鄉,埔頂村,0,1,1190,22,1212,1783,3,1,3,0,1,0,67.98
桃園縣,新屋鄉,九斗村,0,1,1088,15,1103,1565,3,1,3,0,1,0,70.48
桃園縣,新屋鄉,頭洲村,0,1,1704,34,1738,2493,3,1,3,0,1,0,69.72
桃園縣,新屋鄉,大坡村,0,1,953,9,962,1370,3,1,3,0,1,0,70.22
桃園縣,新屋鄉,望間村,0,1,1110,10,1120,1536,3,1,3,0,1,0,72.92
桃園縣,新屋鄉,後庄村,0,1,749,16,765,1127,3,1,3,0,1,0,67.88
桃園縣,新屋鄉,蚵間村,0,1,527,11,538,796,3,1,3,0,1,0,67.59
桃園縣,新屋鄉,深圳村,0,1,473,6,479,716,3,1,3,0,1,0,66.90
桃園縣,新屋鄉,康榔村,0,1,725,2,727,1079,3,1,3,0,1,0,67.38
桃園縣,新屋鄉,笨港村,0,1,771,18,789,1102,3,1,3,0,1,0,71.60
桃園縣,新屋鄉,永安村,0,1,1485,9,1494,2063,3,1,3,0,1,0,72.42
桃園縣,新屋鄉,永興村,0,1,546,5,551,939,3,1,3,0,1,0,58.68
桃園縣,新屋鄉,下埔村,0,1,501,10,511,737,3,1,3,0,1,0,69.34
桃園縣,新屋鄉,石牌村,0,1,594,5,599,827,3,1,3,0,1,0,72.43
桃園縣,新屋鄉,下田村,0,1,1022,12,1034,1433,3,1,3,0,1,0,72.16
桃園縣,新屋鄉,赤欄村,0,1,728,16,744,1032,3,1,3,0,1,0,72.09
桃園縣,觀音鄉,觀音村,0,1,1503,24,1527,2138,3,1,3,0,1,0,71.42
桃園縣,觀音鄉,白玉村,0,1,819,11,830,1150,3,1,3,0,1,0,72.17
桃園縣,觀音鄉,廣興村,0,1,844,15,859,1280,3,1,3,0,1,0,67.11
桃園縣,觀音鄉,大潭村,0,1,763,12,775,1084,3,1,3,0,1,0,71.49
桃園縣,觀音鄉,保生村,0,1,1015,19,1034,1376,3,1,3,0,1,0,75.15
桃園縣,觀音鄉,武威村,0,1,477,8,485,688,3,1,3,0,1,0,70.49
桃園縣,觀音鄉,三和村,0,1,552,6,558,736,3,1,3,0,1,0,75.82
桃園縣,觀音鄉,新興村,0,1,470,9,479,675,3,1,3,0,1,0,70.96
桃園縣,觀音鄉,坑尾村,0,1,763,13,776,1032,3,1,3,0,1,0,75.19
桃園縣,觀音鄉,金湖村,0,1,1003,18,1021,1508,3,1,3,0,1,0,67.71
桃園縣,觀音鄉,藍埔村,0,1,1080,15,1095,1540,3,1,3,0,1,0,71.10
桃園縣,觀音鄉,大同村,0,1,980,8,988,1465,3,1,3,0,1,0,67.44
桃園縣,觀音鄉,大堀村,0,1,585,10,595,862,3,1,3,0,1,0,69.03
桃園縣,觀音鄉,崙坪村,0,1,2025,35,2060,3011,3,1,3,0,1,0,68.42
桃園縣,觀音鄉,富源村,0,1,955,13,968,1447,3,1,3,0,1,0,66.90
桃園縣,觀音鄉,上大村,0,1,890,9,899,1289,3,1,3,0,1,0,69.74
桃園縣,觀音鄉,新坡村,0,1,1601,14,1615,2440,3,1,3,0,1,0,66.19
桃園縣,觀音鄉,廣福村,0,1,1116,19,1135,1614,3,1,3,0,1,0,70.32
桃園縣,觀音鄉,保障村,0,1,1709,23,1732,2454,3,1,3,0,1,0,70.58
桃園縣,觀音鄉,草漯村,0,1,1647,19,1666,2492,3,1,3,0,1,0,66.85
桃園縣,觀音鄉,樹林村,0,1,854,18,872,1370,3,1,3,0,1,0,63.65
桃園縣,觀音鄉,富林村,0,1,830,14,844,1206,3,1,3,0,1,0,69.98
新竹縣,竹北市,鹿場里,0,1,682,13,695,943,3,1,3,0,1,0,73.70
新竹縣,竹北市,東平里,0,1,343,6,349,433,3,1,3,0,1,0,80.60
新竹縣,竹北市,中興里,0,1,829,19,848,1184,3,1,3,0,1,0,71.62
新竹縣,竹北市,隘口里,0,1,527,4,531,738,3,1,3,0,1,0,71.95
新竹縣,竹北市,東海里,0,1,1426,16,1442,2104,3,1,3,0,1,0,68.54
新竹縣,竹北市,十興里,0,1,2260,44,2304,3384,3,1,3,0,1,0,68.09
新竹縣,竹北市,斗崙里,0,1,3264,59,3323,5316,3,1,3,0,1,0,62.51
新竹縣,竹北市,竹北里,0,1,1461,23,1484,2381,3,1,3,0,1,0,62.33
新竹縣,竹北市,竹仁里,0,1,2675,42,2717,4512,3,1,3,0,1,0,60.22
新竹縣,竹北市,竹義里,0,1,3467,56,3523,5624,3,1,3,0,1,0,62.64
新竹縣,竹北市,泰和里,0,1,1638,16,1654,2623,3,1,3,0,1,0,63.06
新竹縣,竹北市,新社里,0,1,2040,42,2082,3640,3,1,3,0,1,0,57.20
新竹縣,竹北市,新國里,0,1,1484,28,1512,2695,3,1,3,0,1,0,56.10
新竹縣,竹北市,聯興里,0,1,1425,33,1458,2257,3,1,3,0,1,0,64.60
新竹縣,竹北市,麻園里,0,1,667,18,685,991,3,1,3,0,1,0,69.12
新竹縣,竹北市,溪州里,0,1,777,17,794,1400,3,1,3,0,1,0,56.71
新竹縣,竹北市,新庄里,0,1,437,9,446,713,3,1,3,0,1,0,62.55
新竹縣,竹北市,白地里,0,1,771,22,793,1347,3,1,3,0,1,0,58.87
新竹縣,竹北市,新港里,0,1,538,12,550,962,3,1,3,0,1,0,57.17
新竹縣,竹北市,大眉里,0,1,662,19,681,1194,3,1,3,0,1,0,57.04
新竹縣,竹北市,大義里,0,1,717,9,726,1188,3,1,3,0,1,0,61.11
新竹縣,竹北市,尚義里,0,1,730,9,739,1241,3,1,3,0,1,0,59.55
新竹縣,竹北市,崇義里,0,1,796,4,800,1324,3,1,3,0,1,0,60.42
新竹縣,竹東鎮,上坪里,0,1,325,2,327,464,3,1,3,0,1,0,70.47
新竹縣,竹東鎮,瑞峰里,0,1,235,3,238,359,3,1,3,0,1,0,66.30
新竹縣,竹東鎮,軟橋里,0,1,283,6,289,400,3,1,3,0,1,0,72.25
新竹縣,竹東鎮,員崠里,0,1,1085,15,1100,1626,3,1,3,0,1,0,67.65
新竹縣,竹東鎮,上舘里,0,1,3113,58,3171,4684,3,1,3,0,1,0,67.70
新竹縣,竹東鎮,東寧里,0,1,1701,22,1723,2550,3,1,3,0,1,0,67.57
新竹縣,竹東鎮,中正里,0,1,1014,19,1033,1440,3,1,3,0,1,0,71.74
新竹縣,竹東鎮,大鄉里,0,1,1883,36,1919,2733,3,1,3,0,1,0,70.22
新竹縣,竹東鎮,中山里,0,1,1376,14,1390,1922,3,1,3,0,1,0,72.32
新竹縣,竹東鎮,南華里,0,1,867,12,879,1201,3,1,3,0,1,0,73.19
新竹縣,竹東鎮,東華里,0,1,572,7,579,822,3,1,3,0,1,0,70.44
新竹縣,竹東鎮,商華里,0,1,1375,27,1402,2003,3,1,3,0,1,0,70.00
新竹縣,竹東鎮,鷄林里,0,1,2177,44,2221,3207,3,1,3,0,1,0,69.25
新竹縣,竹東鎮,仁愛里,0,1,1607,25,1632,2391,3,1,3,0,1,0,68.26
新竹縣,竹東鎮,竹東里,0,1,1122,14,1136,1526,3,1,3,0,1,0,74.44
新竹縣,竹東鎮,忠孝里,0,1,818,16,834,1246,3,1,3,0,1,0,66.93
新竹縣,竹東鎮,榮樂里,0,1,997,12,1009,1435,3,1,3,0,1,0,70.31
新竹縣,竹東鎮,榮華里,0,1,3264,59,3323,4871,3,1,3,0,1,0,68.22
新竹縣,竹東鎮,五豐里,0,1,2297,35,2332,3477,3,1,3,0,1,0,67.07
新竹縣,竹東鎮,陸豐里,0,1,308,3,311,439,3,1,3,0,1,0,70.84
新竹縣,竹東鎮,三重里,0,1,2465,42,2507,3784,3,1,3,0,1,0,66.25
新竹縣,竹東鎮,二重里,0,1,3253,58,3311,4950,3,1,3,0,1,0,66.89
新竹縣,竹東鎮,頭重里,0,1,2084,34,2118,3060,3,1,3,0,1,0,69.22
新竹縣,竹東鎮,員山里,0,1,897,20,917,1286,3,1,3,0,1,0,71.31
新竹縣,竹東鎮,柯湖里,0,1,462,8,470,705,3,1,3,0,1,0,66.67
新竹縣,新埔鎮,新埔里,0,1,702,7,709,976,3,1,3,0,1,0,72.64
新竹縣,新埔鎮,新生里,0,1,463,3,466,659,3,1,3,0,1,0,70.71
新竹縣,新埔鎮,新民里,0,1,681,12,693,1004,3,1,3,0,1,0,69.02
新竹縣,新埔鎮,田新里,0,1,1532,17,1549,2212,3,1,3,0,1,0,70.03
新竹縣,新埔鎮,旱坑里,0,1,1182,24,1206,1581,3,1,3,0,1,0,76.28
新竹縣,新埔鎮,五埔里,0,1,1082,24,1106,1572,3,1,3,0,1,0,70.36
新竹縣,新埔鎮,四座里,0,1,1661,33,1694,2470,3,1,3,0,1,0,68.58
新竹縣,新埔鎮,照門里,0,1,956,14,970,1393,3,1,3,0,1,0,69.63
新竹縣,新埔鎮,清水里,0,1,333,3,336,438,3,1,3,0,1,0,76.71
新竹縣,新埔鎮,鹿鳴里,0,1,467,7,474,712,3,1,3,0,1,0,66.57
新竹縣,新埔鎮,新北里,0,1,395,11,406,613,3,1,3,0,1,0,66.23
新竹縣,新埔鎮,巨埔里,0,1,736,19,755,1122,3,1,3,0,1,0,67.29
新竹縣,新埔鎮,內立里,0,1,739,15,754,1112,3,1,3,0,1,0,67.81
新竹縣,新埔鎮,寶石里,0,1,479,8,487,697,3,1,3,0,1,0,69.87
新竹縣,新埔鎮,文山里,0,1,2084,37,2121,3283,3,1,3,0,1,0,64.61
新竹縣,新埔鎮,上寮里,0,1,997,20,1017,1479,3,1,3,0,1,0,68.76
新竹縣,新埔鎮,下寮里,0,1,1100,17,1117,1603,3,1,3,0,1,0,69.68
新竹縣,新埔鎮,南平里,0,1,637,13,650,945,3,1,3,0,1,0,68.78
新竹縣,新埔鎮,北平里,0,1,475,4,479,647,3,1,3,0,1,0,74.03
新竹縣,關西鎮,東興里,0,1,443,6,449,618,3,1,3,0,1,0,72.65
新竹縣,關西鎮,西安里,0,1,1008,24,1032,1458,3,1,3,0,1,0,70.78
新竹縣,關西鎮,南雄里,0,1,503,8,511,737,3,1,3,0,1,0,69.34
新竹縣,關西鎮,北斗里,0,1,2228,25,2253,3299,3,1,3,0,1,0,68.29
新竹縣,關西鎮,北山里,0,1,533,8,541,764,3,1,3,0,1,0,70.81
新竹縣,關西鎮,仁安里,0,1,592,17,609,885,3,1,3,0,1,0,68.81
新竹縣,關西鎮,南山里,0,1,688,7,695,1038,3,1,3,0,1,0,66.96
新竹縣,關西鎮,東安里,0,1,1538,33,1571,2388,3,1,3,0,1,0,65.79
新竹縣,關西鎮,東山里,0,1,495,11,506,728,3,1,3,0,1,0,69.51
新竹縣,關西鎮,東光里,0,1,757,13,770,1109,3,1,3,0,1,0,69.43
新竹縣,關西鎮,南新里,0,1,655,13,668,1010,3,1,3,0,1,0,66.14
新竹縣,關西鎮,新富里,0,1,383,6,389,608,3,1,3,0,1,0,63.98
新竹縣,關西鎮,玉山里,0,1,340,4,344,546,3,1,3,0,1,0,63.00
新竹縣,關西鎮,金山里,0,1,422,6,428,671,3,1,3,0,1,0,63.79
新竹縣,關西鎮,錦山里,0,1,594,17,611,936,3,1,3,0,1,0,65.28
新竹縣,關西鎮,大同里,0,1,511,4,515,709,3,1,3,0,1,0,72.64
新竹縣,關西鎮,石光里,0,1,1223,19,1242,1839,3,1,3,0,1,0,67.54
新竹縣,關西鎮,東平里,0,1,639,18,657,991,3,1,3,0,1,0,66.30
新竹縣,關西鎮,上林里,0,1,603,7,610,864,3,1,3,0,1,0,70.60
新竹縣,關西鎮,新力里,0,1,412,7,419,601,3,1,3,0,1,0,69.72
新竹縣,關西鎮,南和里,0,1,535,6,541,768,3,1,3,0,1,0,70.44
新竹縣,湖口鄉,和興村,0,1,2669,44,2713,4146,3,1,3,0,1,0,65.44
新竹縣,湖口鄉,德盛村,0,1,1801,30,1831,2713,3,1,3,0,1,0,67.49
新竹縣,湖口鄉,愛勢村,0,1,2295,47,2342,3431,3,1,3,0,1,0,68.26
新竹縣,湖口鄉,仁勢村,0,1,519,10,529,812,3,1,3,0,1,0,65.15
新竹縣,湖口鄉,孝勢村,0,1,736,21,757,1066,3,1,3,0,1,0,71.01
新竹縣,湖口鄉,中勢村,0,1,2714,41,2755,4025,3,1,3,0,1,0,68.45
新竹縣,湖口鄉,信勢村,0,1,2842,46,2888,4278,3,1,3,0,1,0,67.51
新竹縣,湖口鄉,波羅村,0,1,518,4,522,812,3,1,3,0,1,0,64.29
新竹縣,湖口鄉,長嶺村,0,1,1294,40,1334,2014,3,1,3,0,1,0,66.24
新竹縣,湖口鄉,長安村,0,1,659,14,673,982,3,1,3,0,1,0,68.53
新竹縣,湖口鄉,湖口村,0,1,1283,25,1308,1948,3,1,3,0,1,0,67.15
新竹縣,湖口鄉,湖鏡村,0,1,1324,20,1344,1980,3,1,3,0,1,0,67.88
新竹縣,湖口鄉,湖南村,0,1,755,14,769,1243,3,1,3,0,1,0,61.87
新竹縣,湖口鄉,中興村,0,1,1969,47,2016,2876,3,1,3,0,1,0,70.10
新竹縣,湖口鄉,鳳凰村,0,1,2593,54,2647,4160,3,1,3,0,1,0,63.63
新竹縣,湖口鄉,鳳山村,0,1,1420,34,1454,2352,3,1,3,0,1,0,61.82
新竹縣,新豐鄉,福興村,0,1,540,11,551,747,3,1,3,0,1,0,73.76
新竹縣,新豐鄉,後湖村,0,1,1055,17,1072,1529,3,1,3,0,1,0,70.11
新竹縣,新豐鄉,青埔村,0,1,902,24,926,1261,3,1,3,0,1,0,73.43
新竹縣,新豐鄉,埔和村,0,1,1081,11,1092,1909,3,1,3,0,1,0,57.20
新竹縣,新豐鄉,坡頭村,0,1,453,9,462,717,3,1,3,0,1,0,64.44
新竹縣,新豐鄉,新豐村,0,1,1199,18,1217,1964,3,1,3,0,1,0,61.97
新竹縣,新豐鄉,瑞興村,0,1,756,13,769,1080,3,1,3,0,1,0,71.20
新竹縣,新豐鄉,中崙村,0,1,938,19,957,1467,3,1,3,0,1,0,65.24
新竹縣,新豐鄉,重興村,0,1,2797,57,2854,4648,3,1,3,0,1,0,61.40
新竹縣,新豐鄉,上坑村,0,1,692,8,700,1137,3,1,3,0,1,0,61.57
新竹縣,新豐鄉,鳳坑村,0,1,614,20,634,899,3,1,3,0,1,0,70.52
新竹縣,新豐鄉,員山村,0,1,3270,47,3317,5044,3,1,3,0,1,0,65.76
新竹縣,新豐鄉,松林村,0,1,1993,29,2022,3435,3,1,3,0,1,0,58.86
新竹縣,芎林鄉,華龍村,0,1,291,3,294,419,3,1,3,0,1,0,70.17
新竹縣,芎林鄉,五龍村,0,1,367,8,375,495,3,1,3,0,1,0,75.76
新竹縣,芎林鄉,秀湖村,0,1,498,12,510,738,3,1,3,0,1,0,69.11
新竹縣,芎林鄉,永興村,0,1,296,6,302,400,3,1,3,0,1,0,75.50
新竹縣,芎林鄉,石潭村,0,1,1352,30,1382,2068,3,1,3,0,1,0,66.83
新竹縣,芎林鄉,新鳳村,0,1,982,19,1001,1443,3,1,3,0,1,0,69.37
新竹縣,芎林鄉,中坑村,0,1,344,7,351,521,3,1,3,0,1,0,67.37
新竹縣,芎林鄉,水坑村,0,1,399,13,412,597,3,1,3,0,1,0,69.01
新竹縣,芎林鄉,文林村,0,1,1191,18,1209,1770,3,1,3,0,1,0,68.31
新竹縣,芎林鄉,芎林村,0,1,928,22,950,1357,3,1,3,0,1,0,70.01
新竹縣,芎林鄉,上山村,0,1,1295,19,1314,2011,3,1,3,0,1,0,65.34
新竹縣,芎林鄉,下山村,0,1,695,12,707,983,3,1,3,0,1,0,71.92
新竹縣,橫山鄉,橫山村,0,1,2177,38,2215,3219,3,1,3,0,1,0,68.81
新竹縣,橫山鄉,田寮村,0,1,584,6,590,821,3,1,3,0,1,0,71.86
新竹縣,橫山鄉,南昌村,0,1,97,1,98,139,3,1,3,0,1,0,70.50
新竹縣,橫山鄉,豐鄉村,0,1,96,0,96,128,3,1,3,0,1,0,75.00
新竹縣,橫山鄉,豐田村,0,1,215,4,219,317,3,1,3,0,1,0,69.09
新竹縣,橫山鄉,內灣村,0,1,796,16,812,1180,3,1,3,0,1,0,68.81
新竹縣,橫山鄉,力行村,0,1,573,17,590,847,3,1,3,0,1,0,69.66
新竹縣,橫山鄉,福興村,0,1,337,2,339,480,3,1,3,0,1,0,70.63
新竹縣,橫山鄉,沙坑村,0,1,809,12,821,1149,3,1,3,0,1,0,71.45
新竹縣,橫山鄉,新興村,0,1,1114,16,1130,1533,3,1,3,0,1,0,73.71
新竹縣,橫山鄉,大肚村,0,1,890,19,909,1289,3,1,3,0,1,0,70.52
新竹縣,北埔鄉,北埔村,0,1,749,9,758,1125,3,1,3,0,1,0,67.38
新竹縣,北埔鄉,南興村,0,1,922,17,939,1321,3,1,3,0,1,0,71.08
新竹縣,北埔鄉,大湖村,0,1,312,2,314,466,3,1,3,0,1,0,67.38
新竹縣,北埔鄉,埔尾村,0,1,1587,26,1613,2344,3,1,3,0,1,0,68.81
新竹縣,北埔鄉,水際村,0,1,476,14,490,785,3,1,3,0,1,0,62.42
新竹縣,北埔鄉,南埔村,0,1,257,5,262,337,3,1,3,0,1,0,77.74
新竹縣,北埔鄉,大林村,0,1,433,6,439,614,3,1,3,0,1,0,71.50
新竹縣,北埔鄉,南坑村,0,1,229,3,232,341,3,1,3,0,1,0,68.04
新竹縣,北埔鄉,外坪村,0,1,185,3,188,296,3,1,3,0,1,0,63.51
新竹縣,寶山鄉,雙溪村,0,1,1695,21,1716,2652,3,1,3,0,1,0,64.71
新竹縣,寶山鄉,大崎村,0,1,563,9,572,890,3,1,3,0,1,0,64.27
新竹縣,寶山鄉,三峰村,0,1,484,12,496,728,3,1,3,0,1,0,68.13
新竹縣,寶山鄉,新城村,0,1,668,9,677,1076,3,1,3,0,1,0,62.92
新竹縣,寶山鄉,寶斗村,0,1,396,5,401,654,3,1,3,0,1,0,61.31
新竹縣,寶山鄉,深井村,0,1,422,6,428,693,3,1,3,0,1,0,61.76
新竹縣,寶山鄉,寶山村,0,1,430,9,439,597,3,1,3,0,1,0,73.53
新竹縣,寶山鄉,油田村,0,1,379,8,387,557,3,1,3,0,1,0,69.48
新竹縣,寶山鄉,山湖村,0,1,368,4,372,516,3,1,3,0,1,0,72.09
新竹縣,峨眉鄉,峨眉村,0,1,615,7,622,874,3,1,3,0,1,0,71.17
新竹縣,峨眉鄉,中盛村,0,1,483,9,492,708,3,1,3,0,1,0,69.49
新竹縣,峨眉鄉,石井村,0,1,424,5,429,618,3,1,3,0,1,0,69.42
新竹縣,峨眉鄉,七星村,0,1,432,6,438,640,3,1,3,0,1,0,68.44
新竹縣,峨眉鄉,富興村,0,1,744,6,750,1208,3,1,3,0,1,0,62.09
新竹縣,峨眉鄉,湖光村,0,1,585,9,594,978,3,1,3,0,1,0,60.74
新竹縣,尖石鄉,嘉樂村,0,1,299,7,306,425,3,1,3,0,1,0,72.00
新竹縣,尖石鄉,義興村,0,1,14,2,16,31,3,1,3,0,1,0,51.61
新竹縣,尖石鄉,嘉樂村,0,1,92,2,94,150,3,1,3,0,1,0,62.67
新竹縣,尖石鄉,新樂村,0,1,96,0,96,178,3,1,3,0,1,0,53.93
新竹縣,尖石鄉,錦屏村,0,1,75,2,77,148,3,1,3,0,1,0,52.03
新竹縣,尖石鄉,梅花村,0,1,31,1,32,50,3,1,3,0,1,0,64.00
新竹縣,尖石鄉,玉峰村,0,1,18,1,19,35,3,1,3,0,1,0,54.29
新竹縣,尖石鄉,秀巒村,0,1,30,0,30,70,3,1,3,0,1,0,42.86
新竹縣,五峰鄉,大隘村,0,1,105,1,106,193,3,1,3,0,1,0,54.92
新竹縣,五峰鄉,花園村,0,1,53,0,53,88,3,1,3,0,1,0,60.23
新竹縣,五峰鄉,竹林村,0,1,7,0,7,14,3,1,3,0,1,0,50.00
新竹縣,五峰鄉,桃山村,0,1,49,3,52,113,3,1,3,0,1,0,46.02
苗栗縣,苗栗市,中苗里,0,1,606,12,618,830,3,1,3,0,1,0,74.46
苗栗縣,苗栗市,青苗里,0,1,766,6,772,1081,3,1,3,0,1,0,71.42
苗栗縣,苗栗市,維祥里,0,1,2004,26,2030,2791,3,1,3,0,1,0,72.73
苗栗縣,苗栗市,維新里,0,1,2521,32,2553,3543,3,1,3,0,1,0,72.06
苗栗縣,苗栗市,玉清里,0,1,1501,21,1522,2084,3,1,3,0,1,0,73.03
苗栗縣,苗栗市,玉華里,0,1,2287,35,2322,3172,3,1,3,0,1,0,73.20
苗栗縣,苗栗市,綠苗里,0,1,633,9,642,895,3,1,3,0,1,0,71.73
苗栗縣,苗栗市,高苗里,0,1,1629,33,1662,2413,3,1,3,0,1,0,68.88
苗栗縣,苗栗市,新苗里,0,1,731,6,737,1000,3,1,3,0,1,0,73.70
苗栗縣,苗栗市,玉苗里,0,1,845,13,858,1200,3,1,3,0,1,0,71.50
苗栗縣,苗栗市,大同里,0,1,434,14,448,682,3,1,3,0,1,0,65.69
苗栗縣,苗栗市,恭敬里,0,1,1070,11,1081,1489,3,1,3,0,1,0,72.60
苗栗縣,苗栗市,水源里,0,1,1637,19,1656,2202,3,1,3,0,1,0,75.20
苗栗縣,苗栗市,勝利里,0,1,2532,34,2566,3545,3,1,3,0,1,0,72.38
苗栗縣,苗栗市,清華里,0,1,2148,23,2171,2866,3,1,3,0,1,0,75.75
苗栗縣,苗栗市,上苗里,0,1,1310,17,1327,1783,3,1,3,0,1,0,74.43
苗栗縣,苗栗市,北苗里,0,1,2381,41,2422,3464,3,1,3,0,1,0,69.92
苗栗縣,苗栗市,嘉盛里,0,1,3819,64,3883,5154,3,1,3,0,1,0,75.34
苗栗縣,苗栗市,福星里,0,1,3447,51,3498,4827,3,1,3,0,1,0,72.47
苗栗縣,苗栗市,建功里,0,1,2354,24,2378,3219,3,1,3,0,1,0,73.87
苗栗縣,苗栗市,福麗里,0,1,2643,41,2684,3859,3,1,3,0,1,0,69.55
苗栗縣,苗栗市,文山里,0,1,2640,46,2686,3602,3,1,3,0,1,0,74.57
苗栗縣,苗栗市,新川里,0,1,775,13,788,1043,3,1,3,0,1,0,75.55
苗栗縣,苗栗市,新英里,0,1,1896,42,1938,2736,3,1,3,0,1,0,70.83
苗栗縣,苑裡鎮,苑東里,0,1,1128,12,1140,1530,3,1,3,0,1,0,74.51
苗栗縣,苑裡鎮,苑南里,0,1,1117,13,1130,1566,3,1,3,0,1,0,72.16
苗栗縣,苑裡鎮,苑北里,0,1,701,6,707,931,3,1,3,0,1,0,75.94
苗栗縣,苑裡鎮,西平里,0,1,931,11,942,1270,3,1,3,0,1,0,74.17
苗栗縣,苑裡鎮,苑港里,0,1,743,4,747,1048,3,1,3,0,1,0,71.28
苗栗縣,苑裡鎮,西勢里,0,1,1072,12,1084,1444,3,1,3,0,1,0,75.07
苗栗縣,苑裡鎮,海岸里,0,1,707,7,714,965,3,1,3,0,1,0,73.99
苗栗縣,苑裡鎮,房裡里,0,1,1380,21,1401,1883,3,1,3,0,1,0,74.40
苗栗縣,苑裡鎮,客庄里,0,1,1999,23,2022,2685,3,1,3,0,1,0,75.31
苗栗縣,苑裡鎮,中正里,0,1,1227,12,1239,1712,3,1,3,0,1,0,72.37
苗栗縣,苑裡鎮,苑坑里,0,1,653,14,667,991,3,1,3,0,1,0,67.31
苗栗縣,苑裡鎮,水坡里,0,1,426,4,430,614,3,1,3,0,1,0,70.03
苗栗縣,苑裡鎮,新復里,0,1,773,15,788,1094,3,1,3,0,1,0,72.03
苗栗縣,苑裡鎮,山腳里,0,1,1115,18,1133,1627,3,1,3,0,1,0,69.64
苗栗縣,苑裡鎮,舊社里,0,1,1054,23,1077,1451,3,1,3,0,1,0,74.22
苗栗縣,苑裡鎮,福田里,0,1,909,19,928,1285,3,1,3,0,1,0,72.22
苗栗縣,苑裡鎮,石鎮里,0,1,500,8,508,638,3,1,3,0,1,0,79.62
苗栗縣,苑裡鎮,蕉埔里,0,1,722,7,729,967,3,1,3,0,1,0,75.39
苗栗縣,苑裡鎮,南勢里,0,1,545,9,554,757,3,1,3,0,1,0,73.18
苗栗縣,苑裡鎮,泰田里,0,1,993,7,1000,1317,3,1,3,0,1,0,75.93
苗栗縣,苑裡鎮,上館里,0,1,1127,28,1155,1539,3,1,3,0,1,0,75.05
苗栗縣,苑裡鎮,玉田里,0,1,918,13,931,1346,3,1,3,0,1,0,69.17
苗栗縣,苑裡鎮,社苓里,0,1,1298,26,1324,1805,3,1,3,0,1,0,73.35
苗栗縣,苑裡鎮,山柑里,0,1,728,3,731,1008,3,1,3,0,1,0,72.52
苗栗縣,苑裡鎮,田心里,0,1,834,10,844,1090,3,1,3,0,1,0,77.43
苗栗縣,通霄鎮,通東里,0,1,926,11,937,1274,3,1,3,0,1,0,73.55
苗栗縣,通霄鎮,通西里,0,1,1620,19,1639,2136,3,1,3,0,1,0,76.73
苗栗縣,通霄鎮,平元里,0,1,2276,24,2300,3112,3,1,3,0,1,0,73.91
苗栗縣,通霄鎮,五南里,0,1,971,14,985,1255,3,1,3,0,1,0,78.49
苗栗縣,通霄鎮,五北里,0,1,1019,12,1031,1377,3,1,3,0,1,0,74.87
苗栗縣,通霄鎮,梅南里,0,1,1027,17,1044,1382,3,1,3,0,1,0,75.54
苗栗縣,通霄鎮,通南里,0,1,1581,14,1595,2229,3,1,3,0,1,0,71.56
苗栗縣,通霄鎮,坪頂里,0,1,867,16,883,1230,3,1,3,0,1,0,71.79
苗栗縣,通霄鎮,福興里,0,1,481,6,487,701,3,1,3,0,1,0,69.47
苗栗縣,通霄鎮,南和里,0,1,642,6,648,853,3,1,3,0,1,0,75.97
苗栗縣,通霄鎮,城南里,0,1,781,13,794,1069,3,1,3,0,1,0,74.28
苗栗縣,通霄鎮,城北里,0,1,545,12,557,732,3,1,3,0,1,0,76.09
苗栗縣,通霄鎮,圳頭里,0,1,609,6,615,783,3,1,3,0,1,0,78.54
苗栗縣,通霄鎮,內湖里,0,1,1289,9,1298,1679,3,1,3,0,1,0,77.31
苗栗縣,通霄鎮,楓樹里,0,1,459,4,463,592,3,1,3,0,1,0,78.21
苗栗縣,通霄鎮,烏眉里,0,1,750,8,758,976,3,1,3,0,1,0,77.66
苗栗縣,通霄鎮,福龍里,0,1,354,0,354,539,3,1,3,0,1,0,65.68
苗栗縣,通霄鎮,福源里,0,1,480,7,487,640,3,1,3,0,1,0,76.09
苗栗縣,通霄鎮,通灣里,0,1,1510,13,1523,2039,3,1,3,0,1,0,74.69
苗栗縣,通霄鎮,新埔里,0,1,884,12,896,1249,3,1,3,0,1,0,71.74
苗栗縣,通霄鎮,內島里,0,1,564,8,572,768,3,1,3,0,1,0,74.48
苗栗縣,通霄鎮,白東里,0,1,919,13,932,1348,3,1,3,0,1,0,69.14
苗栗縣,通霄鎮,白西里,0,1,615,4,619,852,3,1,3,0,1,0,72.65
苗栗縣,竹南鎮,竹南里,0,1,1158,17,1175,1568,3,1,3,0,1,0,74.94
苗栗縣,竹南鎮,照南里,0,1,1700,22,1722,2282,3,1,3,0,1,0,75.46
苗栗縣,竹南鎮,正南里,0,1,1500,23,1523,1990,3,1,3,0,1,0,76.53
苗栗縣,竹南鎮,新南里,0,1,1795,33,1828,2475,3,1,3,0,1,0,73.86
苗栗縣,竹南鎮,大厝里,0,1,2159,34,2193,2912,3,1,3,0,1,0,75.31
苗栗縣,竹南鎮,營盤里,0,1,1514,14,1528,2155,3,1,3,0,1,0,70.90
苗栗縣,竹南鎮,聖福里,0,1,1440,27,1467,1951,3,1,3,0,1,0,75.19
苗栗縣,竹南鎮,竹興里,0,1,1812,33,1845,2539,3,1,3,0,1,0,72.67
苗栗縣,竹南鎮,龍鳳里,0,1,2405,59,2464,3098,3,1,3,0,1,0,79.54
苗栗縣,竹南鎮,山佳里,0,1,2940,50,2990,4132,3,1,3,0,1,0,72.36
苗栗縣,竹南鎮,中港里,0,1,700,10,710,933,3,1,3,0,1,0,76.10
苗栗縣,竹南鎮,中華里,0,1,1305,27,1332,1724,3,1,3,0,1,0,77.26
苗栗縣,竹南鎮,中英里,0,1,780,10,790,1051,3,1,3,0,1,0,75.17
苗栗縣,竹南鎮,中美里,0,1,896,13,909,1151,3,1,3,0,1,0,78.97
苗栗縣,竹南鎮,開元里,0,1,394,3,397,502,3,1,3,0,1,0,79.08
苗栗縣,竹南鎮,海口里,0,1,1287,30,1317,1791,3,1,3,0,1,0,73.53
苗栗縣,竹南鎮,港墘里,0,1,922,3,925,1160,3,1,3,0,1,0,79.74
苗栗縣,竹南鎮,公館里,0,1,748,14,762,983,3,1,3,0,1,0,77.52
苗栗縣,竹南鎮,大埔里,0,1,2090,38,2128,2736,3,1,3,0,1,0,77.78
苗栗縣,竹南鎮,頂埔里,0,1,1466,37,1503,2005,3,1,3,0,1,0,74.96
苗栗縣,竹南鎮,崎頂里,0,1,1445,22,1467,1969,3,1,3,0,1,0,74.50
苗栗縣,竹南鎮,公義里,0,1,615,13,628,857,3,1,3,0,1,0,73.28
苗栗縣,頭份鎮,流東里,0,1,1337,23,1360,1858,3,1,3,0,1,0,73.20
苗栗縣,頭份鎮,珊湖里,0,1,1351,20,1371,1868,3,1,3,0,1,0,73.39
苗栗縣,頭份鎮,斗煥里,0,1,1986,38,2024,2690,3,1,3,0,1,0,75.24
苗栗縣,頭份鎮,新華里,0,1,2502,36,2538,3396,3,1,3,0,1,0,74.73
苗栗縣,頭份鎮,興隆里,0,1,1742,27,1769,2573,3,1,3,0,1,0,68.75
苗栗縣,頭份鎮,上埔里,0,1,1595,29,1624,2113,3,1,3,0,1,0,76.86
苗栗縣,頭份鎮,土牛里,0,1,599,14,613,850,3,1,3,0,1,0,72.12
苗栗縣,頭份鎮,頭份里,0,1,1400,20,1420,1966,3,1,3,0,1,0,72.23
苗栗縣,頭份鎮,忠孝里,0,1,2588,37,2625,3739,3,1,3,0,1,0,70.21
苗栗縣,頭份鎮,信義里,0,1,558,4,562,754,3,1,3,0,1,0,74.54
苗栗縣,頭份鎮,仁愛里,0,1,1093,20,1113,1442,3,1,3,0,1,0,77.18
苗栗縣,頭份鎮,上興里,0,1,775,7,782,999,3,1,3,0,1,0,78.28
苗栗縣,頭份鎮,下興里,0,1,1215,15,1230,1616,3,1,3,0,1,0,76.11
苗栗縣,頭份鎮,山下里,0,1,1297,12,1309,1760,3,1,3,0,1,0,74.38
苗栗縣,頭份鎮,後庄里,0,1,2163,38,2201,3063,3,1,3,0,1,0,71.86
苗栗縣,頭份鎮,蟠桃里,0,1,3774,71,3845,5403,3,1,3,0,1,0,71.16
苗栗縣,頭份鎮,東庄里,0,1,1453,15,1468,2120,3,1,3,0,1,0,69.25
苗栗縣,頭份鎮,和平里,0,1,828,4,832,1070,3,1,3,0,1,0,77.76
苗栗縣,頭份鎮,民族里,0,1,3078,43,3121,4446,3,1,3,0,1,0,70.20
苗栗縣,頭份鎮,田寮里,0,1,1758,30,1788,2498,3,1,3,0,1,0,71.58
苗栗縣,頭份鎮,蘆竹里,0,1,1059,14,1073,1337,3,1,3,0,1,0,80.25
苗栗縣,頭份鎮,尖山里,0,1,977,26,1003,1311,3,1,3,0,1,0,76.51
苗栗縣,頭份鎮,廣興里,0,1,605,7,612,799,3,1,3,0,1,0,76.60
苗栗縣,頭份鎮,尖下里,0,1,1709,22,1731,2361,3,1,3,0,1,0,73.32
苗栗縣,頭份鎮,濫坑里,0,1,1192,25,1217,1598,3,1,3,0,1,0,76.16
苗栗縣,後龍鎮,南龍里,0,1,1011,16,1027,1489,3,1,3,0,1,0,68.97
苗栗縣,後龍鎮,中龍里,0,1,734,8,742,950,3,1,3,0,1,0,78.11
苗栗縣,後龍鎮,北龍里,0,1,1062,12,1074,1438,3,1,3,0,1,0,74.69
苗栗縣,後龍鎮,大庄里,0,1,2023,20,2043,2796,3,1,3,0,1,0,73.07
苗栗縣,後龍鎮,溪洲里,0,1,1434,14,1448,2009,3,1,3,0,1,0,72.08
苗栗縣,後龍鎮,豐富里,0,1,957,6,963,1265,3,1,3,0,1,0,76.13
苗栗縣,後龍鎮,校椅里,0,1,905,13,918,1164,3,1,3,0,1,0,78.87
苗栗縣,後龍鎮,埔頂里,0,1,1524,22,1546,2015,3,1,3,0,1,0,76.72
苗栗縣,後龍鎮,新民里,0,1,1005,14,1019,1291,3,1,3,0,1,0,78.93
苗栗縣,後龍鎮,復興里,0,1,505,6,511,656,3,1,3,0,1,0,77.90
苗栗縣,後龍鎮,東明里,0,1,942,11,953,1311,3,1,3,0,1,0,72.69
苗栗縣,後龍鎮,大山里,0,1,1159,17,1176,1631,3,1,3,0,1,0,72.10
苗栗縣,後龍鎮,灣寶里,0,1,985,17,1002,1412,3,1,3,0,1,0,70.96
苗栗縣,後龍鎮,海寶里,0,1,752,7,759,1034,3,1,3,0,1,0,73.40
苗栗縣,後龍鎮,外埔里,0,1,832,11,843,1186,3,1,3,0,1,0,71.08
苗栗縣,後龍鎮,海埔里,0,1,759,10,769,1120,3,1,3,0,1,0,68.66
苗栗縣,後龍鎮,秀水里,0,1,599,5,604,809,3,1,3,0,1,0,74.66
苗栗縣,後龍鎮,水尾里,0,1,799,27,826,1123,3,1,3,0,1,0,73.55
苗栗縣,後龍鎮,龍津里,0,1,480,7,487,650,3,1,3,0,1,0,74.92
苗栗縣,後龍鎮,龍坑里,0,1,863,17,880,1278,3,1,3,0,1,0,68.86
苗栗縣,後龍鎮,福寧里,0,1,597,5,602,859,3,1,3,0,1,0,70.08
苗栗縣,後龍鎮,中和里,0,1,853,13,866,1341,3,1,3,0,1,0,64.58
苗栗縣,後龍鎮,南港里,0,1,884,16,900,1339,3,1,3,0,1,0,67.21
苗栗縣,卓蘭鎮,老庄里,0,1,1691,19,1710,2079,3,1,3,0,1,0,82.25
苗栗縣,卓蘭鎮,新榮里,0,1,913,6,919,1153,3,1,3,0,1,0,79.71
苗栗縣,卓蘭鎮,中街里,0,1,629,2,631,790,3,1,3,0,1,0,79.87
苗栗縣,卓蘭鎮,新厝里,0,1,1123,12,1135,1474,3,1,3,0,1,0,77.00
苗栗縣,卓蘭鎮,豐田里,0,1,807,7,814,1010,3,1,3,0,1,0,80.59
苗栗縣,卓蘭鎮,西坪里,0,1,449,11,460,579,3,1,3,0,1,0,79.45
苗栗縣,卓蘭鎮,苗豐里,0,1,554,9,563,687,3,1,3,0,1,0,81.95
苗栗縣,卓蘭鎮,上新里,0,1,1474,14,1488,1870,3,1,3,0,1,0,79.57
苗栗縣,卓蘭鎮,內灣里,0,1,1646,29,1675,2061,3,1,3,0,1,0,81.27
苗栗縣,卓蘭鎮,坪林里,0,1,1152,27,1179,1496,3,1,3,0,1,0,78.81
苗栗縣,卓蘭鎮,景山里,0,1,525,8,533,743,3,1,3,0,1,0,71.74
苗栗縣,大湖鄉,大湖村,0,1,1254,19,1273,1745,3,1,3,0,1,0,72.95
苗栗縣,大湖鄉,明湖村,0,1,586,11,597,741,3,1,3,0,1,0,80.57
苗栗縣,大湖鄉,靜湖村,0,1,1201,12,1213,1629,3,1,3,0,1,0,74.46
苗栗縣,大湖鄉,富興村,0,1,1014,10,1024,1368,3,1,3,0,1,0,74.85
苗栗縣,大湖鄉,大南村,0,1,486,8,494,733,3,1,3,0,1,0,67.39
苗栗縣,大湖鄉,大寮村,0,1,973,12,985,1302,3,1,3,0,1,0,75.65
苗栗縣,大湖鄉,南湖村,0,1,581,8,589,781,3,1,3,0,1,0,75.42
苗栗縣,大湖鄉,義和村,0,1,1094,16,1110,1492,3,1,3,0,1,0,74.40
苗栗縣,大湖鄉,東興村,0,1,580,14,594,786,3,1,3,0,1,0,75.57
苗栗縣,大湖鄉,武榮村,0,1,407,2,409,566,3,1,3,0,1,0,72.26
苗栗縣,大湖鄉,栗林村,0,1,722,10,732,988,3,1,3,0,1,0,74.09
苗栗縣,大湖鄉,新開村,0,1,651,8,659,928,3,1,3,0,1,0,71.01
苗栗縣,公舘鄉,館中村,0,1,1121,15,1136,1470,3,1,3,0,1,0,77.28
苗栗縣,公舘鄉,館東村,0,1,1594,18,1612,2148,3,1,3,0,1,0,75.05
苗栗縣,公舘鄉,館南村,0,1,1670,23,1693,2337,3,1,3,0,1,0,72.44
苗栗縣,公舘鄉,中義村,0,1,1320,23,1343,1766,3,1,3,0,1,0,76.05
苗栗縣,公舘鄉,玉泉村,0,1,1102,10,1112,1532,3,1,3,0,1,0,72.58
苗栗縣,公舘鄉,大坑村,0,1,637,15,652,930,3,1,3,0,1,0,70.11
苗栗縣,公舘鄉,福基村,0,1,823,9,832,1070,3,1,3,0,1,0,77.76
苗栗縣,公舘鄉,福德村,0,1,320,4,324,439,3,1,3,0,1,0,73.80
苗栗縣,公舘鄉,福星村,0,1,974,11,985,1341,3,1,3,0,1,0,73.45
苗栗縣,公舘鄉,石墻村,0,1,1063,17,1080,1386,3,1,3,0,1,0,77.92
苗栗縣,公舘鄉,開礦村,0,1,289,2,291,356,3,1,3,0,1,0,81.74
苗栗縣,公舘鄉,五谷村,0,1,1174,13,1187,1636,3,1,3,0,1,0,72.56
苗栗縣,公舘鄉,玉谷村,0,1,782,11,793,988,3,1,3,0,1,0,80.26
苗栗縣,公舘鄉,鶴岡村,0,1,1026,15,1041,1322,3,1,3,0,1,0,78.74
苗栗縣,公舘鄉,鶴山村,0,1,1000,11,1011,1319,3,1,3,0,1,0,76.65
苗栗縣,公舘鄉,尖山村,0,1,1044,10,1054,1338,3,1,3,0,1,0,78.77
苗栗縣,公舘鄉,仁安村,0,1,925,12,937,1191,3,1,3,0,1,0,78.67
苗栗縣,公舘鄉,南河村,0,1,160,3,163,217,3,1,3,0,1,0,75.12
苗栗縣,公舘鄉,北河村,0,1,275,3,278,336,3,1,3,0,1,0,82.74
苗栗縣,銅鑼鄉,福興村,0,1,806,11,817,1057,3,1,3,0,1,0,77.29
苗栗縣,銅鑼鄉,朝陽村,0,1,1206,19,1225,1609,3,1,3,0,1,0,76.13
苗栗縣,銅鑼鄉,竹森村,0,1,766,13,779,1119,3,1,3,0,1,0,69.62
苗栗縣,銅鑼鄉,銅鑼村,0,1,2907,43,2950,3816,3,1,3,0,1,0,77.31
苗栗縣,銅鑼鄉,樟樹村,0,1,932,15,947,1234,3,1,3,0,1,0,76.74
苗栗縣,銅鑼鄉,九湖村,0,1,952,19,971,1315,3,1,3,0,1,0,73.84
苗栗縣,銅鑼鄉,中平村,0,1,1784,32,1816,2391,3,1,3,0,1,0,75.95
苗栗縣,銅鑼鄉,興隆村,0,1,456,13,469,646,3,1,3,0,1,0,72.60
苗栗縣,銅鑼鄉,盛隆村,0,1,400,4,404,585,3,1,3,0,1,0,69.06
苗栗縣,銅鑼鄉,新隆村,0,1,478,7,485,666,3,1,3,0,1,0,72.82
苗栗縣,南庄鄉,東村,0,1,1071,12,1083,1423,3,1,3,0,1,0,76.11
苗栗縣,南庄鄉,西村,0,1,521,4,525,712,3,1,3,0,1,0,73.74
苗栗縣,南庄鄉,南江村,0,1,802,10,812,1177,3,1,3,0,1,0,68.99
苗栗縣,南庄鄉,田美村,0,1,658,7,665,938,3,1,3,0,1,0,70.90
苗栗縣,南庄鄉,獅山村,0,1,769,14,783,1129,3,1,3,0,1,0,69.35
苗栗縣,南庄鄉,南富村,0,1,804,14,818,1127,3,1,3,0,1,0,72.58
苗栗縣,南庄鄉,員林村,0,1,730,6,736,1087,3,1,3,0,1,0,67.71
苗栗縣,南庄鄉,蓬萊村,0,1,316,4,320,477,3,1,3,0,1,0,67.09
苗栗縣,南庄鄉,東河村,0,1,216,1,217,308,3,1,3,0,1,0,70.45
苗栗縣,頭屋鄉,頭屋村,0,1,1741,27,1768,2269,3,1,3,0,1,0,77.92
苗栗縣,頭屋鄉,象山村,0,1,1327,25,1352,1750,3,1,3,0,1,0,77.26
苗栗縣,頭屋鄉,北坑村,0,1,434,7,441,569,3,1,3,0,1,0,77.50
苗栗縣,頭屋鄉,獅潭村,0,1,1146,19,1165,1450,3,1,3,0,1,0,80.34
苗栗縣,頭屋鄉,曲洞村,0,1,661,31,692,879,3,1,3,0,1,0,78.73
苗栗縣,頭屋鄉,飛鳳村,0,1,269,5,274,359,3,1,3,0,1,0,76.32
苗栗縣,頭屋鄉,明德村,0,1,911,18,929,1155,3,1,3,0,1,0,80.43
苗栗縣,頭屋鄉,鳴鳳村,0,1,276,2,278,370,3,1,3,0,1,0,75.14
苗栗縣,三義鄉,廣盛村,0,1,3012,43,3055,3883,3,1,3,0,1,0,78.68
苗栗縣,三義鄉,勝興村,0,1,1862,23,1885,2385,3,1,3,0,1,0,79.04
苗栗縣,三義鄉,雙湖村,0,1,1247,22,1269,1620,3,1,3,0,1,0,78.33
苗栗縣,三義鄉,雙潭村,0,1,1095,12,1107,1380,3,1,3,0,1,0,80.22
苗栗縣,三義鄉,西湖村,0,1,990,13,1003,1257,3,1,3,0,1,0,79.79
苗栗縣,三義鄉,龍騰村,0,1,317,5,322,386,3,1,3,0,1,0,83.42
苗栗縣,三義鄉,鯉魚潭村,0,1,883,6,889,1117,3,1,3,0,1,0,79.59
苗栗縣,西湖鄉,高埔村,0,1,488,7,495,654,3,1,3,0,1,0,75.69
苗栗縣,西湖鄉,下埔村,0,1,470,10,480,609,3,1,3,0,1,0,78.82
苗栗縣,西湖鄉,五湖村,0,1,701,15,716,972,3,1,3,0,1,0,73.66
苗栗縣,西湖鄉,四湖村,0,1,582,4,586,702,3,1,3,0,1,0,83.48
苗栗縣,西湖鄉,三湖村,0,1,767,5,772,1088,3,1,3,0,1,0,70.96
苗栗縣,西湖鄉,龍洞村,0,1,425,5,430,554,3,1,3,0,1,0,77.62
苗栗縣,西湖鄉,金獅村,0,1,418,11,429,566,3,1,3,0,1,0,75.80
苗栗縣,西湖鄉,湖東村,0,1,783,47,830,1144,3,1,3,0,1,0,72.55
苗栗縣,西湖鄉,二湖村,0,1,507,9,516,714,3,1,3,0,1,0,72.27
苗栗縣,造橋鄉,造橋村,0,1,1215,12,1227,1556,3,1,3,0,1,0,78.86
苗栗縣,造橋鄉,平興村,0,1,447,7,454,556,3,1,3,0,1,0,81.65
苗栗縣,造橋鄉,豐湖村,0,1,738,5,743,946,3,1,3,0,1,0,78.54
苗栗縣,造橋鄉,大西村,0,1,2274,22,2296,2784,3,1,3,0,1,0,82.47
苗栗縣,造橋鄉,錦水村,0,1,479,4,483,574,3,1,3,0,1,0,84.15
苗栗縣,造橋鄉,大龍村,0,1,454,7,461,546,3,1,3,0,1,0,84.43
苗栗縣,造橋鄉,朝陽村,0,1,983,18,1001,1319,3,1,3,0,1,0,75.89
苗栗縣,造橋鄉,談文村,0,1,571,8,579,721,3,1,3,0,1,0,80.31
苗栗縣,造橋鄉,龍昇村,0,1,818,12,830,1053,3,1,3,0,1,0,78.82
苗栗縣,三灣鄉,三灣村,0,1,1561,19,1580,2116,3,1,3,0,1,0,74.67
苗栗縣,三灣鄉,內灣村,0,1,456,5,461,580,3,1,3,0,1,0,79.48
苗栗縣,三灣鄉,銅鏡村,0,1,650,8,658,877,3,1,3,0,1,0,75.03
苗栗縣,三灣鄉,頂寮村,0,1,204,3,207,254,3,1,3,0,1,0,81.50
苗栗縣,三灣鄉,北埔村,0,1,437,4,441,608,3,1,3,0,1,0,72.53
苗栗縣,三灣鄉,大河村,0,1,500,7,507,705,3,1,3,0,1,0,71.91
苗栗縣,三灣鄉,大坪村,0,1,401,5,406,508,3,1,3,0,1,0,79.92
苗栗縣,三灣鄉,永和村,0,1,261,4,265,337,3,1,3,0,1,0,78.64
苗栗縣,獅潭鄉,百壽村,0,1,216,0,216,302,3,1,3,0,1,0,71.52
苗栗縣,獅潭鄉,永興村,0,1,478,11,489,683,3,1,3,0,1,0,71.60
苗栗縣,獅潭鄉,新店村,0,1,692,11,703,1032,3,1,3,0,1,0,68.12
苗栗縣,獅潭鄉,和興村,0,1,417,9,426,632,3,1,3,0,1,0,67.41
苗栗縣,獅潭鄉,豐林村,0,1,469,7,476,695,3,1,3,0,1,0,68.49
苗栗縣,獅潭鄉,新豐村,0,1,295,0,295,391,3,1,3,0,1,0,75.45
苗栗縣,獅潭鄉,竹木村,0,1,600,17,617,820,3,1,3,0,1,0,75.24
苗栗縣,泰安鄉,八卦村,0,1,98,1,99,126,3,1,3,0,1,0,78.57
苗栗縣,泰安鄉,錦水村,0,1,231,1,232,368,3,1,3,0,1,0,63.04
苗栗縣,泰安鄉,清安村,0,1,502,6,508,679,3,1,3,0,1,0,74.82
苗栗縣,泰安鄉,大興村,0,1,81,1,82,107,3,1,3,0,1,0,76.64
苗栗縣,泰安鄉,中興村,0,1,91,3,94,133,3,1,3,0,1,0,70.68
苗栗縣,泰安鄉,梅園村,0,1,17,0,17,25,3,1,3,0,1,0,68.00
苗栗縣,泰安鄉,象鼻村,0,1,39,1,40,62,3,1,3,0,1,0,64.52
苗栗縣,泰安鄉,士林村,0,1,16,0,16,34,3,1,3,0,1,0,47.06
臺中縣,豐原市,豐原里,0,1,1481,26,1507,2052,3,1,3,0,1,0,73.44
臺中縣,豐原市,豐榮里,0,1,639,8,647,918,3,1,3,0,1,0,70.48
臺中縣,豐原市,頂街里,0,1,556,4,560,789,3,1,3,0,1,0,70.98
臺中縣,豐原市,中山里,0,1,716,16,732,1011,3,1,3,0,1,0,72.40
臺中縣,豐原市,下街里,0,1,664,11,675,859,3,1,3,0,1,0,78.58
臺中縣,豐原市,中陽里,0,1,3090,39,3129,4265,3,1,3,0,1,0,73.36
臺中縣,豐原市,大湳里,0,1,1492,22,1514,2025,3,1,3,0,1,0,74.77
臺中縣,豐原市,北湳里,0,1,1504,30,1534,1966,3,1,3,0,1,0,78.03
臺中縣,豐原市,東湳里,0,1,2353,48,2401,3278,3,1,3,0,1,0,73.25
臺中縣,豐原市,西湳里,0,1,3480,84,3564,5118,3,1,3,0,1,0,69.64
臺中縣,豐原市,豐西里,0,1,1136,15,1151,1601,3,1,3,0,1,0,71.89
臺中縣,豐原市,圳寮里,0,1,903,8,911,1152,3,1,3,0,1,0,79.08
臺中縣,豐原市,豐圳里,0,1,1828,31,1859,2479,3,1,3,0,1,0,74.99
臺中縣,豐原市,富春里,0,1,693,9,702,911,3,1,3,0,1,0,77.06
臺中縣,豐原市,葫蘆里,0,1,685,4,689,929,3,1,3,0,1,0,74.17
臺中縣,豐原市,西安里,0,1,3227,52,3279,4573,3,1,3,0,1,0,71.70
臺中縣,豐原市,西勢里,0,1,1526,22,1548,2096,3,1,3,0,1,0,73.85
臺中縣,豐原市,中興里,0,1,1970,26,1996,2729,3,1,3,0,1,0,73.14
臺中縣,豐原市,社皮里,0,1,4230,79,4309,6171,3,1,3,0,1,0,69.83
臺中縣,豐原市,三村里,0,1,2608,59,2667,3773,3,1,3,0,1,0,70.69
臺中縣,豐原市,東勢里,0,1,1006,17,1023,1432,3,1,3,0,1,0,71.44
臺中縣,豐原市,民生里,0,1,776,9,785,1130,3,1,3,0,1,0,69.47
臺中縣,豐原市,田心里,0,1,2860,50,2910,4094,3,1,3,0,1,0,71.08
臺中縣,豐原市,豐田里,0,1,5042,84,5126,7188,3,1,3,0,1,0,71.31
臺中縣,豐原市,鐮村里,0,1,2209,46,2255,3036,3,1,3,0,1,0,74.28
臺中縣,豐原市,陽明里,0,1,1648,28,1676,2329,3,1,3,0,1,0,71.96
臺中縣,豐原市,南陽里,0,1,3508,52,3560,4971,3,1,3,0,1,0,71.62
臺中縣,豐原市,北陽里,0,1,6134,88,6222,8681,3,1,3,0,1,0,71.67
臺中縣,豐原市,東陽里,0,1,1146,18,1164,1510,3,1,3,0,1,0,77.09
臺中縣,豐原市,南村里,0,1,2343,43,2386,3250,3,1,3,0,1,0,73.42
臺中縣,豐原市,南田里,0,1,2162,36,2198,2921,3,1,3,0,1,0,75.25
臺中縣,豐原市,南嵩里,0,1,1908,28,1936,2668,3,1,3,0,1,0,72.56
臺中縣,豐原市,翁明里,0,1,993,25,1018,1355,3,1,3,0,1,0,75.13
臺中縣,豐原市,翁子里,0,1,1564,30,1594,2175,3,1,3,0,1,0,73.29
臺中縣,豐原市,翁社里,0,1,1289,36,1325,1749,3,1,3,0,1,0,75.76
臺中縣,豐原市,朴子里,0,1,1870,34,1904,2583,3,1,3,0,1,0,73.71
臺中縣,東勢鎮,北興里,0,1,808,7,815,1125,3,1,3,0,1,0,72.44
臺中縣,東勢鎮,中寧里,0,1,674,8,682,898,3,1,3,0,1,0,75.95
臺中縣,東勢鎮,東安里,0,1,1143,14,1157,1562,3,1,3,0,1,0,74.07
臺中縣,東勢鎮,南平里,0,1,1470,30,1500,1959,3,1,3,0,1,0,76.57
臺中縣,東勢鎮,延平里,0,1,1622,23,1645,2297,3,1,3,0,1,0,71.62
臺中縣,東勢鎮,上新里,0,1,786,5,791,1059,3,1,3,0,1,0,74.69
臺中縣,東勢鎮,廣興里,0,1,1126,26,1152,1575,3,1,3,0,1,0,73.14
臺中縣,東勢鎮,泰昌里,0,1,2273,24,2297,3191,3,1,3,0,1,0,71.98
臺中縣,東勢鎮,中嵙里,0,1,1262,17,1279,1838,3,1,3,0,1,0,69.59
臺中縣,東勢鎮,福隆里,0,1,1669,30,1699,2381,3,1,3,0,1,0,71.36
臺中縣,東勢鎮,隆興里,0,1,1031,18,1049,1477,3,1,3,0,1,0,71.02
臺中縣,東勢鎮,新盛里,0,1,3042,50,3092,4233,3,1,3,0,1,0,73.05
臺中縣,東勢鎮,詒福里,0,1,1114,24,1138,1492,3,1,3,0,1,0,76.27
臺中縣,東勢鎮,上城里,0,1,735,8,743,998,3,1,3,0,1,0,74.45
臺中縣,東勢鎮,下城里,0,1,697,7,704,899,3,1,3,0,1,0,78.31
臺中縣,東勢鎮,慶東里,0,1,1462,11,1473,1951,3,1,3,0,1,0,75.50
臺中縣,東勢鎮,慶福里,0,1,906,14,920,1393,3,1,3,0,1,0,66.04
臺中縣,東勢鎮,東新里,0,1,1211,24,1235,1705,3,1,3,0,1,0,72.43
臺中縣,東勢鎮,粵寧里,0,1,1373,22,1395,1834,3,1,3,0,1,0,76.06
臺中縣,東勢鎮,下新里,0,1,1106,18,1124,1492,3,1,3,0,1,0,75.34
臺中縣,東勢鎮,興隆里,0,1,866,8,874,1221,3,1,3,0,1,0,71.58
臺中縣,東勢鎮,茂興里,0,1,1045,18,1063,1543,3,1,3,0,1,0,68.89
臺中縣,東勢鎮,泰興里,0,1,547,8,555,754,3,1,3,0,1,0,73.61
臺中縣,東勢鎮,埤頭里,0,1,532,7,539,674,3,1,3,0,1,0,79.97
臺中縣,東勢鎮,明正里,0,1,949,24,973,1350,3,1,3,0,1,0,72.07
臺中縣,大甲鎮,朝陽里,0,1,814,18,832,1155,3,1,3,0,1,0,72.03
臺中縣,大甲鎮,大甲里,0,1,878,8,886,1209,3,1,3,0,1,0,73.28
臺中縣,大甲鎮,順天里,0,1,1291,17,1308,1773,3,1,3,0,1,0,73.77
臺中縣,大甲鎮,孔門里,0,1,524,9,533,717,3,1,3,0,1,0,74.34
臺中縣,大甲鎮,平安里,0,1,1245,15,1260,1645,3,1,3,0,1,0,76.60
臺中縣,大甲鎮,庄美里,0,1,1272,17,1289,1830,3,1,3,0,1,0,70.44
臺中縣,大甲鎮,新美里,0,1,2147,34,2181,2975,3,1,3,0,1,0,73.31
臺中縣,大甲鎮,岷山里,0,1,1150,21,1171,1457,3,1,3,0,1,0,80.37
臺中縣,大甲鎮,中山里,0,1,1899,30,1929,2649,3,1,3,0,1,0,72.82
臺中縣,大甲鎮,南陽里,0,1,640,13,653,903,3,1,3,0,1,0,72.31
臺中縣,大甲鎮,薰風里,0,1,663,4,667,908,3,1,3,0,1,0,73.46
臺中縣,大甲鎮,義和里,0,1,1721,29,1750,2294,3,1,3,0,1,0,76.29
臺中縣,大甲鎮,武陵里,0,1,813,15,828,1001,3,1,3,0,1,0,82.72
臺中縣,大甲鎮,文曲里,0,1,813,12,825,1038,3,1,3,0,1,0,79.48
臺中縣,大甲鎮,武曲里,0,1,1024,18,1042,1295,3,1,3,0,1,0,80.46
臺中縣,大甲鎮,文武里,0,1,2707,40,2747,3662,3,1,3,0,1,0,75.01
臺中縣,大甲鎮,奉化里,0,1,753,16,769,983,3,1,3,0,1,0,78.23
臺中縣,大甲鎮,德化里,0,1,1015,14,1029,1316,3,1,3,0,1,0,78.19
臺中縣,大甲鎮,江南里,0,1,634,8,642,805,3,1,3,0,1,0,79.75
臺中縣,大甲鎮,頂店里,0,1,2194,42,2236,2852,3,1,3,0,1,0,78.40
臺中縣,大甲鎮,太白里,0,1,849,9,858,1136,3,1,3,0,1,0,75.53
臺中縣,大甲鎮,孟春里,0,1,2094,40,2134,2761,3,1,3,0,1,0,77.29
臺中縣,大甲鎮,幸福里,0,1,1627,24,1651,2239,3,1,3,0,1,0,73.74
臺中縣,大甲鎮,日南里,0,1,2123,40,2163,3207,3,1,3,0,1,0,67.45
臺中縣,大甲鎮,龍泉里,0,1,994,11,1005,1254,3,1,3,0,1,0,80.14
臺中縣,大甲鎮,西岐里,0,1,1068,19,1087,1457,3,1,3,0,1,0,74.61
臺中縣,大甲鎮,銅安里,0,1,846,17,863,1128,3,1,3,0,1,0,76.51
臺中縣,大甲鎮,福德里,0,1,839,12,851,1033,3,1,3,0,1,0,82.38
臺中縣,大甲鎮,建興里,0,1,887,13,900,1172,3,1,3,0,1,0,76.79
臺中縣,清水鎮,鰲峰里,0,1,868,17,885,1250,3,1,3,0,1,0,70.80
臺中縣,清水鎮,靈泉里,0,1,815,10,825,1069,3,1,3,0,1,0,77.17
臺中縣,清水鎮,清水里,0,1,1424,21,1445,1994,3,1,3,0,1,0,72.47
臺中縣,清水鎮,文昌里,0,1,543,6,549,753,3,1,3,0,1,0,72.91
臺中縣,清水鎮,南寧里,0,1,1441,19,1460,2003,3,1,3,0,1,0,72.89
臺中縣,清水鎮,西寧里,0,1,1032,16,1048,1345,3,1,3,0,1,0,77.92
臺中縣,清水鎮,北寧里,0,1,544,4,548,719,3,1,3,0,1,0,76.22
臺中縣,清水鎮,中興里,0,1,335,6,341,495,3,1,3,0,1,0,68.89
臺中縣,清水鎮,西社里,0,1,1763,22,1785,2355,3,1,3,0,1,0,75.80
臺中縣,清水鎮,南社里,0,1,2481,32,2513,3323,3,1,3,0,1,0,75.62
臺中縣,清水鎮,裕嘉里,0,1,736,12,748,967,3,1,3,0,1,0,77.35
臺中縣,清水鎮,臨江里,0,1,988,29,1017,1310,3,1,3,0,1,0,77.63
臺中縣,清水鎮,秀水里,0,1,2228,45,2273,2925,3,1,3,0,1,0,77.71
臺中縣,清水鎮,武鹿里,0,1,1829,30,1859,2371,3,1,3,0,1,0,78.41
臺中縣,清水鎮,海濱里,0,1,1346,18,1364,1665,3,1,3,0,1,0,81.92
臺中縣,清水鎮,康榔里,0,1,1908,25,1933,2565,3,1,3,0,1,0,75.36
臺中縣,清水鎮,中社里,0,1,1517,16,1533,1989,3,1,3,0,1,0,77.07
臺中縣,清水鎮,高西里,0,1,971,16,987,1243,3,1,3,0,1,0,79.40
臺中縣,清水鎮,高南里,0,1,924,9,933,1213,3,1,3,0,1,0,76.92
臺中縣,清水鎮,高東里,0,1,923,21,944,1230,3,1,3,0,1,0,76.75
臺中縣,清水鎮,高北里,0,1,762,16,778,961,3,1,3,0,1,0,80.96
臺中縣,清水鎮,高美里,0,1,962,8,970,1220,3,1,3,0,1,0,79.51
臺中縣,清水鎮,國姓里,0,1,1351,11,1362,1897,3,1,3,0,1,0,71.80
臺中縣,清水鎮,菁埔里,0,1,1561,25,1586,2019,3,1,3,0,1,0,78.55
臺中縣,清水鎮,頂湳里,0,1,1201,21,1222,1653,3,1,3,0,1,0,73.93
臺中縣,清水鎮,田寮里,0,1,1402,26,1428,1971,3,1,3,0,1,0,72.45
臺中縣,清水鎮,橋頭里,0,1,3039,49,3088,4481,3,1,3,0,1,0,68.91
臺中縣,清水鎮,下湳里,0,1,1966,27,1993,2746,3,1,3,0,1,0,72.58
臺中縣,清水鎮,東山里,0,1,863,15,878,1059,3,1,3,0,1,0,82.91
臺中縣,清水鎮,吳厝里,0,1,797,6,803,1034,3,1,3,0,1,0,77.66
臺中縣,清水鎮,楊厝里,0,1,718,15,733,949,3,1,3,0,1,0,77.24
臺中縣,清水鎮,海風里,0,1,804,10,814,1050,3,1,3,0,1,0,77.52
臺中縣,沙鹿鎮,居仁里,0,1,1003,14,1017,1296,3,1,3,0,1,0,78.47
臺中縣,沙鹿鎮,洛泉里,0,1,1746,22,1768,2229,3,1,3,0,1,0,79.32
臺中縣,沙鹿鎮,沙鹿里,0,1,874,12,886,1167,3,1,3,0,1,0,75.92
臺中縣,沙鹿鎮,美仁里,0,1,468,4,472,564,3,1,3,0,1,0,83.69
臺中縣,沙鹿鎮,興仁里,0,1,1593,23,1616,2199,3,1,3,0,1,0,73.49
臺中縣,沙鹿鎮,興安里,0,1,1767,29,1796,2334,3,1,3,0,1,0,76.95
臺中縣,沙鹿鎮,斗抵里,0,1,2222,32,2254,2990,3,1,3,0,1,0,75.38
臺中縣,沙鹿鎮,鹿峰里,0,1,2520,40,2560,3298,3,1,3,0,1,0,77.62
臺中縣,沙鹿鎮,鹿寮里,0,1,3225,37,3262,4266,3,1,3,0,1,0,76.47
臺中縣,沙鹿鎮,竹林里,0,1,3291,41,3332,4370,3,1,3,0,1,0,76.25
臺中縣,沙鹿鎮,犁分里,0,1,670,10,680,838,3,1,3,0,1,0,81.15
臺中縣,沙鹿鎮,福興里,0,1,1359,16,1375,1791,3,1,3,0,1,0,76.77
臺中縣,沙鹿鎮,北勢里,0,1,1920,29,1949,2559,3,1,3,0,1,0,76.16
臺中縣,沙鹿鎮,晉江里,0,1,841,13,854,1095,3,1,3,0,1,0,77.99
臺中縣,沙鹿鎮,六路里,0,1,859,14,873,1222,3,1,3,0,1,0,71.44
臺中縣,沙鹿鎮,南勢里,0,1,1079,22,1101,1423,3,1,3,0,1,0,77.37
臺中縣,沙鹿鎮,埔子里,0,1,2287,30,2317,2996,3,1,3,0,1,0,77.34
臺中縣,沙鹿鎮,公明里,0,1,2399,35,2434,3234,3,1,3,0,1,0,75.26
臺中縣,沙鹿鎮,清泉里,0,1,1111,20,1131,1373,3,1,3,0,1,0,82.37
臺中縣,沙鹿鎮,西勢里,0,1,1419,24,1443,1889,3,1,3,0,1,0,76.39
臺中縣,梧棲鎮,頂寮里,0,1,1263,17,1280,1817,3,1,3,0,1,0,70.45
臺中縣,梧棲鎮,下寮里,0,1,1516,24,1540,2043,3,1,3,0,1,0,75.38
臺中縣,梧棲鎮,中正里,0,1,1918,31,1949,2873,3,1,3,0,1,0,67.84
臺中縣,梧棲鎮,中和里,0,1,392,7,399,549,3,1,3,0,1,0,72.68
臺中縣,梧棲鎮,文化里,0,1,828,17,845,1096,3,1,3,0,1,0,77.10
臺中縣,梧棲鎮,安仁里,0,1,561,8,569,748,3,1,3,0,1,0,76.07
臺中縣,梧棲鎮,草湳里,0,1,2740,53,2793,3658,3,1,3,0,1,0,76.35
臺中縣,梧棲鎮,南簡里,0,1,1258,21,1279,1678,3,1,3,0,1,0,76.22
臺中縣,梧棲鎮,福德里,0,1,1594,18,1612,2185,3,1,3,0,1,0,73.78
臺中縣,梧棲鎮,大庄里,0,1,2886,53,2939,4091,3,1,3,0,1,0,71.84
臺中縣,梧棲鎮,大村里,0,1,1956,18,1974,2693,3,1,3,0,1,0,73.30
臺中縣,梧棲鎮,興農里,0,1,1125,13,1138,1585,3,1,3,0,1,0,71.80
臺中縣,梧棲鎮,永寧里,0,1,1392,35,1427,1867,3,1,3,0,1,0,76.43
臺中縣,梧棲鎮,永安里,0,1,1384,21,1405,1837,3,1,3,0,1,0,76.48
臺中縣,后里鄉,廣福村,0,1,1353,28,1381,1844,3,1,3,0,1,0,74.89
臺中縣,后里鄉,仁里村,0,1,1823,26,1849,2257,3,1,3,0,1,0,81.92
臺中縣,后里鄉,義里村,0,1,3356,66,3422,4622,3,1,3,0,1,0,74.04
臺中縣,后里鄉,后里村,0,1,2385,40,2425,3027,3,1,3,0,1,0,80.11
臺中縣,后里鄉,厚里村,0,1,1280,11,1291,1570,3,1,3,0,1,0,82.23
臺中縣,后里鄉,墩東村,0,1,2757,59,2816,3493,3,1,3,0,1,0,80.62
臺中縣,后里鄉,墩西村,0,1,1433,20,1453,1779,3,1,3,0,1,0,81.68
臺中縣,后里鄉,墩南村,0,1,1593,36,1629,2112,3,1,3,0,1,0,77.13
臺中縣,后里鄉,墩北村,0,1,2071,38,2109,2578,3,1,3,0,1,0,81.81
臺中縣,后里鄉,中和村,0,1,1333,25,1358,1673,3,1,3,0,1,0,81.17
臺中縣,后里鄉,舊社村,0,1,861,18,879,1084,3,1,3,0,1,0,81.09
臺中縣,后里鄉,聯合村,0,1,1128,25,1153,1411,3,1,3,0,1,0,81.72
臺中縣,后里鄉,太平村,0,1,1400,27,1427,1740,3,1,3,0,1,0,82.01
臺中縣,后里鄉,眉山村,0,1,1581,29,1610,2040,3,1,3,0,1,0,78.92
臺中縣,后里鄉,樂業村,0,1,265,6,271,330,3,1,3,0,1,0,82.12
臺中縣,后里鄉,月眉村,0,1,1104,17,1121,1394,3,1,3,0,1,0,80.42
臺中縣,后里鄉,公舘村,0,1,1251,20,1271,1655,3,1,3,0,1,0,76.80
臺中縣,后里鄉,泰安村,0,1,936,9,945,1215,3,1,3,0,1,0,77.78
臺中縣,神岡鄉,神岡村,0,1,1548,33,1581,2116,3,1,3,0,1,0,74.72
臺中縣,神岡鄉,庄前村,0,1,957,18,975,1238,3,1,3,0,1,0,78.76
臺中縣,神岡鄉,北庄村,0,1,1456,23,1479,1897,3,1,3,0,1,0,77.97
臺中縣,神岡鄉,庄後村,0,1,1367,26,1393,1741,3,1,3,0,1,0,80.01
臺中縣,神岡鄉,圳前村,0,1,1540,21,1561,2018,3,1,3,0,1,0,77.35
臺中縣,神岡鄉,圳堵村,0,1,1470,31,1501,1898,3,1,3,0,1,0,79.08
臺中縣,神岡鄉,新庄村,0,1,2331,46,2377,3062,3,1,3,0,1,0,77.63
臺中縣,神岡鄉,山皮村,0,1,715,9,724,891,3,1,3,0,1,0,81.26
臺中縣,神岡鄉,社口村,0,1,3128,55,3183,4063,3,1,3,0,1,0,78.34
臺中縣,神岡鄉,社南村,0,1,2257,33,2290,3078,3,1,3,0,1,0,74.40
臺中縣,神岡鄉,三角村,0,1,1336,22,1358,1780,3,1,3,0,1,0,76.29
臺中縣,神岡鄉,大社村,0,1,1094,26,1120,1540,3,1,3,0,1,0,72.73
臺中縣,神岡鄉,岸裡村,0,1,1494,23,1517,2111,3,1,3,0,1,0,71.86
臺中縣,神岡鄉,豐洲村,0,1,3935,93,4028,5350,3,1,3,0,1,0,75.29
臺中縣,神岡鄉,神洲村,0,1,1541,28,1569,1986,3,1,3,0,1,0,79.00
臺中縣,神岡鄉,溪洲村,0,1,1666,45,1711,2171,3,1,3,0,1,0,78.81
臺中縣,潭子鄉,潭秀村,0,1,1081,12,1093,1484,3,1,3,0,1,0,73.65
臺中縣,潭子鄉,潭北村,0,1,1324,17,1341,1854,3,1,3,0,1,0,72.33
臺中縣,潭子鄉,潭陽村,0,1,4577,68,4645,6691,3,1,3,0,1,0,69.42
臺中縣,潭子鄉,福仁村,0,1,3441,58,3499,4892,3,1,3,0,1,0,71.52
臺中縣,潭子鄉,頭家村,0,1,6075,106,6181,9225,3,1,3,0,1,0,67.00
臺中縣,潭子鄉,甘蔗村,0,1,1942,32,1974,2820,3,1,3,0,1,0,70.00
臺中縣,潭子鄉,東寶村,0,1,4827,101,4928,6637,3,1,3,0,1,0,74.25
臺中縣,潭子鄉,大富村,0,1,946,19,965,1140,3,1,3,0,1,0,84.65
臺中縣,潭子鄉,大豐村,0,1,1514,29,1543,2126,3,1,3,0,1,0,72.58
臺中縣,潭子鄉,栗林村,0,1,2661,44,2705,3690,3,1,3,0,1,0,73.31
臺中縣,潭子鄉,嘉仁村,0,1,2119,35,2154,2861,3,1,3,0,1,0,75.29
臺中縣,潭子鄉,新田村,0,1,1073,21,1094,1458,3,1,3,0,1,0,75.03
臺中縣,潭子鄉,聚興村,0,1,1920,42,1962,2618,3,1,3,0,1,0,74.94
臺中縣,大雅鄉,大雅村,0,1,6587,111,6698,9447,3,1,3,0,1,0,70.90
臺中縣,大雅鄉,三和村,0,1,4699,100,4799,6702,3,1,3,0,1,0,71.61
臺中縣,大雅鄉,西寶村,0,1,1498,23,1521,2053,3,1,3,0,1,0,74.09
臺中縣,大雅鄉,上楓村,0,1,4570,95,4665,6800,3,1,3,0,1,0,68.60
臺中縣,大雅鄉,員林村,0,1,3109,76,3185,4161,3,1,3,0,1,0,76.54
臺中縣,大雅鄉,六寶村,0,1,3432,73,3505,4651,3,1,3,0,1,0,75.36
臺中縣,大雅鄉,秀山村,0,1,1805,32,1837,2310,3,1,3,0,1,0,79.52
臺中縣,大雅鄉,橫山村,0,1,1927,46,1973,2526,3,1,3,0,1,0,78.11
臺中縣,大雅鄉,忠義村,0,1,2258,53,2311,3112,3,1,3,0,1,0,74.26
臺中縣,新社鄉,新社村,0,1,1819,31,1850,2393,3,1,3,0,1,0,77.31
臺中縣,新社鄉,復盛村,0,1,1302,22,1324,1666,3,1,3,0,1,0,79.47
臺中縣,新社鄉,中正村,0,1,938,18,956,1179,3,1,3,0,1,0,81.09
臺中縣,新社鄉,月湖村,0,1,690,10,700,848,3,1,3,0,1,0,82.55
臺中縣,新社鄉,崑山村,0,1,939,17,956,1219,3,1,3,0,1,0,78.42
臺中縣,新社鄉,大南村,0,1,1524,26,1550,1954,3,1,3,0,1,0,79.32
臺中縣,新社鄉,永源村,0,1,1880,41,1921,2380,3,1,3,0,1,0,80.71
臺中縣,新社鄉,中興村,0,1,687,4,691,878,3,1,3,0,1,0,78.70
臺中縣,新社鄉,協成村,0,1,1860,30,1890,2414,3,1,3,0,1,0,78.29
臺中縣,新社鄉,東興村,0,1,1011,14,1025,1264,3,1,3,0,1,0,81.09
臺中縣,新社鄉,慶西村,0,1,710,11,721,908,3,1,3,0,1,0,79.41
臺中縣,新社鄉,中和村,0,1,474,1,475,618,3,1,3,0,1,0,76.86
臺中縣,新社鄉,福興村,0,1,1026,13,1039,1391,3,1,3,0,1,0,74.69
臺中縣,石岡鄉,石岡村,0,1,674,11,685,881,3,1,3,0,1,0,77.75
臺中縣,石岡鄉,萬安村,0,1,817,16,833,1078,3,1,3,0,1,0,77.27
臺中縣,石岡鄉,九房村,0,1,711,12,723,932,3,1,3,0,1,0,77.58
臺中縣,石岡鄉,金星村,0,1,780,10,790,1051,3,1,3,0,1,0,75.17
臺中縣,石岡鄉,龍興村,0,1,480,6,486,632,3,1,3,0,1,0,76.90
臺中縣,石岡鄉,萬興村,0,1,945,23,968,1193,3,1,3,0,1,0,81.14
臺中縣,石岡鄉,梅子村,0,1,1211,26,1237,1599,3,1,3,0,1,0,77.36
臺中縣,石岡鄉,土牛村,0,1,751,12,763,966,3,1,3,0,1,0,78.99
臺中縣,石岡鄉,德興村,0,1,982,16,998,1264,3,1,3,0,1,0,78.96
臺中縣,石岡鄉,和盛村,0,1,994,13,1007,1272,3,1,3,0,1,0,79.17
臺中縣,外埔鄉,永豐村,0,1,775,10,785,930,3,1,3,0,1,0,84.41
臺中縣,外埔鄉,六分村,0,1,986,20,1006,1244,3,1,3,0,1,0,80.87
臺中縣,外埔鄉,三崁村,0,1,1193,22,1215,1507,3,1,3,0,1,0,80.62
臺中縣,外埔鄉,大同村,0,1,2406,46,2452,3122,3,1,3,0,1,0,78.54
臺中縣,外埔鄉,水美村,0,1,1538,29,1567,2004,3,1,3,0,1,0,78.19
臺中縣,外埔鄉,大東村,0,1,2746,69,2815,3574,3,1,3,0,1,0,78.76
臺中縣,外埔鄉,馬鳴村,0,1,1012,15,1027,1264,3,1,3,0,1,0,81.25
臺中縣,外埔鄉,中山村,0,1,725,8,733,865,3,1,3,0,1,0,84.74
臺中縣,外埔鄉,鐵山村,0,1,1473,23,1496,1848,3,1,3,0,1,0,80.95
臺中縣,外埔鄉,土城村,0,1,1159,23,1182,1425,3,1,3,0,1,0,82.95
臺中縣,外埔鄉,廍子村,0,1,860,15,875,1080,3,1,3,0,1,0,81.02
臺中縣,大安鄉,南埔村,0,1,814,7,821,1009,3,1,3,0,1,0,81.37
臺中縣,大安鄉,南庄村,0,1,780,12,792,1036,3,1,3,0,1,0,76.45
臺中縣,大安鄉,中庄村,0,1,1492,18,1510,2093,3,1,3,0,1,0,72.15
臺中縣,大安鄉,東安村,0,1,887,11,898,1116,3,1,3,0,1,0,80.47
臺中縣,大安鄉,福興村,0,1,786,6,792,999,3,1,3,0,1,0,79.28
臺中縣,大安鄉,龜殼村,0,1,1232,16,1248,1600,3,1,3,0,1,0,78.00
臺中縣,大安鄉,頂安村,0,1,616,4,620,802,3,1,3,0,1,0,77.31
臺中縣,大安鄉,永安村,0,1,1074,17,1091,1443,3,1,3,0,1,0,75.61
臺中縣,大安鄉,福住村,0,1,668,11,679,922,3,1,3,0,1,0,73.64
臺中縣,大安鄉,海墘村,0,1,1034,12,1046,1311,3,1,3,0,1,0,79.79
臺中縣,大安鄉,西安村,0,1,828,12,840,1147,3,1,3,0,1,0,73.23
臺中縣,大安鄉,松雅村,0,1,501,5,506,630,3,1,3,0,1,0,80.32
臺中縣,烏日鄉,烏日村,0,1,3259,48,3307,4552,3,1,3,0,1,0,72.65
臺中縣,烏日鄉,湖日村,0,1,1527,30,1557,2278,3,1,3,0,1,0,68.35
臺中縣,烏日鄉,三和村,0,1,2597,65,2662,3631,3,1,3,0,1,0,73.31
臺中縣,烏日鄉,榮泉村,0,1,1897,31,1928,2501,3,1,3,0,1,0,77.09
臺中縣,烏日鄉,學田村,0,1,1504,26,1530,1944,3,1,3,0,1,0,78.70
臺中縣,烏日鄉,九德村,0,1,4578,68,4646,6621,3,1,3,0,1,0,70.17
臺中縣,烏日鄉,仁德村,0,1,2672,40,2712,3791,3,1,3,0,1,0,71.54
臺中縣,烏日鄉,前竹村,0,1,1396,21,1417,1907,3,1,3,0,1,0,74.31
臺中縣,烏日鄉,五光村,0,1,933,12,945,1198,3,1,3,0,1,0,78.88
臺中縣,烏日鄉,光明村,0,1,1315,25,1340,1830,3,1,3,0,1,0,73.22
臺中縣,烏日鄉,東園村,0,1,1051,10,1061,1343,3,1,3,0,1,0,79.00
臺中縣,烏日鄉,溪埧村,0,1,2224,41,2265,2820,3,1,3,0,1,0,80.32
臺中縣,烏日鄉,螺潭村,0,1,1049,17,1066,1347,3,1,3,0,1,0,79.14
臺中縣,烏日鄉,北里村,0,1,810,19,829,1127,3,1,3,0,1,0,73.56
臺中縣,烏日鄉,南里村,0,1,673,16,689,927,3,1,3,0,1,0,74.33
臺中縣,烏日鄉,溪尾村,0,1,603,10,613,807,3,1,3,0,1,0,75.96
臺中縣,大肚鄉,王田村,0,1,2254,32,2286,3035,3,1,3,0,1,0,75.32
臺中縣,大肚鄉,中和村,0,1,627,7,634,722,3,1,3,0,1,0,87.81
臺中縣,大肚鄉,福山村,0,1,2077,29,2106,2751,3,1,3,0,1,0,76.55
臺中縣,大肚鄉,營埔村,0,1,857,12,869,1053,3,1,3,0,1,0,82.53
臺中縣,大肚鄉,社腳村,0,1,1591,25,1616,1944,3,1,3,0,1,0,83.13
臺中縣,大肚鄉,新興村,0,1,1286,16,1302,1820,3,1,3,0,1,0,71.54
臺中縣,大肚鄉,大東村,0,1,1605,22,1627,2043,3,1,3,0,1,0,79.64
臺中縣,大肚鄉,大肚村,0,1,1349,15,1364,1738,3,1,3,0,1,0,78.48
臺中縣,大肚鄉,永和村,0,1,644,11,655,800,3,1,3,0,1,0,81.88
臺中縣,大肚鄉,磺溪村,0,1,961,9,970,1171,3,1,3,0,1,0,82.84
臺中縣,大肚鄉,永順村,0,1,1120,13,1133,1445,3,1,3,0,1,0,78.41
臺中縣,大肚鄉,成功村,0,1,667,3,670,777,3,1,3,0,1,0,86.23
臺中縣,大肚鄉,山陽村,0,1,1014,20,1034,1312,3,1,3,0,1,0,78.81
臺中縣,大肚鄉,頂街村,0,1,2003,32,2035,2607,3,1,3,0,1,0,78.06
臺中縣,大肚鄉,瑞井村,0,1,2323,63,2386,3274,3,1,3,0,1,0,72.88
臺中縣,大肚鄉,蔗廍村,0,1,3794,66,3860,5478,3,1,3,0,1,0,70.46
臺中縣,龍井鄉,竹坑村,0,1,1034,22,1056,1440,3,1,3,0,1,0,73.33
臺中縣,龍井鄉,龍東村,0,1,1403,23,1426,1851,3,1,3,0,1,0,77.04
臺中縣,龍井鄉,龍西村,0,1,1056,19,1075,1299,3,1,3,0,1,0,82.76
臺中縣,龍井鄉,田中村,0,1,1419,25,1444,1994,3,1,3,0,1,0,72.42
臺中縣,龍井鄉,福田村,0,1,696,8,704,902,3,1,3,0,1,0,78.05
臺中縣,龍井鄉,麗水村,0,1,1393,18,1411,1760,3,1,3,0,1,0,80.17
臺中縣,龍井鄉,龍津村,0,1,2751,56,2807,3537,3,1,3,0,1,0,79.36
臺中縣,龍井鄉,三德村,0,1,1516,14,1530,1959,3,1,3,0,1,0,78.10
臺中縣,龍井鄉,忠和村,0,1,2272,30,2302,3168,3,1,3,0,1,0,72.66
臺中縣,龍井鄉,山腳村,0,1,1710,28,1738,2359,3,1,3,0,1,0,73.68
臺中縣,龍井鄉,龍泉村,0,1,2299,55,2354,3161,3,1,3,0,1,0,74.47
臺中縣,龍井鄉,龍崗村,0,1,1069,18,1087,1421,3,1,3,0,1,0,76.50
臺中縣,龍井鄉,新庄村,0,1,2270,41,2311,3274,3,1,3,0,1,0,70.59
臺中縣,龍井鄉,南寮村,0,1,862,11,873,1105,3,1,3,0,1,0,79.00
臺中縣,龍井鄉,新東村,0,1,3821,60,3881,6038,3,1,3,0,1,0,64.28
臺中縣,霧峰鄉,桐林村,0,1,803,15,818,1120,3,1,3,0,1,0,73.04
臺中縣,霧峰鄉,吉峰村,0,1,4190,58,4248,5956,3,1,3,0,1,0,71.32
臺中縣,霧峰鄉,甲寅村,0,1,2773,45,2818,3946,3,1,3,0,1,0,71.41
臺中縣,霧峰鄉,本鄉村,0,1,1235,17,1252,1816,3,1,3,0,1,0,68.94
臺中縣,霧峰鄉,中正村,0,1,1042,17,1059,1452,3,1,3,0,1,0,72.93
臺中縣,霧峰鄉,錦榮村,0,1,616,14,630,816,3,1,3,0,1,0,77.21
臺中縣,霧峰鄉,萊園村,0,1,788,15,803,1135,3,1,3,0,1,0,70.75
臺中縣,霧峰鄉,本堂村,0,1,3300,45,3345,4674,3,1,3,0,1,0,71.57
臺中縣,霧峰鄉,北柳村,0,1,1864,50,1914,2506,3,1,3,0,1,0,76.38
臺中縣,霧峰鄉,南柳村,0,1,1005,12,1017,1266,3,1,3,0,1,0,80.33
臺中縣,霧峰鄉,四德村,0,1,1414,19,1433,1865,3,1,3,0,1,0,76.84
臺中縣,霧峰鄉,五福村,0,1,1619,27,1646,2076,3,1,3,0,1,0,79.29
臺中縣,霧峰鄉,丁台村,0,1,1219,30,1249,1637,3,1,3,0,1,0,76.30
臺中縣,霧峰鄉,北勢村,0,1,1100,14,1114,1357,3,1,3,0,1,0,82.09
臺中縣,霧峰鄉,南勢村,0,1,741,11,752,966,3,1,3,0,1,0,77.85
臺中縣,霧峰鄉,萬豐村,0,1,1671,14,1685,2361,3,1,3,0,1,0,71.37
臺中縣,霧峰鄉,舊正村,0,1,1440,15,1455,1913,3,1,3,0,1,0,76.06
臺中縣,霧峰鄉,坑口村,0,1,2118,32,2150,2825,3,1,3,0,1,0,76.11
臺中縣,霧峰鄉,峰谷村,0,1,817,12,829,1089,3,1,3,0,1,0,76.12
臺中縣,霧峰鄉,六股村,0,1,1564,31,1595,2011,3,1,3,0,1,0,79.31
臺中縣,太平市,太平里,0,1,3269,53,3322,4606,3,1,3,0,1,0,72.12
臺中縣,太平市,長億里,0,1,3429,77,3506,5167,3,1,3,0,1,0,67.85
臺中縣,太平市,中平里,0,1,3526,75,3601,5208,3,1,3,0,1,0,69.14
臺中縣,太平市,中興里,0,1,3281,52,3333,4630,3,1,3,0,1,0,71.99
臺中縣,太平市,東平里,0,1,4725,92,4817,6670,3,1,3,0,1,0,72.22
臺中縣,太平市,建國里,0,1,2795,59,2854,4073,3,1,3,0,1,0,70.07
臺中縣,太平市,坪林里,0,1,4766,84,4850,6625,3,1,3,0,1,0,73.21
臺中縣,太平市,光華里,0,1,4309,81,4390,6143,3,1,3,0,1,0,71.46
臺中縣,太平市,中山里,0,1,3950,73,4023,5640,3,1,3,0,1,0,71.33
臺中縣,太平市,宜欣里,0,1,6235,112,6347,9669,3,1,3,0,1,0,65.64
臺中縣,太平市,新坪里,0,1,4569,93,4662,7530,3,1,3,0,1,0,61.91
臺中縣,太平市,新光里,0,1,4158,81,4239,6336,3,1,3,0,1,0,66.90
臺中縣,太平市,新福里,0,1,1976,43,2019,2906,3,1,3,0,1,0,69.48
臺中縣,太平市,頭汴里,0,1,2471,40,2511,3461,3,1,3,0,1,0,72.55
臺中縣,太平市,東汴里,0,1,916,21,937,1271,3,1,3,0,1,0,73.72
臺中縣,太平市,興隆里,0,1,3312,73,3385,4640,3,1,3,0,1,0,72.95
臺中縣,太平市,黃竹里,0,1,719,7,726,921,3,1,3,0,1,0,78.83
臺中縣,太平市,光隆里,0,1,2894,53,2947,4001,3,1,3,0,1,0,73.66
臺中縣,太平市,德隆里,0,1,1904,30,1934,2747,3,1,3,0,1,0,70.40
臺中縣,大里市,大里里,0,1,1853,25,1878,2420,3,1,3,0,1,0,77.60
臺中縣,大里市,新里里,0,1,4116,62,4178,5889,3,1,3,0,1,0,70.95
臺中縣,大里市,樹王里,0,1,1815,36,1851,2424,3,1,3,0,1,0,76.36
臺中縣,大里市,祥興里,0,1,3352,49,3401,5173,3,1,3,0,1,0,65.75
臺中縣,大里市,內新里,0,1,4696,69,4765,7020,3,1,3,0,1,0,67.88
臺中縣,大里市,東昇里,0,1,1808,30,1838,2504,3,1,3,0,1,0,73.40
臺中縣,大里市,大元里,0,1,1892,24,1916,2757,3,1,3,0,1,0,69.50
臺中縣,大里市,西湖里,0,1,983,22,1005,1292,3,1,3,0,1,0,77.79
臺中縣,大里市,夏田里,0,1,747,3,750,898,3,1,3,0,1,0,83.52
臺中縣,大里市,仁化里,0,1,4955,69,5024,7233,3,1,3,0,1,0,69.46
臺中縣,大里市,健民里,0,1,2384,40,2424,3209,3,1,3,0,1,0,75.54
臺中縣,大里市,塗城里,0,1,3489,62,3551,5233,3,1,3,0,1,0,67.86
臺中縣,大里市,東湖里,0,1,3432,48,3480,5254,3,1,3,0,1,0,66.24
臺中縣,大里市,東興里,0,1,4825,77,4902,7257,3,1,3,0,1,0,67.55
臺中縣,大里市,日新里,0,1,1948,47,1995,2816,3,1,3,0,1,0,70.85
臺中縣,大里市,西榮里,0,1,6236,102,6338,9460,3,1,3,0,1,0,67.00
臺中縣,大里市,金城里,0,1,4700,54,4754,7388,3,1,3,0,1,0,64.35
臺中縣,大里市,立仁里,0,1,3930,72,4002,6215,3,1,3,0,1,0,64.39
臺中縣,大里市,新仁里,0,1,3112,48,3160,4797,3,1,3,0,1,0,65.87
臺中縣,大里市,瑞城里,0,1,4262,58,4320,6497,3,1,3,0,1,0,66.49
臺中縣,和平鄉,南勢村,0,1,1023,14,1037,1369,3,1,3,0,1,0,75.75
臺中縣,和平鄉,天輪村,0,1,295,11,306,450,3,1,3,0,1,0,68.00
臺中縣,和平鄉,博愛村,0,1,763,14,777,1093,3,1,3,0,1,0,71.09
臺中縣,和平鄉,自由村,0,1,346,5,351,484,3,1,3,0,1,0,72.52
臺中縣,和平鄉,達觀村,0,1,319,4,323,472,3,1,3,0,1,0,68.43
臺中縣,和平鄉,中坑村,0,1,204,2,206,257,3,1,3,0,1,0,80.16
臺中縣,和平鄉,梨山村,0,1,803,11,814,1337,3,1,3,0,1,0,60.88
臺中縣,和平鄉,平等村,0,1,220,3,223,373,3,1,3,0,1,0,59.79
彰化縣,彰化市,桃源里,0,1,1939,28,1967,2661,3,1,3,0,1,0,73.92
彰化縣,彰化市,卦山里,0,1,1567,28,1595,2184,3,1,3,0,1,0,73.03
彰化縣,彰化市,東興里,0,1,1022,10,1032,1470,3,1,3,0,1,0,70.20
彰化縣,彰化市,華北里,0,1,1161,19,1180,1650,3,1,3,0,1,0,71.52
彰化縣,彰化市,華陽里,0,1,1546,32,1578,2229,3,1,3,0,1,0,70.79
彰化縣,彰化市,建寶里,0,1,1641,28,1669,2325,3,1,3,0,1,0,71.78
彰化縣,彰化市,光南里,0,1,897,10,907,1249,3,1,3,0,1,0,72.62
彰化縣,彰化市,介壽里,0,1,1366,19,1385,1901,3,1,3,0,1,0,72.86
彰化縣,彰化市,延平里,0,1,2799,33,2832,4141,3,1,3,0,1,0,68.39
彰化縣,彰化市,延和里,0,1,1998,39,2037,2817,3,1,3,0,1,0,72.31
彰化縣,彰化市,南興里,0,1,2390,48,2438,3433,3,1,3,0,1,0,71.02
彰化縣,彰化市,南磘里,0,1,3493,63,3556,5341,3,1,3,0,1,0,66.58
彰化縣,彰化市,成功里,0,1,989,17,1006,1437,3,1,3,0,1,0,70.01
彰化縣,彰化市,大同里,0,1,906,12,918,1243,3,1,3,0,1,0,73.85
彰化縣,彰化市,永生里,0,1,1083,16,1099,1535,3,1,3,0,1,0,71.60
彰化縣,彰化市,福安里,0,1,808,10,818,1102,3,1,3,0,1,0,74.23
彰化縣,彰化市,西安里,0,1,1659,13,1672,2456,3,1,3,0,1,0,68.08
彰化縣,彰化市,彰安里,0,1,2015,29,2044,2938,3,1,3,0,1,0,69.57
彰化縣,彰化市,中央里,0,1,699,9,708,985,3,1,3,0,1,0,71.88
彰化縣,彰化市,富貴里,0,1,753,10,763,1091,3,1,3,0,1,0,69.94
彰化縣,彰化市,民權里,0,1,1023,11,1034,1347,3,1,3,0,1,0,76.76
彰化縣,彰化市,長樂里,0,1,959,11,970,1367,3,1,3,0,1,0,70.96
彰化縣,彰化市,萬壽里,0,1,763,11,774,1090,3,1,3,0,1,0,71.01
彰化縣,彰化市,西興里,0,1,1285,21,1306,1851,3,1,3,0,1,0,70.56
彰化縣,彰化市,平和里,0,1,5227,88,5315,7759,3,1,3,0,1,0,68.50
彰化縣,彰化市,莿桐里,0,1,1393,27,1420,1911,3,1,3,0,1,0,74.31
彰化縣,彰化市,南美里,0,1,1060,15,1075,1362,3,1,3,0,1,0,78.93
彰化縣,彰化市,南安里,0,1,1093,27,1120,1475,3,1,3,0,1,0,75.93
彰化縣,彰化市,東芳里,0,1,1874,33,1907,2447,3,1,3,0,1,0,77.93
彰化縣,彰化市,磚磘里,0,1,1707,28,1735,2326,3,1,3,0,1,0,74.59
彰化縣,彰化市,西勢里,0,1,1434,27,1461,2044,3,1,3,0,1,0,71.48
彰化縣,彰化市,忠權里,0,1,1257,20,1277,1838,3,1,3,0,1,0,69.48
彰化縣,彰化市,忠孝里,0,1,800,36,836,1177,3,1,3,0,1,0,71.03
彰化縣,彰化市,五權里,0,1,1636,14,1650,2409,3,1,3,0,1,0,68.49
彰化縣,彰化市,新興里,0,1,2403,35,2438,3448,3,1,3,0,1,0,70.71
彰化縣,彰化市,新華里,0,1,1324,20,1344,1901,3,1,3,0,1,0,70.70
彰化縣,彰化市,興北里,0,1,956,12,968,1384,3,1,3,0,1,0,69.94
彰化縣,彰化市,信義里,0,1,726,13,739,1024,3,1,3,0,1,0,72.17
彰化縣,彰化市,民生里,0,1,992,12,1004,1387,3,1,3,0,1,0,72.39
彰化縣,彰化市,光復里,0,1,602,10,612,820,3,1,3,0,1,0,74.63
彰化縣,彰化市,永福里,0,1,768,15,783,1056,3,1,3,0,1,0,74.15
彰化縣,彰化市,光華里,0,1,676,8,684,947,3,1,3,0,1,0,72.23
彰化縣,彰化市,中正里,0,1,904,13,917,1230,3,1,3,0,1,0,74.55
彰化縣,彰化市,中山里,0,1,625,11,636,898,3,1,3,0,1,0,70.82
彰化縣,彰化市,龍山里,0,1,1507,23,1530,2135,3,1,3,0,1,0,71.66
彰化縣,彰化市,文化里,0,1,995,19,1014,1429,3,1,3,0,1,0,70.96
彰化縣,彰化市,陽明里,0,1,1416,18,1434,1936,3,1,3,0,1,0,74.07
彰化縣,彰化市,萬安里,0,1,2264,36,2300,3171,3,1,3,0,1,0,72.53
彰化縣,彰化市,下廍里,0,1,2279,48,2327,3111,3,1,3,0,1,0,74.80
彰化縣,彰化市,茄苳里,0,1,574,15,589,750,3,1,3,0,1,0,78.53
彰化縣,彰化市,茄南里,0,1,1211,20,1231,1676,3,1,3,0,1,0,73.45
彰化縣,彰化市,寶廍里,0,1,777,20,797,1013,3,1,3,0,1,0,78.68
彰化縣,彰化市,古夷里,0,1,1370,24,1394,1816,3,1,3,0,1,0,76.76
彰化縣,彰化市,阿夷里,0,1,2285,62,2347,2987,3,1,3,0,1,0,78.57
彰化縣,彰化市,和調里,0,1,1445,21,1466,2096,3,1,3,0,1,0,69.94
彰化縣,彰化市,復興里,0,1,2398,43,2441,3369,3,1,3,0,1,0,72.45
彰化縣,彰化市,中庄里,0,1,1201,25,1226,1816,3,1,3,0,1,0,67.51
彰化縣,彰化市,國聖里,0,1,1537,32,1569,2057,3,1,3,0,1,0,76.28
彰化縣,彰化市,福山里,0,1,3344,63,3407,4859,3,1,3,0,1,0,70.12
彰化縣,彰化市,安溪里,0,1,569,11,580,800,3,1,3,0,1,0,72.50
彰化縣,彰化市,竹中里,0,1,1104,18,1122,1523,3,1,3,0,1,0,73.67
彰化縣,彰化市,三村里,0,1,733,7,740,928,3,1,3,0,1,0,79.74
彰化縣,彰化市,大竹里,0,1,1549,33,1582,2153,3,1,3,0,1,0,73.48
彰化縣,彰化市,香山里,0,1,1471,24,1495,1907,3,1,3,0,1,0,78.40
彰化縣,彰化市,牛埔里,0,1,1882,27,1909,2521,3,1,3,0,1,0,75.72
彰化縣,彰化市,台鳳里,0,1,1669,46,1715,2647,3,1,3,0,1,0,64.79
彰化縣,彰化市,田中里,0,1,592,8,600,749,3,1,3,0,1,0,80.11
彰化縣,彰化市,快官里,0,1,700,11,711,934,3,1,3,0,1,0,76.12
彰化縣,彰化市,竹巷里,0,1,561,7,568,711,3,1,3,0,1,0,79.89
彰化縣,彰化市,福田里,0,1,785,13,798,1039,3,1,3,0,1,0,76.80
彰化縣,彰化市,石牌里,0,1,795,11,806,1048,3,1,3,0,1,0,76.91
彰化縣,花壇鄉,花壇村,0,1,1912,28,1940,2623,3,1,3,0,1,0,73.96
彰化縣,花壇鄉,金墩村,0,1,1144,12,1156,1470,3,1,3,0,1,0,78.64
彰化縣,花壇鄉,中庄村,0,1,1442,26,1468,1960,3,1,3,0,1,0,74.90
彰化縣,花壇鄉,劉厝村,0,1,825,12,837,984,3,1,3,0,1,0,85.06
彰化縣,花壇鄉,崙雅村,0,1,936,13,949,1195,3,1,3,0,1,0,79.41
彰化縣,花壇鄉,南口村,0,1,946,10,956,1285,3,1,3,0,1,0,74.40
彰化縣,花壇鄉,中口村,0,1,536,5,541,671,3,1,3,0,1,0,80.63
彰化縣,花壇鄉,北口村,0,1,1071,12,1083,1427,3,1,3,0,1,0,75.89
彰化縣,花壇鄉,長沙村,0,1,2101,28,2129,2965,3,1,3,0,1,0,71.80
彰化縣,花壇鄉,文德村,0,1,1339,27,1366,1821,3,1,3,0,1,0,75.01
彰化縣,花壇鄉,白沙村,0,1,1867,37,1904,2597,3,1,3,0,1,0,73.32
彰化縣,花壇鄉,岩竹村,0,1,885,14,899,1270,3,1,3,0,1,0,70.79
彰化縣,花壇鄉,橋頭村,0,1,1844,25,1869,2569,3,1,3,0,1,0,72.75
彰化縣,花壇鄉,灣雅村,0,1,586,8,594,791,3,1,3,0,1,0,75.09
彰化縣,花壇鄉,灣東村,0,1,688,9,697,948,3,1,3,0,1,0,73.52
彰化縣,花壇鄉,三春村,0,1,1073,9,1082,1420,3,1,3,0,1,0,76.20
彰化縣,花壇鄉,永春村,0,1,703,5,708,994,3,1,3,0,1,0,71.23
彰化縣,花壇鄉,長春村,0,1,868,10,878,1268,3,1,3,0,1,0,69.24
彰化縣,芬園鄉,舊社村,0,1,1226,20,1246,1565,3,1,3,0,1,0,79.62
彰化縣,芬園鄉,大埔村,0,1,992,12,1004,1298,3,1,3,0,1,0,77.35
彰化縣,芬園鄉,竹林村,0,1,1165,23,1188,1466,3,1,3,0,1,0,81.04
彰化縣,芬園鄉,楓坑村,0,1,460,4,464,555,3,1,3,0,1,0,83.60
彰化縣,芬園鄉,社口村,0,1,1424,20,1444,1899,3,1,3,0,1,0,76.04
彰化縣,芬園鄉,茄荖村,0,1,1467,28,1495,1968,3,1,3,0,1,0,75.97
彰化縣,芬園鄉,嘉興村,0,1,1044,16,1060,1374,3,1,3,0,1,0,77.15
彰化縣,芬園鄉,芬園村,0,1,652,12,664,839,3,1,3,0,1,0,79.14
彰化縣,芬園鄉,進芬村,0,1,676,7,683,916,3,1,3,0,1,0,74.56
彰化縣,芬園鄉,縣庄村,0,1,751,10,761,957,3,1,3,0,1,0,79.52
彰化縣,芬園鄉,圳墘村,0,1,567,5,572,715,3,1,3,0,1,0,80.00
彰化縣,芬園鄉,溪頭村,0,1,1118,12,1130,1367,3,1,3,0,1,0,82.66
彰化縣,芬園鄉,同安村,0,1,910,8,918,1263,3,1,3,0,1,0,72.68
彰化縣,芬園鄉,中崙村,0,1,694,12,706,999,3,1,3,0,1,0,70.67
彰化縣,芬園鄉,大竹村,0,1,751,12,763,1032,3,1,3,0,1,0,73.93
彰化縣,鹿港鎮,大有里,0,1,726,9,735,1168,3,1,3,0,1,0,62.93
彰化縣,鹿港鎮,中興里,0,1,396,6,402,576,3,1,3,0,1,0,69.79
彰化縣,鹿港鎮,洛津里,0,1,729,4,733,1146,3,1,3,0,1,0,63.96
彰化縣,鹿港鎮,順興里,0,1,677,14,691,996,3,1,3,0,1,0,69.38
彰化縣,鹿港鎮,菜園里,0,1,653,7,660,1059,3,1,3,0,1,0,62.32
彰化縣,鹿港鎮,街尾里,0,1,1082,21,1103,1752,3,1,3,0,1,0,62.96
彰化縣,鹿港鎮,泰興里,0,1,838,6,844,1238,3,1,3,0,1,0,68.17
彰化縣,鹿港鎮,長興里,0,1,230,3,233,354,3,1,3,0,1,0,65.82
彰化縣,鹿港鎮,興化里,0,1,483,8,491,759,3,1,3,0,1,0,64.69
彰化縣,鹿港鎮,龍山里,0,1,543,8,551,858,3,1,3,0,1,0,64.22
彰化縣,鹿港鎮,景福里,0,1,822,10,832,1223,3,1,3,0,1,0,68.03
彰化縣,鹿港鎮,郭厝里,0,1,428,10,438,595,3,1,3,0,1,0,73.61
彰化縣,鹿港鎮,新宮里,0,1,683,10,693,1013,3,1,3,0,1,0,68.41
彰化縣,鹿港鎮,玉順里,0,1,822,11,833,1320,3,1,3,0,1,0,63.11
彰化縣,鹿港鎮,東石里,0,1,1696,16,1712,2555,3,1,3,0,1,0,67.01
彰化縣,鹿港鎮,埔崙里,0,1,3386,48,3434,5300,3,1,3,0,1,0,64.79
彰化縣,鹿港鎮,頂厝里,0,1,2734,45,2779,3954,3,1,3,0,1,0,70.28
彰化縣,鹿港鎮,東崎里,0,1,2003,27,2030,2878,3,1,3,0,1,0,70.54
彰化縣,鹿港鎮,廖厝里,0,1,1859,29,1888,2568,3,1,3,0,1,0,73.52
彰化縣,鹿港鎮,詔安里,0,1,964,11,975,1429,3,1,3,0,1,0,68.23
彰化縣,鹿港鎮,海埔里,0,1,1587,30,1617,2359,3,1,3,0,1,0,68.55
彰化縣,鹿港鎮,洋厝里,0,1,1452,16,1468,2119,3,1,3,0,1,0,69.28
彰化縣,鹿港鎮,草中里,0,1,1883,30,1913,2680,3,1,3,0,1,0,71.38
彰化縣,鹿港鎮,山崙里,0,1,1814,26,1840,2546,3,1,3,0,1,0,72.27
彰化縣,鹿港鎮,頭南里,0,1,1153,20,1173,1584,3,1,3,0,1,0,74.05
彰化縣,鹿港鎮,頭崙里,0,1,1533,24,1557,1926,3,1,3,0,1,0,80.84
彰化縣,鹿港鎮,頂番里,0,1,1922,37,1959,2720,3,1,3,0,1,0,72.02
彰化縣,鹿港鎮,溝墘里,0,1,2023,40,2063,2791,3,1,3,0,1,0,73.92
彰化縣,福興鄉,番婆村,0,1,1169,24,1193,1748,3,1,3,0,1,0,68.25
彰化縣,福興鄉,大崙村,0,1,751,13,764,1067,3,1,3,0,1,0,71.60
彰化縣,福興鄉,外埔村,0,1,655,12,667,906,3,1,3,0,1,0,73.62
彰化縣,福興鄉,三汴村,0,1,847,5,852,1133,3,1,3,0,1,0,75.20
彰化縣,福興鄉,萬豐村,0,1,449,5,454,615,3,1,3,0,1,0,73.82
彰化縣,福興鄉,外中村,0,1,836,10,846,1103,3,1,3,0,1,0,76.70
彰化縣,福興鄉,元中村,0,1,690,15,705,965,3,1,3,0,1,0,73.06
彰化縣,福興鄉,橋頭村,0,1,1221,14,1235,1716,3,1,3,0,1,0,71.97
彰化縣,福興鄉,社尾村,0,1,739,17,756,1148,3,1,3,0,1,0,65.85
彰化縣,福興鄉,番社村,0,1,820,19,839,1167,3,1,3,0,1,0,71.89
彰化縣,福興鄉,同安村,0,1,1147,19,1166,1699,3,1,3,0,1,0,68.63
彰化縣,福興鄉,西勢村,0,1,905,23,928,1439,3,1,3,0,1,0,64.49
彰化縣,福興鄉,秀厝村,0,1,1142,19,1161,1677,3,1,3,0,1,0,69.23
彰化縣,福興鄉,鎮平村,0,1,684,14,698,1004,3,1,3,0,1,0,69.52
彰化縣,福興鄉,三和村,0,1,676,3,679,1024,3,1,3,0,1,0,66.31
彰化縣,福興鄉,麥厝村,0,1,1227,20,1247,1884,3,1,3,0,1,0,66.19
彰化縣,福興鄉,廈粘村,0,1,1145,20,1165,1568,3,1,3,0,1,0,74.30
彰化縣,福興鄉,頂粘村,0,1,1364,23,1387,1777,3,1,3,0,1,0,78.05
彰化縣,福興鄉,福寶村,0,1,703,18,721,1014,3,1,3,0,1,0,71.10
彰化縣,福興鄉,二港村,0,1,798,14,812,1144,3,1,3,0,1,0,70.98
彰化縣,福興鄉,福興村,0,1,1607,37,1644,2321,3,1,3,0,1,0,70.83
彰化縣,福興鄉,福南村,0,1,1174,14,1188,1801,3,1,3,0,1,0,65.96
彰化縣,秀水鄉,秀水村,0,1,1069,20,1089,1414,3,1,3,0,1,0,77.02
彰化縣,秀水鄉,安溪村,0,1,929,20,949,1272,3,1,3,0,1,0,74.61
彰化縣,秀水鄉,莊雅村,0,1,1220,25,1245,1687,3,1,3,0,1,0,73.80
彰化縣,秀水鄉,陝西村,0,1,824,13,837,1008,3,1,3,0,1,0,83.04
彰化縣,秀水鄉,金興村,0,1,1118,11,1129,1445,3,1,3,0,1,0,78.13
彰化縣,秀水鄉,安東村,0,1,2054,40,2094,2731,3,1,3,0,1,0,76.68
彰化縣,秀水鄉,鶴鳴村,0,1,1641,23,1664,2232,3,1,3,0,1,0,74.55
彰化縣,秀水鄉,馬興村,0,1,1232,26,1258,1624,3,1,3,0,1,0,77.46
彰化縣,秀水鄉,義興村,0,1,748,15,763,974,3,1,3,0,1,0,78.34
彰化縣,秀水鄉,福安村,0,1,1917,35,1952,2580,3,1,3,0,1,0,75.66
彰化縣,秀水鄉,埔崙村,0,1,1093,20,1113,1513,3,1,3,0,1,0,73.56
彰化縣,秀水鄉,曾厝村,0,1,896,18,914,1185,3,1,3,0,1,0,77.13
彰化縣,秀水鄉,金陵村,0,1,962,14,976,1240,3,1,3,0,1,0,78.71
彰化縣,秀水鄉,下崙村,0,1,1362,15,1377,1705,3,1,3,0,1,0,80.76
彰化縣,和美鎮,竹營里,0,1,2146,35,2181,2895,3,1,3,0,1,0,75.34
彰化縣,和美鎮,和東里,0,1,1973,34,2007,2776,3,1,3,0,1,0,72.30
彰化縣,和美鎮,和南里,0,1,392,1,393,474,3,1,3,0,1,0,82.91
彰化縣,和美鎮,和北里,0,1,917,21,938,1228,3,1,3,0,1,0,76.38
彰化縣,和美鎮,和西里,0,1,1975,28,2003,2845,3,1,3,0,1,0,70.40
彰化縣,和美鎮,四張里,0,1,1312,20,1332,1879,3,1,3,0,1,0,70.89
彰化縣,和美鎮,頭前里,0,1,714,19,733,1006,3,1,3,0,1,0,72.86
彰化縣,和美鎮,還社里,0,1,561,9,570,692,3,1,3,0,1,0,82.37
彰化縣,和美鎮,面前里,0,1,1099,12,1111,1378,3,1,3,0,1,0,80.62
彰化縣,和美鎮,鎮平里,0,1,1458,27,1485,1979,3,1,3,0,1,0,75.04
彰化縣,和美鎮,大霞里,0,1,831,19,850,1060,3,1,3,0,1,0,80.19
彰化縣,和美鎮,源埤里,0,1,1060,29,1089,1397,3,1,3,0,1,0,77.95
彰化縣,和美鎮,南佃里,0,1,1014,25,1039,1311,3,1,3,0,1,0,79.25
彰化縣,和美鎮,雅溝里,0,1,935,18,953,1148,3,1,3,0,1,0,83.01
彰化縣,和美鎮,山犁里,0,1,2726,34,2760,3770,3,1,3,0,1,0,73.21
彰化縣,和美鎮,嘉犁里,0,1,926,20,946,1296,3,1,3,0,1,0,72.99
彰化縣,和美鎮,詔安里,0,1,896,13,909,1226,3,1,3,0,1,0,74.14
彰化縣,和美鎮,鐵山里,0,1,1494,29,1523,2000,3,1,3,0,1,0,76.15
彰化縣,和美鎮,柑井里,0,1,1796,34,1830,2375,3,1,3,0,1,0,77.05
彰化縣,和美鎮,竹園里,0,1,554,7,561,674,3,1,3,0,1,0,83.23
彰化縣,和美鎮,新庄里,0,1,1425,42,1467,1927,3,1,3,0,1,0,76.13
彰化縣,和美鎮,犁盛里,0,1,1451,25,1476,1887,3,1,3,0,1,0,78.22
彰化縣,和美鎮,中寮里,0,1,758,15,773,1050,3,1,3,0,1,0,73.62
彰化縣,和美鎮,中圍里,0,1,1591,34,1625,2262,3,1,3,0,1,0,71.84
彰化縣,和美鎮,糖友里,0,1,827,19,846,1187,3,1,3,0,1,0,71.27
彰化縣,和美鎮,塗厝里,0,1,1169,21,1190,1550,3,1,3,0,1,0,76.77
彰化縣,和美鎮,地潭里,0,1,655,7,662,852,3,1,3,0,1,0,77.70
彰化縣,和美鎮,湖內里,0,1,896,8,904,1150,3,1,3,0,1,0,78.61
彰化縣,和美鎮,嘉寶里,0,1,1182,23,1205,1589,3,1,3,0,1,0,75.83
彰化縣,和美鎮,月眉里,0,1,1873,35,1908,2612,3,1,3,0,1,0,73.05
彰化縣,和美鎮,好修里,0,1,1209,17,1226,1511,3,1,3,0,1,0,81.14
彰化縣,線西鄉,線西村,0,1,1286,15,1301,1698,3,1,3,0,1,0,76.62
彰化縣,線西鄉,頂庄村,0,1,809,10,819,1055,3,1,3,0,1,0,77.63
彰化縣,線西鄉,寓埔村,0,1,1139,12,1151,1593,3,1,3,0,1,0,72.25
彰化縣,線西鄉,塭仔村,0,1,832,8,840,1098,3,1,3,0,1,0,76.50
彰化縣,線西鄉,溝內村,0,1,653,16,669,909,3,1,3,0,1,0,73.60
彰化縣,線西鄉,下犁村,0,1,1085,18,1103,1475,3,1,3,0,1,0,74.78
彰化縣,線西鄉,頂犁村,0,1,1384,34,1418,1796,3,1,3,0,1,0,78.95
彰化縣,線西鄉,德興村,0,1,731,16,747,887,3,1,3,0,1,0,84.22
彰化縣,伸港鄉,新港村,0,1,2363,39,2402,3394,3,1,3,0,1,0,70.77
彰化縣,伸港鄉,什股村,0,1,966,14,980,1339,3,1,3,0,1,0,73.19
彰化縣,伸港鄉,大同村,0,1,811,12,823,1045,3,1,3,0,1,0,78.76
彰化縣,伸港鄉,海尾村,0,1,1070,17,1087,1405,3,1,3,0,1,0,77.37
彰化縣,伸港鄉,全興村,0,1,923,17,940,1217,3,1,3,0,1,0,77.24
彰化縣,伸港鄉,溪底村,0,1,1061,13,1074,1359,3,1,3,0,1,0,79.03
彰化縣,伸港鄉,定興村,0,1,1214,30,1244,1737,3,1,3,0,1,0,71.62
彰化縣,伸港鄉,泉州村,0,1,1008,12,1020,1325,3,1,3,0,1,0,76.98
彰化縣,伸港鄉,泉厝村,0,1,667,6,673,967,3,1,3,0,1,0,69.60
彰化縣,伸港鄉,曾家村,0,1,1007,13,1020,1393,3,1,3,0,1,0,73.22
彰化縣,伸港鄉,蚵寮村,0,1,790,14,804,1087,3,1,3,0,1,0,73.97
彰化縣,伸港鄉,埤墘村,0,1,460,4,464,619,3,1,3,0,1,0,74.96
彰化縣,伸港鄉,七嘉村,0,1,993,15,1008,1378,3,1,3,0,1,0,73.15
彰化縣,伸港鄉,汴頭村,0,1,1305,16,1321,1660,3,1,3,0,1,0,79.58
彰化縣,員林鎮,東和里,0,1,836,12,848,1134,3,1,3,0,1,0,74.78
彰化縣,員林鎮,民生里,0,1,1711,25,1736,2501,3,1,3,0,1,0,69.41
彰化縣,員林鎮,中正里,0,1,1106,10,1116,1572,3,1,3,0,1,0,70.99
彰化縣,員林鎮,仁美里,0,1,1829,23,1852,2631,3,1,3,0,1,0,70.39
彰化縣,員林鎮,新興里,0,1,588,15,603,815,3,1,3,0,1,0,73.99
彰化縣,員林鎮,和平里,0,1,1706,21,1727,2475,3,1,3,0,1,0,69.78
彰化縣,員林鎮,光明里,0,1,769,10,779,1012,3,1,3,0,1,0,76.98
彰化縣,員林鎮,中山里,0,1,559,2,561,786,3,1,3,0,1,0,71.37
彰化縣,員林鎮,黎明里,0,1,1210,21,1231,1729,3,1,3,0,1,0,71.20
彰化縣,員林鎮,惠來里,0,1,2349,45,2394,3559,3,1,3,0,1,0,67.27
彰化縣,員林鎮,三義里,0,1,1447,18,1465,2157,3,1,3,0,1,0,67.92
彰化縣,員林鎮,新生里,0,1,2445,45,2490,3480,3,1,3,0,1,0,71.55
彰化縣,員林鎮,南平里,0,1,1982,52,2034,2882,3,1,3,0,1,0,70.58
彰化縣,員林鎮,南興里,0,1,2737,42,2779,3890,3,1,3,0,1,0,71.44
彰化縣,員林鎮,源潭里,0,1,1107,16,1123,1470,3,1,3,0,1,0,76.39
彰化縣,員林鎮,大埔里,0,1,1008,19,1027,1298,3,1,3,0,1,0,79.12
彰化縣,員林鎮,三條里,0,1,3189,50,3239,4565,3,1,3,0,1,0,70.95
彰化縣,員林鎮,三和里,0,1,2968,43,3011,4200,3,1,3,0,1,0,71.69
彰化縣,員林鎮,三橋里,0,1,1548,22,1570,2178,3,1,3,0,1,0,72.08
彰化縣,員林鎮,三愛里,0,1,1234,15,1249,1820,3,1,3,0,1,0,68.63
彰化縣,員林鎮,三信里,0,1,1303,14,1317,1839,3,1,3,0,1,0,71.62
彰化縣,員林鎮,三多里,0,1,1131,10,1141,1675,3,1,3,0,1,0,68.12
彰化縣,員林鎮,中央里,0,1,968,16,984,1287,3,1,3,0,1,0,76.46
彰化縣,員林鎮,溝皂里,0,1,1246,31,1277,1799,3,1,3,0,1,0,70.98
彰化縣,員林鎮,大饒里,0,1,1463,35,1498,2035,3,1,3,0,1,0,73.61
彰化縣,員林鎮,大明里,0,1,1222,20,1242,1697,3,1,3,0,1,0,73.19
彰化縣,員林鎮,萬年里,0,1,1873,34,1907,2652,3,1,3,0,1,0,71.91
彰化縣,員林鎮,崙雅里,0,1,1504,19,1523,2030,3,1,3,0,1,0,75.02
彰化縣,員林鎮,振興里,0,1,1252,20,1272,1764,3,1,3,0,1,0,72.11
彰化縣,員林鎮,林厝里,0,1,1339,29,1368,1957,3,1,3,0,1,0,69.90
彰化縣,員林鎮,出水里,0,1,1023,19,1042,1616,3,1,3,0,1,0,64.48
彰化縣,員林鎮,湖水里,0,1,911,13,924,1261,3,1,3,0,1,0,73.28
彰化縣,員林鎮,大峰里,0,1,480,10,490,739,3,1,3,0,1,0,66.31
彰化縣,員林鎮,鎮興里,0,1,1179,20,1199,1691,3,1,3,0,1,0,70.90
彰化縣,員林鎮,浮圳里,0,1,1294,18,1312,1820,3,1,3,0,1,0,72.09
彰化縣,員林鎮,西東里,0,1,984,18,1002,1384,3,1,3,0,1,0,72.40
彰化縣,員林鎮,南東里,0,1,1015,19,1034,1542,3,1,3,0,1,0,67.06
彰化縣,員林鎮,中東里,0,1,871,33,904,1262,3,1,3,0,1,0,71.63
彰化縣,員林鎮,東北里,0,1,1337,32,1369,1717,3,1,3,0,1,0,79.73
彰化縣,大村鄉,大村村,0,1,1181,25,1206,1588,3,1,3,0,1,0,75.94
彰化縣,大村鄉,茄苳村,0,1,1150,26,1176,1498,3,1,3,0,1,0,78.50
彰化縣,大村鄉,田洋村,0,1,589,6,595,750,3,1,3,0,1,0,79.33
彰化縣,大村鄉,貢旗村,0,1,854,12,866,1155,3,1,3,0,1,0,74.98
彰化縣,大村鄉,加錫村,0,1,826,10,836,1128,3,1,3,0,1,0,74.11
彰化縣,大村鄉,大崙村,0,1,1083,18,1101,1431,3,1,3,0,1,0,76.94
彰化縣,大村鄉,新興村,0,1,750,12,762,1073,3,1,3,0,1,0,71.02
彰化縣,大村鄉,南勢村,0,1,755,12,767,983,3,1,3,0,1,0,78.03
彰化縣,大村鄉,擺塘村,0,1,1328,21,1349,1823,3,1,3,0,1,0,74.00
彰化縣,大村鄉,過溝村,0,1,1022,8,1030,1332,3,1,3,0,1,0,77.33
彰化縣,大村鄉,大橋村,0,1,1208,29,1237,1684,3,1,3,0,1,0,73.46
彰化縣,大村鄉,村上村,0,1,833,12,845,1063,3,1,3,0,1,0,79.49
彰化縣,大村鄉,美港村,0,1,1656,36,1692,2209,3,1,3,0,1,0,76.60
彰化縣,大村鄉,黃厝村,0,1,1081,19,1100,1441,3,1,3,0,1,0,76.34
彰化縣,大村鄉,福興村,0,1,1087,46,1133,1544,3,1,3,0,1,0,73.38
彰化縣,大村鄉,平和村,0,1,1361,24,1385,1761,3,1,3,0,1,0,78.65
彰化縣,永靖鄉,永東村,0,1,585,10,595,779,3,1,3,0,1,0,76.38
彰化縣,永靖鄉,永西村,0,1,928,18,946,1334,3,1,3,0,1,0,70.91
彰化縣,永靖鄉,永南村,0,1,1217,29,1246,1692,3,1,3,0,1,0,73.64
彰化縣,永靖鄉,永北村,0,1,1071,20,1091,1496,3,1,3,0,1,0,72.93
彰化縣,永靖鄉,港西村,0,1,1066,28,1094,1539,3,1,3,0,1,0,71.09
彰化縣,永靖鄉,五福村,0,1,817,20,837,1198,3,1,3,0,1,0,69.87
彰化縣,永靖鄉,湳港村,0,1,563,8,571,770,3,1,3,0,1,0,74.16
彰化縣,永靖鄉,新莊村,0,1,561,7,568,764,3,1,3,0,1,0,74.35
彰化縣,永靖鄉,瑚璉村,0,1,1268,25,1293,1755,3,1,3,0,1,0,73.68
彰化縣,永靖鄉,五汴村,0,1,855,11,866,1170,3,1,3,0,1,0,74.02
彰化縣,永靖鄉,浮圳村,0,1,674,10,684,955,3,1,3,0,1,0,71.62
彰化縣,永靖鄉,光雲村,0,1,904,18,922,1263,3,1,3,0,1,0,73.00
彰化縣,永靖鄉,東寧村,0,1,1032,19,1051,1428,3,1,3,0,1,0,73.60
彰化縣,永靖鄉,永興村,0,1,1024,18,1042,1353,3,1,3,0,1,0,77.01
彰化縣,永靖鄉,崙子村,0,1,746,16,762,1008,3,1,3,0,1,0,75.60
彰化縣,永靖鄉,獨鰲村,0,1,608,15,623,844,3,1,3,0,1,0,73.82
彰化縣,永靖鄉,敦厚村,0,1,438,9,447,592,3,1,3,0,1,0,75.51
彰化縣,永靖鄉,崙美村,0,1,505,21,526,680,3,1,3,0,1,0,77.35
彰化縣,永靖鄉,同安村,0,1,426,7,433,554,3,1,3,0,1,0,78.16
彰化縣,永靖鄉,同仁村,0,1,690,12,702,905,3,1,3,0,1,0,77.57
彰化縣,永靖鄉,湳墘村,0,1,576,18,594,801,3,1,3,0,1,0,74.16
彰化縣,永靖鄉,四芳村,0,1,504,9,513,688,3,1,3,0,1,0,74.56
彰化縣,永靖鄉,福興村,0,1,873,7,880,1121,3,1,3,0,1,0,78.50
彰化縣,永靖鄉,竹子村,0,1,942,15,957,1333,3,1,3,0,1,0,71.79
彰化縣,溪湖鎮,光平里,0,1,845,2,847,1177,3,1,3,0,1,0,71.96
彰化縣,溪湖鎮,平和里,0,1,554,3,557,747,3,1,3,0,1,0,74.56
彰化縣,溪湖鎮,太平里,0,1,816,12,828,1136,3,1,3,0,1,0,72.89
彰化縣,溪湖鎮,光華里,0,1,407,3,410,556,3,1,3,0,1,0,73.74
彰化縣,溪湖鎮,東寮里,0,1,1750,30,1780,2467,3,1,3,0,1,0,72.15
彰化縣,溪湖鎮,西寮里,0,1,1152,16,1168,1563,3,1,3,0,1,0,74.73
彰化縣,溪湖鎮,大突里,0,1,1204,25,1229,1671,3,1,3,0,1,0,73.55
彰化縣,溪湖鎮,北勢里,0,1,850,18,868,1191,3,1,3,0,1,0,72.88
彰化縣,溪湖鎮,汴頭里,0,1,1073,14,1087,1553,3,1,3,0,1,0,69.99
彰化縣,溪湖鎮,大竹里,0,1,1560,20,1580,2155,3,1,3,0,1,0,73.32
彰化縣,溪湖鎮,湖西里,0,1,1117,14,1131,1577,3,1,3,0,1,0,71.72
彰化縣,溪湖鎮,田中里,0,1,538,5,543,722,3,1,3,0,1,0,75.21
彰化縣,溪湖鎮,河東里,0,1,1038,24,1062,1454,3,1,3,0,1,0,73.04
彰化縣,溪湖鎮,中山里,0,1,1548,16,1564,2099,3,1,3,0,1,0,74.51
彰化縣,溪湖鎮,中竹里,0,1,496,9,505,675,3,1,3,0,1,0,74.81
彰化縣,溪湖鎮,東溪里,0,1,748,13,761,1157,3,1,3,0,1,0,65.77
彰化縣,溪湖鎮,西溪里,0,1,918,14,932,1285,3,1,3,0,1,0,72.53
彰化縣,溪湖鎮,湖東里,0,1,2102,31,2133,3021,3,1,3,0,1,0,70.61
彰化縣,溪湖鎮,頂庄里,0,1,429,8,437,630,3,1,3,0,1,0,69.37
彰化縣,溪湖鎮,忠覺里,0,1,879,9,888,1084,3,1,3,0,1,0,81.92
彰化縣,溪湖鎮,湳底里,0,1,559,7,566,690,3,1,3,0,1,0,82.03
彰化縣,溪湖鎮,大庭里,0,1,835,16,851,1081,3,1,3,0,1,0,78.72
彰化縣,溪湖鎮,媽厝里,0,1,894,13,907,1289,3,1,3,0,1,0,70.36
彰化縣,溪湖鎮,西勢里,0,1,1133,11,1144,1600,3,1,3,0,1,0,71.50
彰化縣,溪湖鎮,番婆里,0,1,888,20,908,1397,3,1,3,0,1,0,65.00
彰化縣,埔鹽鄉,埔鹽村,0,1,990,26,1016,1338,3,1,3,0,1,0,75.93
彰化縣,埔鹽鄉,埔南村,0,1,963,12,975,1257,3,1,3,0,1,0,77.57
彰化縣,埔鹽鄉,廍子村,0,1,799,17,816,1052,3,1,3,0,1,0,77.57
彰化縣,埔鹽鄉,出水村,0,1,556,13,569,708,3,1,3,0,1,0,80.37
彰化縣,埔鹽鄉,南港村,0,1,1184,24,1208,1474,3,1,3,0,1,0,81.95
彰化縣,埔鹽鄉,打廉村,0,1,697,17,714,893,3,1,3,0,1,0,79.96
彰化縣,埔鹽鄉,豐澤村,0,1,853,15,868,1167,3,1,3,0,1,0,74.38
彰化縣,埔鹽鄉,崑崙村,0,1,735,12,747,957,3,1,3,0,1,0,78.06
彰化縣,埔鹽鄉,角樹村,0,1,527,7,534,634,3,1,3,0,1,0,84.23
彰化縣,埔鹽鄉,瓦磘村,0,1,747,9,756,966,3,1,3,0,1,0,78.26
彰化縣,埔鹽鄉,好修村,0,1,841,10,851,1087,3,1,3,0,1,0,78.29
彰化縣,埔鹽鄉,西湖村,0,1,1369,21,1390,1837,3,1,3,0,1,0,75.67
彰化縣,埔鹽鄉,大有村,0,1,943,16,959,1189,3,1,3,0,1,0,80.66
彰化縣,埔鹽鄉,新興村,0,1,282,2,284,367,3,1,3,0,1,0,77.38
彰化縣,埔鹽鄉,永平村,0,1,698,10,708,957,3,1,3,0,1,0,73.98
彰化縣,埔鹽鄉,永樂村,0,1,538,5,543,689,3,1,3,0,1,0,78.81
彰化縣,埔鹽鄉,石埤村,0,1,930,10,940,1248,3,1,3,0,1,0,75.32
彰化縣,埔鹽鄉,天盛村,0,1,632,12,644,816,3,1,3,0,1,0,78.92
彰化縣,埔鹽鄉,太平村,0,1,987,18,1005,1397,3,1,3,0,1,0,71.94
彰化縣,埔鹽鄉,新水村,0,1,892,11,903,1196,3,1,3,0,1,0,75.50
彰化縣,埔鹽鄉,三省村,0,1,939,11,950,1214,3,1,3,0,1,0,78.25
彰化縣,埔鹽鄉,南新村,0,1,906,10,916,1182,3,1,3,0,1,0,77.50
彰化縣,埔心鄉,東門村,0,1,1628,23,1651,2142,3,1,3,0,1,0,77.08
彰化縣,埔心鄉,埔心村,0,1,810,14,824,1114,3,1,3,0,1,0,73.97
彰化縣,埔心鄉,義民村,0,1,964,19,983,1285,3,1,3,0,1,0,76.50
彰化縣,埔心鄉,油車村,0,1,751,14,765,964,3,1,3,0,1,0,79.36
彰化縣,埔心鄉,瓦北村,0,1,1087,12,1099,1405,3,1,3,0,1,0,78.22
彰化縣,埔心鄉,瓦中村,0,1,1136,18,1154,1448,3,1,3,0,1,0,79.70
彰化縣,埔心鄉,瓦南村,0,1,944,15,959,1204,3,1,3,0,1,0,79.65
彰化縣,埔心鄉,經口村,0,1,920,8,928,1238,3,1,3,0,1,0,74.96
彰化縣,埔心鄉,太平村,0,1,1085,25,1110,1497,3,1,3,0,1,0,74.15
彰化縣,埔心鄉,大華村,0,1,443,8,451,598,3,1,3,0,1,0,75.42
彰化縣,埔心鄉,仁里村,0,1,638,12,650,894,3,1,3,0,1,0,72.71
彰化縣,埔心鄉,舊舘村,0,1,675,9,684,947,3,1,3,0,1,0,72.23
彰化縣,埔心鄉,南舘村,0,1,456,9,465,687,3,1,3,0,1,0,67.69
彰化縣,埔心鄉,新舘村,0,1,539,13,552,765,3,1,3,0,1,0,72.16
彰化縣,埔心鄉,芎蕉村,0,1,1020,17,1037,1526,3,1,3,0,1,0,67.96
彰化縣,埔心鄉,羅厝村,0,1,889,14,903,1271,3,1,3,0,1,0,71.05
彰化縣,埔心鄉,梧鳳村,0,1,667,5,672,851,3,1,3,0,1,0,78.97
彰化縣,埔心鄉,二重村,0,1,872,13,885,1102,3,1,3,0,1,0,80.31
彰化縣,埔心鄉,埤霞村,0,1,551,8,559,696,3,1,3,0,1,0,80.32
彰化縣,埔心鄉,埤腳村,0,1,652,8,660,833,3,1,3,0,1,0,79.23
彰化縣,田中鎮,香山里,0,1,594,9,603,864,3,1,3,0,1,0,69.79
彰化縣,田中鎮,碧峰里,0,1,1875,61,1936,2771,3,1,3,0,1,0,69.87
彰化縣,田中鎮,東源里,0,1,411,6,417,651,3,1,3,0,1,0,64.06
彰化縣,田中鎮,復興里,0,1,954,14,968,1368,3,1,3,0,1,0,70.76
彰化縣,田中鎮,平和里,0,1,929,21,950,1433,3,1,3,0,1,0,66.29
彰化縣,田中鎮,頂潭里,0,1,732,19,751,1043,3,1,3,0,1,0,72.00
彰化縣,田中鎮,中潭里,0,1,1063,14,1077,1561,3,1,3,0,1,0,68.99
彰化縣,田中鎮,龍潭里,0,1,468,7,475,673,3,1,3,0,1,0,70.58
彰化縣,田中鎮,北路里,0,1,1598,22,1620,2307,3,1,3,0,1,0,70.22
彰化縣,田中鎮,西路里,0,1,1302,25,1327,1860,3,1,3,0,1,0,71.34
彰化縣,田中鎮,東路里,0,1,786,13,799,1108,3,1,3,0,1,0,72.11
彰化縣,田中鎮,南路里,0,1,916,11,927,1314,3,1,3,0,1,0,70.55
彰化縣,田中鎮,中路里,0,1,1331,16,1347,1993,3,1,3,0,1,0,67.59
彰化縣,田中鎮,新庄里,0,1,1114,28,1142,1663,3,1,3,0,1,0,68.67
彰化縣,田中鎮,三安里,0,1,1067,33,1100,1559,3,1,3,0,1,0,70.56
彰化縣,田中鎮,大崙里,0,1,818,22,840,1165,3,1,3,0,1,0,72.10
彰化縣,田中鎮,沙崙里,0,1,938,22,960,1422,3,1,3,0,1,0,67.51
彰化縣,田中鎮,新民里,0,1,1784,40,1824,2650,3,1,3,0,1,0,68.83
彰化縣,田中鎮,梅州里,0,1,890,18,908,1285,3,1,3,0,1,0,70.66
彰化縣,田中鎮,三民里,0,1,962,18,980,1353,3,1,3,0,1,0,72.43
彰化縣,田中鎮,三光里,0,1,636,8,644,876,3,1,3,0,1,0,73.52
彰化縣,田中鎮,大社里,0,1,499,9,508,729,3,1,3,0,1,0,69.68
彰化縣,社頭鄉,社頭村,0,1,1624,24,1648,2376,3,1,3,0,1,0,69.36
彰化縣,社頭鄉,廣興村,0,1,2138,48,2186,2899,3,1,3,0,1,0,75.41
彰化縣,社頭鄉,仁雅村,0,1,1475,26,1501,2152,3,1,3,0,1,0,69.75
彰化縣,社頭鄉,崙雅村,0,1,476,15,491,700,3,1,3,0,1,0,70.14
彰化縣,社頭鄉,美雅村,0,1,691,11,702,927,3,1,3,0,1,0,75.73
彰化縣,社頭鄉,里仁村,0,1,727,13,740,995,3,1,3,0,1,0,74.37
彰化縣,社頭鄉,舊社村,0,1,881,11,892,1241,3,1,3,0,1,0,71.88
彰化縣,社頭鄉,松竹村,0,1,607,14,621,806,3,1,3,0,1,0,77.05
彰化縣,社頭鄉,東興村,0,1,783,13,796,1116,3,1,3,0,1,0,71.33
彰化縣,社頭鄉,廣福村,0,1,577,8,585,757,3,1,3,0,1,0,77.28
彰化縣,社頭鄉,橋頭村,0,1,1242,32,1274,1693,3,1,3,0,1,0,75.25
彰化縣,社頭鄉,湳底村,0,1,982,18,1000,1270,3,1,3,0,1,0,78.74
彰化縣,社頭鄉,新厝村,0,1,979,19,998,1322,3,1,3,0,1,0,75.49
彰化縣,社頭鄉,張厝村,0,1,749,14,763,990,3,1,3,0,1,0,77.07
彰化縣,社頭鄉,埤斗村,0,1,767,12,779,945,3,1,3,0,1,0,82.43
彰化縣,社頭鄉,清水村,0,1,734,12,746,965,3,1,3,0,1,0,77.31
彰化縣,社頭鄉,山湖村,0,1,665,11,676,863,3,1,3,0,1,0,78.33
彰化縣,社頭鄉,朝興村,0,1,634,10,644,883,3,1,3,0,1,0,72.93
彰化縣,社頭鄉,仁和村,0,1,459,14,473,605,3,1,3,0,1,0,78.18
彰化縣,社頭鄉,泰安村,0,1,589,12,601,757,3,1,3,0,1,0,79.39
彰化縣,社頭鄉,平和村,0,1,592,15,607,774,3,1,3,0,1,0,78.42
彰化縣,社頭鄉,龍井村,0,1,567,4,571,733,3,1,3,0,1,0,77.90
彰化縣,社頭鄉,湳雅村,0,1,912,15,927,1243,3,1,3,0,1,0,74.58
彰化縣,社頭鄉,協和村,0,1,1156,27,1183,1683,3,1,3,0,1,0,70.29
彰化縣,二水鄉,復興村,0,1,742,15,757,1047,3,1,3,0,1,0,72.30
彰化縣,二水鄉,十五村,0,1,471,7,478,710,3,1,3,0,1,0,67.32
彰化縣,二水鄉,合和村,0,1,596,13,609,836,3,1,3,0,1,0,72.85
彰化縣,二水鄉,上豐村,0,1,717,13,730,1016,3,1,3,0,1,0,71.85
彰化縣,二水鄉,過圳村,0,1,496,9,505,682,3,1,3,0,1,0,74.05
彰化縣,二水鄉,五伯村,0,1,548,8,556,742,3,1,3,0,1,0,74.93
彰化縣,二水鄉,光化村,0,1,677,18,695,932,3,1,3,0,1,0,74.57
彰化縣,二水鄉,文化村,0,1,656,11,667,886,3,1,3,0,1,0,75.28
彰化縣,二水鄉,二水村,0,1,612,9,621,843,3,1,3,0,1,0,73.67
彰化縣,二水鄉,聖化村,0,1,411,1,412,553,3,1,3,0,1,0,74.50
彰化縣,二水鄉,裕民村,0,1,635,9,644,878,3,1,3,0,1,0,73.35
彰化縣,二水鄉,惠民村,0,1,642,11,653,909,3,1,3,0,1,0,71.84
彰化縣,二水鄉,大園村,0,1,512,11,523,681,3,1,3,0,1,0,76.80
彰化縣,二水鄉,修仁村,0,1,592,9,601,800,3,1,3,0,1,0,75.13
彰化縣,二水鄉,合興村,0,1,594,7,601,856,3,1,3,0,1,0,70.21
彰化縣,二水鄉,源泉村,0,1,481,15,496,661,3,1,3,0,1,0,75.04
彰化縣,二水鄉,倡和村,0,1,483,11,494,653,3,1,3,0,1,0,75.65
彰化縣,北斗鎮,中寮里,0,1,1511,32,1543,2136,3,1,3,0,1,0,72.24
彰化縣,北斗鎮,大道里,0,1,1121,15,1136,1537,3,1,3,0,1,0,73.91
彰化縣,北斗鎮,西德里,0,1,2286,36,2322,3190,3,1,3,0,1,0,72.79
彰化縣,北斗鎮,西安里,0,1,1008,19,1027,1461,3,1,3,0,1,0,70.29
彰化縣,北斗鎮,光復里,0,1,808,18,826,1191,3,1,3,0,1,0,69.35
彰化縣,北斗鎮,新政里,0,1,602,4,606,820,3,1,3,0,1,0,73.90
彰化縣,北斗鎮,重慶里,0,1,476,11,487,701,3,1,3,0,1,0,69.47
彰化縣,北斗鎮,五權里,0,1,581,6,587,802,3,1,3,0,1,0,73.19
彰化縣,北斗鎮,七星里,0,1,923,5,928,1317,3,1,3,0,1,0,70.46
彰化縣,北斗鎮,居仁里,0,1,958,12,970,1315,3,1,3,0,1,0,73.76
彰化縣,北斗鎮,東光里,0,1,970,21,991,1392,3,1,3,0,1,0,71.19
彰化縣,北斗鎮,文昌里,0,1,1196,30,1226,1722,3,1,3,0,1,0,71.20
彰化縣,北斗鎮,中和里,0,1,737,11,748,1007,3,1,3,0,1,0,74.28
彰化縣,北斗鎮,新生里,0,1,1076,28,1104,1520,3,1,3,0,1,0,72.63
彰化縣,北斗鎮,大新里,0,1,783,18,801,1217,3,1,3,0,1,0,65.82
彰化縣,溪州鄉,溪厝村,0,1,1092,52,1144,1722,3,1,3,0,1,0,66.43
彰化縣,溪州鄉,坑厝村,0,1,414,9,423,626,3,1,3,0,1,0,67.57
彰化縣,溪州鄉,瓦厝村,0,1,656,10,666,955,3,1,3,0,1,0,69.74
彰化縣,溪州鄉,溪州村,0,1,1143,13,1156,1597,3,1,3,0,1,0,72.39
彰化縣,溪州鄉,尾厝村,0,1,840,14,854,1151,3,1,3,0,1,0,74.20
彰化縣,溪州鄉,東州村,0,1,1145,18,1163,1695,3,1,3,0,1,0,68.61
彰化縣,溪州鄉,舊眉村,0,1,833,8,841,1159,3,1,3,0,1,0,72.56
彰化縣,溪州鄉,圳寮村,0,1,891,8,899,1336,3,1,3,0,1,0,67.29
彰化縣,溪州鄉,西畔村,0,1,1260,26,1286,1932,3,1,3,0,1,0,66.56
彰化縣,溪州鄉,成功村,0,1,1067,16,1083,1698,3,1,3,0,1,0,63.78
彰化縣,溪州鄉,大庄村,0,1,1248,24,1272,1879,3,1,3,0,1,0,67.70
彰化縣,溪州鄉,榮光村,0,1,546,14,560,787,3,1,3,0,1,0,71.16
彰化縣,溪州鄉,柑園村,0,1,727,14,741,1037,3,1,3,0,1,0,71.46
彰化縣,溪州鄉,潮洋村,0,1,582,14,596,951,3,1,3,0,1,0,62.67
彰化縣,溪州鄉,張厝村,0,1,459,7,466,726,3,1,3,0,1,0,64.19
彰化縣,溪州鄉,菜公村,0,1,570,8,578,863,3,1,3,0,1,0,66.98
彰化縣,溪州鄉,三圳村,0,1,776,21,797,1160,3,1,3,0,1,0,68.71
彰化縣,溪州鄉,三條村,0,1,618,17,635,871,3,1,3,0,1,0,72.90
彰化縣,溪州鄉,水尾村,0,1,787,32,819,1150,3,1,3,0,1,0,71.22
彰化縣,田尾鄉,田尾村,0,1,786,14,800,1160,3,1,3,0,1,0,68.97
彰化縣,田尾鄉,豐田村,0,1,414,3,417,582,3,1,3,0,1,0,71.65
彰化縣,田尾鄉,饒平村,0,1,1168,22,1190,1557,3,1,3,0,1,0,76.43
彰化縣,田尾鄉,北曾村,0,1,754,14,768,1026,3,1,3,0,1,0,74.85
彰化縣,田尾鄉,南曾村,0,1,816,17,833,1089,3,1,3,0,1,0,76.49
彰化縣,田尾鄉,睦宜村,0,1,684,14,698,965,3,1,3,0,1,0,72.33
彰化縣,田尾鄉,新生村,0,1,786,9,795,1045,3,1,3,0,1,0,76.08
彰化縣,田尾鄉,北鎮村,0,1,561,6,567,769,3,1,3,0,1,0,73.73
彰化縣,田尾鄉,南鎮村,0,1,441,11,452,618,3,1,3,0,1,0,73.14
彰化縣,田尾鄉,福田村,0,1,608,15,623,850,3,1,3,0,1,0,73.29
彰化縣,田尾鄉,新興村,0,1,708,6,714,937,3,1,3,0,1,0,76.20
彰化縣,田尾鄉,溪畔村,0,1,843,12,855,1121,3,1,3,0,1,0,76.27
彰化縣,田尾鄉,打簾村,0,1,1148,27,1175,1626,3,1,3,0,1,0,72.26
彰化縣,田尾鄉,柳鳳村,0,1,574,11,585,755,3,1,3,0,1,0,77.48
彰化縣,田尾鄉,陸豐村,0,1,601,7,608,824,3,1,3,0,1,0,73.79
彰化縣,田尾鄉,海豐村,0,1,1020,13,1033,1468,3,1,3,0,1,0,70.37
彰化縣,田尾鄉,仁里村,0,1,1050,17,1067,1438,3,1,3,0,1,0,74.20
彰化縣,田尾鄉,新厝村,0,1,226,4,230,324,3,1,3,0,1,0,70.99
彰化縣,田尾鄉,溪頂村,0,1,453,4,457,627,3,1,3,0,1,0,72.89
彰化縣,田尾鄉,正義村,0,1,436,5,441,602,3,1,3,0,1,0,73.26
彰化縣,埤頭鄉,和豐村,0,1,1456,41,1497,2150,3,1,3,0,1,0,69.63
彰化縣,埤頭鄉,興農村,0,1,970,16,986,1389,3,1,3,0,1,0,70.99
彰化縣,埤頭鄉,埤頭村,0,1,1044,22,1066,1484,3,1,3,0,1,0,71.83
彰化縣,埤頭鄉,豐崙村,0,1,1391,25,1416,1955,3,1,3,0,1,0,72.43
彰化縣,埤頭鄉,崙子村,0,1,727,14,741,1087,3,1,3,0,1,0,68.17
彰化縣,埤頭鄉,永豐村,0,1,1006,32,1038,1442,3,1,3,0,1,0,71.98
彰化縣,埤頭鄉,合興村,0,1,1915,29,1944,2660,3,1,3,0,1,0,73.08
彰化縣,埤頭鄉,平原村,0,1,1088,22,1110,1514,3,1,3,0,1,0,73.32
彰化縣,埤頭鄉,崙腳村,0,1,443,2,445,665,3,1,3,0,1,0,66.92
彰化縣,埤頭鄉,元埔村,0,1,411,6,417,606,3,1,3,0,1,0,68.81
彰化縣,埤頭鄉,芙朝村,0,1,1052,25,1077,1566,3,1,3,0,1,0,68.77
彰化縣,埤頭鄉,新庄村,0,1,808,17,825,1222,3,1,3,0,1,0,67.51
彰化縣,埤頭鄉,陸嘉村,0,1,555,7,562,818,3,1,3,0,1,0,68.70
彰化縣,埤頭鄉,竹圍村,0,1,507,17,524,751,3,1,3,0,1,0,69.77
彰化縣,埤頭鄉,中和村,0,1,817,14,831,1211,3,1,3,0,1,0,68.62
彰化縣,埤頭鄉,庄內村,0,1,596,12,608,930,3,1,3,0,1,0,65.38
彰化縣,埤頭鄉,大湖村,0,1,650,12,662,976,3,1,3,0,1,0,67.83
彰化縣,二林鎮,東和里,0,1,1514,15,1529,2105,3,1,3,0,1,0,72.64
彰化縣,二林鎮,南光里,0,1,1792,28,1820,2510,3,1,3,0,1,0,72.51
彰化縣,二林鎮,西平里,0,1,987,11,998,1411,3,1,3,0,1,0,70.73
彰化縣,二林鎮,北平里,0,1,1461,28,1489,2090,3,1,3,0,1,0,71.24
彰化縣,二林鎮,中西里,0,1,1089,20,1109,1556,3,1,3,0,1,0,71.27
彰化縣,二林鎮,廣興里,0,1,976,13,989,1482,3,1,3,0,1,0,66.73
彰化縣,二林鎮,香田里,0,1,770,13,783,1195,3,1,3,0,1,0,65.52
彰化縣,二林鎮,外竹里,0,1,812,3,815,1097,3,1,3,0,1,0,74.29
彰化縣,二林鎮,興華里,0,1,645,13,658,1040,3,1,3,0,1,0,63.27
彰化縣,二林鎮,東興里,0,1,766,8,774,1123,3,1,3,0,1,0,68.92
彰化縣,二林鎮,後厝里,0,1,1265,19,1284,1954,3,1,3,0,1,0,65.71
彰化縣,二林鎮,豐田里,0,1,1343,19,1362,2048,3,1,3,0,1,0,66.50
彰化縣,二林鎮,頂厝里,0,1,853,13,866,1249,3,1,3,0,1,0,69.34
彰化縣,二林鎮,趙甲里,0,1,1124,32,1156,1613,3,1,3,0,1,0,71.67
彰化縣,二林鎮,振興里,0,1,908,11,919,1204,3,1,3,0,1,0,76.33
彰化縣,二林鎮,萬興里,0,1,569,8,577,758,3,1,3,0,1,0,76.12
彰化縣,二林鎮,永興里,0,1,999,14,1013,1366,3,1,3,0,1,0,74.16
彰化縣,二林鎮,西庄里,0,1,793,13,806,1085,3,1,3,0,1,0,74.29
彰化縣,二林鎮,梅芳里,0,1,801,16,817,1018,3,1,3,0,1,0,80.26
彰化縣,二林鎮,華崙里,0,1,2499,50,2549,3276,3,1,3,0,1,0,77.81
彰化縣,二林鎮,萬合里,0,1,918,8,926,1303,3,1,3,0,1,0,71.07
彰化縣,二林鎮,東勢里,0,1,721,16,737,999,3,1,3,0,1,0,73.77
彰化縣,二林鎮,大永里,0,1,608,6,614,869,3,1,3,0,1,0,70.66
彰化縣,二林鎮,原斗里,0,1,835,11,846,1174,3,1,3,0,1,0,72.06
彰化縣,二林鎮,西斗里,0,1,709,9,718,1013,3,1,3,0,1,0,70.88
彰化縣,二林鎮,東華里,0,1,732,6,738,974,3,1,3,0,1,0,75.77
彰化縣,二林鎮,復豐里,0,1,540,8,548,764,3,1,3,0,1,0,71.73
彰化縣,芳苑鄉,芳苑村,0,1,664,15,679,1113,3,1,3,0,1,0,61.01
彰化縣,芳苑鄉,芳中村,0,1,341,5,346,605,3,1,3,0,1,0,57.19
彰化縣,芳苑鄉,仁愛村,0,1,604,8,612,968,3,1,3,0,1,0,63.22
彰化縣,芳苑鄉,信義村,0,1,364,5,369,716,3,1,3,0,1,0,51.54
彰化縣,芳苑鄉,後寮村,0,1,568,8,576,881,3,1,3,0,1,0,65.38
彰化縣,芳苑鄉,三合村,0,1,1119,25,1144,1595,3,1,3,0,1,0,71.72
彰化縣,芳苑鄉,永興村,0,1,883,3,886,1458,3,1,3,0,1,0,60.77
彰化縣,芳苑鄉,新街村,0,1,681,16,697,1143,3,1,3,0,1,0,60.98
彰化縣,芳苑鄉,路上村,0,1,455,6,461,796,3,1,3,0,1,0,57.91
彰化縣,芳苑鄉,路平村,0,1,535,8,543,787,3,1,3,0,1,0,69.00
彰化縣,芳苑鄉,三成村,0,1,680,11,691,1008,3,1,3,0,1,0,68.55
彰化縣,芳苑鄉,福榮村,0,1,443,5,448,736,3,1,3,0,1,0,60.87
彰化縣,芳苑鄉,頂廍村,0,1,434,7,441,701,3,1,3,0,1,0,62.91
彰化縣,芳苑鄉,博愛村,0,1,555,6,561,824,3,1,3,0,1,0,68.08
彰化縣,芳苑鄉,和平村,0,1,486,2,488,832,3,1,3,0,1,0,58.65
彰化縣,芳苑鄉,興仁村,0,1,728,20,748,1330,3,1,3,0,1,0,56.24
彰化縣,芳苑鄉,民生村,0,1,471,6,477,766,3,1,3,0,1,0,62.27
彰化縣,芳苑鄉,新寶村,0,1,873,8,881,1327,3,1,3,0,1,0,66.39
彰化縣,芳苑鄉,五俊村,0,1,329,8,337,638,3,1,3,0,1,0,52.82
彰化縣,芳苑鄉,草湖村,0,1,855,13,868,1304,3,1,3,0,1,0,66.56
彰化縣,芳苑鄉,建平村,0,1,1360,21,1381,1926,3,1,3,0,1,0,71.70
彰化縣,芳苑鄉,崙腳村,0,1,524,7,531,727,3,1,3,0,1,0,73.04
彰化縣,芳苑鄉,文津村,0,1,672,10,682,980,3,1,3,0,1,0,69.59
彰化縣,芳苑鄉,新生村,0,1,820,17,837,1310,3,1,3,0,1,0,63.89
彰化縣,芳苑鄉,漢寶村,0,1,1631,31,1662,2524,3,1,3,0,1,0,65.85
彰化縣,芳苑鄉,王功村,0,1,1186,26,1212,1982,3,1,3,0,1,0,61.15
彰化縣,大城鄉,潭墘村,0,1,882,24,906,1454,3,1,3,0,1,0,62.31
彰化縣,大城鄉,山腳村,0,1,804,22,826,1414,3,1,3,0,1,0,58.42
彰化縣,大城鄉,西城村,0,1,515,8,523,851,3,1,3,0,1,0,61.46
彰化縣,大城鄉,東城村,0,1,833,12,845,1244,3,1,3,0,1,0,67.93
彰化縣,大城鄉,大城村,0,1,717,13,730,1052,3,1,3,0,1,0,69.39
彰化縣,大城鄉,上山村,0,1,742,10,752,1151,3,1,3,0,1,0,65.33
彰化縣,大城鄉,永和村,0,1,456,12,468,784,3,1,3,0,1,0,59.69
彰化縣,大城鄉,公館村,0,1,756,12,768,1227,3,1,3,0,1,0,62.59
彰化縣,大城鄉,豐美村,0,1,525,4,529,860,3,1,3,0,1,0,61.51
彰化縣,大城鄉,三豐村,0,1,411,5,416,763,3,1,3,0,1,0,54.52
彰化縣,大城鄉,菜寮村,0,1,739,17,756,1185,3,1,3,0,1,0,63.80
彰化縣,大城鄉,東港村,0,1,732,12,744,1301,3,1,3,0,1,0,57.19
彰化縣,大城鄉,西港村,0,1,629,8,637,1081,3,1,3,0,1,0,58.93
彰化縣,大城鄉,頂庄村,0,1,477,4,481,859,3,1,3,0,1,0,56.00
彰化縣,大城鄉,台西村,0,1,591,10,601,1040,3,1,3,0,1,0,57.79
彰化縣,竹塘鄉,竹元村,0,1,638,6,644,999,3,1,3,0,1,0,64.46
彰化縣,竹塘鄉,竹塘村,0,1,1136,14,1150,1527,3,1,3,0,1,0,75.31
彰化縣,竹塘鄉,小西村,0,1,562,4,566,836,3,1,3,0,1,0,67.70
彰化縣,竹塘鄉,民靖村,0,1,564,7,571,816,3,1,3,0,1,0,69.98
彰化縣,竹塘鄉,五庄村,0,1,953,18,971,1426,3,1,3,0,1,0,68.09
彰化縣,竹塘鄉,樹腳村,0,1,410,7,417,631,3,1,3,0,1,0,66.09
彰化縣,竹塘鄉,田頭村,0,1,623,7,630,930,3,1,3,0,1,0,67.74
彰化縣,竹塘鄉,新廣村,0,1,854,10,864,1214,3,1,3,0,1,0,71.17
彰化縣,竹塘鄉,溪墘村,0,1,426,5,431,583,3,1,3,0,1,0,73.93
彰化縣,竹塘鄉,竹林村,0,1,611,13,624,894,3,1,3,0,1,0,69.80
彰化縣,竹塘鄉,土庫村,0,1,517,9,526,754,3,1,3,0,1,0,69.76
彰化縣,竹塘鄉,內新村,0,1,462,1,463,661,3,1,3,0,1,0,70.05
彰化縣,竹塘鄉,長安村,0,1,531,5,536,787,3,1,3,0,1,0,68.11
彰化縣,竹塘鄉,永安村,0,1,486,4,490,739,3,1,3,0,1,0,66.31
南投縣,南投市,龍泉里,0,1,648,4,652,986,3,1,3,0,1,0,66.13
南投縣,南投市,康壽里,0,1,829,9,838,1297,3,1,3,0,1,0,64.61
南投縣,南投市,三民里,0,1,494,7,501,769,3,1,3,0,1,0,65.15
南投縣,南投市,仁和里,0,1,417,2,419,578,3,1,3,0,1,0,72.49
南投縣,南投市,南投里,0,1,501,10,511,739,3,1,3,0,1,0,69.15
南投縣,南投市,彰仁里,0,1,277,6,283,439,3,1,3,0,1,0,64.46
南投縣,南投市,崇文里,0,1,697,8,705,1069,3,1,3,0,1,0,65.95
南投縣,南投市,三興里,0,1,2198,32,2230,3596,3,1,3,0,1,0,62.01
南投縣,南投市,三和里,0,1,1743,21,1764,2757,3,1,3,0,1,0,63.98
南投縣,南投市,嘉興里,0,1,928,27,955,1527,3,1,3,0,1,0,62.54
南投縣,南投市,嘉和里,0,1,1477,20,1497,2259,3,1,3,0,1,0,66.27
南投縣,南投市,平和里,0,1,3078,27,3105,4743,3,1,3,0,1,0,65.46
南投縣,南投市,振興里,0,1,1256,20,1276,1966,3,1,3,0,1,0,64.90
南投縣,南投市,千秋里,0,1,521,4,525,815,3,1,3,0,1,0,64.42
南投縣,南投市,軍功里,0,1,2228,29,2257,3334,3,1,3,0,1,0,67.70
南投縣,南投市,東山里,0,1,286,7,293,467,3,1,3,0,1,0,62.74
南投縣,南投市,營南里,0,1,1237,16,1253,1819,3,1,3,0,1,0,68.88
南投縣,南投市,營北里,0,1,2904,26,2930,4128,3,1,3,0,1,0,70.98
南投縣,南投市,內興里,0,1,2534,30,2564,3821,3,1,3,0,1,0,67.10
南投縣,南投市,內新里,0,1,893,8,901,1250,3,1,3,0,1,0,72.08
南投縣,南投市,光輝里,0,1,448,5,453,618,3,1,3,0,1,0,73.30
南投縣,南投市,光榮里,0,1,1407,20,1427,2079,3,1,3,0,1,0,68.64
南投縣,南投市,光明里,0,1,1664,18,1682,2315,3,1,3,0,1,0,72.66
南投縣,南投市,光華里,0,1,1273,16,1289,1738,3,1,3,0,1,0,74.17
南投縣,南投市,漳興里,0,1,1349,13,1362,2035,3,1,3,0,1,0,66.93
南投縣,南投市,漳和里,0,1,3147,41,3188,5037,3,1,3,0,1,0,63.29
南投縣,南投市,平山里,0,1,1918,24,1942,3245,3,1,3,0,1,0,59.85
南投縣,南投市,新興里,0,1,1639,21,1660,2530,3,1,3,0,1,0,65.61
南投縣,南投市,永豐里,0,1,1175,35,1210,2002,3,1,3,0,1,0,60.44
南投縣,南投市,福興里,0,1,1392,24,1416,2336,3,1,3,0,1,0,60.62
南投縣,南投市,鳳山里,0,1,716,11,727,1244,3,1,3,0,1,0,58.44
南投縣,南投市,永興里,0,1,491,7,498,736,3,1,3,0,1,0,67.66
南投縣,南投市,鳳鳴里,0,1,507,10,517,787,3,1,3,0,1,0,65.69
南投縣,南投市,福山里,0,1,998,16,1014,1511,3,1,3,0,1,0,67.11
南投縣,埔里鎮,東門里,0,1,1957,21,1978,3068,3,1,3,0,1,0,64.47
南投縣,埔里鎮,西門里,0,1,1925,13,1938,3182,3,1,3,0,1,0,60.91
南投縣,埔里鎮,南門里,0,1,668,1,669,983,3,1,3,0,1,0,68.06
南投縣,埔里鎮,北門里,0,1,1489,11,1500,2411,3,1,3,0,1,0,62.21
南投縣,埔里鎮,北安里,0,1,1877,11,1888,2886,3,1,3,0,1,0,65.42
南投縣,埔里鎮,泰安里,0,1,995,8,1003,1632,3,1,3,0,1,0,61.46
南投縣,埔里鎮,北梅里,0,1,1108,8,1116,1727,3,1,3,0,1,0,64.62
南投縣,埔里鎮,同聲里,0,1,1388,34,1422,2159,3,1,3,0,1,0,65.86
南投縣,埔里鎮,清新里,0,1,2125,24,2149,3478,3,1,3,0,1,0,61.79
南投縣,埔里鎮,薰化里,0,1,933,13,946,1378,3,1,3,0,1,0,68.65
南投縣,埔里鎮,大城里,0,1,3145,41,3186,5034,3,1,3,0,1,0,63.29
南投縣,埔里鎮,籃城里,0,1,534,1,535,746,3,1,3,0,1,0,71.72
南投縣,埔里鎮,杷城里,0,1,1495,17,1512,2054,3,1,3,0,1,0,73.61
南投縣,埔里鎮,枇杷里,0,1,2879,31,2910,4646,3,1,3,0,1,0,62.63
南投縣,埔里鎮,水頭里,0,1,1532,21,1553,2532,3,1,3,0,1,0,61.33
南投縣,埔里鎮,麒麟里,0,1,593,8,601,916,3,1,3,0,1,0,65.61
南投縣,埔里鎮,珠格里,0,1,619,8,627,910,3,1,3,0,1,0,68.90
南投縣,埔里鎮,溪南里,0,1,454,6,460,707,3,1,3,0,1,0,65.06
南投縣,埔里鎮,桃米里,0,1,540,5,545,945,3,1,3,0,1,0,57.67
南投縣,埔里鎮,成功里,0,1,202,1,203,371,3,1,3,0,1,0,54.72
南投縣,埔里鎮,南村里,0,1,748,7,755,1197,3,1,3,0,1,0,63.07
南投縣,埔里鎮,愛蘭里,0,1,788,5,793,1200,3,1,3,0,1,0,66.08
南投縣,埔里鎮,鐵山里,0,1,951,11,962,1469,3,1,3,0,1,0,65.49
南投縣,埔里鎮,房里里,0,1,744,5,749,1159,3,1,3,0,1,0,64.62
南投縣,埔里鎮,向善里,0,1,465,1,466,683,3,1,3,0,1,0,68.23
南投縣,埔里鎮,一新里,0,1,487,4,491,805,3,1,3,0,1,0,60.99
南投縣,埔里鎮,合成里,0,1,932,8,940,1495,3,1,3,0,1,0,62.88
南投縣,埔里鎮,廣成里,0,1,667,7,674,1125,3,1,3,0,1,0,59.91
南投縣,埔里鎮,史港里,0,1,402,0,402,640,3,1,3,0,1,0,62.81
南投縣,埔里鎮,福興里,0,1,599,4,603,941,3,1,3,0,1,0,64.08
南投縣,埔里鎮,牛眠里,0,1,1576,13,1589,2362,3,1,3,0,1,0,67.27
南投縣,埔里鎮,大湳里,0,1,678,10,688,1069,3,1,3,0,1,0,64.36
南投縣,埔里鎮,蜈蚣里,0,1,1523,21,1544,2430,3,1,3,0,1,0,63.54
南投縣,草屯鎮,玉峰里,0,1,1165,12,1177,1686,3,1,3,0,1,0,69.81
南投縣,草屯鎮,明正里,0,1,2037,22,2059,3030,3,1,3,0,1,0,67.95
南投縣,草屯鎮,炎峰里,0,1,1375,10,1385,1902,3,1,3,0,1,0,72.82
南投縣,草屯鎮,中正里,0,1,524,4,528,728,3,1,3,0,1,0,72.53
南投縣,草屯鎮,和平里,0,1,1065,11,1076,1470,3,1,3,0,1,0,73.20
南投縣,草屯鎮,中山里,0,1,1594,17,1611,2289,3,1,3,0,1,0,70.38
南投縣,草屯鎮,敦和里,0,1,3045,33,3078,4499,3,1,3,0,1,0,68.42
南投縣,草屯鎮,山腳里,0,1,3182,38,3220,4739,3,1,3,0,1,0,67.95
南投縣,草屯鎮,新厝里,0,1,1834,14,1848,2621,3,1,3,0,1,0,70.51
南投縣,草屯鎮,上林里,0,1,1418,10,1428,2023,3,1,3,0,1,0,70.59
南投縣,草屯鎮,碧峰里,0,1,1823,23,1846,2806,3,1,3,0,1,0,65.79
南投縣,草屯鎮,碧洲里,0,1,1006,13,1019,1452,3,1,3,0,1,0,70.18
南投縣,草屯鎮,復興里,0,1,1730,20,1750,2637,3,1,3,0,1,0,66.36
南投縣,草屯鎮,御史里,0,1,2747,29,2776,4175,3,1,3,0,1,0,66.49
南投縣,草屯鎮,新豐里,0,1,2052,19,2071,3044,3,1,3,0,1,0,68.04
南投縣,草屯鎮,新庄里,0,1,1601,39,1640,2443,3,1,3,0,1,0,67.13
南投縣,草屯鎮,加老里,0,1,1105,13,1118,1706,3,1,3,0,1,0,65.53
南投縣,草屯鎮,石川里,0,1,748,12,760,1052,3,1,3,0,1,0,72.24
南投縣,草屯鎮,北投里,0,1,1363,28,1391,2010,3,1,3,0,1,0,69.20
南投縣,草屯鎮,富寮里,0,1,2386,22,2408,3602,3,1,3,0,1,0,66.85
南投縣,草屯鎮,北勢里,0,1,1222,10,1232,1793,3,1,3,0,1,0,68.71
南投縣,草屯鎮,中原里,0,1,1163,11,1174,1684,3,1,3,0,1,0,69.71
南投縣,草屯鎮,南埔里,0,1,1831,18,1849,2749,3,1,3,0,1,0,67.26
南投縣,草屯鎮,坪頂里,0,1,674,7,681,976,3,1,3,0,1,0,69.77
南投縣,草屯鎮,土城里,0,1,954,16,970,1523,3,1,3,0,1,0,63.69
南投縣,草屯鎮,平林里,0,1,635,5,640,935,3,1,3,0,1,0,68.45
南投縣,草屯鎮,雙冬里,0,1,1386,23,1409,2269,3,1,3,0,1,0,62.10
南投縣,竹山鎮,竹山里,0,1,1414,14,1428,2309,3,1,3,0,1,0,61.84
南投縣,竹山鎮,中正里,0,1,452,5,457,777,3,1,3,0,1,0,58.82
南投縣,竹山鎮,中山里,0,1,2384,30,2414,4212,3,1,3,0,1,0,57.31
南投縣,竹山鎮,雲林里,0,1,1791,18,1809,3113,3,1,3,0,1,0,58.11
南投縣,竹山鎮,竹圍里,0,1,1060,22,1082,1950,3,1,3,0,1,0,55.49
南投縣,竹山鎮,桂林里,0,1,1784,16,1800,3171,3,1,3,0,1,0,56.76
南投縣,竹山鎮,下坪里,0,1,486,6,492,880,3,1,3,0,1,0,55.91
南投縣,竹山鎮,中和里,0,1,606,2,608,947,3,1,3,0,1,0,64.20
南投縣,竹山鎮,中崎里,0,1,705,5,710,1170,3,1,3,0,1,0,60.68
南投縣,竹山鎮,秀林里,0,1,516,3,519,858,3,1,3,0,1,0,60.49
南投縣,竹山鎮,大鞍里,0,1,104,0,104,174,3,1,3,0,1,0,59.77
南投縣,竹山鎮,延和里,0,1,1998,24,2022,3605,3,1,3,0,1,0,56.09
南投縣,竹山鎮,延祥里,0,1,1596,28,1624,2766,3,1,3,0,1,0,58.71
南投縣,竹山鎮,延正里,0,1,917,16,933,1596,3,1,3,0,1,0,58.46
南投縣,竹山鎮,延平里,0,1,1593,19,1612,2583,3,1,3,0,1,0,62.41
南投縣,竹山鎮,延山里,0,1,340,1,341,668,3,1,3,0,1,0,51.05
南投縣,竹山鎮,山崇里,0,1,1039,8,1047,1923,3,1,3,0,1,0,54.45
南投縣,竹山鎮,社寮里,0,1,517,5,522,862,3,1,3,0,1,0,60.56
南投縣,竹山鎮,中央里,0,1,864,6,870,1500,3,1,3,0,1,0,58.00
南投縣,竹山鎮,富州里,0,1,420,8,428,749,3,1,3,0,1,0,57.14
南投縣,竹山鎮,田子里,0,1,366,4,370,687,3,1,3,0,1,0,53.86
南投縣,竹山鎮,硘磘里,0,1,649,11,660,1140,3,1,3,0,1,0,57.89
南投縣,竹山鎮,德興里,0,1,562,6,568,890,3,1,3,0,1,0,63.82
南投縣,竹山鎮,福興里,0,1,358,7,365,584,3,1,3,0,1,0,62.50
南投縣,竹山鎮,鯉魚里,0,1,532,9,541,992,3,1,3,0,1,0,54.54
南投縣,竹山鎮,坪頂里,0,1,321,6,327,611,3,1,3,0,1,0,53.52
南投縣,竹山鎮,瑞竹里,0,1,451,6,457,821,3,1,3,0,1,0,55.66
南投縣,竹山鎮,桶頭里,0,1,529,12,541,1077,3,1,3,0,1,0,50.23
南投縣,集集鎮,集集里,0,1,572,7,579,882,3,1,3,0,1,0,65.65
南投縣,集集鎮,和平里,0,1,545,13,558,1008,3,1,3,0,1,0,55.36
南投縣,集集鎮,林尾里,0,1,397,5,402,597,3,1,3,0,1,0,67.34
南投縣,集集鎮,田寮里,0,1,695,12,707,1162,3,1,3,0,1,0,60.84
南投縣,集集鎮,隘寮里,0,1,354,1,355,546,3,1,3,0,1,0,65.02
南投縣,集集鎮,玉映里,0,1,285,5,290,454,3,1,3,0,1,0,63.88
南投縣,集集鎮,吳厝里,0,1,589,7,596,929,3,1,3,0,1,0,64.16
南投縣,集集鎮,八張里,0,1,760,9,769,1261,3,1,3,0,1,0,60.98
南投縣,集集鎮,永昌里,0,1,538,10,548,818,3,1,3,0,1,0,66.99
南投縣,集集鎮,廣明里,0,1,553,7,560,946,3,1,3,0,1,0,59.20
南投縣,集集鎮,富山里,0,1,249,2,251,433,3,1,3,0,1,0,57.97
南投縣,名間鄉,南雅村,0,1,579,4,583,992,3,1,3,0,1,0,58.77
南投縣,名間鄉,中正村,0,1,1547,24,1571,2590,3,1,3,0,1,0,60.66
南投縣,名間鄉,中山村,0,1,1093,15,1108,1788,3,1,3,0,1,0,61.97
南投縣,名間鄉,濁水村,0,1,956,10,966,1522,3,1,3,0,1,0,63.47
南投縣,名間鄉,新民村,0,1,635,8,643,999,3,1,3,0,1,0,64.36
南投縣,名間鄉,炭寮村,0,1,606,5,611,980,3,1,3,0,1,0,62.35
南投縣,名間鄉,新街村,0,1,1842,27,1869,3002,3,1,3,0,1,0,62.26
南投縣,名間鄉,東湖村,0,1,952,20,972,1565,3,1,3,0,1,0,62.11
南投縣,名間鄉,仁和村,0,1,535,3,538,755,3,1,3,0,1,0,71.26
南投縣,名間鄉,萬丹村,0,1,702,11,713,1052,3,1,3,0,1,0,67.78
南投縣,名間鄉,田仔村,0,1,654,6,660,1034,3,1,3,0,1,0,63.83
南投縣,名間鄉,大坑村,0,1,536,5,541,841,3,1,3,0,1,0,64.33
南投縣,名間鄉,大庄村,0,1,1170,14,1184,1904,3,1,3,0,1,0,62.18
南投縣,名間鄉,廍下村,0,1,453,6,459,781,3,1,3,0,1,0,58.77
南投縣,名間鄉,赤水村,0,1,742,11,753,1244,3,1,3,0,1,0,60.53
南投縣,名間鄉,竹圍村,0,1,559,4,563,881,3,1,3,0,1,0,63.90
南投縣,名間鄉,三崙村,0,1,879,13,892,1433,3,1,3,0,1,0,62.25
南投縣,名間鄉,松山村,0,1,1277,14,1291,2298,3,1,3,0,1,0,56.18
南投縣,名間鄉,崁腳村,0,1,454,8,462,741,3,1,3,0,1,0,62.35
南投縣,名間鄉,埔中村,0,1,484,2,486,832,3,1,3,0,1,0,58.41
南投縣,名間鄉,新厝村,0,1,540,2,542,847,3,1,3,0,1,0,63.99
南投縣,名間鄉,新光村,0,1,909,10,919,1502,3,1,3,0,1,0,61.19
南投縣,鹿谷鄉,初鄉村,0,1,811,7,818,1492,3,1,3,0,1,0,54.83
南投縣,鹿谷鄉,鹿谷村,0,1,917,7,924,1567,3,1,3,0,1,0,58.97
南投縣,鹿谷鄉,彰雅村,0,1,663,10,673,1071,3,1,3,0,1,0,62.84
南投縣,鹿谷鄉,廣興村,0,1,1039,16,1055,1762,3,1,3,0,1,0,59.88
南投縣,鹿谷鄉,內湖村,0,1,596,7,603,1107,3,1,3,0,1,0,54.47
南投縣,鹿谷鄉,和雅村,0,1,372,2,374,687,3,1,3,0,1,0,54.44
南投縣,鹿谷鄉,竹林村,0,1,826,3,829,1580,3,1,3,0,1,0,52.47
南投縣,鹿谷鄉,竹豐村,0,1,537,3,540,910,3,1,3,0,1,0,59.34
南投縣,鹿谷鄉,鳳凰村,0,1,836,8,844,1283,3,1,3,0,1,0,65.78
南投縣,鹿谷鄉,永隆村,0,1,976,7,983,1670,3,1,3,0,1,0,58.86
南投縣,鹿谷鄉,秀峰村,0,1,385,5,390,727,3,1,3,0,1,0,53.65
南投縣,鹿谷鄉,清水村,0,1,426,2,428,800,3,1,3,0,1,0,53.50
南投縣,鹿谷鄉,瑞田村,0,1,469,5,474,837,3,1,3,0,1,0,56.63
南投縣,中寮鄉,廣興村,0,1,551,7,558,930,3,1,3,0,1,0,60.00
南投縣,中寮鄉,崁頂村,0,1,383,3,386,561,3,1,3,0,1,0,68.81
南投縣,中寮鄉,八仙村,0,1,481,5,486,801,3,1,3,0,1,0,60.67
南投縣,中寮鄉,福盛村,0,1,467,9,476,905,3,1,3,0,1,0,52.60
南投縣,中寮鄉,和興村,0,1,424,2,426,746,3,1,3,0,1,0,57.10
南投縣,中寮鄉,復興村,0,1,178,1,179,298,3,1,3,0,1,0,60.07
南投縣,中寮鄉,永平村,0,1,1161,20,1181,1880,3,1,3,0,1,0,62.82
南投縣,中寮鄉,中寮村,0,1,429,6,435,728,3,1,3,0,1,0,59.75
南投縣,中寮鄉,廣福村,0,1,344,4,348,574,3,1,3,0,1,0,60.63
南投縣,中寮鄉,永福村,0,1,618,6,624,984,3,1,3,0,1,0,63.41
南投縣,中寮鄉,義和村,0,1,690,13,703,1120,3,1,3,0,1,0,62.77
南投縣,中寮鄉,清水村,0,1,564,9,573,966,3,1,3,0,1,0,59.32
南投縣,中寮鄉,內城村,0,1,333,4,337,498,3,1,3,0,1,0,67.67
南投縣,中寮鄉,龍安村,0,1,519,5,524,764,3,1,3,0,1,0,68.59
南投縣,中寮鄉,爽文村,0,1,375,13,388,609,3,1,3,0,1,0,63.71
南投縣,中寮鄉,龍岩村,0,1,455,7,462,715,3,1,3,0,1,0,64.62
南投縣,中寮鄉,永芳村,0,1,267,2,269,424,3,1,3,0,1,0,63.44
南投縣,中寮鄉,永和村,0,1,391,2,393,599,3,1,3,0,1,0,65.61
南投縣,魚池鄉,魚池村,0,1,1030,7,1037,1777,3,1,3,0,1,0,58.36
南投縣,魚池鄉,東池村,0,1,834,8,842,1518,3,1,3,0,1,0,55.47
南投縣,魚池鄉,大林村,0,1,596,4,600,1038,3,1,3,0,1,0,57.80
南投縣,魚池鄉,東光村,0,1,654,11,665,1193,3,1,3,0,1,0,55.74
南投縣,魚池鄉,共和村,0,1,147,1,148,247,3,1,3,0,1,0,59.92
南投縣,魚池鄉,新城村,0,1,287,2,289,539,3,1,3,0,1,0,53.62
南投縣,魚池鄉,共和村,0,1,126,1,127,217,3,1,3,0,1,0,58.53
南投縣,魚池鄉,新城村,0,1,720,5,725,1230,3,1,3,0,1,0,58.94
南投縣,魚池鄉,大雁村,0,1,398,1,399,622,3,1,3,0,1,0,64.15
南投縣,魚池鄉,五城村,0,1,433,3,436,744,3,1,3,0,1,0,58.60
南投縣,魚池鄉,中明村,0,1,562,4,566,975,3,1,3,0,1,0,58.05
南投縣,魚池鄉,水社村,0,1,457,4,461,756,3,1,3,0,1,0,60.98
南投縣,魚池鄉,日月村,0,1,323,2,325,539,3,1,3,0,1,0,60.30
南投縣,魚池鄉,頭社村,0,1,508,6,514,1065,3,1,3,0,1,0,48.26
南投縣,魚池鄉,武登村,0,1,438,9,447,819,3,1,3,0,1,0,54.58
南投縣,國姓鄉,國姓村,0,1,1062,8,1070,1735,3,1,3,0,1,0,61.67
南投縣,國姓鄉,石門村,0,1,952,18,970,1546,3,1,3,0,1,0,62.74
南投縣,國姓鄉,大旗村,0,1,511,5,516,821,3,1,3,0,1,0,62.85
南投縣,國姓鄉,長流村,0,1,918,13,931,1626,3,1,3,0,1,0,57.26
南投縣,國姓鄉,長福村,0,1,476,5,481,783,3,1,3,0,1,0,61.43
南投縣,國姓鄉,長豐村,0,1,526,11,537,957,3,1,3,0,1,0,56.11
南投縣,國姓鄉,北港村,0,1,1226,16,1242,2148,3,1,3,0,1,0,57.82
南投縣,國姓鄉,福龜村,0,1,1365,17,1382,1996,3,1,3,0,1,0,69.24
南投縣,國姓鄉,乾溝村,0,1,599,3,602,922,3,1,3,0,1,0,65.29
南投縣,國姓鄉,柑林村,0,1,825,7,832,1246,3,1,3,0,1,0,66.77
南投縣,國姓鄉,大石村,0,1,509,7,516,847,3,1,3,0,1,0,60.92
南投縣,國姓鄉,北山村,0,1,1104,14,1118,1695,3,1,3,0,1,0,65.96
南投縣,國姓鄉,南港村,0,1,1140,13,1153,2023,3,1,3,0,1,0,56.99
南投縣,水里鄉,水里村,0,1,470,10,480,924,3,1,3,0,1,0,51.95
南投縣,水里鄉,新城村,0,1,969,20,989,1750,3,1,3,0,1,0,56.51
南投縣,水里鄉,中央村,0,1,442,7,449,740,3,1,3,0,1,0,60.68
南投縣,水里鄉,城中村,0,1,585,8,593,1030,3,1,3,0,1,0,57.57
南投縣,水里鄉,農富村,0,1,354,1,355,559,3,1,3,0,1,0,63.51
南投縣,水里鄉,北埔村,0,1,642,9,651,1085,3,1,3,0,1,0,60.00
南投縣,水里鄉,南光村,0,1,720,8,728,1257,3,1,3,0,1,0,57.92
南投縣,水里鄉,鉅工村,0,1,701,10,711,1130,3,1,3,0,1,0,62.92
南投縣,水里鄉,永豐村,0,1,828,14,842,1346,3,1,3,0,1,0,62.56
南投縣,水里鄉,民和村,0,1,619,4,623,1050,3,1,3,0,1,0,59.33
南投縣,水里鄉,頂崁村,0,1,609,9,618,1122,3,1,3,0,1,0,55.08
南投縣,水里鄉,新山村,0,1,240,3,243,417,3,1,3,0,1,0,58.27
南投縣,水里鄉,郡坑村,0,1,285,4,289,415,3,1,3,0,1,0,69.64
南投縣,水里鄉,上安村,0,1,676,7,683,1287,3,1,3,0,1,0,53.07
南投縣,水里鄉,興隆村,0,1,219,2,221,366,3,1,3,0,1,0,60.38
南投縣,水里鄉,永興村,0,1,232,6,238,383,3,1,3,0,1,0,62.14
南投縣,水里鄉,玉峰村,0,1,582,8,590,923,3,1,3,0,1,0,63.92
南投縣,水里鄉,車埕村,0,1,368,9,377,636,3,1,3,0,1,0,59.28
南投縣,水里鄉,新興村,0,1,371,3,374,692,3,1,3,0,1,0,54.05
南投縣,信義鄉,明德村,0,1,674,2,676,1146,3,1,3,0,1,0,58.99
南投縣,信義鄉,愛國村,0,1,312,3,315,567,3,1,3,0,1,0,55.56
南投縣,信義鄉,自強村,0,1,447,10,457,752,3,1,3,0,1,0,60.77
南投縣,信義鄉,豐丘村,0,1,207,1,208,330,3,1,3,0,1,0,63.03
南投縣,信義鄉,新鄉村,0,1,42,0,42,84,3,1,3,0,1,0,50.00
南投縣,信義鄉,羅娜村,0,1,110,2,112,224,3,1,3,0,1,0,50.00
南投縣,信義鄉,望美村,0,1,144,1,145,287,3,1,3,0,1,0,50.52
南投縣,信義鄉,東埔村,0,1,120,0,120,231,3,1,3,0,1,0,51.95
南投縣,信義鄉,神木村,0,1,441,9,450,778,3,1,3,0,1,0,57.84
南投縣,信義鄉,同富村,0,1,818,5,823,1373,3,1,3,0,1,0,59.94
南投縣,信義鄉,人和村,0,1,111,3,114,260,3,1,3,0,1,0,43.85
南投縣,信義鄉,雙龍村,0,1,12,0,12,18,3,1,3,0,1,0,66.67
南投縣,信義鄉,地利村,0,1,60,2,62,93,3,1,3,0,1,0,66.67
南投縣,信義鄉,潭南村,0,1,25,0,25,41,3,1,3,0,1,0,60.98
南投縣,仁愛鄉,南豐村,0,1,299,2,301,536,3,1,3,0,1,0,56.16
南投縣,仁愛鄉,大同村,0,1,614,13,627,1062,3,1,3,0,1,0,59.04
南投縣,仁愛鄉,榮興村,0,1,63,0,63,89,3,1,3,0,1,0,70.79
南投縣,仁愛鄉,春陽村,0,1,23,1,24,50,3,1,3,0,1,0,48.00
南投縣,仁愛鄉,精英村,0,1,88,2,90,149,3,1,3,0,1,0,60.40
南投縣,仁愛鄉,合作村,0,1,15,1,16,27,3,1,3,0,1,0,59.26
南投縣,仁愛鄉,力行村,0,1,167,4,171,255,3,1,3,0,1,0,67.06
南投縣,仁愛鄉,發祥村,0,1,23,0,23,54,3,1,3,0,1,0,42.59
南投縣,仁愛鄉,親愛村,0,1,36,1,37,88,3,1,3,0,1,0,42.05
南投縣,仁愛鄉,萬豐村,0,1,32,0,32,65,3,1,3,0,1,0,49.23
南投縣,仁愛鄉,法治村,0,1,18,3,21,44,3,1,3,0,1,0,47.73
南投縣,仁愛鄉,中正村,0,1,44,1,45,85,3,1,3,0,1,0,52.94
南投縣,仁愛鄉,互助村,0,1,50,5,55,120,3,1,3,0,1,0,45.83
南投縣,仁愛鄉,新生村,0,1,38,1,39,62,3,1,3,0,1,0,62.90
雲林縣,斗六市,信義里,0,1,708,2,710,978,3,1,3,0,1,0,72.60
雲林縣,斗六市,四維里,0,1,529,4,533,689,3,1,3,0,1,0,77.36
雲林縣,斗六市,太平里,0,1,564,8,572,775,3,1,3,0,1,0,73.81
雲林縣,斗六市,中和里,0,1,496,4,500,655,3,1,3,0,1,0,76.34
雲林縣,斗六市,光興里,0,1,690,13,703,1001,3,1,3,0,1,0,70.23
雲林縣,斗六市,鎮西里,0,1,1548,27,1575,2236,3,1,3,0,1,0,70.44
雲林縣,斗六市,鎮東里,0,1,2368,34,2402,3225,3,1,3,0,1,0,74.48
雲林縣,斗六市,三平里,0,1,1899,38,1937,2712,3,1,3,0,1,0,71.42
雲林縣,斗六市,鎮北里,0,1,3421,65,3486,4972,3,1,3,0,1,0,70.11
雲林縣,斗六市,忠孝里,0,1,1168,17,1185,1603,3,1,3,0,1,0,73.92
雲林縣,斗六市,仁愛里,0,1,811,17,828,1157,3,1,3,0,1,0,71.56
雲林縣,斗六市,八德里,0,1,1487,38,1525,2125,3,1,3,0,1,0,71.76
雲林縣,斗六市,公正里,0,1,1212,24,1236,1774,3,1,3,0,1,0,69.67
雲林縣,斗六市,重光里,0,1,1290,24,1314,1822,3,1,3,0,1,0,72.12
雲林縣,斗六市,林頭里,0,1,3458,58,3516,4828,3,1,3,0,1,0,72.83
雲林縣,斗六市,鎮南里,0,1,1950,23,1973,2792,3,1,3,0,1,0,70.67
雲林縣,斗六市,社口里,0,1,1513,29,1542,2072,3,1,3,0,1,0,74.42
雲林縣,斗六市,龍潭里,0,1,595,11,606,822,3,1,3,0,1,0,73.72
雲林縣,斗六市,嘉東里,0,1,463,4,467,579,3,1,3,0,1,0,80.66
雲林縣,斗六市,崙峰里,0,1,1157,20,1177,1539,3,1,3,0,1,0,76.48
雲林縣,斗六市,溝埧里,0,1,397,7,404,516,3,1,3,0,1,0,78.29
雲林縣,斗六市,江厝里,0,1,742,15,757,1061,3,1,3,0,1,0,71.35
雲林縣,斗六市,三光里,0,1,457,12,469,633,3,1,3,0,1,0,74.09
雲林縣,斗六市,久安里,0,1,1207,20,1227,1599,3,1,3,0,1,0,76.74
雲林縣,斗六市,虎溪里,0,1,2659,56,2715,3660,3,1,3,0,1,0,74.18
雲林縣,斗六市,保庄里,0,1,1870,35,1905,2531,3,1,3,0,1,0,75.27
雲林縣,斗六市,長平里,0,1,1029,11,1040,1345,3,1,3,0,1,0,77.32
雲林縣,斗六市,榴中里,0,1,2287,53,2340,3225,3,1,3,0,1,0,72.56
雲林縣,斗六市,榴北里,0,1,590,12,602,809,3,1,3,0,1,0,74.41
雲林縣,斗六市,榴南里,0,1,560,9,569,753,3,1,3,0,1,0,75.56
雲林縣,斗六市,梅林里,0,1,1313,37,1350,1758,3,1,3,0,1,0,76.79
雲林縣,斗六市,湖山里,0,1,879,22,901,1217,3,1,3,0,1,0,74.03
雲林縣,斗六市,長安里,0,1,1549,39,1588,2078,3,1,3,0,1,0,76.42
雲林縣,斗六市,溪洲里,0,1,1310,35,1345,1893,3,1,3,0,1,0,71.05
雲林縣,斗六市,十三里,0,1,797,15,812,1071,3,1,3,0,1,0,75.82
雲林縣,斗南鎮,東仁里,0,1,810,19,829,1118,3,1,3,0,1,0,74.15
雲林縣,斗南鎮,西岐里,0,1,2332,40,2372,3425,3,1,3,0,1,0,69.26
雲林縣,斗南鎮,南昌里,0,1,1245,22,1267,1886,3,1,3,0,1,0,67.18
雲林縣,斗南鎮,北銘里,0,1,851,9,860,1198,3,1,3,0,1,0,71.79
雲林縣,斗南鎮,中天里,0,1,928,15,943,1334,3,1,3,0,1,0,70.69
雲林縣,斗南鎮,舊社里,0,1,927,15,942,1412,3,1,3,0,1,0,66.71
雲林縣,斗南鎮,林子里,0,1,753,6,759,1053,3,1,3,0,1,0,72.08
雲林縣,斗南鎮,石龜里,0,1,615,6,621,831,3,1,3,0,1,0,74.73
雲林縣,斗南鎮,石溪里,0,1,654,12,666,903,3,1,3,0,1,0,73.75
雲林縣,斗南鎮,靖興里,0,1,675,9,684,890,3,1,3,0,1,0,76.85
雲林縣,斗南鎮,新南里,0,1,502,5,507,714,3,1,3,0,1,0,71.01
雲林縣,斗南鎮,阿丹里,0,1,915,9,924,1180,3,1,3,0,1,0,78.31
雲林縣,斗南鎮,將軍里,0,1,985,13,998,1320,3,1,3,0,1,0,75.61
雲林縣,斗南鎮,東明里,0,1,689,18,707,971,3,1,3,0,1,0,72.81
雲林縣,斗南鎮,新光里,0,1,1557,36,1593,2167,3,1,3,0,1,0,73.51
雲林縣,斗南鎮,田頭里,0,1,1409,29,1438,1928,3,1,3,0,1,0,74.59
雲林縣,斗南鎮,明昌里,0,1,2682,54,2736,3853,3,1,3,0,1,0,71.01
雲林縣,斗南鎮,大東里,0,1,708,10,718,992,3,1,3,0,1,0,72.38
雲林縣,斗南鎮,埤麻里,0,1,622,7,629,889,3,1,3,0,1,0,70.75
雲林縣,斗南鎮,西伯里,0,1,669,14,683,922,3,1,3,0,1,0,74.08
雲林縣,斗南鎮,新崙里,0,1,1125,11,1136,1576,3,1,3,0,1,0,72.08
雲林縣,斗南鎮,小東里,0,1,1080,12,1092,1533,3,1,3,0,1,0,71.23
雲林縣,虎尾鎮,東仁里,0,1,1586,25,1611,2302,3,1,3,0,1,0,69.98
雲林縣,虎尾鎮,新興里,0,1,1141,19,1160,1653,3,1,3,0,1,0,70.18
雲林縣,虎尾鎮,公安里,0,1,1669,21,1690,2457,3,1,3,0,1,0,68.78
雲林縣,虎尾鎮,德興里,0,1,1608,21,1629,2459,3,1,3,0,1,0,66.25
雲林縣,虎尾鎮,中山里,0,1,779,11,790,1136,3,1,3,0,1,0,69.54
雲林縣,虎尾鎮,西安里,0,1,1865,30,1895,2782,3,1,3,0,1,0,68.12
雲林縣,虎尾鎮,立仁里,0,1,1965,35,2000,2873,3,1,3,0,1,0,69.61
雲林縣,虎尾鎮,安慶里,0,1,911,11,922,1241,3,1,3,0,1,0,74.29
雲林縣,虎尾鎮,平和里,0,1,697,9,706,1007,3,1,3,0,1,0,70.11
雲林縣,虎尾鎮,興南里,0,1,800,8,808,1362,3,1,3,0,1,0,59.32
雲林縣,虎尾鎮,新吉里,0,1,1056,19,1075,1574,3,1,3,0,1,0,68.30
雲林縣,虎尾鎮,穎川里,0,1,1060,11,1071,1514,3,1,3,0,1,0,70.74
雲林縣,虎尾鎮,延平里,0,1,541,12,553,750,3,1,3,0,1,0,73.73
雲林縣,虎尾鎮,建國里,0,1,470,8,478,716,3,1,3,0,1,0,66.76
雲林縣,虎尾鎮,埒內里,0,1,1410,20,1430,1964,3,1,3,0,1,0,72.81
雲林縣,虎尾鎮,堀頭里,0,1,561,9,570,726,3,1,3,0,1,0,78.51
雲林縣,虎尾鎮,安溪里,0,1,1048,15,1063,1448,3,1,3,0,1,0,73.41
雲林縣,虎尾鎮,興中里,0,1,992,31,1023,1413,3,1,3,0,1,0,72.40
雲林縣,虎尾鎮,廉使里,0,1,1704,28,1732,2613,3,1,3,0,1,0,66.28
雲林縣,虎尾鎮,惠來里,0,1,1368,18,1386,2120,3,1,3,0,1,0,65.38
雲林縣,虎尾鎮,頂溪里,0,1,1409,25,1434,2090,3,1,3,0,1,0,68.61
雲林縣,虎尾鎮,中溪里,0,1,730,10,740,1139,3,1,3,0,1,0,64.97
雲林縣,虎尾鎮,下溪里,0,1,874,5,879,1192,3,1,3,0,1,0,73.74
雲林縣,虎尾鎮,東屯里,0,1,791,11,802,1044,3,1,3,0,1,0,76.82
雲林縣,虎尾鎮,西屯里,0,1,1057,11,1068,1400,3,1,3,0,1,0,76.29
雲林縣,虎尾鎮,芳草里,0,1,604,8,612,853,3,1,3,0,1,0,71.75
雲林縣,虎尾鎮,墾地里,0,1,654,12,666,926,3,1,3,0,1,0,71.92
雲林縣,虎尾鎮,北溪里,0,1,508,6,514,740,3,1,3,0,1,0,69.46
雲林縣,虎尾鎮,三合里,0,1,629,6,635,977,3,1,3,0,1,0,64.99
雲林縣,西螺鎮,振興里,0,1,1047,10,1057,1485,3,1,3,0,1,0,71.18
雲林縣,西螺鎮,大園里,0,1,905,14,919,1225,3,1,3,0,1,0,75.02
雲林縣,西螺鎮,廣福里,0,1,1136,14,1150,1545,3,1,3,0,1,0,74.43
雲林縣,西螺鎮,正興里,0,1,1730,19,1749,2527,3,1,3,0,1,0,69.21
雲林縣,西螺鎮,永安里,0,1,387,2,389,533,3,1,3,0,1,0,72.98
雲林縣,西螺鎮,中和里,0,1,556,4,560,811,3,1,3,0,1,0,69.05
雲林縣,西螺鎮,福興里,0,1,494,5,499,711,3,1,3,0,1,0,70.18
雲林縣,西螺鎮,光華里,0,1,721,7,728,1020,3,1,3,0,1,0,71.37
雲林縣,西螺鎮,中興里,0,1,1401,12,1413,2033,3,1,3,0,1,0,69.50
雲林縣,西螺鎮,漢光里,0,1,2034,21,2055,2909,3,1,3,0,1,0,70.64
雲林縣,西螺鎮,新安里,0,1,851,8,859,1172,3,1,3,0,1,0,73.29
雲林縣,西螺鎮,新豐里,0,1,964,8,972,1334,3,1,3,0,1,0,72.86
雲林縣,西螺鎮,大新里,0,1,1205,15,1220,1738,3,1,3,0,1,0,70.20
雲林縣,西螺鎮,埤頭里,0,1,623,4,627,906,3,1,3,0,1,0,69.21
雲林縣,西螺鎮,東興里,0,1,810,14,824,1168,3,1,3,0,1,0,70.55
雲林縣,西螺鎮,鹿場里,0,1,993,16,1009,1414,3,1,3,0,1,0,71.36
雲林縣,西螺鎮,廣興里,0,1,600,8,608,855,3,1,3,0,1,0,71.11
雲林縣,西螺鎮,頂湳里,0,1,714,7,721,1003,3,1,3,0,1,0,71.88
雲林縣,西螺鎮,吳厝里,0,1,905,7,912,1348,3,1,3,0,1,0,67.66
雲林縣,西螺鎮,九隆里,0,1,490,5,495,709,3,1,3,0,1,0,69.82
雲林縣,西螺鎮,下湳里,0,1,574,5,579,764,3,1,3,0,1,0,75.79
雲林縣,西螺鎮,七座里,0,1,677,10,687,1016,3,1,3,0,1,0,67.62
雲林縣,西螺鎮,公舘里,0,1,947,9,956,1311,3,1,3,0,1,0,72.92
雲林縣,西螺鎮,詔安里,0,1,636,6,642,951,3,1,3,0,1,0,67.51
雲林縣,西螺鎮,河南里,0,1,598,8,606,896,3,1,3,0,1,0,67.63
雲林縣,西螺鎮,安定里,0,1,1062,11,1073,1694,3,1,3,0,1,0,63.34
雲林縣,西螺鎮,福田里,0,1,986,10,996,1352,3,1,3,0,1,0,73.67
雲林縣,土庫鎮,忠正里,0,1,662,6,668,921,3,1,3,0,1,0,72.53
雲林縣,土庫鎮,順天里,0,1,765,15,780,1055,3,1,3,0,1,0,73.93
雲林縣,土庫鎮,宮北里,0,1,945,16,961,1327,3,1,3,0,1,0,72.42
雲林縣,土庫鎮,越港里,0,1,576,10,586,798,3,1,3,0,1,0,73.43
雲林縣,土庫鎮,溪邊里,0,1,818,6,824,1116,3,1,3,0,1,0,73.84
雲林縣,土庫鎮,石廟里,0,1,881,26,907,1327,3,1,3,0,1,0,68.35
雲林縣,土庫鎮,興新里,0,1,744,7,751,1118,3,1,3,0,1,0,67.17
雲林縣,土庫鎮,奮起里,0,1,855,9,864,1449,3,1,3,0,1,0,59.63
雲林縣,土庫鎮,埤腳里,0,1,955,11,966,1488,3,1,3,0,1,0,64.92
雲林縣,土庫鎮,後埔里,0,1,1487,20,1507,2249,3,1,3,0,1,0,67.01
雲林縣,土庫鎮,崙內里,0,1,906,12,918,1410,3,1,3,0,1,0,65.11
雲林縣,土庫鎮,大荖里,0,1,500,6,506,809,3,1,3,0,1,0,62.55
雲林縣,土庫鎮,東平里,0,1,999,9,1008,1699,3,1,3,0,1,0,59.33
雲林縣,土庫鎮,南平里,0,1,1111,14,1125,1744,3,1,3,0,1,0,64.51
雲林縣,土庫鎮,西平里,0,1,1021,21,1042,1773,3,1,3,0,1,0,58.77
雲林縣,土庫鎮,北平里,0,1,639,3,642,986,3,1,3,0,1,0,65.11
雲林縣,土庫鎮,新庄里,0,1,944,10,954,1399,3,1,3,0,1,0,68.19
雲林縣,北港鎮,東陽里,0,1,593,7,600,881,3,1,3,0,1,0,68.10
雲林縣,北港鎮,光民里,0,1,564,9,573,801,3,1,3,0,1,0,71.54
雲林縣,北港鎮,東華里,0,1,427,2,429,586,3,1,3,0,1,0,73.21
雲林縣,北港鎮,南安里,0,1,723,13,736,1080,3,1,3,0,1,0,68.15
雲林縣,北港鎮,中和里,0,1,317,4,321,460,3,1,3,0,1,0,69.78
雲林縣,北港鎮,義民里,0,1,344,6,350,482,3,1,3,0,1,0,72.61
雲林縣,北港鎮,共榮里,0,1,377,7,384,559,3,1,3,0,1,0,68.69
雲林縣,北港鎮,西勢里,0,1,513,4,517,764,3,1,3,0,1,0,67.67
雲林縣,北港鎮,仁和里,0,1,422,4,426,595,3,1,3,0,1,0,71.60
雲林縣,北港鎮,賜福里,0,1,293,5,298,453,3,1,3,0,1,0,65.78
雲林縣,北港鎮,公舘里,0,1,484,14,498,704,3,1,3,0,1,0,70.74
雲林縣,北港鎮,大同里,0,1,890,10,900,1383,3,1,3,0,1,0,65.08
雲林縣,北港鎮,仁安里,0,1,353,1,354,534,3,1,3,0,1,0,66.29
雲林縣,北港鎮,華勝里,0,1,3164,49,3213,4835,3,1,3,0,1,0,66.45
雲林縣,北港鎮,光復里,0,1,805,9,814,1208,3,1,3,0,1,0,67.38
雲林縣,北港鎮,新街里,0,1,2826,45,2871,4208,3,1,3,0,1,0,68.23
雲林縣,北港鎮,劉厝里,0,1,703,14,717,1127,3,1,3,0,1,0,63.62
雲林縣,北港鎮,後溝里,0,1,551,6,557,972,3,1,3,0,1,0,57.30
雲林縣,北港鎮,新厝里,0,1,265,2,267,403,3,1,3,0,1,0,66.25
雲林縣,北港鎮,府番里,0,1,511,2,513,868,3,1,3,0,1,0,59.10
雲林縣,北港鎮,草湖里,0,1,879,20,899,1399,3,1,3,0,1,0,64.26
雲林縣,北港鎮,溝皂里,0,1,696,11,707,1272,3,1,3,0,1,0,55.58
雲林縣,北港鎮,番溝里,0,1,684,12,696,1137,3,1,3,0,1,0,61.21
雲林縣,北港鎮,大北里,0,1,380,7,387,711,3,1,3,0,1,0,54.43
雲林縣,北港鎮,好收里,0,1,1080,25,1105,1602,3,1,3,0,1,0,68.98
雲林縣,北港鎮,樹腳里,0,1,1575,29,1604,2567,3,1,3,0,1,0,62.49
雲林縣,北港鎮,扶朝里,0,1,636,12,648,1090,3,1,3,0,1,0,59.45
雲林縣,北港鎮,水埔里,0,1,365,4,369,600,3,1,3,0,1,0,61.50
雲林縣,古坑鄉,棋盤村,0,1,1420,21,1441,2075,3,1,3,0,1,0,69.45
雲林縣,古坑鄉,新庄村,0,1,1019,14,1033,1564,3,1,3,0,1,0,66.05
雲林縣,古坑鄉,東和村,0,1,1695,28,1723,2430,3,1,3,0,1,0,70.91
雲林縣,古坑鄉,荷苞村,0,1,1009,19,1028,1405,3,1,3,0,1,0,73.17
雲林縣,古坑鄉,高林村,0,1,827,13,840,1105,3,1,3,0,1,0,76.02
雲林縣,古坑鄉,水碓村,0,1,935,12,947,1237,3,1,3,0,1,0,76.56
雲林縣,古坑鄉,田心村,0,1,639,9,648,848,3,1,3,0,1,0,76.42
雲林縣,古坑鄉,古坑村,0,1,1434,20,1454,1970,3,1,3,0,1,0,73.81
雲林縣,古坑鄉,朝陽村,0,1,1295,18,1313,1822,3,1,3,0,1,0,72.06
雲林縣,古坑鄉,西平村,0,1,978,8,986,1387,3,1,3,0,1,0,71.09
雲林縣,古坑鄉,湳仔村,0,1,561,3,564,726,3,1,3,0,1,0,77.69
雲林縣,古坑鄉,永光村,0,1,1374,11,1385,1863,3,1,3,0,1,0,74.34
雲林縣,古坑鄉,永昌村,0,1,1414,26,1440,1979,3,1,3,0,1,0,72.76
雲林縣,古坑鄉,麻園村,0,1,517,5,522,662,3,1,3,0,1,0,78.85
雲林縣,古坑鄉,崁腳村,0,1,979,15,994,1340,3,1,3,0,1,0,74.18
雲林縣,古坑鄉,華南村,0,1,267,3,270,339,3,1,3,0,1,0,79.65
雲林縣,古坑鄉,華山村,0,1,674,8,682,1050,3,1,3,0,1,0,64.95
雲林縣,古坑鄉,桂林村,0,1,635,6,641,960,3,1,3,0,1,0,66.77
雲林縣,古坑鄉,樟湖村,0,1,385,1,386,571,3,1,3,0,1,0,67.60
雲林縣,古坑鄉,草嶺村,0,1,520,3,523,715,3,1,3,0,1,0,73.15
雲林縣,大埤鄉,北和村,0,1,543,11,554,825,3,1,3,0,1,0,67.15
雲林縣,大埤鄉,南和村,0,1,1391,21,1412,1972,3,1,3,0,1,0,71.60
雲林縣,大埤鄉,大德村,0,1,739,14,753,1134,3,1,3,0,1,0,66.40
雲林縣,大埤鄉,松竹村,0,1,745,8,753,1095,3,1,3,0,1,0,68.77
雲林縣,大埤鄉,尚義村,0,1,1134,15,1149,1754,3,1,3,0,1,0,65.51
雲林縣,大埤鄉,嘉興村,0,1,1299,18,1317,1760,3,1,3,0,1,0,74.83
雲林縣,大埤鄉,豐田村,0,1,719,15,734,1048,3,1,3,0,1,0,70.04
雲林縣,大埤鄉,三結村,0,1,862,11,873,1267,3,1,3,0,1,0,68.90
雲林縣,大埤鄉,吉田村,0,1,523,7,530,834,3,1,3,0,1,0,63.55
雲林縣,大埤鄉,豐岡村,0,1,525,6,531,759,3,1,3,0,1,0,69.96
雲林縣,大埤鄉,聯美村,0,1,846,17,863,1239,3,1,3,0,1,0,69.65
雲林縣,大埤鄉,怡然村,0,1,598,3,601,844,3,1,3,0,1,0,71.21
雲林縣,大埤鄉,北鎮村,0,1,466,6,472,733,3,1,3,0,1,0,64.39
雲林縣,大埤鄉,興安村,0,1,556,8,564,870,3,1,3,0,1,0,64.83
雲林縣,大埤鄉,西鎮村,0,1,612,5,617,906,3,1,3,0,1,0,68.10
雲林縣,莿桐鄉,莿桐村,0,1,2131,36,2167,2953,3,1,3,0,1,0,73.38
雲林縣,莿桐鄉,甘厝村,0,1,680,10,690,919,3,1,3,0,1,0,75.08
雲林縣,莿桐鄉,甘西村,0,1,1000,11,1011,1513,3,1,3,0,1,0,66.82
雲林縣,莿桐鄉,興桐村,0,1,893,18,911,1334,3,1,3,0,1,0,68.29
雲林縣,莿桐鄉,義和村,0,1,772,11,783,1112,3,1,3,0,1,0,70.41
雲林縣,莿桐鄉,埔子村,0,1,1105,21,1126,1626,3,1,3,0,1,0,69.25
雲林縣,莿桐鄉,大美村,0,1,1450,22,1472,2028,3,1,3,0,1,0,72.58
雲林縣,莿桐鄉,埔尾村,0,1,839,10,849,1119,3,1,3,0,1,0,75.87
雲林縣,莿桐鄉,興貴村,0,1,1224,23,1247,1774,3,1,3,0,1,0,70.29
雲林縣,莿桐鄉,饒平村,0,1,826,19,845,1124,3,1,3,0,1,0,75.18
雲林縣,莿桐鄉,四合村,0,1,1070,20,1090,1622,3,1,3,0,1,0,67.20
雲林縣,莿桐鄉,麻園村,0,1,1032,14,1046,1502,3,1,3,0,1,0,69.64
雲林縣,莿桐鄉,五華村,0,1,808,20,828,1260,3,1,3,0,1,0,65.71
雲林縣,莿桐鄉,六合村,0,1,1066,13,1079,1565,3,1,3,0,1,0,68.95
雲林縣,林內鄉,林南村,0,1,777,10,787,1012,3,1,3,0,1,0,77.77
雲林縣,林內鄉,林中村,0,1,2184,42,2226,2957,3,1,3,0,1,0,75.28
雲林縣,林內鄉,林北村,0,1,1412,36,1448,2047,3,1,3,0,1,0,70.74
雲林縣,林內鄉,坪頂村,0,1,506,4,510,657,3,1,3,0,1,0,77.63
雲林縣,林內鄉,林茂村,0,1,708,26,734,999,3,1,3,0,1,0,73.47
雲林縣,林內鄉,九芎村,0,1,1727,40,1767,2392,3,1,3,0,1,0,73.87
雲林縣,林內鄉,湖本村,0,1,407,13,420,609,3,1,3,0,1,0,68.97
雲林縣,林內鄉,烏塗村,0,1,1630,23,1653,2195,3,1,3,0,1,0,75.31
雲林縣,林內鄉,重興村,0,1,1155,25,1180,1628,3,1,3,0,1,0,72.48
雲林縣,二崙鄉,崙東村,0,1,879,8,887,1335,3,1,3,0,1,0,66.44
雲林縣,二崙鄉,崙西村,0,1,1001,10,1011,1520,3,1,3,0,1,0,66.51
雲林縣,二崙鄉,來惠村,0,1,1194,10,1204,1840,3,1,3,0,1,0,65.43
雲林縣,二崙鄉,三和村,0,1,1134,20,1154,1762,3,1,3,0,1,0,65.49
雲林縣,二崙鄉,湳仔村,0,1,828,13,841,1221,3,1,3,0,1,0,68.88
雲林縣,二崙鄉,田尾村,0,1,1301,15,1316,1903,3,1,3,0,1,0,69.15
雲林縣,二崙鄉,定安村,0,1,606,12,618,946,3,1,3,0,1,0,65.33
雲林縣,二崙鄉,永定村,0,1,863,10,873,1258,3,1,3,0,1,0,69.40
雲林縣,二崙鄉,大華村,0,1,634,5,639,949,3,1,3,0,1,0,67.33
雲林縣,二崙鄉,義庄村,0,1,479,4,483,796,3,1,3,0,1,0,60.68
雲林縣,二崙鄉,楊賢村,0,1,998,9,1007,1449,3,1,3,0,1,0,69.50
雲林縣,二崙鄉,港後村,0,1,1248,12,1260,1978,3,1,3,0,1,0,63.70
雲林縣,二崙鄉,大義村,0,1,571,9,580,907,3,1,3,0,1,0,63.95
雲林縣,二崙鄉,油車村,0,1,1187,13,1200,1762,3,1,3,0,1,0,68.10
雲林縣,二崙鄉,大庄村,0,1,897,14,911,1435,3,1,3,0,1,0,63.48
雲林縣,二崙鄉,庄西村,0,1,602,5,607,1031,3,1,3,0,1,0,58.87
雲林縣,二崙鄉,大同村,0,1,571,8,579,810,3,1,3,0,1,0,71.48
雲林縣,二崙鄉,復興村,0,1,699,8,707,1015,3,1,3,0,1,0,69.66
雲林縣,崙背鄉,東明村,0,1,926,17,943,1286,3,1,3,0,1,0,73.33
雲林縣,崙背鄉,西榮村,0,1,924,17,941,1235,3,1,3,0,1,0,76.19
雲林縣,崙背鄉,南陽村,0,1,1545,19,1564,2066,3,1,3,0,1,0,75.70
雲林縣,崙背鄉,崙前村,0,1,1227,17,1244,1875,3,1,3,0,1,0,66.35
雲林縣,崙背鄉,羅厝村,0,1,1169,14,1183,1786,3,1,3,0,1,0,66.24
雲林縣,崙背鄉,港尾村,0,1,834,11,845,1318,3,1,3,0,1,0,64.11
雲林縣,崙背鄉,阿勸村,0,1,1242,13,1255,1852,3,1,3,0,1,0,67.76
雲林縣,崙背鄉,五魁村,0,1,554,3,557,876,3,1,3,0,1,0,63.58
雲林縣,崙背鄉,大有村,0,1,1131,21,1152,1730,3,1,3,0,1,0,66.59
雲林縣,崙背鄉,豐榮村,0,1,1178,20,1198,2011,3,1,3,0,1,0,59.57
雲林縣,崙背鄉,草湖村,0,1,949,20,969,1402,3,1,3,0,1,0,69.12
雲林縣,崙背鄉,舊庄村,0,1,767,12,779,1165,3,1,3,0,1,0,66.87
雲林縣,崙背鄉,水尾村,0,1,809,12,821,1248,3,1,3,0,1,0,65.79
雲林縣,崙背鄉,枋南村,0,1,633,7,640,898,3,1,3,0,1,0,71.27
雲林縣,麥寮鄉,麥豐村,0,1,1786,21,1807,2733,3,1,3,0,1,0,66.12
雲林縣,麥寮鄉,麥津村,0,1,1431,19,1450,2278,3,1,3,0,1,0,63.65
雲林縣,麥寮鄉,瓦窯村,0,1,775,8,783,1308,3,1,3,0,1,0,59.86
雲林縣,麥寮鄉,興華村,0,1,1075,7,1082,1832,3,1,3,0,1,0,59.06
雲林縣,麥寮鄉,海豐村,0,1,856,8,864,1330,3,1,3,0,1,0,64.96
雲林縣,麥寮鄉,後安村,0,1,1220,15,1235,1868,3,1,3,0,1,0,66.11
雲林縣,麥寮鄉,三盛村,0,1,1187,20,1207,1953,3,1,3,0,1,0,61.80
雲林縣,麥寮鄉,崙後村,0,1,1058,25,1083,1800,3,1,3,0,1,0,60.17
雲林縣,麥寮鄉,橋頭村,0,1,1540,26,1566,2350,3,1,3,0,1,0,66.64
雲林縣,麥寮鄉,新吉村,0,1,460,7,467,757,3,1,3,0,1,0,61.69
雲林縣,麥寮鄉,施厝村,0,1,1306,17,1323,2001,3,1,3,0,1,0,66.12
雲林縣,麥寮鄉,雷厝村,0,1,774,23,797,1363,3,1,3,0,1,0,58.47
雲林縣,東勢鄉,月眉村,0,1,712,13,725,1350,3,1,3,0,1,0,53.70
雲林縣,東勢鄉,復興村,0,1,292,2,294,456,3,1,3,0,1,0,64.47
雲林縣,東勢鄉,嘉隆村,0,1,992,15,1007,1765,3,1,3,0,1,0,57.05
雲林縣,東勢鄉,東南村,0,1,864,11,875,1410,3,1,3,0,1,0,62.06
雲林縣,東勢鄉,東北村,0,1,698,4,702,1143,3,1,3,0,1,0,61.42
雲林縣,東勢鄉,昌南村,0,1,563,7,570,963,3,1,3,0,1,0,59.19
雲林縣,東勢鄉,同安村,0,1,1272,24,1296,2085,3,1,3,0,1,0,62.16
雲林縣,東勢鄉,四美村,0,1,872,8,880,1261,3,1,3,0,1,0,69.79
雲林縣,東勢鄉,新坤村,0,1,661,5,666,1212,3,1,3,0,1,0,54.95
雲林縣,東勢鄉,安南村,0,1,550,8,558,975,3,1,3,0,1,0,57.23
雲林縣,東勢鄉,龍潭村,0,1,581,4,585,1036,3,1,3,0,1,0,56.47
雲林縣,東勢鄉,程海村,0,1,352,6,358,579,3,1,3,0,1,0,61.83
雲林縣,褒忠鄉,中民村,0,1,1197,14,1211,1688,3,1,3,0,1,0,71.74
雲林縣,褒忠鄉,埔姜村,0,1,853,6,859,1275,3,1,3,0,1,0,67.37
雲林縣,褒忠鄉,中勝村,0,1,871,12,883,1274,3,1,3,0,1,0,69.31
雲林縣,褒忠鄉,馬鳴村,0,1,834,11,845,1315,3,1,3,0,1,0,64.26
雲林縣,褒忠鄉,新湖村,0,1,811,12,823,1252,3,1,3,0,1,0,65.73
雲林縣,褒忠鄉,有才村,0,1,549,8,557,891,3,1,3,0,1,0,62.51
雲林縣,褒忠鄉,田洋村,0,1,572,13,585,858,3,1,3,0,1,0,68.18
雲林縣,褒忠鄉,龍岩村,0,1,760,10,770,1241,3,1,3,0,1,0,62.05
雲林縣,褒忠鄉,潮厝村,0,1,583,6,589,973,3,1,3,0,1,0,60.53
雲林縣,台西鄉,台西村,0,1,969,12,981,1347,3,1,3,0,1,0,72.83
雲林縣,台西鄉,海南村,0,1,655,11,666,985,3,1,3,0,1,0,67.61
雲林縣,台西鄉,海北村,0,1,717,11,728,964,3,1,3,0,1,0,75.52
雲林縣,台西鄉,海口村,0,1,1341,25,1366,1822,3,1,3,0,1,0,74.97
雲林縣,台西鄉,山寮村,0,1,673,9,682,968,3,1,3,0,1,0,70.45
雲林縣,台西鄉,溪頂村,0,1,803,15,818,1557,3,1,3,0,1,0,52.54
雲林縣,台西鄉,牛厝村,0,1,1246,22,1268,2113,3,1,3,0,1,0,60.01
雲林縣,台西鄉,泉州村,0,1,394,7,401,621,3,1,3,0,1,0,64.57
雲林縣,台西鄉,五榔村,0,1,351,2,353,578,3,1,3,0,1,0,61.07
雲林縣,台西鄉,光華村,0,1,516,14,530,696,3,1,3,0,1,0,76.15
雲林縣,台西鄉,五港村,0,1,1372,9,1381,1788,3,1,3,0,1,0,77.24
雲林縣,台西鄉,富琦村,0,1,1133,12,1145,1539,3,1,3,0,1,0,74.40
雲林縣,台西鄉,永豐村,0,1,1039,16,1055,1390,3,1,3,0,1,0,75.90
雲林縣,台西鄉,和豐村,0,1,2254,28,2282,3229,3,1,3,0,1,0,70.67
雲林縣,台西鄉,蚊港村,0,1,1513,12,1525,1924,3,1,3,0,1,0,79.26
雲林縣,元長鄉,長南村,0,1,1794,19,1813,2890,3,1,3,0,1,0,62.73
雲林縣,元長鄉,長北村,0,1,927,11,938,1584,3,1,3,0,1,0,59.22
雲林縣,元長鄉,子茂村,0,1,831,6,837,1449,3,1,3,0,1,0,57.76
雲林縣,元長鄉,後湖村,0,1,482,4,486,765,3,1,3,0,1,0,63.53
雲林縣,元長鄉,山內村,0,1,678,5,683,1032,3,1,3,0,1,0,66.18
雲林縣,元長鄉,合和村,0,1,646,3,649,1165,3,1,3,0,1,0,55.71
雲林縣,元長鄉,五塊村,0,1,584,5,589,1059,3,1,3,0,1,0,55.62
雲林縣,元長鄉,潭西村,0,1,524,6,530,1005,3,1,3,0,1,0,52.74
雲林縣,元長鄉,潭東村,0,1,434,2,436,720,3,1,3,0,1,0,60.56
雲林縣,元長鄉,客厝村,0,1,456,3,459,832,3,1,3,0,1,0,55.17
雲林縣,元長鄉,卓運村,0,1,280,4,284,483,3,1,3,0,1,0,58.80
雲林縣,元長鄉,頂寮村,0,1,688,7,695,1236,3,1,3,0,1,0,56.23
雲林縣,元長鄉,下寮村,0,1,801,7,808,1491,3,1,3,0,1,0,54.19
雲林縣,元長鄉,龍岩村,0,1,664,5,669,1147,3,1,3,0,1,0,58.33
雲林縣,元長鄉,西莊村,0,1,519,10,529,931,3,1,3,0,1,0,56.82
雲林縣,元長鄉,鹿北村,0,1,892,7,899,1381,3,1,3,0,1,0,65.10
雲林縣,元長鄉,鹿南村,0,1,630,3,633,1067,3,1,3,0,1,0,59.33
雲林縣,元長鄉,瓦窯村,0,1,1040,13,1053,1714,3,1,3,0,1,0,61.44
雲林縣,元長鄉,內寮村,0,1,433,3,436,741,3,1,3,0,1,0,58.84
雲林縣,元長鄉,崙仔村,0,1,586,11,597,994,3,1,3,0,1,0,60.06
雲林縣,元長鄉,新吉村,0,1,487,3,490,747,3,1,3,0,1,0,65.60
雲林縣,四湖鄉,四湖村,0,1,937,9,946,1691,3,1,3,0,1,0,55.94
雲林縣,四湖鄉,湖西村,0,1,1232,17,1249,2092,3,1,3,0,1,0,59.70
雲林縣,四湖鄉,新庄村,0,1,425,7,432,777,3,1,3,0,1,0,55.60
雲林縣,四湖鄉,溪底村,0,1,706,10,716,1225,3,1,3,0,1,0,58.45
雲林縣,四湖鄉,鹿場村,0,1,572,5,577,1176,3,1,3,0,1,0,49.06
雲林縣,四湖鄉,蔡厝村,0,1,562,4,566,1042,3,1,3,0,1,0,54.32
雲林縣,四湖鄉,湖寮村,0,1,418,6,424,917,3,1,3,0,1,0,46.24
雲林縣,四湖鄉,施湖村,0,1,625,8,633,1330,3,1,3,0,1,0,47.59
雲林縣,四湖鄉,羊調村,0,1,583,10,593,1148,3,1,3,0,1,0,51.66
雲林縣,四湖鄉,內湖村,0,1,396,7,403,1009,3,1,3,0,1,0,39.94
雲林縣,四湖鄉,飛東村,0,1,474,3,477,705,3,1,3,0,1,0,67.66
雲林縣,四湖鄉,飛沙村,0,1,848,12,860,1060,3,1,3,0,1,0,81.13
雲林縣,四湖鄉,三姓村,0,1,222,5,227,421,3,1,3,0,1,0,53.92
雲林縣,四湖鄉,崙北村,0,1,959,15,974,1796,3,1,3,0,1,0,54.23
雲林縣,四湖鄉,崙南村,0,1,489,10,499,983,3,1,3,0,1,0,50.76
雲林縣,四湖鄉,廣溝村,0,1,454,6,460,784,3,1,3,0,1,0,58.67
雲林縣,四湖鄉,箔子村,0,1,670,8,678,1050,3,1,3,0,1,0,64.57
雲林縣,四湖鄉,箔東村,0,1,726,11,737,1177,3,1,3,0,1,0,62.62
雲林縣,四湖鄉,林厝村,0,1,634,10,644,1347,3,1,3,0,1,0,47.81
雲林縣,四湖鄉,林東村,0,1,516,9,525,1129,3,1,3,0,1,0,46.50
雲林縣,四湖鄉,溪尾村,0,1,414,6,420,917,3,1,3,0,1,0,45.80
雲林縣,口湖鄉,口湖村,0,1,602,4,606,942,3,1,3,0,1,0,64.33
雲林縣,口湖鄉,湖東村,0,1,785,16,801,1252,3,1,3,0,1,0,63.98
雲林縣,口湖鄉,頂湖村,0,1,491,5,496,779,3,1,3,0,1,0,63.67
雲林縣,口湖鄉,埔南村,0,1,408,2,410,651,3,1,3,0,1,0,62.98
雲林縣,口湖鄉,埔北村,0,1,481,8,489,957,3,1,3,0,1,0,51.10
雲林縣,口湖鄉,謝厝村,0,1,562,8,570,939,3,1,3,0,1,0,60.70
雲林縣,口湖鄉,蚵寮村,0,1,878,14,892,1419,3,1,3,0,1,0,62.86
雲林縣,口湖鄉,下崙村,0,1,988,20,1008,1960,3,1,3,0,1,0,51.43
雲林縣,口湖鄉,崙中村,0,1,970,17,987,1761,3,1,3,0,1,0,56.05
雲林縣,口湖鄉,崙東村,0,1,861,11,872,1500,3,1,3,0,1,0,58.13
雲林縣,口湖鄉,青蚶村,0,1,338,1,339,556,3,1,3,0,1,0,60.97
雲林縣,口湖鄉,港東村,0,1,899,10,909,1344,3,1,3,0,1,0,67.63
雲林縣,口湖鄉,港西村,0,1,520,8,528,780,3,1,3,0,1,0,67.69
雲林縣,口湖鄉,台子村,0,1,965,11,976,1492,3,1,3,0,1,0,65.42
雲林縣,口湖鄉,成龍村,0,1,697,12,709,1042,3,1,3,0,1,0,68.04
雲林縣,口湖鄉,梧南村,0,1,1081,12,1093,1835,3,1,3,0,1,0,59.56
雲林縣,口湖鄉,梧北村,0,1,743,6,749,1344,3,1,3,0,1,0,55.73
雲林縣,口湖鄉,水井村,0,1,627,4,631,1058,3,1,3,0,1,0,59.64
雲林縣,口湖鄉,後厝村,0,1,464,3,467,808,3,1,3,0,1,0,57.80
雲林縣,口湖鄉,湖口村,0,1,560,8,568,993,3,1,3,0,1,0,57.20
雲林縣,口湖鄉,過港村,0,1,471,4,475,747,3,1,3,0,1,0,63.59
雲林縣,水林鄉,水北村,0,1,1388,29,1417,2148,3,1,3,0,1,0,65.97
雲林縣,水林鄉,水南村,0,1,1220,22,1242,1770,3,1,3,0,1,0,70.17
雲林縣,水林鄉,萬興村,0,1,497,9,506,818,3,1,3,0,1,0,61.86
雲林縣,水林鄉,尖山村,0,1,460,6,466,728,3,1,3,0,1,0,64.01
雲林縣,水林鄉,大溝村,0,1,737,12,749,1109,3,1,3,0,1,0,67.54
雲林縣,水林鄉,順興村,0,1,490,16,506,935,3,1,3,0,1,0,54.12
雲林縣,水林鄉,大山村,0,1,802,8,810,1248,3,1,3,0,1,0,64.90
雲林縣,水林鄉,後寮村,0,1,519,15,534,851,3,1,3,0,1,0,62.75
雲林縣,水林鄉,春埔村,0,1,628,5,633,1130,3,1,3,0,1,0,56.02
雲林縣,水林鄉,西井村,0,1,425,7,432,719,3,1,3,0,1,0,60.08
雲林縣,水林鄉,車港村,0,1,409,6,415,722,3,1,3,0,1,0,57.48
雲林縣,水林鄉,蘇秦村,0,1,741,11,752,1310,3,1,3,0,1,0,57.40
雲林縣,水林鄉,灣東村,0,1,443,3,446,801,3,1,3,0,1,0,55.68
雲林縣,水林鄉,灣西村,0,1,627,8,635,1121,3,1,3,0,1,0,56.65
雲林縣,水林鄉,蕃薯村,0,1,598,5,603,1089,3,1,3,0,1,0,55.37
雲林縣,水林鄉,山腳村,0,1,555,11,566,918,3,1,3,0,1,0,61.66
雲林縣,水林鄉,松北村,0,1,764,11,775,1256,3,1,3,0,1,0,61.70
雲林縣,水林鄉,松中村,0,1,387,3,390,668,3,1,3,0,1,0,58.38
雲林縣,水林鄉,松西村,0,1,500,12,512,915,3,1,3,0,1,0,55.96
雲林縣,水林鄉,舊埔村,0,1,532,6,538,916,3,1,3,0,1,0,58.73
雲林縣,水林鄉,塭底村,0,1,494,7,501,834,3,1,3,0,1,0,60.07
雲林縣,水林鄉,海埔村,0,1,727,9,736,1118,3,1,3,0,1,0,65.83
雲林縣,水林鄉,土厝村,0,1,856,8,864,1300,3,1,3,0,1,0,66.46
雲林縣,水林鄉,溪墘村,0,1,531,7,538,840,3,1,3,0,1,0,64.05
嘉義縣,太保市,太保里,0,1,898,15,913,1478,3,1,3,0,1,0,61.77
嘉義縣,太保市,後庄里,0,1,287,3,290,438,3,1,3,0,1,0,66.21
嘉義縣,太保市,前潭里,0,1,832,8,840,1354,3,1,3,0,1,0,62.04
嘉義縣,太保市,後潭里,0,1,811,10,821,1362,3,1,3,0,1,0,60.28
嘉義縣,太保市,梅埔里,0,1,740,12,752,1058,3,1,3,0,1,0,71.08
嘉義縣,太保市,春珠里,0,1,438,5,443,752,3,1,3,0,1,0,58.91
嘉義縣,太保市,崙頂里,0,1,523,10,533,772,3,1,3,0,1,0,69.04
嘉義縣,太保市,安仁里,0,1,438,3,441,669,3,1,3,0,1,0,65.92
嘉義縣,太保市,東勢里,0,1,520,5,525,856,3,1,3,0,1,0,61.33
嘉義縣,太保市,新埤里,0,1,658,14,672,1169,3,1,3,0,1,0,57.49
嘉義縣,太保市,舊埤里,0,1,478,5,483,904,3,1,3,0,1,0,53.43
嘉義縣,太保市,田尾里,0,1,449,11,460,729,3,1,3,0,1,0,63.10
嘉義縣,太保市,港尾里,0,1,364,7,371,584,3,1,3,0,1,0,63.53
嘉義縣,太保市,過溝里,0,1,871,12,883,1532,3,1,3,0,1,0,57.64
嘉義縣,太保市,麻寮里,0,1,1186,30,1216,2068,3,1,3,0,1,0,58.80
嘉義縣,太保市,南新里,0,1,852,13,865,1597,3,1,3,0,1,0,54.16
嘉義縣,太保市,北新里,0,1,1002,18,1020,1891,3,1,3,0,1,0,53.94
嘉義縣,太保市,埤鄉里,0,1,404,9,413,724,3,1,3,0,1,0,57.04
嘉義縣,朴子市,安福里,0,1,1059,13,1072,1810,3,1,3,0,1,0,59.23
嘉義縣,朴子市,平和里,0,1,1023,10,1033,1718,3,1,3,0,1,0,60.13
嘉義縣,朴子市,內厝里,0,1,726,6,732,1142,3,1,3,0,1,0,64.10
嘉義縣,朴子市,開元里,0,1,353,1,354,562,3,1,3,0,1,0,62.99
嘉義縣,朴子市,順天里,0,1,435,9,444,782,3,1,3,0,1,0,56.78
嘉義縣,朴子市,中正里,0,1,490,5,495,746,3,1,3,0,1,0,66.35
嘉義縣,朴子市,博厚里,0,1,514,7,521,791,3,1,3,0,1,0,65.87
嘉義縣,朴子市,文化里,0,1,1119,8,1127,1881,3,1,3,0,1,0,59.91
嘉義縣,朴子市,永和里,0,1,1396,24,1420,2254,3,1,3,0,1,0,63.00
嘉義縣,朴子市,竹圍里,0,1,1889,26,1915,3099,3,1,3,0,1,0,61.79
嘉義縣,朴子市,新寮里,0,1,395,9,404,600,3,1,3,0,1,0,67.33
嘉義縣,朴子市,双溪里,0,1,498,1,499,776,3,1,3,0,1,0,64.30
嘉義縣,朴子市,溪口里,0,1,520,3,523,806,3,1,3,0,1,0,64.89
嘉義縣,朴子市,德興里,0,1,621,5,626,955,3,1,3,0,1,0,65.55
嘉義縣,朴子市,仁和里,0,1,260,8,268,428,3,1,3,0,1,0,62.62
嘉義縣,朴子市,大鄉里,0,1,1538,32,1570,2427,3,1,3,0,1,0,64.69
嘉義縣,朴子市,大葛里,0,1,944,24,968,1494,3,1,3,0,1,0,64.79
嘉義縣,朴子市,佳禾里,0,1,359,5,364,559,3,1,3,0,1,0,65.12
嘉義縣,朴子市,竹村里,0,1,505,7,512,921,3,1,3,0,1,0,55.59
嘉義縣,朴子市,崁前里,0,1,586,8,594,1005,3,1,3,0,1,0,59.10
嘉義縣,朴子市,崁後里,0,1,516,10,526,911,3,1,3,0,1,0,57.74
嘉義縣,朴子市,順安里,0,1,202,1,203,308,3,1,3,0,1,0,65.91
嘉義縣,朴子市,德家里,0,1,462,9,471,811,3,1,3,0,1,0,58.08
嘉義縣,朴子市,新庄里,0,1,366,3,369,569,3,1,3,0,1,0,64.85
嘉義縣,朴子市,梅華里,0,1,715,9,724,1204,3,1,3,0,1,0,60.13
嘉義縣,朴子市,松華里,0,1,830,12,842,1517,3,1,3,0,1,0,55.50
嘉義縣,朴子市,南竹里,0,1,345,4,349,581,3,1,3,0,1,0,60.07
嘉義縣,布袋鎮,岱江里,0,1,443,5,448,809,3,1,3,0,1,0,55.38
嘉義縣,布袋鎮,九龍里,0,1,261,5,266,449,3,1,3,0,1,0,59.24
嘉義縣,布袋鎮,岑海里,0,1,710,8,718,1170,3,1,3,0,1,0,61.37
嘉義縣,布袋鎮,興中里,0,1,696,19,715,1225,3,1,3,0,1,0,58.37
嘉義縣,布袋鎮,光復里,0,1,1078,16,1094,1805,3,1,3,0,1,0,60.61
嘉義縣,布袋鎮,見龍里,0,1,568,7,575,901,3,1,3,0,1,0,63.82
嘉義縣,布袋鎮,新厝里,0,1,457,12,469,791,3,1,3,0,1,0,59.29
嘉義縣,布袋鎮,龍江里,0,1,514,17,531,921,3,1,3,0,1,0,57.65
嘉義縣,布袋鎮,西安里,0,1,841,7,848,1528,3,1,3,0,1,0,55.50
嘉義縣,布袋鎮,中安里,0,1,865,12,877,1641,3,1,3,0,1,0,53.44
嘉義縣,布袋鎮,東安里,0,1,929,8,937,1608,3,1,3,0,1,0,58.27
嘉義縣,布袋鎮,樹林里,0,1,384,9,393,596,3,1,3,0,1,0,65.94
嘉義縣,布袋鎮,貴舍里,0,1,449,4,453,764,3,1,3,0,1,0,59.29
嘉義縣,布袋鎮,永安里,0,1,747,13,760,1332,3,1,3,0,1,0,57.06
嘉義縣,布袋鎮,東港里,0,1,1141,26,1167,1923,3,1,3,0,1,0,60.69
嘉義縣,布袋鎮,江山里,0,1,228,5,233,399,3,1,3,0,1,0,58.40
嘉義縣,布袋鎮,菜舖里,0,1,289,5,294,483,3,1,3,0,1,0,60.87
嘉義縣,布袋鎮,考試里,0,1,251,1,252,394,3,1,3,0,1,0,63.96
嘉義縣,布袋鎮,振寮里,0,1,567,12,579,845,3,1,3,0,1,0,68.52
嘉義縣,布袋鎮,新岑里,0,1,648,6,654,994,3,1,3,0,1,0,65.79
嘉義縣,布袋鎮,新民里,0,1,637,6,643,1178,3,1,3,0,1,0,54.58
嘉義縣,布袋鎮,復興里,0,1,1209,11,1220,2275,3,1,3,0,1,0,53.63
嘉義縣,布袋鎮,好美里,0,1,625,8,633,1044,3,1,3,0,1,0,60.63
嘉義縣,大林鎮,東林里,0,1,335,8,343,546,3,1,3,0,1,0,62.82
嘉義縣,大林鎮,西林里,0,1,1132,16,1148,1868,3,1,3,0,1,0,61.46
嘉義縣,大林鎮,吉林里,0,1,606,5,611,1032,3,1,3,0,1,0,59.21
嘉義縣,大林鎮,平林里,0,1,2225,41,2266,3908,3,1,3,0,1,0,57.98
嘉義縣,大林鎮,明華里,0,1,745,10,755,1209,3,1,3,0,1,0,62.45
嘉義縣,大林鎮,明和里,0,1,763,2,765,1155,3,1,3,0,1,0,66.23
嘉義縣,大林鎮,排路里,0,1,438,1,439,714,3,1,3,0,1,0,61.48
嘉義縣,大林鎮,西結里,0,1,452,5,457,890,3,1,3,0,1,0,51.35
嘉義縣,大林鎮,湖北里,0,1,493,11,504,717,3,1,3,0,1,0,70.29
嘉義縣,大林鎮,大糖里,0,1,254,4,258,368,3,1,3,0,1,0,70.11
嘉義縣,大林鎮,大美里,0,1,1100,21,1121,1806,3,1,3,0,1,0,62.07
嘉義縣,大林鎮,過溪里,0,1,949,19,968,1527,3,1,3,0,1,0,63.39
嘉義縣,大林鎮,中坑里,0,1,1043,21,1064,1673,3,1,3,0,1,0,63.60
嘉義縣,大林鎮,上林里,0,1,613,6,619,972,3,1,3,0,1,0,63.68
嘉義縣,大林鎮,中林里,0,1,895,12,907,1564,3,1,3,0,1,0,57.99
嘉義縣,大林鎮,三和里,0,1,1053,7,1060,1719,3,1,3,0,1,0,61.66
嘉義縣,大林鎮,溝背里,0,1,639,13,652,1034,3,1,3,0,1,0,63.06
嘉義縣,大林鎮,義和里,0,1,434,6,440,701,3,1,3,0,1,0,62.77
嘉義縣,大林鎮,內林里,0,1,558,8,566,826,3,1,3,0,1,0,68.52
嘉義縣,大林鎮,三角里,0,1,770,15,785,1191,3,1,3,0,1,0,65.91
嘉義縣,大林鎮,三村里,0,1,432,7,439,705,3,1,3,0,1,0,62.27
嘉義縣,民雄鄉,東榮村,0,1,1208,13,1221,1993,3,1,3,0,1,0,61.26
嘉義縣,民雄鄉,中樂村,0,1,876,13,889,1518,3,1,3,0,1,0,58.56
嘉義縣,民雄鄉,西安村,0,1,1552,14,1566,2661,3,1,3,0,1,0,58.85
嘉義縣,民雄鄉,寮頂村,0,1,1042,20,1062,1812,3,1,3,0,1,0,58.61
嘉義縣,民雄鄉,福權村,0,1,652,9,661,1033,3,1,3,0,1,0,63.99
嘉義縣,民雄鄉,東湖村,0,1,1161,17,1178,1748,3,1,3,0,1,0,67.39
嘉義縣,民雄鄉,頂崙村,0,1,772,12,784,1294,3,1,3,0,1,0,60.59
嘉義縣,民雄鄉,豐收村,0,1,1135,21,1156,1741,3,1,3,0,1,0,66.40
嘉義縣,民雄鄉,三興村,0,1,495,12,507,794,3,1,3,0,1,0,63.85
嘉義縣,民雄鄉,東興村,0,1,331,0,331,626,3,1,3,0,1,0,52.88
嘉義縣,民雄鄉,鎮北村,0,1,492,8,500,753,3,1,3,0,1,0,66.40
嘉義縣,民雄鄉,菁埔村,0,1,953,14,967,1624,3,1,3,0,1,0,59.54
嘉義縣,民雄鄉,中和村,0,1,426,11,437,674,3,1,3,0,1,0,64.84
嘉義縣,民雄鄉,平和村,0,1,407,3,410,621,3,1,3,0,1,0,66.02
嘉義縣,民雄鄉,西昌村,0,1,411,4,415,695,3,1,3,0,1,0,59.71
嘉義縣,民雄鄉,興中村,0,1,834,20,854,1467,3,1,3,0,1,0,58.21
嘉義縣,民雄鄉,興南村,0,1,989,26,1015,1853,3,1,3,0,1,0,54.78
嘉義縣,民雄鄉,金興村,0,1,1191,17,1208,2066,3,1,3,0,1,0,58.47
嘉義縣,民雄鄉,福興村,0,1,883,23,906,1523,3,1,3,0,1,0,59.49
嘉義縣,民雄鄉,文隆村,0,1,1021,18,1039,1783,3,1,3,0,1,0,58.27
嘉義縣,民雄鄉,山中村,0,1,1869,25,1894,2906,3,1,3,0,1,0,65.18
嘉義縣,民雄鄉,中央村,0,1,751,4,755,1090,3,1,3,0,1,0,69.27
嘉義縣,民雄鄉,北斗村,0,1,1441,25,1466,2618,3,1,3,0,1,0,56.00
嘉義縣,民雄鄉,雙福村,0,1,852,15,867,1376,3,1,3,0,1,0,63.01
嘉義縣,民雄鄉,福樂村,0,1,1395,29,1424,2577,3,1,3,0,1,0,55.26
嘉義縣,民雄鄉,大崎村,0,1,1055,25,1080,1743,3,1,3,0,1,0,61.96
嘉義縣,民雄鄉,秀林村,0,1,1025,17,1042,1758,3,1,3,0,1,0,59.27
嘉義縣,民雄鄉,松山村,0,1,774,7,781,1505,3,1,3,0,1,0,51.89
嘉義縣,溪口鄉,溪東村,0,1,806,8,814,1352,3,1,3,0,1,0,60.21
嘉義縣,溪口鄉,溪西村,0,1,452,9,461,826,3,1,3,0,1,0,55.81
嘉義縣,溪口鄉,溪北村,0,1,410,4,414,745,3,1,3,0,1,0,55.57
嘉義縣,溪口鄉,柴林村,0,1,463,3,466,875,3,1,3,0,1,0,53.26
嘉義縣,溪口鄉,林腳村,0,1,509,6,515,976,3,1,3,0,1,0,52.77
嘉義縣,溪口鄉,美南村,0,1,671,11,682,1222,3,1,3,0,1,0,55.81
嘉義縣,溪口鄉,美北村,0,1,528,11,539,1023,3,1,3,0,1,0,52.69
嘉義縣,溪口鄉,本厝村,0,1,629,8,637,957,3,1,3,0,1,0,66.56
嘉義縣,溪口鄉,游東村,0,1,622,10,632,1121,3,1,3,0,1,0,56.38
嘉義縣,溪口鄉,游西村,0,1,409,7,416,802,3,1,3,0,1,0,51.87
嘉義縣,溪口鄉,柳溝村,0,1,739,12,751,1242,3,1,3,0,1,0,60.47
嘉義縣,溪口鄉,疊溪村,0,1,522,5,527,949,3,1,3,0,1,0,55.53
嘉義縣,溪口鄉,妙崙村,0,1,430,3,433,764,3,1,3,0,1,0,56.68
嘉義縣,溪口鄉,坪頂村,0,1,533,16,549,861,3,1,3,0,1,0,63.76
嘉義縣,新港鄉,宮前村,0,1,908,8,916,1574,3,1,3,0,1,0,58.20
嘉義縣,新港鄉,宮後村,0,1,904,16,920,1697,3,1,3,0,1,0,54.21
嘉義縣,新港鄉,大興村,0,1,819,11,830,1350,3,1,3,0,1,0,61.48
嘉義縣,新港鄉,福德村,0,1,749,12,761,1412,3,1,3,0,1,0,53.90
嘉義縣,新港鄉,古民村,0,1,648,6,654,1178,3,1,3,0,1,0,55.52
嘉義縣,新港鄉,中庄村,0,1,869,9,878,1507,3,1,3,0,1,0,58.26
嘉義縣,新港鄉,大潭村,0,1,906,19,925,1571,3,1,3,0,1,0,58.88
嘉義縣,新港鄉,西庄村,0,1,489,7,496,920,3,1,3,0,1,0,53.91
嘉義縣,新港鄉,月眉村,0,1,921,24,945,1605,3,1,3,0,1,0,58.88
嘉義縣,新港鄉,月潭村,0,1,858,17,875,1434,3,1,3,0,1,0,61.02
嘉義縣,新港鄉,溪北村,0,1,809,12,821,1397,3,1,3,0,1,0,58.77
嘉義縣,新港鄉,菜公村,0,1,489,4,493,808,3,1,3,0,1,0,61.01
嘉義縣,新港鄉,中洋村,0,1,71,8,79,957,3,1,3,0,1,0,8.25
嘉義縣,新港鄉,三間村,0,1,55,1,56,692,3,1,3,0,1,0,8.09
嘉義縣,新港鄉,安和村,0,1,674,15,689,1153,3,1,3,0,1,0,59.76
嘉義縣,新港鄉,潭大村,0,1,599,10,609,1155,3,1,3,0,1,0,52.73
嘉義縣,新港鄉,南港村,0,1,541,27,568,1104,3,1,3,0,1,0,51.45
嘉義縣,新港鄉,板頭村,0,1,380,6,386,666,3,1,3,0,1,0,57.96
嘉義縣,新港鄉,共和村,0,1,395,4,399,797,3,1,3,0,1,0,50.06
嘉義縣,新港鄉,埤子村,0,1,317,6,323,599,3,1,3,0,1,0,53.92
嘉義縣,新港鄉,南崙村,0,1,517,8,525,979,3,1,3,0,1,0,53.63
嘉義縣,新港鄉,北崙村,0,1,329,2,331,646,3,1,3,0,1,0,51.24
嘉義縣,新港鄉,海瀛村,0,1,289,2,291,502,3,1,3,0,1,0,57.97
嘉義縣,六腳鄉,蒜頭村,0,1,784,13,797,1275,3,1,3,0,1,0,62.51
嘉義縣,六腳鄉,蒜東村,0,1,509,4,513,964,3,1,3,0,1,0,53.22
嘉義縣,六腳鄉,蒜南村,0,1,500,12,512,867,3,1,3,0,1,0,59.05
嘉義縣,六腳鄉,工廠村,0,1,286,14,300,403,3,1,3,0,1,0,74.44
嘉義縣,六腳鄉,灣南村,0,1,765,12,777,1251,3,1,3,0,1,0,62.11
嘉義縣,六腳鄉,灣北村,0,1,760,8,768,1382,3,1,3,0,1,0,55.57
嘉義縣,六腳鄉,雙涵村,0,1,490,5,495,869,3,1,3,0,1,0,56.96
嘉義縣,六腳鄉,塗師村,0,1,488,4,492,760,3,1,3,0,1,0,64.74
嘉義縣,六腳鄉,三義村,0,1,442,6,448,813,3,1,3,0,1,0,55.10
嘉義縣,六腳鄉,正義村,0,1,812,8,820,1400,3,1,3,0,1,0,58.57
嘉義縣,六腳鄉,溪厝村,0,1,379,8,387,676,3,1,3,0,1,0,57.25
嘉義縣,六腳鄉,港美村,0,1,445,9,454,805,3,1,3,0,1,0,56.40
嘉義縣,六腳鄉,豐美村,0,1,578,9,587,1132,3,1,3,0,1,0,51.86
嘉義縣,六腳鄉,六斗村,0,1,461,14,475,825,3,1,3,0,1,0,57.58
嘉義縣,六腳鄉,崙陽村,0,1,555,7,562,1046,3,1,3,0,1,0,53.73
嘉義縣,六腳鄉,蘇厝村,0,1,753,7,760,1396,3,1,3,0,1,0,54.44
嘉義縣,六腳鄉,竹本村,0,1,390,5,395,752,3,1,3,0,1,0,52.53
嘉義縣,六腳鄉,永賢村,0,1,333,5,338,618,3,1,3,0,1,0,54.69
嘉義縣,六腳鄉,魚寮村,0,1,455,3,458,870,3,1,3,0,1,0,52.64
嘉義縣,六腳鄉,潭墘村,0,1,547,9,556,998,3,1,3,0,1,0,55.71
嘉義縣,六腳鄉,六腳村,0,1,539,7,546,975,3,1,3,0,1,0,56.00
嘉義縣,六腳鄉,六南村,0,1,399,5,404,725,3,1,3,0,1,0,55.72
嘉義縣,六腳鄉,崩山村,0,1,459,6,465,835,3,1,3,0,1,0,55.69
嘉義縣,六腳鄉,古林村,0,1,512,9,521,936,3,1,3,0,1,0,55.66
嘉義縣,六腳鄉,更寮村,0,1,401,4,405,705,3,1,3,0,1,0,57.45
嘉義縣,東石鄉,東石村,0,1,893,14,907,1617,3,1,3,0,1,0,56.09
嘉義縣,東石鄉,猿樹村,0,1,540,6,546,1010,3,1,3,0,1,0,54.06
嘉義縣,東石鄉,塭港村,0,1,825,15,840,1477,3,1,3,0,1,0,56.87
嘉義縣,東石鄉,型厝村,0,1,869,13,882,1476,3,1,3,0,1,0,59.76
嘉義縣,東石鄉,三家村,0,1,672,5,677,1251,3,1,3,0,1,0,54.12
嘉義縣,東石鄉,永屯村,0,1,405,4,409,715,3,1,3,0,1,0,57.20
嘉義縣,東石鄉,海埔村,0,1,265,1,266,475,3,1,3,0,1,0,56.00
嘉義縣,東石鄉,龍港村,0,1,602,5,607,1094,3,1,3,0,1,0,55.48
嘉義縣,東石鄉,副瀨村,0,1,771,12,783,1132,3,1,3,0,1,0,69.17
嘉義縣,東石鄉,下揖村,0,1,506,9,515,937,3,1,3,0,1,0,54.96
嘉義縣,東石鄉,頂揖村,0,1,246,0,246,480,3,1,3,0,1,0,51.25
嘉義縣,東石鄉,溪下村,0,1,616,9,625,1136,3,1,3,0,1,0,55.02
嘉義縣,東石鄉,港口村,0,1,223,0,223,418,3,1,3,0,1,0,53.35
嘉義縣,東石鄉,鰲鼓村,0,1,834,13,847,1384,3,1,3,0,1,0,61.20
嘉義縣,東石鄉,港墘村,0,1,811,14,825,1298,3,1,3,0,1,0,63.56
嘉義縣,東石鄉,蔦松村,0,1,601,3,604,938,3,1,3,0,1,0,64.39
嘉義縣,東石鄉,圍潭村,0,1,433,11,444,830,3,1,3,0,1,0,53.49
嘉義縣,東石鄉,洲仔村,0,1,548,7,555,936,3,1,3,0,1,0,59.29
嘉義縣,東石鄉,東崙村,0,1,489,9,498,848,3,1,3,0,1,0,58.73
嘉義縣,東石鄉,西崙村,0,1,600,13,613,991,3,1,3,0,1,0,61.86
嘉義縣,東石鄉,塭仔村,0,1,589,5,594,1022,3,1,3,0,1,0,58.12
嘉義縣,東石鄉,網寮村,0,1,636,3,639,1211,3,1,3,0,1,0,52.77
嘉義縣,東石鄉,掌潭村,0,1,508,4,512,825,3,1,3,0,1,0,62.06
嘉義縣,義竹鄉,岸腳村,0,1,575,17,592,869,3,1,3,0,1,0,68.12
嘉義縣,義竹鄉,義竹村,0,1,993,18,1011,1597,3,1,3,0,1,0,63.31
嘉義縣,義竹鄉,六桂村,0,1,959,9,968,1382,3,1,3,0,1,0,70.04
嘉義縣,義竹鄉,仁里村,0,1,677,7,684,898,3,1,3,0,1,0,76.17
嘉義縣,義竹鄉,傳芳村,0,1,429,8,437,695,3,1,3,0,1,0,62.88
嘉義縣,義竹鄉,頭竹村,0,1,921,15,936,1316,3,1,3,0,1,0,71.12
嘉義縣,義竹鄉,五厝村,0,1,269,2,271,403,3,1,3,0,1,0,67.25
嘉義縣,義竹鄉,中平村,0,1,348,2,350,533,3,1,3,0,1,0,65.67
嘉義縣,義竹鄉,埤前村,0,1,570,9,579,819,3,1,3,0,1,0,70.70
嘉義縣,義竹鄉,平溪村,0,1,296,2,298,434,3,1,3,0,1,0,68.66
嘉義縣,義竹鄉,後鎮村,0,1,376,6,382,546,3,1,3,0,1,0,69.96
嘉義縣,義竹鄉,北華村,0,1,394,2,396,569,3,1,3,0,1,0,69.60
嘉義縣,義竹鄉,新店村,0,1,964,7,971,1479,3,1,3,0,1,0,65.65
嘉義縣,義竹鄉,東過村,0,1,538,8,546,871,3,1,3,0,1,0,62.69
嘉義縣,義竹鄉,西過村,0,1,563,9,572,947,3,1,3,0,1,0,60.40
嘉義縣,義竹鄉,官和村,0,1,552,6,558,835,3,1,3,0,1,0,66.83
嘉義縣,義竹鄉,官順村,0,1,335,5,340,570,3,1,3,0,1,0,59.65
嘉義縣,義竹鄉,新富村,0,1,415,7,422,546,3,1,3,0,1,0,77.29
嘉義縣,義竹鄉,東光村,0,1,606,8,614,913,3,1,3,0,1,0,67.25
嘉義縣,義竹鄉,東榮村,0,1,345,5,350,531,3,1,3,0,1,0,65.91
嘉義縣,義竹鄉,龍蛟村,0,1,479,4,483,773,3,1,3,0,1,0,62.48
嘉義縣,義竹鄉,溪洲村,0,1,512,4,516,840,3,1,3,0,1,0,61.43
嘉義縣,鹿草鄉,後寮村,0,1,294,4,298,493,3,1,3,0,1,0,60.45
嘉義縣,鹿草鄉,鹿東村,0,1,408,7,415,659,3,1,3,0,1,0,62.97
嘉義縣,鹿草鄉,鹿草村,0,1,795,10,805,1250,3,1,3,0,1,0,64.40
嘉義縣,鹿草鄉,西井村,0,1,689,15,704,1162,3,1,3,0,1,0,60.59
嘉義縣,鹿草鄉,豐稠村,0,1,250,2,252,413,3,1,3,0,1,0,61.02
嘉義縣,鹿草鄉,重寮村,0,1,739,10,749,1179,3,1,3,0,1,0,63.53
嘉義縣,鹿草鄉,施家村,0,1,326,8,334,561,3,1,3,0,1,0,59.54
嘉義縣,鹿草鄉,下潭村,0,1,593,6,599,1017,3,1,3,0,1,0,58.90
嘉義縣,鹿草鄉,光潭村,0,1,680,14,694,1173,3,1,3,0,1,0,59.16
嘉義縣,鹿草鄉,碧潭村,0,1,668,16,684,1149,3,1,3,0,1,0,59.53
嘉義縣,鹿草鄉,松竹村,0,1,553,11,564,973,3,1,3,0,1,0,57.97
嘉義縣,鹿草鄉,竹山村,0,1,535,8,543,937,3,1,3,0,1,0,57.95
嘉義縣,鹿草鄉,後堀村,0,1,859,15,874,1350,3,1,3,0,1,0,64.74
嘉義縣,鹿草鄉,三角村,0,1,939,13,952,1533,3,1,3,0,1,0,62.10
嘉義縣,鹿草鄉,下麻村,0,1,369,4,373,578,3,1,3,0,1,0,64.53
嘉義縣,水上鄉,水上村,0,1,1584,31,1615,2526,3,1,3,0,1,0,63.94
嘉義縣,水上鄉,水頭村,0,1,1125,18,1143,1734,3,1,3,0,1,0,65.92
嘉義縣,水上鄉,大堀村,0,1,842,15,857,1274,3,1,3,0,1,0,67.27
嘉義縣,水上鄉,大崙村,0,1,1082,22,1104,1746,3,1,3,0,1,0,63.23
嘉義縣,水上鄉,塗溝村,0,1,471,5,476,765,3,1,3,0,1,0,62.22
嘉義縣,水上鄉,粗溪村,0,1,867,9,876,1364,3,1,3,0,1,0,64.22
嘉義縣,水上鄉,下寮村,0,1,961,21,982,1481,3,1,3,0,1,0,66.31
嘉義縣,水上鄉,三和村,0,1,1068,21,1089,1577,3,1,3,0,1,0,69.06
嘉義縣,水上鄉,回歸村,0,1,434,9,443,662,3,1,3,0,1,0,66.92
嘉義縣,水上鄉,三鎮村,0,1,438,13,451,691,3,1,3,0,1,0,65.27
嘉義縣,水上鄉,靖和村,0,1,394,4,398,549,3,1,3,0,1,0,72.50
嘉義縣,水上鄉,南和村,0,1,750,23,773,1164,3,1,3,0,1,0,66.41
嘉義縣,水上鄉,龍德村,0,1,1052,11,1063,1596,3,1,3,0,1,0,66.60
嘉義縣,水上鄉,溪洲村,0,1,646,7,653,998,3,1,3,0,1,0,65.43
嘉義縣,水上鄉,柳新村,0,1,1292,40,1332,2004,3,1,3,0,1,0,66.47
嘉義縣,水上鄉,柳林村,0,1,955,18,973,1645,3,1,3,0,1,0,59.15
嘉義縣,水上鄉,柳鄉村,0,1,994,10,1004,1574,3,1,3,0,1,0,63.79
嘉義縣,水上鄉,內溪村,0,1,567,11,578,888,3,1,3,0,1,0,65.09
嘉義縣,水上鄉,寬士村,0,1,1548,18,1566,2634,3,1,3,0,1,0,59.45
嘉義縣,水上鄉,民生村,0,1,1576,35,1611,2622,3,1,3,0,1,0,61.44
嘉義縣,水上鄉,義興村,0,1,487,6,493,729,3,1,3,0,1,0,67.63
嘉義縣,水上鄉,中庄村,0,1,1125,16,1141,1738,3,1,3,0,1,0,65.65
嘉義縣,水上鄉,忠和村,0,1,1094,27,1121,1768,3,1,3,0,1,0,63.40
嘉義縣,水上鄉,南鄉村,0,1,475,4,479,830,3,1,3,0,1,0,57.71
嘉義縣,水上鄉,三界村,0,1,650,8,658,1017,3,1,3,0,1,0,64.70
嘉義縣,水上鄉,國姓村,0,1,715,10,725,1263,3,1,3,0,1,0,57.40
嘉義縣,中埔鄉,中埔村,0,1,981,21,1002,1533,3,1,3,0,1,0,65.36
嘉義縣,中埔鄉,塩舘村,0,1,430,6,436,746,3,1,3,0,1,0,58.45
嘉義縣,中埔鄉,龍門村,0,1,450,12,462,712,3,1,3,0,1,0,64.89
嘉義縣,中埔鄉,裕民村,0,1,455,14,469,818,3,1,3,0,1,0,57.33
嘉義縣,中埔鄉,金蘭村,0,1,747,13,760,1278,3,1,3,0,1,0,59.47
嘉義縣,中埔鄉,富收村,0,1,1256,14,1270,2151,3,1,3,0,1,0,59.04
嘉義縣,中埔鄉,和睦村,0,1,1121,15,1136,2105,3,1,3,0,1,0,53.97
嘉義縣,中埔鄉,和美村,0,1,2555,46,2601,4681,3,1,3,0,1,0,55.57
嘉義縣,中埔鄉,和興村,0,1,2161,36,2197,4277,3,1,3,0,1,0,51.37
嘉義縣,中埔鄉,隆興村,0,1,958,17,975,1588,3,1,3,0,1,0,61.40
嘉義縣,中埔鄉,義仁村,0,1,745,12,757,1208,3,1,3,0,1,0,62.67
嘉義縣,中埔鄉,社口村,0,1,1174,8,1182,1968,3,1,3,0,1,0,60.06
嘉義縣,中埔鄉,灣潭村,0,1,721,7,728,1111,3,1,3,0,1,0,65.53
嘉義縣,中埔鄉,石硦村,0,1,814,10,824,1154,3,1,3,0,1,0,71.40
嘉義縣,中埔鄉,頂埔村,0,1,570,7,577,907,3,1,3,0,1,0,63.62
嘉義縣,中埔鄉,同仁村,0,1,1144,17,1161,1818,3,1,3,0,1,0,63.86
嘉義縣,中埔鄉,深坑村,0,1,521,6,527,726,3,1,3,0,1,0,72.59
嘉義縣,中埔鄉,三層村,0,1,407,3,410,622,3,1,3,0,1,0,65.92
嘉義縣,中埔鄉,瑞豐村,0,1,475,2,477,703,3,1,3,0,1,0,67.85
嘉義縣,中埔鄉,沄水村,0,1,738,6,744,1112,3,1,3,0,1,0,66.91
嘉義縣,中埔鄉,東興村,0,1,200,2,202,317,3,1,3,0,1,0,63.72
嘉義縣,中埔鄉,中崙村,0,1,217,2,219,331,3,1,3,0,1,0,66.16
嘉義縣,竹崎鄉,竹崎村,0,1,1247,32,1279,2038,3,1,3,0,1,0,62.76
嘉義縣,竹崎鄉,和平村,0,1,1085,15,1100,1686,3,1,3,0,1,0,65.24
嘉義縣,竹崎鄉,坑頭村,0,1,414,2,416,737,3,1,3,0,1,0,56.45
嘉義縣,竹崎鄉,沙坑村,0,1,543,12,555,840,3,1,3,0,1,0,66.07
嘉義縣,竹崎鄉,獅埜村,0,1,731,5,736,1256,3,1,3,0,1,0,58.60
嘉義縣,竹崎鄉,義和村,0,1,366,3,369,542,3,1,3,0,1,0,68.08
嘉義縣,竹崎鄉,義仁村,0,1,642,6,648,1027,3,1,3,0,1,0,63.10
嘉義縣,竹崎鄉,灣橋村,0,1,2504,21,2525,4149,3,1,3,0,1,0,60.86
嘉義縣,竹崎鄉,鹿滿村,0,1,754,13,767,1256,3,1,3,0,1,0,61.07
嘉義縣,竹崎鄉,紫雲村,0,1,845,5,850,1292,3,1,3,0,1,0,65.79
嘉義縣,竹崎鄉,內埔村,0,1,1010,10,1020,1560,3,1,3,0,1,0,65.38
嘉義縣,竹崎鄉,昇平村,0,1,1128,21,1149,1671,3,1,3,0,1,0,68.76
嘉義縣,竹崎鄉,桃源村,0,1,723,4,727,1108,3,1,3,0,1,0,65.61
嘉義縣,竹崎鄉,白杞村,0,1,481,5,486,737,3,1,3,0,1,0,65.94
嘉義縣,竹崎鄉,塘興村,0,1,582,6,588,893,3,1,3,0,1,0,65.85
嘉義縣,竹崎鄉,義隆村,0,1,343,3,346,535,3,1,3,0,1,0,64.67
嘉義縣,竹崎鄉,龍山村,0,1,145,0,145,234,3,1,3,0,1,0,61.97
嘉義縣,竹崎鄉,文峯村,0,1,828,15,843,1358,3,1,3,0,1,0,62.08
嘉義縣,竹崎鄉,金獅村,0,1,485,10,495,844,3,1,3,0,1,0,58.65
嘉義縣,竹崎鄉,復金村,0,1,1338,15,1353,2294,3,1,3,0,1,0,58.98
嘉義縣,竹崎鄉,緞繻村,0,1,572,12,584,1125,3,1,3,0,1,0,51.91
嘉義縣,竹崎鄉,仁壽村,0,1,167,1,168,349,3,1,3,0,1,0,48.14
嘉義縣,竹崎鄉,中和村,0,1,506,4,510,809,3,1,3,0,1,0,63.04
嘉義縣,竹崎鄉,光華村,0,1,462,4,466,759,3,1,3,0,1,0,61.40
嘉義縣,梅山鄉,梅東村,0,1,1421,28,1449,2499,3,1,3,0,1,0,57.98
嘉義縣,梅山鄉,梅南村,0,1,654,14,668,1010,3,1,3,0,1,0,66.14
嘉義縣,梅山鄉,梅北村,0,1,1971,26,1997,3424,3,1,3,0,1,0,58.32
嘉義縣,梅山鄉,過山村,0,1,394,6,400,597,3,1,3,0,1,0,67.00
嘉義縣,梅山鄉,圳南村,0,1,334,4,338,547,3,1,3,0,1,0,61.79
嘉義縣,梅山鄉,圳北村,0,1,438,3,441,720,3,1,3,0,1,0,61.25
嘉義縣,梅山鄉,双溪村,0,1,410,4,414,589,3,1,3,0,1,0,70.29
嘉義縣,梅山鄉,大南村,0,1,999,16,1015,1701,3,1,3,0,1,0,59.67
嘉義縣,梅山鄉,安靖村,0,1,552,9,561,972,3,1,3,0,1,0,57.72
嘉義縣,梅山鄉,永興村,0,1,276,2,278,535,3,1,3,0,1,0,51.96
嘉義縣,梅山鄉,半天村,0,1,296,4,300,489,3,1,3,0,1,0,61.35
嘉義縣,梅山鄉,太平村,0,1,331,10,341,532,3,1,3,0,1,0,64.10
嘉義縣,梅山鄉,太興村,0,1,280,1,281,413,3,1,3,0,1,0,68.04
嘉義縣,梅山鄉,龍眼村,0,1,319,7,326,489,3,1,3,0,1,0,66.67
嘉義縣,梅山鄉,碧湖村,0,1,198,3,201,353,3,1,3,0,1,0,56.94
嘉義縣,梅山鄉,瑞峯村,0,1,457,4,461,717,3,1,3,0,1,0,64.30
嘉義縣,梅山鄉,瑞里村,0,1,478,20,498,730,3,1,3,0,1,0,68.22
嘉義縣,梅山鄉,太和村,0,1,650,13,663,1027,3,1,3,0,1,0,64.56
嘉義縣,番路鄉,江西村,0,1,573,8,581,878,3,1,3,0,1,0,66.17
嘉義縣,番路鄉,內甕村,0,1,213,2,215,352,3,1,3,0,1,0,61.08
嘉義縣,番路鄉,新福村,0,1,510,3,513,743,3,1,3,0,1,0,69.04
嘉義縣,番路鄉,下坑村,0,1,925,10,935,1450,3,1,3,0,1,0,64.48
嘉義縣,番路鄉,番路村,0,1,529,8,537,794,3,1,3,0,1,0,67.63
嘉義縣,番路鄉,民和村,0,1,503,9,512,783,3,1,3,0,1,0,65.39
嘉義縣,番路鄉,觸口村,0,1,597,8,605,865,3,1,3,0,1,0,69.94
嘉義縣,番路鄉,大湖村,0,1,486,1,487,884,3,1,3,0,1,0,55.09
嘉義縣,番路鄉,公田村,0,1,505,8,513,883,3,1,3,0,1,0,58.10
嘉義縣,番路鄉,公興村,0,1,310,4,314,575,3,1,3,0,1,0,54.61
嘉義縣,番路鄉,草山村,0,1,249,0,249,350,3,1,3,0,1,0,71.14
嘉義縣,大埔鄉,大埔村,0,1,454,64,518,981,3,1,3,0,1,0,52.80
嘉義縣,大埔鄉,和平村,0,1,227,37,264,490,3,1,3,0,1,0,53.88
嘉義縣,大埔鄉,永樂村,0,1,170,13,183,305,3,1,3,0,1,0,60.00
嘉義縣,大埔鄉,茄苳村,0,1,332,17,349,700,3,1,3,0,1,0,49.86
嘉義縣,大埔鄉,西興村,0,1,202,5,207,358,3,1,3,0,1,0,57.82
嘉義縣,阿里山鄉,中山村,0,1,213,2,215,374,3,1,3,0,1,0,57.49
嘉義縣,阿里山鄉,中正村,0,1,104,2,106,206,3,1,3,0,1,0,51.46
嘉義縣,阿里山鄉,香林村,0,1,121,2,123,238,3,1,3,0,1,0,51.68
嘉義縣,阿里山鄉,十字村,0,1,115,2,117,238,3,1,3,0,1,0,49.16
嘉義縣,阿里山鄉,達邦村,0,1,58,0,58,149,3,1,3,0,1,0,38.93
嘉義縣,阿里山鄉,樂野村,0,1,129,0,129,234,3,1,3,0,1,0,55.13
嘉義縣,阿里山鄉,來吉村,0,1,14,0,14,99,3,1,3,0,1,0,14.14
嘉義縣,阿里山鄉,豐山村,0,1,162,1,163,264,3,1,3,0,1,0,61.74
嘉義縣,阿里山鄉,里佳村,0,1,8,0,8,27,3,1,3,0,1,0,29.63
嘉義縣,阿里山鄉,山美村,0,1,12,1,13,24,3,1,3,0,1,0,54.17
嘉義縣,阿里山鄉,新美村,0,1,8,0,8,20,3,1,3,0,1,0,40.00
嘉義縣,阿里山鄉,茶山村,0,1,55,0,55,100,3,1,3,0,1,0,55.00
臺南縣,新營市,忠政里,0,1,3078,34,3112,4816,3,1,3,0,1,0,64.62
臺南縣,新營市,民權里,0,1,886,9,895,1379,3,1,3,0,1,0,64.90
臺南縣,新營市,三仙里,0,1,1499,18,1517,2494,3,1,3,0,1,0,60.83
臺南縣,新營市,好平里,0,1,527,10,537,952,3,1,3,0,1,0,56.41
臺南縣,新營市,延平里,0,1,790,15,805,1382,3,1,3,0,1,0,58.25
臺南縣,新營市,永生里,0,1,732,4,736,1051,3,1,3,0,1,0,70.03
臺南縣,新營市,大宏里,0,1,1876,23,1899,3095,3,1,3,0,1,0,61.36
臺南縣,新營市,王公里,0,1,2596,30,2626,4263,3,1,3,0,1,0,61.60
臺南縣,新營市,中營里,0,1,1008,20,1028,1646,3,1,3,0,1,0,62.45
臺南縣,新營市,土庫里,0,1,979,13,992,1465,3,1,3,0,1,0,67.71
臺南縣,新營市,興安里,0,1,81,1,82,121,3,1,3,0,1,0,67.77
臺南縣,新營市,南興里,0,1,1563,23,1586,2482,3,1,3,0,1,0,63.90
臺南縣,新營市,興業里,0,1,790,16,806,1153,3,1,3,0,1,0,69.90
臺南縣,新營市,民生里,0,1,4336,54,4390,7383,3,1,3,0,1,0,59.46
臺南縣,新營市,民榮里,0,1,2037,25,2062,3407,3,1,3,0,1,0,60.52
臺南縣,新營市,埤寮里,0,1,1383,17,1400,2007,3,1,3,0,1,0,69.76
臺南縣,新營市,護鎮里,0,1,732,9,741,1161,3,1,3,0,1,0,63.82
臺南縣,新營市,太南里,0,1,882,15,897,1336,3,1,3,0,1,0,67.14
臺南縣,新營市,太北里,0,1,912,9,921,1405,3,1,3,0,1,0,65.55
臺南縣,新營市,南紙里,0,1,1278,23,1301,2008,3,1,3,0,1,0,64.79
臺南縣,新營市,嘉芳里,0,1,813,18,831,1336,3,1,3,0,1,0,62.20
臺南縣,新營市,舊埔里,0,1,271,0,271,391,3,1,3,0,1,0,69.31
臺南縣,新營市,角帶里,0,1,346,1,347,462,3,1,3,0,1,0,75.11
臺南縣,新營市,鐵線里,0,1,499,6,505,783,3,1,3,0,1,0,64.50
臺南縣,新營市,五興里,0,1,626,10,636,986,3,1,3,0,1,0,64.50
臺南縣,新營市,姑爺里,0,1,424,3,427,608,3,1,3,0,1,0,70.23
臺南縣,鹽水鎮,水秀里,0,1,846,10,856,1340,3,1,3,0,1,0,63.88
臺南縣,鹽水鎮,福得里,0,1,366,4,370,549,3,1,3,0,1,0,67.40
臺南縣,鹽水鎮,三生里,0,1,248,4,252,372,3,1,3,0,1,0,67.74
臺南縣,鹽水鎮,武廟里,0,1,394,6,400,604,3,1,3,0,1,0,66.23
臺南縣,鹽水鎮,中境里,0,1,356,30,386,581,3,1,3,0,1,0,66.44
臺南縣,鹽水鎮,水仙里,0,1,274,2,276,433,3,1,3,0,1,0,63.74
臺南縣,鹽水鎮,水正里,0,1,516,5,521,764,3,1,3,0,1,0,68.19
臺南縣,鹽水鎮,橋南里,0,1,1601,18,1619,2611,3,1,3,0,1,0,62.01
臺南縣,鹽水鎮,舊營里,0,1,462,7,469,687,3,1,3,0,1,0,68.27
臺南縣,鹽水鎮,汫水里,0,1,628,13,641,1083,3,1,3,0,1,0,59.19
臺南縣,鹽水鎮,岸內里,0,1,1804,27,1831,2921,3,1,3,0,1,0,62.68
臺南縣,鹽水鎮,義稠里,0,1,405,5,410,589,3,1,3,0,1,0,69.61
臺南縣,鹽水鎮,下中里,0,1,496,9,505,781,3,1,3,0,1,0,64.66
臺南縣,鹽水鎮,歡雅里,0,1,848,10,858,1494,3,1,3,0,1,0,57.43
臺南縣,鹽水鎮,大莊里,0,1,346,1,347,569,3,1,3,0,1,0,60.98
臺南縣,鹽水鎮,桐寮里,0,1,189,1,190,297,3,1,3,0,1,0,63.97
臺南縣,鹽水鎮,後宅里,0,1,465,8,473,686,3,1,3,0,1,0,68.95
臺南縣,鹽水鎮,孫厝里,0,1,333,4,337,521,3,1,3,0,1,0,64.68
臺南縣,鹽水鎮,竹埔里,0,1,617,10,627,876,3,1,3,0,1,0,71.58
臺南縣,鹽水鎮,下林里,0,1,261,3,264,439,3,1,3,0,1,0,60.14
臺南縣,鹽水鎮,田寮里,0,1,207,5,212,290,3,1,3,0,1,0,73.10
臺南縣,鹽水鎮,大豐里,0,1,255,1,256,383,3,1,3,0,1,0,66.84
臺南縣,鹽水鎮,飯店里,0,1,286,1,287,427,3,1,3,0,1,0,67.21
臺南縣,鹽水鎮,河南里,0,1,405,4,409,641,3,1,3,0,1,0,63.81
臺南縣,鹽水鎮,南港里,0,1,672,14,686,951,3,1,3,0,1,0,72.13
臺南縣,白河鎮,白河里,0,1,1242,16,1258,1944,3,1,3,0,1,0,64.71
臺南縣,白河鎮,永安里,0,1,1618,10,1628,2554,3,1,3,0,1,0,63.74
臺南縣,白河鎮,外角里,0,1,909,17,926,1458,3,1,3,0,1,0,63.51
臺南縣,白河鎮,庄內里,0,1,914,16,930,1489,3,1,3,0,1,0,62.46
臺南縣,白河鎮,秀祐里,0,1,528,8,536,811,3,1,3,0,1,0,66.09
臺南縣,白河鎮,河東里,0,1,838,8,846,1388,3,1,3,0,1,0,60.95
臺南縣,白河鎮,虎山里,0,1,301,5,306,493,3,1,3,0,1,0,62.07
臺南縣,白河鎮,大林里,0,1,369,5,374,637,3,1,3,0,1,0,58.71
臺南縣,白河鎮,崁頭里,0,1,340,2,342,495,3,1,3,0,1,0,69.09
臺南縣,白河鎮,六溪里,0,1,366,4,370,658,3,1,3,0,1,0,56.23
臺南縣,白河鎮,關嶺里,0,1,796,10,806,1325,3,1,3,0,1,0,60.83
臺南縣,白河鎮,仙草里,0,1,1709,37,1746,2598,3,1,3,0,1,0,67.21
臺南縣,白河鎮,玉豐里,0,1,765,8,773,1174,3,1,3,0,1,0,65.84
臺南縣,白河鎮,大竹里,0,1,881,4,885,1349,3,1,3,0,1,0,65.60
臺南縣,白河鎮,詔安里,0,1,617,11,628,898,3,1,3,0,1,0,69.93
臺南縣,白河鎮,廣安里,0,1,442,9,451,691,3,1,3,0,1,0,65.27
臺南縣,白河鎮,蓮潭里,0,1,658,8,666,938,3,1,3,0,1,0,71.00
臺南縣,白河鎮,竹門里,0,1,686,6,692,982,3,1,3,0,1,0,70.47
臺南縣,白河鎮,崎內里,0,1,529,9,538,872,3,1,3,0,1,0,61.70
臺南縣,白河鎮,昇安里,0,1,778,14,792,1257,3,1,3,0,1,0,63.01
臺南縣,白河鎮,汴頭里,0,1,509,10,519,814,3,1,3,0,1,0,63.76
臺南縣,白河鎮,內角里,0,1,586,8,594,815,3,1,3,0,1,0,72.88
臺南縣,白河鎮,草店里,0,1,632,7,639,960,3,1,3,0,1,0,66.56
臺南縣,白河鎮,甘宅里,0,1,458,10,468,763,3,1,3,0,1,0,61.34
臺南縣,柳營鄉,士林村,0,1,828,9,837,1267,3,1,3,0,1,0,66.06
臺南縣,柳營鄉,光福村,0,1,1157,24,1181,1738,3,1,3,0,1,0,67.95
臺南縣,柳營鄉,中埕村,0,1,488,4,492,693,3,1,3,0,1,0,71.00
臺南縣,柳營鄉,東昇村,0,1,1582,17,1599,2264,3,1,3,0,1,0,70.63
臺南縣,柳營鄉,八翁村,0,1,780,11,791,1191,3,1,3,0,1,0,66.41
臺南縣,柳營鄉,人和村,0,1,527,3,530,792,3,1,3,0,1,0,66.92
臺南縣,柳營鄉,太康村,0,1,1052,12,1064,1489,3,1,3,0,1,0,71.46
臺南縣,柳營鄉,重溪村,0,1,1092,8,1100,1734,3,1,3,0,1,0,63.44
臺南縣,柳營鄉,篤農村,0,1,862,14,876,1390,3,1,3,0,1,0,63.02
臺南縣,柳營鄉,大農村,0,1,457,7,464,652,3,1,3,0,1,0,71.17
臺南縣,柳營鄉,神農村,0,1,889,12,901,1420,3,1,3,0,1,0,63.45
臺南縣,柳營鄉,果毅村,0,1,823,14,837,1260,3,1,3,0,1,0,66.43
臺南縣,柳營鄉,旭山村,0,1,1170,16,1186,1708,3,1,3,0,1,0,69.44
臺南縣,後壁鄉,後壁村,0,1,927,12,939,1434,3,1,3,0,1,0,65.48
臺南縣,後壁鄉,侯伯村,0,1,841,7,848,1202,3,1,3,0,1,0,70.55
臺南縣,後壁鄉,嘉苳村,0,1,847,8,855,1309,3,1,3,0,1,0,65.32
臺南縣,後壁鄉,土溝村,0,1,915,18,933,1300,3,1,3,0,1,0,71.77
臺南縣,後壁鄉,嘉田村,0,1,732,6,738,1176,3,1,3,0,1,0,62.76
臺南縣,後壁鄉,嘉民村,0,1,805,17,822,1229,3,1,3,0,1,0,66.88
臺南縣,後壁鄉,菁豐村,0,1,581,5,586,832,3,1,3,0,1,0,70.43
臺南縣,後壁鄉,崁頂村,0,1,396,4,400,566,3,1,3,0,1,0,70.67
臺南縣,後壁鄉,後壁村,0,1,365,24,389,654,3,1,3,0,1,0,59.48
臺南縣,後壁鄉,墨林村,0,1,584,9,593,862,3,1,3,0,1,0,68.79
臺南縣,後壁鄉,菁寮村,0,1,357,3,360,501,3,1,3,0,1,0,71.86
臺南縣,後壁鄉,新嘉村,0,1,769,9,778,1227,3,1,3,0,1,0,63.41
臺南縣,後壁鄉,頂長村,0,1,392,1,393,537,3,1,3,0,1,0,73.18
臺南縣,後壁鄉,平安村,0,1,765,10,775,1071,3,1,3,0,1,0,72.36
臺南縣,後壁鄉,仕安村,0,1,389,1,390,584,3,1,3,0,1,0,66.78
臺南縣,後壁鄉,竹新村,0,1,1007,13,1020,1446,3,1,3,0,1,0,70.54
臺南縣,後壁鄉,新東村,0,1,892,15,907,1406,3,1,3,0,1,0,64.51
臺南縣,後壁鄉,頂安村,0,1,743,12,755,1086,3,1,3,0,1,0,69.52
臺南縣,後壁鄉,長安村,0,1,948,9,957,1411,3,1,3,0,1,0,67.82
臺南縣,後壁鄉,福安村,0,1,728,4,732,1065,3,1,3,0,1,0,68.73
臺南縣,後壁鄉,烏樹村,0,1,443,5,448,743,3,1,3,0,1,0,60.30
臺南縣,後壁鄉,烏林村,0,1,137,4,141,209,3,1,3,0,1,0,67.46
臺南縣,東山鄉,東山村,0,1,826,6,832,1442,3,1,3,0,1,0,57.70
臺南縣,東山鄉,東中村,0,1,1436,9,1445,2258,3,1,3,0,1,0,63.99
臺南縣,東山鄉,東正村,0,1,924,11,935,1605,3,1,3,0,1,0,58.26
臺南縣,東山鄉,三榮村,0,1,606,2,608,1005,3,1,3,0,1,0,60.50
臺南縣,東山鄉,大客村,0,1,707,12,719,1204,3,1,3,0,1,0,59.72
臺南縣,東山鄉,科里村,0,1,945,15,960,1466,3,1,3,0,1,0,65.48
臺南縣,東山鄉,東河村,0,1,543,7,550,957,3,1,3,0,1,0,57.47
臺南縣,東山鄉,聖賢村,0,1,1172,14,1186,1845,3,1,3,0,1,0,64.28
臺南縣,東山鄉,南溪村,0,1,370,4,374,582,3,1,3,0,1,0,64.26
臺南縣,東山鄉,水雲村,0,1,296,4,300,563,3,1,3,0,1,0,53.29
臺南縣,東山鄉,林安村,0,1,237,2,239,406,3,1,3,0,1,0,58.87
臺南縣,東山鄉,東原村,0,1,1285,18,1303,2309,3,1,3,0,1,0,56.43
臺南縣,東山鄉,嶺南村,0,1,392,4,396,796,3,1,3,0,1,0,49.75
臺南縣,東山鄉,南勢村,0,1,665,8,673,1151,3,1,3,0,1,0,58.47
臺南縣,東山鄉,青山村,0,1,636,5,641,1156,3,1,3,0,1,0,55.45
臺南縣,東山鄉,高原村,0,1,504,7,511,1022,3,1,3,0,1,0,50.00
臺南縣,麻豆鎮,穀興里,0,1,499,4,503,664,3,1,3,0,1,0,75.75
臺南縣,麻豆鎮,保安里,0,1,436,2,438,599,3,1,3,0,1,0,73.12
臺南縣,麻豆鎮,東角里,0,1,1212,15,1227,1695,3,1,3,0,1,0,72.39
臺南縣,麻豆鎮,晉江里,0,1,1540,11,1551,2248,3,1,3,0,1,0,68.99
臺南縣,麻豆鎮,巷口里,0,1,966,10,976,1301,3,1,3,0,1,0,75.02
臺南縣,麻豆鎮,中興里,0,1,1216,9,1225,1681,3,1,3,0,1,0,72.87
臺南縣,麻豆鎮,興農里,0,1,823,13,836,1133,3,1,3,0,1,0,73.79
臺南縣,麻豆鎮,新建里,0,1,671,7,678,903,3,1,3,0,1,0,75.08
臺南縣,麻豆鎮,油車里,0,1,1786,14,1800,2650,3,1,3,0,1,0,67.92
臺南縣,麻豆鎮,北勢里,0,1,822,14,836,1185,3,1,3,0,1,0,70.55
臺南縣,麻豆鎮,大埕里,0,1,1589,17,1606,2306,3,1,3,0,1,0,69.64
臺南縣,麻豆鎮,總榮里,0,1,459,6,465,624,3,1,3,0,1,0,74.52
臺南縣,麻豆鎮,龍泉里,0,1,537,8,545,702,3,1,3,0,1,0,77.64
臺南縣,麻豆鎮,南勢里,0,1,1573,21,1594,2218,3,1,3,0,1,0,71.87
臺南縣,麻豆鎮,寮廍里,0,1,978,8,986,1351,3,1,3,0,1,0,72.98
臺南縣,麻豆鎮,小埤里,0,1,527,6,533,706,3,1,3,0,1,0,75.50
臺南縣,麻豆鎮,埤頭里,0,1,944,10,954,1270,3,1,3,0,1,0,75.12
臺南縣,麻豆鎮,大山里,0,1,420,3,423,518,3,1,3,0,1,0,81.66
臺南縣,麻豆鎮,海埔里,0,1,752,9,761,1013,3,1,3,0,1,0,75.12
臺南縣,麻豆鎮,莊禮里,0,1,415,5,420,563,3,1,3,0,1,0,74.60
臺南縣,麻豆鎮,港尾里,0,1,822,14,836,1168,3,1,3,0,1,0,71.58
臺南縣,麻豆鎮,麻口里,0,1,692,12,704,962,3,1,3,0,1,0,73.18
臺南縣,麻豆鎮,安東里,0,1,449,7,456,584,3,1,3,0,1,0,78.08
臺南縣,麻豆鎮,安業里,0,1,483,13,496,658,3,1,3,0,1,0,75.38
臺南縣,麻豆鎮,安西里,0,1,471,4,475,622,3,1,3,0,1,0,76.37
臺南縣,麻豆鎮,謝安里,0,1,678,5,683,827,3,1,3,0,1,0,82.59
臺南縣,麻豆鎮,中民里,0,1,628,5,633,795,3,1,3,0,1,0,79.62
臺南縣,麻豆鎮,安正里,0,1,555,7,562,763,3,1,3,0,1,0,73.66
臺南縣,麻豆鎮,磚井里,0,1,871,8,879,1152,3,1,3,0,1,0,76.30
臺南縣,下營鄉,下營村,0,1,736,14,750,1079,3,1,3,0,1,0,69.51
臺南縣,下營鄉,仁里村,0,1,1612,21,1633,2410,3,1,3,0,1,0,67.76
臺南縣,下營鄉,宅內村,0,1,815,5,820,1164,3,1,3,0,1,0,70.45
臺南縣,下營鄉,後街村,0,1,1061,15,1076,1494,3,1,3,0,1,0,72.02
臺南縣,下營鄉,新興村,0,1,1357,11,1368,1945,3,1,3,0,1,0,70.33
臺南縣,下營鄉,營前村,0,1,1353,19,1372,2002,3,1,3,0,1,0,68.53
臺南縣,下營鄉,大屯村,0,1,582,10,592,806,3,1,3,0,1,0,73.45
臺南縣,下營鄉,大埤村,0,1,593,3,596,805,3,1,3,0,1,0,74.04
臺南縣,下營鄉,茅港村,0,1,801,13,814,1166,3,1,3,0,1,0,69.81
臺南縣,下營鄉,中營村,0,1,732,6,738,1048,3,1,3,0,1,0,70.42
臺南縣,下營鄉,開化村,0,1,1096,15,1111,1687,3,1,3,0,1,0,65.86
臺南縣,下營鄉,西連村,0,1,637,11,648,884,3,1,3,0,1,0,73.30
臺南縣,下營鄉,賀建村,0,1,857,9,866,1269,3,1,3,0,1,0,68.24
臺南縣,下營鄉,甲中村,0,1,825,5,830,1210,3,1,3,0,1,0,68.60
臺南縣,下營鄉,紅厝村,0,1,904,14,918,1245,3,1,3,0,1,0,73.73
臺南縣,六甲鄉,六甲村,0,1,1767,41,1808,2570,3,1,3,0,1,0,70.35
臺南縣,六甲鄉,甲東村,0,1,1639,21,1660,2411,3,1,3,0,1,0,68.85
臺南縣,六甲鄉,甲南村,0,1,888,10,898,1280,3,1,3,0,1,0,70.16
臺南縣,六甲鄉,龍湖村,0,1,712,7,719,1031,3,1,3,0,1,0,69.74
臺南縣,六甲鄉,七甲村,0,1,592,4,596,846,3,1,3,0,1,0,70.45
臺南縣,六甲鄉,二甲村,0,1,1703,19,1722,2548,3,1,3,0,1,0,67.58
臺南縣,六甲鄉,水林村,0,1,1204,17,1221,1708,3,1,3,0,1,0,71.49
臺南縣,六甲鄉,中社村,0,1,1071,17,1088,1491,3,1,3,0,1,0,72.97
臺南縣,六甲鄉,龜港村,0,1,712,7,719,1017,3,1,3,0,1,0,70.70
臺南縣,六甲鄉,菁埔村,0,1,390,3,393,542,3,1,3,0,1,0,72.51
臺南縣,六甲鄉,王爺村,0,1,573,8,581,958,3,1,3,0,1,0,60.65
臺南縣,六甲鄉,大丘村,0,1,482,6,488,826,3,1,3,0,1,0,59.08
臺南縣,官田鄉,官田村,0,1,1382,16,1398,1949,3,1,3,0,1,0,71.73
臺南縣,官田鄉,二鎮村,0,1,1413,8,1421,1999,3,1,3,0,1,0,71.09
臺南縣,官田鄉,湖山村,0,1,726,12,738,1040,3,1,3,0,1,0,70.96
臺南縣,官田鄉,嘉南村,0,1,527,7,534,686,3,1,3,0,1,0,77.84
臺南縣,官田鄉,大崎村,0,1,344,1,345,499,3,1,3,0,1,0,69.14
臺南縣,官田鄉,隆田村,0,1,1281,18,1299,1795,3,1,3,0,1,0,72.37
臺南縣,官田鄉,隆本村,0,1,1783,25,1808,2521,3,1,3,0,1,0,71.72
臺南縣,官田鄉,南廍村,0,1,654,15,669,958,3,1,3,0,1,0,69.83
臺南縣,官田鄉,東庄村,0,1,955,11,966,1389,3,1,3,0,1,0,69.55
臺南縣,官田鄉,西庄村,0,1,480,5,485,692,3,1,3,0,1,0,70.09
臺南縣,官田鄉,拔林村,0,1,466,5,471,627,3,1,3,0,1,0,75.12
臺南縣,官田鄉,渡頭村,0,1,1586,24,1610,2321,3,1,3,0,1,0,69.37
臺南縣,官田鄉,社子村,0,1,657,10,667,913,3,1,3,0,1,0,73.06
臺南縣,大內鄉,石湖村,0,1,816,4,820,1207,3,1,3,0,1,0,67.94
臺南縣,大內鄉,石林村,0,1,594,6,600,817,3,1,3,0,1,0,73.44
臺南縣,大內鄉,石城村,0,1,975,7,982,1392,3,1,3,0,1,0,70.55
臺南縣,大內鄉,內江村,0,1,780,9,789,1069,3,1,3,0,1,0,73.81
臺南縣,大內鄉,大內村,0,1,620,6,626,842,3,1,3,0,1,0,74.35
臺南縣,大內鄉,內郭村,0,1,449,8,457,668,3,1,3,0,1,0,68.41
臺南縣,大內鄉,頭社村,0,1,699,7,706,1059,3,1,3,0,1,0,66.67
臺南縣,大內鄉,環湖村,0,1,584,11,595,920,3,1,3,0,1,0,64.67
臺南縣,大內鄉,二溪村,0,1,663,6,669,953,3,1,3,0,1,0,70.20
臺南縣,大內鄉,曲溪村,0,1,472,8,480,682,3,1,3,0,1,0,70.38
臺南縣,佳里鎮,東寧里,0,1,1150,17,1167,1693,3,1,3,0,1,0,68.93
臺南縣,佳里鎮,忠仁里,0,1,1610,18,1628,2419,3,1,3,0,1,0,67.30
臺南縣,佳里鎮,鎮山里,0,1,2579,17,2596,3898,3,1,3,0,1,0,66.60
臺南縣,佳里鎮,建南里,0,1,3169,22,3191,4818,3,1,3,0,1,0,66.23
臺南縣,佳里鎮,安西里,0,1,4621,40,4661,6760,3,1,3,0,1,0,68.95
臺南縣,佳里鎮,六安里,0,1,1875,22,1897,2819,3,1,3,0,1,0,67.29
臺南縣,佳里鎮,佳化里,0,1,1190,16,1206,1741,3,1,3,0,1,0,69.27
臺南縣,佳里鎮,禮化里,0,1,621,6,627,839,3,1,3,0,1,0,74.73
臺南縣,佳里鎮,興化里,0,1,938,6,944,1351,3,1,3,0,1,0,69.87
臺南縣,佳里鎮,營頂里,0,1,457,3,460,654,3,1,3,0,1,0,70.34
臺南縣,佳里鎮,溪洲里,0,1,282,3,285,381,3,1,3,0,1,0,74.80
臺南縣,佳里鎮,海澄里,0,1,691,14,705,1062,3,1,3,0,1,0,66.38
臺南縣,佳里鎮,漳洲里,0,1,405,5,410,572,3,1,3,0,1,0,71.68
臺南縣,佳里鎮,頂廍里,0,1,457,5,462,670,3,1,3,0,1,0,68.96
臺南縣,佳里鎮,嘉福里,0,1,679,7,686,962,3,1,3,0,1,0,71.31
臺南縣,佳里鎮,通興里,0,1,762,2,764,1065,3,1,3,0,1,0,71.74
臺南縣,佳里鎮,蚶寮里,0,1,591,6,597,835,3,1,3,0,1,0,71.50
臺南縣,佳里鎮,龍安里,0,1,706,9,715,962,3,1,3,0,1,0,74.32
臺南縣,佳里鎮,民安里,0,1,798,14,812,1180,3,1,3,0,1,0,68.81
臺南縣,佳里鎮,子龍里,0,1,989,13,1002,1440,3,1,3,0,1,0,69.58
臺南縣,佳里鎮,三協里,0,1,574,7,581,807,3,1,3,0,1,0,72.00
臺南縣,學甲鎮,一秀里,0,1,674,9,683,1028,3,1,3,0,1,0,66.44
臺南縣,學甲鎮,西明里,0,1,728,10,738,1164,3,1,3,0,1,0,63.40
臺南縣,學甲鎮,宜民里,0,1,355,2,357,545,3,1,3,0,1,0,65.50
臺南縣,學甲鎮,煥昌里,0,1,540,4,544,849,3,1,3,0,1,0,64.08
臺南縣,學甲鎮,慈生里,0,1,420,5,425,610,3,1,3,0,1,0,69.67
臺南縣,學甲鎮,仁得里,0,1,1990,16,2006,3168,3,1,3,0,1,0,63.32
臺南縣,學甲鎮,新生里,0,1,910,9,919,1374,3,1,3,0,1,0,66.89
臺南縣,學甲鎮,百福里,0,1,847,4,851,1248,3,1,3,0,1,0,68.19
臺南縣,學甲鎮,新榮里,0,1,777,7,784,1148,3,1,3,0,1,0,68.29
臺南縣,學甲鎮,文化里,0,1,349,4,353,492,3,1,3,0,1,0,71.75
臺南縣,學甲鎮,大安里,0,1,349,3,352,517,3,1,3,0,1,0,68.09
臺南縣,學甲鎮,美豐里,0,1,530,7,537,811,3,1,3,0,1,0,66.21
臺南縣,學甲鎮,美和里,0,1,240,4,244,361,3,1,3,0,1,0,67.59
臺南縣,學甲鎮,達明里,0,1,508,8,516,710,3,1,3,0,1,0,72.68
臺南縣,學甲鎮,光明里,0,1,218,3,221,369,3,1,3,0,1,0,59.89
臺南縣,學甲鎮,民吉里,0,1,276,6,282,450,3,1,3,0,1,0,62.67
臺南縣,學甲鎮,西進里,0,1,330,4,334,546,3,1,3,0,1,0,61.17
臺南縣,學甲鎮,白渚里,0,1,244,3,247,347,3,1,3,0,1,0,71.18
臺南縣,學甲鎮,光華里,0,1,525,7,532,737,3,1,3,0,1,0,72.18
臺南縣,學甲鎮,頭港里,0,1,382,1,383,596,3,1,3,0,1,0,64.26
臺南縣,學甲鎮,宅港里,0,1,763,11,774,1233,3,1,3,0,1,0,62.77
臺南縣,學甲鎮,平東里,0,1,350,2,352,558,3,1,3,0,1,0,63.08
臺南縣,學甲鎮,平西里,0,1,443,2,445,777,3,1,3,0,1,0,57.27
臺南縣,學甲鎮,頂洲里,0,1,475,4,479,667,3,1,3,0,1,0,71.81
臺南縣,學甲鎮,紅茄里,0,1,323,0,323,542,3,1,3,0,1,0,59.59
臺南縣,學甲鎮,新芳里,0,1,315,4,319,499,3,1,3,0,1,0,63.93
臺南縣,西港鄉,西港村,0,1,1609,11,1620,2274,3,1,3,0,1,0,71.24
臺南縣,西港鄉,慶安村,0,1,1936,26,1962,2774,3,1,3,0,1,0,70.73
臺南縣,西港鄉,南海村,0,1,1272,20,1292,1761,3,1,3,0,1,0,73.37
臺南縣,西港鄉,港東村,0,1,872,9,881,1226,3,1,3,0,1,0,71.86
臺南縣,西港鄉,檨林村,0,1,1092,11,1103,1546,3,1,3,0,1,0,71.35
臺南縣,西港鄉,後營村,0,1,865,7,872,1244,3,1,3,0,1,0,70.10
臺南縣,西港鄉,營西村,0,1,850,10,860,1203,3,1,3,0,1,0,71.49
臺南縣,西港鄉,金砂村,0,1,603,5,608,828,3,1,3,0,1,0,73.43
臺南縣,西港鄉,劉厝村,0,1,775,21,796,1114,3,1,3,0,1,0,71.45
臺南縣,西港鄉,竹林村,0,1,816,6,822,1141,3,1,3,0,1,0,72.04
臺南縣,西港鄉,永樂村,0,1,636,7,643,843,3,1,3,0,1,0,76.28
臺南縣,西港鄉,新復村,0,1,315,2,317,421,3,1,3,0,1,0,75.30
臺南縣,西港鄉,永樂村,0,1,450,4,454,650,3,1,3,0,1,0,69.85
臺南縣,七股鄉,後港村,0,1,428,4,432,577,3,1,3,0,1,0,74.87
臺南縣,七股鄉,大潭村,0,1,509,3,512,786,3,1,3,0,1,0,65.14
臺南縣,七股鄉,城內村,0,1,388,4,392,499,3,1,3,0,1,0,78.56
臺南縣,七股鄉,篤加村,0,1,595,5,600,851,3,1,3,0,1,0,70.51
臺南縣,七股鄉,頂山村,0,1,694,7,701,984,3,1,3,0,1,0,71.24
臺南縣,七股鄉,西寮村,0,1,384,1,385,555,3,1,3,0,1,0,69.37
臺南縣,七股鄉,鹽埕村,0,1,337,3,340,470,3,1,3,0,1,0,72.34
臺南縣,七股鄉,中寮村,0,1,592,3,595,762,3,1,3,0,1,0,78.08
臺南縣,七股鄉,龍山村,0,1,1102,11,1113,1626,3,1,3,0,1,0,68.45
臺南縣,七股鄉,溪南村,0,1,262,2,264,349,3,1,3,0,1,0,75.64
臺南縣,七股鄉,七股村,0,1,538,7,545,839,3,1,3,0,1,0,64.96
臺南縣,七股鄉,玉成村,0,1,514,3,517,778,3,1,3,0,1,0,66.45
臺南縣,七股鄉,大埕村,0,1,774,11,785,1236,3,1,3,0,1,0,63.51
臺南縣,七股鄉,大寮村,0,1,661,6,667,987,3,1,3,0,1,0,67.58
臺南縣,七股鄉,看坪村,0,1,403,3,406,560,3,1,3,0,1,0,72.50
臺南縣,七股鄉,樹林村,0,1,699,3,702,919,3,1,3,0,1,0,76.39
臺南縣,七股鄉,竹港村,0,1,967,7,974,1312,3,1,3,0,1,0,74.24
臺南縣,七股鄉,義合村,0,1,596,5,601,812,3,1,3,0,1,0,74.01
臺南縣,七股鄉,康榔村,0,1,468,2,470,634,3,1,3,0,1,0,74.13
臺南縣,七股鄉,永吉村,0,1,555,2,557,772,3,1,3,0,1,0,72.15
臺南縣,七股鄉,三股村,0,1,1631,22,1653,2199,3,1,3,0,1,0,75.17
臺南縣,七股鄉,十份村,0,1,895,12,907,1267,3,1,3,0,1,0,71.59
臺南縣,將軍鄉,長榮村,0,1,594,4,598,809,3,1,3,0,1,0,73.92
臺南縣,將軍鄉,西華村,0,1,808,5,813,1187,3,1,3,0,1,0,68.49
臺南縣,將軍鄉,西和村,0,1,763,11,774,1101,3,1,3,0,1,0,70.30
臺南縣,將軍鄉,忠興村,0,1,1041,3,1044,1461,3,1,3,0,1,0,71.46
臺南縣,將軍鄉,嘉昌村,0,1,679,8,687,925,3,1,3,0,1,0,74.27
臺南縣,將軍鄉,保源村,0,1,754,7,761,1054,3,1,3,0,1,0,72.20
臺南縣,將軍鄉,苓和村,0,1,652,5,657,965,3,1,3,0,1,0,68.08
臺南縣,將軍鄉,仁和村,0,1,526,2,528,846,3,1,3,0,1,0,62.41
臺南縣,將軍鄉,北埔村,0,1,447,4,451,663,3,1,3,0,1,0,68.02
臺南縣,將軍鄉,將富村,0,1,501,5,506,746,3,1,3,0,1,0,67.83
臺南縣,將軍鄉,將貴村,0,1,482,1,483,650,3,1,3,0,1,0,74.31
臺南縣,將軍鄉,三吉村,0,1,294,2,296,438,3,1,3,0,1,0,67.58
臺南縣,將軍鄉,玉山村,0,1,642,4,646,925,3,1,3,0,1,0,69.84
臺南縣,將軍鄉,廣山村,0,1,510,6,516,790,3,1,3,0,1,0,65.32
臺南縣,將軍鄉,長沙村,0,1,970,8,978,1374,3,1,3,0,1,0,71.18
臺南縣,將軍鄉,平沙村,0,1,817,10,827,1177,3,1,3,0,1,0,70.26
臺南縣,將軍鄉,鯤鯓村,0,1,1202,13,1215,1745,3,1,3,0,1,0,69.63
臺南縣,將軍鄉,鯤溟村,0,1,574,7,581,944,3,1,3,0,1,0,61.55
臺南縣,北門鄉,北門村,0,1,642,8,650,943,3,1,3,0,1,0,68.93
臺南縣,北門鄉,永隆村,0,1,341,7,348,521,3,1,3,0,1,0,66.79
臺南縣,北門鄉,永華村,0,1,254,2,256,379,3,1,3,0,1,0,67.55
臺南縣,北門鄉,玉港村,0,1,580,2,582,855,3,1,3,0,1,0,68.07
臺南縣,北門鄉,保吉村,0,1,880,6,886,1271,3,1,3,0,1,0,69.71
臺南縣,北門鄉,東壁村,0,1,460,5,465,689,3,1,3,0,1,0,67.49
臺南縣,北門鄉,鯤江村,0,1,498,2,500,763,3,1,3,0,1,0,65.53
臺南縣,北門鄉,雙春村,0,1,353,0,353,579,3,1,3,0,1,0,60.97
臺南縣,北門鄉,錦湖村,0,1,651,8,659,1112,3,1,3,0,1,0,59.26
臺南縣,北門鄉,慈安村,0,1,413,2,415,661,3,1,3,0,1,0,62.78
臺南縣,北門鄉,三光村,0,1,746,10,756,1135,3,1,3,0,1,0,66.61
臺南縣,北門鄉,中樞村,0,1,488,3,491,766,3,1,3,0,1,0,64.10
臺南縣,北門鄉,仁里村,0,1,501,5,506,749,3,1,3,0,1,0,67.56
臺南縣,新化鎮,武安里,0,1,1035,12,1047,1503,3,1,3,0,1,0,69.66
臺南縣,新化鎮,東榮里,0,1,2339,34,2373,3453,3,1,3,0,1,0,68.72
臺南縣,新化鎮,護國里,0,1,882,21,903,1526,3,1,3,0,1,0,59.17
臺南縣,新化鎮,太平里,0,1,2299,36,2335,3170,3,1,3,0,1,0,73.66
臺南縣,新化鎮,中央里,0,1,357,5,362,500,3,1,3,0,1,0,72.40
臺南縣,新化鎮,觀音里,0,1,440,7,447,634,3,1,3,0,1,0,70.50
臺南縣,新化鎮,竹林里,0,1,345,4,349,473,3,1,3,0,1,0,73.78
臺南縣,新化鎮,清水里,0,1,653,6,659,924,3,1,3,0,1,0,71.32
臺南縣,新化鎮,協興里,0,1,1774,23,1797,2575,3,1,3,0,1,0,69.79
臺南縣,新化鎮,唪口里,0,1,879,13,892,1239,3,1,3,0,1,0,71.99
臺南縣,新化鎮,北勢里,0,1,598,6,604,784,3,1,3,0,1,0,77.04
臺南縣,新化鎮,豐榮里,0,1,1381,15,1396,1889,3,1,3,0,1,0,73.90
臺南縣,新化鎮,全興里,0,1,972,15,987,1360,3,1,3,0,1,0,72.57
臺南縣,新化鎮,崙頂里,0,1,1220,16,1236,1649,3,1,3,0,1,0,74.95
臺南縣,新化鎮,知義里,0,1,1439,38,1477,2068,3,1,3,0,1,0,71.42
臺南縣,新化鎮,山腳里,0,1,884,17,901,1149,3,1,3,0,1,0,78.42
臺南縣,新化鎮,大坑里,0,1,367,6,373,529,3,1,3,0,1,0,70.51
臺南縣,新化鎮,那拔里,0,1,1366,25,1391,1981,3,1,3,0,1,0,70.22
臺南縣,新化鎮,羊林里,0,1,559,9,568,858,3,1,3,0,1,0,66.20
臺南縣,新化鎮,礁坑里,0,1,732,7,739,1096,3,1,3,0,1,0,67.43
臺南縣,善化鎮,東關里,0,1,704,8,712,1035,3,1,3,0,1,0,68.79
臺南縣,善化鎮,坐駕里,0,1,1668,19,1687,2343,3,1,3,0,1,0,72.00
臺南縣,善化鎮,光文里,0,1,2531,41,2572,3545,3,1,3,0,1,0,72.55
臺南縣,善化鎮,文昌里,0,1,1269,15,1284,1854,3,1,3,0,1,0,69.26
臺南縣,善化鎮,南關里,0,1,817,15,832,1193,3,1,3,0,1,0,69.74
臺南縣,善化鎮,西關里,0,1,498,3,501,691,3,1,3,0,1,0,72.50
臺南縣,善化鎮,北關里,0,1,343,3,346,495,3,1,3,0,1,0,69.90
臺南縣,善化鎮,文正里,0,1,702,9,711,988,3,1,3,0,1,0,71.96
臺南縣,善化鎮,胡家里,0,1,910,4,914,1254,3,1,3,0,1,0,72.89
臺南縣,善化鎮,胡厝里,0,1,1396,34,1430,1934,3,1,3,0,1,0,73.94
臺南縣,善化鎮,什乃里,0,1,564,10,574,794,3,1,3,0,1,0,72.29
臺南縣,善化鎮,溪美里,0,1,1126,19,1145,1586,3,1,3,0,1,0,72.19
臺南縣,善化鎮,六分里,0,1,462,7,469,677,3,1,3,0,1,0,69.28
臺南縣,善化鎮,六德里,0,1,727,9,736,1039,3,1,3,0,1,0,70.84
臺南縣,善化鎮,田寮里,0,1,1124,9,1133,1668,3,1,3,0,1,0,67.93
臺南縣,善化鎮,東隆里,0,1,531,11,542,778,3,1,3,0,1,0,69.67
臺南縣,善化鎮,東昌里,0,1,632,10,642,957,3,1,3,0,1,0,67.08
臺南縣,善化鎮,牛庄里,0,1,952,12,964,1375,3,1,3,0,1,0,70.11
臺南縣,善化鎮,嘉北里,0,1,950,13,963,1337,3,1,3,0,1,0,72.03
臺南縣,善化鎮,嘉南里,0,1,701,6,707,971,3,1,3,0,1,0,72.81
臺南縣,善化鎮,小新里,0,1,1552,23,1575,2166,3,1,3,0,1,0,72.71
臺南縣,新市鄉,新市村,0,1,1303,19,1322,1945,3,1,3,0,1,0,67.97
臺南縣,新市鄉,新和村,0,1,3027,42,3069,4442,3,1,3,0,1,0,69.09
臺南縣,新市鄉,社內村,0,1,1191,13,1204,1643,3,1,3,0,1,0,73.28
臺南縣,新市鄉,大洲村,0,1,467,2,469,610,3,1,3,0,1,0,76.89
臺南縣,新市鄉,豐華村,0,1,532,7,539,816,3,1,3,0,1,0,66.05
臺南縣,新市鄉,三舍村,0,1,620,9,629,881,3,1,3,0,1,0,71.40
臺南縣,新市鄉,大營村,0,1,1422,16,1438,1929,3,1,3,0,1,0,74.55
臺南縣,新市鄉,大社村,0,1,1765,26,1791,2673,3,1,3,0,1,0,67.00
臺南縣,新市鄉,潭頂村,0,1,911,18,929,1338,3,1,3,0,1,0,69.43
臺南縣,新市鄉,港墘村,0,1,1666,28,1694,2432,3,1,3,0,1,0,69.65
臺南縣,新市鄉,永就村,0,1,893,15,908,1195,3,1,3,0,1,0,75.98
臺南縣,安定鄉,蘇林村,0,1,1474,12,1486,1983,3,1,3,0,1,0,74.94
臺南縣,安定鄉,蘇厝村,0,1,1169,18,1187,1638,3,1,3,0,1,0,72.47
臺南縣,安定鄉,安定村,0,1,928,11,939,1275,3,1,3,0,1,0,73.65
臺南縣,安定鄉,安加村,0,1,835,8,843,1121,3,1,3,0,1,0,75.20
臺南縣,安定鄉,保西村,0,1,516,6,522,687,3,1,3,0,1,0,75.98
臺南縣,安定鄉,港尾村,0,1,971,11,982,1329,3,1,3,0,1,0,73.89
臺南縣,安定鄉,中榮村,0,1,728,11,739,968,3,1,3,0,1,0,76.34
臺南縣,安定鄉,港口村,0,1,1327,17,1344,1855,3,1,3,0,1,0,72.45
臺南縣,安定鄉,港南村,0,1,1402,17,1419,1941,3,1,3,0,1,0,73.11
臺南縣,安定鄉,大同村,0,1,439,9,448,585,3,1,3,0,1,0,76.58
臺南縣,安定鄉,六嘉村,0,1,905,12,917,1247,3,1,3,0,1,0,73.54
臺南縣,安定鄉,中沙村,0,1,507,2,509,689,3,1,3,0,1,0,73.88
臺南縣,安定鄉,新吉村,0,1,1103,10,1113,1466,3,1,3,0,1,0,75.92
臺南縣,安定鄉,海寮村,0,1,1458,17,1475,1926,3,1,3,0,1,0,76.58
臺南縣,安定鄉,管寮村,0,1,646,9,655,887,3,1,3,0,1,0,73.84
臺南縣,安定鄉,南安村,0,1,349,4,353,437,3,1,3,0,1,0,80.78
臺南縣,山上鄉,明和村,0,1,1151,9,1160,1631,3,1,3,0,1,0,71.12
臺南縣,山上鄉,南洲村,0,1,1037,11,1048,1460,3,1,3,0,1,0,71.78
臺南縣,山上鄉,山上村,0,1,605,14,619,860,3,1,3,0,1,0,71.98
臺南縣,山上鄉,新莊村,0,1,450,3,453,661,3,1,3,0,1,0,68.53
臺南縣,山上鄉,玉峰村,0,1,413,4,417,567,3,1,3,0,1,0,73.54
臺南縣,山上鄉,平陽村,0,1,292,2,294,369,3,1,3,0,1,0,79.67
臺南縣,山上鄉,豐德村,0,1,224,3,227,307,3,1,3,0,1,0,73.94
臺南縣,玉井鄉,玉井村,0,1,732,6,738,1054,3,1,3,0,1,0,70.02
臺南縣,玉井鄉,玉田村,0,1,2707,23,2730,3986,3,1,3,0,1,0,68.49
臺南縣,玉井鄉,中正村,0,1,882,9,891,1282,3,1,3,0,1,0,69.50
臺南縣,玉井鄉,竹圍村,0,1,833,7,840,1260,3,1,3,0,1,0,66.67
臺南縣,玉井鄉,沙田村,0,1,339,5,344,496,3,1,3,0,1,0,69.35
臺南縣,玉井鄉,三埔村,0,1,308,2,310,501,3,1,3,0,1,0,61.88
臺南縣,玉井鄉,三和村,0,1,556,5,561,772,3,1,3,0,1,0,72.67
臺南縣,玉井鄉,望明村,0,1,1025,10,1035,1523,3,1,3,0,1,0,67.96
臺南縣,玉井鄉,層林村,0,1,514,2,516,710,3,1,3,0,1,0,72.68
臺南縣,玉井鄉,豐里村,0,1,737,6,743,1073,3,1,3,0,1,0,69.25
臺南縣,楠西鄉,楠西村,0,1,1211,10,1221,1872,3,1,3,0,1,0,65.22
臺南縣,楠西鄉,灣丘村,0,1,814,12,826,1305,3,1,3,0,1,0,63.30
臺南縣,楠西鄉,密枝村,0,1,583,11,594,903,3,1,3,0,1,0,65.78
臺南縣,楠西鄉,照興村,0,1,664,3,667,1102,3,1,3,0,1,0,60.53
臺南縣,楠西鄉,鹿田村,0,1,743,11,754,1108,3,1,3,0,1,0,68.05
臺南縣,楠西鄉,龜丹村,0,1,466,4,470,689,3,1,3,0,1,0,68.21
臺南縣,楠西鄉,東勢村,0,1,1481,17,1498,2236,3,1,3,0,1,0,66.99
臺南縣,南化鄉,南化村,0,1,932,13,945,1404,3,1,3,0,1,0,67.31
臺南縣,南化鄉,小崙村,0,1,548,5,553,789,3,1,3,0,1,0,70.09
臺南縣,南化鄉,中坑村,0,1,360,5,365,493,3,1,3,0,1,0,74.04
臺南縣,南化鄉,北平村,0,1,385,3,388,550,3,1,3,0,1,0,70.55
臺南縣,南化鄉,東和村,0,1,397,10,407,670,3,1,3,0,1,0,60.75
臺南縣,南化鄉,西埔村,0,1,571,8,579,846,3,1,3,0,1,0,68.44
臺南縣,南化鄉,北寮村,0,1,815,6,821,1184,3,1,3,0,1,0,69.34
臺南縣,南化鄉,玉山村,0,1,668,3,671,921,3,1,3,0,1,0,72.86
臺南縣,南化鄉,關山村,0,1,260,5,265,518,3,1,3,0,1,0,51.16
臺南縣,左鎮鄉,光和村,0,1,319,9,328,489,3,1,3,0,1,0,67.08
臺南縣,左鎮鄉,榮和村,0,1,488,7,495,747,3,1,3,0,1,0,66.27
臺南縣,左鎮鄉,左鎮村,0,1,382,7,389,549,3,1,3,0,1,0,70.86
臺南縣,左鎮鄉,中正村,0,1,681,5,686,916,3,1,3,0,1,0,74.89
臺南縣,左鎮鄉,睦光村,0,1,258,1,259,333,3,1,3,0,1,0,77.78
臺南縣,左鎮鄉,內庄村,0,1,331,6,337,481,3,1,3,0,1,0,70.06
臺南縣,左鎮鄉,岡林村,0,1,290,6,296,431,3,1,3,0,1,0,68.68
臺南縣,左鎮鄉,草山村,0,1,220,2,222,303,3,1,3,0,1,0,73.27
臺南縣,左鎮鄉,二寮村,0,1,156,2,158,217,3,1,3,0,1,0,72.81
臺南縣,左鎮鄉,澄山村,0,1,381,6,387,606,3,1,3,0,1,0,63.86
臺南縣,仁德鄉,太子村,0,1,2500,27,2527,3620,3,1,3,0,1,0,69.81
臺南縣,仁德鄉,土庫村,0,1,1431,11,1442,2049,3,1,3,0,1,0,70.38
臺南縣,仁德鄉,一甲村,0,1,1006,13,1019,1519,3,1,3,0,1,0,67.08
臺南縣,仁德鄉,仁德村,0,1,2097,26,2123,3202,3,1,3,0,1,0,66.30
臺南縣,仁德鄉,仁義村,0,1,3575,49,3624,5246,3,1,3,0,1,0,69.08
臺南縣,仁德鄉,新田村,0,1,1365,18,1383,2068,3,1,3,0,1,0,66.88
臺南縣,仁德鄉,後壁村,0,1,2937,52,2989,4724,3,1,3,0,1,0,63.27
臺南縣,仁德鄉,上崙村,0,1,2065,37,2102,3230,3,1,3,0,1,0,65.08
臺南縣,仁德鄉,田厝村,0,1,855,15,870,1162,3,1,3,0,1,0,74.87
臺南縣,仁德鄉,三甲村,0,1,451,5,456,625,3,1,3,0,1,0,72.96
臺南縣,仁德鄉,保安村,0,1,1250,12,1262,1949,3,1,3,0,1,0,64.75
臺南縣,仁德鄉,成功村,0,1,2275,42,2317,3468,3,1,3,0,1,0,66.81
臺南縣,仁德鄉,仁和村,0,1,868,20,888,1249,3,1,3,0,1,0,71.10
臺南縣,仁德鄉,仁愛村,0,1,1351,18,1369,1964,3,1,3,0,1,0,69.70
臺南縣,仁德鄉,二行村,0,1,1251,28,1279,1897,3,1,3,0,1,0,67.42
臺南縣,仁德鄉,大甲村,0,1,1240,21,1261,1763,3,1,3,0,1,0,71.53
臺南縣,仁德鄉,中洲村,0,1,727,6,733,1219,3,1,3,0,1,0,60.13
臺南縣,仁德鄉,中生村,0,1,827,14,841,1307,3,1,3,0,1,0,64.35
臺南縣,歸仁鄉,南保村,0,1,2560,39,2599,3667,3,1,3,0,1,0,70.88
臺南縣,歸仁鄉,南興村,0,1,1433,19,1452,2141,3,1,3,0,1,0,67.82
臺南縣,歸仁鄉,六甲村,0,1,2927,37,2964,4344,3,1,3,0,1,0,68.23
臺南縣,歸仁鄉,後市村,0,1,2935,24,2959,4258,3,1,3,0,1,0,69.49
臺南縣,歸仁鄉,辜厝村,0,1,2626,31,2657,3917,3,1,3,0,1,0,67.83
臺南縣,歸仁鄉,許厝村,0,1,1716,12,1728,2381,3,1,3,0,1,0,72.57
臺南縣,歸仁鄉,看西村,0,1,859,9,868,1200,3,1,3,0,1,0,72.33
臺南縣,歸仁鄉,看東村,0,1,857,17,874,1194,3,1,3,0,1,0,73.20
臺南縣,歸仁鄉,崙頂村,0,1,1236,9,1245,1624,3,1,3,0,1,0,76.66
臺南縣,歸仁鄉,沙崙村,0,1,334,4,338,484,3,1,3,0,1,0,69.83
臺南縣,歸仁鄉,大潭村,0,1,1091,11,1102,1545,3,1,3,0,1,0,71.33
臺南縣,歸仁鄉,武東村,0,1,746,17,763,1348,3,1,3,0,1,0,56.60
臺南縣,歸仁鄉,歸仁村,0,1,1092,12,1104,1604,3,1,3,0,1,0,68.83
臺南縣,歸仁鄉,八甲村,0,1,1201,9,1210,1697,3,1,3,0,1,0,71.30
臺南縣,歸仁鄉,七甲村,0,1,960,8,968,1397,3,1,3,0,1,0,69.29
臺南縣,歸仁鄉,媽廟村,0,1,1147,17,1164,1652,3,1,3,0,1,0,70.46
臺南縣,歸仁鄉,西埔村,0,1,887,15,902,1226,3,1,3,0,1,0,73.57
臺南縣,歸仁鄉,大廟村,0,1,1342,29,1371,1917,3,1,3,0,1,0,71.52
臺南縣,關廟鄉,關廟村,0,1,1246,10,1256,1743,3,1,3,0,1,0,72.06
臺南縣,關廟鄉,山西村,0,1,1195,10,1205,1685,3,1,3,0,1,0,71.51
臺南縣,關廟鄉,香洋村,0,1,2324,23,2347,3419,3,1,3,0,1,0,68.65
臺南縣,關廟鄉,北勢村,0,1,1649,20,1669,2464,3,1,3,0,1,0,67.74
臺南縣,關廟鄉,新埔村,0,1,538,4,542,758,3,1,3,0,1,0,71.50
臺南縣,關廟鄉,新光村,0,1,531,7,538,794,3,1,3,0,1,0,67.76
臺南縣,關廟鄉,五甲村,0,1,1614,22,1636,2255,3,1,3,0,1,0,72.55
臺南縣,關廟鄉,東勢村,0,1,1754,13,1767,2562,3,1,3,0,1,0,68.97
臺南縣,關廟鄉,松腳村,0,1,1301,13,1314,1885,3,1,3,0,1,0,69.71
臺南縣,關廟鄉,南花村,0,1,878,11,889,1278,3,1,3,0,1,0,69.56
臺南縣,關廟鄉,北花村,0,1,1450,15,1465,2075,3,1,3,0,1,0,70.60
臺南縣,關廟鄉,深坑村,0,1,1049,9,1058,1412,3,1,3,0,1,0,74.93
臺南縣,關廟鄉,布袋村,0,1,768,10,778,1170,3,1,3,0,1,0,66.50
臺南縣,關廟鄉,田中村,0,1,513,5,518,774,3,1,3,0,1,0,66.93
臺南縣,關廟鄉,龜洞村,0,1,526,5,531,719,3,1,3,0,1,0,73.85
臺南縣,關廟鄉,埤頭村,0,1,924,7,931,1335,3,1,3,0,1,0,69.74
臺南縣,關廟鄉,下湖村,0,1,299,6,305,396,3,1,3,0,1,0,77.02
臺南縣,龍崎鄉,崎頂村,0,1,811,8,819,1200,3,1,3,0,1,0,68.25
臺南縣,龍崎鄉,土崎村,0,1,501,6,507,693,3,1,3,0,1,0,73.16
臺南縣,龍崎鄉,中坑村,0,1,111,1,112,202,3,1,3,0,1,0,55.45
臺南縣,龍崎鄉,楠坑村,0,1,224,4,228,306,3,1,3,0,1,0,74.51
臺南縣,龍崎鄉,牛埔村,0,1,213,2,215,285,3,1,3,0,1,0,75.44
臺南縣,龍崎鄉,大坪村,0,1,230,0,230,325,3,1,3,0,1,0,70.77
臺南縣,龍崎鄉,龍船村,0,1,322,2,324,437,3,1,3,0,1,0,74.14
臺南縣,龍崎鄉,石曹村,0,1,253,3,256,393,3,1,3,0,1,0,65.14
臺南縣,永康市,五王里,0,1,2063,22,2085,3427,3,1,3,0,1,0,60.84
臺南縣,永康市,三合里,0,1,1368,29,1397,2229,3,1,3,0,1,0,62.67
臺南縣,永康市,六合里,0,1,1117,18,1135,1779,3,1,3,0,1,0,63.80
臺南縣,永康市,網寮里,0,1,1754,23,1777,2872,3,1,3,0,1,0,61.87
臺南縣,永康市,二王里,0,1,2712,28,2740,4339,3,1,3,0,1,0,63.15
臺南縣,永康市,永康里,0,1,3033,29,3062,4611,3,1,3,0,1,0,66.41
臺南縣,永康市,埔園里,0,1,2346,41,2387,3419,3,1,3,0,1,0,69.82
臺南縣,永康市,正強里,0,1,2970,32,3002,4537,3,1,3,0,1,0,66.17
臺南縣,永康市,大橋里,0,1,2181,30,2211,3564,3,1,3,0,1,0,62.04
臺南縣,永康市,東橋里,0,1,1398,19,1417,2182,3,1,3,0,1,0,64.94
臺南縣,永康市,西橋里,0,1,1269,25,1294,2110,3,1,3,0,1,0,61.33
臺南縣,永康市,安康里,0,1,1229,22,1251,2083,3,1,3,0,1,0,60.06
臺南縣,永康市,蔦松里,0,1,822,11,833,1171,3,1,3,0,1,0,71.14
臺南縣,永康市,三民里,0,1,729,9,738,1010,3,1,3,0,1,0,73.07
臺南縣,永康市,鹽行里,0,1,3262,48,3310,4921,3,1,3,0,1,0,67.26
臺南縣,永康市,鹽洲里,0,1,2196,37,2233,3245,3,1,3,0,1,0,68.81
臺南縣,永康市,甲頂里,0,1,1501,11,1512,2228,3,1,3,0,1,0,67.86
臺南縣,永康市,尚頂里,0,1,1734,19,1753,2655,3,1,3,0,1,0,66.03
臺南縣,永康市,龍潭里,0,1,2809,42,2851,4405,3,1,3,0,1,0,64.72
臺南縣,永康市,王行里,0,1,1029,12,1041,1506,3,1,3,0,1,0,69.12
臺南縣,永康市,烏竹里,0,1,789,6,795,1162,3,1,3,0,1,0,68.42
臺南縣,永康市,西勢里,0,1,2094,38,2132,3082,3,1,3,0,1,0,69.18
臺南縣,永康市,新樹里,0,1,769,11,780,1133,3,1,3,0,1,0,68.84
臺南縣,永康市,大灣里,0,1,1950,25,1975,2694,3,1,3,0,1,0,73.31
臺南縣,永康市,東灣里,0,1,1873,20,1893,2742,3,1,3,0,1,0,69.04
臺南縣,永康市,西灣里,0,1,2535,43,2578,3789,3,1,3,0,1,0,68.04
臺南縣,永康市,南灣里,0,1,2258,19,2277,3152,3,1,3,0,1,0,72.24
臺南縣,永康市,崑山里,0,1,2813,46,2859,4325,3,1,3,0,1,0,66.10
臺南縣,永康市,北灣里,0,1,2647,36,2683,3999,3,1,3,0,1,0,67.09
臺南縣,永康市,復興里,0,1,1331,32,1363,1947,3,1,3,0,1,0,70.01
臺南縣,永康市,建國里,0,1,1530,26,1556,2098,3,1,3,0,1,0,74.17
臺南縣,永康市,復國里,0,1,1272,11,1283,1894,3,1,3,0,1,0,67.74
臺南縣,永康市,復華里,0,1,3543,51,3594,5929,3,1,3,0,1,0,60.62
臺南縣,永康市,光復里,0,1,904,15,919,1259,3,1,3,0,1,0,72.99
臺南縣,永康市,神洲里,0,1,1270,15,1285,1826,3,1,3,0,1,0,70.37
臺南縣,永康市,成功里,0,1,1619,25,1644,2360,3,1,3,0,1,0,69.66
臺南縣,永康市,中華里,0,1,986,5,991,1597,3,1,3,0,1,0,62.05
臺南縣,永康市,中興里,0,1,1727,30,1757,2726,3,1,3,0,1,0,64.45
臺南縣,永康市,勝利里,0,1,2441,31,2472,3997,3,1,3,0,1,0,61.85
高雄縣,鳳山市,鳳崗里,0,1,980,11,991,1444,3,1,3,0,1,0,68.63
高雄縣,鳳山市,縣衙里,0,1,584,6,590,924,3,1,3,0,1,0,63.85
高雄縣,鳳山市,曹公里,0,1,1536,16,1552,2305,3,1,3,0,1,0,67.33
高雄縣,鳳山市,鎮西里,0,1,3359,34,3393,5163,3,1,3,0,1,0,65.72
高雄縣,鳳山市,北門里,0,1,2727,43,2770,4161,3,1,3,0,1,0,66.57
高雄縣,鳳山市,鎮北里,0,1,3549,38,3587,5709,3,1,3,0,1,0,62.83
高雄縣,鳳山市,忠誠里,0,1,1506,16,1522,2280,3,1,3,0,1,0,66.75
高雄縣,鳳山市,文英里,0,1,1353,13,1366,2085,3,1,3,0,1,0,65.52
高雄縣,鳳山市,文華里,0,1,2783,22,2805,4219,3,1,3,0,1,0,66.48
高雄縣,鳳山市,文山里,0,1,2725,28,2753,4162,3,1,3,0,1,0,66.15
高雄縣,鳳山市,文德里,0,1,4836,51,4887,8030,3,1,3,0,1,0,60.86
高雄縣,鳳山市,成功里,0,1,681,10,691,949,3,1,3,0,1,0,72.81
高雄縣,鳳山市,縣口里,0,1,387,3,390,549,3,1,3,0,1,0,71.04
高雄縣,鳳山市,光明里,0,1,1016,18,1034,1492,3,1,3,0,1,0,69.30
高雄縣,鳳山市,和德里,0,1,1113,12,1125,1642,3,1,3,0,1,0,68.51
高雄縣,鳳山市,和興里,0,1,3118,24,3142,4644,3,1,3,0,1,0,67.66
高雄縣,鳳山市,南興里,0,1,714,11,725,1064,3,1,3,0,1,0,68.14
高雄縣,鳳山市,三民里,0,1,784,13,797,1181,3,1,3,0,1,0,67.49
高雄縣,鳳山市,新興里,0,1,799,9,808,1128,3,1,3,0,1,0,71.63
高雄縣,鳳山市,興仁里,0,1,2566,20,2586,3816,3,1,3,0,1,0,67.77
高雄縣,鳳山市,興中里,0,1,559,8,567,831,3,1,3,0,1,0,68.23
高雄縣,鳳山市,協和里,0,1,2441,41,2482,3618,3,1,3,0,1,0,68.60
高雄縣,鳳山市,忠義里,0,1,2022,21,2043,3130,3,1,3,0,1,0,65.27
高雄縣,鳳山市,忠孝里,0,1,2877,35,2912,4437,3,1,3,0,1,0,65.63
高雄縣,鳳山市,中和里,0,1,2254,20,2274,3228,3,1,3,0,1,0,70.45
高雄縣,鳳山市,誠正里,0,1,893,7,900,1157,3,1,3,0,1,0,77.79
高雄縣,鳳山市,誠義里,0,1,479,2,481,649,3,1,3,0,1,0,74.11
高雄縣,鳳山市,生明里,0,1,1053,17,1070,1454,3,1,3,0,1,0,73.59
高雄縣,鳳山市,鎮東里,0,1,1441,13,1454,2283,3,1,3,0,1,0,63.69
高雄縣,鳳山市,瑞竹里,0,1,3174,51,3225,4743,3,1,3,0,1,0,67.99
高雄縣,鳳山市,瑞興里,0,1,1512,18,1530,2316,3,1,3,0,1,0,66.06
高雄縣,鳳山市,東門里,0,1,2262,25,2287,3376,3,1,3,0,1,0,67.74
高雄縣,鳳山市,誠德里,0,1,3075,27,3102,4698,3,1,3,0,1,0,66.03
高雄縣,鳳山市,鳳東里,0,1,2392,36,2428,3628,3,1,3,0,1,0,66.92
高雄縣,鳳山市,埤頂里,0,1,2841,36,2877,4215,3,1,3,0,1,0,68.26
高雄縣,鳳山市,美齡里,0,1,753,11,764,989,3,1,3,0,1,0,77.25
高雄縣,鳳山市,中正里,0,1,1550,19,1569,2166,3,1,3,0,1,0,72.44
高雄縣,鳳山市,海光里,0,1,2839,41,2880,4112,3,1,3,0,1,0,70.04
高雄縣,鳳山市,海風里,0,1,2066,15,2081,2678,3,1,3,0,1,0,77.71
高雄縣,鳳山市,國泰里,0,1,2389,30,2419,3594,3,1,3,0,1,0,67.31
高雄縣,鳳山市,國光里,0,1,2621,24,2645,4044,3,1,3,0,1,0,65.41
高雄縣,鳳山市,國隆里,0,1,1865,26,1891,3157,3,1,3,0,1,0,59.90
高雄縣,鳳山市,武漢里,0,1,3194,46,3240,5249,3,1,3,0,1,0,61.73
高雄縣,鳳山市,新甲里,0,1,4051,61,4112,7110,3,1,3,0,1,0,57.83
高雄縣,鳳山市,新強里,0,1,1989,25,2014,2991,3,1,3,0,1,0,67.34
高雄縣,鳳山市,新富里,0,1,3069,46,3115,5288,3,1,3,0,1,0,58.91
高雄縣,鳳山市,老爺里,0,1,3636,55,3691,5892,3,1,3,0,1,0,62.64
高雄縣,鳳山市,過埤里,0,1,1361,26,1387,2116,3,1,3,0,1,0,65.55
高雄縣,鳳山市,正義里,0,1,3233,54,3287,5128,3,1,3,0,1,0,64.10
高雄縣,鳳山市,一甲里,0,1,3562,51,3613,5656,3,1,3,0,1,0,63.88
高雄縣,鳳山市,鎮南里,0,1,3676,44,3720,5666,3,1,3,0,1,0,65.65
高雄縣,鳳山市,富甲里,0,1,4183,62,4245,6761,3,1,3,0,1,0,62.79
高雄縣,鳳山市,南成里,0,1,3563,49,3612,5514,3,1,3,0,1,0,65.51
高雄縣,鳳山市,天興里,0,1,2279,23,2302,3492,3,1,3,0,1,0,65.92
高雄縣,鳳山市,大德里,0,1,1777,25,1802,2879,3,1,3,0,1,0,62.59
高雄縣,鳳山市,五福里,0,1,2161,30,2191,3245,3,1,3,0,1,0,67.52
高雄縣,鳳山市,福興里,0,1,3437,45,3482,5270,3,1,3,0,1,0,66.07
高雄縣,鳳山市,福誠里,0,1,2523,29,2552,4152,3,1,3,0,1,0,61.46
高雄縣,林園鄉,林園村,0,1,3266,43,3309,4724,3,1,3,0,1,0,70.05
高雄縣,林園鄉,東林村,0,1,2615,25,2640,4026,3,1,3,0,1,0,65.57
高雄縣,林園鄉,溪州村,0,1,2843,52,2895,4316,3,1,3,0,1,0,67.08
高雄縣,林園鄉,潭頭村,0,1,1515,16,1531,2110,3,1,3,0,1,0,72.56
高雄縣,林園鄉,中厝村,0,1,1747,37,1784,2444,3,1,3,0,1,0,73.00
高雄縣,林園鄉,林內村,0,1,1216,18,1234,1690,3,1,3,0,1,0,73.02
高雄縣,林園鄉,王公村,0,1,3221,59,3280,4560,3,1,3,0,1,0,71.93
高雄縣,林園鄉,林家村,0,1,1004,13,1017,1279,3,1,3,0,1,0,79.52
高雄縣,林園鄉,龔厝村,0,1,990,15,1005,1411,3,1,3,0,1,0,71.23
高雄縣,林園鄉,中門村,0,1,1320,29,1349,1776,3,1,3,0,1,0,75.96
高雄縣,林園鄉,頂厝村,0,1,1884,28,1912,2686,3,1,3,0,1,0,71.18
高雄縣,林園鄉,港埔村,0,1,1084,12,1096,1494,3,1,3,0,1,0,73.36
高雄縣,林園鄉,港嘴村,0,1,821,11,832,1124,3,1,3,0,1,0,74.02
高雄縣,林園鄉,西溪村,0,1,1667,21,1688,2318,3,1,3,0,1,0,72.82
高雄縣,林園鄉,中芸村,0,1,1175,11,1186,1645,3,1,3,0,1,0,72.10
高雄縣,林園鄉,鳳芸村,0,1,1128,14,1142,1540,3,1,3,0,1,0,74.16
高雄縣,林園鄉,東汕村,0,1,641,12,653,897,3,1,3,0,1,0,72.80
高雄縣,林園鄉,西汕村,0,1,533,3,536,820,3,1,3,0,1,0,65.37
高雄縣,林園鄉,北汕村,0,1,2304,33,2337,3651,3,1,3,0,1,0,64.01
高雄縣,大寮鄉,義和村,0,1,1322,18,1340,1847,3,1,3,0,1,0,72.55
高雄縣,大寮鄉,溪寮村,0,1,843,8,851,1227,3,1,3,0,1,0,69.36
高雄縣,大寮鄉,江山村,0,1,945,13,958,1386,3,1,3,0,1,0,69.12
高雄縣,大寮鄉,中庄村,0,1,4775,66,4841,7308,3,1,3,0,1,0,66.24
高雄縣,大寮鄉,後庄村,0,1,2514,34,2548,4019,3,1,3,0,1,0,63.40
高雄縣,大寮鄉,前庄村,0,1,1229,21,1250,1756,3,1,3,0,1,0,71.18
高雄縣,大寮鄉,翁園村,0,1,1427,12,1439,1827,3,1,3,0,1,0,78.76
高雄縣,大寮鄉,琉球村,0,1,1871,21,1892,2703,3,1,3,0,1,0,70.00
高雄縣,大寮鄉,中興村,0,1,3763,49,3812,5473,3,1,3,0,1,0,69.65
高雄縣,大寮鄉,忠義村,0,1,1935,21,1956,2662,3,1,3,0,1,0,73.48
高雄縣,大寮鄉,光武村,0,1,1763,12,1775,2286,3,1,3,0,1,0,77.65
高雄縣,大寮鄉,復興村,0,1,3209,45,3254,4122,3,1,3,0,1,0,78.94
高雄縣,大寮鄉,永芳村,0,1,3064,37,3101,4585,3,1,3,0,1,0,67.63
高雄縣,大寮鄉,山頂村,0,1,2857,41,2898,4397,3,1,3,0,1,0,65.91
高雄縣,大寮鄉,會社村,0,1,2803,39,2842,4120,3,1,3,0,1,0,68.98
高雄縣,大寮鄉,三隆村,0,1,2365,30,2395,3474,3,1,3,0,1,0,68.94
高雄縣,大寮鄉,上寮村,0,1,1229,11,1240,1778,3,1,3,0,1,0,69.74
高雄縣,大寮鄉,大寮村,0,1,2660,48,2708,4441,3,1,3,0,1,0,60.98
高雄縣,大寮鄉,拷潭村,0,1,756,8,764,1056,3,1,3,0,1,0,72.35
高雄縣,大寮鄉,內坑村,0,1,1452,16,1468,2405,3,1,3,0,1,0,61.04
高雄縣,大寮鄉,新厝村,0,1,786,11,797,1211,3,1,3,0,1,0,65.81
高雄縣,大寮鄉,過溪村,0,1,898,11,909,1284,3,1,3,0,1,0,70.79
高雄縣,大寮鄉,潮寮村,0,1,1750,26,1776,2462,3,1,3,0,1,0,72.14
高雄縣,大寮鄉,會結村,0,1,886,16,902,1158,3,1,3,0,1,0,77.89
高雄縣,大寮鄉,昭明村,0,1,1752,30,1782,2631,3,1,3,0,1,0,67.73
高雄縣,大寮鄉,義仁村,0,1,1144,16,1160,1712,3,1,3,0,1,0,67.76
高雄縣,大樹鄉,竹寮村,0,1,1363,19,1382,1883,3,1,3,0,1,0,73.39
高雄縣,大樹鄉,九曲村,0,1,2121,19,2140,2897,3,1,3,0,1,0,73.87
高雄縣,大樹鄉,久堂村,0,1,2945,34,2979,3899,3,1,3,0,1,0,76.40
高雄縣,大樹鄉,水安村,0,1,1465,14,1479,2083,3,1,3,0,1,0,71.00
高雄縣,大樹鄉,水寮村,0,1,1665,10,1675,2241,3,1,3,0,1,0,74.74
高雄縣,大樹鄉,井腳村,0,1,1163,17,1180,1514,3,1,3,0,1,0,77.94
高雄縣,大樹鄉,小坪村,0,1,856,15,871,1132,3,1,3,0,1,0,76.94
高雄縣,大樹鄉,龍目村,0,1,1160,15,1175,1519,3,1,3,0,1,0,77.35
高雄縣,大樹鄉,大樹村,0,1,1493,20,1513,2189,3,1,3,0,1,0,69.12
高雄縣,大樹鄉,檨腳村,0,1,2065,21,2086,2933,3,1,3,0,1,0,71.12
高雄縣,大樹鄉,興山村,0,1,730,3,733,1032,3,1,3,0,1,0,71.03
高雄縣,大樹鄉,和山村,0,1,674,9,683,959,3,1,3,0,1,0,71.22
高雄縣,大樹鄉,姑山村,0,1,726,10,736,1001,3,1,3,0,1,0,73.53
高雄縣,大樹鄉,三和村,0,1,639,5,644,917,3,1,3,0,1,0,70.23
高雄縣,大樹鄉,大坑村,0,1,824,6,830,1194,3,1,3,0,1,0,69.51
高雄縣,大樹鄉,溪埔村,0,1,1408,11,1419,1854,3,1,3,0,1,0,76.54
高雄縣,大樹鄉,興田村,0,1,1209,20,1229,1727,3,1,3,0,1,0,71.16
高雄縣,大樹鄉,統嶺村,0,1,507,6,513,694,3,1,3,0,1,0,73.92
高雄縣,仁武鄉,仁武村,0,1,2449,50,2499,3532,3,1,3,0,1,0,70.75
高雄縣,仁武鄉,文武村,0,1,1799,25,1824,2557,3,1,3,0,1,0,71.33
高雄縣,仁武鄉,後安村,0,1,1072,32,1104,1684,3,1,3,0,1,0,65.56
高雄縣,仁武鄉,竹後村,0,1,2139,41,2180,3219,3,1,3,0,1,0,67.72
高雄縣,仁武鄉,八卦村,0,1,2483,32,2515,4032,3,1,3,0,1,0,62.38
高雄縣,仁武鄉,高楠村,0,1,1182,22,1204,1587,3,1,3,0,1,0,75.87
高雄縣,仁武鄉,大灣村,0,1,769,6,775,1167,3,1,3,0,1,0,66.41
高雄縣,仁武鄉,灣內村,0,1,2862,39,2901,4523,3,1,3,0,1,0,64.14
高雄縣,仁武鄉,考潭村,0,1,2102,27,2129,3240,3,1,3,0,1,0,65.71
高雄縣,仁武鄉,烏林村,0,1,1604,26,1630,2266,3,1,3,0,1,0,71.93
高雄縣,仁武鄉,仁福村,0,1,329,2,331,465,3,1,3,0,1,0,71.18
高雄縣,大社鄉,嘉誠村,0,1,590,8,598,861,3,1,3,0,1,0,69.45
高雄縣,大社鄉,保社村,0,1,1018,10,1028,1369,3,1,3,0,1,0,75.09
高雄縣,大社鄉,大社村,0,1,3599,44,3643,5701,3,1,3,0,1,0,63.90
高雄縣,大社鄉,三奶村,0,1,1679,32,1711,2365,3,1,3,0,1,0,72.35
高雄縣,大社鄉,觀音村,0,1,2699,35,2734,4007,3,1,3,0,1,0,68.23
高雄縣,大社鄉,神農村,0,1,1764,29,1793,2671,3,1,3,0,1,0,67.13
高雄縣,大社鄉,中里村,0,1,1579,26,1605,2261,3,1,3,0,1,0,70.99
高雄縣,大社鄉,翠屏村,0,1,922,12,934,1258,3,1,3,0,1,0,74.24
高雄縣,鳥松鄉,鳥松村,0,1,3341,31,3372,5119,3,1,3,0,1,0,65.87
高雄縣,鳥松鄉,夢裡村,0,1,1095,16,1111,1527,3,1,3,0,1,0,72.76
高雄縣,鳥松鄉,大華村,0,1,3442,42,3484,5328,3,1,3,0,1,0,65.39
高雄縣,鳥松鄉,濫埔村,0,1,1557,13,1570,2160,3,1,3,0,1,0,72.69
高雄縣,鳥松鄉,仁美村,0,1,3121,40,3161,4766,3,1,3,0,1,0,66.32
高雄縣,鳥松鄉,華美村,0,1,1803,32,1835,2689,3,1,3,0,1,0,68.24
高雄縣,鳥松鄉,大竹村,0,1,382,16,398,541,3,1,3,0,1,0,73.57
高雄縣,岡山鎮,岡山里,0,1,2056,22,2078,3061,3,1,3,0,1,0,67.89
高雄縣,岡山鎮,平安里,0,1,959,15,974,1354,3,1,3,0,1,0,71.94
高雄縣,岡山鎮,壽天里,0,1,1859,35,1894,2768,3,1,3,0,1,0,68.42
高雄縣,岡山鎮,維仁里,0,1,961,17,978,1420,3,1,3,0,1,0,68.87
高雄縣,岡山鎮,灣裡里,0,1,818,9,827,1115,3,1,3,0,1,0,74.17
高雄縣,岡山鎮,大遼里,0,1,840,1,841,1122,3,1,3,0,1,0,74.96
高雄縣,岡山鎮,後紅里,0,1,1232,20,1252,1778,3,1,3,0,1,0,70.42
高雄縣,岡山鎮,碧紅里,0,1,1741,24,1765,2509,3,1,3,0,1,0,70.35
高雄縣,岡山鎮,程香里,0,1,1638,22,1660,2444,3,1,3,0,1,0,67.92
高雄縣,岡山鎮,竹圍里,0,1,1771,20,1791,2629,3,1,3,0,1,0,68.12
高雄縣,岡山鎮,台上里,0,1,1721,22,1743,2501,3,1,3,0,1,0,69.69
高雄縣,岡山鎮,為隨里,0,1,438,4,442,547,3,1,3,0,1,0,80.80
高雄縣,岡山鎮,前峰里,0,1,1637,19,1656,2451,3,1,3,0,1,0,67.56
高雄縣,岡山鎮,壽峰里,0,1,1044,11,1055,1448,3,1,3,0,1,0,72.86
高雄縣,岡山鎮,仁壽里,0,1,2215,23,2238,3196,3,1,3,0,1,0,70.03
高雄縣,岡山鎮,協和里,0,1,2053,25,2078,2915,3,1,3,0,1,0,71.29
高雄縣,岡山鎮,本洲里,0,1,853,5,858,1156,3,1,3,0,1,0,74.22
高雄縣,岡山鎮,後協里,0,1,2550,32,2582,3698,3,1,3,0,1,0,69.82
高雄縣,岡山鎮,協榮里,0,1,1240,15,1255,1770,3,1,3,0,1,0,70.90
高雄縣,岡山鎮,劉厝里,0,1,845,10,855,1201,3,1,3,0,1,0,71.19
高雄縣,岡山鎮,白米里,0,1,496,4,500,673,3,1,3,0,1,0,74.29
高雄縣,岡山鎮,石潭里,0,1,852,13,865,1187,3,1,3,0,1,0,72.87
高雄縣,岡山鎮,福興里,0,1,661,7,668,970,3,1,3,0,1,0,68.87
高雄縣,岡山鎮,嘉興里,0,1,1979,34,2013,2949,3,1,3,0,1,0,68.26
高雄縣,岡山鎮,嘉峰里,0,1,1121,19,1140,1445,3,1,3,0,1,0,78.89
高雄縣,岡山鎮,潭底里,0,1,540,10,550,722,3,1,3,0,1,0,76.18
高雄縣,岡山鎮,華崗里,0,1,950,10,960,1253,3,1,3,0,1,0,76.62
高雄縣,岡山鎮,三和里,0,1,510,5,515,694,3,1,3,0,1,0,74.21
高雄縣,岡山鎮,大莊里,0,1,599,9,608,838,3,1,3,0,1,0,72.55
高雄縣,岡山鎮,忠孝里,0,1,730,7,737,984,3,1,3,0,1,0,74.90
高雄縣,岡山鎮,和平里,0,1,686,13,699,919,3,1,3,0,1,0,76.06
高雄縣,岡山鎮,信義里,0,1,1577,10,1587,2151,3,1,3,0,1,0,73.78
高雄縣,岡山鎮,仁愛里,0,1,1088,10,1098,1421,3,1,3,0,1,0,77.27
高雄縣,岡山鎮,四維里,0,1,1120,12,1132,1446,3,1,3,0,1,0,78.28
高雄縣,岡山鎮,復興里,0,1,357,2,359,468,3,1,3,0,1,0,76.71
高雄縣,橋頭鄉,橋頭村,0,1,1081,15,1096,1493,3,1,3,0,1,0,73.41
高雄縣,橋頭鄉,橋南村,0,1,712,4,716,919,3,1,3,0,1,0,77.91
高雄縣,橋頭鄉,興糖村,0,1,261,3,264,357,3,1,3,0,1,0,73.95
高雄縣,橋頭鄉,仕隆村,0,1,1590,17,1607,2209,3,1,3,0,1,0,72.75
高雄縣,橋頭鄉,仕豐村,0,1,1383,17,1400,1897,3,1,3,0,1,0,73.80
高雄縣,橋頭鄉,仕和村,0,1,1892,20,1912,2606,3,1,3,0,1,0,73.37
高雄縣,橋頭鄉,新莊村,0,1,930,7,937,1224,3,1,3,0,1,0,76.55
高雄縣,橋頭鄉,甲北村,0,1,1344,23,1367,1869,3,1,3,0,1,0,73.14
高雄縣,橋頭鄉,甲南村,0,1,1413,20,1433,1995,3,1,3,0,1,0,71.83
高雄縣,橋頭鄉,頂鹽村,0,1,595,15,610,874,3,1,3,0,1,0,69.79
高雄縣,橋頭鄉,白樹村,0,1,1695,21,1716,2220,3,1,3,0,1,0,77.30
高雄縣,橋頭鄉,芋寮村,0,1,1293,12,1305,1716,3,1,3,0,1,0,76.05
高雄縣,橋頭鄉,西林村,0,1,1068,21,1089,1464,3,1,3,0,1,0,74.39
高雄縣,橋頭鄉,東林村,0,1,1420,17,1437,1922,3,1,3,0,1,0,74.77
高雄縣,橋頭鄉,德松村,0,1,626,5,631,854,3,1,3,0,1,0,73.89
高雄縣,橋頭鄉,筆秀村,0,1,973,14,987,1290,3,1,3,0,1,0,76.51
高雄縣,橋頭鄉,中崎村,0,1,465,0,465,610,3,1,3,0,1,0,76.23
高雄縣,燕巢鄉,金山村,0,1,358,1,359,441,3,1,3,0,1,0,81.41
高雄縣,燕巢鄉,尖山村,0,1,733,17,750,1018,3,1,3,0,1,0,73.67
高雄縣,燕巢鄉,東燕村,0,1,1513,14,1527,2036,3,1,3,0,1,0,75.00
高雄縣,燕巢鄉,西燕村,0,1,2014,33,2047,2788,3,1,3,0,1,0,73.42
高雄縣,燕巢鄉,南燕村,0,1,1802,30,1832,2455,3,1,3,0,1,0,74.62
高雄縣,燕巢鄉,瓊林村,0,1,1089,16,1105,1476,3,1,3,0,1,0,74.86
高雄縣,燕巢鄉,安招村,0,1,3188,43,3231,4280,3,1,3,0,1,0,75.49
高雄縣,燕巢鄉,角宿村,0,1,1432,39,1471,2026,3,1,3,0,1,0,72.61
高雄縣,燕巢鄉,鳳雄村,0,1,1652,35,1687,2177,3,1,3,0,1,0,77.49
高雄縣,燕巢鄉,橫山村,0,1,1204,16,1220,1747,3,1,3,0,1,0,69.83
高雄縣,燕巢鄉,深水村,0,1,1625,30,1655,2520,3,1,3,0,1,0,65.67
高雄縣,田寮鄉,鹿埔村,0,1,266,1,267,382,3,1,3,0,1,0,69.90
高雄縣,田寮鄉,古亭村,0,1,426,9,435,696,3,1,3,0,1,0,62.50
高雄縣,田寮鄉,崇德村,0,1,746,7,753,1017,3,1,3,0,1,0,74.04
高雄縣,田寮鄉,三和村,0,1,286,4,290,426,3,1,3,0,1,0,68.08
高雄縣,田寮鄉,西德村,0,1,628,21,649,975,3,1,3,0,1,0,66.56
高雄縣,田寮鄉,南安村,0,1,944,16,960,1412,3,1,3,0,1,0,67.99
高雄縣,田寮鄉,大同村,0,1,292,6,298,434,3,1,3,0,1,0,68.66
高雄縣,田寮鄉,田寮村,0,1,283,7,290,444,3,1,3,0,1,0,65.32
高雄縣,田寮鄉,七星村,0,1,460,12,472,695,3,1,3,0,1,0,67.91
高雄縣,田寮鄉,新興村,0,1,913,8,921,1289,3,1,3,0,1,0,71.45
高雄縣,阿蓮鄉,阿蓮村,0,1,2292,39,2331,3630,3,1,3,0,1,0,64.21
高雄縣,阿蓮鄉,南蓮村,0,1,1663,24,1687,2478,3,1,3,0,1,0,68.08
高雄縣,阿蓮鄉,清蓮村,0,1,1565,20,1585,2186,3,1,3,0,1,0,72.51
高雄縣,阿蓮鄉,和蓮村,0,1,1213,15,1228,1799,3,1,3,0,1,0,68.26
高雄縣,阿蓮鄉,青旗村,0,1,845,11,856,1276,3,1,3,0,1,0,67.08
高雄縣,阿蓮鄉,石安村,0,1,865,16,881,1213,3,1,3,0,1,0,72.63
高雄縣,阿蓮鄉,中路村,0,1,1284,16,1300,1789,3,1,3,0,1,0,72.67
高雄縣,阿蓮鄉,峰山村,0,1,798,14,812,1070,3,1,3,0,1,0,75.89
高雄縣,阿蓮鄉,港後村,0,1,1152,21,1173,1523,3,1,3,0,1,0,77.02
高雄縣,阿蓮鄉,崗山村,0,1,479,12,491,656,3,1,3,0,1,0,74.85
高雄縣,阿蓮鄉,復安村,0,1,1026,20,1046,1434,3,1,3,0,1,0,72.94
高雄縣,阿蓮鄉,玉庫村,0,1,673,9,682,904,3,1,3,0,1,0,75.44
高雄縣,路竹鄉,竹園村,0,1,1282,12,1294,1630,3,1,3,0,1,0,79.39
高雄縣,路竹鄉,下坑村,0,1,1983,33,2016,2393,3,1,3,0,1,0,84.25
高雄縣,路竹鄉,甲南村,0,1,1968,21,1989,2637,3,1,3,0,1,0,75.43
高雄縣,路竹鄉,甲北村,0,1,1430,8,1438,1760,3,1,3,0,1,0,81.70
高雄縣,路竹鄉,社東村,0,1,1122,11,1133,1456,3,1,3,0,1,0,77.82
高雄縣,路竹鄉,社中村,0,1,744,7,751,973,3,1,3,0,1,0,77.18
高雄縣,路竹鄉,社西村,0,1,1565,31,1596,2117,3,1,3,0,1,0,75.39
高雄縣,路竹鄉,社南村,0,1,2120,23,2143,2877,3,1,3,0,1,0,74.49
高雄縣,路竹鄉,竹東村,0,1,1744,20,1764,2347,3,1,3,0,1,0,75.16
高雄縣,路竹鄉,竹南村,0,1,1770,23,1793,2525,3,1,3,0,1,0,71.01
高雄縣,路竹鄉,竹西村,0,1,1514,14,1528,1959,3,1,3,0,1,0,78.00
高雄縣,路竹鄉,文南村,0,1,1366,10,1376,1816,3,1,3,0,1,0,75.77
高雄縣,路竹鄉,文北村,0,1,1809,17,1826,2246,3,1,3,0,1,0,81.30
高雄縣,路竹鄉,竹滬村,0,1,1411,22,1433,1885,3,1,3,0,1,0,76.02
高雄縣,路竹鄉,頂寮村,0,1,831,2,833,1137,3,1,3,0,1,0,73.26
高雄縣,路竹鄉,新達村,0,1,849,10,859,1121,3,1,3,0,1,0,76.63
高雄縣,路竹鄉,後鄉村,0,1,645,9,654,833,3,1,3,0,1,0,78.51
高雄縣,路竹鄉,北嶺村,0,1,789,11,800,969,3,1,3,0,1,0,82.56
高雄縣,路竹鄉,三爺村,0,1,647,9,656,805,3,1,3,0,1,0,81.49
高雄縣,路竹鄉,鴨寮村,0,1,946,11,957,1213,3,1,3,0,1,0,78.90
高雄縣,湖內鄉,大湖村,0,1,1563,16,1579,2081,3,1,3,0,1,0,75.88
高雄縣,湖內鄉,田尾村,0,1,727,12,739,1008,3,1,3,0,1,0,73.31
高雄縣,湖內鄉,湖內村,0,1,2100,35,2135,3072,3,1,3,0,1,0,69.50
高雄縣,湖內鄉,海埔村,0,1,1054,16,1070,1618,3,1,3,0,1,0,66.13
高雄縣,湖內鄉,海山村,0,1,833,12,845,1150,3,1,3,0,1,0,73.48
高雄縣,湖內鄉,劉家村,0,1,748,18,766,1107,3,1,3,0,1,0,69.20
高雄縣,湖內鄉,太爺村,0,1,587,5,592,801,3,1,3,0,1,0,73.91
高雄縣,湖內鄉,公舘村,0,1,979,10,989,1340,3,1,3,0,1,0,73.81
高雄縣,湖內鄉,葉厝村,0,1,1084,12,1096,1532,3,1,3,0,1,0,71.54
高雄縣,湖內鄉,文賢村,0,1,754,19,773,1099,3,1,3,0,1,0,70.34
高雄縣,湖內鄉,中賢村,0,1,1286,13,1299,1845,3,1,3,0,1,0,70.41
高雄縣,湖內鄉,逸賢村,0,1,573,10,583,834,3,1,3,0,1,0,69.90
高雄縣,湖內鄉,忠興村,0,1,546,6,552,724,3,1,3,0,1,0,76.24
高雄縣,茄萣鄉,福德村,0,1,690,4,694,1036,3,1,3,0,1,0,66.99
高雄縣,茄萣鄉,萬福村,0,1,553,6,559,847,3,1,3,0,1,0,66.00
高雄縣,茄萣鄉,白雲村,0,1,1061,15,1076,1537,3,1,3,0,1,0,70.01
高雄縣,茄萣鄉,嘉賜村,0,1,1517,15,1532,2359,3,1,3,0,1,0,64.94
高雄縣,茄萣鄉,嘉安村,0,1,875,8,883,1266,3,1,3,0,1,0,69.75
高雄縣,茄萣鄉,嘉樂村,0,1,1254,15,1269,1785,3,1,3,0,1,0,71.09
高雄縣,茄萣鄉,嘉泰村,0,1,827,12,839,1278,3,1,3,0,1,0,65.65
高雄縣,茄萣鄉,嘉福村,0,1,725,7,732,1090,3,1,3,0,1,0,67.16
高雄縣,茄萣鄉,和協村,0,1,760,9,769,1197,3,1,3,0,1,0,64.24
高雄縣,茄萣鄉,嘉定村,0,1,895,7,902,1307,3,1,3,0,1,0,69.01
高雄縣,茄萣鄉,保定村,0,1,1657,16,1673,2693,3,1,3,0,1,0,62.12
高雄縣,茄萣鄉,大定村,0,1,742,10,752,1158,3,1,3,0,1,0,64.94
高雄縣,茄萣鄉,光定村,0,1,678,10,688,1027,3,1,3,0,1,0,66.99
高雄縣,茄萣鄉,吉定村,0,1,758,8,766,1110,3,1,3,0,1,0,69.01
高雄縣,茄萣鄉,崎漏村,0,1,1836,31,1867,2650,3,1,3,0,1,0,70.45
高雄縣,彌陀鄉,舊港村,0,1,1045,10,1055,1340,3,1,3,0,1,0,78.73
高雄縣,彌陀鄉,文安村,0,1,1241,17,1258,1698,3,1,3,0,1,0,74.09
高雄縣,彌陀鄉,鹽埕村,0,1,1295,20,1315,1734,3,1,3,0,1,0,75.84
高雄縣,彌陀鄉,過港村,0,1,700,16,716,860,3,1,3,0,1,0,83.26
高雄縣,彌陀鄉,光和村,0,1,735,8,743,993,3,1,3,0,1,0,74.82
高雄縣,彌陀鄉,彌靖村,0,1,1265,11,1276,1682,3,1,3,0,1,0,75.86
高雄縣,彌陀鄉,彌仁村,0,1,440,3,443,575,3,1,3,0,1,0,77.04
高雄縣,彌陀鄉,彌壽村,0,1,544,7,551,724,3,1,3,0,1,0,76.10
高雄縣,彌陀鄉,彌陀村,0,1,1052,23,1075,1403,3,1,3,0,1,0,76.62
高雄縣,彌陀鄉,海尾村,0,1,611,13,624,802,3,1,3,0,1,0,77.81
高雄縣,彌陀鄉,漯底村,0,1,745,5,750,901,3,1,3,0,1,0,83.24
高雄縣,彌陀鄉,南寮村,0,1,1346,11,1357,1821,3,1,3,0,1,0,74.52
高雄縣,永安鄉,永安村,0,1,980,6,986,1333,3,1,3,0,1,0,73.97
高雄縣,永安鄉,永華村,0,1,1124,15,1139,1513,3,1,3,0,1,0,75.28
高雄縣,永安鄉,新港村,0,1,1510,11,1521,2090,3,1,3,0,1,0,72.78
高雄縣,永安鄉,鹽田村,0,1,287,2,289,429,3,1,3,0,1,0,67.37
高雄縣,永安鄉,保寧村,0,1,1177,15,1192,1520,3,1,3,0,1,0,78.42
高雄縣,永安鄉,維新村,0,1,1514,9,1523,2024,3,1,3,0,1,0,75.25
高雄縣,梓官鄉,梓信村,0,1,1180,25,1205,1714,3,1,3,0,1,0,70.30
高雄縣,梓官鄉,梓義村,0,1,1348,19,1367,1920,3,1,3,0,1,0,71.20
高雄縣,梓官鄉,梓和村,0,1,1470,23,1493,2093,3,1,3,0,1,0,71.33
高雄縣,梓官鄉,梓平村,0,1,743,7,750,996,3,1,3,0,1,0,75.30
高雄縣,梓官鄉,中崙村,0,1,619,10,629,861,3,1,3,0,1,0,73.05
高雄縣,梓官鄉,同安村,0,1,601,5,606,784,3,1,3,0,1,0,77.30
高雄縣,梓官鄉,大舍村,0,1,2201,35,2236,3127,3,1,3,0,1,0,71.51
高雄縣,梓官鄉,赤崁村,0,1,1356,26,1382,1890,3,1,3,0,1,0,73.12
高雄縣,梓官鄉,赤東村,0,1,1756,26,1782,2391,3,1,3,0,1,0,74.53
高雄縣,梓官鄉,赤西村,0,1,444,4,448,639,3,1,3,0,1,0,70.11
高雄縣,梓官鄉,禮蚵村,0,1,1559,19,1578,2236,3,1,3,0,1,0,70.57
高雄縣,梓官鄉,智蚵村,0,1,1313,21,1334,1892,3,1,3,0,1,0,70.51
高雄縣,梓官鄉,信蚵村,0,1,781,5,786,1157,3,1,3,0,1,0,67.93
高雄縣,梓官鄉,茄苳村,0,1,1534,17,1551,2104,3,1,3,0,1,0,73.72
高雄縣,梓官鄉,典寶村,0,1,1418,17,1435,1857,3,1,3,0,1,0,77.28
高雄縣,旗山鎮,太平里,0,1,1546,18,1564,2286,3,1,3,0,1,0,68.42
高雄縣,旗山鎮,大德里,0,1,1741,15,1756,2426,3,1,3,0,1,0,72.38
高雄縣,旗山鎮,湄洲里,0,1,642,5,647,896,3,1,3,0,1,0,72.21
高雄縣,旗山鎮,鼓山里,0,1,482,7,489,635,3,1,3,0,1,0,77.01
高雄縣,旗山鎮,新山里,0,1,672,3,675,915,3,1,3,0,1,0,73.77
高雄縣,旗山鎮,和平里,0,1,466,8,474,671,3,1,3,0,1,0,70.64
高雄縣,旗山鎮,竹峰里,0,1,365,5,370,495,3,1,3,0,1,0,74.75
高雄縣,旗山鎮,瑞吉里,0,1,1271,9,1280,1869,3,1,3,0,1,0,68.49
高雄縣,旗山鎮,永和里,0,1,1959,28,1987,2812,3,1,3,0,1,0,70.66
高雄縣,旗山鎮,三協里,0,1,1018,14,1032,1770,3,1,3,0,1,0,58.31
高雄縣,旗山鎮,圓富里,0,1,1284,32,1316,1885,3,1,3,0,1,0,69.81
高雄縣,旗山鎮,中正里,0,1,1044,22,1066,1521,3,1,3,0,1,0,70.09
高雄縣,旗山鎮,大林里,0,1,1197,15,1212,1678,3,1,3,0,1,0,72.23
高雄縣,旗山鎮,上洲里,0,1,721,9,730,954,3,1,3,0,1,0,76.52
高雄縣,旗山鎮,鯤洲里,0,1,767,7,774,986,3,1,3,0,1,0,78.50
高雄縣,旗山鎮,大山里,0,1,1061,14,1075,1402,3,1,3,0,1,0,76.68
高雄縣,旗山鎮,中洲里,0,1,825,14,839,1103,3,1,3,0,1,0,76.07
高雄縣,旗山鎮,南洲里,0,1,1124,10,1134,1452,3,1,3,0,1,0,78.10
高雄縣,旗山鎮,新光里,0,1,762,3,765,988,3,1,3,0,1,0,77.43
高雄縣,旗山鎮,南勝里,0,1,1844,25,1869,2406,3,1,3,0,1,0,77.68
高雄縣,旗山鎮,東平里,0,1,1323,14,1337,1849,3,1,3,0,1,0,72.31
高雄縣,旗山鎮,東昌里,0,1,492,8,500,709,3,1,3,0,1,0,70.52
高雄縣,旗山鎮,糖廠里,0,1,283,3,286,387,3,1,3,0,1,0,73.90
高雄縣,旗山鎮,廣福里,0,1,457,3,460,612,3,1,3,0,1,0,75.16
高雄縣,旗山鎮,中寮里,0,1,139,0,139,201,3,1,3,0,1,0,69.15
高雄縣,美濃鎮,中圳里,0,1,1177,13,1190,1610,3,1,3,0,1,0,73.91
高雄縣,美濃鎮,東門里,0,1,1109,14,1123,1575,3,1,3,0,1,0,71.30
高雄縣,美濃鎮,泰安里,0,1,993,8,1001,1422,3,1,3,0,1,0,70.39
高雄縣,美濃鎮,合和里,0,1,1554,25,1579,2230,3,1,3,0,1,0,70.81
高雄縣,美濃鎮,瀰濃里,0,1,1514,18,1532,2216,3,1,3,0,1,0,69.13
高雄縣,美濃鎮,福安里,0,1,1755,20,1775,2547,3,1,3,0,1,0,69.69
高雄縣,美濃鎮,祿興里,0,1,1723,22,1745,2458,3,1,3,0,1,0,70.99
高雄縣,美濃鎮,中壇里,0,1,1488,13,1501,2097,3,1,3,0,1,0,71.58
高雄縣,美濃鎮,德興里,0,1,1088,9,1097,1532,3,1,3,0,1,0,71.61
高雄縣,美濃鎮,清水里,0,1,1188,17,1205,1744,3,1,3,0,1,0,69.09
高雄縣,美濃鎮,吉和里,0,1,1070,12,1082,1459,3,1,3,0,1,0,74.16
高雄縣,美濃鎮,吉洋里,0,1,1441,16,1457,2126,3,1,3,0,1,0,68.53
高雄縣,美濃鎮,吉東里,0,1,1185,16,1201,1638,3,1,3,0,1,0,73.32
高雄縣,美濃鎮,龍山里,0,1,1567,32,1599,2306,3,1,3,0,1,0,69.34
高雄縣,美濃鎮,獅山里,0,1,1673,59,1732,2384,3,1,3,0,1,0,72.65
高雄縣,美濃鎮,龍肚里,0,1,1142,17,1159,1694,3,1,3,0,1,0,68.42
高雄縣,美濃鎮,廣德里,0,1,1035,18,1053,1477,3,1,3,0,1,0,71.29
高雄縣,美濃鎮,興隆里,0,1,899,5,904,1232,3,1,3,0,1,0,73.38
高雄縣,美濃鎮,廣林里,0,1,1162,17,1179,1769,3,1,3,0,1,0,66.65
高雄縣,六龜鄉,六龜村,0,1,672,13,685,1146,3,1,3,0,1,0,59.77
高雄縣,六龜鄉,義寶村,0,1,845,8,853,1191,3,1,3,0,1,0,71.62
高雄縣,六龜鄉,文武村,0,1,1031,24,1055,1670,3,1,3,0,1,0,63.17
高雄縣,六龜鄉,中興村,0,1,889,20,909,1416,3,1,3,0,1,0,64.19
高雄縣,六龜鄉,興龍村,0,1,634,12,646,1000,3,1,3,0,1,0,64.60
高雄縣,六龜鄉,新威村,0,1,591,9,600,871,3,1,3,0,1,0,68.89
高雄縣,六龜鄉,新興村,0,1,549,4,553,809,3,1,3,0,1,0,68.36
高雄縣,六龜鄉,新寮村,0,1,499,7,506,651,3,1,3,0,1,0,77.73
高雄縣,六龜鄉,大津村,0,1,276,5,281,382,3,1,3,0,1,0,73.56
高雄縣,六龜鄉,新發村,0,1,853,8,861,1510,3,1,3,0,1,0,57.02
高雄縣,六龜鄉,荖濃村,0,1,977,32,1009,1570,3,1,3,0,1,0,64.27
高雄縣,六龜鄉,寶來村,0,1,676,15,691,1024,3,1,3,0,1,0,67.48
高雄縣,甲仙鄉,東安村,0,1,435,6,441,630,3,1,3,0,1,0,70.00
高雄縣,甲仙鄉,西安村,0,1,813,5,818,1057,3,1,3,0,1,0,77.39
高雄縣,甲仙鄉,和安村,0,1,559,6,565,764,3,1,3,0,1,0,73.95
高雄縣,甲仙鄉,大田村,0,1,1064,11,1075,1472,3,1,3,0,1,0,73.03
高雄縣,甲仙鄉,寶隆村,0,1,494,5,499,712,3,1,3,0,1,0,70.08
高雄縣,甲仙鄉,關山村,0,1,494,4,498,693,3,1,3,0,1,0,71.86
高雄縣,甲仙鄉,小林村,0,1,734,8,742,1163,3,1,3,0,1,0,63.80
高雄縣,杉林鄉,杉林村,0,1,583,5,588,878,3,1,3,0,1,0,66.97
高雄縣,杉林鄉,木梓村,0,1,483,4,487,812,3,1,3,0,1,0,59.98
高雄縣,杉林鄉,集來村,0,1,1089,26,1115,1902,3,1,3,0,1,0,58.62
高雄縣,杉林鄉,新庄村,0,1,1188,19,1207,1852,3,1,3,0,1,0,65.17
高雄縣,杉林鄉,上平村,0,1,1124,17,1141,1638,3,1,3,0,1,0,69.66
高雄縣,杉林鄉,月眉村,0,1,1205,22,1227,1836,3,1,3,0,1,0,66.83
高雄縣,杉林鄉,月美村,0,1,938,13,951,1411,3,1,3,0,1,0,67.40
高雄縣,內門鄉,金竹村,0,1,573,14,587,778,3,1,3,0,1,0,75.45
高雄縣,內門鄉,溝坪村,0,1,722,10,732,1055,3,1,3,0,1,0,69.38
高雄縣,內門鄉,永興村,0,1,344,4,348,510,3,1,3,0,1,0,68.24
高雄縣,內門鄉,永吉村,0,1,373,7,380,483,3,1,3,0,1,0,78.67
高雄縣,內門鄉,永富村,0,1,752,16,768,1001,3,1,3,0,1,0,76.72
高雄縣,內門鄉,觀亭村,0,1,1275,27,1302,1747,3,1,3,0,1,0,74.53
高雄縣,內門鄉,中埔村,0,1,477,5,482,623,3,1,3,0,1,0,77.37
高雄縣,內門鄉,瑞山村,0,1,291,3,294,386,3,1,3,0,1,0,76.17
高雄縣,內門鄉,內南村,0,1,281,3,284,364,3,1,3,0,1,0,78.02
高雄縣,內門鄉,內東村,0,1,665,6,671,844,3,1,3,0,1,0,79.50
高雄縣,內門鄉,光興村,0,1,507,7,514,656,3,1,3,0,1,0,78.35
高雄縣,內門鄉,東埔村,0,1,344,3,347,476,3,1,3,0,1,0,72.90
高雄縣,內門鄉,內豐村,0,1,885,3,888,1130,3,1,3,0,1,0,78.58
高雄縣,內門鄉,內門村,0,1,759,5,764,928,3,1,3,0,1,0,82.33
高雄縣,內門鄉,石坑村,0,1,379,9,388,508,3,1,3,0,1,0,76.38
高雄縣,內門鄉,三平村,0,1,502,7,509,675,3,1,3,0,1,0,75.41
高雄縣,內門鄉,木柵村,0,1,469,8,477,685,3,1,3,0,1,0,69.64
高雄縣,內門鄉,內興村,0,1,447,3,450,619,3,1,3,0,1,0,72.70
高雄縣,茂林鄉,茂林村,0,1,29,1,30,59,3,1,3,0,1,0,50.85
高雄縣,茂林鄉,萬山村,0,1,12,0,12,18,3,1,3,0,1,0,66.67
高雄縣,茂林鄉,多納村,0,1,7,0,7,17,3,1,3,0,1,0,41.18
高雄縣,桃源鄉,寶山村,0,1,12,2,14,29,3,1,3,0,1,0,48.28
高雄縣,桃源鄉,建山村,0,1,27,1,28,42,3,1,3,0,1,0,66.67
高雄縣,桃源鄉,高中村,0,1,46,0,46,72,3,1,3,0,1,0,63.89
高雄縣,桃源鄉,桃源村,0,1,87,0,87,130,3,1,3,0,1,0,66.92
高雄縣,桃源鄉,勤和村,0,1,7,0,7,17,3,1,3,0,1,0,41.18
高雄縣,桃源鄉,復興村,0,1,9,0,9,19,3,1,3,0,1,0,47.37
高雄縣,桃源鄉,梅蘭村,0,1,7,0,7,13,3,1,3,0,1,0,53.85
高雄縣,桃源鄉,梅山村,0,1,8,0,8,18,3,1,3,0,1,0,44.44
高雄縣,三民鄉,民族村,0,1,53,0,53,133,3,1,3,0,1,0,39.85
高雄縣,三民鄉,民權村,0,1,15,0,15,31,3,1,3,0,1,0,48.39
高雄縣,三民鄉,民生村,0,1,49,0,49,79,3,1,3,0,1,0,62.03
屏東縣,屏東市,端正里,0,1,922,4,926,1348,3,1,3,0,1,0,68.69
屏東縣,屏東市,光榮里,0,1,1092,7,1099,1561,3,1,3,0,1,0,70.40
屏東縣,屏東市,大同里,0,1,622,2,624,882,3,1,3,0,1,0,70.75
屏東縣,屏東市,泰安里,0,1,913,3,916,1412,3,1,3,0,1,0,64.87
屏東縣,屏東市,維新里,0,1,1974,14,1988,2985,3,1,3,0,1,0,66.60
屏東縣,屏東市,大埔里,0,1,988,10,998,1521,3,1,3,0,1,0,65.61
屏東縣,屏東市,崇智里,0,1,674,4,678,972,3,1,3,0,1,0,69.75
屏東縣,屏東市,楠樹里,0,1,629,4,633,968,3,1,3,0,1,0,65.39
屏東縣,屏東市,金泉里,0,1,883,4,887,1355,3,1,3,0,1,0,65.46
屏東縣,屏東市,平和里,0,1,688,2,690,1007,3,1,3,0,1,0,68.52
屏東縣,屏東市,安樂里,0,1,780,5,785,1128,3,1,3,0,1,0,69.59
屏東縣,屏東市,橋南里,0,1,915,7,922,1640,3,1,3,0,1,0,56.22
屏東縣,屏東市,橋北里,0,1,729,6,735,1128,3,1,3,0,1,0,65.16
屏東縣,屏東市,長春里,0,1,1299,12,1311,2044,3,1,3,0,1,0,64.14
屏東縣,屏東市,豐榮里,0,1,1562,6,1568,2315,3,1,3,0,1,0,67.73
屏東縣,屏東市,豐田里,0,1,2410,13,2423,3752,3,1,3,0,1,0,64.58
屏東縣,屏東市,大連里,0,1,4562,38,4600,7001,3,1,3,0,1,0,65.70
屏東縣,屏東市,豐源里,0,1,2155,20,2175,3377,3,1,3,0,1,0,64.41
屏東縣,屏東市,湖南里,0,1,613,7,620,881,3,1,3,0,1,0,70.37
屏東縣,屏東市,湖西里,0,1,862,5,867,1251,3,1,3,0,1,0,69.30
屏東縣,屏東市,歸心里,0,1,713,8,721,1034,3,1,3,0,1,0,69.73
屏東縣,屏東市,瑞光里,0,1,3563,45,3608,5513,3,1,3,0,1,0,65.45
屏東縣,屏東市,一心里,0,1,940,12,952,1380,3,1,3,0,1,0,68.99
屏東縣,屏東市,擇仁里,0,1,902,7,909,1488,3,1,3,0,1,0,61.09
屏東縣,屏東市,光華里,0,1,485,5,490,774,3,1,3,0,1,0,63.31
屏東縣,屏東市,萬年里,0,1,534,5,539,838,3,1,3,0,1,0,64.32
屏東縣,屏東市,厚生里,0,1,1778,17,1795,2944,3,1,3,0,1,0,60.97
屏東縣,屏東市,永安里,0,1,3462,26,3488,5790,3,1,3,0,1,0,60.24
屏東縣,屏東市,新生里,0,1,2406,29,2435,3652,3,1,3,0,1,0,66.68
屏東縣,屏東市,頂宅里,0,1,363,5,368,544,3,1,3,0,1,0,67.65
屏東縣,屏東市,頂柳里,0,1,653,6,659,907,3,1,3,0,1,0,72.66
屏東縣,屏東市,龍華里,0,1,1578,13,1591,2230,3,1,3,0,1,0,71.35
屏東縣,屏東市,大湖里,0,1,899,9,908,1278,3,1,3,0,1,0,71.05
屏東縣,屏東市,新興里,0,1,1372,7,1379,1956,3,1,3,0,1,0,70.50
屏東縣,屏東市,公館里,0,1,1024,9,1033,1435,3,1,3,0,1,0,71.99
屏東縣,屏東市,玉成里,0,1,815,7,822,1161,3,1,3,0,1,0,70.80
屏東縣,屏東市,永光里,0,1,763,14,777,1129,3,1,3,0,1,0,68.82
屏東縣,屏東市,安鎮里,0,1,1249,10,1259,1879,3,1,3,0,1,0,67.00
屏東縣,屏東市,永昌里,0,1,856,11,867,1293,3,1,3,0,1,0,67.05
屏東縣,屏東市,長安里,0,1,1269,22,1291,1959,3,1,3,0,1,0,65.90
屏東縣,屏東市,崇武里,0,1,826,7,833,1169,3,1,3,0,1,0,71.26
屏東縣,屏東市,大武里,0,1,3547,44,3591,5487,3,1,3,0,1,0,65.45
屏東縣,屏東市,清溪里,0,1,2213,21,2234,3453,3,1,3,0,1,0,64.70
屏東縣,屏東市,前進里,0,1,747,4,751,1092,3,1,3,0,1,0,68.77
屏東縣,屏東市,大洲里,0,1,644,5,649,891,3,1,3,0,1,0,72.84
屏東縣,屏東市,凌雲里,0,1,1074,6,1080,1528,3,1,3,0,1,0,70.68
屏東縣,屏東市,鵬程里,0,1,1058,13,1071,1446,3,1,3,0,1,0,74.07
屏東縣,屏東市,興樂里,0,1,734,7,741,1108,3,1,3,0,1,0,66.88
屏東縣,屏東市,斯文里,0,1,1260,14,1274,1863,3,1,3,0,1,0,68.38
屏東縣,屏東市,太平里,0,1,662,8,670,995,3,1,3,0,1,0,67.34
屏東縣,屏東市,華山里,0,1,2604,21,2625,3881,3,1,3,0,1,0,67.64
屏東縣,屏東市,溝美里,0,1,1642,5,1647,2543,3,1,3,0,1,0,64.77
屏東縣,屏東市,中正里,0,1,1680,16,1696,2657,3,1,3,0,1,0,63.83
屏東縣,屏東市,仁愛里,0,1,1174,8,1182,1987,3,1,3,0,1,0,59.49
屏東縣,屏東市,北興里,0,1,2927,28,2955,4594,3,1,3,0,1,0,64.32
屏東縣,屏東市,北勢里,0,1,1476,12,1488,2153,3,1,3,0,1,0,69.11
屏東縣,屏東市,勝利里,0,1,2389,25,2414,3783,3,1,3,0,1,0,63.81
屏東縣,屏東市,永城里,0,1,1536,15,1551,2434,3,1,3,0,1,0,63.72
屏東縣,屏東市,崇蘭里,0,1,3271,20,3291,5008,3,1,3,0,1,0,65.71
屏東縣,屏東市,廣興里,0,1,1245,18,1263,1700,3,1,3,0,1,0,74.29
屏東縣,屏東市,空翔里,0,1,1025,9,1034,1538,3,1,3,0,1,0,67.23
屏東縣,屏東市,大鵬里,0,1,543,8,551,786,3,1,3,0,1,0,70.10
屏東縣,屏東市,潭墘里,0,1,3575,23,3598,5667,3,1,3,0,1,0,63.49
屏東縣,屏東市,三山里,0,1,822,16,838,1188,3,1,3,0,1,0,70.54
屏東縣,屏東市,海豐里,0,1,565,1,566,817,3,1,3,0,1,0,69.28
屏東縣,屏東市,仁義里,0,1,695,7,702,947,3,1,3,0,1,0,74.13
屏東縣,屏東市,信和里,0,1,936,6,942,1360,3,1,3,0,1,0,69.26
屏東縣,屏東市,和興里,0,1,640,5,645,943,3,1,3,0,1,0,68.40
屏東縣,潮州鎮,潮州里,0,1,447,0,447,696,3,1,3,0,1,0,64.22
屏東縣,潮州鎮,光華里,0,1,2026,15,2041,3315,3,1,3,0,1,0,61.57
屏東縣,潮州鎮,同榮里,0,1,550,2,552,806,3,1,3,0,1,0,68.49
屏東縣,潮州鎮,新生里,0,1,841,5,846,1320,3,1,3,0,1,0,64.09
屏東縣,潮州鎮,新榮里,0,1,922,5,927,1459,3,1,3,0,1,0,63.54
屏東縣,潮州鎮,彭城里,0,1,559,0,559,781,3,1,3,0,1,0,71.57
屏東縣,潮州鎮,三星里,0,1,2211,13,2224,3562,3,1,3,0,1,0,62.44
屏東縣,潮州鎮,三共里,0,1,2933,22,2955,4794,3,1,3,0,1,0,61.64
屏東縣,潮州鎮,三和里,0,1,1011,7,1018,1606,3,1,3,0,1,0,63.39
屏東縣,潮州鎮,五魁里,0,1,617,6,623,932,3,1,3,0,1,0,66.85
屏東縣,潮州鎮,蓬萊里,0,1,1156,15,1171,1747,3,1,3,0,1,0,67.03
屏東縣,潮州鎮,八爺里,0,1,1209,9,1218,1830,3,1,3,0,1,0,66.56
屏東縣,潮州鎮,永春里,0,1,2517,14,2531,4127,3,1,3,0,1,0,61.33
屏東縣,潮州鎮,富春里,0,1,905,8,913,1414,3,1,3,0,1,0,64.57
屏東縣,潮州鎮,光春里,0,1,819,12,831,1254,3,1,3,0,1,0,66.27
屏東縣,潮州鎮,興美里,0,1,470,5,475,746,3,1,3,0,1,0,63.67
屏東縣,潮州鎮,檨子里,0,1,385,2,387,612,3,1,3,0,1,0,63.24
屏東縣,潮州鎮,九塊里,0,1,956,15,971,1557,3,1,3,0,1,0,62.36
屏東縣,潮州鎮,泗林里,0,1,925,10,935,1420,3,1,3,0,1,0,65.85
屏東縣,潮州鎮,四春里,0,1,1227,17,1244,1859,3,1,3,0,1,0,66.92
屏東縣,潮州鎮,崙東里,0,1,961,15,976,1545,3,1,3,0,1,0,63.17
屏東縣,東港鎮,新勝里,0,1,1737,13,1750,2375,3,1,3,0,1,0,73.68
屏東縣,東港鎮,頂新里,0,1,393,4,397,559,3,1,3,0,1,0,71.02
屏東縣,東港鎮,頂中里,0,1,367,3,370,488,3,1,3,0,1,0,75.82
屏東縣,東港鎮,東和里,0,1,491,2,493,776,3,1,3,0,1,0,63.53
屏東縣,東港鎮,興台里,0,1,460,5,465,651,3,1,3,0,1,0,71.43
屏東縣,東港鎮,興東里,0,1,2787,35,2822,4263,3,1,3,0,1,0,66.20
屏東縣,東港鎮,興農里,0,1,508,8,516,700,3,1,3,0,1,0,73.71
屏東縣,東港鎮,中興里,0,1,447,3,450,615,3,1,3,0,1,0,73.17
屏東縣,東港鎮,朝安里,0,1,1253,10,1263,1928,3,1,3,0,1,0,65.51
屏東縣,東港鎮,八德里,0,1,587,10,597,925,3,1,3,0,1,0,64.54
屏東縣,東港鎮,東隆里,0,1,982,8,990,1384,3,1,3,0,1,0,71.53
屏東縣,東港鎮,豐漁里,0,1,507,2,509,735,3,1,3,0,1,0,69.25
屏東縣,東港鎮,盛漁里,0,1,728,10,738,1184,3,1,3,0,1,0,62.33
屏東縣,東港鎮,興漁里,0,1,1187,15,1202,1824,3,1,3,0,1,0,65.90
屏東縣,東港鎮,鎮海里,0,1,1478,19,1497,2287,3,1,3,0,1,0,65.46
屏東縣,東港鎮,嘉蓮里,0,1,814,7,821,1266,3,1,3,0,1,0,64.85
屏東縣,東港鎮,南平里,0,1,956,9,965,1452,3,1,3,0,1,0,66.46
屏東縣,東港鎮,船頭里,0,1,1765,16,1781,2631,3,1,3,0,1,0,67.69
屏東縣,東港鎮,下廍里,0,1,1151,6,1157,1718,3,1,3,0,1,0,67.35
屏東縣,東港鎮,大潭里,0,1,1055,7,1062,1542,3,1,3,0,1,0,68.87
屏東縣,東港鎮,興和里,0,1,574,12,586,817,3,1,3,0,1,0,71.73
屏東縣,東港鎮,共和里,0,1,529,8,537,771,3,1,3,0,1,0,69.65
屏東縣,東港鎮,大鵬里,0,1,256,2,258,382,3,1,3,0,1,0,67.54
屏東縣,恆春鎮,城南里,0,1,652,8,660,1033,3,1,3,0,1,0,63.89
屏東縣,恆春鎮,城北里,0,1,1050,17,1067,1845,3,1,3,0,1,0,57.83
屏東縣,恆春鎮,城西里,0,1,710,7,717,1127,3,1,3,0,1,0,63.62
屏東縣,恆春鎮,山腳里,0,1,1742,27,1769,3167,3,1,3,0,1,0,55.86
屏東縣,恆春鎮,網紗里,0,1,1284,13,1297,2419,3,1,3,0,1,0,53.62
屏東縣,恆春鎮,仁壽里,0,1,433,9,442,786,3,1,3,0,1,0,56.23
屏東縣,恆春鎮,茄湖里,0,1,280,10,290,516,3,1,3,0,1,0,56.20
屏東縣,恆春鎮,頭溝里,0,1,237,3,240,504,3,1,3,0,1,0,47.62
屏東縣,恆春鎮,四溝里,0,1,502,5,507,916,3,1,3,0,1,0,55.35
屏東縣,恆春鎮,德和里,0,1,315,8,323,534,3,1,3,0,1,0,60.49
屏東縣,恆春鎮,龍水里,0,1,514,9,523,922,3,1,3,0,1,0,56.72
屏東縣,恆春鎮,山海里,0,1,854,8,862,1475,3,1,3,0,1,0,58.44
屏東縣,恆春鎮,大光里,0,1,991,10,1001,1728,3,1,3,0,1,0,57.93
屏東縣,恆春鎮,水泉里,0,1,709,10,719,1474,3,1,3,0,1,0,48.78
屏東縣,恆春鎮,南灣里,0,1,727,10,737,1347,3,1,3,0,1,0,54.71
屏東縣,恆春鎮,墾丁里,0,1,706,4,710,1134,3,1,3,0,1,0,62.61
屏東縣,恆春鎮,鵝鑾里,0,1,600,6,606,1044,3,1,3,0,1,0,58.05
屏東縣,萬丹鄉,社上村,0,1,776,14,790,1138,3,1,3,0,1,0,69.42
屏東縣,萬丹鄉,社中村,0,1,857,6,863,1238,3,1,3,0,1,0,69.71
屏東縣,萬丹鄉,社皮村,0,1,1085,13,1098,1625,3,1,3,0,1,0,67.57
屏東縣,萬丹鄉,磚寮村,0,1,611,12,623,786,3,1,3,0,1,0,79.26
屏東縣,萬丹鄉,社口村,0,1,748,8,756,1029,3,1,3,0,1,0,73.47
屏東縣,萬丹鄉,加興村,0,1,774,7,781,1004,3,1,3,0,1,0,77.79
屏東縣,萬丹鄉,上村村,0,1,449,5,454,582,3,1,3,0,1,0,78.01
屏東縣,萬丹鄉,廈北村,0,1,1003,9,1012,1506,3,1,3,0,1,0,67.20
屏東縣,萬丹鄉,廈南村,0,1,885,7,892,1271,3,1,3,0,1,0,70.18
屏東縣,萬丹鄉,崙頂村,0,1,888,10,898,1217,3,1,3,0,1,0,73.79
屏東縣,萬丹鄉,田厝村,0,1,573,4,577,708,3,1,3,0,1,0,81.50
屏東縣,萬丹鄉,後村村,0,1,805,5,810,956,3,1,3,0,1,0,84.73
屏東縣,萬丹鄉,灣內村,0,1,853,5,858,1106,3,1,3,0,1,0,77.58
屏東縣,萬丹鄉,香社村,0,1,960,10,970,1360,3,1,3,0,1,0,71.32
屏東縣,萬丹鄉,新庄村,0,1,1269,14,1283,1711,3,1,3,0,1,0,74.99
屏東縣,萬丹鄉,新鐘村,0,1,1292,13,1305,1694,3,1,3,0,1,0,77.04
屏東縣,萬丹鄉,水仙村,0,1,369,3,372,481,3,1,3,0,1,0,77.34
屏東縣,萬丹鄉,興安村,0,1,595,5,600,756,3,1,3,0,1,0,79.37
屏東縣,萬丹鄉,興全村,0,1,807,4,811,1063,3,1,3,0,1,0,76.29
屏東縣,萬丹鄉,甘棠村,0,1,245,1,246,351,3,1,3,0,1,0,70.09
屏東縣,萬丹鄉,水泉村,0,1,907,8,915,1270,3,1,3,0,1,0,72.05
屏東縣,萬丹鄉,竹林村,0,1,948,11,959,1368,3,1,3,0,1,0,70.10
屏東縣,萬丹鄉,廣安村,0,1,1165,9,1174,1612,3,1,3,0,1,0,72.83
屏東縣,萬丹鄉,四維村,0,1,1096,3,1099,1496,3,1,3,0,1,0,73.46
屏東縣,萬丹鄉,寶厝村,0,1,1297,16,1313,1807,3,1,3,0,1,0,72.66
屏東縣,萬丹鄉,萬生村,0,1,880,8,888,1194,3,1,3,0,1,0,74.37
屏東縣,萬丹鄉,萬惠村,0,1,567,3,570,697,3,1,3,0,1,0,81.78
屏東縣,萬丹鄉,萬安村,0,1,338,1,339,468,3,1,3,0,1,0,72.44
屏東縣,萬丹鄉,萬後村,0,1,315,2,317,413,3,1,3,0,1,0,76.76
屏東縣,萬丹鄉,萬全村,0,1,2196,19,2215,3057,3,1,3,0,1,0,72.46
屏東縣,長治鄉,進興村,0,1,1216,15,1231,1822,3,1,3,0,1,0,67.56
屏東縣,長治鄉,新潭村,0,1,1422,13,1435,2173,3,1,3,0,1,0,66.04
屏東縣,長治鄉,潭頭村,0,1,995,4,999,1399,3,1,3,0,1,0,71.41
屏東縣,長治鄉,香楊村,0,1,885,8,893,1300,3,1,3,0,1,0,68.69
屏東縣,長治鄉,長興村,0,1,602,6,608,903,3,1,3,0,1,0,67.33
屏東縣,長治鄉,崙上村,0,1,983,5,988,1345,3,1,3,0,1,0,73.46
屏東縣,長治鄉,德榮村,0,1,696,3,699,971,3,1,3,0,1,0,71.99
屏東縣,長治鄉,德和村,0,1,551,8,559,743,3,1,3,0,1,0,75.24
屏東縣,長治鄉,復興村,0,1,930,14,944,1323,3,1,3,0,1,0,71.35
屏東縣,長治鄉,德成村,0,1,589,3,592,818,3,1,3,0,1,0,72.37
屏東縣,長治鄉,德協村,0,1,698,8,706,1015,3,1,3,0,1,0,69.56
屏東縣,長治鄉,繁榮村,0,1,836,7,843,1204,3,1,3,0,1,0,70.02
屏東縣,長治鄉,繁昌村,0,1,1103,11,1114,1535,3,1,3,0,1,0,72.57
屏東縣,長治鄉,繁隆村,0,1,672,6,678,942,3,1,3,0,1,0,71.97
屏東縣,長治鄉,繁華村,0,1,1426,20,1446,2016,3,1,3,0,1,0,71.73
屏東縣,長治鄉,榮華村,0,1,361,5,366,498,3,1,3,0,1,0,73.49
屏東縣,麟洛鄉,新田村,0,1,1142,7,1149,1585,3,1,3,0,1,0,72.49
屏東縣,麟洛鄉,麟頂村,0,1,549,3,552,730,3,1,3,0,1,0,75.62
屏東縣,麟洛鄉,麟蹄村,0,1,1030,9,1039,1417,3,1,3,0,1,0,73.32
屏東縣,麟洛鄉,麟趾村,0,1,1453,21,1474,2025,3,1,3,0,1,0,72.79
屏東縣,麟洛鄉,田中村,0,1,745,4,749,975,3,1,3,0,1,0,76.82
屏東縣,麟洛鄉,田心村,0,1,521,5,526,689,3,1,3,0,1,0,76.34
屏東縣,麟洛鄉,田道村,0,1,515,5,520,684,3,1,3,0,1,0,76.02
屏東縣,九如鄉,九清村,0,1,1050,8,1058,1472,3,1,3,0,1,0,71.88
屏東縣,九如鄉,九塊村,0,1,863,7,870,1174,3,1,3,0,1,0,74.11
屏東縣,九如鄉,九明村,0,1,932,16,948,1304,3,1,3,0,1,0,72.70
屏東縣,九如鄉,玉水村,0,1,857,10,867,1161,3,1,3,0,1,0,74.68
屏東縣,九如鄉,玉泉村,0,1,924,16,940,1320,3,1,3,0,1,0,71.21
屏東縣,九如鄉,東寧村,0,1,2052,27,2079,2904,3,1,3,0,1,0,71.59
屏東縣,九如鄉,大坵村,0,1,667,4,671,893,3,1,3,0,1,0,75.14
屏東縣,九如鄉,三塊村,0,1,780,12,792,1121,3,1,3,0,1,0,70.65
屏東縣,九如鄉,後庄村,0,1,1114,7,1121,1504,3,1,3,0,1,0,74.53
屏東縣,九如鄉,耆老村,0,1,801,10,811,1060,3,1,3,0,1,0,76.51
屏東縣,九如鄉,洽興村,0,1,854,6,860,1197,3,1,3,0,1,0,71.85
屏東縣,里港鄉,玉田村,0,1,1150,14,1164,1677,3,1,3,0,1,0,69.41
屏東縣,里港鄉,大平村,0,1,834,3,837,1120,3,1,3,0,1,0,74.73
屏東縣,里港鄉,永春村,0,1,580,4,584,806,3,1,3,0,1,0,72.46
屏東縣,里港鄉,春林村,0,1,763,3,766,1115,3,1,3,0,1,0,68.70
屏東縣,里港鄉,過江村,0,1,994,7,1001,1494,3,1,3,0,1,0,67.00
屏東縣,里港鄉,鐵店村,0,1,746,8,754,1058,3,1,3,0,1,0,71.27
屏東縣,里港鄉,塔樓村,0,1,877,7,884,1259,3,1,3,0,1,0,70.21
屏東縣,里港鄉,潮厝村,0,1,843,12,855,1233,3,1,3,0,1,0,69.34
屏東縣,里港鄉,茄苳村,0,1,1136,10,1146,1563,3,1,3,0,1,0,73.32
屏東縣,里港鄉,載興村,0,1,1576,13,1589,2201,3,1,3,0,1,0,72.19
屏東縣,里港鄉,土庫村,0,1,1485,24,1509,2084,3,1,3,0,1,0,72.41
屏東縣,里港鄉,三廍村,0,1,1166,11,1177,1718,3,1,3,0,1,0,68.51
屏東縣,里港鄉,中和村,0,1,523,5,528,763,3,1,3,0,1,0,69.20
屏東縣,里港鄉,瀰力村,0,1,368,5,373,499,3,1,3,0,1,0,74.75
屏東縣,鹽埔鄉,鹽北村,0,1,1163,10,1173,1536,3,1,3,0,1,0,76.37
屏東縣,鹽埔鄉,鹽中村,0,1,1605,22,1627,2154,3,1,3,0,1,0,75.53
屏東縣,鹽埔鄉,鹽南村,0,1,1086,8,1094,1445,3,1,3,0,1,0,75.71
屏東縣,鹽埔鄉,仕絨村,0,1,747,5,752,865,3,1,3,0,1,0,86.94
屏東縣,鹽埔鄉,高朗村,0,1,1860,20,1880,2464,3,1,3,0,1,0,76.30
屏東縣,鹽埔鄉,振興村,0,1,1311,34,1345,1864,3,1,3,0,1,0,72.16
屏東縣,鹽埔鄉,久愛村,0,1,632,7,639,810,3,1,3,0,1,0,78.89
屏東縣,鹽埔鄉,新圍村,0,1,1972,31,2003,2619,3,1,3,0,1,0,76.48
屏東縣,鹽埔鄉,新二村,0,1,1996,28,2024,2778,3,1,3,0,1,0,72.86
屏東縣,鹽埔鄉,彭厝村,0,1,706,2,708,897,3,1,3,0,1,0,78.93
屏東縣,鹽埔鄉,洛陽村,0,1,1025,17,1042,1321,3,1,3,0,1,0,78.88
屏東縣,鹽埔鄉,永隆村,0,1,436,11,447,591,3,1,3,0,1,0,75.63
屏東縣,高樹鄉,高樹村,0,1,1391,7,1398,2160,3,1,3,0,1,0,64.72
屏東縣,高樹鄉,長榮村,0,1,862,3,865,1336,3,1,3,0,1,0,64.75
屏東縣,高樹鄉,東興村,0,1,560,2,562,864,3,1,3,0,1,0,65.05
屏東縣,高樹鄉,東振村,0,1,414,4,418,686,3,1,3,0,1,0,60.93
屏東縣,高樹鄉,源泉村,0,1,641,4,645,950,3,1,3,0,1,0,67.89
屏東縣,高樹鄉,建興村,0,1,730,4,734,1224,3,1,3,0,1,0,59.97
屏東縣,高樹鄉,大埔村,0,1,463,8,471,749,3,1,3,0,1,0,62.88
屏東縣,高樹鄉,菜寮村,0,1,560,6,566,904,3,1,3,0,1,0,62.61
屏東縣,高樹鄉,司馬村,0,1,494,6,500,747,3,1,3,0,1,0,66.93
屏東縣,高樹鄉,舊寮村,0,1,898,6,904,1366,3,1,3,0,1,0,66.18
屏東縣,高樹鄉,新豐村,0,1,905,15,920,1550,3,1,3,0,1,0,59.35
屏東縣,高樹鄉,泰山村,0,1,1203,16,1219,1997,3,1,3,0,1,0,61.04
屏東縣,高樹鄉,南華村,0,1,815,8,823,1228,3,1,3,0,1,0,67.02
屏東縣,高樹鄉,廣福村,0,1,612,3,615,995,3,1,3,0,1,0,61.81
屏東縣,高樹鄉,廣興村,0,1,709,11,720,1032,3,1,3,0,1,0,69.77
屏東縣,高樹鄉,舊庄村,0,1,696,9,705,1027,3,1,3,0,1,0,68.65
屏東縣,高樹鄉,田子村,0,1,827,7,834,1144,3,1,3,0,1,0,72.90
屏東縣,高樹鄉,鹽樹村,0,1,899,14,913,1397,3,1,3,0,1,0,65.35
屏東縣,高樹鄉,新南村,0,1,947,6,953,1402,3,1,3,0,1,0,67.97
屏東縣,萬巒鄉,萬巒村,0,1,864,3,867,1226,3,1,3,0,1,0,70.72
屏東縣,萬巒鄉,萬全村,0,1,572,4,576,817,3,1,3,0,1,0,70.50
屏東縣,萬巒鄉,萬和村,0,1,878,10,888,1365,3,1,3,0,1,0,65.05
屏東縣,萬巒鄉,鹿寮村,0,1,682,8,690,929,3,1,3,0,1,0,74.27
屏東縣,萬巒鄉,硫黃村,0,1,395,1,396,532,3,1,3,0,1,0,74.44
屏東縣,萬巒鄉,泗溝村,0,1,903,10,913,1305,3,1,3,0,1,0,69.96
屏東縣,萬巒鄉,五溝村,0,1,903,6,909,1162,3,1,3,0,1,0,78.23
屏東縣,萬巒鄉,成德村,0,1,901,12,913,1371,3,1,3,0,1,0,66.59
屏東縣,萬巒鄉,赤山村,0,1,934,20,954,1645,3,1,3,0,1,0,57.99
屏東縣,萬巒鄉,萬金村,0,1,1210,20,1230,1873,3,1,3,0,1,0,65.67
屏東縣,萬巒鄉,佳佐村,0,1,988,12,1000,1510,3,1,3,0,1,0,66.23
屏東縣,萬巒鄉,佳和村,0,1,1036,6,1042,1461,3,1,3,0,1,0,71.32
屏東縣,萬巒鄉,新厝村,0,1,668,8,676,1052,3,1,3,0,1,0,64.26
屏東縣,萬巒鄉,新置村,0,1,673,4,677,1219,3,1,3,0,1,0,55.54
屏東縣,內埔鄉,內埔村,0,1,1897,17,1914,2931,3,1,3,0,1,0,65.30
屏東縣,內埔鄉,內田村,0,1,1599,15,1614,2629,3,1,3,0,1,0,61.39
屏東縣,內埔鄉,興南村,0,1,981,5,986,1343,3,1,3,0,1,0,73.42
屏東縣,內埔鄉,義亭村,0,1,380,5,385,568,3,1,3,0,1,0,67.78
屏東縣,內埔鄉,美和村,0,1,1286,12,1298,1873,3,1,3,0,1,0,69.30
屏東縣,內埔鄉,和興村,0,1,1101,10,1111,1613,3,1,3,0,1,0,68.88
屏東縣,內埔鄉,東寧村,0,1,2371,14,2385,3631,3,1,3,0,1,0,65.68
屏東縣,內埔鄉,豐田村,0,1,1338,18,1356,2208,3,1,3,0,1,0,61.41
屏東縣,內埔鄉,振豐村,0,1,1142,12,1154,1673,3,1,3,0,1,0,68.98
屏東縣,內埔鄉,富田村,0,1,1281,8,1289,1913,3,1,3,0,1,0,67.38
屏東縣,內埔鄉,竹圍村,0,1,800,11,811,1344,3,1,3,0,1,0,60.34
屏東縣,內埔鄉,東勢村,0,1,2005,22,2027,2910,3,1,3,0,1,0,69.66
屏東縣,內埔鄉,東片村,0,1,631,4,635,883,3,1,3,0,1,0,71.91
屏東縣,內埔鄉,上樹村,0,1,672,8,680,970,3,1,3,0,1,0,70.10
屏東縣,內埔鄉,老埤村,0,1,1273,11,1284,2275,3,1,3,0,1,0,56.44
屏東縣,內埔鄉,中林村,0,1,839,11,850,1331,3,1,3,0,1,0,63.86
屏東縣,內埔鄉,龍泉村,0,1,1632,24,1656,2492,3,1,3,0,1,0,66.45
屏東縣,內埔鄉,龍潭村,0,1,1696,22,1718,2565,3,1,3,0,1,0,66.98
屏東縣,內埔鄉,建興村,0,1,1647,27,1674,2328,3,1,3,0,1,0,71.91
屏東縣,內埔鄉,大新村,0,1,1137,16,1153,1689,3,1,3,0,1,0,68.27
屏東縣,內埔鄉,黎明村,0,1,1452,19,1471,2106,3,1,3,0,1,0,69.85
屏東縣,內埔鄉,隘寮村,0,1,713,9,722,1191,3,1,3,0,1,0,60.62
屏東縣,內埔鄉,水門村,0,1,484,4,488,784,3,1,3,0,1,0,62.24
屏東縣,竹田鄉,竹田村,0,1,942,10,952,1402,3,1,3,0,1,0,67.90
屏東縣,竹田鄉,竹南村,0,1,578,8,586,856,3,1,3,0,1,0,68.46
屏東縣,竹田鄉,糶糴村,0,1,488,1,489,656,3,1,3,0,1,0,74.54
屏東縣,竹田鄉,履豐村,0,1,431,6,437,580,3,1,3,0,1,0,75.34
屏東縣,竹田鄉,頭崙村,0,1,901,10,911,1294,3,1,3,0,1,0,70.40
屏東縣,竹田鄉,二崙村,0,1,652,1,653,965,3,1,3,0,1,0,67.67
屏東縣,竹田鄉,美崙村,0,1,422,4,426,626,3,1,3,0,1,0,68.05
屏東縣,竹田鄉,南勢村,0,1,339,2,341,461,3,1,3,0,1,0,73.97
屏東縣,竹田鄉,西勢村,0,1,1830,16,1846,2580,3,1,3,0,1,0,71.55
屏東縣,竹田鄉,福田村,0,1,324,1,325,426,3,1,3,0,1,0,76.29
屏東縣,竹田鄉,永豐村,0,1,377,3,380,526,3,1,3,0,1,0,72.24
屏東縣,竹田鄉,六巷村,0,1,455,8,463,641,3,1,3,0,1,0,72.23
屏東縣,竹田鄉,泗洲村,0,1,734,11,745,1145,3,1,3,0,1,0,65.07
屏東縣,竹田鄉,大湖村,0,1,723,6,729,1066,3,1,3,0,1,0,68.39
屏東縣,竹田鄉,鳳明村,0,1,691,9,700,933,3,1,3,0,1,0,75.03
屏東縣,新埤鄉,新埤村,0,1,1252,9,1261,1916,3,1,3,0,1,0,65.81
屏東縣,新埤鄉,建功村,0,1,829,3,832,1253,3,1,3,0,1,0,66.40
屏東縣,新埤鄉,打鐵村,0,1,710,5,715,1086,3,1,3,0,1,0,65.84
屏東縣,新埤鄉,南豐村,0,1,516,5,521,793,3,1,3,0,1,0,65.70
屏東縣,新埤鄉,萬隆村,0,1,1064,15,1079,1676,3,1,3,0,1,0,64.38
屏東縣,新埤鄉,餉潭村,0,1,773,8,781,1306,3,1,3,0,1,0,59.80
屏東縣,新埤鄉,箕湖村,0,1,668,13,681,1053,3,1,3,0,1,0,64.67
屏東縣,枋寮鄉,枋寮村,0,1,916,6,922,1415,3,1,3,0,1,0,65.16
屏東縣,枋寮鄉,新龍村,0,1,550,5,555,816,3,1,3,0,1,0,68.01
屏東縣,枋寮鄉,保生村,0,1,685,6,691,1011,3,1,3,0,1,0,68.35
屏東縣,枋寮鄉,中寮村,0,1,473,3,476,752,3,1,3,0,1,0,63.30
屏東縣,枋寮鄉,安樂村,0,1,1166,16,1182,1832,3,1,3,0,1,0,64.52
屏東縣,枋寮鄉,隆山村,0,1,1989,14,2003,3294,3,1,3,0,1,0,60.81
屏東縣,枋寮鄉,天時村,0,1,1301,8,1309,1908,3,1,3,0,1,0,68.61
屏東縣,枋寮鄉,地利村,0,1,1101,9,1110,1712,3,1,3,0,1,0,64.84
屏東縣,枋寮鄉,人和村,0,1,1403,10,1413,2210,3,1,3,0,1,0,63.94
屏東縣,枋寮鄉,內寮村,0,1,428,1,429,804,3,1,3,0,1,0,53.36
屏東縣,枋寮鄉,新開村,0,1,543,3,546,1044,3,1,3,0,1,0,52.30
屏東縣,枋寮鄉,東海村,0,1,1681,20,1701,2590,3,1,3,0,1,0,65.68
屏東縣,枋寮鄉,大庄村,0,1,389,0,389,555,3,1,3,0,1,0,70.09
屏東縣,枋寮鄉,太源村,0,1,533,8,541,925,3,1,3,0,1,0,58.49
屏東縣,枋寮鄉,玉泉村,0,1,255,4,259,436,3,1,3,0,1,0,59.40
屏東縣,新園鄉,瓦窯村,0,1,1071,5,1076,1505,3,1,3,0,1,0,71.50
屏東縣,新園鄉,仙吉村,0,1,1471,12,1483,2141,3,1,3,0,1,0,69.27
屏東縣,新園鄉,田洋村,0,1,1293,12,1305,1858,3,1,3,0,1,0,70.24
屏東縣,新園鄉,港墘村,0,1,467,6,473,648,3,1,3,0,1,0,72.99
屏東縣,新園鄉,內庄村,0,1,588,3,591,752,3,1,3,0,1,0,78.59
屏東縣,新園鄉,新東村,0,1,1539,16,1555,2142,3,1,3,0,1,0,72.60
屏東縣,新園鄉,新園村,0,1,1380,11,1391,1909,3,1,3,0,1,0,72.87
屏東縣,新園鄉,港西村,0,1,1625,15,1640,2104,3,1,3,0,1,0,77.95
屏東縣,新園鄉,五房村,0,1,1826,17,1843,2723,3,1,3,0,1,0,67.68
屏東縣,新園鄉,烏龍村,0,1,882,9,891,1211,3,1,3,0,1,0,73.58
屏東縣,新園鄉,興龍村,0,1,1348,10,1358,1967,3,1,3,0,1,0,69.04
屏東縣,新園鄉,中洲村,0,1,1054,8,1062,1602,3,1,3,0,1,0,66.29
屏東縣,新園鄉,南龍村,0,1,916,9,925,1308,3,1,3,0,1,0,70.72
屏東縣,新園鄉,鹽埔村,0,1,2132,17,2149,3526,3,1,3,0,1,0,60.95
屏東縣,新園鄉,共和村,0,1,1294,12,1306,2120,3,1,3,0,1,0,61.60
屏東縣,崁頂鄉,崁頂村,0,1,1213,12,1225,1722,3,1,3,0,1,0,71.14
屏東縣,崁頂鄉,園寮村,0,1,909,9,918,1385,3,1,3,0,1,0,66.28
屏東縣,崁頂鄉,力社村,0,1,675,7,682,969,3,1,3,0,1,0,70.38
屏東縣,崁頂鄉,圍內村,0,1,783,5,788,1011,3,1,3,0,1,0,77.94
屏東縣,崁頂鄉,洲子村,0,1,591,7,598,798,3,1,3,0,1,0,74.94
屏東縣,崁頂鄉,北勢村,0,1,983,12,995,1407,3,1,3,0,1,0,70.72
屏東縣,崁頂鄉,越溪村,0,1,467,9,476,655,3,1,3,0,1,0,72.67
屏東縣,崁頂鄉,港東村,0,1,1104,11,1115,1624,3,1,3,0,1,0,68.66
屏東縣,林邊鄉,林邊村,0,1,996,10,1006,1380,3,1,3,0,1,0,72.90
屏東縣,林邊鄉,光林村,0,1,1120,7,1127,1617,3,1,3,0,1,0,69.70
屏東縣,林邊鄉,中林村,0,1,665,6,671,897,3,1,3,0,1,0,74.80
屏東縣,林邊鄉,仁和村,0,1,1063,7,1070,1473,3,1,3,0,1,0,72.64
屏東縣,林邊鄉,永樂村,0,1,2128,21,2149,2961,3,1,3,0,1,0,72.58
屏東縣,林邊鄉,田厝村,0,1,628,4,632,889,3,1,3,0,1,0,71.09
屏東縣,林邊鄉,崎峰村,0,1,825,5,830,1266,3,1,3,0,1,0,65.56
屏東縣,林邊鄉,水利村,0,1,1131,14,1145,1737,3,1,3,0,1,0,65.92
屏東縣,林邊鄉,竹林村,0,1,2003,17,2020,2842,3,1,3,0,1,0,71.08
屏東縣,林邊鄉,鎮安村,0,1,807,5,812,1155,3,1,3,0,1,0,70.30
屏東縣,南州鄉,溪洲村,0,1,1228,14,1242,1724,3,1,3,0,1,0,72.04
屏東縣,南州鄉,溪南村,0,1,703,7,710,992,3,1,3,0,1,0,71.57
屏東縣,南州鄉,仁里村,0,1,423,3,426,607,3,1,3,0,1,0,70.18
屏東縣,南州鄉,溪北村,0,1,554,5,559,756,3,1,3,0,1,0,73.94
屏東縣,南州鄉,七塊村,0,1,679,4,683,1042,3,1,3,0,1,0,65.55
屏東縣,南州鄉,萬華村,0,1,707,8,715,998,3,1,3,0,1,0,71.64
屏東縣,南州鄉,米崙村,0,1,746,7,753,1068,3,1,3,0,1,0,70.51
屏東縣,南州鄉,壽元村,0,1,758,7,765,1085,3,1,3,0,1,0,70.51
屏東縣,南州鄉,同安村,0,1,589,5,594,873,3,1,3,0,1,0,68.04
屏東縣,南州鄉,南安村,0,1,408,5,413,608,3,1,3,0,1,0,67.93
屏東縣,佳冬鄉,佳冬村,0,1,1049,10,1059,1508,3,1,3,0,1,0,70.23
屏東縣,佳冬鄉,六根村,0,1,1270,14,1284,1789,3,1,3,0,1,0,71.77
屏東縣,佳冬鄉,賴家村,0,1,678,9,687,1001,3,1,3,0,1,0,68.63
屏東縣,佳冬鄉,萬建村,0,1,1060,9,1069,1687,3,1,3,0,1,0,63.37
屏東縣,佳冬鄉,石光村,0,1,1210,13,1223,1827,3,1,3,0,1,0,66.94
屏東縣,佳冬鄉,玉光村,0,1,1408,15,1423,2211,3,1,3,0,1,0,64.36
屏東縣,佳冬鄉,昌隆村,0,1,799,4,803,1173,3,1,3,0,1,0,68.46
屏東縣,佳冬鄉,豐隆村,0,1,582,8,590,895,3,1,3,0,1,0,65.92
屏東縣,佳冬鄉,大同村,0,1,880,3,883,1204,3,1,3,0,1,0,73.34
屏東縣,佳冬鄉,羌園村,0,1,692,4,696,943,3,1,3,0,1,0,73.81
屏東縣,佳冬鄉,燄溫村,0,1,749,13,762,1089,3,1,3,0,1,0,69.97
屏東縣,佳冬鄉,塭豐村,0,1,1408,17,1425,2090,3,1,3,0,1,0,68.18
屏東縣,琉球鄉,本福村,0,1,885,10,895,1629,3,1,3,0,1,0,54.94
屏東縣,琉球鄉,中福村,0,1,543,11,554,949,3,1,3,0,1,0,58.38
屏東縣,琉球鄉,漁福村,0,1,425,6,431,762,3,1,3,0,1,0,56.56
屏東縣,琉球鄉,大福村,0,1,662,3,665,1332,3,1,3,0,1,0,49.92
屏東縣,琉球鄉,南福村,0,1,472,6,478,1023,3,1,3,0,1,0,46.73
屏東縣,琉球鄉,天福村,0,1,453,6,459,942,3,1,3,0,1,0,48.73
屏東縣,琉球鄉,上福村,0,1,610,7,617,1197,3,1,3,0,1,0,51.55
屏東縣,琉球鄉,杉福村,0,1,330,4,334,675,3,1,3,0,1,0,49.48
屏東縣,車城鄉,福興村,0,1,861,11,872,1369,3,1,3,0,1,0,63.70
屏東縣,車城鄉,福安村,0,1,363,0,363,576,3,1,3,0,1,0,63.02
屏東縣,車城鄉,田中村,0,1,426,2,428,798,3,1,3,0,1,0,53.63
屏東縣,車城鄉,海口村,0,1,472,4,476,849,3,1,3,0,1,0,56.07
屏東縣,車城鄉,統埔村,0,1,253,3,256,450,3,1,3,0,1,0,56.89
屏東縣,車城鄉,溫泉村,0,1,589,13,602,1078,3,1,3,0,1,0,55.84
屏東縣,車城鄉,保力村,0,1,775,7,782,1484,3,1,3,0,1,0,52.70
屏東縣,車城鄉,新街村,0,1,276,4,280,438,3,1,3,0,1,0,63.93
屏東縣,車城鄉,埔墘村,0,1,257,4,261,448,3,1,3,0,1,0,58.26
屏東縣,車城鄉,射寮村,0,1,307,3,310,534,3,1,3,0,1,0,58.05
屏東縣,車城鄉,後灣村,0,1,292,7,299,538,3,1,3,0,1,0,55.58
屏東縣,滿州鄉,滿州村,0,1,793,9,802,1391,3,1,3,0,1,0,57.66
屏東縣,滿州鄉,里德村,0,1,126,2,128,260,3,1,3,0,1,0,49.23
屏東縣,滿州鄉,永靖村,0,1,608,4,612,1123,3,1,3,0,1,0,54.50
屏東縣,滿州鄉,港口村,0,1,597,6,603,1043,3,1,3,0,1,0,57.81
屏東縣,滿州鄉,響林村,0,1,240,1,241,452,3,1,3,0,1,0,53.32
屏東縣,滿州鄉,長樂村,0,1,340,9,349,683,3,1,3,0,1,0,51.10
屏東縣,滿州鄉,九棚村,0,1,127,1,128,239,3,1,3,0,1,0,53.56
屏東縣,滿州鄉,港仔村,0,1,176,3,179,296,3,1,3,0,1,0,60.47
屏東縣,枋山鄉,枋山村,0,1,643,6,649,1042,3,1,3,0,1,0,62.28
屏東縣,枋山鄉,加祿村,0,1,1161,12,1173,1769,3,1,3,0,1,0,66.31
屏東縣,枋山鄉,楓港村,0,1,593,7,600,1164,3,1,3,0,1,0,51.55
屏東縣,枋山鄉,善餘村,0,1,493,7,500,1030,3,1,3,0,1,0,48.54
屏東縣,三地門鄉,三地村,0,1,70,1,71,112,3,1,3,0,1,0,63.39
屏東縣,三地門鄉,賽嘉村,0,1,19,1,20,37,3,1,3,0,1,0,54.05
屏東縣,三地門鄉,口社村,0,1,28,0,28,48,3,1,3,0,1,0,58.33
屏東縣,三地門鄉,馬兒村,0,1,2,0,2,5,3,1,3,0,1,0,40.00
屏東縣,三地門鄉,安坡村,0,1,21,0,21,38,3,1,3,0,1,0,55.26
屏東縣,三地門鄉,青山村,0,1,28,1,29,46,3,1,3,0,1,0,63.04
屏東縣,三地門鄉,青葉村,0,1,21,0,21,39,3,1,3,0,1,0,53.85
屏東縣,三地門鄉,達來村,0,1,8,0,8,14,3,1,3,0,1,0,57.14
屏東縣,三地門鄉,德文村,0,1,6,0,6,11,3,1,3,0,1,0,54.55
屏東縣,三地門鄉,大社村,0,1,5,0,5,22,3,1,3,0,1,0,22.73
屏東縣,霧台鄉,霧台村,0,1,14,0,14,25,3,1,3,0,1,0,56.00
屏東縣,霧台鄉,好茶村,0,1,4,0,4,5,3,1,3,0,1,0,80.00
屏東縣,霧台鄉,阿禮村,0,1,2,0,2,4,3,1,3,0,1,0,50.00
屏東縣,霧台鄉,吉露村,0,1,2,0,2,5,3,1,3,0,1,0,40.00
屏東縣,霧台鄉,大武村,0,1,4,0,4,8,3,1,3,0,1,0,50.00
屏東縣,霧台鄉,佳暮村,0,1,2,0,2,4,3,1,3,0,1,0,50.00
屏東縣,瑪家鄉,瑪家村,0,1,5,1,6,12,3,1,3,0,1,0,50.00
屏東縣,瑪家鄉,北葉村,0,1,57,0,57,87,3,1,3,0,1,0,65.52
屏東縣,瑪家鄉,涼山村,0,1,33,1,34,46,3,1,3,0,1,0,73.91
屏東縣,瑪家鄉,佳義村,0,1,31,1,32,51,3,1,3,0,1,0,62.75
屏東縣,瑪家鄉,排灣村,0,1,8,0,8,17,3,1,3,0,1,0,47.06
屏東縣,瑪家鄉,三和村,0,1,87,1,88,149,3,1,3,0,1,0,59.06
屏東縣,泰武鄉,佳平村,0,1,25,0,25,47,3,1,3,0,1,0,53.19
屏東縣,泰武鄉,武潭村,0,1,16,0,16,36,3,1,3,0,1,0,44.44
屏東縣,泰武鄉,平和村,0,1,17,0,17,33,3,1,3,0,1,0,51.52
屏東縣,泰武鄉,佳興村,0,1,6,0,6,14,3,1,3,0,1,0,42.86
屏東縣,泰武鄉,泰武村,0,1,1,0,1,6,3,1,3,0,1,0,16.67
屏東縣,泰武鄉,萬安村,0,1,18,0,18,33,3,1,3,0,1,0,54.55
屏東縣,來義鄉,來義村,0,1,17,3,20,39,3,1,3,0,1,0,51.28
屏東縣,來義鄉,義林村,0,1,23,0,23,39,3,1,3,0,1,0,58.97
屏東縣,來義鄉,丹林村,0,1,48,1,49,74,3,1,3,0,1,0,66.22
屏東縣,來義鄉,古樓村,0,1,53,0,53,106,3,1,3,0,1,0,50.00
屏東縣,來義鄉,文樂村,0,1,30,1,31,46,3,1,3,0,1,0,67.39
屏東縣,來義鄉,望嘉村,0,1,44,1,45,57,3,1,3,0,1,0,78.95
屏東縣,來義鄉,南和村,0,1,35,1,36,70,3,1,3,0,1,0,51.43
屏東縣,春日鄉,春日村,0,1,36,0,36,68,3,1,3,0,1,0,52.94
屏東縣,春日鄉,古華村,0,1,32,1,33,59,3,1,3,0,1,0,55.93
屏東縣,春日鄉,士文村,0,1,6,0,6,9,3,1,3,0,1,0,66.67
屏東縣,春日鄉,歸崇村,0,1,95,0,95,153,3,1,3,0,1,0,62.09
屏東縣,春日鄉,七佳村,0,1,76,2,78,124,3,1,3,0,1,0,62.90
屏東縣,春日鄉,力里村,0,1,14,0,14,20,3,1,3,0,1,0,70.00
屏東縣,獅子鄉,南世村,0,1,9,0,9,14,3,1,3,0,1,0,64.29
屏東縣,獅子鄉,內獅村,0,1,22,0,22,38,3,1,3,0,1,0,57.89
屏東縣,獅子鄉,獅子村,0,1,9,0,9,14,3,1,3,0,1,0,64.29
屏東縣,獅子鄉,竹坑村,0,1,18,0,18,29,3,1,3,0,1,0,62.07
屏東縣,獅子鄉,楓林村,0,1,30,0,30,45,3,1,3,0,1,0,66.67
屏東縣,獅子鄉,丹路村,0,1,32,0,32,72,3,1,3,0,1,0,44.44
屏東縣,獅子鄉,草埔村,0,1,34,0,34,58,3,1,3,0,1,0,58.62
屏東縣,獅子鄉,內文村,0,1,11,0,11,22,3,1,3,0,1,0,50.00
屏東縣,牡丹鄉,石門村,0,1,112,2,114,176,3,1,3,0,1,0,64.77
屏東縣,牡丹鄉,牡丹村,0,1,36,0,36,64,3,1,3,0,1,0,56.25
屏東縣,牡丹鄉,東源村,0,1,8,0,8,19,3,1,3,0,1,0,42.11
屏東縣,牡丹鄉,旭海村,0,1,48,1,49,91,3,1,3,0,1,0,53.85
屏東縣,牡丹鄉,高士村,0,1,15,0,15,24,3,1,3,0,1,0,62.50
屏東縣,牡丹鄉,四林村,0,1,16,1,17,27,3,1,3,0,1,0,62.96
臺東縣,台東市,文化里,0,1,854,15,869,1397,3,1,3,0,1,0,62.20
臺東縣,台東市,民族里,0,1,1244,15,1259,1900,3,1,3,0,1,0,66.26
臺東縣,台東市,自強里,0,1,1958,15,1973,3103,3,1,3,0,1,0,63.58
臺東縣,台東市,民生里,0,1,1503,22,1525,2538,3,1,3,0,1,0,60.09
臺東縣,台東市,寶桑里,0,1,432,7,439,717,3,1,3,0,1,0,61.23
臺東縣,台東市,民權里,0,1,681,5,686,1117,3,1,3,0,1,0,61.41
臺東縣,台東市,四維里,0,1,248,1,249,444,3,1,3,0,1,0,56.08
臺東縣,台東市,中華里,0,1,1057,8,1065,1750,3,1,3,0,1,0,60.86
臺東縣,台東市,仁愛里,0,1,484,9,493,797,3,1,3,0,1,0,61.86
臺東縣,台東市,強國里,0,1,422,2,424,677,3,1,3,0,1,0,62.63
臺東縣,台東市,大同里,0,1,458,11,469,770,3,1,3,0,1,0,60.91
臺東縣,台東市,成功里,0,1,563,9,572,991,3,1,3,0,1,0,57.72
臺東縣,台東市,建國里,0,1,885,17,902,1514,3,1,3,0,1,0,59.58
臺東縣,台東市,中正里,0,1,544,3,547,889,3,1,3,0,1,0,61.53
臺東縣,台東市,中山里,0,1,702,7,709,1116,3,1,3,0,1,0,63.53
臺東縣,台東市,興國里,0,1,523,3,526,823,3,1,3,0,1,0,63.91
臺東縣,台東市,鐵花里,0,1,283,1,284,489,3,1,3,0,1,0,58.08
臺東縣,台東市,東海里,0,1,1237,20,1257,2062,3,1,3,0,1,0,60.96
臺東縣,台東市,復國里,0,1,453,13,466,790,3,1,3,0,1,0,58.99
臺東縣,台東市,復興里,0,1,311,4,315,585,3,1,3,0,1,0,53.85
臺東縣,台東市,新興里,0,1,737,13,750,1247,3,1,3,0,1,0,60.14
臺東縣,台東市,新生里,0,1,2143,27,2170,3628,3,1,3,0,1,0,59.81
臺東縣,台東市,中心里,0,1,1154,21,1175,1900,3,1,3,0,1,0,61.84
臺東縣,台東市,馬蘭里,0,1,2084,18,2102,3313,3,1,3,0,1,0,63.45
臺東縣,台東市,光明里,0,1,446,6,452,788,3,1,3,0,1,0,57.36
臺東縣,台東市,豐年里,0,1,900,18,918,1591,3,1,3,0,1,0,57.70
臺東縣,台東市,豐樂里,0,1,453,12,465,782,3,1,3,0,1,0,59.46
臺東縣,台東市,永樂里,0,1,506,13,519,786,3,1,3,0,1,0,66.03
臺東縣,台東市,康樂里,0,1,551,9,560,941,3,1,3,0,1,0,59.51
臺東縣,台東市,豐榮里,0,1,3108,43,3151,5615,3,1,3,0,1,0,56.12
臺東縣,台東市,豐谷里,0,1,941,14,955,1623,3,1,3,0,1,0,58.84
臺東縣,台東市,豐里里,0,1,823,10,833,1376,3,1,3,0,1,0,60.54
臺東縣,台東市,豐原里,0,1,561,13,574,973,3,1,3,0,1,0,58.99
臺東縣,台東市,富岡里,0,1,635,11,646,1101,3,1,3,0,1,0,58.67
臺東縣,台東市,富豐里,0,1,248,5,253,478,3,1,3,0,1,0,52.93
臺東縣,台東市,南榮里,0,1,1144,45,1189,1785,3,1,3,0,1,0,66.61
臺東縣,台東市,岩灣里,0,1,523,6,529,1061,3,1,3,0,1,0,49.86
臺東縣,台東市,卑南里,0,1,949,10,959,1390,3,1,3,0,1,0,68.99
臺東縣,台東市,南王里,0,1,770,7,777,1340,3,1,3,0,1,0,57.99
臺東縣,台東市,豐田里,0,1,1037,12,1049,1738,3,1,3,0,1,0,60.36
臺東縣,台東市,新園里,0,1,662,4,666,1063,3,1,3,0,1,0,62.65
臺東縣,台東市,建和里,0,1,516,7,523,973,3,1,3,0,1,0,53.75
臺東縣,台東市,建興里,0,1,468,4,472,832,3,1,3,0,1,0,56.73
臺東縣,台東市,建業里,0,1,496,3,499,899,3,1,3,0,1,0,55.51
臺東縣,台東市,知本里,0,1,458,5,463,844,3,1,3,0,1,0,54.86
臺東縣,台東市,建農里,0,1,640,24,664,1155,3,1,3,0,1,0,57.49
臺東縣,成功鎮,信義里,0,1,287,3,290,514,3,1,3,0,1,0,56.42
臺東縣,成功鎮,和平里,0,1,110,1,111,204,3,1,3,0,1,0,54.41
臺東縣,成功鎮,忠仁里,0,1,1292,18,1310,2394,3,1,3,0,1,0,54.72
臺東縣,成功鎮,忠智里,0,1,643,2,645,1129,3,1,3,0,1,0,57.13
臺東縣,成功鎮,三民里,0,1,499,6,505,992,3,1,3,0,1,0,50.91
臺東縣,成功鎮,三仙里,0,1,298,6,304,574,3,1,3,0,1,0,52.96
臺東縣,成功鎮,忠孝里,0,1,291,8,299,575,3,1,3,0,1,0,52.00
臺東縣,成功鎮,博愛里,0,1,73,0,73,139,3,1,3,0,1,0,52.52
臺東縣,關山鎮,里壟里,0,1,941,15,956,1720,3,1,3,0,1,0,55.58
臺東縣,關山鎮,中福里,0,1,538,10,548,876,3,1,3,0,1,0,62.56
臺東縣,關山鎮,新福里,0,1,375,12,387,652,3,1,3,0,1,0,59.36
臺東縣,關山鎮,豐泉里,0,1,498,5,503,922,3,1,3,0,1,0,54.56
臺東縣,關山鎮,月眉里,0,1,363,4,367,737,3,1,3,0,1,0,49.80
臺東縣,關山鎮,德高里,0,1,663,6,669,1343,3,1,3,0,1,0,49.81
臺東縣,關山鎮,電光里,0,1,119,0,119,257,3,1,3,0,1,0,46.30
臺東縣,卑南鄉,賓朗村,0,1,1033,12,1045,1699,3,1,3,0,1,0,61.51
臺東縣,卑南鄉,美農村,0,1,589,5,594,1013,3,1,3,0,1,0,58.64
臺東縣,卑南鄉,初鹿村,0,1,644,10,654,1066,3,1,3,0,1,0,61.35
臺東縣,卑南鄉,明峰村,0,1,576,10,586,1062,3,1,3,0,1,0,55.18
臺東縣,卑南鄉,嘉豐村,0,1,130,3,133,241,3,1,3,0,1,0,55.19
臺東縣,卑南鄉,太平村,0,1,1972,34,2006,2996,3,1,3,0,1,0,66.96
臺東縣,卑南鄉,泰安村,0,1,438,11,449,741,3,1,3,0,1,0,60.59
臺東縣,卑南鄉,利嘉村,0,1,221,1,222,418,3,1,3,0,1,0,53.11
臺東縣,卑南鄉,東興村,0,1,172,1,173,306,3,1,3,0,1,0,56.54
臺東縣,卑南鄉,溫泉村,0,1,580,7,587,1065,3,1,3,0,1,0,55.12
臺東縣,卑南鄉,富山村,0,1,241,5,246,473,3,1,3,0,1,0,52.01
臺東縣,卑南鄉,富源村,0,1,197,2,199,374,3,1,3,0,1,0,53.21
臺東縣,卑南鄉,利吉村,0,1,143,2,145,269,3,1,3,0,1,0,53.90
臺東縣,鹿野鄉,鹿野村,0,1,420,10,430,827,3,1,3,0,1,0,52.00
臺東縣,鹿野鄉,龍田村,0,1,563,6,569,1088,3,1,3,0,1,0,52.30
臺東縣,鹿野鄉,永安村,0,1,535,10,545,1077,3,1,3,0,1,0,50.60
臺東縣,鹿野鄉,瑞隆村,0,1,449,6,455,852,3,1,3,0,1,0,53.40
臺東縣,鹿野鄉,瑞源村,0,1,348,4,352,677,3,1,3,0,1,0,51.99
臺東縣,鹿野鄉,瑞和村,0,1,222,6,228,409,3,1,3,0,1,0,55.75
臺東縣,鹿野鄉,瑞豐村,0,1,556,4,560,1031,3,1,3,0,1,0,54.32
臺東縣,池上鄉,福原村,0,1,1055,11,1066,1820,3,1,3,0,1,0,58.57
臺東縣,池上鄉,福文村,0,1,714,16,730,1426,3,1,3,0,1,0,51.19
臺東縣,池上鄉,慶豐村,0,1,357,6,363,703,3,1,3,0,1,0,51.64
臺東縣,池上鄉,大坡村,0,1,56,1,57,128,3,1,3,0,1,0,44.53
臺東縣,池上鄉,大埔村,0,1,249,3,252,412,3,1,3,0,1,0,61.17
臺東縣,池上鄉,新興村,0,1,484,8,492,882,3,1,3,0,1,0,55.78
臺東縣,池上鄉,錦園村,0,1,256,4,260,487,3,1,3,0,1,0,53.39
臺東縣,池上鄉,萬安村,0,1,207,3,210,406,3,1,3,0,1,0,51.72
臺東縣,池上鄉,富興村,0,1,219,4,223,405,3,1,3,0,1,0,55.06
臺東縣,池上鄉,振興村,0,1,91,1,92,192,3,1,3,0,1,0,47.92
臺東縣,東河鄉,都蘭村,0,1,639,5,644,1306,3,1,3,0,1,0,49.31
臺東縣,東河鄉,興昌村,0,1,353,2,355,708,3,1,3,0,1,0,50.14
臺東縣,東河鄉,隆昌村,0,1,99,2,101,212,3,1,3,0,1,0,47.64
臺東縣,東河鄉,東河村,0,1,173,4,177,369,3,1,3,0,1,0,47.97
臺東縣,東河鄉,泰源村,0,1,421,3,424,720,3,1,3,0,1,0,58.89
臺東縣,東河鄉,北源村,0,1,485,7,492,1568,3,1,3,0,1,0,31.38
臺東縣,東河鄉,尚德村,0,1,108,2,110,224,3,1,3,0,1,0,49.11
臺東縣,長濱鄉,寧埔村,0,1,193,3,196,468,3,1,3,0,1,0,41.88
臺東縣,長濱鄉,竹湖村,0,1,205,4,209,443,3,1,3,0,1,0,47.18
臺東縣,長濱鄉,長濱村,0,1,675,10,685,1218,3,1,3,0,1,0,56.24
臺東縣,長濱鄉,忠勇村,0,1,244,5,249,567,3,1,3,0,1,0,43.92
臺東縣,長濱鄉,長濱村,0,1,105,1,106,238,3,1,3,0,1,0,44.54
臺東縣,長濱鄉,三間村,0,1,251,2,253,547,3,1,3,0,1,0,46.25
臺東縣,長濱鄉,樟原村,0,1,169,3,172,328,3,1,3,0,1,0,52.44
臺東縣,太麻里鄉,美和村,0,1,792,6,798,1349,3,1,3,0,1,0,59.15
臺東縣,太麻里鄉,三和村,0,1,81,0,81,160,3,1,3,0,1,0,50.63
臺東縣,太麻里鄉,華源村,0,1,392,6,398,749,3,1,3,0,1,0,53.14
臺東縣,太麻里鄉,北里村,0,1,209,1,210,389,3,1,3,0,1,0,53.98
臺東縣,太麻里鄉,大王村,0,1,581,11,592,1185,3,1,3,0,1,0,49.96
臺東縣,太麻里鄉,泰和村,0,1,735,6,741,1341,3,1,3,0,1,0,55.26
臺東縣,太麻里鄉,香蘭村,0,1,301,3,304,590,3,1,3,0,1,0,51.53
臺東縣,太麻里鄉,金崙村,0,1,317,5,322,638,3,1,3,0,1,0,50.47
臺東縣,太麻里鄉,多良村,0,1,141,0,141,254,3,1,3,0,1,0,55.51
臺東縣,大武鄉,南興村,0,1,157,0,157,272,3,1,3,0,1,0,57.72
臺東縣,大武鄉,尚武村,0,1,622,4,626,1148,3,1,3,0,1,0,54.53
臺東縣,大武鄉,大武村,0,1,493,10,503,904,3,1,3,0,1,0,55.64
臺東縣,大武鄉,大鳥村,0,1,54,2,56,137,3,1,3,0,1,0,40.88
臺東縣,大武鄉,大竹村,0,1,42,1,43,90,3,1,3,0,1,0,47.78
臺東縣,綠島鄉,南寮村,0,1,297,7,304,596,3,1,3,0,1,0,51.01
臺東縣,綠島鄉,中寮村,0,1,336,2,338,630,3,1,3,0,1,0,53.65
臺東縣,綠島鄉,公舘村,0,1,266,4,270,492,3,1,3,0,1,0,54.88
臺東縣,海端鄉,加拿村,0,1,11,0,11,20,3,1,3,0,1,0,55.00
臺東縣,海端鄉,崁頂村,0,1,30,2,32,46,3,1,3,0,1,0,69.57
臺東縣,海端鄉,海端村,0,1,56,0,56,130,3,1,3,0,1,0,43.08
臺東縣,海端鄉,廣原村,0,1,60,1,61,90,3,1,3,0,1,0,67.78
臺東縣,海端鄉,霧鹿村,0,1,18,1,19,30,3,1,3,0,1,0,63.33
臺東縣,海端鄉,利稻村,0,1,19,2,21,33,3,1,3,0,1,0,63.64
臺東縣,延平鄉,桃源村,0,1,58,0,58,108,3,1,3,0,1,0,53.70
臺東縣,延平鄉,紅葉村,0,1,18,0,18,27,3,1,3,0,1,0,66.67
臺東縣,延平鄉,永康村,0,1,16,1,17,21,3,1,3,0,1,0,80.95
臺東縣,延平鄉,武陵村,0,1,19,0,19,33,3,1,3,0,1,0,57.58
臺東縣,延平鄉,鸞山村,0,1,63,1,64,108,3,1,3,0,1,0,59.26
臺東縣,金峰鄉,嘉蘭村,0,1,52,0,52,109,3,1,3,0,1,0,47.71
臺東縣,金峰鄉,正興村,0,1,18,0,18,46,3,1,3,0,1,0,39.13
臺東縣,金峰鄉,新興村,0,1,22,0,22,35,3,1,3,0,1,0,62.86
臺東縣,金峰鄉,賓茂村,0,1,11,0,11,20,3,1,3,0,1,0,55.00
臺東縣,金峰鄉,歷坵村,0,1,6,0,6,21,3,1,3,0,1,0,28.57
臺東縣,達仁鄉,安朔村,0,1,105,0,105,184,3,1,3,0,1,0,57.07
臺東縣,達仁鄉,南田村,0,1,16,0,16,37,3,1,3,0,1,0,43.24
臺東縣,達仁鄉,森永村,0,1,26,1,27,67,3,1,3,0,1,0,40.30
臺東縣,達仁鄉,新化村,0,1,2,0,2,15,3,1,3,0,1,0,13.33
臺東縣,達仁鄉,台板村,0,1,6,0,6,30,3,1,3,0,1,0,20.00
臺東縣,達仁鄉,土板村,0,1,5,0,5,11,3,1,3,0,1,0,45.45
臺東縣,蘭嶼鄉,椰油村,0,1,25,0,25,62,3,1,3,0,1,0,40.32
臺東縣,蘭嶼鄉,紅頭村,0,1,31,1,32,66,3,1,3,0,1,0,48.48
臺東縣,蘭嶼鄉,東清村,0,1,1,0,1,10,3,1,3,0,1,0,10.00
臺東縣,蘭嶼鄉,朗島村,0,1,5,0,5,14,3,1,3,0,1,0,35.71
花蓮縣,花蓮市,民德里,0,1,955,6,961,1494,3,1,3,0,1,0,64.32
花蓮縣,花蓮市,民勤里,0,1,2135,26,2161,3350,3,1,3,0,1,0,64.51
花蓮縣,花蓮市,民意里,0,1,1982,43,2025,3178,3,1,3,0,1,0,63.72
花蓮縣,花蓮市,民心里,0,1,386,8,394,657,3,1,3,0,1,0,59.97
花蓮縣,花蓮市,民享里,0,1,1511,17,1528,2596,3,1,3,0,1,0,58.86
花蓮縣,花蓮市,民運里,0,1,1057,22,1079,1710,3,1,3,0,1,0,63.10
花蓮縣,花蓮市,民政里,0,1,1480,28,1508,2401,3,1,3,0,1,0,62.81
花蓮縣,花蓮市,民立里,0,1,994,17,1011,1483,3,1,3,0,1,0,68.17
花蓮縣,花蓮市,民樂里,0,1,213,0,213,344,3,1,3,0,1,0,61.92
花蓮縣,花蓮市,民有里,0,1,421,4,425,655,3,1,3,0,1,0,64.89
花蓮縣,花蓮市,民主里,0,1,400,7,407,687,3,1,3,0,1,0,59.24
花蓮縣,花蓮市,民治里,0,1,337,6,343,535,3,1,3,0,1,0,64.11
花蓮縣,花蓮市,民族里,0,1,403,0,403,646,3,1,3,0,1,0,62.38
花蓮縣,花蓮市,民生里,0,1,910,13,923,1411,3,1,3,0,1,0,65.41
花蓮縣,花蓮市,民權里,0,1,339,6,345,550,3,1,3,0,1,0,62.73
花蓮縣,花蓮市,主商里,0,1,573,9,582,833,3,1,3,0,1,0,69.87
花蓮縣,花蓮市,主勤里,0,1,678,8,686,1094,3,1,3,0,1,0,62.71
花蓮縣,花蓮市,主工里,0,1,499,6,505,724,3,1,3,0,1,0,69.75
花蓮縣,花蓮市,主信里,0,1,497,7,504,776,3,1,3,0,1,0,64.95
花蓮縣,花蓮市,主睦里,0,1,619,7,626,1004,3,1,3,0,1,0,62.35
花蓮縣,花蓮市,主計里,0,1,466,7,473,796,3,1,3,0,1,0,59.42
花蓮縣,花蓮市,主和里,0,1,1691,23,1714,2746,3,1,3,0,1,0,62.42
花蓮縣,花蓮市,主學里,0,1,1025,8,1033,1572,3,1,3,0,1,0,65.71
花蓮縣,花蓮市,主農里,0,1,2943,33,2976,4642,3,1,3,0,1,0,64.11
花蓮縣,花蓮市,主權里,0,1,1894,18,1912,3134,3,1,3,0,1,0,61.01
花蓮縣,花蓮市,主力里,0,1,1439,18,1457,2222,3,1,3,0,1,0,65.57
花蓮縣,花蓮市,國風里,0,1,1857,20,1877,3040,3,1,3,0,1,0,61.74
花蓮縣,花蓮市,國威里,0,1,1011,8,1019,1530,3,1,3,0,1,0,66.60
花蓮縣,花蓮市,國治里,0,1,709,11,720,1087,3,1,3,0,1,0,66.24
花蓮縣,花蓮市,國安里,0,1,297,3,300,460,3,1,3,0,1,0,65.22
花蓮縣,花蓮市,國光里,0,1,930,24,954,1456,3,1,3,0,1,0,65.52
花蓮縣,花蓮市,國防里,0,1,491,3,494,780,3,1,3,0,1,0,63.33
花蓮縣,花蓮市,國華里,0,1,1395,15,1410,2163,3,1,3,0,1,0,65.19
花蓮縣,花蓮市,國魂里,0,1,1098,13,1111,1748,3,1,3,0,1,0,63.56
花蓮縣,花蓮市,國聯里,0,1,2176,26,2202,3704,3,1,3,0,1,0,59.45
花蓮縣,花蓮市,國強里,0,1,489,3,492,809,3,1,3,0,1,0,60.82
花蓮縣,花蓮市,國富里,0,1,2417,31,2448,3751,3,1,3,0,1,0,65.26
花蓮縣,花蓮市,國裕里,0,1,1517,17,1534,2455,3,1,3,0,1,0,62.48
花蓮縣,花蓮市,國慶里,0,1,1630,16,1646,2750,3,1,3,0,1,0,59.85
花蓮縣,花蓮市,國福里,0,1,384,7,391,733,3,1,3,0,1,0,53.34
花蓮縣,新城鄉,新城村,0,1,826,12,838,1294,3,1,3,0,1,0,64.76
花蓮縣,新城鄉,順安村,0,1,471,3,474,840,3,1,3,0,1,0,56.43
花蓮縣,新城鄉,康樂村,0,1,1241,14,1255,1974,3,1,3,0,1,0,63.58
花蓮縣,新城鄉,北埔村,0,1,2150,36,2186,3672,3,1,3,0,1,0,59.53
花蓮縣,新城鄉,佳林村,0,1,317,4,321,541,3,1,3,0,1,0,59.33
花蓮縣,新城鄉,嘉里村,0,1,1579,38,1617,2463,3,1,3,0,1,0,65.65
花蓮縣,新城鄉,嘉新村,0,1,692,18,710,1053,3,1,3,0,1,0,67.43
花蓮縣,秀林鄉,和平村,0,1,227,6,233,444,3,1,3,0,1,0,52.48
花蓮縣,秀林鄉,崇德村,0,1,186,3,189,334,3,1,3,0,1,0,56.59
花蓮縣,秀林鄉,富世村,0,1,239,7,246,496,3,1,3,0,1,0,49.60
花蓮縣,秀林鄉,秀林村,0,1,59,3,62,124,3,1,3,0,1,0,50.00
花蓮縣,秀林鄉,景美村,0,1,78,1,79,168,3,1,3,0,1,0,47.02
花蓮縣,秀林鄉,佳民村,0,1,76,0,76,124,3,1,3,0,1,0,61.29
花蓮縣,秀林鄉,水源村,0,1,79,1,80,114,3,1,3,0,1,0,70.18
花蓮縣,秀林鄉,銅門村,0,1,78,1,79,122,3,1,3,0,1,0,64.75
花蓮縣,秀林鄉,文蘭村,0,1,47,0,47,92,3,1,3,0,1,0,51.09
花蓮縣,吉安鄉,永安村,0,1,1565,25,1590,2606,3,1,3,0,1,0,61.01
花蓮縣,吉安鄉,太昌村,0,1,1236,16,1252,2067,3,1,3,0,1,0,60.57
花蓮縣,吉安鄉,慶豐村,0,1,2010,39,2049,3341,3,1,3,0,1,0,61.33
花蓮縣,吉安鄉,吉安村,0,1,1368,13,1381,2254,3,1,3,0,1,0,61.27
花蓮縣,吉安鄉,福興村,0,1,1001,8,1009,1652,3,1,3,0,1,0,61.08
花蓮縣,吉安鄉,南華村,0,1,710,9,719,1133,3,1,3,0,1,0,63.46
花蓮縣,吉安鄉,干城村,0,1,517,17,534,1034,3,1,3,0,1,0,51.64
花蓮縣,吉安鄉,永興村,0,1,884,13,897,1425,3,1,3,0,1,0,62.95
花蓮縣,吉安鄉,稻香村,0,1,1252,25,1277,1984,3,1,3,0,1,0,64.36
花蓮縣,吉安鄉,南昌村,0,1,899,24,923,1599,3,1,3,0,1,0,57.72
花蓮縣,吉安鄉,宜昌村,0,1,1446,15,1461,2314,3,1,3,0,1,0,63.14
花蓮縣,吉安鄉,北昌村,0,1,3159,36,3195,4946,3,1,3,0,1,0,64.60
花蓮縣,吉安鄉,勝安村,0,1,1662,19,1681,2673,3,1,3,0,1,0,62.89
花蓮縣,吉安鄉,仁里村,0,1,2421,31,2452,4034,3,1,3,0,1,0,60.78
花蓮縣,吉安鄉,東昌村,0,1,1461,18,1479,2469,3,1,3,0,1,0,59.90
花蓮縣,吉安鄉,仁安村,0,1,703,10,713,1301,3,1,3,0,1,0,54.80
花蓮縣,吉安鄉,仁和村,0,1,1640,29,1669,2746,3,1,3,0,1,0,60.78
花蓮縣,吉安鄉,光華村,0,1,499,21,520,856,3,1,3,0,1,0,60.75
花蓮縣,壽豐鄉,溪口村,0,1,453,9,462,769,3,1,3,0,1,0,60.08
花蓮縣,壽豐鄉,樹湖村,0,1,177,1,178,326,3,1,3,0,1,0,54.60
花蓮縣,壽豐鄉,豐山村,0,1,1064,17,1081,1843,3,1,3,0,1,0,58.65
花蓮縣,壽豐鄉,豐裡村,0,1,679,11,690,1163,3,1,3,0,1,0,59.33
花蓮縣,壽豐鄉,豐坪村,0,1,410,3,413,666,3,1,3,0,1,0,62.01
花蓮縣,壽豐鄉,壽豐村,0,1,627,10,637,1088,3,1,3,0,1,0,58.55
花蓮縣,壽豐鄉,共和村,0,1,380,5,385,604,3,1,3,0,1,0,63.74
花蓮縣,壽豐鄉,光榮村,0,1,87,2,89,156,3,1,3,0,1,0,57.05
花蓮縣,壽豐鄉,池南村,0,1,328,5,333,561,3,1,3,0,1,0,59.36
花蓮縣,壽豐鄉,平和村,0,1,634,14,648,1113,3,1,3,0,1,0,58.22
花蓮縣,壽豐鄉,志學村,0,1,1170,31,1201,2046,3,1,3,0,1,0,58.70
花蓮縣,壽豐鄉,米棧村,0,1,92,3,95,142,3,1,3,0,1,0,66.90
花蓮縣,壽豐鄉,月眉村,0,1,108,1,109,270,3,1,3,0,1,0,40.37
花蓮縣,壽豐鄉,鹽寮村,0,1,173,6,179,388,3,1,3,0,1,0,46.13
花蓮縣,壽豐鄉,水璉村,0,1,266,4,270,499,3,1,3,0,1,0,54.11
花蓮縣,鳳林鎮,鳳仁里,0,1,705,6,711,1124,3,1,3,0,1,0,63.26
花蓮縣,鳳林鎮,鳳義里,0,1,417,6,423,722,3,1,3,0,1,0,58.59
花蓮縣,鳳林鎮,鳳禮里,0,1,493,4,497,739,3,1,3,0,1,0,67.25
花蓮縣,鳳林鎮,鳳智里,0,1,804,9,813,1244,3,1,3,0,1,0,65.35
花蓮縣,鳳林鎮,鳳信里,0,1,597,1,598,935,3,1,3,0,1,0,63.96
花蓮縣,鳳林鎮,山興里,0,1,164,3,167,295,3,1,3,0,1,0,56.61
花蓮縣,鳳林鎮,大榮里,0,1,724,13,737,1320,3,1,3,0,1,0,55.83
花蓮縣,鳳林鎮,北林里,0,1,437,9,446,684,3,1,3,0,1,0,65.20
花蓮縣,鳳林鎮,南平里,0,1,441,1,442,739,3,1,3,0,1,0,59.81
花蓮縣,鳳林鎮,林榮里,0,1,602,10,612,905,3,1,3,0,1,0,67.62
花蓮縣,鳳林鎮,長橋里,0,1,635,16,651,1087,3,1,3,0,1,0,59.89
花蓮縣,鳳林鎮,森榮里,0,1,108,2,110,196,3,1,3,0,1,0,56.12
花蓮縣,光復鄉,大華村,0,1,535,8,543,931,3,1,3,0,1,0,58.32
花蓮縣,光復鄉,大安村,0,1,540,2,542,912,3,1,3,0,1,0,59.43
花蓮縣,光復鄉,大馬村,0,1,250,4,254,456,3,1,3,0,1,0,55.70
花蓮縣,光復鄉,大平村,0,1,139,3,142,324,3,1,3,0,1,0,43.83
花蓮縣,光復鄉,大同村,0,1,405,7,412,735,3,1,3,0,1,0,56.05
花蓮縣,光復鄉,東富村,0,1,116,2,118,266,3,1,3,0,1,0,44.36
花蓮縣,光復鄉,西富村,0,1,67,0,67,134,3,1,3,0,1,0,50.00
花蓮縣,光復鄉,南富村,0,1,55,1,56,127,3,1,3,0,1,0,44.09
花蓮縣,光復鄉,北富村,0,1,89,1,90,237,3,1,3,0,1,0,37.97
花蓮縣,光復鄉,西富村,0,1,129,2,131,258,3,1,3,0,1,0,50.78
花蓮縣,光復鄉,大進村,0,1,366,3,369,566,3,1,3,0,1,0,65.19
花蓮縣,光復鄉,大全村,0,1,385,6,391,722,3,1,3,0,1,0,54.16
花蓮縣,光復鄉,大興村,0,1,211,1,212,386,3,1,3,0,1,0,54.92
花蓮縣,光復鄉,大富村,0,1,232,5,237,427,3,1,3,0,1,0,55.50
花蓮縣,光復鄉,大豐村,0,1,345,8,353,642,3,1,3,0,1,0,54.98
花蓮縣,豐濱鄉,靜浦村,0,1,54,0,54,148,3,1,3,0,1,0,36.49
花蓮縣,豐濱鄉,港口村,0,1,68,2,70,160,3,1,3,0,1,0,43.75
花蓮縣,豐濱鄉,豐濱村,0,1,440,7,447,807,3,1,3,0,1,0,55.39
花蓮縣,豐濱鄉,新社村,0,1,57,1,58,145,3,1,3,0,1,0,40.00
花蓮縣,豐濱鄉,磯崎村,0,1,73,0,73,116,3,1,3,0,1,0,62.93
花蓮縣,萬榮鄉,西林村,0,1,29,2,31,63,3,1,3,0,1,0,49.21
花蓮縣,萬榮鄉,見晴村,0,1,15,0,15,29,3,1,3,0,1,0,51.72
花蓮縣,萬榮鄉,萬榮村,0,1,30,1,31,47,3,1,3,0,1,0,65.96
花蓮縣,萬榮鄉,明利村,0,1,34,0,34,64,3,1,3,0,1,0,53.13
花蓮縣,萬榮鄉,馬遠村,0,1,12,0,12,27,3,1,3,0,1,0,44.44
花蓮縣,萬榮鄉,紅葉村,0,1,56,1,57,118,3,1,3,0,1,0,48.31
花蓮縣,瑞穗鄉,瑞穗村,0,1,1126,12,1138,1954,3,1,3,0,1,0,58.24
花蓮縣,瑞穗鄉,瑞美村,0,1,948,9,957,1591,3,1,3,0,1,0,60.15
花蓮縣,瑞穗鄉,瑞良村,0,1,281,2,283,442,3,1,3,0,1,0,64.03
花蓮縣,瑞穗鄉,瑞祥村,0,1,472,8,480,844,3,1,3,0,1,0,56.87
花蓮縣,瑞穗鄉,瑞北村,0,1,240,2,242,452,3,1,3,0,1,0,53.54
花蓮縣,瑞穗鄉,舞鶴村,0,1,262,9,271,504,3,1,3,0,1,0,53.77
花蓮縣,瑞穗鄉,鶴岡村,0,1,159,2,161,364,3,1,3,0,1,0,44.23
花蓮縣,瑞穗鄉,奇美村,0,1,19,0,19,52,3,1,3,0,1,0,36.54
花蓮縣,瑞穗鄉,富源村,0,1,426,7,433,716,3,1,3,0,1,0,60.47
花蓮縣,瑞穗鄉,富興村,0,1,273,3,276,538,3,1,3,0,1,0,51.30
花蓮縣,瑞穗鄉,富民村,0,1,134,6,140,311,3,1,3,0,1,0,45.02
花蓮縣,玉里鎮,中城里,0,1,2226,42,2268,3951,3,1,3,0,1,0,57.40
花蓮縣,玉里鎮,國武里,0,1,833,5,838,1422,3,1,3,0,1,0,58.93
花蓮縣,玉里鎮,啟模里,0,1,1051,16,1067,1911,3,1,3,0,1,0,55.83
花蓮縣,玉里鎮,泰昌里,0,1,1404,147,1551,3091,3,1,3,0,1,0,50.18
花蓮縣,玉里鎮,永昌里,0,1,624,15,639,1127,3,1,3,0,1,0,56.70
花蓮縣,玉里鎮,源城里,0,1,583,9,592,1150,3,1,3,0,1,0,51.48
花蓮縣,玉里鎮,長良里,0,1,350,46,396,769,3,1,3,0,1,0,51.50
花蓮縣,玉里鎮,樂合里,0,1,185,4,189,406,3,1,3,0,1,0,46.55
花蓮縣,玉里鎮,東豐里,0,1,193,2,195,379,3,1,3,0,1,0,51.45
花蓮縣,玉里鎮,觀音里,0,1,489,17,506,1106,3,1,3,0,1,0,45.75
花蓮縣,玉里鎮,松浦里,0,1,249,7,256,600,3,1,3,0,1,0,42.67
花蓮縣,玉里鎮,春日里,0,1,247,3,250,531,3,1,3,0,1,0,47.08
花蓮縣,玉里鎮,德武里,0,1,43,1,44,97,3,1,3,0,1,0,45.36
花蓮縣,玉里鎮,三民里,0,1,520,8,528,1030,3,1,3,0,1,0,51.26
花蓮縣,玉里鎮,大禹里,0,1,587,7,594,1119,3,1,3,0,1,0,53.08
花蓮縣,富里鄉,吳江村,0,1,244,4,248,508,3,1,3,0,1,0,48.82
花蓮縣,富里鄉,東里村,0,1,633,20,653,1308,3,1,3,0,1,0,49.92
花蓮縣,富里鄉,萬寧村,0,1,619,43,662,1134,3,1,3,0,1,0,58.38
花蓮縣,富里鄉,新興村,0,1,324,6,330,674,3,1,3,0,1,0,48.96
花蓮縣,富里鄉,竹田村,0,1,630,11,641,1133,3,1,3,0,1,0,56.58
花蓮縣,富里鄉,羅山村,0,1,224,0,224,482,3,1,3,0,1,0,46.47
花蓮縣,富里鄉,石牌村,0,1,517,4,521,931,3,1,3,0,1,0,55.96
花蓮縣,富里鄉,明里村,0,1,255,3,258,440,3,1,3,0,1,0,58.64
花蓮縣,富里鄉,富里村,0,1,922,13,935,1744,3,1,3,0,1,0,53.61
花蓮縣,富里鄉,永豐村,0,1,302,1,303,589,3,1,3,0,1,0,51.44
花蓮縣,富里鄉,豐南村,0,1,212,5,217,397,3,1,3,0,1,0,54.66
花蓮縣,富里鄉,富南村,0,1,281,8,289,555,3,1,3,0,1,0,52.07
花蓮縣,富里鄉,學田村,0,1,332,4,336,583,3,1,3,0,1,0,57.63
花蓮縣,卓溪鄉,崙山村,0,1,14,0,14,34,3,1,3,0,1,0,41.18
花蓮縣,卓溪鄉,立山村,0,1,18,2,20,49,3,1,3,0,1,0,40.82
花蓮縣,卓溪鄉,太平村,0,1,18,1,19,36,3,1,3,0,1,0,52.78
花蓮縣,卓溪鄉,卓溪村,0,1,41,1,42,81,3,1,3,0,1,0,51.85
花蓮縣,卓溪鄉,卓清村,0,1,58,4,62,107,3,1,3,0,1,0,57.94
花蓮縣,卓溪鄉,古風村,0,1,48,0,48,97,3,1,3,0,1,0,49.48
澎湖縣,馬公市,新復里,0,1,259,3,262,405,3,1,3,0,1,0,64.69
澎湖縣,馬公市,復興里,0,1,266,5,271,353,3,1,3,0,1,0,76.77
澎湖縣,馬公市,長安里,0,1,418,6,424,644,3,1,3,0,1,0,65.84
澎湖縣,馬公市,中央里,0,1,392,5,397,553,3,1,3,0,1,0,71.79
澎湖縣,馬公市,啟明里,0,1,645,4,649,944,3,1,3,0,1,0,68.75
澎湖縣,馬公市,重慶里,0,1,808,4,812,1154,3,1,3,0,1,0,70.36
澎湖縣,馬公市,中興里,0,1,557,5,562,789,3,1,3,0,1,0,71.23
澎湖縣,馬公市,光復里,0,1,1242,13,1255,1814,3,1,3,0,1,0,69.18
澎湖縣,馬公市,光明里,0,1,951,16,967,1424,3,1,3,0,1,0,67.91
澎湖縣,馬公市,光榮里,0,1,1447,18,1465,2169,3,1,3,0,1,0,67.54
澎湖縣,馬公市,朝陽里,0,1,2628,28,2656,3932,3,1,3,0,1,0,67.55
澎湖縣,馬公市,陽明里,0,1,1452,23,1475,2276,3,1,3,0,1,0,64.81
澎湖縣,馬公市,重光里,0,1,563,9,572,810,3,1,3,0,1,0,70.62
澎湖縣,馬公市,西衛里,0,1,1421,16,1437,2107,3,1,3,0,1,0,68.20
澎湖縣,馬公市,西文里,0,1,1167,9,1176,1728,3,1,3,0,1,0,68.06
澎湖縣,馬公市,東文里,0,1,934,11,945,1369,3,1,3,0,1,0,69.03
澎湖縣,馬公市,案山里,0,1,808,14,822,1125,3,1,3,0,1,0,73.07
澎湖縣,馬公市,光華里,0,1,321,2,323,509,3,1,3,0,1,0,63.46
澎湖縣,馬公市,前寮里,0,1,342,3,345,467,3,1,3,0,1,0,73.88
澎湖縣,馬公市,石泉里,0,1,694,8,702,1026,3,1,3,0,1,0,68.42
澎湖縣,馬公市,菜園里,0,1,247,0,247,330,3,1,3,0,1,0,74.85
澎湖縣,馬公市,東衛里,0,1,768,12,780,1119,3,1,3,0,1,0,69.71
澎湖縣,馬公市,安宅里,0,1,305,5,310,434,3,1,3,0,1,0,71.43
澎湖縣,馬公市,興仁里,0,1,348,7,355,533,3,1,3,0,1,0,66.60
澎湖縣,馬公市,烏崁里,0,1,484,3,487,770,3,1,3,0,1,0,63.25
澎湖縣,馬公市,鐵線里,0,1,242,1,243,323,3,1,3,0,1,0,75.23
澎湖縣,馬公市,鎖港里,0,1,1134,16,1150,1859,3,1,3,0,1,0,61.86
澎湖縣,馬公市,山水里,0,1,821,6,827,1248,3,1,3,0,1,0,66.27
澎湖縣,馬公市,五德里,0,1,113,2,115,171,3,1,3,0,1,0,67.25
澎湖縣,馬公市,井垵里,0,1,215,3,218,321,3,1,3,0,1,0,67.91
澎湖縣,馬公市,時裡里,0,1,799,5,804,967,3,1,3,0,1,0,83.14
澎湖縣,馬公市,風櫃里,0,1,731,17,748,1080,3,1,3,0,1,0,69.26
澎湖縣,馬公市,虎井里,0,1,203,1,204,550,3,1,3,0,1,0,37.09
澎湖縣,馬公市,桶盤里,0,1,54,0,54,147,3,1,3,0,1,0,36.73
澎湖縣,湖西鄉,湖西村,0,1,526,13,539,797,3,1,3,0,1,0,67.63
澎湖縣,湖西鄉,湖東村,0,1,168,4,172,262,3,1,3,0,1,0,65.65
澎湖縣,湖西鄉,青螺村,0,1,130,1,131,210,3,1,3,0,1,0,62.38
澎湖縣,湖西鄉,白坑村,0,1,153,5,158,244,3,1,3,0,1,0,64.75
澎湖縣,湖西鄉,南寮村,0,1,344,3,347,596,3,1,3,0,1,0,58.22
澎湖縣,湖西鄉,北寮村,0,1,179,0,179,264,3,1,3,0,1,0,67.80
澎湖縣,湖西鄉,紅羅村,0,1,339,3,342,507,3,1,3,0,1,0,67.46
澎湖縣,湖西鄉,西溪村,0,1,239,7,246,404,3,1,3,0,1,0,60.89
澎湖縣,湖西鄉,成功村,0,1,263,2,265,384,3,1,3,0,1,0,69.01
澎湖縣,湖西鄉,東石村,0,1,72,1,73,108,3,1,3,0,1,0,67.59
澎湖縣,湖西鄉,沙港村,0,1,454,4,458,733,3,1,3,0,1,0,62.48
澎湖縣,湖西鄉,中西村,0,1,101,1,102,160,3,1,3,0,1,0,63.75
澎湖縣,湖西鄉,鼎灣村,0,1,210,3,213,449,3,1,3,0,1,0,47.44
澎湖縣,湖西鄉,潭邊村,0,1,176,3,179,230,3,1,3,0,1,0,77.83
澎湖縣,湖西鄉,許家村,0,1,115,4,119,186,3,1,3,0,1,0,63.98
澎湖縣,湖西鄉,城北村,0,1,127,1,128,192,3,1,3,0,1,0,66.67
澎湖縣,湖西鄉,太武村,0,1,56,0,56,77,3,1,3,0,1,0,72.73
澎湖縣,湖西鄉,隘門村,0,1,401,4,405,617,3,1,3,0,1,0,65.64
澎湖縣,湖西鄉,林投村,0,1,518,8,526,786,3,1,3,0,1,0,66.92
澎湖縣,湖西鄉,尖山村,0,1,683,9,692,1205,3,1,3,0,1,0,57.43
澎湖縣,湖西鄉,龍門村,0,1,379,4,383,746,3,1,3,0,1,0,51.34
澎湖縣,湖西鄉,果葉村,0,1,354,6,360,608,3,1,3,0,1,0,59.21
澎湖縣,白沙鄉,中屯村,0,1,270,4,274,408,3,1,3,0,1,0,67.16
澎湖縣,白沙鄉,講美村,0,1,337,4,341,485,3,1,3,0,1,0,70.31
澎湖縣,白沙鄉,城前村,0,1,63,0,63,87,3,1,3,0,1,0,72.41
澎湖縣,白沙鄉,鎮海村,0,1,72,0,72,103,3,1,3,0,1,0,69.90
澎湖縣,白沙鄉,港子村,0,1,170,3,173,264,3,1,3,0,1,0,65.53
澎湖縣,白沙鄉,岐頭村,0,1,115,2,117,179,3,1,3,0,1,0,65.36
澎湖縣,白沙鄉,小赤村,0,1,106,2,108,160,3,1,3,0,1,0,67.50
澎湖縣,白沙鄉,赤崁村,0,1,818,9,827,1235,3,1,3,0,1,0,66.96
澎湖縣,白沙鄉,瓦硐村,0,1,178,1,179,276,3,1,3,0,1,0,64.86
澎湖縣,白沙鄉,後寮村,0,1,362,2,364,640,3,1,3,0,1,0,56.88
澎湖縣,白沙鄉,通梁村,0,1,429,3,432,705,3,1,3,0,1,0,61.28
澎湖縣,白沙鄉,吉貝村,0,1,443,5,448,1149,3,1,3,0,1,0,38.99
澎湖縣,白沙鄉,鳥嶼村,0,1,379,2,381,828,3,1,3,0,1,0,46.01
澎湖縣,白沙鄉,員貝村,0,1,85,0,85,180,3,1,3,0,1,0,47.22
澎湖縣,白沙鄉,大倉村,0,1,86,0,86,158,3,1,3,0,1,0,54.43
澎湖縣,西嶼鄉,橫礁村,0,1,122,3,125,230,3,1,3,0,1,0,54.35
澎湖縣,西嶼鄉,合界村,0,1,230,2,232,422,3,1,3,0,1,0,54.98
澎湖縣,西嶼鄉,竹灣村,0,1,438,8,446,793,3,1,3,0,1,0,56.24
澎湖縣,西嶼鄉,小門村,0,1,151,0,151,242,3,1,3,0,1,0,62.40
澎湖縣,西嶼鄉,大池村,0,1,326,6,332,604,3,1,3,0,1,0,54.97
澎湖縣,西嶼鄉,二崁村,0,1,51,1,52,104,3,1,3,0,1,0,50.00
澎湖縣,西嶼鄉,池東村,0,1,310,3,313,498,3,1,3,0,1,0,62.85
澎湖縣,西嶼鄉,池西村,0,1,111,1,112,202,3,1,3,0,1,0,55.45
澎湖縣,西嶼鄉,赤馬村,0,1,315,3,318,618,3,1,3,0,1,0,51.46
澎湖縣,西嶼鄉,內垵村,0,1,669,6,675,1179,3,1,3,0,1,0,57.25
澎湖縣,西嶼鄉,外垵村,0,1,848,7,855,1650,3,1,3,0,1,0,51.82
澎湖縣,望安鄉,東安村,0,1,168,7,175,371,3,1,3,0,1,0,47.17
澎湖縣,望安鄉,西安村,0,1,162,4,166,326,3,1,3,0,1,0,50.92
澎湖縣,望安鄉,中社村,0,1,87,2,89,198,3,1,3,0,1,0,44.95
澎湖縣,望安鄉,水垵村,0,1,95,2,97,228,3,1,3,0,1,0,42.54
澎湖縣,望安鄉,將軍村,0,1,470,6,476,1049,3,1,3,0,1,0,45.38
澎湖縣,望安鄉,東吉村,0,1,16,0,16,66,3,1,3,0,1,0,24.24
澎湖縣,望安鄉,東坪村,0,1,63,1,64,172,3,1,3,0,1,0,37.21
澎湖縣,望安鄉,西坪村,0,1,41,0,41,104,3,1,3,0,1,0,39.42
澎湖縣,望安鄉,花嶼村,0,1,120,1,121,233,3,1,3,0,1,0,51.93
澎湖縣,七美鄉,東湖村,0,1,110,3,113,230,3,1,3,0,1,0,49.13
澎湖縣,七美鄉,西湖村,0,1,178,1,179,373,3,1,3,0,1,0,47.99
澎湖縣,七美鄉,中和村,0,1,207,2,209,422,3,1,3,0,1,0,49.53
澎湖縣,七美鄉,平和村,0,1,95,2,97,220,3,1,3,0,1,0,44.09
澎湖縣,七美鄉,海豐村,0,1,91,0,91,238,3,1,3,0,1,0,38.24
澎湖縣,七美鄉,南港村,0,1,413,8,421,761,3,1,3,0,1,0,55.32
基隆市,中正區,長潭里,0,1,505,11,516,754,3,1,3,0,1,0,68.44
基隆市,中正區,砂子里,0,1,1152,15,1167,1975,3,1,3,0,1,0,59.09
基隆市,中正區,八斗里,0,1,1054,16,1070,1658,3,1,3,0,1,0,64.54
基隆市,中正區,碧砂里,0,1,1668,32,1700,3220,3,1,3,0,1,0,52.80
基隆市,中正區,平寮里,0,1,1073,15,1088,1667,3,1,3,0,1,0,65.27
基隆市,中正區,社寮里,0,1,1384,18,1402,2187,3,1,3,0,1,0,64.11
基隆市,中正區,和憲里,0,1,663,7,670,1033,3,1,3,0,1,0,64.86
基隆市,中正區,海濱里,0,1,671,18,689,1088,3,1,3,0,1,0,63.33
基隆市,中正區,正濱里,0,1,925,15,940,1466,3,1,3,0,1,0,64.12
基隆市,中正區,中正里,0,1,1325,21,1346,2154,3,1,3,0,1,0,62.49
基隆市,中正區,中濱里,0,1,1013,7,1020,1638,3,1,3,0,1,0,62.27
基隆市,中正區,建國里,0,1,1526,18,1544,2285,3,1,3,0,1,0,67.57
基隆市,中正區,砂灣里,0,1,1363,20,1383,2209,3,1,3,0,1,0,62.61
基隆市,中正區,真砂里,0,1,1004,13,1017,1578,3,1,3,0,1,0,64.45
基隆市,中正區,正砂里,0,1,1591,12,1603,2472,3,1,3,0,1,0,64.85
基隆市,中正區,中砂里,0,1,1046,11,1057,1584,3,1,3,0,1,0,66.73
基隆市,中正區,入船里,0,1,958,15,973,1529,3,1,3,0,1,0,63.64
基隆市,中正區,正船里,0,1,1040,11,1051,1667,3,1,3,0,1,0,63.05
基隆市,中正區,中船里,0,1,999,12,1011,1615,3,1,3,0,1,0,62.60
基隆市,中正區,港通里,0,1,915,14,929,1412,3,1,3,0,1,0,65.79
基隆市,中正區,義重里,0,1,829,11,840,1299,3,1,3,0,1,0,64.67
基隆市,中正區,信義里,0,1,788,12,800,1222,3,1,3,0,1,0,65.47
基隆市,中正區,正義里,0,1,974,10,984,1517,3,1,3,0,1,0,64.86
基隆市,中正區,德義里,0,1,618,5,623,912,3,1,3,0,1,0,68.31
基隆市,七堵區,長興里,0,1,2445,39,2484,3910,3,1,3,0,1,0,63.53
基隆市,七堵區,正光里,0,1,1348,26,1374,2051,3,1,3,0,1,0,66.99
基隆市,七堵區,正明里,0,1,1501,27,1528,2296,3,1,3,0,1,0,66.55
基隆市,七堵區,富民里,0,1,2403,33,2436,3640,3,1,3,0,1,0,66.92
基隆市,七堵區,永平里,0,1,1466,15,1481,2251,3,1,3,0,1,0,65.79
基隆市,七堵區,永安里,0,1,1510,25,1535,2276,3,1,3,0,1,0,67.44
基隆市,七堵區,八德里,0,1,931,10,941,1542,3,1,3,0,1,0,61.02
基隆市,七堵區,自強里,0,1,499,6,505,873,3,1,3,0,1,0,57.85
基隆市,七堵區,泰安里,0,1,1414,21,1435,2270,3,1,3,0,1,0,63.22
基隆市,七堵區,六堵里,0,1,650,11,661,1068,3,1,3,0,1,0,61.89
基隆市,七堵區,堵南里,0,1,1573,13,1586,2679,3,1,3,0,1,0,59.20
基隆市,七堵區,堵北里,0,1,1455,35,1490,2442,3,1,3,0,1,0,61.02
基隆市,七堵區,百福里,0,1,2006,31,2037,3382,3,1,3,0,1,0,60.23
基隆市,七堵區,實踐里,0,1,1863,28,1891,3164,3,1,3,0,1,0,59.77
基隆市,七堵區,瑪南里,0,1,285,3,288,432,3,1,3,0,1,0,66.67
基隆市,七堵區,瑪東里,0,1,208,4,212,344,3,1,3,0,1,0,61.63
基隆市,七堵區,瑪西里,0,1,277,2,279,396,3,1,3,0,1,0,70.45
基隆市,七堵區,友一里,0,1,563,5,568,884,3,1,3,0,1,0,64.25
基隆市,七堵區,友二里,0,1,290,0,290,440,3,1,3,0,1,0,65.91
基隆市,暖暖區,八西里,0,1,789,20,809,1267,3,1,3,0,1,0,63.85
基隆市,暖暖區,八中里,0,1,433,13,446,691,3,1,3,0,1,0,64.54
基隆市,暖暖區,八堵里,0,1,622,9,631,943,3,1,3,0,1,0,66.91
基隆市,暖暖區,八南里,0,1,356,4,360,573,3,1,3,0,1,0,62.83
基隆市,暖暖區,過港里,0,1,1773,30,1803,2716,3,1,3,0,1,0,66.38
基隆市,暖暖區,暖暖里,0,1,1243,14,1257,1905,3,1,3,0,1,0,65.98
基隆市,暖暖區,暖同里,0,1,1079,17,1096,1664,3,1,3,0,1,0,65.87
基隆市,暖暖區,暖東里,0,1,272,3,275,396,3,1,3,0,1,0,69.44
基隆市,暖暖區,暖西里,0,1,1879,37,1916,3040,3,1,3,0,1,0,63.03
基隆市,暖暖區,碇內里,0,1,1288,27,1315,1964,3,1,3,0,1,0,66.96
基隆市,暖暖區,碇和里,0,1,1693,21,1714,2619,3,1,3,0,1,0,65.44
基隆市,暖暖區,碇安里,0,1,1928,25,1953,2852,3,1,3,0,1,0,68.48
基隆市,仁愛區,林泉里,0,1,1262,18,1280,1988,3,1,3,0,1,0,64.39
基隆市,仁愛區,花崗里,0,1,762,12,774,1049,3,1,3,0,1,0,73.78
基隆市,仁愛區,虹橋里,0,1,1154,17,1171,1717,3,1,3,0,1,0,68.20
基隆市,仁愛區,水錦里,0,1,1272,21,1293,1934,3,1,3,0,1,0,66.86
基隆市,仁愛區,智仁里,0,1,1714,18,1732,2556,3,1,3,0,1,0,67.76
基隆市,仁愛區,和明里,0,1,882,11,893,1350,3,1,3,0,1,0,66.15
基隆市,仁愛區,忠勇里,0,1,772,10,782,1213,3,1,3,0,1,0,64.47
基隆市,仁愛區,玉田里,0,1,880,7,887,1273,3,1,3,0,1,0,69.68
基隆市,仁愛區,仁德里,0,1,793,7,800,1168,3,1,3,0,1,0,68.49
基隆市,仁愛區,博愛里,0,1,1265,18,1283,1810,3,1,3,0,1,0,70.88
基隆市,仁愛區,福仁里,0,1,632,4,636,976,3,1,3,0,1,0,65.16
基隆市,仁愛區,誠仁里,0,1,727,19,746,1134,3,1,3,0,1,0,65.78
基隆市,仁愛區,吉仁里,0,1,2204,33,2237,3358,3,1,3,0,1,0,66.62
基隆市,仁愛區,育仁里,0,1,591,5,596,922,3,1,3,0,1,0,64.64
基隆市,仁愛區,英仁里,0,1,1072,12,1084,1672,3,1,3,0,1,0,64.83
基隆市,仁愛區,龍門里,0,1,595,14,609,963,3,1,3,0,1,0,63.24
基隆市,仁愛區,德厚里,0,1,913,14,927,1335,3,1,3,0,1,0,69.44
基隆市,仁愛區,曲水里,0,1,735,4,739,1055,3,1,3,0,1,0,70.05
基隆市,仁愛區,崇文里,0,1,653,8,661,1001,3,1,3,0,1,0,66.03
基隆市,仁愛區,文安里,0,1,865,10,875,1288,3,1,3,0,1,0,67.93
基隆市,仁愛區,兆連里,0,1,524,11,535,792,3,1,3,0,1,0,67.55
基隆市,仁愛區,獅球里,0,1,910,8,918,1343,3,1,3,0,1,0,68.35
基隆市,仁愛區,書院里,0,1,913,10,923,1296,3,1,3,0,1,0,71.22
基隆市,仁愛區,朝棟里,0,1,1191,27,1218,1870,3,1,3,0,1,0,65.13
基隆市,仁愛區,光華里,0,1,1403,14,1417,2061,3,1,3,0,1,0,68.75
基隆市,仁愛區,明德里,0,1,584,9,593,840,3,1,3,0,1,0,70.60
基隆市,仁愛區,同風里,0,1,545,7,552,783,3,1,3,0,1,0,70.50
基隆市,仁愛區,文昌里,0,1,665,6,671,953,3,1,3,0,1,0,70.41
基隆市,仁愛區,新店里,0,1,605,14,619,902,3,1,3,0,1,0,68.63
基隆市,中山區,新建里,0,1,647,5,652,937,3,1,3,0,1,0,69.58
基隆市,中山區,安民里,0,1,840,8,848,1255,3,1,3,0,1,0,67.57
基隆市,中山區,安平里,0,1,697,19,716,1046,3,1,3,0,1,0,68.45
基隆市,中山區,中山里,0,1,862,10,872,1276,3,1,3,0,1,0,68.34
基隆市,中山區,民治里,0,1,773,12,785,1202,3,1,3,0,1,0,65.31
基隆市,中山區,中興里,0,1,1047,12,1059,1559,3,1,3,0,1,0,67.93
基隆市,中山區,仁正里,0,1,607,11,618,915,3,1,3,0,1,0,67.54
基隆市,中山區,健民里,0,1,1202,21,1223,1811,3,1,3,0,1,0,67.53
基隆市,中山區,通化里,0,1,938,15,953,1419,3,1,3,0,1,0,67.16
基隆市,中山區,居仁里,0,1,1261,13,1274,2006,3,1,3,0,1,0,63.51
基隆市,中山區,通明里,0,1,1527,32,1559,2226,3,1,3,0,1,0,70.04
基隆市,中山區,和平里,0,1,593,5,598,880,3,1,3,0,1,0,67.95
基隆市,中山區,仙洞里,0,1,542,8,550,897,3,1,3,0,1,0,61.32
基隆市,中山區,太白里,0,1,744,15,759,1108,3,1,3,0,1,0,68.50
基隆市,中山區,協和里,0,1,1162,19,1181,1722,3,1,3,0,1,0,68.58
基隆市,中山區,文化里,0,1,784,16,800,1173,3,1,3,0,1,0,68.20
基隆市,中山區,德安里,0,1,1409,24,1433,2212,3,1,3,0,1,0,64.78
基隆市,中山區,德和里,0,1,2167,33,2200,3160,3,1,3,0,1,0,69.62
基隆市,中山區,中和里,0,1,1624,33,1657,2650,3,1,3,0,1,0,62.53
基隆市,中山區,西康里,0,1,1272,26,1298,2007,3,1,3,0,1,0,64.67
基隆市,中山區,西定里,0,1,760,7,767,1154,3,1,3,0,1,0,66.46
基隆市,中山區,西華里,0,1,802,8,810,1199,3,1,3,0,1,0,67.56
基隆市,中山區,西榮里,0,1,645,8,653,957,3,1,3,0,1,0,68.23
基隆市,安樂區,新西里,0,1,1151,11,1162,1824,3,1,3,0,1,0,63.71
基隆市,安樂區,西川里,0,1,1010,15,1025,1571,3,1,3,0,1,0,65.25
基隆市,安樂區,定國里,0,1,893,13,906,1412,3,1,3,0,1,0,64.16
基隆市,安樂區,定邦里,0,1,965,23,988,1511,3,1,3,0,1,0,65.39
基隆市,安樂區,干城里,0,1,1791,24,1815,2672,3,1,3,0,1,0,67.93
基隆市,安樂區,永康里,0,1,1327,23,1350,2134,3,1,3,0,1,0,63.26
基隆市,安樂區,慈仁里,0,1,713,14,727,1168,3,1,3,0,1,0,62.24
基隆市,安樂區,安和里,0,1,639,8,647,950,3,1,3,0,1,0,68.11
基隆市,安樂區,樂一里,0,1,608,19,627,853,3,1,3,0,1,0,73.51
基隆市,安樂區,嘉仁里,0,1,2183,30,2213,3445,3,1,3,0,1,0,64.24
基隆市,安樂區,鶯歌里,0,1,1706,14,1720,2574,3,1,3,0,1,0,66.82
基隆市,安樂區,七賢里,0,1,1993,26,2019,3055,3,1,3,0,1,0,66.09
基隆市,安樂區,三民里,0,1,2330,35,2365,3475,3,1,3,0,1,0,68.06
基隆市,安樂區,四維里,0,1,1024,17,1041,1514,3,1,3,0,1,0,68.76
基隆市,安樂區,五福里,0,1,2368,51,2419,3518,3,1,3,0,1,0,68.76
基隆市,安樂區,六合里,0,1,2324,24,2348,3523,3,1,3,0,1,0,66.65
基隆市,安樂區,外寮里,0,1,1642,29,1671,2774,3,1,3,0,1,0,60.24
基隆市,安樂區,新崙里,0,1,1701,28,1729,2872,3,1,3,0,1,0,60.20
基隆市,安樂區,中崙里,0,1,631,10,641,1081,3,1,3,0,1,0,59.30
基隆市,安樂區,內寮里,0,1,1316,18,1334,2193,3,1,3,0,1,0,60.83
基隆市,信義區,仁壽里,0,1,853,11,864,1264,3,1,3,0,1,0,68.35
基隆市,信義區,仁義里,0,1,978,13,991,1333,3,1,3,0,1,0,74.34
基隆市,信義區,義昭里,0,1,839,5,844,1222,3,1,3,0,1,0,69.07
基隆市,信義區,義幸里,0,1,1834,26,1860,2556,3,1,3,0,1,0,72.77
基隆市,信義區,義民里,0,1,620,7,627,896,3,1,3,0,1,0,69.98
基隆市,信義區,義和里,0,1,1012,14,1026,1495,3,1,3,0,1,0,68.63
基隆市,信義區,智慧里,0,1,585,7,592,826,3,1,3,0,1,0,71.67
基隆市,信義區,智誠里,0,1,1321,17,1338,1909,3,1,3,0,1,0,70.09
基隆市,信義區,禮儀里,0,1,1079,14,1093,1592,3,1,3,0,1,0,68.66
基隆市,信義區,禮東里,0,1,1139,12,1151,1694,3,1,3,0,1,0,67.95
基隆市,信義區,信綠里,0,1,1651,17,1668,2412,3,1,3,0,1,0,69.15
基隆市,信義區,東信里,0,1,1414,16,1430,2172,3,1,3,0,1,0,65.84
基隆市,信義區,東光里,0,1,1142,13,1155,1660,3,1,3,0,1,0,69.58
基隆市,信義區,東明里,0,1,1708,32,1740,2760,3,1,3,0,1,0,63.04
基隆市,信義區,東安里,0,1,1887,30,1917,2766,3,1,3,0,1,0,69.31
基隆市,信義區,孝深里,0,1,2465,33,2498,3821,3,1,3,0,1,0,65.38
基隆市,信義區,孝岡里,0,1,456,4,460,748,3,1,3,0,1,0,61.50
新竹市,東區,育賢里,0,1,661,4,665,1121,3,1,3,0,1,0,59.32
新竹市,東區,親仁里,0,1,1172,11,1183,1914,3,1,3,0,1,0,61.81
新竹市,東區,東門里,0,1,528,5,533,884,3,1,3,0,1,0,60.29
新竹市,東區,成功里,0,1,491,4,495,873,3,1,3,0,1,0,56.70
新竹市,東區,榮光里,0,1,329,3,332,584,3,1,3,0,1,0,56.85
新竹市,東區,中正里,0,1,350,2,352,630,3,1,3,0,1,0,55.87
新竹市,東區,錦華里,0,1,1208,15,1223,1870,3,1,3,0,1,0,65.40
新竹市,東區,文華里,0,1,1765,25,1790,2883,3,1,3,0,1,0,62.09
新竹市,東區,復中里,0,1,1841,19,1860,3096,3,1,3,0,1,0,60.08
新竹市,東區,復興里,0,1,1391,20,1411,2388,3,1,3,0,1,0,59.09
新竹市,東區,三民里,0,1,2172,24,2196,3560,3,1,3,0,1,0,61.69
新竹市,東區,東園里,0,1,1144,10,1154,1869,3,1,3,0,1,0,61.74
新竹市,東區,公園里,0,1,1068,8,1076,1805,3,1,3,0,1,0,59.61
新竹市,東區,建華里,0,1,1240,11,1251,2108,3,1,3,0,1,0,59.35
新竹市,東區,東山里,0,1,1678,16,1694,2769,3,1,3,0,1,0,61.18
新竹市,東區,綠水里,0,1,2404,26,2430,3844,3,1,3,0,1,0,63.22
新竹市,東區,光復里,0,1,901,12,913,1620,3,1,3,0,1,0,56.36
新竹市,東區,東勢里,0,1,584,6,590,984,3,1,3,0,1,0,59.96
新竹市,東區,前溪里,0,1,1153,35,1188,2204,3,1,3,0,1,0,53.90
新竹市,東區,水源里,0,1,1660,29,1689,2803,3,1,3,0,1,0,60.26
新竹市,東區,千甲里,0,1,867,26,893,1394,3,1,3,0,1,0,64.06
新竹市,東區,豐功里,0,1,1743,22,1765,2713,3,1,3,0,1,0,65.06
新竹市,東區,偉功里,0,1,519,4,523,785,3,1,3,0,1,0,66.62
新竹市,東區,武功里,0,1,320,6,326,539,3,1,3,0,1,0,60.48
新竹市,東區,軍功里,0,1,1972,23,1995,2947,3,1,3,0,1,0,67.70
新竹市,東區,立功里,0,1,833,14,847,1249,3,1,3,0,1,0,67.81
新竹市,東區,建功里,0,1,1633,17,1650,2344,3,1,3,0,1,0,70.39
新竹市,東區,光明里,0,1,1576,10,1586,2491,3,1,3,0,1,0,63.67
新竹市,東區,龍山里,0,1,1259,14,1273,1997,3,1,3,0,1,0,63.75
新竹市,東區,科園里,0,1,2789,27,2816,4224,3,1,3,0,1,0,66.67
新竹市,東區,埔頂里,0,1,985,23,1008,1730,3,1,3,0,1,0,58.27
新竹市,東區,新莊里,0,1,2204,33,2237,3661,3,1,3,0,1,0,61.10
新竹市,東區,關東里,0,1,1867,27,1894,3129,3,1,3,0,1,0,60.53
新竹市,東區,金山里,0,1,1478,14,1492,2327,3,1,3,0,1,0,64.12
新竹市,東區,仙水里,0,1,1396,13,1409,2279,3,1,3,0,1,0,61.83
新竹市,東區,仙宮里,0,1,297,5,302,532,3,1,3,0,1,0,56.77
新竹市,東區,關帝里,0,1,365,6,371,668,3,1,3,0,1,0,55.54
新竹市,東區,南門里,0,1,410,5,415,690,3,1,3,0,1,0,60.14
新竹市,東區,南市里,0,1,569,11,580,981,3,1,3,0,1,0,59.12
新竹市,東區,福德里,0,1,733,12,745,1248,3,1,3,0,1,0,59.70
新竹市,東區,振興里,0,1,1946,25,1971,3488,3,1,3,0,1,0,56.51
新竹市,東區,新興里,0,1,1798,31,1829,3126,3,1,3,0,1,0,58.51
新竹市,東區,寺前里,0,1,466,6,472,862,3,1,3,0,1,0,54.76
新竹市,東區,竹蓮里,0,1,530,5,535,896,3,1,3,0,1,0,59.71
新竹市,東區,下竹里,0,1,809,14,823,1305,3,1,3,0,1,0,63.07
新竹市,東區,頂竹里,0,1,1766,16,1782,3113,3,1,3,0,1,0,57.24
新竹市,東區,南大里,0,1,880,14,894,1679,3,1,3,0,1,0,53.25
新竹市,東區,新光里,0,1,1353,19,1372,2359,3,1,3,0,1,0,58.16
新竹市,東區,光鎮里,0,1,1499,25,1524,2621,3,1,3,0,1,0,58.15
新竹市,東區,高峰里,0,1,2299,28,2327,4071,3,1,3,0,1,0,57.16
新竹市,東區,柴橋里,0,1,2873,33,2906,5180,3,1,3,0,1,0,56.10
新竹市,北區,西門里,0,1,314,3,317,558,3,1,3,0,1,0,56.81
新竹市,北區,仁德里,0,1,446,2,448,771,3,1,3,0,1,0,58.11
新竹市,北區,中央里,0,1,359,2,361,601,3,1,3,0,1,0,60.07
新竹市,北區,石坊里,0,1,298,4,302,499,3,1,3,0,1,0,60.52
新竹市,北區,潛園里,0,1,524,11,535,938,3,1,3,0,1,0,57.04
新竹市,北區,崇禮里,0,1,699,7,706,1112,3,1,3,0,1,0,63.49
新竹市,北區,興南里,0,1,809,8,817,1374,3,1,3,0,1,0,59.46
新竹市,北區,育英里,0,1,2160,31,2191,3781,3,1,3,0,1,0,57.95
新竹市,北區,曲溪里,0,1,3350,63,3413,5343,3,1,3,0,1,0,63.88
新竹市,北區,西雅里,0,1,1369,17,1386,2450,3,1,3,0,1,0,56.57
新竹市,北區,客雅里,0,1,1979,20,1999,3194,3,1,3,0,1,0,62.59
新竹市,北區,南勢里,0,1,1858,28,1886,3095,3,1,3,0,1,0,60.94
新竹市,北區,大鵬里,0,1,1278,16,1294,1691,3,1,3,0,1,0,76.52
新竹市,北區,大同里,0,1,511,4,515,862,3,1,3,0,1,0,59.74
新竹市,北區,中山里,0,1,423,3,426,696,3,1,3,0,1,0,61.21
新竹市,北區,中興里,0,1,335,6,341,625,3,1,3,0,1,0,54.56
新竹市,北區,新民里,0,1,731,14,745,1299,3,1,3,0,1,0,57.35
新竹市,北區,長和里,0,1,582,10,592,960,3,1,3,0,1,0,61.67
新竹市,北區,北門里,0,1,578,5,583,995,3,1,3,0,1,0,58.59
新竹市,北區,民富里,0,1,2089,23,2112,3965,3,1,3,0,1,0,53.27
新竹市,北區,磐石里,0,1,1702,23,1725,3075,3,1,3,0,1,0,56.10
新竹市,北區,新雅里,0,1,1897,27,1924,3277,3,1,3,0,1,0,58.71
新竹市,北區,文雅里,0,1,1666,22,1688,2717,3,1,3,0,1,0,62.13
新竹市,北區,水田里,0,1,1328,12,1340,2255,3,1,3,0,1,0,59.42
新竹市,北區,光田里,0,1,1213,24,1237,2051,3,1,3,0,1,0,60.31
新竹市,北區,光華里,0,1,1281,15,1296,2322,3,1,3,0,1,0,55.81
新竹市,北區,金華里,0,1,1473,16,1489,2611,3,1,3,0,1,0,57.03
新竹市,北區,湳雅里,0,1,2299,37,2336,4017,3,1,3,0,1,0,58.15
新竹市,北區,舊社里,0,1,1770,27,1797,2961,3,1,3,0,1,0,60.69
新竹市,北區,金竹里,0,1,1688,19,1707,2865,3,1,3,0,1,0,59.58
新竹市,北區,武陵里,0,1,782,6,788,1147,3,1,3,0,1,0,68.70
新竹市,北區,福林里,0,1,1573,29,1602,2603,3,1,3,0,1,0,61.54
新竹市,北區,境福里,0,1,1653,28,1681,2893,3,1,3,0,1,0,58.11
新竹市,北區,士林里,0,1,1937,15,1952,2927,3,1,3,0,1,0,66.69
新竹市,北區,古賢里,0,1,430,12,442,757,3,1,3,0,1,0,58.39
新竹市,北區,南寮里,0,1,1562,22,1584,3132,3,1,3,0,1,0,50.57
新竹市,北區,康樂里,0,1,739,8,747,1240,3,1,3,0,1,0,60.24
新竹市,北區,中寮里,0,1,503,9,512,847,3,1,3,0,1,0,60.45
新竹市,北區,海濱里,0,1,628,10,638,1185,3,1,3,0,1,0,53.84
新竹市,北區,港北里,0,1,567,7,574,1014,3,1,3,0,1,0,56.61
新竹市,北區,舊港里,0,1,314,4,318,516,3,1,3,0,1,0,61.63
新竹市,香山區,頂埔里,0,1,2406,33,2439,4176,3,1,3,0,1,0,58.41
新竹市,香山區,中埔里,0,1,1064,16,1080,1824,3,1,3,0,1,0,59.21
新竹市,香山區,牛埔里,0,1,742,10,752,1350,3,1,3,0,1,0,55.70
新竹市,香山區,埔前里,0,1,1125,10,1135,2004,3,1,3,0,1,0,56.64
新竹市,香山區,樹下里,0,1,906,10,916,1574,3,1,3,0,1,0,58.20
新竹市,香山區,浸水里,0,1,719,15,734,1293,3,1,3,0,1,0,56.77
新竹市,香山區,虎林里,0,1,845,10,855,1445,3,1,3,0,1,0,59.17
新竹市,香山區,虎山里,0,1,1867,27,1894,3655,3,1,3,0,1,0,51.82
新竹市,香山區,港南里,0,1,887,12,899,1560,3,1,3,0,1,0,57.63
新竹市,香山區,東香里,0,1,528,4,532,1044,3,1,3,0,1,0,50.96
新竹市,香山區,香村里,0,1,764,14,778,1484,3,1,3,0,1,0,52.43
新竹市,香山區,香山里,0,1,1272,15,1287,2258,3,1,3,0,1,0,57.00
新竹市,香山區,大庄里,0,1,890,10,900,1549,3,1,3,0,1,0,58.10
新竹市,香山區,美山里,0,1,475,3,478,884,3,1,3,0,1,0,54.07
新竹市,香山區,朝山里,0,1,798,11,809,1427,3,1,3,0,1,0,56.69
新竹市,香山區,海山里,0,1,722,20,742,1293,3,1,3,0,1,0,57.39
新竹市,香山區,鹽水里,0,1,555,4,559,935,3,1,3,0,1,0,59.79
新竹市,香山區,內湖里,0,1,1380,22,1402,2601,3,1,3,0,1,0,53.90
新竹市,香山區,南港里,0,1,421,4,425,677,3,1,3,0,1,0,62.78
新竹市,香山區,中隘里,0,1,604,14,618,1053,3,1,3,0,1,0,58.69
新竹市,香山區,南隘里,0,1,347,5,352,577,3,1,3,0,1,0,61.01
新竹市,香山區,大湖里,0,1,384,10,394,643,3,1,3,0,1,0,61.28
新竹市,香山區,茄苳里,0,1,330,8,338,654,3,1,3,0,1,0,51.68
臺中市,中區,中山里,0,1,602,7,609,966,3,1,3,0,1,0,63.04
臺中市,中區,南京里,0,1,678,3,681,1083,3,1,3,0,1,0,62.88
臺中市,中區,繼光里,0,1,784,4,788,1296,3,1,3,0,1,0,60.80
臺中市,中區,自由里,0,1,950,10,960,1584,3,1,3,0,1,0,60.61
臺中市,中區,重慶里,0,1,647,6,653,993,3,1,3,0,1,0,65.76
臺中市,中區,錦上里,0,1,945,10,955,1390,3,1,3,0,1,0,68.71
臺中市,中區,錦花里,0,1,835,1,836,1310,3,1,3,0,1,0,63.82
臺中市,中區,大墩里,0,1,944,7,951,1442,3,1,3,0,1,0,65.95
臺中市,中區,中墩里,0,1,765,15,780,1238,3,1,3,0,1,0,63.00
臺中市,中區,正音里,0,1,745,10,755,1114,3,1,3,0,1,0,67.77
臺中市,中區,柳原里,0,1,733,10,743,1125,3,1,3,0,1,0,66.04
臺中市,中區,光音里,0,1,807,12,819,1307,3,1,3,0,1,0,62.66
臺中市,中區,博松里,0,1,903,7,910,1301,3,1,3,0,1,0,69.95
臺中市,中區,中政里,0,1,754,17,771,1267,3,1,3,0,1,0,60.85
臺中市,東區,新庄里,0,1,734,7,741,1123,3,1,3,0,1,0,65.98
臺中市,東區,立德里,0,1,428,6,434,624,3,1,3,0,1,0,69.55
臺中市,東區,朱文里,0,1,646,6,652,998,3,1,3,0,1,0,65.33
臺中市,東區,翰第里,0,1,669,6,675,1044,3,1,3,0,1,0,64.66
臺中市,東區,振興里,0,1,783,10,793,1283,3,1,3,0,1,0,61.81
臺中市,東區,曙峰里,0,1,762,7,769,1178,3,1,3,0,1,0,65.28
臺中市,東區,頂峰里,0,1,878,6,884,1298,3,1,3,0,1,0,68.10
臺中市,東區,忠孝里,0,1,663,7,670,992,3,1,3,0,1,0,67.54
臺中市,東區,東橋里,0,1,2224,26,2250,3549,3,1,3,0,1,0,63.40
臺中市,東區,東興里,0,1,1293,19,1312,1931,3,1,3,0,1,0,67.94
臺中市,東區,樂業里,0,1,689,14,703,1014,3,1,3,0,1,0,69.33
臺中市,東區,泉源里,0,1,634,7,641,916,3,1,3,0,1,0,69.98
臺中市,東區,文化里,0,1,767,9,776,1213,3,1,3,0,1,0,63.97
臺中市,東區,干城里,0,1,540,5,545,842,3,1,3,0,1,0,64.73
臺中市,東區,旱溪里,0,1,709,8,717,1070,3,1,3,0,1,0,67.01
臺中市,東區,樂成里,0,1,950,14,964,1384,3,1,3,0,1,0,69.65
臺中市,東區,東門里,0,1,2450,32,2482,3657,3,1,3,0,1,0,67.87
臺中市,東區,東信里,0,1,3363,46,3409,5322,3,1,3,0,1,0,64.05
臺中市,東區,十甲里,0,1,2030,22,2052,3108,3,1,3,0,1,0,66.02
臺中市,東區,東南里,0,1,1045,10,1055,1671,3,1,3,0,1,0,63.14
臺中市,東區,東明里,0,1,540,5,545,884,3,1,3,0,1,0,61.65
臺中市,東區,東勢里,0,1,1617,25,1642,2533,3,1,3,0,1,0,64.82
臺中市,東區,成功里,0,1,586,5,591,921,3,1,3,0,1,0,64.17
臺中市,東區,合作里,0,1,2012,36,2048,3016,3,1,3,0,1,0,67.90
臺中市,東區,尚武里,0,1,672,9,681,967,3,1,3,0,1,0,70.42
臺中市,東區,富台里,0,1,439,4,443,756,3,1,3,0,1,0,58.60
臺中市,東區,富仁里,0,1,1525,28,1553,2450,3,1,3,0,1,0,63.39
臺中市,東區,祖聖里,0,1,970,10,980,1483,3,1,3,0,1,0,66.08
臺中市,西區,福壽里,0,1,1053,11,1064,1538,3,1,3,0,1,0,69.18
臺中市,西區,光明里,0,1,727,6,733,1107,3,1,3,0,1,0,66.21
臺中市,西區,利民里,0,1,1356,9,1365,2396,3,1,3,0,1,0,56.97
臺中市,西區,平和里,0,1,993,4,997,1522,3,1,3,0,1,0,65.51
臺中市,西區,公民里,0,1,2285,16,2301,3577,3,1,3,0,1,0,64.33
臺中市,西區,中民里,0,1,1089,8,1097,1550,3,1,3,0,1,0,70.77
臺中市,西區,藍興里,0,1,1555,19,1574,2278,3,1,3,0,1,0,69.10
臺中市,西區,公舘里,0,1,2587,42,2629,3794,3,1,3,0,1,0,69.29
臺中市,西區,元龍里,0,1,554,6,560,856,3,1,3,0,1,0,65.42
臺中市,西區,和龍里,0,1,963,12,975,1571,3,1,3,0,1,0,62.06
臺中市,西區,三民里,0,1,1631,11,1642,2522,3,1,3,0,1,0,65.11
臺中市,西區,東昇里,0,1,1095,7,1102,1681,3,1,3,0,1,0,65.56
臺中市,西區,廣民里,0,1,953,6,959,1444,3,1,3,0,1,0,66.41
臺中市,西區,民龍里,0,1,1145,10,1155,1791,3,1,3,0,1,0,64.49
臺中市,西區,福龍里,0,1,909,4,913,1381,3,1,3,0,1,0,66.11
臺中市,西區,靖龍里,0,1,1122,8,1130,1813,3,1,3,0,1,0,62.33
臺中市,西區,雲龍里,0,1,1259,10,1269,1974,3,1,3,0,1,0,64.29
臺中市,西區,永龍里,0,1,648,7,655,891,3,1,3,0,1,0,73.51
臺中市,西區,安龍里,0,1,1302,14,1316,2050,3,1,3,0,1,0,64.20
臺中市,西區,吉龍里,0,1,2754,30,2784,4279,3,1,3,0,1,0,65.06
臺中市,西區,昇平里,0,1,2112,18,2130,3331,3,1,3,0,1,0,63.94
臺中市,西區,忠明里,0,1,2488,30,2518,3978,3,1,3,0,1,0,63.30
臺中市,西區,忠誠里,0,1,2993,18,3011,4659,3,1,3,0,1,0,64.63
臺中市,西區,公正里,0,1,4845,63,4908,7680,3,1,3,0,1,0,63.91
臺中市,西區,公益里,0,1,1699,28,1727,2505,3,1,3,0,1,0,68.94
臺中市,西區,中興里,0,1,1887,19,1906,2814,3,1,3,0,1,0,67.73
臺中市,西區,土庫里,0,1,3707,40,3747,5721,3,1,3,0,1,0,65.50
臺中市,南區,南興里,0,1,488,4,492,750,3,1,3,0,1,0,65.60
臺中市,南區,正義里,0,1,543,8,551,865,3,1,3,0,1,0,63.70
臺中市,南區,民主里,0,1,650,5,655,995,3,1,3,0,1,0,65.83
臺中市,南區,復興里,0,1,1074,11,1085,1579,3,1,3,0,1,0,68.71
臺中市,南區,萬安里,0,1,772,11,783,1159,3,1,3,0,1,0,67.56
臺中市,南區,信義里,0,1,698,9,707,1059,3,1,3,0,1,0,66.76
臺中市,南區,城隍里,0,1,939,5,944,1488,3,1,3,0,1,0,63.44
臺中市,南區,中南里,0,1,744,3,747,1147,3,1,3,0,1,0,65.13
臺中市,南區,國光里,0,1,2018,22,2040,3181,3,1,3,0,1,0,64.13
臺中市,南區,南門里,0,1,1919,17,1936,3020,3,1,3,0,1,0,64.11
臺中市,南區,德義里,0,1,1394,16,1410,2051,3,1,3,0,1,0,68.75
臺中市,南區,積善里,0,1,1598,30,1628,2675,3,1,3,0,1,0,60.86
臺中市,南區,江川里,0,1,1159,12,1171,1720,3,1,3,0,1,0,68.08
臺中市,南區,新榮里,0,1,808,5,813,1270,3,1,3,0,1,0,64.02
臺中市,南區,福興里,0,1,1473,13,1486,2219,3,1,3,0,1,0,66.97
臺中市,南區,福平里,0,1,3571,42,3613,5696,3,1,3,0,1,0,63.43
臺中市,南區,和平里,0,1,3110,44,3154,4902,3,1,3,0,1,0,64.34
臺中市,南區,永興里,0,1,2517,25,2542,4208,3,1,3,0,1,0,60.41
臺中市,南區,樹義里,0,1,2902,36,2938,4683,3,1,3,0,1,0,62.74
臺中市,南區,樹德里,0,1,1188,14,1202,1892,3,1,3,0,1,0,63.53
臺中市,南區,西川里,0,1,2950,41,2991,4605,3,1,3,0,1,0,64.95
臺中市,北區,高風里,0,1,1038,10,1048,1496,3,1,3,0,1,0,70.05
臺中市,北區,高平里,0,1,579,7,586,882,3,1,3,0,1,0,66.44
臺中市,北區,大安里,0,1,710,8,718,1075,3,1,3,0,1,0,66.79
臺中市,北區,光榮里,0,1,504,9,513,893,3,1,3,0,1,0,57.45
臺中市,北區,光大里,0,1,1227,17,1244,1934,3,1,3,0,1,0,64.32
臺中市,北區,文莊里,0,1,1242,16,1258,1994,3,1,3,0,1,0,63.09
臺中市,北區,湖北里,0,1,658,11,669,1082,3,1,3,0,1,0,61.83
臺中市,北區,中湖里,0,1,487,7,494,709,3,1,3,0,1,0,69.68
臺中市,北區,平等里,0,1,615,3,618,980,3,1,3,0,1,0,63.06
臺中市,北區,五常里,0,1,951,13,964,1563,3,1,3,0,1,0,61.68
臺中市,北區,仁和里,0,1,556,8,564,837,3,1,3,0,1,0,67.38
臺中市,北區,錦和里,0,1,673,11,684,1030,3,1,3,0,1,0,66.41
臺中市,北區,新興里,0,1,775,6,781,1251,3,1,3,0,1,0,62.43
臺中市,北區,武順里,0,1,611,5,616,1000,3,1,3,0,1,0,61.60
臺中市,北區,新北里,0,1,1543,19,1562,2422,3,1,3,0,1,0,64.49
臺中市,北區,樂英里,0,1,2241,18,2259,3316,3,1,3,0,1,0,68.12
臺中市,北區,錦村里,0,1,2021,12,2033,3059,3,1,3,0,1,0,66.46
臺中市,北區,建成里,0,1,3889,51,3940,6207,3,1,3,0,1,0,63.48
臺中市,北區,錦洲里,0,1,1851,13,1864,2840,3,1,3,0,1,0,65.63
臺中市,北區,錦祥里,0,1,1757,12,1769,2983,3,1,3,0,1,0,59.30
臺中市,北區,金華里,0,1,1017,8,1025,1553,3,1,3,0,1,0,66.00
臺中市,北區,金龍里,0,1,2681,22,2703,4199,3,1,3,0,1,0,64.37
臺中市,北區,邱厝里,0,1,1313,7,1320,2235,3,1,3,0,1,0,59.06
臺中市,北區,建興里,0,1,2834,28,2862,4533,3,1,3,0,1,0,63.14
臺中市,北區,頂厝里,0,1,2964,28,2992,4711,3,1,3,0,1,0,63.51
臺中市,北區,賴厝里,0,1,2155,20,2175,3264,3,1,3,0,1,0,66.64
臺中市,北區,賴明里,0,1,2293,23,2316,3663,3,1,3,0,1,0,63.23
臺中市,北區,賴興里,0,1,2775,34,2809,4649,3,1,3,0,1,0,60.42
臺中市,北區,賴村里,0,1,2046,30,2076,3297,3,1,3,0,1,0,62.97
臺中市,北區,育德里,0,1,1733,20,1753,2792,3,1,3,0,1,0,62.79
臺中市,北區,淡溝里,0,1,1959,21,1980,3143,3,1,3,0,1,0,63.00
臺中市,北區,健行里,0,1,3247,32,3279,5036,3,1,3,0,1,0,65.11
臺中市,北區,明德里,0,1,3533,34,3567,5629,3,1,3,0,1,0,63.37
臺中市,北區,長青里,0,1,3808,31,3839,6325,3,1,3,0,1,0,60.70
臺中市,北區,中達里,0,1,1650,13,1663,2663,3,1,3,0,1,0,62.45
臺中市,西屯區,西安里,0,1,2995,26,3021,4406,3,1,3,0,1,0,68.57
臺中市,西屯區,西平里,0,1,2359,35,2394,3523,3,1,3,0,1,0,67.95
臺中市,西屯區,西墩里,0,1,2237,25,2262,3193,3,1,3,0,1,0,70.84
臺中市,西屯區,潮洋里,0,1,741,10,751,1052,3,1,3,0,1,0,71.39
臺中市,西屯區,龍潭里,0,1,676,10,686,883,3,1,3,0,1,0,77.69
臺中市,西屯區,惠來里,0,1,2058,27,2085,2974,3,1,3,0,1,0,70.11
臺中市,西屯區,上石里,0,1,2980,32,3012,4600,3,1,3,0,1,0,65.48
臺中市,西屯區,逢甲里,0,1,3516,39,3555,5263,3,1,3,0,1,0,67.55
臺中市,西屯區,鵬程里,0,1,1489,20,1509,1944,3,1,3,0,1,0,77.62
臺中市,西屯區,何厝里,0,1,2856,24,2880,4555,3,1,3,0,1,0,63.23
臺中市,西屯區,何南里,0,1,2873,36,2909,4345,3,1,3,0,1,0,66.95
臺中市,西屯區,何安里,0,1,2210,21,2231,3296,3,1,3,0,1,0,67.69
臺中市,西屯區,何仁里,0,1,2404,23,2427,3733,3,1,3,0,1,0,65.01
臺中市,西屯區,何德里,0,1,2767,21,2788,4251,3,1,3,0,1,0,65.58
臺中市,西屯區,何源里,0,1,2297,24,2321,3618,3,1,3,0,1,0,64.15
臺中市,西屯區,大河里,0,1,2104,29,2133,3081,3,1,3,0,1,0,69.23
臺中市,西屯區,大石里,0,1,782,8,790,1019,3,1,3,0,1,0,77.53
臺中市,西屯區,大福里,0,1,1895,30,1925,2672,3,1,3,0,1,0,72.04
臺中市,西屯區,大鵬里,0,1,2439,20,2459,3704,3,1,3,0,1,0,66.39
臺中市,西屯區,港尾里,0,1,2878,37,2915,3961,3,1,3,0,1,0,73.59
臺中市,西屯區,廣福里,0,1,1255,22,1277,1773,3,1,3,0,1,0,72.02
臺中市,西屯區,林厝里,0,1,1379,27,1406,2019,3,1,3,0,1,0,69.64
臺中市,西屯區,永安里,0,1,1965,19,1984,3011,3,1,3,0,1,0,65.89
臺中市,西屯區,福安里,0,1,7786,76,7862,12585,3,1,3,0,1,0,62.47
臺中市,西屯區,協和里,0,1,1540,24,1564,2355,3,1,3,0,1,0,66.41
臺中市,南屯區,南屯里,0,1,2381,43,2424,3400,3,1,3,0,1,0,71.29
臺中市,南屯區,豐樂里,0,1,1936,25,1961,2882,3,1,3,0,1,0,68.04
臺中市,南屯區,楓樹里,0,1,2174,29,2203,3185,3,1,3,0,1,0,69.17
臺中市,南屯區,中和里,0,1,2203,31,2234,3134,3,1,3,0,1,0,71.28
臺中市,南屯區,鎮平里,0,1,1090,17,1107,1498,3,1,3,0,1,0,73.90
臺中市,南屯區,永定里,0,1,1493,15,1508,2304,3,1,3,0,1,0,65.45
臺中市,南屯區,春社里,0,1,2560,35,2595,4999,3,1,3,0,1,0,51.91
臺中市,南屯區,春安里,0,1,1693,22,1715,2201,3,1,3,0,1,0,77.92
臺中市,南屯區,文山里,0,1,2885,36,2921,4424,3,1,3,0,1,0,66.03
臺中市,南屯區,新生里,0,1,896,15,911,1219,3,1,3,0,1,0,74.73
臺中市,南屯區,三厝里,0,1,2130,15,2145,3232,3,1,3,0,1,0,66.37
臺中市,南屯區,黎明里,0,1,1000,7,1007,1345,3,1,3,0,1,0,74.87
臺中市,南屯區,黎光里,0,1,1631,12,1643,2366,3,1,3,0,1,0,69.44
臺中市,南屯區,田心里,0,1,4822,47,4869,7309,3,1,3,0,1,0,66.62
臺中市,南屯區,大同里,0,1,3771,47,3818,5843,3,1,3,0,1,0,65.34
臺中市,南屯區,溝墘里,0,1,4137,25,4162,6272,3,1,3,0,1,0,66.36
臺中市,北屯區,北屯里,0,1,3144,29,3173,4816,3,1,3,0,1,0,65.88
臺中市,北屯區,北興里,0,1,2073,19,2092,2997,3,1,3,0,1,0,69.80
臺中市,北屯區,三光里,0,1,4812,65,4877,7652,3,1,3,0,1,0,63.73
臺中市,北屯區,平田里,0,1,4428,40,4468,7072,3,1,3,0,1,0,63.18
臺中市,北屯區,平和里,0,1,2939,25,2964,4786,3,1,3,0,1,0,61.93
臺中市,北屯區,平安里,0,1,2250,31,2281,3540,3,1,3,0,1,0,64.44
臺中市,北屯區,平順里,0,1,3178,44,3222,5017,3,1,3,0,1,0,64.22
臺中市,北屯區,平德里,0,1,2043,26,2069,3207,3,1,3,0,1,0,64.52
臺中市,北屯區,東光里,0,1,1757,16,1773,2721,3,1,3,0,1,0,65.16
臺中市,北屯區,舊社里,0,1,2479,34,2513,3957,3,1,3,0,1,0,63.51
臺中市,北屯區,水景里,0,1,2975,42,3017,4635,3,1,3,0,1,0,65.09
臺中市,北屯區,軍功里,0,1,3463,50,3513,5398,3,1,3,0,1,0,65.08
臺中市,北屯區,和平里,0,1,2625,31,2656,3827,3,1,3,0,1,0,69.40
臺中市,北屯區,東山里,0,1,942,11,953,1401,3,1,3,0,1,0,68.02
臺中市,北屯區,民政里,0,1,536,4,540,859,3,1,3,0,1,0,62.86
臺中市,北屯區,廍子里,0,1,1196,32,1228,1825,3,1,3,0,1,0,67.29
臺中市,北屯區,大坑里,0,1,840,8,848,1255,3,1,3,0,1,0,67.57
臺中市,北屯區,民德里,0,1,464,7,471,693,3,1,3,0,1,0,67.97
臺中市,北屯區,松竹里,0,1,2178,27,2205,3394,3,1,3,0,1,0,64.97
臺中市,北屯區,松安里,0,1,3729,36,3765,6038,3,1,3,0,1,0,62.36
臺中市,北屯區,松茂里,0,1,4350,48,4398,6773,3,1,3,0,1,0,64.93
臺中市,北屯區,仁和里,0,1,3832,29,3861,5583,3,1,3,0,1,0,69.16
臺中市,北屯區,仁美里,0,1,3376,40,3416,4734,3,1,3,0,1,0,72.16
臺中市,北屯區,四民里,0,1,723,10,733,1021,3,1,3,0,1,0,71.79
臺中市,北屯區,同榮里,0,1,2981,29,3010,4386,3,1,3,0,1,0,68.63
臺中市,北屯區,后庄里,0,1,2636,31,2667,3868,3,1,3,0,1,0,68.95
臺中市,北屯區,陳平里,0,1,3266,32,3298,5174,3,1,3,0,1,0,63.74
臺中市,北屯區,大德里,0,1,2350,21,2371,3459,3,1,3,0,1,0,68.55
臺中市,北屯區,新平里,0,1,2785,40,2825,4121,3,1,3,0,1,0,68.55
臺中市,北屯區,仁愛里,0,1,620,4,624,857,3,1,3,0,1,0,72.81
臺中市,北屯區,水湳里,0,1,3291,41,3332,5026,3,1,3,0,1,0,66.30
嘉義市,東區,短竹里,0,1,2345,14,2359,3244,3,1,3,0,1,0,72.72
嘉義市,東區,東川里,0,1,1778,10,1788,2437,3,1,3,0,1,0,73.37
嘉義市,東區,鹿寮里,0,1,428,3,431,590,3,1,3,0,1,0,73.05
嘉義市,東區,盧厝里,0,1,1309,16,1325,1827,3,1,3,0,1,0,72.52
嘉義市,東區,東平里,0,1,731,8,739,958,3,1,3,0,1,0,77.14
嘉義市,東區,太平里,0,1,2242,17,2259,3025,3,1,3,0,1,0,74.68
嘉義市,東區,王田里,0,1,1578,10,1588,2047,3,1,3,0,1,0,77.58
嘉義市,東區,長竹里,0,1,1440,5,1445,1892,3,1,3,0,1,0,76.37
嘉義市,東區,後庄里,0,1,2146,14,2160,2778,3,1,3,0,1,0,77.75
嘉義市,東區,新店里,0,1,2216,13,2229,2952,3,1,3,0,1,0,75.51
嘉義市,東區,圳頭里,0,1,2720,18,2738,3656,3,1,3,0,1,0,74.89
嘉義市,東區,東噴里,0,1,970,3,973,1340,3,1,3,0,1,0,72.61
嘉義市,東區,希康里,0,1,261,2,263,351,3,1,3,0,1,0,74.93
嘉義市,東區,東山里,0,1,391,6,397,518,3,1,3,0,1,0,76.64
嘉義市,東區,東安里,0,1,461,4,465,601,3,1,3,0,1,0,77.37
嘉義市,東區,大街里,0,1,436,3,439,564,3,1,3,0,1,0,77.84
嘉義市,東區,祐民里,0,1,499,4,503,642,3,1,3,0,1,0,78.35
嘉義市,東區,東仁里,0,1,447,4,451,603,3,1,3,0,1,0,74.79
嘉義市,東區,內安里,0,1,390,2,392,524,3,1,3,0,1,0,74.81
嘉義市,東區,雲霄里,0,1,1036,3,1039,1377,3,1,3,0,1,0,75.45
嘉義市,東區,建國里,0,1,498,1,499,675,3,1,3,0,1,0,73.93
嘉義市,東區,府路里,0,1,787,1,788,1023,3,1,3,0,1,0,77.03
嘉義市,東區,鎮南里,0,1,297,3,300,411,3,1,3,0,1,0,72.99
嘉義市,東區,神農里,0,1,842,3,845,1126,3,1,3,0,1,0,75.04
嘉義市,東區,崇文里,0,1,509,3,512,681,3,1,3,0,1,0,75.18
嘉義市,東區,龍山里,0,1,594,1,595,784,3,1,3,0,1,0,75.89
嘉義市,東區,安平里,0,1,617,3,620,828,3,1,3,0,1,0,74.88
嘉義市,東區,文昌里,0,1,585,2,587,754,3,1,3,0,1,0,77.85
嘉義市,東區,志航里,0,1,1474,13,1487,1939,3,1,3,0,1,0,76.69
嘉義市,東區,蘭井里,0,1,882,10,892,1231,3,1,3,0,1,0,72.46
嘉義市,東區,光復里,0,1,951,7,958,1262,3,1,3,0,1,0,75.91
嘉義市,東區,初陽里,0,1,692,10,702,931,3,1,3,0,1,0,75.40
嘉義市,東區,新開里,0,1,1823,14,1837,2469,3,1,3,0,1,0,74.40
嘉義市,東區,宣信里,0,1,1200,9,1209,1673,3,1,3,0,1,0,72.27
嘉義市,東區,興南里,0,1,592,1,593,781,3,1,3,0,1,0,75.93
嘉義市,東區,豐年里,0,1,1228,9,1237,1674,3,1,3,0,1,0,73.89
嘉義市,東區,芳草里,0,1,2189,19,2208,2997,3,1,3,0,1,0,73.67
嘉義市,東區,芳安里,0,1,1574,9,1583,2092,3,1,3,0,1,0,75.67
嘉義市,東區,頂寮里,0,1,1390,8,1398,1820,3,1,3,0,1,0,76.81
嘉義市,東區,安寮里,0,1,3194,23,3217,4310,3,1,3,0,1,0,74.64
嘉義市,東區,興村里,0,1,1772,10,1782,2441,3,1,3,0,1,0,73.00
嘉義市,東區,興安里,0,1,1389,14,1403,1981,3,1,3,0,1,0,70.82
嘉義市,東區,興仁里,0,1,1840,20,1860,2482,3,1,3,0,1,0,74.94
嘉義市,東區,北城里,0,1,642,8,650,853,3,1,3,0,1,0,76.20
嘉義市,東區,仁武里,0,1,529,5,534,710,3,1,3,0,1,0,75.21
嘉義市,東區,泰安里,0,1,863,2,865,1179,3,1,3,0,1,0,73.37
嘉義市,東區,檜村里,0,1,1145,3,1148,1523,3,1,3,0,1,0,75.38
嘉義市,東區,社口里,0,1,739,4,743,954,3,1,3,0,1,0,77.88
嘉義市,東區,仁和里,0,1,398,5,403,496,3,1,3,0,1,0,81.25
嘉義市,東區,中庄里,0,1,1807,15,1822,2486,3,1,3,0,1,0,73.29
嘉義市,東區,仁義里,0,1,1463,12,1475,1941,3,1,3,0,1,0,75.99
嘉義市,東區,後湖里,0,1,1893,11,1904,2538,3,1,3,0,1,0,75.02
嘉義市,東區,荖藤里,0,1,1183,4,1187,1564,3,1,3,0,1,0,75.90
嘉義市,東區,頂庄里,0,1,2898,18,2916,3884,3,1,3,0,1,0,75.08
嘉義市,西區,書院里,0,1,840,3,843,1096,3,1,3,0,1,0,76.92
嘉義市,西區,驛站里,0,1,553,1,554,722,3,1,3,0,1,0,76.73
嘉義市,西區,長安里,0,1,397,3,400,519,3,1,3,0,1,0,77.07
嘉義市,西區,菜園里,0,1,488,5,493,661,3,1,3,0,1,0,74.58
嘉義市,西區,集英里,0,1,461,4,465,603,3,1,3,0,1,0,77.11
嘉義市,西區,福松里,0,1,696,5,701,873,3,1,3,0,1,0,80.30
嘉義市,西區,義昌里,0,1,464,1,465,581,3,1,3,0,1,0,80.03
嘉義市,西區,自治里,0,1,769,12,781,1022,3,1,3,0,1,0,76.42
嘉義市,西區,大業里,0,1,758,1,759,1006,3,1,3,0,1,0,75.45
嘉義市,西區,中庸里,0,1,637,2,639,853,3,1,3,0,1,0,74.91
嘉義市,西區,學圃里,0,1,443,5,448,548,3,1,3,0,1,0,81.75
嘉義市,西區,北杏里,0,1,613,3,616,821,3,1,3,0,1,0,75.03
嘉義市,西區,社內里,0,1,423,1,424,574,3,1,3,0,1,0,73.87
嘉義市,西區,民生里,0,1,432,7,439,573,3,1,3,0,1,0,76.61
嘉義市,西區,慶昇里,0,1,355,3,358,475,3,1,3,0,1,0,75.37
嘉義市,西區,通運里,0,1,360,4,364,483,3,1,3,0,1,0,75.36
嘉義市,西區,榮檜里,0,1,481,4,485,659,3,1,3,0,1,0,73.60
嘉義市,西區,功科里,0,1,606,4,610,749,3,1,3,0,1,0,81.44
嘉義市,西區,康莊里,0,1,531,2,533,689,3,1,3,0,1,0,77.36
嘉義市,西區,福全里,0,1,3160,27,3187,4317,3,1,3,0,1,0,73.82
嘉義市,西區,力行里,0,1,734,10,744,979,3,1,3,0,1,0,76.00
嘉義市,西區,劉厝里,0,1,1985,19,2004,2705,3,1,3,0,1,0,74.09
嘉義市,西區,港坪里,0,1,913,10,923,1180,3,1,3,0,1,0,78.22
嘉義市,西區,頭港里,0,1,768,8,776,976,3,1,3,0,1,0,79.51
嘉義市,西區,西平里,0,1,951,4,955,1231,3,1,3,0,1,0,77.58
嘉義市,西區,大溪里,0,1,1237,2,1239,1621,3,1,3,0,1,0,76.43
嘉義市,西區,磚窯里,0,1,1826,13,1839,2425,3,1,3,0,1,0,75.84
嘉義市,西區,新西里,0,1,1603,10,1613,2161,3,1,3,0,1,0,74.64
嘉義市,西區,華明里,0,1,621,4,625,816,3,1,3,0,1,0,76.59
嘉義市,西區,導民里,0,1,984,6,990,1356,3,1,3,0,1,0,73.01
嘉義市,西區,培元里,0,1,818,5,823,1096,3,1,3,0,1,0,75.09
嘉義市,西區,垂楊里,0,1,1479,10,1489,2050,3,1,3,0,1,0,72.63
嘉義市,西區,車店里,0,1,2499,23,2522,3364,3,1,3,0,1,0,74.97
嘉義市,西區,福民里,0,1,2233,10,2243,2877,3,1,3,0,1,0,77.96
嘉義市,西區,湖內里,0,1,3660,32,3692,5011,3,1,3,0,1,0,73.68
嘉義市,西區,美源里,0,1,2283,21,2304,3053,3,1,3,0,1,0,75.47
嘉義市,西區,光路里,0,1,2735,17,2752,3626,3,1,3,0,1,0,75.90
嘉義市,西區,育英里,0,1,1784,8,1792,2385,3,1,3,0,1,0,75.14
嘉義市,西區,致遠里,0,1,511,3,514,671,3,1,3,0,1,0,76.60
嘉義市,西區,翠岱里,0,1,398,4,402,522,3,1,3,0,1,0,77.01
嘉義市,西區,自強里,0,1,1329,9,1338,1790,3,1,3,0,1,0,74.75
嘉義市,西區,長安里,0,1,1002,6,1008,1324,3,1,3,0,1,0,76.13
嘉義市,西區,北榮里,0,1,1235,7,1242,1710,3,1,3,0,1,0,72.63
嘉義市,西區,重興里,0,1,1531,18,1549,2116,3,1,3,0,1,0,73.20
嘉義市,西區,慶昌里,0,1,472,3,475,612,3,1,3,0,1,0,77.61
嘉義市,西區,小湖里,0,1,519,6,525,728,3,1,3,0,1,0,72.12
嘉義市,西區,竹文里,0,1,1110,7,1117,1516,3,1,3,0,1,0,73.68
嘉義市,西區,香湖里,0,1,938,10,948,1293,3,1,3,0,1,0,73.32
嘉義市,西區,湖邊里,0,1,1307,6,1313,1730,3,1,3,0,1,0,75.90
嘉義市,西區,竹圍里,0,1,2446,22,2468,3265,3,1,3,0,1,0,75.59
嘉義市,西區,保安里,0,1,4748,43,4791,6142,3,1,3,0,1,0,78.00
嘉義市,西區,新厝里,0,1,2136,18,2154,2874,3,1,3,0,1,0,74.95
嘉義市,西區,北湖里,0,1,1617,8,1625,2064,3,1,3,0,1,0,78.73
嘉義市,西區,下埤里,0,1,772,5,777,1037,3,1,3,0,1,0,74.93
嘉義市,西區,竹村里,0,1,672,6,678,884,3,1,3,0,1,0,76.70
臺南市,東區,崇學里,0,1,3358,41,3399,5228,3,1,3,0,1,0,65.02
臺南市,東區,崇德里,0,1,2128,26,2154,3119,3,1,3,0,1,0,69.06
臺南市,東區,崇善里,0,1,1563,14,1577,2459,3,1,3,0,1,0,64.13
臺南市,東區,崇成里,0,1,2816,31,2847,4243,3,1,3,0,1,0,67.10
臺南市,東區,大智里,0,1,2639,30,2669,3798,3,1,3,0,1,0,70.27
臺南市,東區,東智里,0,1,1174,14,1188,1751,3,1,3,0,1,0,67.85
臺南市,東區,德高里,0,1,1578,26,1604,2475,3,1,3,0,1,0,64.81
臺南市,東區,和平里,0,1,1364,14,1378,2016,3,1,3,0,1,0,68.35
臺南市,東區,仁和里,0,1,1336,21,1357,1988,3,1,3,0,1,0,68.26
臺南市,東區,虎尾里,0,1,2908,26,2934,4307,3,1,3,0,1,0,68.12
臺南市,東區,自強里,0,1,2945,36,2981,4401,3,1,3,0,1,0,67.73
臺南市,東區,東聖里,0,1,1240,6,1246,1879,3,1,3,0,1,0,66.31
臺南市,東區,關聖里,0,1,1593,33,1626,2426,3,1,3,0,1,0,67.02
臺南市,東區,後甲里,0,1,1759,13,1772,2563,3,1,3,0,1,0,69.14
臺南市,東區,復國里,0,1,1732,21,1753,2250,3,1,3,0,1,0,77.91
臺南市,東區,中興里,0,1,1493,27,1520,1924,3,1,3,0,1,0,79.00
臺南市,東區,東光里,0,1,2154,19,2173,3101,3,1,3,0,1,0,70.07
臺南市,東區,東明里,0,1,2017,18,2035,2942,3,1,3,0,1,0,69.17
臺南市,東區,莊敬里,0,1,1791,22,1813,2576,3,1,3,0,1,0,70.38
臺南市,東區,小東里,0,1,2341,33,2374,3512,3,1,3,0,1,0,67.60
臺南市,東區,大學里,0,1,1118,16,1134,1674,3,1,3,0,1,0,67.74
臺南市,東區,育樂里,0,1,699,5,704,1022,3,1,3,0,1,0,68.88
臺南市,東區,前鋒里,0,1,576,12,588,871,3,1,3,0,1,0,67.51
臺南市,東區,大廟里,0,1,832,10,842,1309,3,1,3,0,1,0,64.32
臺南市,東區,泉北里,0,1,691,9,700,1077,3,1,3,0,1,0,65.00
臺南市,東區,圍上里,0,1,527,6,533,830,3,1,3,0,1,0,64.22
臺南市,東區,圍下里,0,1,1182,15,1197,1762,3,1,3,0,1,0,67.93
臺南市,東區,中西里,0,1,2918,34,2952,4472,3,1,3,0,1,0,66.01
臺南市,東區,新東里,0,1,1610,16,1626,2332,3,1,3,0,1,0,69.73
臺南市,東區,崇誨里,0,1,1886,28,1914,2752,3,1,3,0,1,0,69.55
臺南市,東區,衛國里,0,1,989,11,1000,1510,3,1,3,0,1,0,66.23
臺南市,東區,裕農里,0,1,1745,22,1767,2534,3,1,3,0,1,0,69.73
臺南市,東區,富裕里,0,1,1281,17,1298,1928,3,1,3,0,1,0,67.32
臺南市,東區,富強里,0,1,2406,32,2438,3428,3,1,3,0,1,0,71.12
臺南市,東區,崇明里,0,1,1106,11,1117,1662,3,1,3,0,1,0,67.21
臺南市,東區,大德里,0,1,1168,20,1188,1816,3,1,3,0,1,0,65.42
臺南市,東區,忠孝里,0,1,3158,45,3203,4764,3,1,3,0,1,0,67.23
臺南市,東區,大福里,0,1,1294,15,1309,1998,3,1,3,0,1,0,65.52
臺南市,東區,路東里,0,1,725,6,731,1060,3,1,3,0,1,0,68.96
臺南市,東區,府宅里,0,1,828,11,839,1242,3,1,3,0,1,0,67.55
臺南市,東區,川東里,0,1,585,5,590,871,3,1,3,0,1,0,67.74
臺南市,東區,大興里,0,1,713,9,722,1087,3,1,3,0,1,0,66.42
臺南市,東區,泉南里,0,1,2460,27,2487,3713,3,1,3,0,1,0,66.98
臺南市,東區,龍山里,0,1,2830,40,2870,4182,3,1,3,0,1,0,68.63
臺南市,南區,大恩里,0,1,1968,35,2003,2904,3,1,3,0,1,0,68.97
臺南市,南區,大林里,0,1,1296,12,1308,1957,3,1,3,0,1,0,66.84
臺南市,南區,大忠里,0,1,2786,32,2818,4107,3,1,3,0,1,0,68.61
臺南市,南區,新生里,0,1,798,11,809,1166,3,1,3,0,1,0,69.38
臺南市,南區,竹溪里,0,1,943,12,955,1411,3,1,3,0,1,0,67.68
臺南市,南區,明德里,0,1,854,14,868,1204,3,1,3,0,1,0,72.09
臺南市,南區,興中里,0,1,948,11,959,1289,3,1,3,0,1,0,74.40
臺南市,南區,荔宅里,0,1,1089,13,1102,1527,3,1,3,0,1,0,72.17
臺南市,南區,大成里,0,1,723,9,732,1042,3,1,3,0,1,0,70.25
臺南市,南區,田寮里,0,1,2285,24,2309,3345,3,1,3,0,1,0,69.03
臺南市,南區,新興里,0,1,1707,17,1724,2530,3,1,3,0,1,0,68.14
臺南市,南區,再興里,0,1,1449,11,1460,2055,3,1,3,0,1,0,71.05
臺南市,南區,廣州里,0,1,1969,18,1987,2640,3,1,3,0,1,0,75.27
臺南市,南區,新昌里,0,1,1635,12,1647,2445,3,1,3,0,1,0,67.36
臺南市,南區,文華里,0,1,2055,21,2076,2992,3,1,3,0,1,0,69.39
臺南市,南區,文南里,0,1,2156,19,2175,2994,3,1,3,0,1,0,72.65
臺南市,南區,金華里,0,1,3046,23,3069,4380,3,1,3,0,1,0,70.07
臺南市,南區,國宅里,0,1,2092,22,2114,3047,3,1,3,0,1,0,69.38
臺南市,南區,日新里,0,1,1367,14,1381,2001,3,1,3,0,1,0,69.02
臺南市,南區,光明里,0,1,2600,27,2627,3696,3,1,3,0,1,0,71.08
臺南市,南區,白雪里,0,1,1453,13,1466,1975,3,1,3,0,1,0,74.23
臺南市,南區,明亮里,0,1,2224,29,2253,3250,3,1,3,0,1,0,69.32
臺南市,南區,府南里,0,1,2290,32,2322,3467,3,1,3,0,1,0,66.97
臺南市,南區,明興里,0,1,2132,26,2158,2919,3,1,3,0,1,0,73.93
臺南市,南區,郡南里,0,1,2281,25,2306,3203,3,1,3,0,1,0,72.00
臺南市,南區,建南里,0,1,2081,20,2101,3046,3,1,3,0,1,0,68.98
臺南市,南區,南都里,0,1,2771,26,2797,4102,3,1,3,0,1,0,68.19
臺南市,南區,開南里,0,1,2191,34,2225,3371,3,1,3,0,1,0,66.00
臺南市,南區,彰南里,0,1,1308,6,1314,1970,3,1,3,0,1,0,66.70
臺南市,南區,清泉里,0,1,697,9,706,1003,3,1,3,0,1,0,70.39
臺南市,南區,龍崗里,0,1,688,10,698,949,3,1,3,0,1,0,73.55
臺南市,南區,喜北里,0,1,1416,13,1429,2006,3,1,3,0,1,0,71.24
臺南市,南區,喜南里,0,1,1081,10,1091,1552,3,1,3,0,1,0,70.30
臺南市,南區,喜東里,0,1,943,11,954,1377,3,1,3,0,1,0,69.28
臺南市,南區,省躬里,0,1,1595,13,1608,2281,3,1,3,0,1,0,70.50
臺南市,南區,覺醒里,0,1,451,4,455,606,3,1,3,0,1,0,75.08
臺南市,南區,海豐里,0,1,401,9,410,588,3,1,3,0,1,0,69.73
臺南市,南區,松山里,0,1,666,4,670,986,3,1,3,0,1,0,67.95
臺南市,南區,南山里,0,1,495,3,498,708,3,1,3,0,1,0,70.34
臺南市,南區,佛壇里,0,1,967,13,980,1398,3,1,3,0,1,0,70.10
臺南市,南區,同安里,0,1,1169,9,1178,1699,3,1,3,0,1,0,69.33
臺南市,南區,中和里,0,1,525,6,531,737,3,1,3,0,1,0,72.05
臺南市,南區,興農里,0,1,1182,10,1192,1637,3,1,3,0,1,0,72.82
臺南市,西區,普濟里,0,1,555,8,563,788,3,1,3,0,1,0,71.45
臺南市,西區,濟同里,0,1,504,3,507,683,3,1,3,0,1,0,74.23
臺南市,西區,金安里,0,1,461,9,470,666,3,1,3,0,1,0,70.57
臺南市,西區,忠信里,0,1,553,3,556,788,3,1,3,0,1,0,70.56
臺南市,西區,工業里,0,1,545,4,549,841,3,1,3,0,1,0,65.28
臺南市,西區,協和里,0,1,1570,23,1593,2168,3,1,3,0,1,0,73.48
臺南市,西區,文賢里,0,1,921,9,930,1370,3,1,3,0,1,0,67.88
臺南市,西區,光賢里,0,1,1593,15,1608,2202,3,1,3,0,1,0,73.02
臺南市,西區,西湖里,0,1,1564,12,1576,2253,3,1,3,0,1,0,69.95
臺南市,西區,西賢里,0,1,1682,18,1700,2479,3,1,3,0,1,0,68.58
臺南市,西區,藥王里,0,1,1565,18,1583,2281,3,1,3,0,1,0,69.40
臺南市,西區,協進里,0,1,790,14,804,1115,3,1,3,0,1,0,72.11
臺南市,西區,西羅里,0,1,678,12,690,938,3,1,3,0,1,0,73.56
臺南市,西區,北勢里,0,1,634,24,658,927,3,1,3,0,1,0,70.98
臺南市,西區,水仙里,0,1,669,7,676,1005,3,1,3,0,1,0,67.26
臺南市,西區,安新里,0,1,408,8,416,569,3,1,3,0,1,0,73.11
臺南市,西區,中正里,0,1,658,9,667,960,3,1,3,0,1,0,69.48
臺南市,西區,正德里,0,1,431,10,441,633,3,1,3,0,1,0,69.67
臺南市,西區,安海里,0,1,597,7,604,936,3,1,3,0,1,0,64.53
臺南市,西區,大涼里,0,1,1362,16,1378,2114,3,1,3,0,1,0,65.18
臺南市,西區,民主里,0,1,590,9,599,904,3,1,3,0,1,0,66.26
臺南市,西區,運河里,0,1,416,7,423,604,3,1,3,0,1,0,70.03
臺南市,西區,北頭里,0,1,199,0,199,248,3,1,3,0,1,0,80.24
臺南市,西區,保民里,0,1,346,2,348,466,3,1,3,0,1,0,74.68
臺南市,西區,保良里,0,1,385,1,386,507,3,1,3,0,1,0,76.13
臺南市,西區,元安里,0,1,1046,10,1056,1552,3,1,3,0,1,0,68.04
臺南市,西區,天池里,0,1,217,3,220,306,3,1,3,0,1,0,71.90
臺南市,西區,新安里,0,1,619,11,630,821,3,1,3,0,1,0,76.74
臺南市,西區,中頭里,0,1,669,9,678,1005,3,1,3,0,1,0,67.46
臺南市,西區,民生里,0,1,845,10,855,1151,3,1,3,0,1,0,74.28
臺南市,北區,城隍里,0,1,654,6,660,958,3,1,3,0,1,0,68.89
臺南市,北區,元和里,0,1,698,8,706,1051,3,1,3,0,1,0,67.17
臺南市,北區,城朔里,0,1,638,6,644,971,3,1,3,0,1,0,66.32
臺南市,北區,共和里,0,1,822,7,829,1270,3,1,3,0,1,0,65.28
臺南市,北區,福德里,0,1,679,9,688,985,3,1,3,0,1,0,69.85
臺南市,北區,花園里,0,1,753,8,761,1143,3,1,3,0,1,0,66.58
臺南市,北區,西華里,0,1,798,7,805,1203,3,1,3,0,1,0,66.92
臺南市,北區,北門里,0,1,647,9,656,951,3,1,3,0,1,0,68.98
臺南市,北區,東豐里,0,1,846,13,859,1191,3,1,3,0,1,0,72.12
臺南市,北區,水源里,0,1,740,5,745,1037,3,1,3,0,1,0,71.84
臺南市,北區,仁愛里,0,1,1156,12,1168,1734,3,1,3,0,1,0,67.36
臺南市,北區,振興里,0,1,1376,9,1385,2043,3,1,3,0,1,0,67.79
臺南市,北區,東興里,0,1,1447,22,1469,2040,3,1,3,0,1,0,72.01
臺南市,北區,重興里,0,1,1676,29,1705,2420,3,1,3,0,1,0,70.45
臺南市,北區,華興里,0,1,1391,19,1410,2135,3,1,3,0,1,0,66.04
臺南市,北區,力行里,0,1,1370,16,1386,2017,3,1,3,0,1,0,68.72
臺南市,北區,國興里,0,1,1002,9,1011,1418,3,1,3,0,1,0,71.30
臺南市,北區,新勝里,0,1,1300,15,1315,1918,3,1,3,0,1,0,68.56
臺南市,北區,開元里,0,1,1962,20,1982,2870,3,1,3,0,1,0,69.06
臺南市,北區,北垣里,0,1,778,11,789,1004,3,1,3,0,1,0,78.59
臺南市,北區,富台里,0,1,458,5,463,608,3,1,3,0,1,0,76.15
臺南市,北區,勝安里,0,1,934,7,941,1369,3,1,3,0,1,0,68.74
臺南市,北區,大仁里,0,1,838,7,845,1168,3,1,3,0,1,0,72.35
臺南市,北區,大山里,0,1,1036,24,1060,1477,3,1,3,0,1,0,71.77
臺南市,北區,大道里,0,1,1037,8,1045,1360,3,1,3,0,1,0,76.84
臺南市,北區,光武里,0,1,711,11,722,994,3,1,3,0,1,0,72.64
臺南市,北區,實踐里,0,1,1405,13,1418,1964,3,1,3,0,1,0,72.20
臺南市,北區,小康里,0,1,3254,35,3289,4680,3,1,3,0,1,0,70.28
臺南市,北區,正風里,0,1,1060,15,1075,1544,3,1,3,0,1,0,69.62
臺南市,北區,延平里,0,1,1357,16,1373,1999,3,1,3,0,1,0,68.68
臺南市,北區,興北里,0,1,1146,13,1159,1666,3,1,3,0,1,0,69.57
臺南市,北區,興南里,0,1,938,11,949,1379,3,1,3,0,1,0,68.82
臺南市,北區,國姓里,0,1,1096,8,1104,1601,3,1,3,0,1,0,68.96
臺南市,北區,六甲里,0,1,1235,13,1248,1867,3,1,3,0,1,0,66.85
臺南市,北區,正覺里,0,1,2258,23,2281,3372,3,1,3,0,1,0,67.65
臺南市,北區,成功里,0,1,2917,35,2952,4329,3,1,3,0,1,0,68.19
臺南市,北區,和順里,0,1,2071,19,2090,2991,3,1,3,0,1,0,69.88
臺南市,北區,安民里,0,1,873,8,881,1229,3,1,3,0,1,0,71.68
臺南市,北區,裕民里,0,1,919,13,932,1368,3,1,3,0,1,0,68.13
臺南市,北區,文元里,0,1,2884,28,2912,4229,3,1,3,0,1,0,68.86
臺南市,北區,大港里,0,1,3769,44,3813,5400,3,1,3,0,1,0,70.61
臺南市,北區,大豐里,0,1,3202,41,3243,4746,3,1,3,0,1,0,68.33
臺南市,中區,萬壽里,0,1,957,9,966,1348,3,1,3,0,1,0,71.66
臺南市,中區,文昌里,0,1,821,8,829,1136,3,1,3,0,1,0,72.98
臺南市,中區,萬鍾里,0,1,781,7,788,1127,3,1,3,0,1,0,69.92
臺南市,中區,銀同里,0,1,995,15,1010,1481,3,1,3,0,1,0,68.20
臺南市,中區,清水里,0,1,543,3,546,795,3,1,3,0,1,0,68.68
臺南市,中區,環翠里,0,1,455,4,459,684,3,1,3,0,1,0,67.11
臺南市,中區,公正里,0,1,329,2,331,485,3,1,3,0,1,0,68.25
臺南市,中區,廣慈里,0,1,361,3,364,536,3,1,3,0,1,0,67.91
臺南市,中區,啟智里,0,1,916,6,922,1294,3,1,3,0,1,0,71.25
臺南市,中區,永慶里,0,1,302,3,305,431,3,1,3,0,1,0,70.77
臺南市,中區,天中里,0,1,417,4,421,559,3,1,3,0,1,0,75.31
臺南市,中區,中山里,0,1,427,5,432,589,3,1,3,0,1,0,73.34
臺南市,中區,白金里,0,1,531,7,538,715,3,1,3,0,1,0,75.24
臺南市,中區,武聖里,0,1,536,4,540,766,3,1,3,0,1,0,70.50
臺南市,中區,蓬壺里,0,1,757,6,763,1138,3,1,3,0,1,0,67.05
臺南市,中區,赤嵌里,0,1,393,5,398,576,3,1,3,0,1,0,69.10
臺南市,中區,觀音里,0,1,462,5,467,657,3,1,3,0,1,0,71.08
臺南市,中區,竹翠里,0,1,395,6,401,560,3,1,3,0,1,0,71.61
臺南市,中區,溫陵里,0,1,454,6,460,705,3,1,3,0,1,0,65.25
臺南市,中區,開仙里,0,1,551,6,557,843,3,1,3,0,1,0,66.07
臺南市,中區,保西里,0,1,586,9,595,844,3,1,3,0,1,0,70.50
臺南市,中區,中南里,0,1,430,2,432,600,3,1,3,0,1,0,72.00
臺南市,中區,福安里,0,1,645,7,652,987,3,1,3,0,1,0,66.06
臺南市,中區,昇平里,0,1,374,3,377,512,3,1,3,0,1,0,73.63
臺南市,中區,聖前里,0,1,352,7,359,512,3,1,3,0,1,0,70.12
臺南市,中區,小西里,0,1,832,8,840,1233,3,1,3,0,1,0,68.13
臺南市,中區,仙草里,0,1,1608,13,1621,2406,3,1,3,0,1,0,67.37
臺南市,中區,五妃里,0,1,774,2,776,1096,3,1,3,0,1,0,70.80
臺南市,中區,大南里,0,1,1012,13,1025,1510,3,1,3,0,1,0,67.88
臺南市,中區,進學里,0,1,503,7,510,727,3,1,3,0,1,0,70.15
臺南市,中區,川西里,0,1,563,9,572,830,3,1,3,0,1,0,68.92
臺南市,中區,開山里,0,1,1065,8,1073,1609,3,1,3,0,1,0,66.69
臺南市,中區,郡王里,0,1,1253,10,1263,1756,3,1,3,0,1,0,71.92
臺南市,中區,法華里,0,1,2114,15,2129,3099,3,1,3,0,1,0,68.70
臺南市,安南區,溪頂里,0,1,1808,22,1830,2649,3,1,3,0,1,0,69.08
臺南市,安南區,溪北里,0,1,1344,24,1368,1947,3,1,3,0,1,0,70.26
臺南市,安南區,安和里,0,1,1314,17,1331,1820,3,1,3,0,1,0,73.13
臺南市,安南區,安西里,0,1,1432,16,1448,1957,3,1,3,0,1,0,73.99
臺南市,安南區,安東里,0,1,1685,24,1709,2445,3,1,3,0,1,0,69.90
臺南市,安南區,安慶里,0,1,2241,30,2271,3257,3,1,3,0,1,0,69.73
臺南市,安南區,頂安里,0,1,1466,16,1482,2014,3,1,3,0,1,0,73.58
臺南市,安南區,鳳凰里,0,1,1486,16,1502,2407,3,1,3,0,1,0,62.40
臺南市,安南區,梅花里,0,1,1575,17,1592,2362,3,1,3,0,1,0,67.40
臺南市,安南區,新順里,0,1,1262,12,1274,1875,3,1,3,0,1,0,67.95
臺南市,安南區,安順里,0,1,1204,10,1214,1805,3,1,3,0,1,0,67.26
臺南市,安南區,州南里,0,1,2687,37,2724,3850,3,1,3,0,1,0,70.75
臺南市,安南區,東和里,0,1,349,3,352,468,3,1,3,0,1,0,75.21
臺南市,安南區,州北里,0,1,1636,18,1654,2338,3,1,3,0,1,0,70.74
臺南市,安南區,塭南里,0,1,1973,28,2001,2851,3,1,3,0,1,0,70.19
臺南市,安南區,布袋里,0,1,670,10,680,951,3,1,3,0,1,0,71.50
臺南市,安南區,總頭里,0,1,1095,7,1102,1448,3,1,3,0,1,0,76.10
臺南市,安南區,原佃里,0,1,870,11,881,1144,3,1,3,0,1,0,77.01
臺南市,安南區,長安里,0,1,1727,22,1749,2424,3,1,3,0,1,0,72.15
臺南市,安南區,公親里,0,1,592,13,605,790,3,1,3,0,1,0,76.58
臺南市,安南區,佃東里,0,1,1242,12,1254,1708,3,1,3,0,1,0,73.42
臺南市,安南區,佃西里,0,1,757,7,764,1059,3,1,3,0,1,0,72.14
臺南市,安南區,公塭里,0,1,610,4,614,765,3,1,3,0,1,0,80.26
臺南市,安南區,南興里,0,1,722,7,729,1026,3,1,3,0,1,0,71.05
臺南市,安南區,學東里,0,1,1039,11,1050,1511,3,1,3,0,1,0,69.49
臺南市,安南區,砂崙里,0,1,732,6,738,916,3,1,3,0,1,0,80.57
臺南市,安南區,青草里,0,1,804,17,821,1017,3,1,3,0,1,0,80.73
臺南市,安南區,城西里,0,1,579,7,586,763,3,1,3,0,1,0,76.80
臺南市,安南區,城南里,0,1,1429,21,1450,1949,3,1,3,0,1,0,74.40
臺南市,安南區,城中里,0,1,436,3,439,556,3,1,3,0,1,0,78.96
臺南市,安南區,城北里,0,1,782,7,789,1039,3,1,3,0,1,0,75.94
臺南市,安南區,城東里,0,1,906,4,910,1245,3,1,3,0,1,0,73.09
臺南市,安南區,顯宮里,0,1,707,8,715,943,3,1,3,0,1,0,75.82
臺南市,安南區,鹿耳里,0,1,422,5,427,558,3,1,3,0,1,0,76.52
臺南市,安南區,四草里,0,1,923,9,932,1236,3,1,3,0,1,0,75.40
臺南市,安南區,鹽田里,0,1,400,3,403,486,3,1,3,0,1,0,82.92
臺南市,安南區,淵西里,0,1,1240,15,1255,1822,3,1,3,0,1,0,68.88
臺南市,安南區,淵中里,0,1,1576,19,1595,2318,3,1,3,0,1,0,68.81
臺南市,安南區,溪心里,0,1,1538,27,1565,2282,3,1,3,0,1,0,68.58
臺南市,安南區,淵東里,0,1,1286,21,1307,1872,3,1,3,0,1,0,69.82
臺南市,安南區,海西里,0,1,1384,17,1401,2041,3,1,3,0,1,0,68.64
臺南市,安南區,海東里,0,1,1547,21,1568,2316,3,1,3,0,1,0,67.70
臺南市,安南區,理想里,0,1,3340,56,3396,5026,3,1,3,0,1,0,67.57
臺南市,安南區,海佃里,0,1,3263,44,3307,4615,3,1,3,0,1,0,71.66
臺南市,安南區,幸福里,0,1,2125,25,2150,3105,3,1,3,0,1,0,69.24
臺南市,安南區,海南里,0,1,1284,10,1294,1862,3,1,3,0,1,0,69.50
臺南市,安南區,溪墘里,0,1,1693,21,1714,2464,3,1,3,0,1,0,69.56
臺南市,安南區,溪東里,0,1,3669,44,3713,5379,3,1,3,0,1,0,69.03
臺南市,安平區,校前里,0,1,5921,56,5977,9699,3,1,3,0,1,0,61.62
臺南市,安平區,石門里,0,1,2697,38,2735,3944,3,1,3,0,1,0,69.35
臺南市,安平區,菩薩里,0,1,300,4,304,374,3,1,3,0,1,0,81.28
臺南市,安平區,安中里,0,1,345,8,353,488,3,1,3,0,1,0,72.34
臺南市,安平區,文朱里,0,1,271,1,272,371,3,1,3,0,1,0,73.32
臺南市,安平區,妙壽里,0,1,253,2,255,399,3,1,3,0,1,0,63.91
臺南市,安平區,海興里,0,1,606,7,613,879,3,1,3,0,1,0,69.74
臺南市,安平區,西門里,0,1,1620,25,1645,2202,3,1,3,0,1,0,74.70
臺南市,安平區,金城里,0,1,1300,10,1310,1930,3,1,3,0,1,0,67.88
臺南市,安平區,漁光里,0,1,313,5,318,425,3,1,3,0,1,0,74.82
金門縣,金城鎮,東門里,0,1,946,10,956,1342,3,1,3,0,1,0,71.24
金門縣,金城鎮,南門里,0,1,1294,8,1302,1789,3,1,3,0,1,0,72.78
金門縣,金城鎮,西門里,0,1,1665,16,1681,2358,3,1,3,0,1,0,71.29
金門縣,金城鎮,北門里,0,1,855,10,865,1195,3,1,3,0,1,0,72.38
金門縣,金城鎮,賢庵里,0,1,585,9,594,844,3,1,3,0,1,0,70.38
金門縣,金城鎮,金水里,0,1,380,1,381,541,3,1,3,0,1,0,70.43
金門縣,金城鎮,古城里,0,1,688,14,702,1005,3,1,3,0,1,0,69.85
金門縣,金城鎮,珠沙里,0,1,307,4,311,472,3,1,3,0,1,0,65.89
金門縣,金寧鄉,古寧村,0,1,619,8,627,961,3,1,3,0,1,0,65.24
金門縣,金寧鄉,安美村,0,1,784,8,792,1156,3,1,3,0,1,0,68.51
金門縣,金寧鄉,湖埔村,0,1,626,10,636,886,3,1,3,0,1,0,71.78
金門縣,金寧鄉,榜林村,0,1,702,20,722,1112,3,1,3,0,1,0,64.93
金門縣,金寧鄉,盤山村,0,1,576,4,580,824,3,1,3,0,1,0,70.39
金門縣,金寧鄉,后盤村,0,1,263,2,265,402,3,1,3,0,1,0,65.92
金門縣,金湖鎮,新市里,0,1,1085,13,1098,1497,3,1,3,0,1,0,73.35
金門縣,金湖鎮,山外里,0,1,788,9,797,1055,3,1,3,0,1,0,75.55
金門縣,金湖鎮,溪湖里,0,1,335,6,341,456,3,1,3,0,1,0,74.78
金門縣,金湖鎮,蓮庵里,0,1,304,1,305,434,3,1,3,0,1,0,70.28
金門縣,金湖鎮,料羅里,0,1,326,1,327,477,3,1,3,0,1,0,68.55
金門縣,金湖鎮,新湖里,0,1,788,6,794,1026,3,1,3,0,1,0,77.39
金門縣,金湖鎮,正義里,0,1,556,5,561,709,3,1,3,0,1,0,79.13
金門縣,金湖鎮,瓊林里,0,1,664,4,668,958,3,1,3,0,1,0,69.73
金門縣,金沙鎮,汶沙里,0,1,1053,16,1069,1490,3,1,3,0,1,0,71.74
金門縣,金沙鎮,何斗里,0,1,444,7,451,620,3,1,3,0,1,0,72.74
金門縣,金沙鎮,浦山里,0,1,445,11,456,698,3,1,3,0,1,0,65.33
金門縣,金沙鎮,西園里,0,1,306,4,310,445,3,1,3,0,1,0,69.66
金門縣,金沙鎮,官嶼里,0,1,331,1,332,529,3,1,3,0,1,0,62.76
金門縣,金沙鎮,三山里,0,1,356,3,359,531,3,1,3,0,1,0,67.61
金門縣,金沙鎮,大洋里,0,1,258,2,260,372,3,1,3,0,1,0,69.89
金門縣,金沙鎮,光前里,0,1,389,6,395,589,3,1,3,0,1,0,67.06
金門縣,烈嶼鄉,林湖村,0,1,708,5,713,921,3,1,3,0,1,0,77.42
金門縣,烈嶼鄉,黃埔村,0,1,267,1,268,387,3,1,3,0,1,0,69.25
金門縣,烈嶼鄉,西口村,0,1,370,9,379,548,3,1,3,0,1,0,69.16
金門縣,烈嶼鄉,上林村,0,1,272,2,274,373,3,1,3,0,1,0,73.46
金門縣,烈嶼鄉,上歧村,0,1,566,6,572,768,3,1,3,0,1,0,74.48
金門縣,烏坵鄉,大坵村,0,1,33,0,33,82,3,1,3,0,1,0,40.24
連江縣,南竿鄉,介壽村,0,1,1297,18,1315,1508,3,1,3,0,1,0,87.20
連江縣,南竿鄉,馬祖村,0,1,601,10,611,724,3,1,3,0,1,0,84.39
連江縣,北竿鄉,塘歧村,0,1,420,4,424,515,3,1,3,0,1,0,82.33
連江縣,北竿鄉,白沙村,0,1,183,3,186,234,3,1,3,0,1,0,79.49
連江縣,莒光鄉,青帆村,0,1,177,0,177,219,3,1,3,0,1,0,80.82
連江縣,莒光鄉,大坪村,0,1,127,1,128,155,3,1,3,0,1,0,82.58
連江縣,東引鄉,中柳村,0,1,308,4,312,426,3,1,3,0,1,0,73.24
臺北市,北投區,建民里,1,1,761,9,770,1068,3,1,3,0,1,0,72.10
臺北市,北投區,建民里,2,1,880,5,885,1348,3,1,3,0,1,0,65.65
臺北市,北投區,建民里,3,1,817,10,827,1220,3,1,3,0,1,0,67.79
臺北市,北投區,文林里,4,1,1182,17,1199,1756,3,1,3,0,1,0,68.28
臺北市,北投區,文林里,5,1,935,5,940,1376,3,1,3,0,1,0,68.31
臺北市,北投區,石牌里,6,1,836,7,843,1311,3,1,3,0,1,0,64.30
臺北市,北投區,石牌里,7,1,868,12,880,1410,3,1,3,0,1,0,62.41
臺北市,北投區,石牌里,8,1,940,12,952,1440,3,1,3,0,1,0,66.11
臺北市,北投區,榮光里,9,1,829,9,838,1296,3,1,3,0,1,0,64.66
臺北市,北投區,榮光里,10,1,901,8,909,1357,3,1,3,0,1,0,66.99
臺北市,北投區,榮光里,11,1,928,5,933,1382,3,1,3,0,1,0,67.51
臺北市,北投區,榮光里,12,1,795,1,796,1181,3,1,3,0,1,0,67.40
臺北市,北投區,福興里,13,1,1019,12,1031,1490,3,1,3,0,1,0,69.19
臺北市,北投區,福興里,14,1,1044,7,1051,1490,3,1,3,0,1,0,70.54
臺北市,北投區,福興里,15,1,1177,11,1188,1748,3,1,3,0,1,0,67.96
臺北市,北投區,洲美里,16,1,854,6,860,1149,3,1,3,0,1,0,74.85
臺北市,北投區,吉慶里,17,1,826,10,836,1235,3,1,3,0,1,0,67.69
臺北市,北投區,吉慶里,18,1,839,6,845,1208,3,1,3,0,1,0,69.95
臺北市,北投區,吉慶里,19,1,913,4,917,1254,3,1,3,0,1,0,73.13
臺北市,北投區,吉利里,20,1,995,13,1008,1442,3,1,3,0,1,0,69.90
臺北市,北投區,吉利里,21,1,1018,16,1034,1592,3,1,3,0,1,0,64.95
臺北市,北投區,吉利里,22,1,954,8,962,1348,3,1,3,0,1,0,71.36
臺北市,北投區,尊賢里,23,1,715,10,725,1080,3,1,3,0,1,0,67.13
臺北市,北投區,尊賢里,24,1,823,10,833,1282,3,1,3,0,1,0,64.98
臺北市,北投區,尊賢里,25,1,758,7,765,1145,3,1,3,0,1,0,66.81
臺北市,北投區,立賢里,26,1,819,9,828,1185,3,1,3,0,1,0,69.87
臺北市,北投區,立賢里,27,1,885,8,893,1335,3,1,3,0,1,0,66.89
臺北市,北投區,立賢里,28,1,804,8,812,1167,3,1,3,0,1,0,69.58
臺北市,北投區,立農里,29,1,1098,14,1112,1615,3,1,3,0,1,0,68.85
臺北市,北投區,立農里,30,1,949,5,954,1400,3,1,3,0,1,0,68.14
臺北市,北投區,立農里,31,1,949,13,962,1358,3,1,3,0,1,0,70.84
臺北市,北投區,立農里,32,1,1066,16,1082,1534,3,1,3,0,1,0,70.53
臺北市,北投區,永和里,33,1,863,18,881,1282,3,1,3,0,1,0,68.72
臺北市,北投區,永和里,34,1,815,5,820,1334,3,1,3,0,1,0,61.47
臺北市,北投區,永和里,35,1,861,9,870,1399,3,1,3,0,1,0,62.19
臺北市,北投區,永和里,36,1,786,5,791,1235,3,1,3,0,1,0,64.05
臺北市,北投區,永欣里,37,1,1114,6,1120,1530,3,1,3,0,1,0,73.20
臺北市,北投區,永欣里,38,1,987,11,998,1465,3,1,3,0,1,0,68.12
臺北市,北投區,永欣里,39,1,971,9,980,1373,3,1,3,0,1,0,71.38
臺北市,北投區,榮華里,40,1,1132,13,1145,1670,3,1,3,0,1,0,68.56
臺北市,北投區,榮華里,41,1,1207,9,1216,1810,3,1,3,0,1,0,67.18
臺北市,北投區,榮華里,42,1,1154,7,1161,1694,3,1,3,0,1,0,68.54
臺北市,北投區,裕民里,43,1,1126,16,1142,1622,3,1,3,0,1,0,70.41
臺北市,北投區,裕民里,44,1,1021,10,1031,1533,3,1,3,0,1,0,67.25
臺北市,北投區,裕民里,45,1,1106,8,1114,1574,3,1,3,0,1,0,70.78
臺北市,北投區,振華里,46,1,1144,6,1150,1650,3,1,3,0,1,0,69.70
臺北市,北投區,振華里,47,1,991,7,998,1413,3,1,3,0,1,0,70.63
臺北市,北投區,振華里,48,1,845,12,857,1235,3,1,3,0,1,0,69.39
臺北市,北投區,振華里,49,1,1097,13,1110,1686,3,1,3,0,1,0,65.84
臺北市,北投區,永明里,50,1,1013,14,1027,1444,3,1,3,0,1,0,71.12
臺北市,北投區,永明里,51,1,1102,19,1121,1574,3,1,3,0,1,0,71.22
臺北市,北投區,東華里,52,1,725,5,730,1024,3,1,3,0,1,0,71.29
臺北市,北投區,東華里,53,1,986,13,999,1326,3,1,3,0,1,0,75.34
臺北市,北投區,東華里,54,1,936,16,952,1296,3,1,3,0,1,0,73.46
臺北市,北投區,八仙里,55,1,968,16,984,1536,3,1,3,0,1,0,64.06
臺北市,北投區,八仙里,56,1,1073,14,1087,1654,3,1,3,0,1,0,65.72
臺北市,北投區,清江里,57,1,912,8,920,1369,3,1,3,0,1,0,67.20
臺北市,北投區,清江里,58,1,1096,14,1110,1632,3,1,3,0,1,0,68.01
臺北市,北投區,清江里,59,1,1138,5,1143,1640,3,1,3,0,1,0,69.70
臺北市,北投區,清江里,60,1,1050,13,1063,1505,3,1,3,0,1,0,70.63
臺北市,北投區,中央里,61,1,915,9,924,1338,3,1,3,0,1,0,69.06
臺北市,北投區,中央里,62,1,928,9,937,1446,3,1,3,0,1,0,64.80
臺北市,北投區,中央里,63,1,832,11,843,1327,3,1,3,0,1,0,63.53
臺北市,北投區,中央里,64,1,1016,15,1031,1541,3,1,3,0,1,0,66.90
臺北市,北投區,大同里,65,1,856,10,866,1229,3,1,3,0,1,0,70.46
臺北市,北投區,大同里,66,1,626,13,639,911,3,1,3,0,1,0,70.14
臺北市,北投區,大同里,67,1,918,6,924,1500,3,1,3,0,1,0,61.60
臺北市,北投區,長安里,68,1,779,12,791,1170,3,1,3,0,1,0,67.61
臺北市,北投區,長安里,69,1,781,5,786,1152,3,1,3,0,1,0,68.23
臺北市,北投區,長安里,70,1,1053,14,1067,1706,3,1,3,0,1,0,62.54
臺北市,北投區,奇岩里,71,1,1084,14,1098,1569,3,1,3,0,1,0,69.98
臺北市,北投區,奇岩里,72,1,1110,10,1120,1602,3,1,3,0,1,0,69.91
臺北市,北投區,奇岩里,73,1,1124,16,1140,1616,3,1,3,0,1,0,70.54
臺北市,北投區,奇岩里,74,1,1071,9,1080,1639,3,1,3,0,1,0,65.89
臺北市,北投區,溫泉里,75,1,1034,18,1052,1463,3,1,3,0,1,0,71.91
臺北市,北投區,溫泉里,76,1,996,10,1006,1539,3,1,3,0,1,0,65.37
臺北市,北投區,溫泉里,77,1,1100,17,1117,1764,3,1,3,0,1,0,63.32
臺北市,北投區,林泉里,78,1,878,4,882,1302,3,1,3,0,1,0,67.74
臺北市,北投區,林泉里,79,1,868,13,881,1456,3,1,3,0,1,0,60.51
臺北市,北投區,中心里,80,1,960,11,971,1500,3,1,3,0,1,0,64.73
臺北市,北投區,中心里,81,1,893,7,900,1487,3,1,3,0,1,0,60.52
臺北市,北投區,中心里,82,1,779,3,782,1242,3,1,3,0,1,0,62.96
臺北市,北投區,開明里,83,1,912,12,924,1453,3,1,3,0,1,0,63.59
臺北市,北投區,開明里,84,1,946,10,956,1421,3,1,3,0,1,0,67.28
臺北市,北投區,開明里,85,1,1023,5,1028,1545,3,1,3,0,1,0,66.54
臺北市,北投區,中庸里,86,1,1069,13,1082,1583,3,1,3,0,1,0,68.35
臺北市,北投區,中庸里,87,1,1164,31,1195,1747,3,1,3,0,1,0,68.40
臺北市,北投區,中和里,88,1,991,14,1005,1505,3,1,3,0,1,0,66.78
臺北市,北投區,中和里,89,1,1294,9,1303,1895,3,1,3,0,1,0,68.76
臺北市,北投區,中和里,90,1,367,9,376,715,3,1,3,0,1,0,52.59
臺北市,北投區,秀山里,91,1,1031,15,1046,1597,3,1,3,0,1,0,65.50
臺北市,北投區,秀山里,92,1,994,14,1008,1419,3,1,3,0,1,0,71.04
臺北市,北投區,智仁里,93,1,1187,13,1200,1696,3,1,3,0,1,0,70.75
臺北市,北投區,智仁里,94,1,1083,17,1100,1573,3,1,3,0,1,0,69.93
臺北市,北投區,智仁里,95,1,871,19,890,1291,3,1,3,0,1,0,68.94
臺北市,北投區,文化里,96,1,1078,8,1086,1456,3,1,3,0,1,0,74.59
臺北市,北投區,文化里,97,1,989,14,1003,1486,3,1,3,0,1,0,67.50
臺北市,北投區,豐年里,98,1,1064,7,1071,1593,3,1,3,0,1,0,67.23
臺北市,北投區,豐年里,99,1,1053,16,1069,1576,3,1,3,0,1,0,67.83
臺北市,北投區,稻香里,100,1,1174,12,1186,1747,3,1,3,0,1,0,67.89
臺北市,北投區,稻香里,101,1,1096,11,1107,1705,3,1,3,0,1,0,64.93
臺北市,北投區,桃源里,102,1,898,6,904,1359,3,1,3,0,1,0,66.52
臺北市,北投區,桃源里,103,1,852,7,859,1304,3,1,3,0,1,0,65.87
臺北市,北投區,桃源里,104,1,694,8,702,1086,3,1,3,0,1,0,64.64
臺北市,北投區,一德里,105,1,1027,21,1048,1605,3,1,3,0,1,0,65.30
臺北市,北投區,一德里,106,1,891,13,904,1512,3,1,3,0,1,0,59.79
臺北市,北投區,一德里,107,1,855,12,867,1288,3,1,3,0,1,0,67.31
臺北市,北投區,關渡里,108,1,931,11,942,1472,3,1,3,0,1,0,63.99
臺北市,北投區,關渡里,109,1,712,18,730,1146,3,1,3,0,1,0,63.70
臺北市,北投區,關渡里,110,1,930,28,958,1369,3,1,3,0,1,0,69.98
臺北市,北投區,關渡里,111,1,1066,11,1077,1571,3,1,3,0,1,0,68.56
臺北市,北投區,關渡里,112,1,942,17,959,1414,3,1,3,0,1,0,67.82
臺北市,北投區,泉源里,113,1,1166,8,1174,1764,3,1,3,0,1,0,66.55
臺北市,北投區,湖山里,114,1,464,5,469,674,3,1,3,0,1,0,69.58
臺北市,北投區,湖山里,115,1,612,9,621,922,3,1,3,0,1,0,67.35
臺北市,北投區,湖山里,116,1,448,4,452,718,3,1,3,0,1,0,62.95
臺北市,士林區,仁勇里,117,1,604,6,610,922,3,1,3,0,1,0,66.16
臺北市,士林區,仁勇里,118,1,1139,12,1151,1655,3,1,3,0,1,0,69.55
臺北市,士林區,仁勇里,119,1,846,12,858,1213,3,1,3,0,1,0,70.73
臺北市,士林區,義信里,120,1,676,7,683,1081,3,1,3,0,1,0,63.18
臺北市,士林區,義信里,121,1,764,15,779,1168,3,1,3,0,1,0,66.70
臺北市,士林區,福林里,122,1,794,10,804,1266,3,1,3,0,1,0,63.51
臺北市,士林區,福林里,123,1,1046,10,1056,1498,3,1,3,0,1,0,70.49
臺北市,士林區,福林里,124,1,576,6,582,875,3,1,3,0,1,0,66.51
臺北市,士林區,福德里,125,1,970,9,979,1445,3,1,3,0,1,0,67.75
臺北市,士林區,福德里,126,1,1172,10,1182,1808,3,1,3,0,1,0,65.38
臺北市,士林區,福志里,127,1,999,6,1005,1424,3,1,3,0,1,0,70.58
臺北市,士林區,福志里,128,1,1052,9,1061,1608,3,1,3,0,1,0,65.98
臺北市,士林區,福志里,129,1,1040,8,1048,1548,3,1,3,0,1,0,67.70
臺北市,士林區,福志里,130,1,1076,9,1085,1499,3,1,3,0,1,0,72.38
臺北市,士林區,舊佳里,131,1,1350,11,1361,1974,3,1,3,0,1,0,68.95
臺北市,士林區,舊佳里,132,1,1178,7,1185,1736,3,1,3,0,1,0,68.26
臺北市,士林區,舊佳里,133,1,1134,11,1145,1681,3,1,3,0,1,0,68.11
臺北市,士林區,福佳里,134,1,1254,10,1264,1888,3,1,3,0,1,0,66.95
臺北市,士林區,福佳里,135,1,1158,8,1166,1721,3,1,3,0,1,0,67.75
臺北市,士林區,福佳里,136,1,1457,21,1478,2194,3,1,3,0,1,0,67.37
臺北市,士林區,後港里,137,1,1042,14,1056,1605,3,1,3,0,1,0,65.79
臺北市,士林區,後港里,138,1,938,13,951,1518,3,1,3,0,1,0,62.65
臺北市,士林區,後港里,139,1,978,10,988,1582,3,1,3,0,1,0,62.45
臺北市,士林區,後港里,140,1,862,6,868,1396,3,1,3,0,1,0,62.18
臺北市,士林區,福中里,141,1,787,13,800,1282,3,1,3,0,1,0,62.40
臺北市,士林區,福中里,142,1,877,10,887,1347,3,1,3,0,1,0,65.85
臺北市,士林區,福中里,143,1,910,11,921,1401,3,1,3,0,1,0,65.74
臺北市,士林區,前港里,144,1,864,12,876,1473,3,1,3,0,1,0,59.47
臺北市,士林區,前港里,145,1,1024,15,1039,1565,3,1,3,0,1,0,66.39
臺北市,士林區,百齡里,146,1,1143,8,1151,1764,3,1,3,0,1,0,65.25
臺北市,士林區,百齡里,147,1,1191,14,1205,1713,3,1,3,0,1,0,70.34
臺北市,士林區,百齡里,148,1,1259,20,1279,1904,3,1,3,0,1,0,67.17
臺北市,士林區,承德里,149,1,1044,5,1049,1587,3,1,3,0,1,0,66.10
臺北市,士林區,承德里,150,1,1019,12,1031,1509,3,1,3,0,1,0,68.32
臺北市,士林區,福華里,151,1,1509,25,1534,2297,3,1,3,0,1,0,66.78
臺北市,士林區,福華里,152,1,1091,19,1110,1837,3,1,3,0,1,0,60.42
臺北市,士林區,福華里,153,1,859,16,875,1412,3,1,3,0,1,0,61.97
臺北市,士林區,明勝里,154,1,875,13,888,1392,3,1,3,0,1,0,63.79
臺北市,士林區,明勝里,155,1,769,13,782,1192,3,1,3,0,1,0,65.60
臺北市,士林區,明勝里,156,1,875,14,889,1426,3,1,3,0,1,0,62.34
臺北市,士林區,福順里,157,1,1094,12,1106,1625,3,1,3,0,1,0,68.06
臺北市,士林區,福順里,158,1,925,12,937,1459,3,1,3,0,1,0,64.22
臺北市,士林區,福順里,159,1,831,13,844,1194,3,1,3,0,1,0,70.69
臺北市,士林區,富光里,160,1,844,16,860,1326,3,1,3,0,1,0,64.86
臺北市,士林區,富光里,161,1,854,12,866,1377,3,1,3,0,1,0,62.89
臺北市,士林區,富光里,162,1,1176,17,1193,1796,3,1,3,0,1,0,66.43
臺北市,士林區,葫蘆里,163,1,954,13,967,1449,3,1,3,0,1,0,66.74
臺北市,士林區,葫蘆里,164,1,921,9,930,1394,3,1,3,0,1,0,66.71
臺北市,士林區,葫蘆里,165,1,921,14,935,1402,3,1,3,0,1,0,66.69
臺北市,士林區,葫蘆里,166,1,980,12,992,1411,3,1,3,0,1,0,70.30
臺北市,士林區,葫東里,167,1,829,7,836,1261,3,1,3,0,1,0,66.30
臺北市,士林區,葫東里,168,1,1187,12,1199,1731,3,1,3,0,1,0,69.27
臺北市,士林區,社子里,169,1,1044,14,1058,1586,3,1,3,0,1,0,66.71
臺北市,士林區,社子里,170,1,1036,12,1048,1565,3,1,3,0,1,0,66.96
臺北市,士林區,社子里,171,1,976,13,989,1465,3,1,3,0,1,0,67.51
臺北市,士林區,社新里,172,1,951,12,963,1547,3,1,3,0,1,0,62.25
臺北市,士林區,社新里,173,1,921,22,943,1475,3,1,3,0,1,0,63.93
臺北市,士林區,社新里,174,1,815,12,827,1347,3,1,3,0,1,0,61.40
臺北市,士林區,社新里,175,1,1043,20,1063,1669,3,1,3,0,1,0,63.69
臺北市,士林區,社園里,176,1,1077,10,1087,1556,3,1,3,0,1,0,69.86
臺北市,士林區,社園里,177,1,973,14,987,1484,3,1,3,0,1,0,66.51
臺北市,士林區,社園里,178,1,1245,11,1256,1841,3,1,3,0,1,0,68.22
臺北市,士林區,永倫里,179,1,994,7,1001,1589,3,1,3,0,1,0,63.00
臺北市,士林區,永倫里,180,1,1016,6,1022,1534,3,1,3,0,1,0,66.62
臺北市,士林區,永倫里,181,1,629,8,637,935,3,1,3,0,1,0,68.13
臺北市,士林區,永倫里,182,1,997,9,1006,1536,3,1,3,0,1,0,65.49
臺北市,士林區,福安里,183,1,1229,16,1245,1807,3,1,3,0,1,0,68.90
臺北市,士林區,福安里,184,1,1205,19,1224,1825,3,1,3,0,1,0,67.07
臺北市,士林區,富洲里,185,1,1344,20,1364,2097,3,1,3,0,1,0,65.05
臺北市,士林區,富洲里,186,1,1264,12,1276,1898,3,1,3,0,1,0,67.23
臺北市,士林區,岩山里,187,1,980,16,996,1613,3,1,3,0,1,0,61.75
臺北市,士林區,岩山里,188,1,1264,11,1275,1863,3,1,3,0,1,0,68.44
臺北市,士林區,名山里,189,1,1097,11,1108,1594,3,1,3,0,1,0,69.51
臺北市,士林區,名山里,190,1,1175,15,1190,1785,3,1,3,0,1,0,66.67
臺北市,士林區,名山里,191,1,1034,9,1043,1621,3,1,3,0,1,0,64.34
臺北市,士林區,德行里,192,1,966,5,971,1481,3,1,3,0,1,0,65.56
臺北市,士林區,德行里,193,1,1093,13,1106,1693,3,1,3,0,1,0,65.33
臺北市,士林區,德華里,194,1,925,11,936,1347,3,1,3,0,1,0,69.49
臺北市,士林區,德華里,195,1,776,6,782,1239,3,1,3,0,1,0,63.12
臺北市,士林區,德華里,196,1,1130,11,1141,1694,3,1,3,0,1,0,67.36
臺北市,士林區,聖山里,197,1,1313,11,1324,1954,3,1,3,0,1,0,67.76
臺北市,士林區,聖山里,198,1,1249,7,1256,1770,3,1,3,0,1,0,70.96
臺北市,士林區,忠誠里,199,1,1126,12,1138,1512,3,1,3,0,1,0,75.26
臺北市,士林區,忠誠里,200,1,940,16,956,1446,3,1,3,0,1,0,66.11
臺北市,士林區,忠誠里,201,1,1006,3,1009,1398,3,1,3,0,1,0,72.17
臺北市,士林區,芝山里,202,1,1042,6,1048,1625,3,1,3,0,1,0,64.49
臺北市,士林區,芝山里,203,1,1077,12,1089,1599,3,1,3,0,1,0,68.11
臺北市,士林區,芝山里,204,1,1177,9,1186,1787,3,1,3,0,1,0,66.37
臺北市,士林區,東山里,205,1,1343,19,1362,1881,3,1,3,0,1,0,72.41
臺北市,士林區,東山里,206,1,1316,12,1328,1917,3,1,3,0,1,0,69.27
臺北市,士林區,三玉里,207,1,1018,9,1027,1507,3,1,3,0,1,0,68.15
臺北市,士林區,三玉里,208,1,873,9,882,1286,3,1,3,0,1,0,68.58
臺北市,士林區,三玉里,209,1,863,7,870,1334,3,1,3,0,1,0,65.22
臺北市,士林區,天母里,210,1,1071,10,1081,1625,3,1,3,0,1,0,66.52
臺北市,士林區,天母里,211,1,1277,7,1284,1908,3,1,3,0,1,0,67.30
臺北市,士林區,天母里,212,1,875,6,881,1324,3,1,3,0,1,0,66.54
臺北市,士林區,蘭雅里,213,1,1036,7,1043,1614,3,1,3,0,1,0,64.62
臺北市,士林區,蘭雅里,214,1,899,13,912,1381,3,1,3,0,1,0,66.04
臺北市,士林區,蘭雅里,215,1,1129,5,1134,1757,3,1,3,0,1,0,64.54
臺北市,士林區,蘭雅里,216,1,966,9,975,1508,3,1,3,0,1,0,64.66
臺北市,士林區,蘭興里,217,1,1078,9,1087,1623,3,1,3,0,1,0,66.97
臺北市,士林區,蘭興里,218,1,985,6,991,1480,3,1,3,0,1,0,66.96
臺北市,士林區,蘭興里,219,1,836,13,849,1378,3,1,3,0,1,0,61.61
臺北市,士林區,天福里,220,1,1128,13,1141,1685,3,1,3,0,1,0,67.72
臺北市,士林區,天福里,221,1,1035,9,1044,1479,3,1,3,0,1,0,70.59
臺北市,士林區,天福里,222,1,984,8,992,1461,3,1,3,0,1,0,67.90
臺北市,士林區,天祿里,223,1,1163,10,1173,1829,3,1,3,0,1,0,64.13
臺北市,士林區,天祿里,224,1,1299,14,1313,1998,3,1,3,0,1,0,65.72
臺北市,士林區,天壽里,225,1,1179,12,1191,1801,3,1,3,0,1,0,66.13
臺北市,士林區,天壽里,226,1,983,4,987,1509,3,1,3,0,1,0,65.41
臺北市,士林區,天和里,227,1,1202,10,1212,1839,3,1,3,0,1,0,65.91
臺北市,士林區,天和里,228,1,1253,10,1263,1918,3,1,3,0,1,0,65.85
臺北市,士林區,天和里,229,1,1030,7,1037,1685,3,1,3,0,1,0,61.54
臺北市,士林區,天山里,230,1,1072,3,1075,1696,3,1,3,0,1,0,63.38
臺北市,士林區,天山里,231,1,1060,5,1065,1721,3,1,3,0,1,0,61.88
臺北市,士林區,天山里,232,1,1163,12,1175,1860,3,1,3,0,1,0,63.17
臺北市,士林區,天玉里,233,1,1184,6,1190,1839,3,1,3,0,1,0,64.71
臺北市,士林區,天玉里,234,1,1538,16,1554,2347,3,1,3,0,1,0,66.21
臺北市,士林區,天玉里,235,1,1255,15,1270,1894,3,1,3,0,1,0,67.05
臺北市,士林區,永福里,236,1,671,6,677,1048,3,1,3,0,1,0,64.60
臺北市,士林區,公舘里,237,1,735,5,740,1108,3,1,3,0,1,0,66.79
臺北市,士林區,新安里,238,1,1031,26,1057,1663,3,1,3,0,1,0,63.56
臺北市,士林區,陽明里,239,1,1048,17,1065,1803,3,1,3,0,1,0,59.07
臺北市,士林區,陽明里,240,1,522,11,533,837,3,1,3,0,1,0,63.68
臺北市,士林區,菁山里,241,1,853,9,862,1262,3,1,3,0,1,0,68.30
臺北市,士林區,平等里,242,1,833,6,839,1137,3,1,3,0,1,0,73.79
臺北市,士林區,溪山里,243,1,791,13,804,1218,3,1,3,0,1,0,66.01
臺北市,士林區,翠山里,244,1,1008,7,1015,1463,3,1,3,0,1,0,69.38
臺北市,士林區,翠山里,245,1,925,7,932,1386,3,1,3,0,1,0,67.24
臺北市,士林區,翠山里,246,1,519,5,524,844,3,1,3,0,1,0,62.09
臺北市,士林區,翠山里,247,1,899,14,913,1394,3,1,3,0,1,0,65.49
臺北市,松山區,莊敬里,248,1,1090,6,1096,1551,3,1,3,0,1,0,70.66
臺北市,松山區,莊敬里,249,1,1069,8,1077,1605,3,1,3,0,1,0,67.10
臺北市,松山區,莊敬里,250,1,1077,6,1083,1619,3,1,3,0,1,0,66.89
臺北市,松山區,東榮里,251,1,1134,7,1141,1744,3,1,3,0,1,0,65.42
臺北市,松山區,東榮里,252,1,1245,7,1252,1814,3,1,3,0,1,0,69.02
臺北市,松山區,東榮里,253,1,1065,10,1075,1706,3,1,3,0,1,0,63.01
臺北市,松山區,東榮里,254,1,1125,4,1129,1683,3,1,3,0,1,0,67.08
臺北市,松山區,三民里,255,1,1217,15,1232,1774,3,1,3,0,1,0,69.45
臺北市,松山區,三民里,256,1,1015,2,1017,1859,3,1,3,0,1,0,54.71
臺北市,松山區,三民里,257,1,1251,8,1259,1808,3,1,3,0,1,0,69.63
臺北市,松山區,新益里,258,1,1242,7,1249,1853,3,1,3,0,1,0,67.40
臺北市,松山區,新益里,259,1,1217,16,1233,1938,3,1,3,0,1,0,63.62
臺北市,松山區,富錦里,260,1,960,5,965,1535,3,1,3,0,1,0,62.87
臺北市,松山區,富錦里,261,1,759,7,766,1094,3,1,3,0,1,0,70.02
臺北市,松山區,富錦里,262,1,1110,11,1121,1669,3,1,3,0,1,0,67.17
臺北市,松山區,新東里,263,1,1195,8,1203,1851,3,1,3,0,1,0,64.99
臺北市,松山區,新東里,264,1,1274,17,1291,1906,3,1,3,0,1,0,67.73
臺北市,松山區,富泰里,265,1,1113,4,1117,1729,3,1,3,0,1,0,64.60
臺北市,松山區,富泰里,266,1,1115,11,1126,1812,3,1,3,0,1,0,62.14
臺北市,松山區,介壽里,267,1,1370,12,1382,2149,3,1,3,0,1,0,64.31
臺北市,松山區,介壽里,268,1,1148,6,1154,1836,3,1,3,0,1,0,62.85
臺北市,松山區,精忠里,269,1,1209,9,1218,1838,3,1,3,0,1,0,66.27
臺北市,松山區,精忠里,270,1,1180,6,1186,1892,3,1,3,0,1,0,62.68
臺北市,松山區,東光里,271,1,1464,26,1490,2292,3,1,3,0,1,0,65.01
臺北市,松山區,東光里,272,1,1273,14,1287,1890,3,1,3,0,1,0,68.10
臺北市,松山區,東光里,273,1,634,4,638,923,3,1,3,0,1,0,69.12
臺北市,松山區,東光里,274,1,671,4,675,1049,3,1,3,0,1,0,64.35
臺北市,松山區,龍田里,275,1,1221,9,1230,1822,3,1,3,0,1,0,67.51
臺北市,松山區,龍田里,276,1,938,7,945,1495,3,1,3,0,1,0,63.21
臺北市,松山區,東昌里,277,1,1276,12,1288,2007,3,1,3,0,1,0,64.18
臺北市,松山區,東昌里,278,1,1224,7,1231,1873,3,1,3,0,1,0,65.72
臺北市,松山區,東勢里,279,1,897,8,905,1450,3,1,3,0,1,0,62.41
臺北市,松山區,東勢里,280,1,860,13,873,1309,3,1,3,0,1,0,66.69
臺北市,松山區,中華里,281,1,1304,12,1316,1902,3,1,3,0,1,0,69.19
臺北市,松山區,中華里,282,1,1142,4,1146,1716,3,1,3,0,1,0,66.78
臺北市,松山區,民有里,283,1,1028,11,1039,1724,3,1,3,0,1,0,60.27
臺北市,松山區,民有里,284,1,1119,5,1124,1693,3,1,3,0,1,0,66.39
臺北市,松山區,民有里,285,1,974,9,983,1548,3,1,3,0,1,0,63.50
臺北市,松山區,民有里,286,1,1103,12,1115,1763,3,1,3,0,1,0,63.24
臺北市,松山區,民福里,287,1,1187,13,1200,1751,3,1,3,0,1,0,68.53
臺北市,松山區,民福里,288,1,1212,9,1221,1837,3,1,3,0,1,0,66.47
臺北市,松山區,民福里,289,1,1026,9,1035,1601,3,1,3,0,1,0,64.65
臺北市,松山區,松基里,290,1,1313,18,1331,2166,3,1,3,0,1,0,61.45
臺北市,松山區,松基里,291,1,534,8,542,839,3,1,3,0,1,0,64.60
臺北市,松山區,慈祐里,292,1,1082,9,1091,1588,3,1,3,0,1,0,68.70
臺北市,松山區,慈祐里,293,1,1386,12,1398,2046,3,1,3,0,1,0,68.33
臺北市,松山區,慈祐里,294,1,619,15,634,935,3,1,3,0,1,0,67.81
臺北市,松山區,安平里,295,1,1185,15,1200,1770,3,1,3,0,1,0,67.80
臺北市,松山區,安平里,296,1,1113,12,1125,1676,3,1,3,0,1,0,67.12
臺北市,松山區,安平里,297,1,1167,10,1177,1749,3,1,3,0,1,0,67.30
臺北市,松山區,安平里,298,1,1273,21,1294,1909,3,1,3,0,1,0,67.78
臺北市,松山區,鵬程里,299,1,1109,15,1124,1596,3,1,3,0,1,0,70.43
臺北市,松山區,鵬程里,300,1,1679,15,1694,2351,3,1,3,0,1,0,72.05
臺北市,松山區,自強里,301,1,1290,5,1295,1756,3,1,3,0,1,0,73.75
臺北市,松山區,自強里,302,1,867,5,872,1298,3,1,3,0,1,0,67.18
臺北市,松山區,自強里,303,1,902,13,915,1300,3,1,3,0,1,0,70.38
臺北市,松山區,自強里,304,1,786,9,795,1241,3,1,3,0,1,0,64.06
臺北市,松山區,吉祥里,305,1,1297,15,1312,2079,3,1,3,0,1,0,63.11
臺北市,松山區,吉祥里,306,1,1253,17,1270,1989,3,1,3,0,1,0,63.85
臺北市,松山區,吉祥里,307,1,1187,13,1200,1824,3,1,3,0,1,0,65.79
臺北市,松山區,新聚里,308,1,1227,12,1239,1957,3,1,3,0,1,0,63.31
臺北市,松山區,新聚里,309,1,1146,16,1162,1838,3,1,3,0,1,0,63.22
臺北市,松山區,新聚里,310,1,1256,6,1262,1836,3,1,3,0,1,0,68.74
臺北市,松山區,復盛里,311,1,1238,13,1251,1850,3,1,3,0,1,0,67.62
臺北市,松山區,復盛里,312,1,949,6,955,1549,3,1,3,0,1,0,61.65
臺北市,松山區,復盛里,313,1,1079,11,1090,1654,3,1,3,0,1,0,65.90
臺北市,松山區,中正里,314,1,905,12,917,1502,3,1,3,0,1,0,61.05
臺北市,松山區,中正里,315,1,914,9,923,1574,3,1,3,0,1,0,58.64
臺北市,松山區,中正里,316,1,1001,6,1007,1505,3,1,3,0,1,0,66.91
臺北市,松山區,中正里,317,1,832,11,843,1416,3,1,3,0,1,0,59.53
臺北市,松山區,中崙里,318,1,987,14,1001,1565,3,1,3,0,1,0,63.96
臺北市,松山區,中崙里,319,1,1046,6,1052,1593,3,1,3,0,1,0,66.04
臺北市,松山區,美仁里,320,1,792,8,800,1263,3,1,3,0,1,0,63.34
臺北市,松山區,美仁里,321,1,970,12,982,1532,3,1,3,0,1,0,64.10
臺北市,松山區,吉仁里,322,1,953,12,965,1461,3,1,3,0,1,0,66.05
臺北市,松山區,吉仁里,323,1,972,9,981,1528,3,1,3,0,1,0,64.20
臺北市,松山區,敦化里,324,1,1300,7,1307,1927,3,1,3,0,1,0,67.83
臺北市,松山區,敦化里,325,1,1243,15,1258,1884,3,1,3,0,1,0,66.77
臺北市,松山區,敦化里,326,1,1206,13,1219,1876,3,1,3,0,1,0,64.98
臺北市,松山區,復源里,327,1,783,8,791,1135,3,1,3,0,1,0,69.69
臺北市,松山區,復源里,328,1,925,5,930,1456,3,1,3,0,1,0,63.87
臺北市,松山區,復建里,329,1,865,8,873,1355,3,1,3,0,1,0,64.43
臺北市,松山區,復建里,330,1,862,14,876,1354,3,1,3,0,1,0,64.70
臺北市,松山區,復勢里,331,1,1061,16,1077,1583,3,1,3,0,1,0,68.04
臺北市,松山區,復勢里,332,1,1170,12,1182,1748,3,1,3,0,1,0,67.62
臺北市,松山區,復勢里,333,1,932,7,939,1408,3,1,3,0,1,0,66.69
臺北市,松山區,福成里,334,1,680,6,686,1036,3,1,3,0,1,0,66.22
臺北市,松山區,福成里,335,1,693,8,701,1193,3,1,3,0,1,0,58.76
臺北市,信義區,西村里,336,1,1321,9,1330,1851,3,1,3,0,1,0,71.85
臺北市,信義區,西村里,337,1,1369,10,1379,1944,3,1,3,0,1,0,70.94
臺北市,信義區,正和里,338,1,1284,9,1293,1944,3,1,3,0,1,0,66.51
臺北市,信義區,正和里,339,1,1344,12,1356,2029,3,1,3,0,1,0,66.83
臺北市,信義區,興隆里,340,1,830,9,839,1250,3,1,3,0,1,0,67.12
臺北市,信義區,興隆里,341,1,761,5,766,1285,3,1,3,0,1,0,59.61
臺北市,信義區,中興里,342,1,1446,14,1460,2302,3,1,3,0,1,0,63.42
臺北市,信義區,新仁里,343,1,1250,10,1260,1875,3,1,3,0,1,0,67.20
臺北市,信義區,新仁里,344,1,1033,8,1041,1645,3,1,3,0,1,0,63.28
臺北市,信義區,興雅里,345,1,1104,16,1120,1806,3,1,3,0,1,0,62.02
臺北市,信義區,興雅里,346,1,1249,8,1257,1850,3,1,3,0,1,0,67.95
臺北市,信義區,興雅里,347,1,856,11,867,1252,3,1,3,0,1,0,69.25
臺北市,信義區,敦厚里,348,1,1173,10,1183,1898,3,1,3,0,1,0,62.33
臺北市,信義區,敦厚里,349,1,1094,9,1103,1824,3,1,3,0,1,0,60.47
臺北市,信義區,廣居里,350,1,1072,11,1083,1560,3,1,3,0,1,0,69.42
臺北市,信義區,廣居里,351,1,946,8,954,1503,3,1,3,0,1,0,63.47
臺北市,信義區,廣居里,352,1,1119,8,1127,1760,3,1,3,0,1,0,64.03
臺北市,信義區,安康里,353,1,1135,16,1151,1635,3,1,3,0,1,0,70.40
臺北市,信義區,安康里,354,1,1168,11,1179,1805,3,1,3,0,1,0,65.32
臺北市,信義區,安康里,355,1,1154,9,1163,1806,3,1,3,0,1,0,64.40
臺北市,信義區,六藝里,356,1,797,19,816,1266,3,1,3,0,1,0,64.45
臺北市,信義區,六藝里,357,1,1113,7,1120,1596,3,1,3,0,1,0,70.18
臺北市,信義區,雅祥里,358,1,1227,13,1240,1968,3,1,3,0,1,0,63.01
臺北市,信義區,雅祥里,359,1,1229,15,1244,1807,3,1,3,0,1,0,68.84
臺北市,信義區,五常里,360,1,1005,9,1014,1529,3,1,3,0,1,0,66.32
臺北市,信義區,五常里,361,1,885,14,899,1385,3,1,3,0,1,0,64.91
臺北市,信義區,五全里,362,1,1543,17,1560,2303,3,1,3,0,1,0,67.74
臺北市,信義區,五全里,363,1,1227,15,1242,1890,3,1,3,0,1,0,65.71
臺北市,信義區,永吉里,364,1,1174,12,1186,1917,3,1,3,0,1,0,61.87
臺北市,信義區,永吉里,365,1,1000,14,1014,1705,3,1,3,0,1,0,59.47
臺北市,信義區,長春里,366,1,1397,21,1418,2125,3,1,3,0,1,0,66.73
臺北市,信義區,長春里,367,1,1098,11,1109,1647,3,1,3,0,1,0,67.33
臺北市,信義區,四育里,368,1,1544,15,1559,2277,3,1,3,0,1,0,68.47
臺北市,信義區,四育里,369,1,1549,24,1573,2220,3,1,3,0,1,0,70.86
臺北市,信義區,四維里,370,1,1575,17,1592,2334,3,1,3,0,1,0,68.21
臺北市,信義區,四維里,371,1,1352,20,1372,2158,3,1,3,0,1,0,63.58
臺北市,信義區,永春里,372,1,1410,11,1421,2092,3,1,3,0,1,0,67.93
臺北市,信義區,永春里,373,1,1548,12,1560,2285,3,1,3,0,1,0,68.27
臺北市,信義區,富台里,374,1,1130,10,1140,1627,3,1,3,0,1,0,70.07
臺北市,信義區,富台里,375,1,1004,12,1016,1465,3,1,3,0,1,0,69.35
臺北市,信義區,國業里,376,1,1382,16,1398,2067,3,1,3,0,1,0,67.63
臺北市,信義區,國業里,377,1,1143,9,1152,1686,3,1,3,0,1,0,68.33
臺北市,信義區,國業里,378,1,1072,18,1090,1557,3,1,3,0,1,0,70.01
臺北市,信義區,松隆里,379,1,1415,24,1439,2233,3,1,3,0,1,0,64.44
臺北市,信義區,松友里,380,1,1605,22,1627,2488,3,1,3,0,1,0,65.39
臺北市,信義區,松友里,381,1,1521,9,1530,2208,3,1,3,0,1,0,69.29
臺北市,信義區,松光里,382,1,1002,14,1016,1560,3,1,3,0,1,0,65.13
臺北市,信義區,松光里,383,1,932,10,942,1362,3,1,3,0,1,0,69.16
臺北市,信義區,松光里,384,1,1127,7,1134,1711,3,1,3,0,1,0,66.28
臺北市,信義區,中坡里,385,1,1216,21,1237,1786,3,1,3,0,1,0,69.26
臺北市,信義區,中坡里,386,1,1285,16,1301,1937,3,1,3,0,1,0,67.17
臺北市,信義區,中行里,387,1,1424,13,1437,2121,3,1,3,0,1,0,67.75
臺北市,信義區,中行里,388,1,1347,14,1361,1985,3,1,3,0,1,0,68.56
臺北市,信義區,中行里,389,1,1442,24,1466,2168,3,1,3,0,1,0,67.62
臺北市,信義區,大道里,390,1,1174,23,1197,1758,3,1,3,0,1,0,68.09
臺北市,信義區,大道里,391,1,1089,15,1104,1674,3,1,3,0,1,0,65.95
臺北市,信義區,大道里,392,1,1121,11,1132,1684,3,1,3,0,1,0,67.22
臺北市,信義區,大仁里,393,1,1108,21,1129,1610,3,1,3,0,1,0,70.12
臺北市,信義區,大仁里,394,1,1245,32,1277,1999,3,1,3,0,1,0,63.88
臺北市,信義區,大仁里,395,1,1038,13,1051,1509,3,1,3,0,1,0,69.65
臺北市,信義區,景新里,396,1,926,6,932,1385,3,1,3,0,1,0,67.29
臺北市,信義區,景新里,397,1,1157,10,1167,1615,3,1,3,0,1,0,72.26
臺北市,信義區,景新里,398,1,1045,5,1050,1430,3,1,3,0,1,0,73.43
臺北市,信義區,惠安里,399,1,1392,17,1409,2010,3,1,3,0,1,0,70.10
臺北市,信義區,惠安里,400,1,1125,10,1135,1567,3,1,3,0,1,0,72.43
臺北市,信義區,惠安里,401,1,1333,19,1352,1972,3,1,3,0,1,0,68.56
臺北市,信義區,三張里,402,1,1211,8,1219,1864,3,1,3,0,1,0,65.40
臺北市,信義區,三張里,403,1,1243,16,1259,1871,3,1,3,0,1,0,67.29
臺北市,信義區,三張里,404,1,1043,10,1053,1589,3,1,3,0,1,0,66.27
臺北市,信義區,三張里,405,1,1058,6,1064,1553,3,1,3,0,1,0,68.51
臺北市,信義區,三犁里,406,1,1251,20,1271,1886,3,1,3,0,1,0,67.39
臺北市,信義區,三犁里,407,1,1181,11,1192,1824,3,1,3,0,1,0,65.35
臺北市,信義區,六合里,408,1,1327,9,1336,2003,3,1,3,0,1,0,66.70
臺北市,信義區,六合里,409,1,1166,17,1183,1798,3,1,3,0,1,0,65.80
臺北市,信義區,六合里,410,1,760,7,767,1213,3,1,3,0,1,0,63.23
臺北市,信義區,泰和里,411,1,1560,15,1575,2392,3,1,3,0,1,0,65.84
臺北市,信義區,泰和里,412,1,1268,9,1277,1864,3,1,3,0,1,0,68.51
臺北市,信義區,泰和里,413,1,1484,10,1494,2133,3,1,3,0,1,0,70.04
臺北市,信義區,景聯里,414,1,1187,17,1204,1893,3,1,3,0,1,0,63.60
臺北市,信義區,景聯里,415,1,1438,15,1453,2075,3,1,3,0,1,0,70.02
臺北市,信義區,景勤里,416,1,1333,19,1352,2027,3,1,3,0,1,0,66.70
臺北市,信義區,景勤里,417,1,1286,15,1301,1833,3,1,3,0,1,0,70.98
臺北市,信義區,雙和里,418,1,1456,19,1475,2145,3,1,3,0,1,0,68.76
臺北市,信義區,雙和里,419,1,1011,9,1020,1472,3,1,3,0,1,0,69.29
臺北市,信義區,雙和里,420,1,1114,7,1121,1574,3,1,3,0,1,0,71.22
臺北市,信義區,嘉興里,421,1,875,10,885,1317,3,1,3,0,1,0,67.20
臺北市,信義區,嘉興里,422,1,774,11,785,1218,3,1,3,0,1,0,64.45
臺北市,信義區,黎順里,423,1,1146,13,1159,1735,3,1,3,0,1,0,66.80
臺北市,信義區,黎順里,424,1,1156,14,1170,1770,3,1,3,0,1,0,66.10
臺北市,信義區,黎平里,425,1,1165,15,1180,1764,3,1,3,0,1,0,66.89
臺北市,信義區,黎平里,426,1,1191,14,1205,1806,3,1,3,0,1,0,66.72
臺北市,信義區,黎平里,427,1,1202,15,1217,1804,3,1,3,0,1,0,67.46
臺北市,信義區,黎忠里,428,1,1291,21,1312,1953,3,1,3,0,1,0,67.18
臺北市,信義區,黎忠里,429,1,1254,13,1267,1894,3,1,3,0,1,0,66.90
臺北市,信義區,黎安里,430,1,1711,45,1756,2461,3,1,3,0,1,0,71.35
臺北市,內湖區,西康里,431,1,1020,24,1044,1538,3,1,3,0,1,0,67.88
臺北市,內湖區,西康里,432,1,1472,14,1486,2137,3,1,3,0,1,0,69.54
臺北市,內湖區,西康里,433,1,1258,10,1268,1682,3,1,3,0,1,0,75.39
臺北市,內湖區,西安里,434,1,992,17,1009,1343,3,1,3,0,1,0,75.13
臺北市,內湖區,西安里,435,1,819,7,826,1185,3,1,3,0,1,0,69.70
臺北市,內湖區,西安里,436,1,1128,9,1137,1598,3,1,3,0,1,0,71.15
臺北市,內湖區,西湖里,437,1,1359,15,1374,1993,3,1,3,0,1,0,68.94
臺北市,內湖區,西湖里,438,1,1384,13,1397,2026,3,1,3,0,1,0,68.95
臺北市,內湖區,西湖里,439,1,1231,11,1242,1800,3,1,3,0,1,0,69.00
臺北市,內湖區,港墘里,440,1,1213,10,1223,1676,3,1,3,0,1,0,72.97
臺北市,內湖區,港墘里,441,1,1120,17,1137,1594,3,1,3,0,1,0,71.33
臺北市,內湖區,港華里,442,1,1207,9,1216,1734,3,1,3,0,1,0,70.13
臺北市,內湖區,港華里,443,1,1274,13,1287,1816,3,1,3,0,1,0,70.87
臺北市,內湖區,港華里,444,1,1308,13,1321,1898,3,1,3,0,1,0,69.60
臺北市,內湖區,港都里,445,1,1348,5,1353,1955,3,1,3,0,1,0,69.21
臺北市,內湖區,港都里,446,1,1210,11,1221,1755,3,1,3,0,1,0,69.57
臺北市,內湖區,港都里,447,1,1342,12,1354,1909,3,1,3,0,1,0,70.93
臺北市,內湖區,港都里,448,1,1410,16,1426,2035,3,1,3,0,1,0,70.07
臺北市,內湖區,港富里,449,1,940,10,950,1355,3,1,3,0,1,0,70.11
臺北市,內湖區,港富里,450,1,1283,31,1314,1988,3,1,3,0,1,0,66.10
臺北市,內湖區,港富里,451,1,1027,12,1039,1451,3,1,3,0,1,0,71.61
臺北市,內湖區,港富里,452,1,1132,10,1142,1610,3,1,3,0,1,0,70.93
臺北市,內湖區,瑞光里,453,1,1163,7,1170,1649,3,1,3,0,1,0,70.95
臺北市,內湖區,瑞光里,454,1,1206,12,1218,1619,3,1,3,0,1,0,75.23
臺北市,內湖區,瑞陽里,455,1,1489,17,1506,1961,3,1,3,0,1,0,76.80
臺北市,內湖區,瑞陽里,456,1,1263,19,1282,1704,3,1,3,0,1,0,75.23
臺北市,內湖區,瑞陽里,457,1,1313,13,1326,1763,3,1,3,0,1,0,75.21
臺北市,內湖區,紫陽里,458,1,1144,14,1158,1667,3,1,3,0,1,0,69.47
臺北市,內湖區,紫陽里,459,1,1058,6,1064,1496,3,1,3,0,1,0,71.12
臺北市,內湖區,紫陽里,460,1,996,10,1006,1483,3,1,3,0,1,0,67.84
臺北市,內湖區,湖濱里,461,1,1360,20,1380,1952,3,1,3,0,1,0,70.70
臺北市,內湖區,湖濱里,462,1,1139,6,1145,1639,3,1,3,0,1,0,69.86
臺北市,內湖區,湖濱里,463,1,1060,16,1076,1524,3,1,3,0,1,0,70.60
臺北市,內湖區,湖元里,464,1,1118,9,1127,1590,3,1,3,0,1,0,70.88
臺北市,內湖區,湖元里,465,1,1017,10,1027,1488,3,1,3,0,1,0,69.02
臺北市,內湖區,石潭里,466,1,858,13,871,1272,3,1,3,0,1,0,68.47
臺北市,內湖區,石潭里,467,1,798,9,807,1203,3,1,3,0,1,0,67.08
臺北市,內湖區,內湖里,468,1,1145,23,1168,1774,3,1,3,0,1,0,65.84
臺北市,內湖區,內湖里,469,1,956,9,965,1531,3,1,3,0,1,0,63.03
臺北市,內湖區,金龍里,470,1,1001,9,1010,1374,3,1,3,0,1,0,73.51
臺北市,內湖區,金龍里,471,1,995,9,1004,1423,3,1,3,0,1,0,70.56
臺北市,內湖區,金龍里,472,1,957,6,963,1345,3,1,3,0,1,0,71.60
臺北市,內湖區,金瑞里,473,1,982,4,986,1385,3,1,3,0,1,0,71.19
臺北市,內湖區,金瑞里,474,1,896,5,901,1307,3,1,3,0,1,0,68.94
臺北市,內湖區,金瑞里,475,1,1186,26,1212,1675,3,1,3,0,1,0,72.36
臺北市,內湖區,碧山里,476,1,249,1,250,364,3,1,3,0,1,0,68.68
臺北市,內湖區,碧山里,477,1,1005,8,1013,1451,3,1,3,0,1,0,69.81
臺北市,內湖區,碧山里,478,1,1025,14,1039,1411,3,1,3,0,1,0,73.64
臺北市,內湖區,碧山里,479,1,882,16,898,1310,3,1,3,0,1,0,68.55
臺北市,內湖區,行善里,480,1,908,17,925,1275,3,1,3,0,1,0,72.55
臺北市,內湖區,行善里,481,1,806,8,814,1166,3,1,3,0,1,0,69.81
臺北市,內湖區,週美里,482,1,1073,18,1091,1588,3,1,3,0,1,0,68.70
臺北市,內湖區,週美里,483,1,1347,16,1363,1895,3,1,3,0,1,0,71.93
臺北市,內湖區,紫星里,484,1,938,29,967,1411,3,1,3,0,1,0,68.53
臺北市,內湖區,紫星里,485,1,896,6,902,1291,3,1,3,0,1,0,69.87
臺北市,內湖區,紫星里,486,1,1111,10,1121,1597,3,1,3,0,1,0,70.19
臺北市,內湖區,紫星里,487,1,1081,12,1093,1541,3,1,3,0,1,0,70.93
臺北市,內湖區,紫雲里,488,1,820,5,825,1118,3,1,3,0,1,0,73.79
臺北市,內湖區,紫雲里,489,1,1072,14,1086,1532,3,1,3,0,1,0,70.89
臺北市,內湖區,紫雲里,490,1,781,8,789,1122,3,1,3,0,1,0,70.32
臺北市,內湖區,清白里,491,1,719,11,730,1043,3,1,3,0,1,0,69.99
臺北市,內湖區,清白里,492,1,1288,13,1301,1784,3,1,3,0,1,0,72.93
臺北市,內湖區,大湖里,493,1,1109,10,1119,1641,3,1,3,0,1,0,68.19
臺北市,內湖區,大湖里,494,1,723,2,725,1113,3,1,3,0,1,0,65.14
臺北市,內湖區,大湖里,495,1,1667,16,1683,2553,3,1,3,0,1,0,65.92
臺北市,內湖區,大湖里,496,1,557,4,561,883,3,1,3,0,1,0,63.53
臺北市,內湖區,湖興里,497,1,981,9,990,1415,3,1,3,0,1,0,69.96
臺北市,內湖區,湖興里,498,1,1131,12,1143,1627,3,1,3,0,1,0,70.25
臺北市,內湖區,湖興里,499,1,990,6,996,1422,3,1,3,0,1,0,70.04
臺北市,內湖區,葫洲里,500,1,1228,10,1238,1756,3,1,3,0,1,0,70.50
臺北市,內湖區,葫洲里,501,1,1393,9,1402,1963,3,1,3,0,1,0,71.42
臺北市,內湖區,葫洲里,502,1,478,11,489,786,3,1,3,0,1,0,62.21
臺北市,內湖區,葫洲里,503,1,1316,13,1329,1938,3,1,3,0,1,0,68.58
臺北市,內湖區,葫洲里,504,1,988,5,993,1494,3,1,3,0,1,0,66.47
臺北市,內湖區,葫洲里,505,1,1457,8,1465,2213,3,1,3,0,1,0,66.20
臺北市,內湖區,葫洲里,506,1,1615,11,1626,2370,3,1,3,0,1,0,68.61
臺北市,內湖區,五分里,507,1,1090,10,1100,1717,3,1,3,0,1,0,64.07
臺北市,內湖區,五分里,508,1,1188,14,1202,1759,3,1,3,0,1,0,68.33
臺北市,內湖區,五分里,509,1,1248,18,1266,1867,3,1,3,0,1,0,67.81
臺北市,內湖區,樂康里,510,1,1054,20,1074,1629,3,1,3,0,1,0,65.93
臺北市,內湖區,樂康里,511,1,1134,11,1145,1665,3,1,3,0,1,0,68.77
臺北市,內湖區,樂康里,512,1,1022,12,1034,1574,3,1,3,0,1,0,65.69
臺北市,內湖區,東湖里,513,1,1206,12,1218,1823,3,1,3,0,1,0,66.81
臺北市,內湖區,東湖里,514,1,1198,11,1209,1806,3,1,3,0,1,0,66.94
臺北市,內湖區,東湖里,515,1,1306,10,1316,1927,3,1,3,0,1,0,68.29
臺北市,內湖區,東湖里,516,1,1174,13,1187,1795,3,1,3,0,1,0,66.13
臺北市,內湖區,東湖里,517,1,1130,10,1140,1776,3,1,3,0,1,0,64.19
臺北市,內湖區,內溝里,518,1,396,4,400,599,3,1,3,0,1,0,66.78
臺北市,內湖區,內溝里,519,1,1183,10,1193,1808,3,1,3,0,1,0,65.98
臺北市,內湖區,內溝里,520,1,1010,13,1023,1500,3,1,3,0,1,0,68.20
臺北市,內湖區,內溝里,521,1,901,6,907,1319,3,1,3,0,1,0,68.76
臺北市,南港區,南港里,522,1,880,9,889,1287,3,1,3,0,1,0,69.08
臺北市,南港區,南港里,523,1,882,14,896,1342,3,1,3,0,1,0,66.77
臺北市,南港區,南港里,524,1,934,13,947,1424,3,1,3,0,1,0,66.50
臺北市,南港區,中南里,525,1,999,21,1020,1515,3,1,3,0,1,0,67.33
臺北市,南港區,中南里,526,1,1068,13,1081,1705,3,1,3,0,1,0,63.40
臺北市,南港區,新富里,527,1,1004,20,1024,1475,3,1,3,0,1,0,69.42
臺北市,南港區,新富里,528,1,1148,23,1171,1705,3,1,3,0,1,0,68.68
臺北市,南港區,三重里,529,1,754,14,768,1186,3,1,3,0,1,0,64.76
臺北市,南港區,三重里,530,1,916,10,926,1423,3,1,3,0,1,0,65.07
臺北市,南港區,東新里,531,1,1352,19,1371,2036,3,1,3,0,1,0,67.34
臺北市,南港區,東新里,532,1,1102,17,1119,1656,3,1,3,0,1,0,67.57
臺北市,南港區,東新里,533,1,887,7,894,1387,3,1,3,0,1,0,64.46
臺北市,南港區,新光里,534,1,1290,22,1312,1820,3,1,3,0,1,0,72.09
臺北市,南港區,新光里,535,1,1167,10,1177,1694,3,1,3,0,1,0,69.48
臺北市,南港區,東明里,536,1,1193,17,1210,1770,3,1,3,0,1,0,68.36
臺北市,南港區,東明里,537,1,972,22,994,1491,3,1,3,0,1,0,66.67
臺北市,南港區,西新里,538,1,1197,12,1209,1818,3,1,3,0,1,0,66.50
臺北市,南港區,西新里,539,1,1139,16,1155,1667,3,1,3,0,1,0,69.29
臺北市,南港區,玉成里,540,1,1145,11,1156,1804,3,1,3,0,1,0,64.08
臺北市,南港區,玉成里,541,1,1247,14,1261,1770,3,1,3,0,1,0,71.24
臺北市,南港區,合成里,542,1,978,13,991,1412,3,1,3,0,1,0,70.18
臺北市,南港區,合成里,543,1,851,10,861,1203,3,1,3,0,1,0,71.57
臺北市,南港區,合成里,544,1,1378,16,1394,2028,3,1,3,0,1,0,68.74
臺北市,南港區,成福里,545,1,1202,22,1224,1708,3,1,3,0,1,0,71.66
臺北市,南港區,成福里,546,1,1311,15,1326,1880,3,1,3,0,1,0,70.53
臺北市,南港區,成福里,547,1,1233,10,1243,1749,3,1,3,0,1,0,71.07
臺北市,南港區,鴻福里,548,1,1195,24,1219,1777,3,1,3,0,1,0,68.60
臺北市,南港區,鴻福里,549,1,1222,17,1239,1769,3,1,3,0,1,0,70.04
臺北市,南港區,萬福里,550,1,1247,15,1262,1768,3,1,3,0,1,0,71.38
臺北市,南港區,萬福里,551,1,1127,11,1138,1517,3,1,3,0,1,0,75.02
臺北市,南港區,百福里,552,1,1350,21,1371,1955,3,1,3,0,1,0,70.13
臺北市,南港區,百福里,553,1,1210,20,1230,1859,3,1,3,0,1,0,66.16
臺北市,南港區,聯成里,554,1,1484,15,1499,2088,3,1,3,0,1,0,71.79
臺北市,南港區,聯成里,555,1,1321,35,1356,1908,3,1,3,0,1,0,71.07
臺北市,南港區,舊莊里,556,1,1089,19,1108,1702,3,1,3,0,1,0,65.10
臺北市,南港區,舊莊里,557,1,755,9,764,1180,3,1,3,0,1,0,64.75
臺北市,南港區,舊莊里,558,1,833,6,839,1297,3,1,3,0,1,0,64.69
臺北市,南港區,舊莊里,559,1,1130,32,1162,1845,3,1,3,0,1,0,62.98
臺北市,南港區,中研里,560,1,1211,16,1227,1773,3,1,3,0,1,0,69.20
臺北市,南港區,中研里,561,1,1143,13,1156,1591,3,1,3,0,1,0,72.66
臺北市,南港區,中研里,562,1,1219,6,1225,1732,3,1,3,0,1,0,70.73
臺北市,南港區,中研里,563,1,1132,19,1151,1574,3,1,3,0,1,0,73.13
臺北市,南港區,九如里,564,1,1265,12,1277,1795,3,1,3,0,1,0,71.14
臺北市,南港區,九如里,565,1,961,11,972,1407,3,1,3,0,1,0,69.08
臺北市,南港區,九如里,566,1,1046,8,1054,1554,3,1,3,0,1,0,67.82
臺北市,中山區,正守里,567,2,893,17,910,1542,3,1,3,0,1,0,59.01
臺北市,中山區,正守里,568,2,957,14,971,1572,3,1,3,0,1,0,61.77
臺北市,中山區,正義里,569,2,846,10,856,1713,3,1,3,0,1,0,49.97
臺北市,中山區,正義里,570,2,893,14,907,1631,3,1,3,0,1,0,55.61
臺北市,中山區,正得里,571,2,683,9,692,1146,3,1,3,0,1,0,60.38
臺北市,中山區,正得里,572,2,824,12,836,1616,3,1,3,0,1,0,51.73
臺北市,中山區,民安里,573,2,874,5,879,1372,3,1,3,0,1,0,64.07
臺北市,中山區,民安里,574,2,796,10,806,1458,3,1,3,0,1,0,55.28
臺北市,中山區,民安里,575,2,821,15,836,1395,3,1,3,0,1,0,59.93
臺北市,中山區,康樂里,576,2,1285,24,1309,2315,3,1,3,0,1,0,56.54
臺北市,中山區,康樂里,577,2,1185,16,1201,2091,3,1,3,0,1,0,57.44
臺北市,中山區,中山里,578,2,717,6,723,1300,3,1,3,0,1,0,55.62
臺北市,中山區,中山里,579,2,655,11,666,1163,3,1,3,0,1,0,57.27
臺北市,中山區,中山里,580,2,741,7,748,1413,3,1,3,0,1,0,52.94
臺北市,中山區,聚盛里,581,2,714,13,727,1344,3,1,3,0,1,0,54.09
臺北市,中山區,聚盛里,582,2,639,11,650,1293,3,1,3,0,1,0,50.27
臺北市,中山區,集英里,583,2,884,15,899,1395,3,1,3,0,1,0,64.44
臺北市,中山區,集英里,584,2,985,14,999,1664,3,1,3,0,1,0,60.04
臺北市,中山區,集英里,585,2,844,10,854,1516,3,1,3,0,1,0,56.33
臺北市,中山區,聚葉里,586,2,850,18,868,1521,3,1,3,0,1,0,57.07
臺北市,中山區,聚葉里,587,2,863,23,886,1466,3,1,3,0,1,0,60.44
臺北市,中山區,恆安里,588,2,810,14,824,1394,3,1,3,0,1,0,59.11
臺北市,中山區,恆安里,589,2,572,4,576,1041,3,1,3,0,1,0,55.33
臺北市,中山區,晴光里,590,2,710,14,724,1460,3,1,3,0,1,0,49.59
臺北市,中山區,晴光里,591,2,855,15,870,1692,3,1,3,0,1,0,51.42
臺北市,中山區,圓山里,592,2,1001,9,1010,1760,3,1,3,0,1,0,57.39
臺北市,中山區,圓山里,593,2,685,12,697,1265,3,1,3,0,1,0,55.10
臺北市,中山區,圓山里,594,2,587,10,597,897,3,1,3,0,1,0,66.56
臺北市,中山區,新庄里,595,2,1098,19,1117,2016,3,1,3,0,1,0,55.41
臺北市,中山區,新庄里,596,2,1282,13,1295,2029,3,1,3,0,1,0,63.82
臺北市,中山區,劍潭里,597,2,1604,13,1617,2358,3,1,3,0,1,0,68.58
臺北市,中山區,大直里,598,2,1359,10,1369,2034,3,1,3,0,1,0,67.31
臺北市,中山區,大直里,599,2,1301,32,1333,1913,3,1,3,0,1,0,69.68
臺北市,中山區,大直里,600,2,1345,6,1351,1943,3,1,3,0,1,0,69.53
臺北市,中山區,大直里,601,2,1233,17,1250,1815,3,1,3,0,1,0,68.87
臺北市,中山區,成功里,602,2,1594,19,1613,2247,3,1,3,0,1,0,71.78
臺北市,中山區,成功里,603,2,1074,12,1086,1577,3,1,3,0,1,0,68.86
臺北市,中山區,永安里,604,2,763,7,770,1098,3,1,3,0,1,0,70.13
臺北市,中山區,永安里,605,2,757,8,765,1107,3,1,3,0,1,0,69.11
臺北市,中山區,永安里,606,2,1137,10,1147,1676,3,1,3,0,1,0,68.44
臺北市,中山區,新喜里,607,2,1192,21,1213,1857,3,1,3,0,1,0,65.32
臺北市,中山區,新喜里,608,2,1178,15,1193,1941,3,1,3,0,1,0,61.46
臺北市,中山區,大佳里,609,2,573,8,581,874,3,1,3,0,1,0,66.48
臺北市,中山區,新福里,610,2,1306,36,1342,2146,3,1,3,0,1,0,62.53
臺北市,中山區,新福里,611,2,1144,16,1160,1948,3,1,3,0,1,0,59.55
臺北市,中山區,松江里,612,2,1071,21,1092,1711,3,1,3,0,1,0,63.82
臺北市,中山區,松江里,613,2,1031,9,1040,1701,3,1,3,0,1,0,61.14
臺北市,中山區,松江里,614,2,1034,13,1047,1673,3,1,3,0,1,0,62.58
臺北市,中山區,新生里,615,2,1228,10,1238,2089,3,1,3,0,1,0,59.26
臺北市,中山區,新生里,616,2,1045,16,1061,1803,3,1,3,0,1,0,58.85
臺北市,中山區,中庄里,617,2,1213,20,1233,2033,3,1,3,0,1,0,60.65
臺北市,中山區,中庄里,618,2,1443,26,1469,2496,3,1,3,0,1,0,58.85
臺北市,中山區,行政里,619,2,975,9,984,1597,3,1,3,0,1,0,61.62
臺北市,中山區,行政里,620,2,1480,15,1495,2380,3,1,3,0,1,0,62.82
臺北市,中山區,行仁里,621,2,1307,19,1326,2075,3,1,3,0,1,0,63.90
臺北市,中山區,行仁里,622,2,1318,18,1336,2084,3,1,3,0,1,0,64.11
臺北市,中山區,行仁里,623,2,1277,18,1295,2086,3,1,3,0,1,0,62.08
臺北市,中山區,行孝里,624,2,794,22,816,1287,3,1,3,0,1,0,63.40
臺北市,中山區,行孝里,625,2,1051,17,1068,1767,3,1,3,0,1,0,60.44
臺北市,中山區,下埤里,626,2,1152,10,1162,1854,3,1,3,0,1,0,62.68
臺北市,中山區,下埤里,627,2,1199,12,1211,1934,3,1,3,0,1,0,62.62
臺北市,中山區,下埤里,628,2,1098,14,1112,1757,3,1,3,0,1,0,63.29
臺北市,中山區,江寧里,629,2,1490,18,1508,2425,3,1,3,0,1,0,62.19
臺北市,中山區,江寧里,630,2,1557,9,1566,2462,3,1,3,0,1,0,63.61
臺北市,中山區,江山里,631,2,1106,13,1119,1847,3,1,3,0,1,0,60.58
臺北市,中山區,江山里,632,2,1354,16,1370,2174,3,1,3,0,1,0,63.02
臺北市,中山區,江山里,633,2,1253,12,1265,1863,3,1,3,0,1,0,67.90
臺北市,中山區,中吉里,634,2,800,12,812,1331,3,1,3,0,1,0,61.01
臺北市,中山區,中吉里,635,2,850,9,859,1442,3,1,3,0,1,0,59.57
臺北市,中山區,中吉里,636,2,807,12,819,1367,3,1,3,0,1,0,59.91
臺北市,中山區,中原里,637,2,1057,20,1077,1821,3,1,3,0,1,0,59.14
臺北市,中山區,中原里,638,2,1062,12,1074,1814,3,1,3,0,1,0,59.21
臺北市,中山區,興亞里,639,2,1279,13,1292,2204,3,1,3,0,1,0,58.62
臺北市,中山區,興亞里,640,2,1193,11,1204,1984,3,1,3,0,1,0,60.69
臺北市,中山區,中央里,641,2,871,14,885,1478,3,1,3,0,1,0,59.88
臺北市,中山區,中央里,642,2,949,10,959,1498,3,1,3,0,1,0,64.02
臺北市,中山區,朱馥里,643,2,1034,18,1052,1658,3,1,3,0,1,0,63.45
臺北市,中山區,朱馥里,644,2,942,9,951,1537,3,1,3,0,1,0,61.87
臺北市,中山區,朱馥里,645,2,1167,22,1189,1940,3,1,3,0,1,0,61.29
臺北市,中山區,龍洲里,646,2,1236,13,1249,1841,3,1,3,0,1,0,67.84
臺北市,中山區,龍洲里,647,2,1894,20,1914,2606,3,1,3,0,1,0,73.45
臺北市,中山區,朱園里,648,2,1045,11,1056,1678,3,1,3,0,1,0,62.93
臺北市,中山區,朱園里,649,2,1101,13,1114,1725,3,1,3,0,1,0,64.58
臺北市,中山區,埤頭里,650,2,1303,18,1321,2028,3,1,3,0,1,0,65.14
臺北市,中山區,埤頭里,651,2,1036,13,1049,1623,3,1,3,0,1,0,64.63
臺北市,中山區,朱崙里,652,2,862,14,876,1394,3,1,3,0,1,0,62.84
臺北市,中山區,朱崙里,653,2,843,23,866,1363,3,1,3,0,1,0,63.54
臺北市,中山區,力行里,654,2,1143,9,1152,1827,3,1,3,0,1,0,63.05
臺北市,中山區,力行里,655,2,1000,18,1018,1724,3,1,3,0,1,0,59.05
臺北市,中山區,力行里,656,2,1000,8,1008,1629,3,1,3,0,1,0,61.88
臺北市,中山區,復華里,657,2,1102,29,1131,1808,3,1,3,0,1,0,62.56
臺北市,中山區,復華里,658,2,742,7,749,1224,3,1,3,0,1,0,61.19
臺北市,大同區,玉泉里,659,2,1308,22,1330,2123,3,1,3,0,1,0,62.65
臺北市,大同區,玉泉里,660,2,715,11,726,1108,3,1,3,0,1,0,65.52
臺北市,大同區,建明里,661,2,978,14,992,1599,3,1,3,0,1,0,62.04
臺北市,大同區,建明里,662,2,939,12,951,1495,3,1,3,0,1,0,63.61
臺北市,大同區,建功里,663,2,1010,13,1023,1610,3,1,3,0,1,0,63.54
臺北市,大同區,建功里,664,2,1053,16,1069,1598,3,1,3,0,1,0,66.90
臺北市,大同區,建泰里,665,2,1019,17,1036,1650,3,1,3,0,1,0,62.79
臺北市,大同區,建泰里,666,2,770,11,781,1127,3,1,3,0,1,0,69.30
臺北市,大同區,永樂里,667,2,1297,13,1310,2021,3,1,3,0,1,0,64.82
臺北市,大同區,永樂里,668,2,1338,13,1351,1958,3,1,3,0,1,0,69.00
臺北市,大同區,朝陽里,669,2,918,8,926,1436,3,1,3,0,1,0,64.48
臺北市,大同區,朝陽里,670,2,833,11,844,1339,3,1,3,0,1,0,63.03
臺北市,大同區,星明里,671,2,1094,12,1106,1746,3,1,3,0,1,0,63.34
臺北市,大同區,星明里,672,2,1078,12,1090,1584,3,1,3,0,1,0,68.81
臺北市,大同區,光能里,673,2,919,17,936,1366,3,1,3,0,1,0,68.52
臺北市,大同區,光能里,674,2,1038,11,1049,1516,3,1,3,0,1,0,69.20
臺北市,大同區,光能里,675,2,926,19,945,1409,3,1,3,0,1,0,67.07
臺北市,大同區,大有里,676,2,949,8,957,1412,3,1,3,0,1,0,67.78
臺北市,大同區,大有里,677,2,823,12,835,1184,3,1,3,0,1,0,70.52
臺北市,大同區,大有里,678,2,932,10,942,1359,3,1,3,0,1,0,69.32
臺北市,大同區,延平里,679,2,963,15,978,1507,3,1,3,0,1,0,64.90
臺北市,大同區,延平里,680,2,881,8,889,1470,3,1,3,0,1,0,60.48
臺北市,大同區,雙連里,681,2,950,17,967,1563,3,1,3,0,1,0,61.87
臺北市,大同區,雙連里,682,2,971,8,979,1448,3,1,3,0,1,0,67.61
臺北市,大同區,雙連里,683,2,1103,16,1119,1701,3,1,3,0,1,0,65.78
臺北市,大同區,雙連里,684,2,814,16,830,1298,3,1,3,0,1,0,63.94
臺北市,大同區,雙連里,685,2,581,8,589,897,3,1,3,0,1,0,65.66
臺北市,大同區,南芳里,686,2,991,17,1008,1592,3,1,3,0,1,0,63.32
臺北市,大同區,南芳里,687,2,1080,14,1094,1658,3,1,3,0,1,0,65.98
臺北市,大同區,民權里,688,2,1073,10,1083,1588,3,1,3,0,1,0,68.20
臺北市,大同區,民權里,689,2,1152,17,1169,1832,3,1,3,0,1,0,63.81
臺北市,大同區,民權里,690,2,1116,18,1134,1772,3,1,3,0,1,0,64.00
臺北市,大同區,景星里,691,2,789,12,801,1254,3,1,3,0,1,0,63.88
臺北市,大同區,景星里,692,2,788,14,802,1253,3,1,3,0,1,0,64.01
臺北市,大同區,隆和里,693,2,832,11,843,1290,3,1,3,0,1,0,65.35
臺北市,大同區,隆和里,694,2,848,11,859,1260,3,1,3,0,1,0,68.17
臺北市,大同區,蓬萊里,695,2,1124,13,1137,1875,3,1,3,0,1,0,60.64
臺北市,大同區,蓬萊里,696,2,1282,19,1301,1960,3,1,3,0,1,0,66.38
臺北市,大同區,國順里,697,2,1251,24,1275,1934,3,1,3,0,1,0,65.93
臺北市,大同區,國順里,698,2,1078,17,1095,1591,3,1,3,0,1,0,68.82
臺北市,大同區,國慶里,699,2,1293,16,1309,1919,3,1,3,0,1,0,68.21
臺北市,大同區,揚雅里,700,2,789,15,804,1262,3,1,3,0,1,0,63.71
臺北市,大同區,揚雅里,701,2,804,12,816,1256,3,1,3,0,1,0,64.97
臺北市,大同區,斯文里,702,2,1188,20,1208,1966,3,1,3,0,1,0,61.44
臺北市,大同區,斯文里,703,2,1426,16,1442,2171,3,1,3,0,1,0,66.42
臺北市,大同區,鄰江里,704,2,1226,22,1248,1840,3,1,3,0,1,0,67.83
臺北市,大同區,鄰江里,705,2,1035,9,1044,1533,3,1,3,0,1,0,68.10
臺北市,大同區,鄰江里,706,2,1169,13,1182,1746,3,1,3,0,1,0,67.70
臺北市,大同區,至聖里,707,2,1121,12,1133,1714,3,1,3,0,1,0,66.10
臺北市,大同區,至聖里,708,2,1095,13,1108,1697,3,1,3,0,1,0,65.29
臺北市,大同區,至聖里,709,2,986,10,996,1486,3,1,3,0,1,0,67.03
臺北市,大同區,至聖里,710,2,931,10,941,1399,3,1,3,0,1,0,67.26
臺北市,大同區,文昌里,711,2,644,5,649,967,3,1,3,0,1,0,67.11
臺北市,大同區,老師里,712,2,1259,11,1270,1984,3,1,3,0,1,0,64.01
臺北市,大同區,老師里,713,2,1066,11,1077,1601,3,1,3,0,1,0,67.27
臺北市,大同區,重慶里,714,2,1022,17,1039,1494,3,1,3,0,1,0,69.54
臺北市,大同區,重慶里,715,2,1105,12,1117,1646,3,1,3,0,1,0,67.86
臺北市,大同區,保安里,716,2,1078,12,1090,1568,3,1,3,0,1,0,69.52
臺北市,大同區,保安里,717,2,1088,14,1102,1581,3,1,3,0,1,0,69.70
臺北市,大同區,保安里,718,2,984,12,996,1504,3,1,3,0,1,0,66.22
臺北市,大安區,德安里,719,2,1186,5,1191,2077,3,1,3,0,1,0,57.34
臺北市,大安區,德安里,720,2,1272,19,1291,2132,3,1,3,0,1,0,60.55
臺北市,大安區,仁慈里,721,2,1150,10,1160,1898,3,1,3,0,1,0,61.12
臺北市,大安區,仁慈里,722,2,1145,7,1152,1844,3,1,3,0,1,0,62.47
臺北市,大安區,和安里,723,2,1015,7,1022,1685,3,1,3,0,1,0,60.65
臺北市,大安區,和安里,724,2,1013,16,1029,1649,3,1,3,0,1,0,62.40
臺北市,大安區,和安里,725,2,1277,13,1290,1859,3,1,3,0,1,0,69.39
臺北市,大安區,民炤里,726,2,899,9,908,1470,3,1,3,0,1,0,61.77
臺北市,大安區,民炤里,727,2,1102,14,1116,1714,3,1,3,0,1,0,65.11
臺北市,大安區,民炤里,728,2,940,10,950,1548,3,1,3,0,1,0,61.37
臺北市,大安區,民炤里,729,2,972,6,978,1607,3,1,3,0,1,0,60.86
臺北市,大安區,仁愛里,730,2,900,7,907,1679,3,1,3,0,1,0,54.02
臺北市,大安區,仁愛里,731,2,843,5,848,1611,3,1,3,0,1,0,52.64
臺北市,大安區,仁愛里,732,2,849,6,855,1522,3,1,3,0,1,0,56.18
臺北市,大安區,義村里,733,2,1258,8,1266,1876,3,1,3,0,1,0,67.48
臺北市,大安區,義村里,734,2,1310,13,1323,1967,3,1,3,0,1,0,67.26
臺北市,大安區,義村里,735,2,1209,8,1217,1835,3,1,3,0,1,0,66.32
臺北市,大安區,民輝里,736,2,1002,9,1011,1656,3,1,3,0,1,0,61.05
臺北市,大安區,民輝里,737,2,919,6,925,1479,3,1,3,0,1,0,62.54
臺北市,大安區,民輝里,738,2,934,8,942,1595,3,1,3,0,1,0,59.06
臺北市,大安區,昌隆里,739,2,1026,9,1035,1738,3,1,3,0,1,0,59.55
臺北市,大安區,昌隆里,740,2,1101,14,1115,1826,3,1,3,0,1,0,61.06
臺北市,大安區,誠安里,741,2,1201,14,1215,1891,3,1,3,0,1,0,64.25
臺北市,大安區,誠安里,742,2,1129,13,1142,1828,3,1,3,0,1,0,62.47
臺北市,大安區,光武里,743,2,864,9,873,1548,3,1,3,0,1,0,56.40
臺北市,大安區,光武里,744,2,891,12,903,1560,3,1,3,0,1,0,57.88
臺北市,大安區,光武里,745,2,900,14,914,1542,3,1,3,0,1,0,59.27
臺北市,大安區,光武里,746,2,896,11,907,1524,3,1,3,0,1,0,59.51
臺北市,大安區,龍坡里,747,2,1003,5,1008,1563,3,1,3,0,1,0,64.49
臺北市,大安區,龍坡里,748,2,945,6,951,1451,3,1,3,0,1,0,65.54
臺北市,大安區,龍坡里,749,2,890,9,899,1334,3,1,3,0,1,0,67.39
臺北市,大安區,龍泉里,750,2,960,7,967,1665,3,1,3,0,1,0,58.08
臺北市,大安區,龍泉里,751,2,1165,10,1175,1884,3,1,3,0,1,0,62.37
臺北市,大安區,古風里,752,2,1005,10,1015,1604,3,1,3,0,1,0,63.28
臺北市,大安區,古風里,753,2,1072,7,1079,1701,3,1,3,0,1,0,63.43
臺北市,大安區,古莊里,754,2,1689,17,1706,2654,3,1,3,0,1,0,64.28
臺北市,大安區,古莊里,755,2,1497,15,1512,2415,3,1,3,0,1,0,62.61
臺北市,大安區,龍安里,756,2,856,7,863,1330,3,1,3,0,1,0,64.89
臺北市,大安區,龍安里,757,2,829,3,832,1300,3,1,3,0,1,0,64.00
臺北市,大安區,龍安里,758,2,909,8,917,1409,3,1,3,0,1,0,65.08
臺北市,大安區,錦安里,759,2,1322,7,1329,2064,3,1,3,0,1,0,64.39
臺北市,大安區,錦安里,760,2,1220,9,1229,1990,3,1,3,0,1,0,61.76
臺北市,大安區,福住里,761,2,1091,5,1096,1878,3,1,3,0,1,0,58.36
臺北市,大安區,福住里,762,2,1152,7,1159,1793,3,1,3,0,1,0,64.64
臺北市,大安區,永康里,763,2,895,5,900,1362,3,1,3,0,1,0,66.08
臺北市,大安區,永康里,764,2,847,13,860,1317,3,1,3,0,1,0,65.30
臺北市,大安區,光明里,765,2,1189,10,1199,1778,3,1,3,0,1,0,67.44
臺北市,大安區,光明里,766,2,1049,12,1061,1620,3,1,3,0,1,0,65.49
臺北市,大安區,錦泰里,767,2,1418,11,1429,2023,3,1,3,0,1,0,70.64
臺北市,大安區,錦泰里,768,2,1463,9,1472,2210,3,1,3,0,1,0,66.61
臺北市,大安區,錦華里,769,2,882,8,890,1300,3,1,3,0,1,0,68.46
臺北市,大安區,錦華里,770,2,926,7,933,1331,3,1,3,0,1,0,70.10
臺北市,大安區,錦華里,771,2,1042,11,1053,1537,3,1,3,0,1,0,68.51
臺北市,大安區,龍圖里,772,2,1045,11,1056,1677,3,1,3,0,1,0,62.97
臺北市,大安區,龍圖里,773,2,1180,12,1192,1893,3,1,3,0,1,0,62.97
臺北市,大安區,龍圖里,774,2,1042,10,1052,1577,3,1,3,0,1,0,66.71
臺北市,大安區,新龍里,775,2,1004,5,1009,1587,3,1,3,0,1,0,63.58
臺北市,大安區,新龍里,776,2,1434,8,1442,2048,3,1,3,0,1,0,70.41
臺北市,大安區,新龍里,777,2,971,9,980,1402,3,1,3,0,1,0,69.90
臺北市,大安區,龍陣里,778,2,910,8,918,1534,3,1,3,0,1,0,59.84
臺北市,大安區,龍陣里,779,2,1016,12,1028,1645,3,1,3,0,1,0,62.49
臺北市,大安區,龍雲里,780,2,1415,8,1423,2127,3,1,3,0,1,0,66.90
臺北市,大安區,龍雲里,781,2,1277,10,1287,2062,3,1,3,0,1,0,62.42
臺北市,大安區,龍生里,782,2,1192,15,1207,1776,3,1,3,0,1,0,67.96
臺北市,大安區,龍生里,783,2,981,8,989,1554,3,1,3,0,1,0,63.64
臺北市,大安區,龍生里,784,2,1035,10,1045,1599,3,1,3,0,1,0,65.35
臺北市,大安區,住安里,785,2,996,5,1001,1532,3,1,3,0,1,0,65.34
臺北市,大安區,住安里,786,2,876,20,896,1426,3,1,3,0,1,0,62.83
臺北市,大安區,住安里,787,2,1070,11,1081,1707,3,1,3,0,1,0,63.33
臺北市,大安區,義安里,788,2,800,5,805,1284,3,1,3,0,1,0,62.69
臺北市,大安區,義安里,789,2,950,10,960,1499,3,1,3,0,1,0,64.04
臺北市,大安區,義安里,790,2,1002,6,1008,1649,3,1,3,0,1,0,61.13
臺北市,大安區,通化里,791,2,943,15,958,1549,3,1,3,0,1,0,61.85
臺北市,大安區,通化里,792,2,1113,22,1135,1773,3,1,3,0,1,0,64.02
臺北市,大安區,通化里,793,2,1112,16,1128,1780,3,1,3,0,1,0,63.37
臺北市,大安區,通安里,794,2,1142,15,1157,1839,3,1,3,0,1,0,62.91
臺北市,大安區,通安里,795,2,1045,10,1055,1605,3,1,3,0,1,0,65.73
臺北市,大安區,通安里,796,2,951,11,962,1429,3,1,3,0,1,0,67.32
臺北市,大安區,臨江里,797,2,1183,22,1205,1910,3,1,3,0,1,0,63.09
臺北市,大安區,臨江里,798,2,1095,17,1112,1785,3,1,3,0,1,0,62.30
臺北市,大安區,法治里,799,2,1111,12,1123,1760,3,1,3,0,1,0,63.81
臺北市,大安區,法治里,800,2,974,7,981,1573,3,1,3,0,1,0,62.36
臺北市,大安區,全安里,801,2,1185,10,1195,1882,3,1,3,0,1,0,63.50
臺北市,大安區,全安里,802,2,1017,14,1031,1602,3,1,3,0,1,0,64.36
臺北市,大安區,群賢里,803,2,1136,9,1145,1763,3,1,3,0,1,0,64.95
臺北市,大安區,群賢里,804,2,925,13,938,1513,3,1,3,0,1,0,62.00
臺北市,大安區,群賢里,805,2,1072,9,1081,1755,3,1,3,0,1,0,61.60
臺北市,大安區,群英里,806,2,1039,3,1042,1460,3,1,3,0,1,0,71.37
臺北市,大安區,群英里,807,2,1051,6,1057,1523,3,1,3,0,1,0,69.40
臺北市,大安區,群英里,808,2,1055,8,1063,1527,3,1,3,0,1,0,69.61
臺北市,大安區,群英里,809,2,1078,10,1088,1528,3,1,3,0,1,0,71.20
臺北市,大安區,虎嘯里,810,2,904,2,906,1427,3,1,3,0,1,0,63.49
臺北市,大安區,虎嘯里,811,2,837,7,844,1334,3,1,3,0,1,0,63.27
臺北市,大安區,臥龍里,812,2,946,13,959,1473,3,1,3,0,1,0,65.11
臺北市,大安區,臥龍里,813,2,804,7,811,1252,3,1,3,0,1,0,64.78
臺北市,大安區,龍淵里,814,2,1078,12,1090,1678,3,1,3,0,1,0,64.96
臺北市,大安區,龍淵里,815,2,1193,11,1204,1807,3,1,3,0,1,0,66.63
臺北市,大安區,龍淵里,816,2,1037,3,1040,1661,3,1,3,0,1,0,62.61
臺北市,大安區,龍淵里,817,2,1090,7,1097,1739,3,1,3,0,1,0,63.08
臺北市,大安區,龍門里,818,2,1116,23,1139,2125,3,1,3,0,1,0,53.60
臺北市,大安區,龍門里,819,2,1244,11,1255,1882,3,1,3,0,1,0,66.68
臺北市,大安區,農場里,820,2,1011,4,1015,1474,3,1,3,0,1,0,68.86
臺北市,大安區,農場里,821,2,401,2,403,852,3,1,3,0,1,0,47.30
臺北市,大安區,大學里,822,2,1330,12,1342,2174,3,1,3,0,1,0,61.73
臺北市,大安區,大學里,823,2,1400,9,1409,2193,3,1,3,0,1,0,64.25
臺北市,大安區,大學里,824,2,1406,5,1411,2220,3,1,3,0,1,0,63.56
臺北市,大安區,芳和里,825,2,1156,14,1170,1730,3,1,3,0,1,0,67.63
臺北市,大安區,芳和里,826,2,1167,10,1177,1737,3,1,3,0,1,0,67.76
臺北市,大安區,芳和里,827,2,1176,15,1191,1715,3,1,3,0,1,0,69.45
臺北市,大安區,青峰里,828,2,655,16,671,984,3,1,3,0,1,0,68.19
臺北市,大安區,青峰里,829,2,632,4,636,1094,3,1,3,0,1,0,58.14
臺北市,大安區,黎元里,830,2,1500,18,1518,2271,3,1,3,0,1,0,66.84
臺北市,大安區,黎元里,831,2,1388,13,1401,2193,3,1,3,0,1,0,63.89
臺北市,大安區,黎孝里,832,2,1388,23,1411,2115,3,1,3,0,1,0,66.71
臺北市,大安區,黎孝里,833,2,1143,17,1160,1741,3,1,3,0,1,0,66.63
臺北市,大安區,黎孝里,834,2,1370,18,1388,2013,3,1,3,0,1,0,68.95
臺北市,大安區,黎和里,835,2,1066,14,1080,1628,3,1,3,0,1,0,66.34
臺北市,大安區,黎和里,836,2,1066,20,1086,1637,3,1,3,0,1,0,66.34
臺北市,大安區,建安里,837,2,1300,14,1314,2218,3,1,3,0,1,0,59.24
臺北市,大安區,建安里,838,2,1062,16,1078,1915,3,1,3,0,1,0,56.29
臺北市,大安區,建倫里,839,2,984,11,995,1688,3,1,3,0,1,0,58.95
臺北市,大安區,建倫里,840,2,945,3,948,1566,3,1,3,0,1,0,60.54
臺北市,大安區,建倫里,841,2,859,9,868,1529,3,1,3,0,1,0,56.77
臺北市,大安區,敦安里,842,2,872,10,882,1533,3,1,3,0,1,0,57.53
臺北市,大安區,敦安里,843,2,1117,12,1129,1786,3,1,3,0,1,0,63.21
臺北市,大安區,敦安里,844,2,973,12,985,1682,3,1,3,0,1,0,58.56
臺北市,大安區,正聲里,845,2,1211,7,1218,2018,3,1,3,0,1,0,60.36
臺北市,大安區,正聲里,846,2,1105,9,1114,1946,3,1,3,0,1,0,57.25
臺北市,大安區,敦煌里,847,2,1052,7,1059,1703,3,1,3,0,1,0,62.18
臺北市,大安區,敦煌里,848,2,973,14,987,1602,3,1,3,0,1,0,61.61
臺北市,大安區,敦煌里,849,2,897,5,902,1458,3,1,3,0,1,0,61.87
臺北市,大安區,華聲里,850,2,1053,12,1065,1765,3,1,3,0,1,0,60.34
臺北市,大安區,華聲里,851,2,1114,11,1125,1782,3,1,3,0,1,0,63.13
臺北市,大安區,車層里,852,2,801,7,808,1262,3,1,3,0,1,0,64.03
臺北市,大安區,車層里,853,2,1230,7,1237,2141,3,1,3,0,1,0,57.78
臺北市,大安區,車層里,854,2,1168,7,1175,1983,3,1,3,0,1,0,59.25
臺北市,大安區,光信里,855,2,1104,4,1108,1703,3,1,3,0,1,0,65.06
臺北市,大安區,光信里,856,2,1218,10,1228,1903,3,1,3,0,1,0,64.53
臺北市,大安區,光信里,857,2,1269,15,1284,2112,3,1,3,0,1,0,60.80
臺北市,中正區,水源里,858,2,981,9,990,1502,3,1,3,0,1,0,65.91
臺北市,中正區,水源里,859,2,945,15,960,1449,3,1,3,0,1,0,66.25
臺北市,中正區,富水里,860,2,615,4,619,1067,3,1,3,0,1,0,58.01
臺北市,中正區,富水里,861,2,852,12,864,1316,3,1,3,0,1,0,65.65
臺北市,中正區,文盛里,862,2,752,2,754,1098,3,1,3,0,1,0,68.67
臺北市,中正區,文盛里,863,2,673,13,686,1052,3,1,3,0,1,0,65.21
臺北市,中正區,林興里,864,2,917,10,927,1381,3,1,3,0,1,0,67.13
臺北市,中正區,林興里,865,2,757,10,767,1162,3,1,3,0,1,0,66.01
臺北市,中正區,林興里,866,2,933,8,941,1426,3,1,3,0,1,0,65.99
臺北市,中正區,河堤里,867,2,835,8,843,1302,3,1,3,0,1,0,64.75
臺北市,中正區,河堤里,868,2,874,9,883,1394,3,1,3,0,1,0,63.34
臺北市,中正區,河堤里,869,2,858,10,868,1430,3,1,3,0,1,0,60.70
臺北市,中正區,頂東里,870,2,1054,5,1059,1652,3,1,3,0,1,0,64.10
臺北市,中正區,頂東里,871,2,1025,7,1032,1605,3,1,3,0,1,0,64.30
臺北市,中正區,頂東里,872,2,865,13,878,1354,3,1,3,0,1,0,64.84
臺北市,中正區,網溪里,873,2,952,9,961,1485,3,1,3,0,1,0,64.71
臺北市,中正區,網溪里,874,2,1025,9,1034,1542,3,1,3,0,1,0,67.06
臺北市,中正區,網溪里,875,2,1013,19,1032,1552,3,1,3,0,1,0,66.49
臺北市,中正區,板溪里,876,2,847,14,861,1337,3,1,3,0,1,0,64.40
臺北市,中正區,板溪里,877,2,969,12,981,1523,3,1,3,0,1,0,64.41
臺北市,中正區,螢圃里,878,2,870,6,876,1310,3,1,3,0,1,0,66.87
臺北市,中正區,螢圃里,879,2,1017,9,1026,1472,3,1,3,0,1,0,69.70
臺北市,中正區,螢圃里,880,2,924,8,932,1340,3,1,3,0,1,0,69.55
臺北市,中正區,螢雪里,881,2,795,8,803,1232,3,1,3,0,1,0,65.18
臺北市,中正區,螢雪里,882,2,812,7,819,1215,3,1,3,0,1,0,67.41
臺北市,中正區,螢雪里,883,2,748,10,758,1169,3,1,3,0,1,0,64.84
臺北市,中正區,永功里,884,2,931,13,944,1377,3,1,3,0,1,0,68.55
臺北市,中正區,永功里,885,2,919,9,928,1506,3,1,3,0,1,0,61.62
臺北市,中正區,永功里,886,2,940,9,949,1428,3,1,3,0,1,0,66.46
臺北市,中正區,永功里,887,2,768,4,772,1214,3,1,3,0,1,0,63.59
臺北市,中正區,永昌里,888,2,957,11,968,1446,3,1,3,0,1,0,66.94
臺北市,中正區,永昌里,889,2,937,12,949,1456,3,1,3,0,1,0,65.18
臺北市,中正區,永昌里,890,2,1022,15,1037,1535,3,1,3,0,1,0,67.56
臺北市,中正區,龍興里,891,2,1222,24,1246,1816,3,1,3,0,1,0,68.61
臺北市,中正區,龍興里,892,2,1293,11,1304,1967,3,1,3,0,1,0,66.29
臺北市,中正區,忠勤里,893,2,893,17,910,1450,3,1,3,0,1,0,62.76
臺北市,中正區,忠勤里,894,2,962,26,988,1527,3,1,3,0,1,0,64.70
臺北市,中正區,忠勤里,895,2,831,16,847,1366,3,1,3,0,1,0,62.01
臺北市,中正區,忠勤里,896,2,1093,18,1111,1682,3,1,3,0,1,0,66.05
臺北市,中正區,廈安里,897,2,839,11,850,1203,3,1,3,0,1,0,70.66
臺北市,中正區,廈安里,898,2,933,9,942,1432,3,1,3,0,1,0,65.78
臺北市,中正區,愛國里,899,2,942,10,952,1448,3,1,3,0,1,0,65.75
臺北市,中正區,愛國里,900,2,888,12,900,1404,3,1,3,0,1,0,64.10
臺北市,中正區,南門里,901,2,821,5,826,1191,3,1,3,0,1,0,69.35
臺北市,中正區,南門里,902,2,679,11,690,1110,3,1,3,0,1,0,62.16
臺北市,中正區,南門里,903,2,706,11,717,1170,3,1,3,0,1,0,61.28
臺北市,中正區,龍光里,904,2,730,7,737,1141,3,1,3,0,1,0,64.59
臺北市,中正區,龍光里,905,2,790,9,799,1256,3,1,3,0,1,0,63.61
臺北市,中正區,龍光里,906,2,865,7,872,1248,3,1,3,0,1,0,69.87
臺北市,中正區,南福里,907,2,1003,12,1015,1483,3,1,3,0,1,0,68.44
臺北市,中正區,南福里,908,2,852,12,864,1355,3,1,3,0,1,0,63.76
臺北市,中正區,南福里,909,2,885,10,895,1378,3,1,3,0,1,0,64.95
臺北市,中正區,南福里,910,2,1265,5,1270,1735,3,1,3,0,1,0,73.20
臺北市,中正區,龍福里,911,2,1005,11,1016,1520,3,1,3,0,1,0,66.84
臺北市,中正區,龍福里,912,2,1003,5,1008,1492,3,1,3,0,1,0,67.56
臺北市,中正區,龍福里,913,2,969,16,985,1437,3,1,3,0,1,0,68.55
臺北市,中正區,新營里,914,2,1143,7,1150,1613,3,1,3,0,1,0,71.30
臺北市,中正區,新營里,915,2,1228,13,1241,1729,3,1,3,0,1,0,71.78
臺北市,中正區,新營里,916,2,961,8,969,1412,3,1,3,0,1,0,68.63
臺北市,中正區,新營里,917,2,1111,18,1129,1606,3,1,3,0,1,0,70.30
臺北市,中正區,建國里,918,2,714,5,719,1274,3,1,3,0,1,0,56.44
臺北市,中正區,光復里,919,2,861,12,873,1559,3,1,3,0,1,0,56.00
臺北市,中正區,光復里,920,2,851,7,858,1459,3,1,3,0,1,0,58.81
臺北市,中正區,黎明里,921,2,1176,16,1192,2076,3,1,3,0,1,0,57.42
臺北市,中正區,梅花里,922,2,1125,10,1135,1733,3,1,3,0,1,0,65.49
臺北市,中正區,梅花里,923,2,815,11,826,1213,3,1,3,0,1,0,68.10
臺北市,中正區,幸福里,924,2,758,8,766,1291,3,1,3,0,1,0,59.33
臺北市,中正區,幸福里,925,2,721,5,726,1190,3,1,3,0,1,0,61.01
臺北市,中正區,幸福里,926,2,718,9,727,1170,3,1,3,0,1,0,62.14
臺北市,中正區,幸市里,927,2,793,9,802,1364,3,1,3,0,1,0,58.80
臺北市,中正區,幸市里,928,2,567,7,574,950,3,1,3,0,1,0,60.42
臺北市,中正區,幸市里,929,2,849,13,862,1375,3,1,3,0,1,0,62.69
臺北市,中正區,東門里,930,2,766,15,781,1266,3,1,3,0,1,0,61.69
臺北市,中正區,東門里,931,2,867,11,878,1459,3,1,3,0,1,0,60.18
臺北市,中正區,文北里,932,2,909,7,916,1382,3,1,3,0,1,0,66.28
臺北市,中正區,文北里,933,2,769,5,774,1275,3,1,3,0,1,0,60.71
臺北市,中正區,文北里,934,2,816,9,825,1348,3,1,3,0,1,0,61.20
臺北市,中正區,文祥里,935,2,921,5,926,1331,3,1,3,0,1,0,69.57
臺北市,中正區,文祥里,936,2,747,12,759,1129,3,1,3,0,1,0,67.23
臺北市,中正區,文祥里,937,2,861,3,864,1274,3,1,3,0,1,0,67.82
臺北市,中正區,文祥里,938,2,1021,6,1027,1493,3,1,3,0,1,0,68.79
臺北市,中正區,三愛里,939,2,873,7,880,1303,3,1,3,0,1,0,67.54
臺北市,中正區,三愛里,940,2,711,5,716,1062,3,1,3,0,1,0,67.42
臺北市,中正區,三愛里,941,2,1092,11,1103,1769,3,1,3,0,1,0,62.35
臺北市,中正區,三愛里,942,2,1300,14,1314,2049,3,1,3,0,1,0,64.13
臺北市,萬華區,福星里,943,2,1181,20,1201,2019,3,1,3,0,1,0,59.48
臺北市,萬華區,福星里,944,2,1057,14,1071,1888,3,1,3,0,1,0,56.73
臺北市,萬華區,萬壽里,945,2,790,9,799,1376,3,1,3,0,1,0,58.07
臺北市,萬華區,萬壽里,946,2,679,14,693,1194,3,1,3,0,1,0,58.04
臺北市,萬華區,西門里,947,2,790,10,800,1371,3,1,3,0,1,0,58.35
臺北市,萬華區,西門里,948,2,838,17,855,1449,3,1,3,0,1,0,59.01
臺北市,萬華區,新起里,949,2,1216,15,1231,1788,3,1,3,0,1,0,68.85
臺北市,萬華區,新起里,950,2,1177,21,1198,1764,3,1,3,0,1,0,67.91
臺北市,萬華區,新起里,951,2,1180,21,1201,1856,3,1,3,0,1,0,64.71
臺北市,萬華區,菜園里,952,2,871,16,887,1488,3,1,3,0,1,0,59.61
臺北市,萬華區,菜園里,953,2,799,18,817,1148,3,1,3,0,1,0,71.17
臺北市,萬華區,菜園里,954,2,1204,26,1230,1878,3,1,3,0,1,0,65.50
臺北市,萬華區,青山里,955,2,873,7,880,1372,3,1,3,0,1,0,64.14
臺北市,萬華區,青山里,956,2,962,18,980,1517,3,1,3,0,1,0,64.60
臺北市,萬華區,青山里,957,2,796,18,814,1306,3,1,3,0,1,0,62.33
臺北市,萬華區,富民里,958,2,866,9,875,1292,3,1,3,0,1,0,67.72
臺北市,萬華區,富民里,959,2,881,17,898,1393,3,1,3,0,1,0,64.47
臺北市,萬華區,富民里,960,2,820,7,827,1236,3,1,3,0,1,0,66.91
臺北市,萬華區,福音里,961,2,1212,14,1226,1776,3,1,3,0,1,0,69.03
臺北市,萬華區,福音里,962,2,974,6,980,1476,3,1,3,0,1,0,66.40
臺北市,萬華區,仁德里,963,2,1319,20,1339,1862,3,1,3,0,1,0,71.91
臺北市,萬華區,仁德里,964,2,1194,20,1214,1737,3,1,3,0,1,0,69.89
臺北市,萬華區,富福里,965,2,816,7,823,1193,3,1,3,0,1,0,68.99
臺北市,萬華區,富福里,966,2,863,9,872,1252,3,1,3,0,1,0,69.65
臺北市,萬華區,富福里,967,2,859,11,870,1305,3,1,3,0,1,0,66.67
臺北市,萬華區,頂碩里,968,2,1302,21,1323,2035,3,1,3,0,1,0,65.01
臺北市,萬華區,頂碩里,969,2,1051,21,1072,1543,3,1,3,0,1,0,69.48
臺北市,萬華區,頂碩里,970,2,1019,22,1041,1500,3,1,3,0,1,0,69.40
臺北市,萬華區,頂碩里,971,2,911,14,925,1419,3,1,3,0,1,0,65.19
臺北市,萬華區,雙園里,972,2,737,9,746,1107,3,1,3,0,1,0,67.39
臺北市,萬華區,雙園里,973,2,703,12,715,1077,3,1,3,0,1,0,66.39
臺北市,萬華區,雙園里,974,2,1170,22,1192,1848,3,1,3,0,1,0,64.50
臺北市,萬華區,新忠里,975,2,1060,12,1072,1669,3,1,3,0,1,0,64.23
臺北市,萬華區,新忠里,976,2,1326,7,1333,1854,3,1,3,0,1,0,71.90
臺北市,萬華區,新和里,977,2,1332,11,1343,1789,3,1,3,0,1,0,75.07
臺北市,萬華區,新和里,978,2,1220,13,1233,1734,3,1,3,0,1,0,71.11
臺北市,萬華區,新和里,979,2,1306,13,1319,1907,3,1,3,0,1,0,69.17
臺北市,萬華區,新和里,980,2,1167,12,1179,1769,3,1,3,0,1,0,66.65
臺北市,萬華區,糖廍里,981,2,977,21,998,1595,3,1,3,0,1,0,62.57
臺北市,萬華區,糖廍里,982,2,1237,16,1253,1913,3,1,3,0,1,0,65.50
臺北市,萬華區,和平里,983,2,1085,12,1097,1685,3,1,3,0,1,0,65.10
臺北市,萬華區,和平里,984,2,1073,11,1084,1643,3,1,3,0,1,0,65.98
臺北市,萬華區,和平里,985,2,797,14,811,1208,3,1,3,0,1,0,67.14
臺北市,萬華區,和平里,986,2,948,14,962,1463,3,1,3,0,1,0,65.76
臺北市,萬華區,綠堤里,987,2,1085,10,1095,1704,3,1,3,0,1,0,64.26
臺北市,萬華區,綠堤里,988,2,888,8,896,1565,3,1,3,0,1,0,57.25
臺北市,萬華區,綠堤里,989,2,1035,18,1053,1648,3,1,3,0,1,0,63.90
臺北市,萬華區,華江里,990,2,1256,12,1268,1946,3,1,3,0,1,0,65.16
臺北市,萬華區,華江里,991,2,1243,12,1255,1811,3,1,3,0,1,0,69.30
臺北市,萬華區,華江里,992,2,981,14,995,1483,3,1,3,0,1,0,67.09
臺北市,萬華區,華江里,993,2,994,19,1013,1646,3,1,3,0,1,0,61.54
臺北市,萬華區,柳鄉里,994,2,1499,21,1520,2412,3,1,3,0,1,0,63.02
臺北市,萬華區,柳鄉里,995,2,1412,18,1430,2201,3,1,3,0,1,0,64.97
臺北市,萬華區,日善里,996,2,1091,20,1111,1726,3,1,3,0,1,0,64.37
臺北市,萬華區,日善里,997,2,858,14,872,1307,3,1,3,0,1,0,66.72
臺北市,萬華區,新安里,998,2,1095,23,1118,1850,3,1,3,0,1,0,60.43
臺北市,萬華區,新安里,999,2,1258,16,1274,1950,3,1,3,0,1,0,65.33
臺北市,萬華區,新安里,1000,2,1365,22,1387,1923,3,1,3,0,1,0,72.13
臺北市,萬華區,忠德里,1001,2,1302,14,1316,2071,3,1,3,0,1,0,63.54
臺北市,萬華區,忠德里,1002,2,1037,11,1048,1494,3,1,3,0,1,0,70.15
臺北市,萬華區,孝德里,1003,2,942,9,951,1442,3,1,3,0,1,0,65.95
臺北市,萬華區,孝德里,1004,2,812,9,821,1231,3,1,3,0,1,0,66.69
臺北市,萬華區,和德里,1005,2,1204,16,1220,1891,3,1,3,0,1,0,64.52
臺北市,萬華區,和德里,1006,2,1227,35,1262,2038,3,1,3,0,1,0,61.92
臺北市,萬華區,和德里,1007,2,1198,18,1216,1909,3,1,3,0,1,0,63.70
臺北市,萬華區,錦德里,1008,2,1485,27,1512,2302,3,1,3,0,1,0,65.68
臺北市,萬華區,錦德里,1009,2,1208,15,1223,1892,3,1,3,0,1,0,64.64
臺北市,萬華區,全德里,1010,2,1109,16,1125,1721,3,1,3,0,1,0,65.37
臺北市,萬華區,全德里,1011,2,986,12,998,1565,3,1,3,0,1,0,63.77
臺北市,萬華區,保德里,1012,2,831,12,843,1248,3,1,3,0,1,0,67.55
臺北市,萬華區,保德里,1013,2,845,12,857,1248,3,1,3,0,1,0,68.67
臺北市,萬華區,銘德里,1014,2,1316,15,1331,1993,3,1,3,0,1,0,66.78
臺北市,萬華區,銘德里,1015,2,1172,27,1199,1851,3,1,3,0,1,0,64.78
臺北市,萬華區,榮德里,1016,2,1135,17,1152,1751,3,1,3,0,1,0,65.79
臺北市,萬華區,榮德里,1017,2,1019,23,1042,1517,3,1,3,0,1,0,68.69
臺北市,萬華區,壽德里,1018,2,1005,12,1017,1476,3,1,3,0,1,0,68.90
臺北市,萬華區,壽德里,1019,2,719,11,730,1133,3,1,3,0,1,0,64.43
臺北市,萬華區,壽德里,1020,2,889,12,901,1385,3,1,3,0,1,0,65.05
臺北市,萬華區,興德里,1021,2,1247,15,1262,1937,3,1,3,0,1,0,65.15
臺北市,萬華區,興德里,1022,2,1112,25,1137,1871,3,1,3,0,1,0,60.77
臺北市,萬華區,華中里,1023,2,1218,20,1238,1935,3,1,3,0,1,0,63.98
臺北市,萬華區,華中里,1024,2,1116,14,1130,1792,3,1,3,0,1,0,63.06
臺北市,萬華區,華中里,1025,2,1034,16,1050,1581,3,1,3,0,1,0,66.41
臺北市,萬華區,日祥里,1026,2,800,11,811,1234,3,1,3,0,1,0,65.72
臺北市,萬華區,日祥里,1027,2,953,10,963,1491,3,1,3,0,1,0,64.59
臺北市,萬華區,日祥里,1028,2,901,3,904,1283,3,1,3,0,1,0,70.46
臺北市,萬華區,忠貞里,1029,2,1579,23,1602,2184,3,1,3,0,1,0,73.35
臺北市,萬華區,忠貞里,1030,2,1236,29,1265,2242,3,1,3,0,1,0,56.42
臺北市,萬華區,凌霄里,1031,2,1148,18,1166,1787,3,1,3,0,1,0,65.25
臺北市,萬華區,凌霄里,1032,2,1321,21,1342,1944,3,1,3,0,1,0,69.03
臺北市,萬華區,騰雲里,1033,2,809,9,818,1187,3,1,3,0,1,0,68.91
臺北市,萬華區,騰雲里,1034,2,823,9,832,1243,3,1,3,0,1,0,66.93
臺北市,文山區,景行里,1035,2,843,17,860,1257,3,1,3,0,1,0,68.42
臺北市,文山區,景行里,1036,2,747,11,758,1141,3,1,3,0,1,0,66.43
臺北市,文山區,景行里,1037,2,891,10,901,1367,3,1,3,0,1,0,65.91
臺北市,文山區,景東里,1038,2,816,9,825,1249,3,1,3,0,1,0,66.05
臺北市,文山區,景東里,1039,2,825,5,830,1297,3,1,3,0,1,0,63.99
臺北市,文山區,景東里,1040,2,1116,6,1122,1651,3,1,3,0,1,0,67.96
臺北市,文山區,景美里,1041,2,1145,11,1156,1684,3,1,3,0,1,0,68.65
臺北市,文山區,景美里,1042,2,1040,14,1054,1604,3,1,3,0,1,0,65.71
臺北市,文山區,景慶里,1043,2,956,15,971,1358,3,1,3,0,1,0,71.50
臺北市,文山區,景慶里,1044,2,1073,10,1083,1607,3,1,3,0,1,0,67.39
臺北市,文山區,景慶里,1045,2,1095,8,1103,1601,3,1,3,0,1,0,68.89
臺北市,文山區,景仁里,1046,2,697,11,708,1103,3,1,3,0,1,0,64.19
臺北市,文山區,景仁里,1047,2,1421,15,1436,2064,3,1,3,0,1,0,69.57
臺北市,文山區,景華里,1048,2,1062,12,1074,1690,3,1,3,0,1,0,63.55
臺北市,文山區,景華里,1049,2,859,8,867,1300,3,1,3,0,1,0,66.69
臺北市,文山區,景華里,1050,2,986,6,992,1420,3,1,3,0,1,0,69.86
臺北市,文山區,萬有里,1051,2,1128,13,1141,1624,3,1,3,0,1,0,70.26
臺北市,文山區,萬有里,1052,2,1310,9,1319,1937,3,1,3,0,1,0,68.09
臺北市,文山區,萬祥里,1053,2,844,15,859,1231,3,1,3,0,1,0,69.78
臺北市,文山區,萬祥里,1054,2,768,7,775,1180,3,1,3,0,1,0,65.68
臺北市,文山區,萬祥里,1055,2,928,10,938,1317,3,1,3,0,1,0,71.22
臺北市,文山區,萬隆里,1056,2,834,9,843,1243,3,1,3,0,1,0,67.82
臺北市,文山區,萬隆里,1057,2,912,5,917,1357,3,1,3,0,1,0,67.58
臺北市,文山區,萬隆里,1058,2,1049,4,1053,1528,3,1,3,0,1,0,68.91
臺北市,文山區,萬年里,1059,2,911,9,920,1479,3,1,3,0,1,0,62.20
臺北市,文山區,萬年里,1060,2,827,10,837,1312,3,1,3,0,1,0,63.80
臺北市,文山區,萬年里,1061,2,976,6,982,1411,3,1,3,0,1,0,69.60
臺北市,文山區,萬和里,1062,2,1116,11,1127,1510,3,1,3,0,1,0,74.64
臺北市,文山區,萬和里,1063,2,1092,11,1103,1426,3,1,3,0,1,0,77.35
臺北市,文山區,萬盛里,1064,2,829,3,832,1250,3,1,3,0,1,0,66.56
臺北市,文山區,萬盛里,1065,2,734,12,746,1114,3,1,3,0,1,0,66.97
臺北市,文山區,萬盛里,1066,2,888,8,896,1315,3,1,3,0,1,0,68.14
臺北市,文山區,興豐里,1067,2,1141,10,1151,1697,3,1,3,0,1,0,67.83
臺北市,文山區,興豐里,1068,2,1137,10,1147,1623,3,1,3,0,1,0,70.67
臺北市,文山區,興豐里,1069,2,1166,7,1173,1709,3,1,3,0,1,0,68.64
臺北市,文山區,興光里,1070,2,962,12,974,1533,3,1,3,0,1,0,63.54
臺北市,文山區,興光里,1071,2,1018,8,1026,1613,3,1,3,0,1,0,63.61
臺北市,文山區,興家里,1072,2,854,8,862,1258,3,1,3,0,1,0,68.52
臺北市,文山區,興家里,1073,2,983,10,993,1437,3,1,3,0,1,0,69.10
臺北市,文山區,興得里,1074,2,993,22,1015,1495,3,1,3,0,1,0,67.89
臺北市,文山區,興得里,1075,2,1140,12,1152,1732,3,1,3,0,1,0,66.51
臺北市,文山區,興得里,1076,2,967,8,975,1483,3,1,3,0,1,0,65.75
臺北市,文山區,興得里,1077,2,853,10,863,1374,3,1,3,0,1,0,62.81
臺北市,文山區,興業里,1078,2,836,7,843,1230,3,1,3,0,1,0,68.54
臺北市,文山區,興業里,1079,2,940,11,951,1362,3,1,3,0,1,0,69.82
臺北市,文山區,興業里,1080,2,907,9,916,1339,3,1,3,0,1,0,68.41
臺北市,文山區,興安里,1081,2,907,13,920,1351,3,1,3,0,1,0,68.10
臺北市,文山區,興安里,1082,2,718,10,728,1119,3,1,3,0,1,0,65.06
臺北市,文山區,興安里,1083,2,804,14,818,1252,3,1,3,0,1,0,65.34
臺北市,文山區,興福里,1084,2,944,14,958,1405,3,1,3,0,1,0,68.19
臺北市,文山區,興福里,1085,2,991,14,1005,1452,3,1,3,0,1,0,69.21
臺北市,文山區,興福里,1086,2,1032,15,1047,1503,3,1,3,0,1,0,69.66
臺北市,文山區,興旺里,1087,2,1289,19,1308,1870,3,1,3,0,1,0,69.95
臺北市,文山區,興旺里,1088,2,1277,12,1289,1943,3,1,3,0,1,0,66.34
臺北市,文山區,興泰里,1089,2,834,9,843,1246,3,1,3,0,1,0,67.66
臺北市,文山區,興泰里,1090,2,896,16,912,1329,3,1,3,0,1,0,68.62
臺北市,文山區,興昌里,1091,2,926,11,937,1408,3,1,3,0,1,0,66.55
臺北市,文山區,興昌里,1092,2,1059,6,1065,1554,3,1,3,0,1,0,68.53
臺北市,文山區,試院里,1093,2,1115,12,1127,1552,3,1,3,0,1,0,72.62
臺北市,文山區,試院里,1094,2,865,6,871,1274,3,1,3,0,1,0,68.37
臺北市,文山區,試院里,1095,2,1083,12,1095,1606,3,1,3,0,1,0,68.18
臺北市,文山區,華興里,1096,2,1222,8,1230,1759,3,1,3,0,1,0,69.93
臺北市,文山區,華興里,1097,2,1089,19,1108,1661,3,1,3,0,1,0,66.71
臺北市,文山區,華興里,1098,2,1077,7,1084,1590,3,1,3,0,1,0,68.18
臺北市,文山區,明義里,1099,2,1041,35,1076,1659,3,1,3,0,1,0,64.86
臺北市,文山區,明義里,1100,2,1091,34,1125,1774,3,1,3,0,1,0,63.42
臺北市,文山區,明興里,1101,2,1038,17,1055,1532,3,1,3,0,1,0,68.86
臺北市,文山區,明興里,1102,2,920,9,929,1376,3,1,3,0,1,0,67.51
臺北市,文山區,明興里,1103,2,917,11,928,1338,3,1,3,0,1,0,69.36
臺北市,文山區,木柵里,1104,2,1144,13,1157,1664,3,1,3,0,1,0,69.53
臺北市,文山區,木柵里,1105,2,1334,9,1343,1774,3,1,3,0,1,0,75.70
臺北市,文山區,木柵里,1106,2,1176,19,1195,1725,3,1,3,0,1,0,69.28
臺北市,文山區,木新里,1107,2,920,19,939,1456,3,1,3,0,1,0,64.49
臺北市,文山區,木新里,1108,2,859,19,878,1346,3,1,3,0,1,0,65.23
臺北市,文山區,木新里,1109,2,992,12,1004,1464,3,1,3,0,1,0,68.58
臺北市,文山區,木新里,1110,2,1026,9,1035,1553,3,1,3,0,1,0,66.65
臺北市,文山區,順興里,1111,2,1468,11,1479,2161,3,1,3,0,1,0,68.44
臺北市,文山區,順興里,1112,2,1414,14,1428,2038,3,1,3,0,1,0,70.07
臺北市,文山區,順興里,1113,2,1215,21,1236,1742,3,1,3,0,1,0,70.95
臺北市,文山區,順興里,1114,2,685,8,693,948,3,1,3,0,1,0,73.10
臺北市,文山區,樟林里,1115,2,980,4,984,1419,3,1,3,0,1,0,69.34
臺北市,文山區,樟林里,1116,2,1047,13,1060,1504,3,1,3,0,1,0,70.48
臺北市,文山區,樟林里,1117,2,1044,9,1053,1532,3,1,3,0,1,0,68.73
臺北市,文山區,樟林里,1118,2,1108,15,1123,1649,3,1,3,0,1,0,68.10
臺北市,文山區,樟新里,1119,2,1022,12,1034,1500,3,1,3,0,1,0,68.93
臺北市,文山區,樟新里,1120,2,849,20,869,1272,3,1,3,0,1,0,68.32
臺北市,文山區,樟新里,1121,2,1183,38,1221,1819,3,1,3,0,1,0,67.12
臺北市,文山區,樟新里,1122,2,1728,17,1745,2475,3,1,3,0,1,0,70.51
臺北市,文山區,樟腳里,1123,2,1114,6,1120,1667,3,1,3,0,1,0,67.19
臺北市,文山區,樟腳里,1124,2,1137,16,1153,1606,3,1,3,0,1,0,71.79
臺北市,文山區,樟腳里,1125,2,1035,19,1054,1519,3,1,3,0,1,0,69.39
臺北市,文山區,樟腳里,1126,2,1137,14,1151,1654,3,1,3,0,1,0,69.59
臺北市,文山區,萬芳里,1127,2,1086,10,1096,1588,3,1,3,0,1,0,69.02
臺北市,文山區,萬芳里,1128,2,1187,16,1203,1722,3,1,3,0,1,0,69.86
臺北市,文山區,萬芳里,1129,2,1305,12,1317,1788,3,1,3,0,1,0,73.66
臺北市,文山區,萬芳里,1130,2,1136,9,1145,1718,3,1,3,0,1,0,66.65
臺北市,文山區,博嘉里,1131,2,761,26,787,1291,3,1,3,0,1,0,60.96
臺北市,文山區,博嘉里,1132,2,1032,14,1046,1548,3,1,3,0,1,0,67.57
臺北市,文山區,萬興里,1133,2,854,13,867,1393,3,1,3,0,1,0,62.24
臺北市,文山區,萬興里,1134,2,1151,17,1168,1701,3,1,3,0,1,0,68.67
臺北市,文山區,萬興里,1135,2,1081,15,1096,1683,3,1,3,0,1,0,65.12
臺北市,文山區,指南里,1136,2,1211,20,1231,1870,3,1,3,0,1,0,65.83
臺北市,文山區,老泉里,1137,2,378,6,384,578,3,1,3,0,1,0,66.44
高雄市,鹽埕區,藍橋里,1,1,704,13,717,978,3,1,3,0,1,0,73.31
高雄市,鹽埕區,壽星里,2,1,933,23,956,1302,3,1,3,0,1,0,73.43
高雄市,鹽埕區,慈愛里,3,1,497,12,509,691,3,1,3,0,1,0,73.66
高雄市,鹽埕區,博愛里,4,1,587,8,595,749,3,1,3,0,1,0,79.44
高雄市,鹽埕區,陸橋里,5,1,982,15,997,1384,3,1,3,0,1,0,72.04
高雄市,鹽埕區,中山里,6,1,869,14,883,1239,3,1,3,0,1,0,71.27
高雄市,鹽埕區,中原里,7,1,498,16,514,705,3,1,3,0,1,0,72.91
高雄市,鹽埕區,府北里,8,1,1162,13,1175,1742,3,1,3,0,1,0,67.45
高雄市,鹽埕區,瀨南里,9,1,571,7,578,760,3,1,3,0,1,0,76.05
高雄市,鹽埕區,新樂里,10,1,556,9,565,760,3,1,3,0,1,0,74.34
高雄市,鹽埕區,教仁里,11,1,1583,27,1610,2212,3,1,3,0,1,0,72.78
高雄市,鹽埕區,江西里,12,1,895,12,907,1307,3,1,3,0,1,0,69.40
高雄市,鹽埕區,新豐里,13,1,532,8,540,716,3,1,3,0,1,0,75.42
高雄市,鹽埕區,港都里,14,1,880,20,900,1223,3,1,3,0,1,0,73.59
高雄市,鹽埕區,江南里,15,1,664,11,675,942,3,1,3,0,1,0,71.66
高雄市,鹽埕區,新化里,16,1,613,21,634,853,3,1,3,0,1,0,74.33
高雄市,鹽埕區,河濱里,17,1,1340,15,1355,1908,3,1,3,0,1,0,71.02
高雄市,鹽埕區,南端里,18,1,851,10,861,1209,3,1,3,0,1,0,71.22
高雄市,鹽埕區,沙地里,19,1,782,11,793,1155,3,1,3,0,1,0,68.66
高雄市,鹽埕區,育仁里,20,1,632,16,648,911,3,1,3,0,1,0,71.13
高雄市,鹽埕區,光明里,21,1,727,13,740,1020,3,1,3,0,1,0,72.55
高雄市,鼓山區,鼓峰里,22,1,1465,31,1496,2083,3,1,3,0,1,0,71.82
高雄市,鼓山區,雄峰里,23,1,742,9,751,989,3,1,3,0,1,0,75.94
高雄市,鼓山區,雄峰里,24,1,767,6,773,1049,3,1,3,0,1,0,73.69
高雄市,鼓山區,前峰里,25,1,1016,13,1029,1334,3,1,3,0,1,0,77.14
高雄市,鼓山區,前峰里,26,1,1204,12,1216,1497,3,1,3,0,1,0,81.23
高雄市,鼓山區,前峰里,27,1,903,6,909,1185,3,1,3,0,1,0,76.71
高雄市,鼓山區,光榮里,28,1,841,11,852,1173,3,1,3,0,1,0,72.63
高雄市,鼓山區,光榮里,29,1,1130,11,1141,1504,3,1,3,0,1,0,75.86
高雄市,鼓山區,光榮里,30,1,946,8,954,1230,3,1,3,0,1,0,77.56
高雄市,鼓山區,民族里,31,1,1067,29,1096,1494,3,1,3,0,1,0,73.36
高雄市,鼓山區,自強里,32,1,658,5,663,876,3,1,3,0,1,0,75.68
高雄市,鼓山區,內惟里,33,1,899,12,911,1206,3,1,3,0,1,0,75.54
高雄市,鼓山區,建國里,34,1,841,7,848,1063,3,1,3,0,1,0,79.77
高雄市,鼓山區,建國里,35,1,741,13,754,996,3,1,3,0,1,0,75.70
高雄市,鼓山區,龍井里,36,1,1169,13,1182,1555,3,1,3,0,1,0,76.01
高雄市,鼓山區,忠正里,37,1,913,13,926,1299,3,1,3,0,1,0,71.29
高雄市,鼓山區,忠正里,38,1,1275,22,1297,1788,3,1,3,0,1,0,72.54
高雄市,鼓山區,忠正里,39,1,1049,7,1056,1402,3,1,3,0,1,0,75.32
高雄市,鼓山區,正德里,40,1,1087,11,1098,1499,3,1,3,0,1,0,73.25
高雄市,鼓山區,平和里,41,1,995,12,1007,1333,3,1,3,0,1,0,75.54
高雄市,鼓山區,平和里,42,1,1105,15,1120,1487,3,1,3,0,1,0,75.32
高雄市,鼓山區,民強里,43,1,1519,23,1542,2042,3,1,3,0,1,0,75.51
高雄市,鼓山區,厚生里,44,1,1497,11,1508,1968,3,1,3,0,1,0,76.63
高雄市,鼓山區,龍子里,45,1,1186,22,1208,1705,3,1,3,0,1,0,70.85
高雄市,鼓山區,龍子里,46,1,1380,21,1401,1965,3,1,3,0,1,0,71.30
高雄市,鼓山區,明誠里,47,1,1705,17,1722,2305,3,1,3,0,1,0,74.71
高雄市,鼓山區,明誠里,48,1,2008,30,2038,2871,3,1,3,0,1,0,70.99
高雄市,鼓山區,龍水里,49,1,937,7,944,1349,3,1,3,0,1,0,69.98
高雄市,鼓山區,華豐里,50,1,1072,8,1080,1461,3,1,3,0,1,0,73.92
高雄市,鼓山區,華豐里,51,1,1211,10,1221,1632,3,1,3,0,1,0,74.82
高雄市,鼓山區,裕豐里,52,1,728,3,731,981,3,1,3,0,1,0,74.52
高雄市,鼓山區,裕豐里,53,1,905,5,910,1247,3,1,3,0,1,0,72.98
高雄市,鼓山區,裕興里,54,1,855,13,868,1180,3,1,3,0,1,0,73.56
高雄市,鼓山區,裕興里,55,1,730,8,738,1012,3,1,3,0,1,0,72.92
高雄市,鼓山區,鼓岩里,56,1,702,5,707,920,3,1,3,0,1,0,76.85
高雄市,鼓山區,鼓岩里,57,1,634,12,646,885,3,1,3,0,1,0,72.99
高雄市,鼓山區,樹德里,58,1,759,6,765,1006,3,1,3,0,1,0,76.04
高雄市,鼓山區,寶樹里,59,1,688,10,698,961,3,1,3,0,1,0,72.63
高雄市,鼓山區,興宗里,60,1,1258,18,1276,1722,3,1,3,0,1,0,74.10
高雄市,鼓山區,綠川里,61,1,1301,15,1316,1901,3,1,3,0,1,0,69.23
高雄市,鼓山區,河邊里,62,1,1151,15,1166,1561,3,1,3,0,1,0,74.70
高雄市,鼓山區,光化里,63,1,1175,15,1190,1702,3,1,3,0,1,0,69.92
高雄市,鼓山區,山下里,64,1,1140,14,1154,1609,3,1,3,0,1,0,71.72
高雄市,鼓山區,登山里,65,1,592,12,604,878,3,1,3,0,1,0,68.79
高雄市,鼓山區,峰南里,66,1,857,48,905,1265,3,1,3,0,1,0,71.54
高雄市,鼓山區,新民里,67,1,929,14,943,1296,3,1,3,0,1,0,72.76
高雄市,鼓山區,延平里,68,1,773,25,798,1128,3,1,3,0,1,0,70.74
高雄市,鼓山區,維生里,69,1,1160,17,1177,1672,3,1,3,0,1,0,70.39
高雄市,鼓山區,麗興里,70,1,886,11,897,1295,3,1,3,0,1,0,69.27
高雄市,鼓山區,惠安里,71,1,981,17,998,1493,3,1,3,0,1,0,66.85
高雄市,鼓山區,壽山里,72,1,1232,18,1250,1772,3,1,3,0,1,0,70.54
高雄市,鼓山區,哨船頭里,73,1,779,5,784,1133,3,1,3,0,1,0,69.20
高雄市,鼓山區,桃源里,74,1,398,4,402,525,3,1,3,0,1,0,76.57
高雄市,旗津區,旗下里,75,1,972,28,1000,1328,3,1,3,0,1,0,75.30
高雄市,旗津區,永安里,76,1,845,13,858,1231,3,1,3,0,1,0,69.70
高雄市,旗津區,振興里,77,1,1269,30,1299,1745,3,1,3,0,1,0,74.44
高雄市,旗津區,慈愛里,78,1,846,13,859,1154,3,1,3,0,1,0,74.44
高雄市,旗津區,慈愛里,79,1,659,12,671,991,3,1,3,0,1,0,67.71
高雄市,旗津區,復興里,80,1,987,17,1004,1342,3,1,3,0,1,0,74.81
高雄市,旗津區,復興里,81,1,913,16,929,1282,3,1,3,0,1,0,72.46
高雄市,旗津區,中華里,82,1,806,13,819,1060,3,1,3,0,1,0,77.26
高雄市,旗津區,實踐里,83,1,1171,14,1185,1687,3,1,3,0,1,0,70.24
高雄市,旗津區,北汕里,84,1,821,13,834,1203,3,1,3,0,1,0,69.33
高雄市,旗津區,北汕里,85,1,835,27,862,1152,3,1,3,0,1,0,74.83
高雄市,旗津區,南汕里,86,1,1145,37,1182,1621,3,1,3,0,1,0,72.92
高雄市,旗津區,上竹里,87,1,512,21,533,815,3,1,3,0,1,0,65.40
高雄市,旗津區,上竹里,88,1,1059,11,1070,1491,3,1,3,0,1,0,71.76
高雄市,旗津區,中洲里,89,1,1147,16,1163,1565,3,1,3,0,1,0,74.31
高雄市,旗津區,安順里,90,1,725,15,740,1088,3,1,3,0,1,0,68.01
高雄市,旗津區,中興里,91,1,656,13,669,878,3,1,3,0,1,0,76.20
高雄市,旗津區,中興里,92,1,762,17,779,991,3,1,3,0,1,0,78.61
高雄市,左營區,進學里,93,1,712,9,721,976,3,1,3,0,1,0,73.87
高雄市,左營區,進學里,94,1,605,12,617,847,3,1,3,0,1,0,72.85
高雄市,左營區,尾西里,95,1,1024,17,1041,1389,3,1,3,0,1,0,74.95
高雄市,左營區,頂北里,96,1,569,9,578,790,3,1,3,0,1,0,73.16
高雄市,左營區,中北里,97,1,586,6,592,735,3,1,3,0,1,0,80.54
高雄市,左營區,中南里,98,1,501,4,505,666,3,1,3,0,1,0,75.83
高雄市,左營區,廟東里,99,1,745,9,754,1010,3,1,3,0,1,0,74.65
高雄市,左營區,廟北里,100,1,776,16,792,1109,3,1,3,0,1,0,71.42
高雄市,左營區,尾南里,101,1,717,6,723,963,3,1,3,0,1,0,75.08
高雄市,左營區,尾北里,102,1,837,15,852,1158,3,1,3,0,1,0,73.58
高雄市,左營區,尾北里,103,1,1027,14,1041,1444,3,1,3,0,1,0,72.09
高雄市,左營區,海光里,104,1,1322,21,1343,1752,3,1,3,0,1,0,76.66
高雄市,左營區,屏山里,105,1,912,12,924,1219,3,1,3,0,1,0,75.80
高雄市,左營區,屏山里,106,1,574,10,584,774,3,1,3,0,1,0,75.45
高雄市,左營區,祥和里,107,1,685,15,700,851,3,1,3,0,1,0,82.26
高雄市,左營區,永清里,108,1,1392,24,1416,1769,3,1,3,0,1,0,80.05
高雄市,左營區,復興里,109,1,1036,22,1058,1369,3,1,3,0,1,0,77.28
高雄市,左營區,莒光里,110,1,652,6,658,900,3,1,3,0,1,0,73.11
高雄市,左營區,莒光里,111,1,625,5,630,872,3,1,3,0,1,0,72.25
高雄市,左營區,光輝里,112,1,858,15,873,1195,3,1,3,0,1,0,73.05
高雄市,左營區,光輝里,113,1,1032,11,1043,1353,3,1,3,0,1,0,77.09
高雄市,左營區,合群里,114,1,1114,8,1122,1438,3,1,3,0,1,0,78.03
高雄市,左營區,自治里,115,1,708,7,715,887,3,1,3,0,1,0,80.61
高雄市,左營區,自治里,116,1,848,10,858,1077,3,1,3,0,1,0,79.67
高雄市,左營區,明建里,117,1,1234,16,1250,1588,3,1,3,0,1,0,78.72
高雄市,左營區,自立里,118,1,782,16,798,1003,3,1,3,0,1,0,79.56
高雄市,左營區,頂西里,119,1,985,6,991,1291,3,1,3,0,1,0,76.76
高雄市,左營區,聖后里,120,1,756,13,769,1042,3,1,3,0,1,0,73.80
高雄市,左營區,聖西里,121,1,361,2,363,487,3,1,3,0,1,0,74.54
高雄市,左營區,聖南里,122,1,463,12,475,598,3,1,3,0,1,0,79.43
高雄市,左營區,城南里,123,1,473,5,478,609,3,1,3,0,1,0,78.49
高雄市,左營區,路東里,124,1,620,5,625,814,3,1,3,0,1,0,76.78
高雄市,左營區,廍北里,125,1,453,6,459,584,3,1,3,0,1,0,78.60
高雄市,左營區,廍南里,126,1,642,10,652,822,3,1,3,0,1,0,79.32
高雄市,左營區,埤西里,127,1,952,9,961,1255,3,1,3,0,1,0,76.57
高雄市,左營區,埤北里,128,1,1142,16,1158,1567,3,1,3,0,1,0,73.90
高雄市,左營區,埤東里,129,1,566,4,570,757,3,1,3,0,1,0,75.30
高雄市,左營區,埤東里,130,1,511,11,522,679,3,1,3,0,1,0,76.88
高雄市,左營區,海勝里,131,1,1146,9,1155,1470,3,1,3,0,1,0,78.57
高雄市,左營區,自勉里,132,1,1525,16,1541,1887,3,1,3,0,1,0,81.66
高雄市,左營區,崇實里,133,1,982,7,989,1224,3,1,3,0,1,0,80.80
高雄市,左營區,自助里,134,1,1463,25,1488,1932,3,1,3,0,1,0,77.02
高雄市,左營區,自助里,135,1,526,7,533,685,3,1,3,0,1,0,77.81
高雄市,左營區,果貿里,136,1,775,10,785,1030,3,1,3,0,1,0,76.21
高雄市,左營區,果貿里,137,1,866,8,874,1162,3,1,3,0,1,0,75.22
高雄市,左營區,果惠里,138,1,1176,18,1194,1662,3,1,3,0,1,0,71.84
高雄市,左營區,果峰里,139,1,823,6,829,1056,3,1,3,0,1,0,78.50
高雄市,左營區,果峰里,140,1,708,6,714,904,3,1,3,0,1,0,78.98
高雄市,左營區,新下里,141,1,1482,24,1506,2069,3,1,3,0,1,0,72.79
高雄市,左營區,新下里,142,1,1468,19,1487,2066,3,1,3,0,1,0,71.97
高雄市,左營區,新下里,143,1,863,8,871,1133,3,1,3,0,1,0,76.88
高雄市,左營區,新上里,144,1,1544,22,1566,2023,3,1,3,0,1,0,77.41
高雄市,左營區,新上里,145,1,987,5,992,1572,3,1,3,0,1,0,63.10
高雄市,左營區,新上里,146,1,880,12,892,1434,3,1,3,0,1,0,62.20
高雄市,左營區,新上里,147,1,1106,16,1122,1678,3,1,3,0,1,0,66.87
高雄市,左營區,新上里,148,1,1017,7,1024,1632,3,1,3,0,1,0,62.75
高雄市,左營區,新上里,149,1,1086,14,1100,1696,3,1,3,0,1,0,64.86
高雄市,左營區,新中里,150,1,1146,12,1158,1546,3,1,3,0,1,0,74.90
高雄市,左營區,新中里,151,1,540,3,543,671,3,1,3,0,1,0,80.92
高雄市,左營區,新中里,152,1,1075,14,1089,1512,3,1,3,0,1,0,72.02
高雄市,左營區,新光里,153,1,1215,12,1227,1584,3,1,3,0,1,0,77.46
高雄市,左營區,新光里,154,1,1446,19,1465,2034,3,1,3,0,1,0,72.03
高雄市,左營區,菜公里,155,1,1124,26,1150,1703,3,1,3,0,1,0,67.53
高雄市,左營區,菜公里,156,1,778,16,794,1145,3,1,3,0,1,0,69.34
高雄市,左營區,菜公里,157,1,1188,9,1197,1749,3,1,3,0,1,0,68.44
高雄市,左營區,福山里,158,1,1710,23,1733,2683,3,1,3,0,1,0,64.59
高雄市,左營區,福山里,159,1,955,12,967,1347,3,1,3,0,1,0,71.79
高雄市,楠梓區,清豐里,160,1,1274,25,1299,1706,3,1,3,0,1,0,76.14
高雄市,楠梓區,清豐里,161,1,1141,11,1152,1576,3,1,3,0,1,0,73.10
高雄市,楠梓區,清豐里,162,1,1560,16,1576,2367,3,1,3,0,1,0,66.58
高雄市,楠梓區,東寧里,163,1,1317,14,1331,1930,3,1,3,0,1,0,68.96
高雄市,楠梓區,五常里,164,1,778,12,790,1097,3,1,3,0,1,0,72.01
高雄市,楠梓區,五常里,165,1,1365,14,1379,2129,3,1,3,0,1,0,64.77
高雄市,楠梓區,享平里,166,1,1533,12,1545,1996,3,1,3,0,1,0,77.40
高雄市,楠梓區,中陽里,167,1,964,12,976,1379,3,1,3,0,1,0,70.78
高雄市,楠梓區,中陽里,168,1,784,49,833,1179,3,1,3,0,1,0,70.65
高雄市,楠梓區,惠楠里,169,1,1342,17,1359,1844,3,1,3,0,1,0,73.70
高雄市,楠梓區,惠民里,170,1,1092,18,1110,1487,3,1,3,0,1,0,74.65
高雄市,楠梓區,惠民里,171,1,1040,10,1050,1309,3,1,3,0,1,0,80.21
高雄市,楠梓區,惠豐里,172,1,1141,17,1158,1643,3,1,3,0,1,0,70.48
高雄市,楠梓區,錦屏里,173,1,1183,12,1195,1603,3,1,3,0,1,0,74.55
高雄市,楠梓區,錦屏里,174,1,1062,9,1071,1413,3,1,3,0,1,0,75.80
高雄市,楠梓區,玉屏里,175,1,682,33,715,908,3,1,3,0,1,0,78.74
高雄市,楠梓區,玉屏里,176,1,844,23,867,1098,3,1,3,0,1,0,78.96
高雄市,楠梓區,瑞屏里,177,1,998,15,1013,1316,3,1,3,0,1,0,76.98
高雄市,楠梓區,瑞屏里,178,1,993,16,1009,1295,3,1,3,0,1,0,77.92
高雄市,楠梓區,翠屏里,179,1,868,11,879,1225,3,1,3,0,1,0,71.76
高雄市,楠梓區,翠屏里,180,1,1831,27,1858,2590,3,1,3,0,1,0,71.74
高雄市,楠梓區,翠屏里,181,1,1542,20,1562,2202,3,1,3,0,1,0,70.94
高雄市,楠梓區,金田里,182,1,996,11,1007,1372,3,1,3,0,1,0,73.40
高雄市,楠梓區,金田里,183,1,1006,14,1020,1355,3,1,3,0,1,0,75.28
高雄市,楠梓區,稔田里,184,1,1050,13,1063,1455,3,1,3,0,1,0,73.06
高雄市,楠梓區,宏南里,185,1,575,6,581,684,3,1,3,0,1,0,84.94
高雄市,楠梓區,宏南里,186,1,811,10,821,1077,3,1,3,0,1,0,76.23
高雄市,楠梓區,宏毅里,187,1,1206,6,1212,1516,3,1,3,0,1,0,79.95
高雄市,楠梓區,宏毅里,188,1,1195,18,1213,1499,3,1,3,0,1,0,80.92
高雄市,楠梓區,宏榮里,189,1,1244,9,1253,1556,3,1,3,0,1,0,80.53
高雄市,楠梓區,廣昌里,190,1,1119,19,1138,1422,3,1,3,0,1,0,80.03
高雄市,楠梓區,廣昌里,191,1,1112,29,1141,1452,3,1,3,0,1,0,78.58
高雄市,楠梓區,久昌里,192,1,1330,20,1350,1929,3,1,3,0,1,0,69.98
高雄市,楠梓區,大昌里,193,1,786,6,792,1075,3,1,3,0,1,0,73.67
高雄市,楠梓區,大昌里,194,1,789,11,800,1050,3,1,3,0,1,0,76.19
高雄市,楠梓區,福昌里,195,1,1325,13,1338,1674,3,1,3,0,1,0,79.93
高雄市,楠梓區,盛昌里,196,1,721,6,727,935,3,1,3,0,1,0,77.75
高雄市,楠梓區,盛昌里,197,1,1174,16,1190,1627,3,1,3,0,1,0,73.14
高雄市,楠梓區,泰昌里,198,1,1164,16,1180,1481,3,1,3,0,1,0,79.68
高雄市,楠梓區,興昌里,199,1,899,8,907,1127,3,1,3,0,1,0,80.48
高雄市,楠梓區,興昌里,200,1,785,9,794,1023,3,1,3,0,1,0,77.61
高雄市,楠梓區,建昌里,201,1,856,7,863,1189,3,1,3,0,1,0,72.58
高雄市,楠梓區,建昌里,202,1,815,7,822,1090,3,1,3,0,1,0,75.41
高雄市,楠梓區,宏昌里,203,1,1255,12,1267,1647,3,1,3,0,1,0,76.93
高雄市,楠梓區,和昌里,204,1,829,9,838,1059,3,1,3,0,1,0,79.13
高雄市,楠梓區,和昌里,205,1,772,5,777,1043,3,1,3,0,1,0,74.50
高雄市,楠梓區,慶昌里,206,1,1024,20,1044,1397,3,1,3,0,1,0,74.73
高雄市,楠梓區,慶昌里,207,1,1030,18,1048,1362,3,1,3,0,1,0,76.95
高雄市,楠梓區,隆昌里,208,1,1356,18,1374,1734,3,1,3,0,1,0,79.24
高雄市,楠梓區,隆昌里,209,1,1028,5,1033,1332,3,1,3,0,1,0,77.55
高雄市,楠梓區,秀昌里,210,1,1278,20,1298,1705,3,1,3,0,1,0,76.13
高雄市,楠梓區,裕昌里,211,1,1197,20,1217,1638,3,1,3,0,1,0,74.30
高雄市,楠梓區,國昌里,212,1,901,6,907,1206,3,1,3,0,1,0,75.21
高雄市,楠梓區,國昌里,213,1,723,10,733,1014,3,1,3,0,1,0,72.29
高雄市,楠梓區,加昌里,214,1,796,10,806,1093,3,1,3,0,1,0,73.74
高雄市,楠梓區,加昌里,215,1,1070,14,1084,1402,3,1,3,0,1,0,77.32
高雄市,楠梓區,加昌里,216,1,1028,33,1061,1468,3,1,3,0,1,0,72.28
高雄市,楠梓區,仁昌里,217,1,821,18,839,1093,3,1,3,0,1,0,76.76
高雄市,楠梓區,仁昌里,218,1,1099,14,1113,1444,3,1,3,0,1,0,77.08
高雄市,楠梓區,藍田里,219,1,667,5,672,802,3,1,3,0,1,0,83.79
高雄市,楠梓區,中和里,220,1,970,12,982,1297,3,1,3,0,1,0,75.71
高雄市,楠梓區,中興里,221,1,618,6,624,791,3,1,3,0,1,0,78.89
高雄市,三民區,鼎金里,222,1,741,11,752,1106,3,1,3,0,1,0,67.99
高雄市,三民區,鼎金里,223,1,918,14,932,1339,3,1,3,0,1,0,69.60
高雄市,三民區,鼎盛里,224,1,1330,10,1340,1859,3,1,3,0,1,0,72.08
高雄市,三民區,鼎盛里,225,1,1173,13,1186,1766,3,1,3,0,1,0,67.16
高雄市,三民區,鼎強里,226,1,1072,7,1079,1443,3,1,3,0,1,0,74.77
高雄市,三民區,鼎強里,227,1,933,25,958,1398,3,1,3,0,1,0,68.53
高雄市,三民區,鼎力里,228,1,945,24,969,1439,3,1,3,0,1,0,67.34
高雄市,三民區,鼎力里,229,1,992,18,1010,1384,3,1,3,0,1,0,72.98
高雄市,三民區,鼎西里,230,1,1223,27,1250,1692,3,1,3,0,1,0,73.88
高雄市,三民區,鼎西里,231,1,1048,19,1067,1577,3,1,3,0,1,0,67.66
高雄市,三民區,鼎中里,232,1,983,26,1009,1348,3,1,3,0,1,0,74.85
高雄市,三民區,鼎中里,233,1,945,10,955,1249,3,1,3,0,1,0,76.46
高雄市,三民區,鼎泰里,234,1,1069,13,1082,1539,3,1,3,0,1,0,70.31
高雄市,三民區,鼎泰里,235,1,1030,13,1043,1514,3,1,3,0,1,0,68.89
高雄市,三民區,鼎泰里,236,1,1089,26,1115,1538,3,1,3,0,1,0,72.50
高雄市,三民區,鼎泰里,237,1,874,10,884,1275,3,1,3,0,1,0,69.33
高雄市,三民區,本舘里,238,1,1267,9,1276,1748,3,1,3,0,1,0,73.00
高雄市,三民區,本舘里,239,1,1434,16,1450,2072,3,1,3,0,1,0,69.98
高雄市,三民區,本舘里,240,1,1357,16,1373,1856,3,1,3,0,1,0,73.98
高雄市,三民區,本和里,241,1,1522,18,1540,2097,3,1,3,0,1,0,73.44
高雄市,三民區,本和里,242,1,1168,23,1191,1557,3,1,3,0,1,0,76.49
高雄市,三民區,本文里,243,1,1260,12,1272,1743,3,1,3,0,1,0,72.98
高雄市,三民區,本武里,244,1,993,14,1007,1412,3,1,3,0,1,0,71.32
高雄市,三民區,本元里,245,1,1566,18,1584,2169,3,1,3,0,1,0,73.03
高雄市,三民區,本元里,246,1,1127,38,1165,1622,3,1,3,0,1,0,71.82
高雄市,三民區,本安里,247,1,974,13,987,1384,3,1,3,0,1,0,71.32
高雄市,三民區,本安里,248,1,1160,10,1170,1559,3,1,3,0,1,0,75.05
高雄市,三民區,本上里,249,1,1234,14,1248,1802,3,1,3,0,1,0,69.26
高雄市,三民區,本上里,250,1,1031,3,1034,1493,3,1,3,0,1,0,69.26
高雄市,三民區,本揚里,251,1,931,16,947,1355,3,1,3,0,1,0,69.89
高雄市,三民區,本揚里,252,1,1124,6,1130,1664,3,1,3,0,1,0,67.91
高雄市,三民區,本揚里,253,1,1044,16,1060,1554,3,1,3,0,1,0,68.21
高雄市,三民區,寶獅里,254,1,1006,8,1014,1527,3,1,3,0,1,0,66.40
高雄市,三民區,寶獅里,255,1,990,8,998,1465,3,1,3,0,1,0,68.12
高雄市,三民區,寶德里,256,1,1174,12,1186,1714,3,1,3,0,1,0,69.19
高雄市,三民區,寶德里,257,1,1145,14,1159,1769,3,1,3,0,1,0,65.52
高雄市,三民區,寶泰里,258,1,719,2,721,1102,3,1,3,0,1,0,65.43
高雄市,三民區,寶泰里,259,1,652,10,662,960,3,1,3,0,1,0,68.96
高雄市,三民區,寶興里,260,1,919,7,926,1357,3,1,3,0,1,0,68.24
高雄市,三民區,寶興里,261,1,904,10,914,1342,3,1,3,0,1,0,68.11
高雄市,三民區,寶興里,262,1,886,7,893,1315,3,1,3,0,1,0,67.91
高雄市,三民區,寶中里,263,1,868,14,882,1194,3,1,3,0,1,0,73.87
高雄市,三民區,寶中里,264,1,894,15,909,1293,3,1,3,0,1,0,70.30
高雄市,三民區,寶華里,265,1,828,9,837,1208,3,1,3,0,1,0,69.29
高雄市,三民區,寶華里,266,1,692,5,697,1019,3,1,3,0,1,0,68.40
高雄市,三民區,寶國里,267,1,969,9,978,1454,3,1,3,0,1,0,67.26
高雄市,三民區,寶國里,268,1,806,10,816,1240,3,1,3,0,1,0,65.81
高雄市,三民區,寶國里,269,1,1021,14,1035,1502,3,1,3,0,1,0,68.91
高雄市,三民區,寶民里,270,1,1393,19,1412,1998,3,1,3,0,1,0,70.67
高雄市,三民區,寶慶里,271,1,750,6,756,1061,3,1,3,0,1,0,71.25
高雄市,三民區,寶慶里,272,1,804,12,816,1167,3,1,3,0,1,0,69.92
高雄市,三民區,寶業里,273,1,1027,13,1040,1502,3,1,3,0,1,0,69.24
高雄市,三民區,寶業里,274,1,1141,7,1148,1674,3,1,3,0,1,0,68.58
高雄市,三民區,寶盛里,275,1,905,13,918,1335,3,1,3,0,1,0,68.76
高雄市,三民區,寶盛里,276,1,1075,6,1081,1477,3,1,3,0,1,0,73.19
高雄市,三民區,寶安里,277,1,812,2,814,1152,3,1,3,0,1,0,70.66
高雄市,三民區,寶安里,278,1,925,12,937,1350,3,1,3,0,1,0,69.41
高雄市,三民區,寶安里,279,1,959,26,985,1473,3,1,3,0,1,0,66.87
高雄市,三民區,寶龍里,280,1,1090,18,1108,1518,3,1,3,0,1,0,72.99
高雄市,三民區,寶龍里,281,1,1126,24,1150,1681,3,1,3,0,1,0,68.41
高雄市,三民區,寶珠里,282,1,1274,23,1297,1884,3,1,3,0,1,0,68.84
高雄市,三民區,寶珠里,283,1,1296,22,1318,1873,3,1,3,0,1,0,70.37
高雄市,三民區,寶玉里,284,1,910,10,920,1354,3,1,3,0,1,0,67.95
高雄市,三民區,寶玉里,285,1,932,17,949,1391,3,1,3,0,1,0,68.22
高雄市,三民區,寶玉里,286,1,1065,21,1086,1657,3,1,3,0,1,0,65.54
高雄市,三民區,灣子里,287,1,908,8,916,1328,3,1,3,0,1,0,68.98
高雄市,三民區,灣子里,288,1,716,5,721,1110,3,1,3,0,1,0,64.95
高雄市,三民區,灣愛里,289,1,846,20,866,1290,3,1,3,0,1,0,67.13
高雄市,三民區,灣愛里,290,1,853,16,869,1213,3,1,3,0,1,0,71.64
高雄市,三民區,灣中里,291,1,1053,15,1068,1657,3,1,3,0,1,0,64.45
高雄市,三民區,灣中里,292,1,1216,22,1238,1797,3,1,3,0,1,0,68.89
高雄市,三民區,灣華里,293,1,1411,20,1431,1898,3,1,3,0,1,0,75.40
高雄市,三民區,灣勝里,294,1,1418,14,1432,1942,3,1,3,0,1,0,73.74
高雄市,三民區,灣利里,295,1,1248,10,1258,1789,3,1,3,0,1,0,70.32
高雄市,三民區,灣利里,296,1,1027,16,1043,1383,3,1,3,0,1,0,75.42
高雄市,三民區,灣復里,297,1,1612,23,1635,2444,3,1,3,0,1,0,66.90
高雄市,三民區,正興里,298,1,1327,9,1336,1949,3,1,3,0,1,0,68.55
高雄市,三民區,正興里,299,1,993,15,1008,1531,3,1,3,0,1,0,65.84
高雄市,三民區,正興里,300,1,1127,18,1145,1608,3,1,3,0,1,0,71.21
高雄市,三民區,正順里,301,1,1064,6,1070,1538,3,1,3,0,1,0,69.57
高雄市,三民區,正順里,302,1,972,11,983,1408,3,1,3,0,1,0,69.82
高雄市,三民區,灣興里,303,1,995,15,1010,1441,3,1,3,0,1,0,70.09
高雄市,三民區,灣成里,304,1,967,10,977,1366,3,1,3,0,1,0,71.52
高雄市,三民區,安康里,305,1,946,60,1006,1592,3,1,3,0,1,0,63.19
高雄市,三民區,安康里,306,1,1007,23,1030,1556,3,1,3,0,1,0,66.20
高雄市,三民區,安寧里,307,1,1448,33,1481,2264,3,1,3,0,1,0,65.42
高雄市,三民區,安吉里,308,1,916,20,936,1400,3,1,3,0,1,0,66.86
高雄市,三民區,安吉里,309,1,1022,9,1031,1552,3,1,3,0,1,0,66.43
高雄市,三民區,安發里,310,1,1071,7,1078,1666,3,1,3,0,1,0,64.71
高雄市,三民區,安發里,311,1,1264,24,1288,1905,3,1,3,0,1,0,67.61
高雄市,三民區,安東里,312,1,1225,20,1245,1663,3,1,3,0,1,0,74.86
高雄市,三民區,安東里,313,1,1121,8,1129,1629,3,1,3,0,1,0,69.31
高雄市,三民區,安和里,314,1,879,10,889,1224,3,1,3,0,1,0,72.63
高雄市,三民區,安和里,315,1,1032,13,1045,1452,3,1,3,0,1,0,71.97
高雄市,三民區,達德里,316,1,1150,7,1157,1572,3,1,3,0,1,0,73.60
高雄市,三民區,達明里,317,1,1305,19,1324,1809,3,1,3,0,1,0,73.19
高雄市,三民區,達仁里,318,1,1064,11,1075,1541,3,1,3,0,1,0,69.76
高雄市,三民區,達勇里,319,1,857,11,868,1143,3,1,3,0,1,0,75.94
高雄市,三民區,同德里,320,1,1026,8,1034,1415,3,1,3,0,1,0,73.07
高雄市,三民區,同德里,321,1,1088,6,1094,1541,3,1,3,0,1,0,70.99
高雄市,三民區,德智里,322,1,877,2,879,1234,3,1,3,0,1,0,71.23
高雄市,三民區,德智里,323,1,767,7,774,1128,3,1,3,0,1,0,68.62
高雄市,三民區,德仁里,324,1,1192,108,1300,1902,3,1,3,0,1,0,68.35
高雄市,三民區,安生里,325,1,1252,20,1272,1856,3,1,3,0,1,0,68.53
高雄市,三民區,德東里,326,1,681,13,694,952,3,1,3,0,1,0,72.90
高雄市,三民區,德行里,327,1,888,7,895,1197,3,1,3,0,1,0,74.77
高雄市,三民區,精華里,328,1,1323,17,1340,1874,3,1,3,0,1,0,71.50
高雄市,三民區,民享里,329,1,682,5,687,959,3,1,3,0,1,0,71.64
高雄市,三民區,民享里,330,1,847,9,856,1160,3,1,3,0,1,0,73.79
高雄市,三民區,安宜里,331,1,1132,11,1143,1571,3,1,3,0,1,0,72.76
高雄市,三民區,安宜里,332,1,1106,13,1119,1614,3,1,3,0,1,0,69.33
高雄市,三民區,安泰里,333,1,1385,49,1434,1901,3,1,3,0,1,0,75.43
高雄市,三民區,安泰里,334,1,1303,13,1316,1899,3,1,3,0,1,0,69.30
高雄市,三民區,安邦里,335,1,1254,16,1270,1677,3,1,3,0,1,0,75.73
高雄市,三民區,安邦里,336,1,1226,17,1243,1735,3,1,3,0,1,0,71.64
高雄市,三民區,十全里,337,1,1026,11,1037,1421,3,1,3,0,1,0,72.98
高雄市,三民區,十美里,338,1,1245,14,1259,1699,3,1,3,0,1,0,74.10
高雄市,三民區,德北里,339,1,1399,22,1421,1938,3,1,3,0,1,0,73.32
高雄市,三民區,立誠里,340,1,859,10,869,1165,3,1,3,0,1,0,74.59
高雄市,三民區,立業里,341,1,821,10,831,1143,3,1,3,0,1,0,72.70
高雄市,三民區,港東里,342,1,942,14,956,1428,3,1,3,0,1,0,66.95
高雄市,三民區,港新里,343,1,1042,10,1052,1556,3,1,3,0,1,0,67.61
高雄市,三民區,港西里,344,1,602,10,612,924,3,1,3,0,1,0,66.23
高雄市,三民區,港北里,345,1,477,5,482,597,3,1,3,0,1,0,80.74
高雄市,三民區,博愛里,346,1,773,12,785,1188,3,1,3,0,1,0,66.08
高雄市,三民區,博惠里,347,1,1320,16,1336,1970,3,1,3,0,1,0,67.82
高雄市,三民區,博惠里,348,1,1344,15,1359,2017,3,1,3,0,1,0,67.38
高雄市,三民區,長明里,349,1,926,13,939,1321,3,1,3,0,1,0,71.08
高雄市,三民區,建東里,350,1,673,11,684,1037,3,1,3,0,1,0,65.96
高雄市,三民區,興德里,351,1,871,8,879,1285,3,1,3,0,1,0,68.40
高雄市,三民區,鳳南里,352,1,815,5,820,1148,3,1,3,0,1,0,71.43
高雄市,三民區,鳳北里,353,1,736,17,753,1020,3,1,3,0,1,0,73.82
高雄市,三民區,鳳北里,354,1,799,12,811,1134,3,1,3,0,1,0,71.52
高雄市,三民區,德西里,355,1,851,8,859,1212,3,1,3,0,1,0,70.87
高雄市,三民區,九如里,356,1,317,6,323,440,3,1,3,0,1,0,73.41
高雄市,三民區,豐裕里,357,1,1034,7,1041,1437,3,1,3,0,1,0,72.44
高雄市,三民區,豐裕里,358,1,961,15,976,1324,3,1,3,0,1,0,73.72
高雄市,三民區,川東里,359,1,1272,22,1294,1819,3,1,3,0,1,0,71.14
高雄市,三民區,裕民里,360,1,601,14,615,801,3,1,3,0,1,0,76.78
高雄市,三民區,力行里,361,1,991,4,995,1312,3,1,3,0,1,0,75.84
高雄市,三民區,千歲里,362,1,863,16,879,1241,3,1,3,0,1,0,70.83
高雄市,三民區,立德里,363,1,943,13,956,1365,3,1,3,0,1,0,70.04
高雄市,三民區,千北里,364,1,920,13,933,1281,3,1,3,0,1,0,72.83
高雄市,三民區,千秋里,365,1,875,35,910,1313,3,1,3,0,1,0,69.31
高雄市,三民區,千秋里,366,1,847,24,871,1208,3,1,3,0,1,0,72.10
高雄市,新興區,興昌里,367,2,623,4,627,796,3,1,3,0,1,0,78.77
高雄市,新興區,興昌里,368,2,815,7,822,1104,3,1,3,0,1,0,74.46
高雄市,新興區,南港里,369,2,593,3,596,866,3,1,3,0,1,0,68.82
高雄市,新興區,南港里,370,2,977,12,989,1381,3,1,3,0,1,0,71.61
高雄市,新興區,仁聲里,371,2,471,6,477,706,3,1,3,0,1,0,67.56
高雄市,新興區,振成里,372,2,822,15,837,1224,3,1,3,0,1,0,68.38
高雄市,新興區,華聲里,373,2,739,7,746,1038,3,1,3,0,1,0,71.87
高雄市,新興區,漢民里,374,2,748,11,759,1009,3,1,3,0,1,0,75.22
高雄市,新興區,愛平里,375,2,700,9,709,978,3,1,3,0,1,0,72.49
高雄市,新興區,振華里,376,2,920,9,929,1295,3,1,3,0,1,0,71.74
高雄市,新興區,東坡里,377,2,1026,13,1039,1405,3,1,3,0,1,0,73.95
高雄市,新興區,大明里,378,2,849,11,860,1222,3,1,3,0,1,0,70.38
高雄市,新興區,明莊里,379,2,671,22,693,916,3,1,3,0,1,0,75.66
高雄市,新興區,建興里,380,2,650,13,663,934,3,1,3,0,1,0,70.99
高雄市,新興區,建華里,381,2,587,3,590,881,3,1,3,0,1,0,66.97
高雄市,新興區,黎明里,382,2,627,10,637,915,3,1,3,0,1,0,69.62
高雄市,新興區,中東里,383,2,736,4,740,1147,3,1,3,0,1,0,64.52
高雄市,新興區,中東里,384,2,839,11,850,1283,3,1,3,0,1,0,66.25
高雄市,新興區,順昌里,385,2,712,9,721,1005,3,1,3,0,1,0,71.74
高雄市,新興區,順昌里,386,2,936,15,951,1237,3,1,3,0,1,0,76.88
高雄市,新興區,德望里,387,2,1235,15,1250,1800,3,1,3,0,1,0,69.44
高雄市,新興區,榮治里,388,2,406,6,412,573,3,1,3,0,1,0,71.90
高雄市,新興區,德生里,389,2,571,2,573,867,3,1,3,0,1,0,66.09
高雄市,新興區,德生里,390,2,804,7,811,1151,3,1,3,0,1,0,70.46
高雄市,新興區,永寧里,391,2,1046,20,1066,1468,3,1,3,0,1,0,72.62
高雄市,新興區,文昌里,392,2,804,9,813,1100,3,1,3,0,1,0,73.91
高雄市,新興區,文昌里,393,2,774,9,783,1131,3,1,3,0,1,0,69.23
高雄市,新興區,秋山里,394,2,645,10,655,944,3,1,3,0,1,0,69.39
高雄市,新興區,長驛里,395,2,570,7,577,819,3,1,3,0,1,0,70.45
高雄市,新興區,開平里,396,2,742,7,749,976,3,1,3,0,1,0,76.74
高雄市,新興區,開平里,397,2,900,10,910,1230,3,1,3,0,1,0,73.98
高雄市,新興區,成功里,398,2,851,7,858,1170,3,1,3,0,1,0,73.33
高雄市,新興區,德政里,399,2,532,15,547,763,3,1,3,0,1,0,71.69
高雄市,新興區,玉衡里,400,2,890,16,906,1202,3,1,3,0,1,0,75.37
高雄市,新興區,正氣里,401,2,1173,15,1188,1614,3,1,3,0,1,0,73.61
高雄市,新興區,新江里,402,2,837,8,845,1265,3,1,3,0,1,0,66.80
高雄市,新興區,蕉園里,403,2,599,8,607,833,3,1,3,0,1,0,72.87
高雄市,新興區,浩然里,404,2,751,6,757,1099,3,1,3,0,1,0,68.88
高雄市,新興區,浩然里,405,2,720,10,730,974,3,1,3,0,1,0,74.95
高雄市,新興區,光耀里,406,2,883,8,891,1296,3,1,3,0,1,0,68.75
高雄市,新興區,光耀里,407,2,939,13,952,1299,3,1,3,0,1,0,73.29
高雄市,前金區,三川里,408,2,630,14,644,921,3,1,3,0,1,0,69.92
高雄市,前金區,草江里,409,2,830,13,843,1190,3,1,3,0,1,0,70.84
高雄市,前金區,長城里,410,2,1092,13,1105,1600,3,1,3,0,1,0,69.06
高雄市,前金區,長興里,411,2,710,10,720,1064,3,1,3,0,1,0,67.67
高雄市,前金區,青山里,412,2,922,5,927,1322,3,1,3,0,1,0,70.12
高雄市,前金區,東金里,413,2,632,11,643,991,3,1,3,0,1,0,64.88
高雄市,前金區,北金里,414,2,558,9,567,814,3,1,3,0,1,0,69.66
高雄市,前金區,新生里,415,2,1061,14,1075,1462,3,1,3,0,1,0,73.53
高雄市,前金區,新生里,416,2,798,12,810,1278,3,1,3,0,1,0,63.38
高雄市,前金區,後金里,417,2,826,13,839,1122,3,1,3,0,1,0,74.78
高雄市,前金區,林投里,418,2,1036,12,1048,1436,3,1,3,0,1,0,72.98
高雄市,前金區,民生里,419,2,512,2,514,766,3,1,3,0,1,0,67.10
高雄市,前金區,復元里,420,2,714,7,721,995,3,1,3,0,1,0,72.46
高雄市,前金區,國民里,421,2,729,22,751,1063,3,1,3,0,1,0,70.65
高雄市,前金區,社東里,422,2,1295,13,1308,1805,3,1,3,0,1,0,72.47
高雄市,前金區,社西里,423,2,882,9,891,1220,3,1,3,0,1,0,73.03
高雄市,前金區,長生里,424,2,1207,14,1221,1724,3,1,3,0,1,0,70.82
高雄市,前金區,榮復里,425,2,989,22,1011,1350,3,1,3,0,1,0,74.89
高雄市,前金區,博孝里,426,2,639,6,645,1045,3,1,3,0,1,0,61.72
高雄市,前金區,文西里,427,2,874,22,896,1271,3,1,3,0,1,0,70.50
高雄市,前金區,文東里,428,2,954,12,966,1370,3,1,3,0,1,0,70.51
高雄市,苓雅區,博仁里,429,2,454,3,457,650,3,1,3,0,1,0,70.31
高雄市,苓雅區,苓洲里,430,2,920,20,940,1351,3,1,3,0,1,0,69.58
高雄市,苓雅區,苓昇里,431,2,956,13,969,1419,3,1,3,0,1,0,68.29
高雄市,苓雅區,苓中里,432,2,1078,17,1095,1529,3,1,3,0,1,0,71.62
高雄市,苓雅區,苓雅里,433,2,863,14,877,1291,3,1,3,0,1,0,67.93
高雄市,苓雅區,苓東里,434,2,928,58,986,1468,3,1,3,0,1,0,67.17
高雄市,苓雅區,城北里,435,2,1034,20,1054,1518,3,1,3,0,1,0,69.43
高雄市,苓雅區,城西里,436,2,565,9,574,798,3,1,3,0,1,0,71.93
高雄市,苓雅區,城東里,437,2,1137,11,1148,1658,3,1,3,0,1,0,69.24
高雄市,苓雅區,意誠里,438,2,987,15,1002,1591,3,1,3,0,1,0,62.98
高雄市,苓雅區,鼓中里,439,2,987,20,1007,1352,3,1,3,0,1,0,74.48
高雄市,苓雅區,田西里,440,2,1119,49,1168,1537,3,1,3,0,1,0,75.99
高雄市,苓雅區,人和里,441,2,1202,14,1216,1737,3,1,3,0,1,0,70.01
高雄市,苓雅區,仁政里,442,2,1118,30,1148,1709,3,1,3,0,1,0,67.17
高雄市,苓雅區,廣澤里,443,2,1440,17,1457,2031,3,1,3,0,1,0,71.74
高雄市,苓雅區,美田里,444,2,871,16,887,1299,3,1,3,0,1,0,68.28
高雄市,苓雅區,華堂里,445,2,1054,17,1071,1626,3,1,3,0,1,0,65.87
高雄市,苓雅區,華堂里,446,2,805,10,815,1312,3,1,3,0,1,0,62.12
高雄市,苓雅區,日中里,447,2,828,11,839,1187,3,1,3,0,1,0,70.68
高雄市,苓雅區,日中里,448,2,830,23,853,1211,3,1,3,0,1,0,70.44
高雄市,苓雅區,普照里,449,2,886,7,893,1218,3,1,3,0,1,0,73.32
高雄市,苓雅區,普照里,450,2,789,10,799,1154,3,1,3,0,1,0,69.24
高雄市,苓雅區,和煦里,451,2,1522,28,1550,2215,3,1,3,0,1,0,69.98
高雄市,苓雅區,晴朗里,452,2,692,11,703,997,3,1,3,0,1,0,70.51
高雄市,苓雅區,普天里,453,2,932,8,940,1349,3,1,3,0,1,0,69.68
高雄市,苓雅區,普天里,454,2,820,8,828,1270,3,1,3,0,1,0,65.20
高雄市,苓雅區,林富里,455,2,1046,30,1076,1493,3,1,3,0,1,0,72.07
高雄市,苓雅區,林圍里,456,2,1336,15,1351,1877,3,1,3,0,1,0,71.98
高雄市,苓雅區,林安里,457,2,1081,8,1089,1496,3,1,3,0,1,0,72.79
高雄市,苓雅區,光華里,458,2,606,5,611,852,3,1,3,0,1,0,71.71
高雄市,苓雅區,林興里,459,2,997,6,1003,1402,3,1,3,0,1,0,71.54
高雄市,苓雅區,林華里,460,2,1022,14,1036,1497,3,1,3,0,1,0,69.21
高雄市,苓雅區,林華里,461,2,1146,14,1160,1664,3,1,3,0,1,0,69.71
高雄市,苓雅區,林西里,462,2,1433,28,1461,2055,3,1,3,0,1,0,71.09
高雄市,苓雅區,林中里,463,2,1125,25,1150,1566,3,1,3,0,1,0,73.44
高雄市,苓雅區,林中里,464,2,1324,20,1344,1839,3,1,3,0,1,0,73.08
高雄市,苓雅區,林泉里,465,2,1154,7,1161,1646,3,1,3,0,1,0,70.53
高雄市,苓雅區,林南里,466,2,1031,13,1044,1489,3,1,3,0,1,0,70.11
高雄市,苓雅區,林南里,467,2,828,9,837,1274,3,1,3,0,1,0,65.70
高雄市,苓雅區,中正里,468,2,769,7,776,1131,3,1,3,0,1,0,68.61
高雄市,苓雅區,中正里,469,2,799,7,806,1216,3,1,3,0,1,0,66.28
高雄市,苓雅區,尚義里,470,2,998,28,1026,1477,3,1,3,0,1,0,69.47
高雄市,苓雅區,同慶里,471,2,1117,13,1130,1623,3,1,3,0,1,0,69.62
高雄市,苓雅區,凱旋里,472,2,1439,26,1465,1942,3,1,3,0,1,0,75.44
高雄市,苓雅區,安祥里,473,2,635,22,657,987,3,1,3,0,1,0,66.57
高雄市,苓雅區,安祥里,474,2,904,5,909,1354,3,1,3,0,1,0,67.13
高雄市,苓雅區,奏捷里,475,2,1269,24,1293,1803,3,1,3,0,1,0,71.71
高雄市,苓雅區,福壽里,476,2,1138,43,1181,1582,3,1,3,0,1,0,74.65
高雄市,苓雅區,福南里,477,2,796,9,805,1154,3,1,3,0,1,0,69.76
高雄市,苓雅區,福南里,478,2,864,11,875,1239,3,1,3,0,1,0,70.62
高雄市,苓雅區,五權里,479,2,1208,21,1229,1783,3,1,3,0,1,0,68.93
高雄市,苓雅區,民主里,480,2,1116,9,1125,1683,3,1,3,0,1,0,66.84
高雄市,苓雅區,民主里,481,2,1216,19,1235,1779,3,1,3,0,1,0,69.42
高雄市,苓雅區,林德里,482,2,1332,53,1385,1938,3,1,3,0,1,0,71.47
高雄市,苓雅區,林貴里,483,2,1000,10,1010,1439,3,1,3,0,1,0,70.19
高雄市,苓雅區,林榮里,484,2,1362,15,1377,1979,3,1,3,0,1,0,69.58
高雄市,苓雅區,林榮里,485,2,1274,16,1290,1852,3,1,3,0,1,0,69.65
高雄市,苓雅區,英明里,486,2,685,16,701,1050,3,1,3,0,1,0,66.76
高雄市,苓雅區,英明里,487,2,728,13,741,1066,3,1,3,0,1,0,69.51
高雄市,苓雅區,林靖里,488,2,886,16,902,1229,3,1,3,0,1,0,73.39
高雄市,苓雅區,朝陽里,489,2,1118,12,1130,1574,3,1,3,0,1,0,71.79
高雄市,苓雅區,福隆里,490,2,880,71,951,1353,3,1,3,0,1,0,70.29
高雄市,苓雅區,福隆里,491,2,1045,8,1053,1499,3,1,3,0,1,0,70.25
高雄市,苓雅區,福祥里,492,2,1034,9,1043,1422,3,1,3,0,1,0,73.35
高雄市,苓雅區,福海里,493,2,741,21,762,1077,3,1,3,0,1,0,70.75
高雄市,苓雅區,福康里,494,2,1334,19,1353,1948,3,1,3,0,1,0,69.46
高雄市,苓雅區,福人里,495,2,1621,26,1647,2248,3,1,3,0,1,0,73.27
高雄市,苓雅區,福地里,496,2,1013,19,1032,1479,3,1,3,0,1,0,69.78
高雄市,苓雅區,福地里,497,2,895,8,903,1371,3,1,3,0,1,0,65.86
高雄市,苓雅區,福居里,498,2,1003,24,1027,1379,3,1,3,0,1,0,74.47
高雄市,苓雅區,福居里,499,2,1089,21,1110,1584,3,1,3,0,1,0,70.08
高雄市,苓雅區,福東里,500,2,1387,27,1414,2162,3,1,3,0,1,0,65.40
高雄市,苓雅區,福西里,501,2,867,8,875,1277,3,1,3,0,1,0,68.52
高雄市,苓雅區,福西里,502,2,791,14,805,1142,3,1,3,0,1,0,70.49
高雄市,苓雅區,永康里,503,2,1449,39,1488,2146,3,1,3,0,1,0,69.34
高雄市,苓雅區,正文里,504,2,1082,12,1094,1503,3,1,3,0,1,0,72.79
高雄市,苓雅區,正言里,505,2,1397,13,1410,2149,3,1,3,0,1,0,65.61
高雄市,苓雅區,正大里,506,2,1157,15,1172,1712,3,1,3,0,1,0,68.46
高雄市,苓雅區,正大里,507,2,1274,19,1293,1928,3,1,3,0,1,0,67.06
高雄市,苓雅區,五福里,508,2,1260,19,1279,1824,3,1,3,0,1,0,70.12
高雄市,苓雅區,五福里,509,2,1260,22,1282,1922,3,1,3,0,1,0,66.70
高雄市,苓雅區,正心里,510,2,1130,30,1160,1650,3,1,3,0,1,0,70.30
高雄市,苓雅區,正心里,511,2,1116,21,1137,1593,3,1,3,0,1,0,71.37
高雄市,苓雅區,正道里,512,2,1273,23,1296,1854,3,1,3,0,1,0,69.90
高雄市,苓雅區,正道里,513,2,1107,12,1119,1582,3,1,3,0,1,0,70.73
高雄市,苓雅區,正義里,514,2,1392,22,1414,1942,3,1,3,0,1,0,72.81
高雄市,苓雅區,正仁里,515,2,951,13,964,1247,3,1,3,0,1,0,77.31
高雄市,苓雅區,正仁里,516,2,671,13,684,939,3,1,3,0,1,0,72.84
高雄市,苓雅區,文昌里,517,2,1307,20,1327,1809,3,1,3,0,1,0,73.36
高雄市,苓雅區,文昌里,518,2,1197,10,1207,1654,3,1,3,0,1,0,72.97
高雄市,苓雅區,建軍里,519,2,1298,10,1308,1791,3,1,3,0,1,0,73.03
高雄市,苓雅區,衛武里,520,2,1478,34,1512,2110,3,1,3,0,1,0,71.66
高雄市,前鎮區,草衙里,521,2,1299,18,1317,1855,3,1,3,0,1,0,71.00
高雄市,前鎮區,草衙里,522,2,1210,27,1237,1889,3,1,3,0,1,0,65.48
高雄市,前鎮區,草衙里,523,2,1638,18,1656,2604,3,1,3,0,1,0,63.59
高雄市,前鎮區,明孝里,524,2,1000,17,1017,1395,3,1,3,0,1,0,72.90
高雄市,前鎮區,明孝里,525,2,537,11,548,884,3,1,3,0,1,0,61.99
高雄市,前鎮區,明正里,526,2,1098,14,1112,1478,3,1,3,0,1,0,75.24
高雄市,前鎮區,明正里,527,2,1191,20,1211,1760,3,1,3,0,1,0,68.81
高雄市,前鎮區,明義里,528,2,793,16,809,1031,3,1,3,0,1,0,78.47
高雄市,前鎮區,明義里,529,2,553,3,556,771,3,1,3,0,1,0,72.11
高雄市,前鎮區,仁愛里,530,2,1067,17,1084,1509,3,1,3,0,1,0,71.84
高雄市,前鎮區,德昌里,531,2,809,16,825,1172,3,1,3,0,1,0,70.39
高雄市,前鎮區,德昌里,532,2,621,11,632,901,3,1,3,0,1,0,70.14
高雄市,前鎮區,平等里,533,2,1083,24,1107,1624,3,1,3,0,1,0,68.17
高雄市,前鎮區,平昌里,534,2,645,7,652,913,3,1,3,0,1,0,71.41
高雄市,前鎮區,明禮里,535,2,1270,25,1295,1792,3,1,3,0,1,0,72.27
高雄市,前鎮區,信義里,536,2,1038,16,1054,1513,3,1,3,0,1,0,69.66
高雄市,前鎮區,信德里,537,2,838,14,852,1248,3,1,3,0,1,0,68.27
高雄市,前鎮區,信德里,538,2,1017,13,1030,1482,3,1,3,0,1,0,69.50
高雄市,前鎮區,明道里,539,2,1024,14,1038,1396,3,1,3,0,1,0,74.36
高雄市,前鎮區,興化里,540,2,592,10,602,814,3,1,3,0,1,0,73.96
高雄市,前鎮區,興仁里,541,2,718,11,729,980,3,1,3,0,1,0,74.39
高雄市,前鎮區,前鎮里,542,2,1359,34,1393,1759,3,1,3,0,1,0,79.19
高雄市,前鎮區,鎮東里,543,2,1407,26,1433,1897,3,1,3,0,1,0,75.54
高雄市,前鎮區,鎮榮里,544,2,884,17,901,1177,3,1,3,0,1,0,76.55
高雄市,前鎮區,鎮榮里,545,2,865,29,894,1231,3,1,3,0,1,0,72.62
高雄市,前鎮區,鎮昌里,546,2,837,30,867,1187,3,1,3,0,1,0,73.04
高雄市,前鎮區,鎮昌里,547,2,536,12,548,764,3,1,3,0,1,0,71.73
高雄市,前鎮區,鎮海里,548,2,1220,19,1239,1663,3,1,3,0,1,0,74.50
高雄市,前鎮區,鎮海里,549,2,1053,8,1061,1542,3,1,3,0,1,0,68.81
高雄市,前鎮區,興邦里,550,2,655,9,664,841,3,1,3,0,1,0,78.95
高雄市,前鎮區,鎮中里,551,2,772,22,794,994,3,1,3,0,1,0,79.88
高雄市,前鎮區,鎮北里,552,2,919,15,934,1216,3,1,3,0,1,0,76.81
高雄市,前鎮區,鎮陽里,553,2,959,16,975,1233,3,1,3,0,1,0,79.08
高雄市,前鎮區,忠純里,554,2,1971,31,2002,2515,3,1,3,0,1,0,79.60
高雄市,前鎮區,忠誠里,555,2,1505,18,1523,1890,3,1,3,0,1,0,80.58
高雄市,前鎮區,君毅里,556,2,153,2,155,200,3,1,3,0,1,0,77.50
高雄市,前鎮區,壯勇里,557,2,29,1,30,58,3,1,3,0,1,0,51.72
高雄市,前鎮區,西山里,558,2,962,16,978,1357,3,1,3,0,1,0,72.07
高雄市,前鎮區,西山里,559,2,1177,10,1187,1657,3,1,3,0,1,0,71.64
高雄市,前鎮區,民權里,560,2,1386,21,1407,1801,3,1,3,0,1,0,78.12
高雄市,前鎮區,建隆里,561,2,703,19,722,969,3,1,3,0,1,0,74.51
高雄市,前鎮區,振興里,562,2,872,13,885,1169,3,1,3,0,1,0,75.71
高雄市,前鎮區,良和里,563,2,716,9,725,917,3,1,3,0,1,0,79.06
高雄市,前鎮區,良和里,564,2,695,86,781,1188,3,1,3,0,1,0,65.74
高雄市,前鎮區,西甲里,565,2,779,14,793,1062,3,1,3,0,1,0,74.67
高雄市,前鎮區,西甲里,566,2,781,16,797,1097,3,1,3,0,1,0,72.65
高雄市,前鎮區,盛興里,567,2,702,6,708,1135,3,1,3,0,1,0,62.38
高雄市,前鎮區,盛興里,568,2,631,8,639,995,3,1,3,0,1,0,64.22
高雄市,前鎮區,盛豐里,569,2,1075,16,1091,1588,3,1,3,0,1,0,68.70
高雄市,前鎮區,盛豐里,570,2,901,13,914,1391,3,1,3,0,1,0,65.71
高雄市,前鎮區,興中里,571,2,1076,13,1089,1554,3,1,3,0,1,0,70.08
高雄市,前鎮區,興中里,572,2,1013,18,1031,1573,3,1,3,0,1,0,65.54
高雄市,前鎮區,興東里,573,2,1184,15,1199,1776,3,1,3,0,1,0,67.51
高雄市,前鎮區,忠孝里,574,2,892,14,906,1302,3,1,3,0,1,0,69.59
高雄市,前鎮區,忠孝里,575,2,854,10,864,1242,3,1,3,0,1,0,69.57
高雄市,前鎮區,復國里,576,2,966,10,976,1335,3,1,3,0,1,0,73.11
高雄市,前鎮區,復國里,577,2,910,4,914,1319,3,1,3,0,1,0,69.29
高雄市,前鎮區,竹內里,578,2,799,13,812,1201,3,1,3,0,1,0,67.61
高雄市,前鎮區,竹內里,579,2,927,14,941,1368,3,1,3,0,1,0,68.79
高雄市,前鎮區,竹東里,580,2,607,8,615,973,3,1,3,0,1,0,63.21
高雄市,前鎮區,竹東里,581,2,656,6,662,939,3,1,3,0,1,0,70.50
高雄市,前鎮區,竹南里,582,2,788,25,813,1147,3,1,3,0,1,0,70.88
高雄市,前鎮區,竹南里,583,2,822,12,834,1164,3,1,3,0,1,0,71.65
高雄市,前鎮區,竹北里,584,2,701,5,706,1078,3,1,3,0,1,0,65.49
高雄市,前鎮區,竹北里,585,2,649,3,652,970,3,1,3,0,1,0,67.22
高雄市,前鎮區,竹西里,586,2,955,15,970,1342,3,1,3,0,1,0,72.28
高雄市,前鎮區,竹西里,587,2,1048,25,1073,1490,3,1,3,0,1,0,72.01
高雄市,前鎮區,竹中里,588,2,933,14,947,1336,3,1,3,0,1,0,70.88
高雄市,前鎮區,竹中里,589,2,899,17,916,1214,3,1,3,0,1,0,75.45
高雄市,前鎮區,瑞竹里,590,2,876,81,957,1377,3,1,3,0,1,0,69.50
高雄市,前鎮區,瑞南里,591,2,1044,22,1066,1480,3,1,3,0,1,0,72.03
高雄市,前鎮區,瑞南里,592,2,1175,19,1194,1573,3,1,3,0,1,0,75.91
高雄市,前鎮區,瑞南里,593,2,998,18,1016,1455,3,1,3,0,1,0,69.83
高雄市,前鎮區,瑞豐里,594,2,858,7,865,1184,3,1,3,0,1,0,73.06
高雄市,前鎮區,瑞豐里,595,2,784,11,795,1126,3,1,3,0,1,0,70.60
高雄市,前鎮區,瑞祥里,596,2,1308,17,1325,1874,3,1,3,0,1,0,70.70
高雄市,前鎮區,瑞祥里,597,2,1355,12,1367,1945,3,1,3,0,1,0,70.28
高雄市,前鎮區,瑞東里,598,2,772,10,782,1157,3,1,3,0,1,0,67.59
高雄市,前鎮區,瑞東里,599,2,873,15,888,1309,3,1,3,0,1,0,67.84
高雄市,前鎮區,瑞和里,600,2,740,10,750,1036,3,1,3,0,1,0,72.39
高雄市,前鎮區,瑞和里,601,2,684,11,695,995,3,1,3,0,1,0,69.85
高雄市,前鎮區,瑞平里,602,2,894,22,916,1388,3,1,3,0,1,0,65.99
高雄市,前鎮區,瑞平里,603,2,982,39,1021,1533,3,1,3,0,1,0,66.60
高雄市,前鎮區,瑞隆里,604,2,923,7,930,1401,3,1,3,0,1,0,66.38
高雄市,前鎮區,瑞隆里,605,2,1082,13,1095,1596,3,1,3,0,1,0,68.61
高雄市,前鎮區,瑞北里,606,2,1015,17,1032,1373,3,1,3,0,1,0,75.16
高雄市,前鎮區,瑞北里,607,2,932,18,950,1346,3,1,3,0,1,0,70.58
高雄市,前鎮區,瑞西里,608,2,1025,16,1041,1350,3,1,3,0,1,0,77.11
高雄市,前鎮區,瑞西里,609,2,954,24,978,1277,3,1,3,0,1,0,76.59
高雄市,前鎮區,瑞崗里,610,2,974,18,992,1386,3,1,3,0,1,0,71.57
高雄市,前鎮區,瑞崗里,611,2,777,10,787,1127,3,1,3,0,1,0,69.83
高雄市,前鎮區,瑞興里,612,2,771,15,786,1086,3,1,3,0,1,0,72.38
高雄市,前鎮區,瑞興里,613,2,872,12,884,1291,3,1,3,0,1,0,68.47
高雄市,前鎮區,瑞誠里,614,2,1236,15,1251,1790,3,1,3,0,1,0,69.89
高雄市,前鎮區,瑞文里,615,2,583,16,599,879,3,1,3,0,1,0,68.15
高雄市,前鎮區,瑞文里,616,2,723,16,739,1053,3,1,3,0,1,0,70.18
高雄市,前鎮區,瑞華里,617,2,1200,14,1214,1740,3,1,3,0,1,0,69.77
高雄市,前鎮區,瑞華里,618,2,873,18,891,1261,3,1,3,0,1,0,70.66
高雄市,前鎮區,瑞昌里,619,2,856,10,866,1215,3,1,3,0,1,0,71.28
高雄市,前鎮區,瑞昌里,620,2,856,29,885,1281,3,1,3,0,1,0,69.09
高雄市,小港區,小港里,621,2,1204,12,1216,1752,3,1,3,0,1,0,69.41
高雄市,小港區,港口里,622,2,753,5,758,970,3,1,3,0,1,0,78.14
高雄市,小港區,港口里,623,2,1048,4,1052,1457,3,1,3,0,1,0,72.20
高雄市,小港區,港正里,624,2,1283,11,1294,1722,3,1,3,0,1,0,75.15
高雄市,小港區,港明里,625,2,828,15,843,1147,3,1,3,0,1,0,73.50
高雄市,小港區,港明里,626,2,927,19,946,1326,3,1,3,0,1,0,71.34
高雄市,小港區,港墘里,627,2,941,15,956,1339,3,1,3,0,1,0,71.40
高雄市,小港區,港南里,628,2,959,14,973,1341,3,1,3,0,1,0,72.56
高雄市,小港區,港后里,629,2,899,14,913,1295,3,1,3,0,1,0,70.50
高雄市,小港區,港興里,630,2,1229,15,1244,1686,3,1,3,0,1,0,73.78
高雄市,小港區,大苓里,631,2,688,6,694,942,3,1,3,0,1,0,73.67
高雄市,小港區,大苓里,632,2,707,6,713,961,3,1,3,0,1,0,74.19
高雄市,小港區,二苓里,633,2,694,11,705,981,3,1,3,0,1,0,71.87
高雄市,小港區,二苓里,634,2,1041,11,1052,1464,3,1,3,0,1,0,71.86
高雄市,小港區,三苓里,635,2,988,16,1004,1361,3,1,3,0,1,0,73.77
高雄市,小港區,三苓里,636,2,540,13,553,726,3,1,3,0,1,0,76.17
高雄市,小港區,鳳宮里,637,2,860,11,871,1280,3,1,3,0,1,0,68.05
高雄市,小港區,店鎮里,638,2,1208,20,1228,1717,3,1,3,0,1,0,71.52
高雄市,小港區,店鎮里,639,2,1258,11,1269,1814,3,1,3,0,1,0,69.96
高雄市,小港區,正苓里,640,2,874,9,883,1293,3,1,3,0,1,0,68.29
高雄市,小港區,正苓里,641,2,1010,18,1028,1554,3,1,3,0,1,0,66.15
高雄市,小港區,順苓里,642,2,727,13,740,1082,3,1,3,0,1,0,68.39
高雄市,小港區,順苓里,643,2,924,11,935,1329,3,1,3,0,1,0,70.35
高雄市,小港區,六苓里,644,2,523,3,526,703,3,1,3,0,1,0,74.82
高雄市,小港區,宏亮里,645,2,960,23,983,1415,3,1,3,0,1,0,69.47
高雄市,小港區,山明里,646,2,997,21,1018,1433,3,1,3,0,1,0,71.04
高雄市,小港區,山明里,647,2,923,19,942,1341,3,1,3,0,1,0,70.25
高雄市,小港區,山東里,648,2,881,12,893,1247,3,1,3,0,1,0,71.61
高雄市,小港區,山東里,649,2,699,7,706,1014,3,1,3,0,1,0,69.63
高雄市,小港區,青島里,650,2,1014,9,1023,1387,3,1,3,0,1,0,73.76
高雄市,小港區,濟南里,651,2,1398,12,1410,1910,3,1,3,0,1,0,73.82
高雄市,小港區,泰山里,652,2,1061,14,1075,1454,3,1,3,0,1,0,73.93
高雄市,小港區,松金里,653,2,984,11,995,1370,3,1,3,0,1,0,72.63
高雄市,小港區,松山里,654,2,955,22,977,1252,3,1,3,0,1,0,78.04
高雄市,小港區,高松里,655,2,889,24,913,1200,3,1,3,0,1,0,76.08
高雄市,小港區,高松里,656,2,1077,20,1097,1364,3,1,3,0,1,0,80.43
高雄市,小港區,大坪里,657,2,715,12,727,938,3,1,3,0,1,0,77.51
高雄市,小港區,坪頂里,658,2,685,8,693,958,3,1,3,0,1,0,72.34
高雄市,小港區,孔宅里,659,2,713,4,717,971,3,1,3,0,1,0,73.84
高雄市,小港區,孔宅里,660,2,1002,28,1030,1512,3,1,3,0,1,0,68.12
高雄市,小港區,合作里,661,2,1179,12,1191,1691,3,1,3,0,1,0,70.43
高雄市,小港區,廈莊里,662,2,926,17,943,1292,3,1,3,0,1,0,72.99
高雄市,小港區,桂林里,663,2,1146,20,1166,1548,3,1,3,0,1,0,75.32
高雄市,小港區,桂林里,664,2,1593,21,1614,2341,3,1,3,0,1,0,68.94
高雄市,小港區,中厝里,665,2,623,11,634,855,3,1,3,0,1,0,74.15
高雄市,小港區,中厝里,666,2,795,21,816,1100,3,1,3,0,1,0,74.18
高雄市,小港區,龍鳳里,667,2,1392,15,1407,1722,3,1,3,0,1,0,81.71
高雄市,小港區,鳳鳴里,668,2,1500,13,1513,1859,3,1,3,0,1,0,81.39
高雄市,小港區,鳳興里,669,2,1075,11,1086,1374,3,1,3,0,1,0,79.04
高雄市,小港區,鳳源里,670,2,742,9,751,951,3,1,3,0,1,0,78.97
高雄市,小港區,鳳源里,671,2,792,12,804,1116,3,1,3,0,1,0,72.04
高雄市,小港區,鳳林里,672,2,1417,17,1434,1964,3,1,3,0,1,0,73.01
高雄市,小港區,鳳森里,673,2,1056,12,1068,1358,3,1,3,0,1,0,78.65
高雄市,小港區,海澄里,674,2,1350,13,1363,1870,3,1,3,0,1,0,72.89
高雄市,小港區,海澄里,675,2,1227,9,1236,1833,3,1,3,0,1,0,67.43
高雄市,小港區,海昌里,676,2,1372,18,1390,1986,3,1,3,0,1,0,69.99
高雄市,小港區,海豐里,677,2,822,10,832,1185,3,1,3,0,1,0,70.21
高雄市,小港區,海豐里,678,2,653,5,658,932,3,1,3,0,1,0,70.60
高雄市,小港區,海原里,679,2,763,8,771,1134,3,1,3,0,1,0,67.99
高雄市,小港區,海原里,680,2,859,10,869,1223,3,1,3,0,1,0,71.05
高雄市,小港區,海城里,681,2,1009,16,1025,1471,3,1,3,0,1,0,69.68
高雄市,小港區,海城里,682,2,618,10,628,891,3,1,3,0,1,0,70.48
臺北縣,板橋市,留侯里,1,1,842,10,852,1239,3,1,3,0,1,0,68.77
臺北縣,板橋市,流芳里,2,1,907,10,917,1292,3,1,3,0,1,0,70.98
臺北縣,板橋市,赤松里,3,1,403,6,409,553,3,1,3,0,1,0,73.96
臺北縣,板橋市,黃石里,4,1,781,11,792,1133,3,1,3,0,1,0,69.90
臺北縣,板橋市,挹秀里,5,1,603,4,607,865,3,1,3,0,1,0,70.17
臺北縣,板橋市,挹秀里,6,1,507,5,512,779,3,1,3,0,1,0,65.73
臺北縣,板橋市,湳興里,7,1,723,16,739,1129,3,1,3,0,1,0,65.46
臺北縣,板橋市,湳興里,8,1,924,13,937,1411,3,1,3,0,1,0,66.41
臺北縣,板橋市,湳興里,9,1,906,20,926,1349,3,1,3,0,1,0,68.64
臺北縣,板橋市,新興里,10,1,906,10,916,1289,3,1,3,0,1,0,71.06
臺北縣,板橋市,新興里,11,1,788,9,797,1201,3,1,3,0,1,0,66.36
臺北縣,板橋市,社後里,12,1,721,6,727,1021,3,1,3,0,1,0,71.20
臺北縣,板橋市,社後里,13,1,886,19,905,1391,3,1,3,0,1,0,65.06
臺北縣,板橋市,社後里,14,1,724,13,737,1115,3,1,3,0,1,0,66.10
臺北縣,板橋市,社後里,15,1,626,10,636,965,3,1,3,0,1,0,65.91
臺北縣,板橋市,香社里,16,1,694,10,704,1045,3,1,3,0,1,0,67.37
臺北縣,板橋市,香社里,17,1,700,7,707,1017,3,1,3,0,1,0,69.52
臺北縣,板橋市,香社里,18,1,673,12,685,990,3,1,3,0,1,0,69.19
臺北縣,板橋市,香雅里,19,1,642,6,648,948,3,1,3,0,1,0,68.35
臺北縣,板橋市,香雅里,20,1,680,6,686,1048,3,1,3,0,1,0,65.46
臺北縣,板橋市,中正里,21,1,736,19,755,1175,3,1,3,0,1,0,64.26
臺北縣,板橋市,中正里,22,1,793,21,814,1229,3,1,3,0,1,0,66.23
臺北縣,板橋市,中正里,23,1,739,16,755,1145,3,1,3,0,1,0,65.94
臺北縣,板橋市,自強里,24,1,778,6,784,1088,3,1,3,0,1,0,72.06
臺北縣,板橋市,自強里,25,1,703,4,707,980,3,1,3,0,1,0,72.14
臺北縣,板橋市,自強里,26,1,802,11,813,1152,3,1,3,0,1,0,70.57
臺北縣,板橋市,自強里,27,1,779,8,787,1082,3,1,3,0,1,0,72.74
臺北縣,板橋市,自立里,28,1,856,7,863,1270,3,1,3,0,1,0,67.95
臺北縣,板橋市,自立里,29,1,728,8,736,1112,3,1,3,0,1,0,66.19
臺北縣,板橋市,光華里,30,1,733,9,742,1165,3,1,3,0,1,0,63.69
臺北縣,板橋市,光華里,31,1,680,4,684,943,3,1,3,0,1,0,72.53
臺北縣,板橋市,光榮里,32,1,739,10,749,1082,3,1,3,0,1,0,69.22
臺北縣,板橋市,光榮里,33,1,769,14,783,1093,3,1,3,0,1,0,71.64
臺北縣,板橋市,國光里,34,1,1836,13,1849,2442,3,1,3,0,1,0,75.72
臺北縣,板橋市,港尾里,35,1,956,9,965,1434,3,1,3,0,1,0,67.29
臺北縣,板橋市,新生里,36,1,791,13,804,1171,3,1,3,0,1,0,68.66
臺北縣,板橋市,新生里,37,1,780,15,795,1165,3,1,3,0,1,0,68.24
臺北縣,板橋市,新生里,38,1,687,6,693,1013,3,1,3,0,1,0,68.41
臺北縣,板橋市,金華里,39,1,668,12,680,1092,3,1,3,0,1,0,62.27
臺北縣,板橋市,金華里,40,1,731,13,744,1111,3,1,3,0,1,0,66.97
臺北縣,板橋市,金華里,41,1,604,9,613,888,3,1,3,0,1,0,69.03
臺北縣,板橋市,港德里,42,1,753,15,768,1132,3,1,3,0,1,0,67.84
臺北縣,板橋市,港德里,43,1,670,8,678,1055,3,1,3,0,1,0,64.27
臺北縣,板橋市,港德里,44,1,524,6,530,812,3,1,3,0,1,0,65.27
臺北縣,板橋市,港德里,45,1,599,8,607,952,3,1,3,0,1,0,63.76
臺北縣,板橋市,民權里,46,1,814,10,824,1193,3,1,3,0,1,0,69.07
臺北縣,板橋市,民權里,47,1,936,11,947,1303,3,1,3,0,1,0,72.68
臺北縣,板橋市,民安里,48,1,654,9,663,983,3,1,3,0,1,0,67.45
臺北縣,板橋市,民安里,49,1,589,5,594,832,3,1,3,0,1,0,71.39
臺北縣,板橋市,建國里,50,1,702,10,712,996,3,1,3,0,1,0,71.49
臺北縣,板橋市,建國里,51,1,693,7,700,1020,3,1,3,0,1,0,68.63
臺北縣,板橋市,建國里,52,1,727,13,740,1193,3,1,3,0,1,0,62.03
臺北縣,板橋市,漢生里,53,1,887,8,895,1299,3,1,3,0,1,0,68.90
臺北縣,板橋市,漢生里,54,1,987,6,993,1355,3,1,3,0,1,0,73.28
臺北縣,板橋市,漢生里,55,1,786,14,800,1094,3,1,3,0,1,0,73.13
臺北縣,板橋市,公舘里,56,1,575,13,588,806,3,1,3,0,1,0,72.95
臺北縣,板橋市,公舘里,57,1,626,8,634,856,3,1,3,0,1,0,74.07
臺北縣,板橋市,公舘里,58,1,943,15,958,1345,3,1,3,0,1,0,71.23
臺北縣,板橋市,新民里,59,1,805,6,811,1194,3,1,3,0,1,0,67.92
臺北縣,板橋市,新民里,60,1,799,5,804,1133,3,1,3,0,1,0,70.96
臺北縣,板橋市,新民里,61,1,907,19,926,1317,3,1,3,0,1,0,70.31
臺北縣,板橋市,幸福里,62,1,644,9,653,898,3,1,3,0,1,0,72.72
臺北縣,板橋市,幸福里,63,1,763,15,778,1150,3,1,3,0,1,0,67.65
臺北縣,板橋市,幸福里,64,1,647,4,651,971,3,1,3,0,1,0,67.04
臺北縣,板橋市,文德里,65,1,599,14,613,889,3,1,3,0,1,0,68.95
臺北縣,板橋市,文德里,66,1,618,8,626,919,3,1,3,0,1,0,68.12
臺北縣,板橋市,忠誠里,67,1,720,1,721,972,3,1,3,0,1,0,74.18
臺北縣,板橋市,忠誠里,68,1,743,4,747,981,3,1,3,0,1,0,76.15
臺北縣,板橋市,陽明里,69,1,816,5,821,1135,3,1,3,0,1,0,72.33
臺北縣,板橋市,陽明里,70,1,736,16,752,1098,3,1,3,0,1,0,68.49
臺北縣,板橋市,百壽里,71,1,678,15,693,956,3,1,3,0,1,0,72.49
臺北縣,板橋市,百壽里,72,1,703,5,708,993,3,1,3,0,1,0,71.30
臺北縣,板橋市,介壽里,73,1,736,4,740,1068,3,1,3,0,1,0,69.29
臺北縣,板橋市,介壽里,74,1,833,4,837,1268,3,1,3,0,1,0,66.01
臺北縣,板橋市,新埔里,75,1,608,12,620,919,3,1,3,0,1,0,67.46
臺北縣,板橋市,新埔里,76,1,752,9,761,1072,3,1,3,0,1,0,70.99
臺北縣,板橋市,華江里,77,1,441,9,450,721,3,1,3,0,1,0,62.41
臺北縣,板橋市,華江里,78,1,605,5,610,922,3,1,3,0,1,0,66.16
臺北縣,板橋市,華江里,79,1,699,6,705,994,3,1,3,0,1,0,70.93
臺北縣,板橋市,江翠里,80,1,741,6,747,1117,3,1,3,0,1,0,66.88
臺北縣,板橋市,江翠里,81,1,791,11,802,1198,3,1,3,0,1,0,66.94
臺北縣,板橋市,江翠里,82,1,804,6,810,1189,3,1,3,0,1,0,68.12
臺北縣,板橋市,純翠里,83,1,704,8,712,1046,3,1,3,0,1,0,68.07
臺北縣,板橋市,純翠里,84,1,745,10,755,1098,3,1,3,0,1,0,68.76
臺北縣,板橋市,純翠里,85,1,550,11,561,823,3,1,3,0,1,0,68.17
臺北縣,板橋市,溪頭里,86,1,770,7,777,1133,3,1,3,0,1,0,68.58
臺北縣,板橋市,溪頭里,87,1,488,7,495,835,3,1,3,0,1,0,59.28
臺北縣,板橋市,溪頭里,88,1,641,13,654,1055,3,1,3,0,1,0,61.99
臺北縣,板橋市,溪頭里,89,1,571,5,576,837,3,1,3,0,1,0,68.82
臺北縣,板橋市,聯翠里,90,1,593,7,600,908,3,1,3,0,1,0,66.08
臺北縣,板橋市,聯翠里,91,1,758,9,767,1135,3,1,3,0,1,0,67.58
臺北縣,板橋市,文化里,92,1,828,10,838,1218,3,1,3,0,1,0,68.80
臺北縣,板橋市,文化里,93,1,842,14,856,1268,3,1,3,0,1,0,67.51
臺北縣,板橋市,宏翠里,94,1,740,13,753,1092,3,1,3,0,1,0,68.96
臺北縣,板橋市,宏翠里,95,1,723,16,739,1074,3,1,3,0,1,0,68.81
臺北縣,板橋市,仁翠里,96,1,789,20,809,1172,3,1,3,0,1,0,69.03
臺北縣,板橋市,仁翠里,97,1,869,12,881,1270,3,1,3,0,1,0,69.37
臺北縣,板橋市,新翠里,98,1,625,13,638,975,3,1,3,0,1,0,65.44
臺北縣,板橋市,新翠里,99,1,904,12,916,1289,3,1,3,0,1,0,71.06
臺北縣,板橋市,新翠里,100,1,816,10,826,1227,3,1,3,0,1,0,67.32
臺北縣,板橋市,朝陽里,101,1,524,8,532,781,3,1,3,0,1,0,68.12
臺北縣,板橋市,朝陽里,102,1,496,4,500,743,3,1,3,0,1,0,67.29
臺北縣,板橋市,朝陽里,103,1,662,13,675,1062,3,1,3,0,1,0,63.56
臺北縣,板橋市,吉翠里,104,1,895,11,906,1311,3,1,3,0,1,0,69.11
臺北縣,板橋市,吉翠里,105,1,923,15,938,1386,3,1,3,0,1,0,67.68
臺北縣,板橋市,德翠里,106,1,778,13,791,1228,3,1,3,0,1,0,64.41
臺北縣,板橋市,德翠里,107,1,721,6,727,1104,3,1,3,0,1,0,65.85
臺北縣,板橋市,新海里,108,1,814,15,829,1319,3,1,3,0,1,0,62.85
臺北縣,板橋市,新海里,109,1,780,11,791,1279,3,1,3,0,1,0,61.85
臺北縣,板橋市,滿翠里,110,1,409,9,418,615,3,1,3,0,1,0,67.97
臺北縣,板橋市,滿翠里,111,1,489,7,496,733,3,1,3,0,1,0,67.67
臺北縣,板橋市,滿翠里,112,1,883,10,893,1287,3,1,3,0,1,0,69.39
臺北縣,板橋市,明翠里,113,1,564,6,570,883,3,1,3,0,1,0,64.55
臺北縣,板橋市,明翠里,114,1,699,11,710,1038,3,1,3,0,1,0,68.40
臺北縣,板橋市,明翠里,115,1,617,5,622,897,3,1,3,0,1,0,69.34
臺北縣,板橋市,明翠里,116,1,925,5,930,1341,3,1,3,0,1,0,69.35
臺北縣,板橋市,松翠里,117,1,850,11,861,1290,3,1,3,0,1,0,66.74
臺北縣,板橋市,松翠里,118,1,721,10,731,1155,3,1,3,0,1,0,63.29
臺北縣,板橋市,柏翠里,119,1,845,8,853,1221,3,1,3,0,1,0,69.86
臺北縣,板橋市,柏翠里,120,1,900,14,914,1336,3,1,3,0,1,0,68.41
臺北縣,板橋市,龍翠里,121,1,583,3,586,929,3,1,3,0,1,0,63.08
臺北縣,板橋市,龍翠里,122,1,691,13,704,1059,3,1,3,0,1,0,66.48
臺北縣,板橋市,龍翠里,123,1,713,7,720,1016,3,1,3,0,1,0,70.87
臺北縣,板橋市,松柏里,124,1,746,3,749,1096,3,1,3,0,1,0,68.34
臺北縣,板橋市,松柏里,125,1,584,4,588,925,3,1,3,0,1,0,63.57
臺北縣,板橋市,華翠里,126,1,746,13,759,1145,3,1,3,0,1,0,66.29
臺北縣,板橋市,華翠里,127,1,896,5,901,1293,3,1,3,0,1,0,69.68
臺北縣,板橋市,莒光里,128,1,804,8,812,1205,3,1,3,0,1,0,67.39
臺北縣,板橋市,莒光里,129,1,621,4,625,976,3,1,3,0,1,0,64.04
臺北縣,板橋市,忠翠里,130,1,649,9,658,964,3,1,3,0,1,0,68.26
臺北縣,板橋市,忠翠里,131,1,785,12,797,1148,3,1,3,0,1,0,69.43
臺北縣,板橋市,忠翠里,132,1,808,19,827,1232,3,1,3,0,1,0,67.13
臺北縣,板橋市,嵐翠里,133,1,727,11,738,1193,3,1,3,0,1,0,61.86
臺北縣,板橋市,嵐翠里,134,1,648,12,660,1002,3,1,3,0,1,0,65.87
臺北縣,板橋市,文聖里,135,1,672,11,683,969,3,1,3,0,1,0,70.49
臺北縣,板橋市,文聖里,136,1,657,11,668,1001,3,1,3,0,1,0,66.73
臺北縣,板橋市,文翠里,137,1,757,16,773,1055,3,1,3,0,1,0,73.27
臺北縣,板橋市,文翠里,138,1,606,8,614,934,3,1,3,0,1,0,65.74
臺北縣,板橋市,文翠里,139,1,599,6,605,895,3,1,3,0,1,0,67.60
臺北縣,板橋市,青翠里,140,1,809,12,821,1281,3,1,3,0,1,0,64.09
臺北縣,板橋市,青翠里,141,1,826,12,838,1308,3,1,3,0,1,0,64.07
臺北縣,板橋市,懷翠里,142,1,712,11,723,1165,3,1,3,0,1,0,62.06
臺北縣,板橋市,懷翠里,143,1,677,15,692,1045,3,1,3,0,1,0,66.22
臺北縣,板橋市,懷翠里,144,1,798,11,809,1283,3,1,3,0,1,0,63.06
臺北縣,板橋市,福翠里,145,1,517,13,530,784,3,1,3,0,1,0,67.60
臺北縣,板橋市,福翠里,146,1,659,6,665,976,3,1,3,0,1,0,68.14
臺北縣,板橋市,港嘴里,147,1,851,16,867,1198,3,1,3,0,1,0,72.37
臺北縣,板橋市,港嘴里,148,1,560,0,560,860,3,1,3,0,1,0,65.12
臺北縣,板橋市,港嘴里,149,1,787,9,796,1222,3,1,3,0,1,0,65.14
臺北縣,板橋市,港嘴里,150,1,546,9,555,867,3,1,3,0,1,0,64.01
臺北縣,板橋市,振興里,151,1,787,9,796,1160,3,1,3,0,1,0,68.62
臺北縣,板橋市,振興里,152,1,810,17,827,1132,3,1,3,0,1,0,73.06
臺北縣,板橋市,振興里,153,1,690,14,704,963,3,1,3,0,1,0,73.10
臺北縣,板橋市,振義里,154,1,721,19,740,1056,3,1,3,0,1,0,70.08
臺北縣,板橋市,振義里,155,1,678,11,689,1088,3,1,3,0,1,0,63.33
臺北縣,板橋市,振義里,156,1,607,7,614,897,3,1,3,0,1,0,68.45
臺北縣,板橋市,光復里,157,1,760,14,774,1152,3,1,3,0,1,0,67.19
臺北縣,板橋市,光復里,158,1,804,20,824,1242,3,1,3,0,1,0,66.34
臺北縣,板橋市,埔墘里,159,1,849,26,875,1275,3,1,3,0,1,0,68.63
臺北縣,板橋市,埔墘里,160,1,792,6,798,1216,3,1,3,0,1,0,65.63
臺北縣,板橋市,埔墘里,161,1,851,12,863,1291,3,1,3,0,1,0,66.85
臺北縣,板橋市,富貴里,162,1,513,7,520,818,3,1,3,0,1,0,63.57
臺北縣,板橋市,富貴里,163,1,519,4,523,758,3,1,3,0,1,0,69.00
臺北縣,板橋市,長壽里,164,1,834,21,855,1204,3,1,3,0,1,0,71.01
臺北縣,板橋市,長壽里,165,1,641,10,651,976,3,1,3,0,1,0,66.70
臺北縣,板橋市,福壽里,166,1,671,13,684,1010,3,1,3,0,1,0,67.72
臺北縣,板橋市,福壽里,167,1,692,7,699,995,3,1,3,0,1,0,70.25
臺北縣,板橋市,居仁里,168,1,725,10,735,1045,3,1,3,0,1,0,70.33
臺北縣,板橋市,居仁里,169,1,926,20,946,1294,3,1,3,0,1,0,73.11
臺北縣,板橋市,海山里,170,1,567,17,584,861,3,1,3,0,1,0,67.83
臺北縣,板橋市,海山里,171,1,549,4,553,759,3,1,3,0,1,0,72.86
臺北縣,板橋市,海山里,172,1,860,12,872,1207,3,1,3,0,1,0,72.25
臺北縣,板橋市,海山里,173,1,691,10,701,1054,3,1,3,0,1,0,66.51
臺北縣,板橋市,九如里,174,1,772,14,786,1231,3,1,3,0,1,0,63.85
臺北縣,板橋市,九如里,175,1,745,8,753,1109,3,1,3,0,1,0,67.90
臺北縣,板橋市,正泰里,176,1,775,10,785,1078,3,1,3,0,1,0,72.82
臺北縣,板橋市,正泰里,177,1,696,8,704,1046,3,1,3,0,1,0,67.30
臺北縣,板橋市,玉光里,178,1,654,4,658,977,3,1,3,0,1,0,67.35
臺北縣,板橋市,玉光里,179,1,823,14,837,1247,3,1,3,0,1,0,67.12
臺北縣,板橋市,玉光里,180,1,759,13,772,1144,3,1,3,0,1,0,67.48
臺北縣,板橋市,光仁里,181,1,842,6,848,1183,3,1,3,0,1,0,71.68
臺北縣,板橋市,光仁里,182,1,791,9,800,1158,3,1,3,0,1,0,69.08
臺北縣,板橋市,埤墘里,183,1,881,11,892,1343,3,1,3,0,1,0,66.42
臺北縣,板橋市,埤墘里,184,1,845,12,857,1287,3,1,3,0,1,0,66.59
臺北縣,板橋市,莊敬里,185,1,440,4,444,651,3,1,3,0,1,0,68.20
臺北縣,板橋市,莊敬里,186,1,477,5,482,708,3,1,3,0,1,0,68.08
臺北縣,板橋市,永安里,187,1,728,4,732,1125,3,1,3,0,1,0,65.07
臺北縣,板橋市,永安里,188,1,597,13,610,955,3,1,3,0,1,0,63.87
臺北縣,板橋市,雙玉里,189,1,698,15,713,1224,3,1,3,0,1,0,58.25
臺北縣,板橋市,雙玉里,190,1,812,16,828,1265,3,1,3,0,1,0,65.45
臺北縣,板橋市,廣新里,191,1,599,7,606,1005,3,1,3,0,1,0,60.30
臺北縣,板橋市,廣新里,192,1,609,10,619,961,3,1,3,0,1,0,64.41
臺北縣,板橋市,廣新里,193,1,612,9,621,921,3,1,3,0,1,0,67.43
臺北縣,板橋市,深丘里,194,1,714,2,716,1067,3,1,3,0,1,0,67.10
臺北縣,板橋市,深丘里,195,1,934,10,944,1316,3,1,3,0,1,0,71.73
臺北縣,板橋市,深丘里,196,1,558,5,563,850,3,1,3,0,1,0,66.24
臺北縣,板橋市,深丘里,197,1,478,1,479,682,3,1,3,0,1,0,70.23
臺北縣,板橋市,香丘里,198,1,606,11,617,891,3,1,3,0,1,0,69.25
臺北縣,板橋市,香丘里,199,1,599,8,607,839,3,1,3,0,1,0,72.35
臺北縣,板橋市,香丘里,200,1,650,8,658,959,3,1,3,0,1,0,68.61
臺北縣,板橋市,西安里,201,1,775,12,787,1143,3,1,3,0,1,0,68.85
臺北縣,板橋市,西安里,202,1,493,3,496,749,3,1,3,0,1,0,66.22
臺北縣,板橋市,東丘里,203,1,631,8,639,979,3,1,3,0,1,0,65.27
臺北縣,板橋市,東丘里,204,1,779,13,792,1150,3,1,3,0,1,0,68.87
臺北縣,板橋市,東丘里,205,1,710,13,723,1070,3,1,3,0,1,0,67.57
臺北縣,板橋市,民生里,206,1,393,7,400,656,3,1,3,0,1,0,60.98
臺北縣,板橋市,民生里,207,1,501,5,506,742,3,1,3,0,1,0,68.19
臺北縣,板橋市,長安里,208,1,765,7,772,1236,3,1,3,0,1,0,62.46
臺北縣,板橋市,長安里,209,1,838,16,854,1226,3,1,3,0,1,0,69.66
臺北縣,板橋市,東安里,210,1,622,12,634,922,3,1,3,0,1,0,68.76
臺北縣,板橋市,東安里,211,1,671,8,679,996,3,1,3,0,1,0,68.17
臺北縣,板橋市,福丘里,212,1,533,4,537,809,3,1,3,0,1,0,66.38
臺北縣,板橋市,福丘里,213,1,527,12,539,795,3,1,3,0,1,0,67.80
臺北縣,板橋市,福祿里,214,1,659,14,673,1048,3,1,3,0,1,0,64.22
臺北縣,板橋市,福祿里,215,1,921,15,936,1303,3,1,3,0,1,0,71.83
臺北縣,板橋市,民族里,216,1,745,6,751,1082,3,1,3,0,1,0,69.41
臺北縣,板橋市,民族里,217,1,767,5,772,1130,3,1,3,0,1,0,68.32
臺北縣,板橋市,民族里,218,1,646,8,654,962,3,1,3,0,1,0,67.98
臺北縣,板橋市,國泰里,219,1,747,13,760,1147,3,1,3,0,1,0,66.26
臺北縣,板橋市,國泰里,220,1,657,12,669,1028,3,1,3,0,1,0,65.08
臺北縣,板橋市,後埔里,221,1,885,7,892,1281,3,1,3,0,1,0,69.63
臺北縣,板橋市,後埔里,222,1,684,10,694,1073,3,1,3,0,1,0,64.68
臺北縣,板橋市,福德里,223,1,762,7,769,1175,3,1,3,0,1,0,65.45
臺北縣,板橋市,福德里,224,1,817,14,831,1187,3,1,3,0,1,0,70.01
臺北縣,板橋市,福德里,225,1,882,13,895,1264,3,1,3,0,1,0,70.81
臺北縣,板橋市,景星里,226,1,855,7,862,1186,3,1,3,0,1,0,72.68
臺北縣,板橋市,景星里,227,1,801,9,810,1236,3,1,3,0,1,0,65.53
臺北縣,板橋市,福星里,228,1,787,10,797,1159,3,1,3,0,1,0,68.77
臺北縣,板橋市,福星里,229,1,684,7,691,1035,3,1,3,0,1,0,66.76
臺北縣,板橋市,鄉雲里,230,1,790,16,806,1062,3,1,3,0,1,0,75.89
臺北縣,板橋市,鄉雲里,231,1,929,17,946,1311,3,1,3,0,1,0,72.16
臺北縣,板橋市,廣德里,232,1,699,11,710,1059,3,1,3,0,1,0,67.04
臺北縣,板橋市,廣德里,233,1,871,6,877,1276,3,1,3,0,1,0,68.73
臺北縣,板橋市,廣德里,234,1,1066,9,1075,1516,3,1,3,0,1,0,70.91
臺北縣,板橋市,大豐里,235,1,945,16,961,1437,3,1,3,0,1,0,66.88
臺北縣,板橋市,大豐里,236,1,640,18,658,998,3,1,3,0,1,0,65.93
臺北縣,板橋市,大豐里,237,1,737,9,746,1083,3,1,3,0,1,0,68.88
臺北縣,板橋市,重慶里,238,1,650,6,656,996,3,1,3,0,1,0,65.86
臺北縣,板橋市,重慶里,239,1,795,20,815,1130,3,1,3,0,1,0,72.12
臺北縣,板橋市,重慶里,240,1,742,14,756,1118,3,1,3,0,1,0,67.62
臺北縣,板橋市,重慶里,241,1,716,13,729,1045,3,1,3,0,1,0,69.76
臺北縣,板橋市,仁愛里,242,1,749,3,752,950,3,1,3,0,1,0,79.16
臺北縣,板橋市,仁愛里,243,1,586,7,593,870,3,1,3,0,1,0,68.16
臺北縣,板橋市,仁愛里,244,1,615,9,624,925,3,1,3,0,1,0,67.46
臺北縣,板橋市,和平里,245,1,596,12,608,880,3,1,3,0,1,0,69.09
臺北縣,板橋市,廣福里,246,1,710,14,724,1027,3,1,3,0,1,0,70.50
臺北縣,板橋市,廣福里,247,1,641,12,653,1059,3,1,3,0,1,0,61.66
臺北縣,板橋市,五權里,248,1,890,16,906,1322,3,1,3,0,1,0,68.53
臺北縣,板橋市,五權里,249,1,657,7,664,979,3,1,3,0,1,0,67.82
臺北縣,板橋市,五權里,250,1,773,4,777,1163,3,1,3,0,1,0,66.81
臺北縣,板橋市,華興里,251,1,674,8,682,1058,3,1,3,0,1,0,64.46
臺北縣,板橋市,華興里,252,1,752,9,761,1149,3,1,3,0,1,0,66.23
臺北縣,板橋市,華貴里,253,1,744,9,753,1099,3,1,3,0,1,0,68.52
臺北縣,板橋市,華貴里,254,1,809,5,814,1141,3,1,3,0,1,0,71.34
臺北縣,板橋市,華福里,255,1,571,8,579,817,3,1,3,0,1,0,70.87
臺北縣,板橋市,華福里,256,1,542,14,556,820,3,1,3,0,1,0,67.80
臺北縣,板橋市,華德里,257,1,904,22,926,1388,3,1,3,0,1,0,66.71
臺北縣,板橋市,華德里,258,1,639,6,645,1007,3,1,3,0,1,0,64.05
臺北縣,板橋市,華德里,259,1,823,9,832,1272,3,1,3,0,1,0,65.41
臺北縣,板橋市,華東里,260,1,488,7,495,688,3,1,3,0,1,0,71.95
臺北縣,板橋市,華東里,261,1,1055,12,1067,1476,3,1,3,0,1,0,72.29
臺北縣,板橋市,華東里,262,1,806,13,819,1172,3,1,3,0,1,0,69.88
臺北縣,板橋市,信義里,263,1,724,14,738,1045,3,1,3,0,1,0,70.62
臺北縣,板橋市,信義里,264,1,649,6,655,961,3,1,3,0,1,0,68.16
臺北縣,板橋市,信義里,265,1,793,20,813,1135,3,1,3,0,1,0,71.63
臺北縣,板橋市,浮洲里,266,1,746,8,754,1256,3,1,3,0,1,0,60.03
臺北縣,板橋市,浮洲里,267,1,724,14,738,1166,3,1,3,0,1,0,63.29
臺北縣,板橋市,浮洲里,268,1,516,7,523,1129,3,1,3,0,1,0,46.32
臺北縣,板橋市,華中里,269,1,794,15,809,1279,3,1,3,0,1,0,63.25
臺北縣,板橋市,華中里,270,1,643,10,653,1063,3,1,3,0,1,0,61.43
臺北縣,板橋市,華中里,271,1,782,17,799,1288,3,1,3,0,1,0,62.03
臺北縣,板橋市,僑中里,272,1,768,8,776,1138,3,1,3,0,1,0,68.19
臺北縣,板橋市,僑中里,273,1,511,10,521,727,3,1,3,0,1,0,71.66
臺北縣,板橋市,僑中里,274,1,483,7,490,686,3,1,3,0,1,0,71.43
臺北縣,板橋市,大觀里,275,1,766,15,781,1160,3,1,3,0,1,0,67.33
臺北縣,板橋市,大觀里,276,1,827,15,842,1232,3,1,3,0,1,0,68.34
臺北縣,板橋市,歡園里,277,1,731,13,744,1058,3,1,3,0,1,0,70.32
臺北縣,板橋市,中山里,278,1,620,13,633,1014,3,1,3,0,1,0,62.43
臺北縣,板橋市,中山里,279,1,568,9,577,923,3,1,3,0,1,0,62.51
臺北縣,板橋市,中山里,280,1,693,17,710,1076,3,1,3,0,1,0,65.99
臺北縣,板橋市,中山里,281,1,670,10,680,978,3,1,3,0,1,0,69.53
臺北縣,板橋市,復興里,282,1,720,19,739,949,3,1,3,0,1,0,77.87
臺北縣,板橋市,復興里,283,1,1149,41,1190,1636,3,1,3,0,1,0,72.74
臺北縣,板橋市,復興里,284,1,413,3,416,686,3,1,3,0,1,0,60.64
臺北縣,板橋市,大安里,285,1,743,13,756,1207,3,1,3,0,1,0,62.63
臺北縣,板橋市,大安里,286,1,843,11,854,1201,3,1,3,0,1,0,71.11
臺北縣,板橋市,大安里,287,1,571,7,578,887,3,1,3,0,1,0,65.16
臺北縣,板橋市,福安里,288,1,817,21,838,1263,3,1,3,0,1,0,66.35
臺北縣,板橋市,福安里,289,1,666,10,676,1073,3,1,3,0,1,0,63.00
臺北縣,板橋市,聚安里,290,1,579,8,587,949,3,1,3,0,1,0,61.85
臺北縣,板橋市,聚安里,291,1,615,11,626,946,3,1,3,0,1,0,66.17
臺北縣,板橋市,聚安里,292,1,511,12,523,822,3,1,3,0,1,0,63.63
臺北縣,板橋市,聚安里,293,1,605,9,614,968,3,1,3,0,1,0,63.43
臺北縣,板橋市,龍安里,294,1,769,12,781,1123,3,1,3,0,1,0,69.55
臺北縣,板橋市,龍安里,295,1,790,21,811,1284,3,1,3,0,1,0,63.16
臺北縣,板橋市,崑崙里,296,1,684,15,699,1005,3,1,3,0,1,0,69.55
臺北縣,板橋市,崑崙里,297,1,859,15,874,1372,3,1,3,0,1,0,63.70
臺北縣,板橋市,崑崙里,298,1,840,19,859,1288,3,1,3,0,1,0,66.69
臺北縣,板橋市,成和里,299,1,752,14,766,1263,3,1,3,0,1,0,60.65
臺北縣,板橋市,成和里,300,1,703,23,726,1072,3,1,3,0,1,0,67.72
臺北縣,板橋市,溪洲里,301,1,860,8,868,1272,3,1,3,0,1,0,68.24
臺北縣,板橋市,溪洲里,302,1,794,13,807,1256,3,1,3,0,1,0,64.25
臺北縣,板橋市,溪洲里,303,1,628,12,640,1066,3,1,3,0,1,0,60.04
臺北縣,板橋市,溪福里,304,1,775,9,784,1199,3,1,3,0,1,0,65.39
臺北縣,板橋市,溪福里,305,1,758,16,774,1188,3,1,3,0,1,0,65.15
臺北縣,板橋市,溪福里,306,1,670,15,685,1034,3,1,3,0,1,0,66.25
臺北縣,板橋市,溪北里,307,1,754,17,771,1146,3,1,3,0,1,0,67.28
臺北縣,板橋市,溪北里,308,1,793,13,806,1160,3,1,3,0,1,0,69.48
臺北縣,板橋市,堂春里,309,1,643,16,659,1084,3,1,3,0,1,0,60.79
臺北縣,板橋市,堂春里,310,1,835,14,849,1227,3,1,3,0,1,0,69.19
臺北縣,三重市,大有里,311,1,1095,16,1111,1651,3,1,3,0,1,0,67.29
臺北縣,三重市,大有里,312,1,893,16,909,1320,3,1,3,0,1,0,68.86
臺北縣,三重市,博愛里,313,1,1026,11,1037,1504,3,1,3,0,1,0,68.95
臺北縣,三重市,博愛里,314,1,973,16,989,1429,3,1,3,0,1,0,69.21
臺北縣,三重市,二重里,315,1,497,12,509,813,3,1,3,0,1,0,62.61
臺北縣,三重市,二重里,316,1,607,10,617,941,3,1,3,0,1,0,65.57
臺北縣,三重市,頂崁里,317,1,938,19,957,1456,3,1,3,0,1,0,65.73
臺北縣,三重市,谷王里,318,1,856,12,868,1233,3,1,3,0,1,0,70.40
臺北縣,三重市,五谷里,319,1,646,11,657,891,3,1,3,0,1,0,73.74
臺北縣,三重市,五谷里,320,1,677,10,687,994,3,1,3,0,1,0,69.11
臺北縣,三重市,中興里,321,1,1113,24,1137,1743,3,1,3,0,1,0,65.23
臺北縣,三重市,中興里,322,1,726,9,735,1010,3,1,3,0,1,0,72.77
臺北縣,三重市,德厚里,323,1,293,6,299,382,3,1,3,0,1,0,78.27
臺北縣,三重市,成功里,324,1,734,9,743,1174,3,1,3,0,1,0,63.29
臺北縣,三重市,成功里,325,1,734,14,748,1136,3,1,3,0,1,0,65.85
臺北縣,三重市,福祉里,326,1,949,7,956,1392,3,1,3,0,1,0,68.68
臺北縣,三重市,福祉里,327,1,837,12,849,1286,3,1,3,0,1,0,66.02
臺北縣,三重市,福德里,328,1,807,13,820,1237,3,1,3,0,1,0,66.29
臺北縣,三重市,福德里,329,1,756,7,763,1190,3,1,3,0,1,0,64.12
臺北縣,三重市,福民里,330,1,798,8,806,1168,3,1,3,0,1,0,69.01
臺北縣,三重市,福民里,331,1,881,6,887,1254,3,1,3,0,1,0,70.73
臺北縣,三重市,過田里,332,1,992,20,1012,1591,3,1,3,0,1,0,63.61
臺北縣,三重市,過田里,333,1,992,15,1007,1470,3,1,3,0,1,0,68.50
臺北縣,三重市,錦田里,334,1,553,8,561,857,3,1,3,0,1,0,65.46
臺北縣,三重市,錦田里,335,1,742,8,750,1042,3,1,3,0,1,0,71.98
臺北縣,三重市,重明里,336,1,800,12,812,1198,3,1,3,0,1,0,67.78
臺北縣,三重市,重明里,337,1,591,6,597,866,3,1,3,0,1,0,68.94
臺北縣,三重市,光田里,338,1,885,9,894,1353,3,1,3,0,1,0,66.08
臺北縣,三重市,光田里,339,1,1096,7,1103,1562,3,1,3,0,1,0,70.61
臺北縣,三重市,光陽里,340,1,1176,20,1196,1784,3,1,3,0,1,0,67.04
臺北縣,三重市,光陽里,341,1,1118,11,1129,1606,3,1,3,0,1,0,70.30
臺北縣,三重市,田心里,342,1,734,6,740,1101,3,1,3,0,1,0,67.21
臺北縣,三重市,田心里,343,1,743,5,748,1112,3,1,3,0,1,0,67.27
臺北縣,三重市,田心里,344,1,807,10,817,1236,3,1,3,0,1,0,66.10
臺北縣,三重市,福田里,345,1,776,11,787,1139,3,1,3,0,1,0,69.10
臺北縣,三重市,福田里,346,1,735,8,743,1131,3,1,3,0,1,0,65.69
臺北縣,三重市,田中里,347,1,868,9,877,1259,3,1,3,0,1,0,69.66
臺北縣,三重市,田中里,348,1,886,11,897,1326,3,1,3,0,1,0,67.65
臺北縣,三重市,田中里,349,1,861,10,871,1392,3,1,3,0,1,0,62.57
臺北縣,三重市,田安里,350,1,789,13,802,1182,3,1,3,0,1,0,67.85
臺北縣,三重市,田安里,351,1,705,12,717,1147,3,1,3,0,1,0,62.51
臺北縣,三重市,田安里,352,1,871,11,882,1304,3,1,3,0,1,0,67.64
臺北縣,三重市,三民里,353,1,742,10,752,1088,3,1,3,0,1,0,69.12
臺北縣,三重市,三民里,354,1,574,8,582,850,3,1,3,0,1,0,68.47
臺北縣,三重市,光明里,355,1,681,13,694,1064,3,1,3,0,1,0,65.23
臺北縣,三重市,光明里,356,1,732,4,736,1151,3,1,3,0,1,0,63.94
臺北縣,三重市,光明里,357,1,782,12,794,1310,3,1,3,0,1,0,60.61
臺北縣,三重市,光正里,358,1,691,10,701,1151,3,1,3,0,1,0,60.90
臺北縣,三重市,同安里,359,1,967,16,983,1570,3,1,3,0,1,0,62.61
臺北縣,三重市,同慶里,360,1,862,19,881,1429,3,1,3,0,1,0,61.65
臺北縣,三重市,菜寮里,361,1,1174,17,1191,1735,3,1,3,0,1,0,68.65
臺北縣,三重市,永春里,362,1,815,17,832,1188,3,1,3,0,1,0,70.03
臺北縣,三重市,中正里,363,1,752,12,764,1105,3,1,3,0,1,0,69.14
臺北縣,三重市,吉利里,364,1,875,20,895,1380,3,1,3,0,1,0,64.86
臺北縣,三重市,大同里,365,1,879,15,894,1368,3,1,3,0,1,0,65.35
臺北縣,三重市,中民里,366,1,819,14,833,1232,3,1,3,0,1,0,67.61
臺北縣,三重市,平和里,367,1,1049,18,1067,1545,3,1,3,0,1,0,69.06
臺北縣,三重市,大安里,368,1,864,17,881,1385,3,1,3,0,1,0,63.61
臺北縣,三重市,仁德里,369,1,591,11,602,939,3,1,3,0,1,0,64.11
臺北縣,三重市,仁德里,370,1,726,9,735,1066,3,1,3,0,1,0,68.95
臺北縣,三重市,忠孝里,371,1,1034,15,1049,1630,3,1,3,0,1,0,64.36
臺北縣,三重市,仁義里,372,1,745,14,759,1100,3,1,3,0,1,0,69.00
臺北縣,三重市,光榮里,373,1,658,11,669,1000,3,1,3,0,1,0,66.90
臺北縣,三重市,光輝里,374,1,660,7,667,923,3,1,3,0,1,0,72.26
臺北縣,三重市,光輝里,375,1,517,2,519,760,3,1,3,0,1,0,68.29
臺北縣,三重市,福星里,376,1,642,9,651,896,3,1,3,0,1,0,72.66
臺北縣,三重市,福利里,377,1,539,13,552,885,3,1,3,0,1,0,62.37
臺北縣,三重市,清和里,378,1,1021,12,1033,1542,3,1,3,0,1,0,66.99
臺北縣,三重市,永興里,379,1,485,7,492,737,3,1,3,0,1,0,66.76
臺北縣,三重市,中山里,380,1,744,11,755,1066,3,1,3,0,1,0,70.83
臺北縣,三重市,中山里,381,1,630,7,637,968,3,1,3,0,1,0,65.81
臺北縣,三重市,大園里,382,1,724,5,729,1097,3,1,3,0,1,0,66.45
臺北縣,三重市,大園里,383,1,599,8,607,950,3,1,3,0,1,0,63.89
臺北縣,三重市,國隆里,384,1,1033,10,1043,1575,3,1,3,0,1,0,66.22
臺北縣,三重市,重陽里,385,1,761,9,770,1199,3,1,3,0,1,0,64.22
臺北縣,三重市,重陽里,386,1,846,13,859,1289,3,1,3,0,1,0,66.64
臺北縣,三重市,民生里,387,1,1205,8,1213,1760,3,1,3,0,1,0,68.92
臺北縣,三重市,民生里,388,1,1155,11,1166,1663,3,1,3,0,1,0,70.11
臺北縣,三重市,重新里,389,1,1017,10,1027,1442,3,1,3,0,1,0,71.22
臺北縣,三重市,正德里,390,1,764,8,772,1105,3,1,3,0,1,0,69.86
臺北縣,三重市,正義里,391,1,854,4,858,1231,3,1,3,0,1,0,69.70
臺北縣,三重市,正安里,392,1,1072,12,1084,1618,3,1,3,0,1,0,67.00
臺北縣,三重市,自強里,393,1,995,10,1005,1518,3,1,3,0,1,0,66.21
臺北縣,三重市,文化里,394,1,834,10,844,1255,3,1,3,0,1,0,67.25
臺北縣,三重市,文化里,395,1,745,8,753,1131,3,1,3,0,1,0,66.58
臺北縣,三重市,中央里,396,1,909,14,923,1390,3,1,3,0,1,0,66.40
臺北縣,三重市,雙園里,397,1,674,15,689,1011,3,1,3,0,1,0,68.15
臺北縣,三重市,錦通里,398,1,1031,34,1065,1621,3,1,3,0,1,0,65.70
臺北縣,三重市,錦安里,399,1,591,4,595,868,3,1,3,0,1,0,68.55
臺北縣,三重市,錦安里,400,1,644,7,651,930,3,1,3,0,1,0,70.00
臺北縣,三重市,長安里,401,1,570,8,578,906,3,1,3,0,1,0,63.80
臺北縣,三重市,長安里,402,1,599,8,607,938,3,1,3,0,1,0,64.71
臺北縣,三重市,光華里,403,1,1029,17,1046,1535,3,1,3,0,1,0,68.14
臺北縣,三重市,長生里,404,1,445,4,449,694,3,1,3,0,1,0,64.70
臺北縣,三重市,開元里,405,1,1039,16,1055,1552,3,1,3,0,1,0,67.98
臺北縣,三重市,大德里,406,1,418,4,422,616,3,1,3,0,1,0,68.51
臺北縣,三重市,長元里,407,1,612,11,623,905,3,1,3,0,1,0,68.84
臺北縣,三重市,長元里,408,1,510,7,517,783,3,1,3,0,1,0,66.03
臺北縣,三重市,長江里,409,1,1012,10,1022,1555,3,1,3,0,1,0,65.72
臺北縣,三重市,長泰里,410,1,687,11,698,963,3,1,3,0,1,0,72.48
臺北縣,三重市,長泰里,411,1,602,8,610,933,3,1,3,0,1,0,65.38
臺北縣,三重市,長福里,412,1,998,14,1012,1451,3,1,3,0,1,0,69.75
臺北縣,三重市,介壽里,413,1,694,14,708,1060,3,1,3,0,1,0,66.79
臺北縣,三重市,萬壽里,414,1,935,10,945,1398,3,1,3,0,1,0,67.60
臺北縣,三重市,錦江里,415,1,756,16,772,1212,3,1,3,0,1,0,63.70
臺北縣,三重市,錦江里,416,1,657,14,671,997,3,1,3,0,1,0,67.30
臺北縣,三重市,龍濱里,417,1,877,17,894,1273,3,1,3,0,1,0,70.23
臺北縣,三重市,龍濱里,418,1,598,10,608,1027,3,1,3,0,1,0,59.20
臺北縣,三重市,龍門里,419,1,982,14,996,1519,3,1,3,0,1,0,65.57
臺北縣,三重市,秀江里,420,1,821,8,829,1176,3,1,3,0,1,0,70.49
臺北縣,三重市,奕壽里,421,1,993,11,1004,1448,3,1,3,0,1,0,69.34
臺北縣,三重市,三安里,422,1,937,13,950,1411,3,1,3,0,1,0,67.33
臺北縣,三重市,三安里,423,1,569,11,580,889,3,1,3,0,1,0,65.24
臺北縣,三重市,福安里,424,1,770,13,783,1169,3,1,3,0,1,0,66.98
臺北縣,三重市,福安里,425,1,696,12,708,1029,3,1,3,0,1,0,68.80
臺北縣,三重市,信安里,426,1,774,14,788,1125,3,1,3,0,1,0,70.04
臺北縣,三重市,安慶里,427,1,556,11,567,813,3,1,3,0,1,0,69.74
臺北縣,三重市,安慶里,428,1,642,11,653,929,3,1,3,0,1,0,70.29
臺北縣,三重市,幸福里,429,1,859,11,870,1348,3,1,3,0,1,0,64.54
臺北縣,三重市,幸福里,430,1,747,16,763,1122,3,1,3,0,1,0,68.00
臺北縣,三重市,幸福里,431,1,731,10,741,1126,3,1,3,0,1,0,65.81
臺北縣,三重市,六合里,432,1,1032,10,1042,1554,3,1,3,0,1,0,67.05
臺北縣,三重市,六合里,433,1,937,11,948,1468,3,1,3,0,1,0,64.58
臺北縣,三重市,六福里,434,1,834,14,848,1320,3,1,3,0,1,0,64.24
臺北縣,三重市,六福里,435,1,791,7,798,1112,3,1,3,0,1,0,71.76
臺北縣,三重市,六福里,436,1,771,12,783,1169,3,1,3,0,1,0,66.98
臺北縣,三重市,順德里,437,1,756,7,763,1100,3,1,3,0,1,0,69.36
臺北縣,三重市,順德里,438,1,626,5,631,934,3,1,3,0,1,0,67.56
臺北縣,三重市,承德里,439,1,567,8,575,819,3,1,3,0,1,0,70.21
臺北縣,三重市,承德里,440,1,593,7,600,866,3,1,3,0,1,0,69.28
臺北縣,三重市,瑞德里,441,1,686,9,695,977,3,1,3,0,1,0,71.14
臺北縣,三重市,瑞德里,442,1,763,13,776,1137,3,1,3,0,1,0,68.25
臺北縣,三重市,崇德里,443,1,744,11,755,1156,3,1,3,0,1,0,65.31
臺北縣,三重市,崇德里,444,1,733,11,744,1166,3,1,3,0,1,0,63.81
臺北縣,三重市,崇德里,445,1,722,10,732,1139,3,1,3,0,1,0,64.27
臺北縣,三重市,厚德里,446,1,773,9,782,1124,3,1,3,0,1,0,69.57
臺北縣,三重市,厚德里,447,1,779,11,790,1095,3,1,3,0,1,0,72.15
臺北縣,三重市,維德里,448,1,675,13,688,1099,3,1,3,0,1,0,62.60
臺北縣,三重市,維德里,449,1,735,11,746,1094,3,1,3,0,1,0,68.19
臺北縣,三重市,尚德里,450,1,930,15,945,1432,3,1,3,0,1,0,65.99
臺北縣,三重市,尚德里,451,1,838,17,855,1215,3,1,3,0,1,0,70.37
臺北縣,三重市,培德里,452,1,575,5,580,884,3,1,3,0,1,0,65.61
臺北縣,三重市,培德里,453,1,1072,12,1084,1594,3,1,3,0,1,0,68.01
臺北縣,三重市,立德里,454,1,721,5,726,1098,3,1,3,0,1,0,66.12
臺北縣,三重市,立德里,455,1,781,9,790,1197,3,1,3,0,1,0,66.00
臺北縣,三重市,永德里,456,1,764,9,773,1116,3,1,3,0,1,0,69.27
臺北縣,三重市,永德里,457,1,1145,14,1159,1704,3,1,3,0,1,0,68.02
臺北縣,三重市,永德里,458,1,753,13,766,1103,3,1,3,0,1,0,69.45
臺北縣,三重市,永煇里,459,1,723,11,734,1068,3,1,3,0,1,0,68.73
臺北縣,三重市,永煇里,460,1,586,5,591,917,3,1,3,0,1,0,64.45
臺北縣,三重市,永發里,461,1,930,14,944,1405,3,1,3,0,1,0,67.19
臺北縣,三重市,永發里,462,1,904,15,919,1371,3,1,3,0,1,0,67.03
臺北縣,三重市,永盛里,463,1,795,8,803,1135,3,1,3,0,1,0,70.75
臺北縣,三重市,永盛里,464,1,940,16,956,1419,3,1,3,0,1,0,67.37
臺北縣,三重市,永吉里,465,1,728,10,738,1141,3,1,3,0,1,0,64.68
臺北縣,三重市,永吉里,466,1,584,7,591,906,3,1,3,0,1,0,65.23
臺北縣,三重市,永安里,467,1,654,11,665,999,3,1,3,0,1,0,66.57
臺北縣,三重市,永安里,468,1,651,8,659,973,3,1,3,0,1,0,67.73
臺北縣,三重市,永豐里,469,1,905,17,922,1424,3,1,3,0,1,0,64.75
臺北縣,三重市,永豐里,470,1,981,15,996,1560,3,1,3,0,1,0,63.85
臺北縣,三重市,永福里,471,1,922,8,930,1441,3,1,3,0,1,0,64.54
臺北縣,三重市,永福里,472,1,1148,24,1172,1850,3,1,3,0,1,0,63.35
臺北縣,三重市,永清里,473,1,869,22,891,1374,3,1,3,0,1,0,64.85
臺北縣,三重市,永清里,474,1,782,11,793,1269,3,1,3,0,1,0,62.49
臺北縣,三重市,永清里,475,1,634,10,644,1085,3,1,3,0,1,0,59.35
臺北縣,三重市,永順里,476,1,939,13,952,1462,3,1,3,0,1,0,65.12
臺北縣,三重市,永順里,477,1,750,7,757,1200,3,1,3,0,1,0,63.08
臺北縣,三重市,溪美里,478,1,957,14,971,1437,3,1,3,0,1,0,67.57
臺北縣,三重市,溪美里,479,1,819,9,828,1224,3,1,3,0,1,0,67.65
臺北縣,三重市,溪美里,480,1,830,12,842,1306,3,1,3,0,1,0,64.47
臺北縣,三重市,福隆里,481,1,1167,6,1173,1876,3,1,3,0,1,0,62.53
臺北縣,三重市,福隆里,482,1,1134,13,1147,1720,3,1,3,0,1,0,66.69
臺北縣,三重市,福隆里,483,1,680,9,689,1053,3,1,3,0,1,0,65.43
臺北縣,三重市,五常里,484,1,952,23,975,1512,3,1,3,0,1,0,64.48
臺北縣,三重市,五常里,485,1,1051,14,1065,1554,3,1,3,0,1,0,68.53
臺北縣,三重市,五常里,486,1,1135,13,1148,1720,3,1,3,0,1,0,66.74
臺北縣,三重市,五福里,487,1,639,10,649,1013,3,1,3,0,1,0,64.07
臺北縣,三重市,五福里,488,1,674,14,688,1113,3,1,3,0,1,0,61.81
臺北縣,三重市,仁忠里,489,1,809,12,821,1310,3,1,3,0,1,0,62.67
臺北縣,三重市,仁忠里,490,1,763,15,778,1201,3,1,3,0,1,0,64.78
臺北縣,三重市,慈福里,491,1,461,10,471,764,3,1,3,0,1,0,61.65
臺北縣,三重市,慈福里,492,1,783,15,798,1195,3,1,3,0,1,0,66.78
臺北縣,三重市,慈生里,493,1,849,11,860,1206,3,1,3,0,1,0,71.31
臺北縣,三重市,慈生里,494,1,555,11,566,886,3,1,3,0,1,0,63.88
臺北縣,三重市,慈惠里,495,1,573,10,583,831,3,1,3,0,1,0,70.16
臺北縣,三重市,慈惠里,496,1,669,10,679,961,3,1,3,0,1,0,70.66
臺北縣,三重市,慈愛里,497,1,973,17,990,1419,3,1,3,0,1,0,69.77
臺北縣,三重市,慈愛里,498,1,1031,17,1048,1491,3,1,3,0,1,0,70.29
臺北縣,三重市,慈化里,499,1,589,6,595,866,3,1,3,0,1,0,68.71
臺北縣,三重市,慈化里,500,1,672,22,694,987,3,1,3,0,1,0,70.31
臺北縣,三重市,慈祐里,501,1,738,10,748,1131,3,1,3,0,1,0,66.14
臺北縣,三重市,慈祐里,502,1,668,22,690,1071,3,1,3,0,1,0,64.43
臺北縣,三重市,慈祐里,503,1,693,7,700,1009,3,1,3,0,1,0,69.38
臺北縣,三重市,富華里,504,1,629,12,641,968,3,1,3,0,1,0,66.22
臺北縣,三重市,富華里,505,1,725,11,736,1102,3,1,3,0,1,0,66.79
臺北縣,三重市,富貴里,506,1,755,24,779,1257,3,1,3,0,1,0,61.97
臺北縣,三重市,富貴里,507,1,644,8,652,922,3,1,3,0,1,0,70.72
臺北縣,三重市,富福里,508,1,440,8,448,708,3,1,3,0,1,0,63.28
臺北縣,三重市,富福里,509,1,603,9,612,946,3,1,3,0,1,0,64.69
臺北縣,三重市,五華里,510,1,896,17,913,1325,3,1,3,0,1,0,68.91
臺北縣,三重市,五華里,511,1,540,13,553,811,3,1,3,0,1,0,68.19
臺北縣,三重市,碧華里,512,1,709,17,726,1260,3,1,3,0,1,0,57.62
臺北縣,三重市,碧華里,513,1,967,15,982,1546,3,1,3,0,1,0,63.52
臺北縣,三重市,碧華里,514,1,828,9,837,1327,3,1,3,0,1,0,63.07
臺北縣,中和市,中原里,515,1,1169,19,1188,1902,3,1,3,0,1,0,62.46
臺北縣,中和市,中原里,516,1,434,6,440,660,3,1,3,0,1,0,66.67
臺北縣,中和市,連和里,517,1,872,9,881,1335,3,1,3,0,1,0,65.99
臺北縣,中和市,連城里,518,1,1100,16,1116,1657,3,1,3,0,1,0,67.35
臺北縣,中和市,連城里,519,1,863,4,867,1144,3,1,3,0,1,0,75.79
臺北縣,中和市,連城里,520,1,788,5,793,1163,3,1,3,0,1,0,68.19
臺北縣,中和市,力行里,521,1,779,7,786,1149,3,1,3,0,1,0,68.41
臺北縣,中和市,力行里,522,1,954,11,965,1469,3,1,3,0,1,0,65.69
臺北縣,中和市,正行里,523,1,1260,18,1278,1853,3,1,3,0,1,0,68.97
臺北縣,中和市,德行里,524,1,900,27,927,1392,3,1,3,0,1,0,66.59
臺北縣,中和市,德行里,525,1,832,9,841,1209,3,1,3,0,1,0,69.56
臺北縣,中和市,枋寮里,526,1,958,7,965,1404,3,1,3,0,1,0,68.73
臺北縣,中和市,枋寮里,527,1,950,9,959,1410,3,1,3,0,1,0,68.01
臺北縣,中和市,漳和里,528,1,853,16,869,1232,3,1,3,0,1,0,70.54
臺北縣,中和市,漳和里,529,1,941,13,954,1391,3,1,3,0,1,0,68.58
臺北縣,中和市,廟美里,530,1,922,11,933,1300,3,1,3,0,1,0,71.77
臺北縣,中和市,廟美里,531,1,993,8,1001,1402,3,1,3,0,1,0,71.40
臺北縣,中和市,廟美里,532,1,600,8,608,907,3,1,3,0,1,0,67.03
臺北縣,中和市,福真里,533,1,973,23,996,1519,3,1,3,0,1,0,65.57
臺北縣,中和市,福真里,534,1,986,15,1001,1514,3,1,3,0,1,0,66.12
臺北縣,中和市,福善里,535,1,1180,18,1198,1792,3,1,3,0,1,0,66.85
臺北縣,中和市,福善里,536,1,850,9,859,1243,3,1,3,0,1,0,69.11
臺北縣,中和市,福美里,537,1,1193,15,1208,1624,3,1,3,0,1,0,74.38
臺北縣,中和市,福美里,538,1,722,10,732,1100,3,1,3,0,1,0,66.55
臺北縣,中和市,福美里,539,1,738,19,757,1074,3,1,3,0,1,0,70.48
臺北縣,中和市,福祥里,540,1,935,23,958,1406,3,1,3,0,1,0,68.14
臺北縣,中和市,福祥里,541,1,1101,24,1125,1628,3,1,3,0,1,0,69.10
臺北縣,中和市,瓦窯里,542,1,617,18,635,962,3,1,3,0,1,0,66.01
臺北縣,中和市,瓦窯里,543,1,920,12,932,1366,3,1,3,0,1,0,68.23
臺北縣,中和市,瓦窯里,544,1,962,8,970,1411,3,1,3,0,1,0,68.75
臺北縣,中和市,福和里,545,1,970,12,982,1414,3,1,3,0,1,0,69.45
臺北縣,中和市,福和里,546,1,1107,16,1123,1587,3,1,3,0,1,0,70.76
臺北縣,中和市,佳和里,547,1,1227,25,1252,1867,3,1,3,0,1,0,67.06
臺北縣,中和市,佳和里,548,1,1240,14,1254,1786,3,1,3,0,1,0,70.21
臺北縣,中和市,新南里,549,1,1154,13,1167,1796,3,1,3,0,1,0,64.98
臺北縣,中和市,新南里,550,1,1087,13,1100,1597,3,1,3,0,1,0,68.88
臺北縣,中和市,南山里,551,1,893,12,905,1248,3,1,3,0,1,0,72.52
臺北縣,中和市,南山里,552,1,1192,11,1203,1696,3,1,3,0,1,0,70.93
臺北縣,中和市,宜安里,553,1,1031,10,1041,1571,3,1,3,0,1,0,66.26
臺北縣,中和市,安樂里,554,1,785,6,791,1114,3,1,3,0,1,0,71.01
臺北縣,中和市,安樂里,555,1,891,15,906,1259,3,1,3,0,1,0,71.96
臺北縣,中和市,安和里,556,1,578,6,584,819,3,1,3,0,1,0,71.31
臺北縣,中和市,安和里,557,1,751,11,762,1101,3,1,3,0,1,0,69.21
臺北縣,中和市,安順里,558,1,850,13,863,1302,3,1,3,0,1,0,66.28
臺北縣,中和市,安順里,559,1,979,11,990,1412,3,1,3,0,1,0,70.11
臺北縣,中和市,安平里,560,1,844,8,852,1195,3,1,3,0,1,0,71.30
臺北縣,中和市,安平里,561,1,792,10,802,1135,3,1,3,0,1,0,70.66
臺北縣,中和市,安平里,562,1,1004,12,1016,1544,3,1,3,0,1,0,65.80
臺北縣,中和市,中安里,563,1,965,13,978,1412,3,1,3,0,1,0,69.26
臺北縣,中和市,中安里,564,1,827,3,830,1266,3,1,3,0,1,0,65.56
臺北縣,中和市,泰安里,565,1,695,13,708,1024,3,1,3,0,1,0,69.14
臺北縣,中和市,泰安里,566,1,656,11,667,976,3,1,3,0,1,0,68.34
臺北縣,中和市,泰安里,567,1,837,11,848,1247,3,1,3,0,1,0,68.00
臺北縣,中和市,秀山里,568,1,1128,9,1137,1596,3,1,3,0,1,0,71.24
臺北縣,中和市,秀山里,569,1,1047,16,1063,1607,3,1,3,0,1,0,66.15
臺北縣,中和市,秀成里,570,1,1026,20,1046,1517,3,1,3,0,1,0,68.95
臺北縣,中和市,秀成里,571,1,876,6,882,1290,3,1,3,0,1,0,68.37
臺北縣,中和市,秀義里,572,1,789,21,810,1198,3,1,3,0,1,0,67.61
臺北縣,中和市,秀義里,573,1,731,15,746,1027,3,1,3,0,1,0,72.64
臺北縣,中和市,秀福里,574,1,934,12,946,1386,3,1,3,0,1,0,68.25
臺北縣,中和市,秀福里,575,1,769,7,776,1127,3,1,3,0,1,0,68.86
臺北縣,中和市,秀福里,576,1,693,5,698,1022,3,1,3,0,1,0,68.30
臺北縣,中和市,秀景里,577,1,951,17,968,1475,3,1,3,0,1,0,65.63
臺北縣,中和市,秀景里,578,1,653,9,662,960,3,1,3,0,1,0,68.96
臺北縣,中和市,秀景里,579,1,781,12,793,1120,3,1,3,0,1,0,70.80
臺北縣,中和市,秀明里,580,1,905,9,914,1294,3,1,3,0,1,0,70.63
臺北縣,中和市,秀明里,581,1,1089,17,1106,1630,3,1,3,0,1,0,67.85
臺北縣,中和市,秀峰里,582,1,742,4,746,1001,3,1,3,0,1,0,74.53
臺北縣,中和市,秀峰里,583,1,683,9,692,1026,3,1,3,0,1,0,67.45
臺北縣,中和市,秀士里,584,1,726,12,738,1116,3,1,3,0,1,0,66.13
臺北縣,中和市,秀士里,585,1,713,8,721,1043,3,1,3,0,1,0,69.13
臺北縣,中和市,秀水里,586,1,853,12,865,1248,3,1,3,0,1,0,69.31
臺北縣,中和市,秀水里,587,1,651,6,657,985,3,1,3,0,1,0,66.70
臺北縣,中和市,秀水里,588,1,976,18,994,1443,3,1,3,0,1,0,68.88
臺北縣,中和市,秀仁里,589,1,1070,10,1080,1535,3,1,3,0,1,0,70.36
臺北縣,中和市,秀仁里,590,1,571,10,581,837,3,1,3,0,1,0,69.41
臺北縣,中和市,正南里,591,1,963,20,983,1509,3,1,3,0,1,0,65.14
臺北縣,中和市,正南里,592,1,1155,21,1176,1769,3,1,3,0,1,0,66.48
臺北縣,中和市,頂南里,593,1,1119,19,1138,1687,3,1,3,0,1,0,67.46
臺北縣,中和市,頂南里,594,1,484,4,488,715,3,1,3,0,1,0,68.25
臺北縣,中和市,華新里,595,1,975,16,991,1527,3,1,3,0,1,0,64.90
臺北縣,中和市,華新里,596,1,885,14,899,1368,3,1,3,0,1,0,65.72
臺北縣,中和市,東南里,597,1,851,11,862,1132,3,1,3,0,1,0,76.15
臺北縣,中和市,東南里,598,1,1047,19,1066,1623,3,1,3,0,1,0,65.68
臺北縣,中和市,東南里,599,1,1052,10,1062,1487,3,1,3,0,1,0,71.42
臺北縣,中和市,華南里,600,1,1021,26,1047,1505,3,1,3,0,1,0,69.57
臺北縣,中和市,華南里,601,1,922,21,943,1393,3,1,3,0,1,0,67.70
臺北縣,中和市,忠孝里,602,1,537,13,550,914,3,1,3,0,1,0,60.18
臺北縣,中和市,忠孝里,603,1,627,6,633,955,3,1,3,0,1,0,66.28
臺北縣,中和市,忠孝里,604,1,663,12,675,1001,3,1,3,0,1,0,67.43
臺北縣,中和市,忠孝里,605,1,908,11,919,1429,3,1,3,0,1,0,64.31
臺北縣,中和市,崇南里,606,1,463,7,470,729,3,1,3,0,1,0,64.47
臺北縣,中和市,崇南里,607,1,870,5,875,1194,3,1,3,0,1,0,73.28
臺北縣,中和市,興南里,608,1,1021,13,1034,1517,3,1,3,0,1,0,68.16
臺北縣,中和市,興南里,609,1,1100,20,1120,1688,3,1,3,0,1,0,66.35
臺北縣,中和市,景南里,610,1,894,12,906,1280,3,1,3,0,1,0,70.78
臺北縣,中和市,景南里,611,1,991,10,1001,1491,3,1,3,0,1,0,67.14
臺北縣,中和市,景本里,612,1,625,7,632,915,3,1,3,0,1,0,69.07
臺北縣,中和市,景本里,613,1,725,6,731,1023,3,1,3,0,1,0,71.46
臺北縣,中和市,橫路里,614,1,167,1,168,232,3,1,3,0,1,0,72.41
臺北縣,中和市,內南里,615,1,734,12,746,1099,3,1,3,0,1,0,67.88
臺北縣,中和市,內南里,616,1,1119,20,1139,1659,3,1,3,0,1,0,68.66
臺北縣,中和市,內南里,617,1,891,12,903,1382,3,1,3,0,1,0,65.34
臺北縣,中和市,壽南里,618,1,894,10,904,1289,3,1,3,0,1,0,70.13
臺北縣,中和市,壽南里,619,1,637,16,653,985,3,1,3,0,1,0,66.29
臺北縣,中和市,福南里,620,1,998,18,1016,1619,3,1,3,0,1,0,62.75
臺北縣,中和市,福南里,621,1,849,7,856,1264,3,1,3,0,1,0,67.72
臺北縣,中和市,外南里,622,1,1226,17,1243,1816,3,1,3,0,1,0,68.45
臺北縣,中和市,外南里,623,1,538,10,548,778,3,1,3,0,1,0,70.44
臺北縣,中和市,中興里,624,1,709,8,717,1037,3,1,3,0,1,0,69.14
臺北縣,中和市,中興里,625,1,1104,10,1114,1608,3,1,3,0,1,0,69.28
臺北縣,中和市,吉興里,626,1,612,8,620,956,3,1,3,0,1,0,64.85
臺北縣,中和市,吉興里,627,1,617,14,631,1002,3,1,3,0,1,0,62.97
臺北縣,中和市,復興里,628,1,1142,17,1159,1673,3,1,3,0,1,0,69.28
臺北縣,中和市,復興里,629,1,887,13,900,1352,3,1,3,0,1,0,66.57
臺北縣,中和市,復興里,630,1,1031,13,1044,1523,3,1,3,0,1,0,68.55
臺北縣,中和市,和興里,631,1,762,9,771,1120,3,1,3,0,1,0,68.84
臺北縣,中和市,和興里,632,1,1131,27,1158,1692,3,1,3,0,1,0,68.44
臺北縣,中和市,景平里,633,1,1139,12,1151,1730,3,1,3,0,1,0,66.53
臺北縣,中和市,景平里,634,1,1014,14,1028,1606,3,1,3,0,1,0,64.01
臺北縣,中和市,景新里,635,1,1076,16,1092,1736,3,1,3,0,1,0,62.90
臺北縣,中和市,景新里,636,1,887,17,904,1352,3,1,3,0,1,0,66.86
臺北縣,中和市,景福里,637,1,1064,19,1083,1600,3,1,3,0,1,0,67.69
臺北縣,中和市,景福里,638,1,841,15,856,1267,3,1,3,0,1,0,67.56
臺北縣,中和市,景福里,639,1,900,26,926,1439,3,1,3,0,1,0,64.35
臺北縣,中和市,景安里,640,1,397,6,403,545,3,1,3,0,1,0,73.94
臺北縣,中和市,景安里,641,1,579,10,589,814,3,1,3,0,1,0,72.36
臺北縣,中和市,景安里,642,1,893,9,902,1362,3,1,3,0,1,0,66.23
臺北縣,中和市,景安里,643,1,849,16,865,1253,3,1,3,0,1,0,69.03
臺北縣,中和市,景文里,644,1,745,10,755,1087,3,1,3,0,1,0,69.46
臺北縣,中和市,景文里,645,1,727,15,742,1105,3,1,3,0,1,0,67.15
臺北縣,中和市,平河里,646,1,1095,19,1114,1668,3,1,3,0,1,0,66.79
臺北縣,中和市,平河里,647,1,892,14,906,1352,3,1,3,0,1,0,67.01
臺北縣,中和市,信和里,648,1,943,13,956,1375,3,1,3,0,1,0,69.53
臺北縣,中和市,信和里,649,1,998,20,1018,1512,3,1,3,0,1,0,67.33
臺北縣,中和市,仁和里,650,1,1312,18,1330,2010,3,1,3,0,1,0,66.17
臺北縣,中和市,仁和里,651,1,1007,12,1019,1398,3,1,3,0,1,0,72.89
臺北縣,中和市,中正里,652,1,897,16,913,1389,3,1,3,0,1,0,65.73
臺北縣,中和市,中正里,653,1,1123,15,1138,1641,3,1,3,0,1,0,69.35
臺北縣,中和市,中山里,654,1,1167,11,1178,1846,3,1,3,0,1,0,63.81
臺北縣,中和市,建和里,655,1,1079,22,1101,1669,3,1,3,0,1,0,65.97
臺北縣,中和市,建和里,656,1,1263,12,1275,1675,3,1,3,0,1,0,76.12
臺北縣,中和市,碧河里,657,1,600,2,602,925,3,1,3,0,1,0,65.08
臺北縣,中和市,碧河里,658,1,854,9,863,1253,3,1,3,0,1,0,68.87
臺北縣,中和市,錦和里,659,1,881,8,889,1253,3,1,3,0,1,0,70.95
臺北縣,中和市,錦和里,660,1,579,1,580,872,3,1,3,0,1,0,66.51
臺北縣,中和市,錦中里,661,1,744,12,756,1118,3,1,3,0,1,0,67.62
臺北縣,中和市,錦中里,662,1,1061,15,1076,1582,3,1,3,0,1,0,68.02
臺北縣,中和市,錦昌里,663,1,997,11,1008,1441,3,1,3,0,1,0,69.95
臺北縣,中和市,錦盛里,664,1,853,7,860,1313,3,1,3,0,1,0,65.50
臺北縣,中和市,錦盛里,665,1,898,11,909,1343,3,1,3,0,1,0,67.68
臺北縣,中和市,灰窯里,666,1,320,5,325,466,3,1,3,0,1,0,69.74
臺北縣,中和市,積穗里,667,1,903,15,918,1454,3,1,3,0,1,0,63.14
臺北縣,中和市,積穗里,668,1,421,7,428,652,3,1,3,0,1,0,65.64
臺北縣,中和市,積穗里,669,1,901,6,907,1310,3,1,3,0,1,0,69.24
臺北縣,中和市,民享里,670,1,741,12,753,997,3,1,3,0,1,0,75.53
臺北縣,中和市,民享里,671,1,751,6,757,999,3,1,3,0,1,0,75.78
臺北縣,中和市,民有里,672,1,991,8,999,1409,3,1,3,0,1,0,70.90
臺北縣,中和市,民有里,673,1,797,10,807,1152,3,1,3,0,1,0,70.05
臺北縣,中和市,員山里,674,1,924,12,936,1327,3,1,3,0,1,0,70.54
臺北縣,中和市,員山里,675,1,1009,16,1025,1534,3,1,3,0,1,0,66.82
臺北縣,中和市,員富里,676,1,375,5,380,581,3,1,3,0,1,0,65.40
臺北縣,中和市,員富里,677,1,869,15,884,1355,3,1,3,0,1,0,65.24
臺北縣,中和市,嘉穗里,678,1,771,12,783,1128,3,1,3,0,1,0,69.41
臺北縣,中和市,嘉穗里,679,1,628,8,636,990,3,1,3,0,1,0,64.24
臺北縣,中和市,嘉慶里,680,1,858,14,872,1394,3,1,3,0,1,0,62.55
臺北縣,中和市,嘉慶里,681,1,809,14,823,1331,3,1,3,0,1,0,61.83
臺北縣,中和市,文元里,682,1,762,11,773,1223,3,1,3,0,1,0,63.21
臺北縣,中和市,文元里,683,1,720,6,726,1031,3,1,3,0,1,0,70.42
臺北縣,中和市,文元里,684,1,1193,16,1209,1779,3,1,3,0,1,0,67.96
臺北縣,中和市,嘉新里,685,1,831,11,842,1282,3,1,3,0,1,0,65.68
臺北縣,中和市,嘉新里,686,1,874,15,889,1341,3,1,3,0,1,0,66.29
臺北縣,中和市,民安里,687,1,1236,20,1256,1893,3,1,3,0,1,0,66.35
臺北縣,中和市,民安里,688,1,1048,11,1059,1602,3,1,3,0,1,0,66.10
臺北縣,中和市,安穗里,689,1,878,12,890,1335,3,1,3,0,1,0,66.67
臺北縣,中和市,安穗里,690,1,872,15,887,1421,3,1,3,0,1,0,62.42
臺北縣,中和市,瑞穗里,691,1,645,7,652,885,3,1,3,0,1,0,73.67
臺北縣,中和市,瑞穗里,692,1,666,5,671,931,3,1,3,0,1,0,72.07
臺北縣,中和市,冠穗里,693,1,984,19,1003,1483,3,1,3,0,1,0,67.63
臺北縣,中和市,冠穗里,694,1,885,12,897,1265,3,1,3,0,1,0,70.91
臺北縣,中和市,明穗里,695,1,976,22,998,1394,3,1,3,0,1,0,71.59
臺北縣,中和市,明穗里,696,1,1138,16,1154,1645,3,1,3,0,1,0,70.15
臺北縣,中和市,清穗里,697,1,1064,15,1079,1577,3,1,3,0,1,0,68.42
臺北縣,中和市,清穗里,698,1,533,10,543,757,3,1,3,0,1,0,71.73
臺北縣,中和市,自強里,699,1,1106,17,1123,1638,3,1,3,0,1,0,68.56
臺北縣,中和市,自強里,700,1,1188,22,1210,1748,3,1,3,0,1,0,69.22
臺北縣,中和市,德穗里,701,1,996,9,1005,1390,3,1,3,0,1,0,72.30
臺北縣,中和市,德穗里,702,1,797,15,812,1185,3,1,3,0,1,0,68.52
臺北縣,中和市,德穗里,703,1,946,13,959,1287,3,1,3,0,1,0,74.51
臺北縣,中和市,民生里,704,1,778,12,790,1139,3,1,3,0,1,0,69.36
臺北縣,中和市,民生里,705,1,916,10,926,1285,3,1,3,0,1,0,72.06
臺北縣,中和市,國光里,706,1,755,11,766,1100,3,1,3,0,1,0,69.64
臺北縣,中和市,國光里,707,1,900,7,907,1343,3,1,3,0,1,0,67.54
臺北縣,中和市,國華里,708,1,655,5,660,944,3,1,3,0,1,0,69.92
臺北縣,中和市,國華里,709,1,643,10,653,962,3,1,3,0,1,0,67.88
臺北縣,中和市,壽德里,710,1,1018,14,1032,1520,3,1,3,0,1,0,67.89
臺北縣,中和市,明德里,711,1,963,18,981,1451,3,1,3,0,1,0,67.61
臺北縣,中和市,明德里,712,1,1002,15,1017,1471,3,1,3,0,1,0,69.14
臺北縣,永和市,光復里,713,1,1142,16,1158,1640,3,1,3,0,1,0,70.61
臺北縣,永和市,網溪里,714,1,752,11,763,1147,3,1,3,0,1,0,66.52
臺北縣,永和市,復興里,715,1,641,8,649,1004,3,1,3,0,1,0,64.64
臺北縣,永和市,復興里,716,1,749,6,755,1107,3,1,3,0,1,0,68.20
臺北縣,永和市,竹林里,717,1,1150,11,1161,1726,3,1,3,0,1,0,67.27
臺北縣,永和市,竹林里,718,1,1140,19,1159,1703,3,1,3,0,1,0,68.06
臺北縣,永和市,桂林里,719,1,1103,16,1119,1563,3,1,3,0,1,0,71.59
臺北縣,永和市,桂林里,720,1,892,17,909,1373,3,1,3,0,1,0,66.21
臺北縣,永和市,上林里,721,1,1106,9,1115,1635,3,1,3,0,1,0,68.20
臺北縣,永和市,上林里,722,1,1143,13,1156,1716,3,1,3,0,1,0,67.37
臺北縣,永和市,福林里,723,1,1107,10,1117,1599,3,1,3,0,1,0,69.86
臺北縣,永和市,福林里,724,1,1044,11,1055,1587,3,1,3,0,1,0,66.48
臺北縣,永和市,勵行里,725,1,871,15,886,1245,3,1,3,0,1,0,71.16
臺北縣,永和市,中興里,726,1,1057,8,1065,1543,3,1,3,0,1,0,69.02
臺北縣,永和市,中興里,727,1,903,14,917,1360,3,1,3,0,1,0,67.43
臺北縣,永和市,永興里,728,1,1084,11,1095,1650,3,1,3,0,1,0,66.36
臺北縣,永和市,永興里,729,1,1039,25,1064,1618,3,1,3,0,1,0,65.76
臺北縣,永和市,正興里,730,1,724,10,734,1107,3,1,3,0,1,0,66.31
臺北縣,永和市,正興里,731,1,594,5,599,887,3,1,3,0,1,0,67.53
臺北縣,永和市,豫溪里,732,1,930,20,950,1505,3,1,3,0,1,0,63.12
臺北縣,永和市,豫溪里,733,1,971,14,985,1449,3,1,3,0,1,0,67.98
臺北縣,永和市,光明里,734,1,858,7,865,1247,3,1,3,0,1,0,69.37
臺北縣,永和市,光明里,735,1,847,8,855,1288,3,1,3,0,1,0,66.38
臺北縣,永和市,福和里,736,1,705,8,713,1103,3,1,3,0,1,0,64.64
臺北縣,永和市,福和里,737,1,899,12,911,1354,3,1,3,0,1,0,67.28
臺北縣,永和市,福和里,738,1,800,9,809,1165,3,1,3,0,1,0,69.44
臺北縣,永和市,得和里,739,1,761,9,770,1084,3,1,3,0,1,0,71.03
臺北縣,永和市,得和里,740,1,813,5,818,1174,3,1,3,0,1,0,69.68
臺北縣,永和市,得和里,741,1,825,9,834,1131,3,1,3,0,1,0,73.74
臺北縣,永和市,永貞里,742,1,1093,6,1099,1608,3,1,3,0,1,0,68.35
臺北縣,永和市,永貞里,743,1,1070,13,1083,1510,3,1,3,0,1,0,71.72
臺北縣,永和市,永福里,744,1,948,12,960,1351,3,1,3,0,1,0,71.06
臺北縣,永和市,永福里,745,1,902,9,911,1271,3,1,3,0,1,0,71.68
臺北縣,永和市,河濱里,746,1,915,16,931,1332,3,1,3,0,1,0,69.89
臺北縣,永和市,河濱里,747,1,858,10,868,1278,3,1,3,0,1,0,67.92
臺北縣,永和市,秀和里,748,1,1129,16,1145,1645,3,1,3,0,1,0,69.60
臺北縣,永和市,秀和里,749,1,1162,9,1171,1732,3,1,3,0,1,0,67.61
臺北縣,永和市,永元里,750,1,905,8,913,1261,3,1,3,0,1,0,72.40
臺北縣,永和市,永元里,751,1,844,13,857,1237,3,1,3,0,1,0,69.28
臺北縣,永和市,永元里,752,1,954,17,971,1377,3,1,3,0,1,0,70.52
臺北縣,永和市,民權里,753,1,1111,9,1120,1563,3,1,3,0,1,0,71.66
臺北縣,永和市,民權里,754,1,1040,13,1053,1452,3,1,3,0,1,0,72.52
臺北縣,永和市,民族里,755,1,779,9,788,1180,3,1,3,0,1,0,66.78
臺北縣,永和市,民族里,756,1,878,9,887,1236,3,1,3,0,1,0,71.76
臺北縣,永和市,民族里,757,1,907,6,913,1219,3,1,3,0,1,0,74.90
臺北縣,永和市,秀朗里,758,1,999,21,1020,1504,3,1,3,0,1,0,67.82
臺北縣,永和市,秀朗里,759,1,1070,18,1088,1643,3,1,3,0,1,0,66.22
臺北縣,永和市,秀成里,760,1,730,9,739,1066,3,1,3,0,1,0,69.32
臺北縣,永和市,秀成里,761,1,916,11,927,1355,3,1,3,0,1,0,68.41
臺北縣,永和市,秀林里,762,1,1043,11,1054,1495,3,1,3,0,1,0,70.50
臺北縣,永和市,秀林里,763,1,963,10,973,1410,3,1,3,0,1,0,69.01
臺北縣,永和市,秀得里,764,1,1059,13,1072,1522,3,1,3,0,1,0,70.43
臺北縣,永和市,秀得里,765,1,1051,11,1062,1523,3,1,3,0,1,0,69.73
臺北縣,永和市,秀得里,766,1,1092,14,1106,1620,3,1,3,0,1,0,68.27
臺北縣,永和市,民生里,767,1,806,7,813,1164,3,1,3,0,1,0,69.85
臺北縣,永和市,民生里,768,1,961,7,968,1357,3,1,3,0,1,0,71.33
臺北縣,永和市,民生里,769,1,720,11,731,1041,3,1,3,0,1,0,70.22
臺北縣,永和市,民本里,770,1,1188,17,1205,1703,3,1,3,0,1,0,70.76
臺北縣,永和市,民本里,771,1,1009,13,1022,1496,3,1,3,0,1,0,68.32
臺北縣,永和市,民本里,772,1,932,14,946,1389,3,1,3,0,1,0,68.11
臺北縣,永和市,民樂里,773,1,1179,14,1193,1670,3,1,3,0,1,0,71.44
臺北縣,永和市,民樂里,774,1,1079,16,1095,1569,3,1,3,0,1,0,69.79
臺北縣,永和市,民治里,775,1,837,12,849,1215,3,1,3,0,1,0,69.88
臺北縣,永和市,民治里,776,1,765,15,780,1183,3,1,3,0,1,0,65.93
臺北縣,永和市,智光里,777,1,1090,12,1102,1660,3,1,3,0,1,0,66.39
臺北縣,永和市,智光里,778,1,1131,19,1150,1638,3,1,3,0,1,0,70.21
臺北縣,永和市,潭安里,779,1,614,12,626,958,3,1,3,0,1,0,65.34
臺北縣,永和市,潭安里,780,1,1029,8,1037,1507,3,1,3,0,1,0,68.81
臺北縣,永和市,潭安里,781,1,718,5,723,1096,3,1,3,0,1,0,65.97
臺北縣,永和市,潭墘里,782,1,748,9,757,1100,3,1,3,0,1,0,68.82
臺北縣,永和市,潭墘里,783,1,822,14,836,1200,3,1,3,0,1,0,69.67
臺北縣,永和市,潭墘里,784,1,777,11,788,1193,3,1,3,0,1,0,66.05
臺北縣,永和市,店街里,785,1,938,14,952,1440,3,1,3,0,1,0,66.11
臺北縣,永和市,店街里,786,1,960,8,968,1437,3,1,3,0,1,0,67.36
臺北縣,永和市,大新里,787,1,577,7,584,887,3,1,3,0,1,0,65.84
臺北縣,永和市,大新里,788,1,624,2,626,974,3,1,3,0,1,0,64.27
臺北縣,永和市,永安里,789,1,862,5,867,1229,3,1,3,0,1,0,70.55
臺北縣,永和市,永安里,790,1,819,10,829,1194,3,1,3,0,1,0,69.43
臺北縣,永和市,永安里,791,1,936,9,945,1424,3,1,3,0,1,0,66.36
臺北縣,永和市,水源里,792,1,1242,15,1257,1809,3,1,3,0,1,0,69.49
臺北縣,永和市,水源里,793,1,926,14,940,1339,3,1,3,0,1,0,70.20
臺北縣,永和市,協和里,794,1,903,12,915,1395,3,1,3,0,1,0,65.59
臺北縣,永和市,協和里,795,1,918,16,934,1368,3,1,3,0,1,0,68.27
臺北縣,永和市,雙和里,796,1,848,7,855,1308,3,1,3,0,1,0,65.37
臺北縣,永和市,雙和里,797,1,966,13,979,1321,3,1,3,0,1,0,74.11
臺北縣,永和市,安和里,798,1,833,14,847,1261,3,1,3,0,1,0,67.17
臺北縣,永和市,安和里,799,1,1043,16,1059,1492,3,1,3,0,1,0,70.98
臺北縣,永和市,前溪里,800,1,1203,16,1219,1727,3,1,3,0,1,0,70.58
臺北縣,永和市,和平里,801,1,1101,14,1115,1662,3,1,3,0,1,0,67.09
臺北縣,永和市,和平里,802,1,1109,13,1122,1663,3,1,3,0,1,0,67.47
臺北縣,永和市,保平里,803,1,1098,12,1110,1573,3,1,3,0,1,0,70.57
臺北縣,永和市,保平里,804,1,1232,6,1238,1745,3,1,3,0,1,0,70.95
臺北縣,永和市,中溪里,805,1,1137,10,1147,1637,3,1,3,0,1,0,70.07
臺北縣,永和市,中溪里,806,1,1110,17,1127,1687,3,1,3,0,1,0,66.80
臺北縣,永和市,保安里,807,1,1173,13,1186,1768,3,1,3,0,1,0,67.08
臺北縣,永和市,保安里,808,1,783,9,792,1153,3,1,3,0,1,0,68.69
臺北縣,永和市,保安里,809,1,900,8,908,1378,3,1,3,0,1,0,65.89
臺北縣,永和市,下溪里,810,1,1031,15,1046,1493,3,1,3,0,1,0,70.06
臺北縣,永和市,下溪里,811,1,886,13,899,1348,3,1,3,0,1,0,66.69
臺北縣,永和市,大同里,812,1,808,27,835,1055,3,1,3,0,1,0,79.15
臺北縣,永和市,新生里,813,1,640,18,658,855,3,1,3,0,1,0,76.96
臺北縣,永和市,永成里,814,1,750,18,768,1034,3,1,3,0,1,0,74.27
臺北縣,永和市,忠義里,815,1,586,9,595,789,3,1,3,0,1,0,75.41
臺北縣,永和市,文化里,816,1,805,15,820,1161,3,1,3,0,1,0,70.63
臺北縣,永和市,文化里,817,1,978,13,991,1384,3,1,3,0,1,0,71.60
臺北縣,永和市,仁愛里,818,1,641,6,647,967,3,1,3,0,1,0,66.91
臺北縣,永和市,仁愛里,819,1,736,12,748,1154,3,1,3,0,1,0,64.82
臺北縣,永和市,信義里,820,1,647,8,655,983,3,1,3,0,1,0,66.63
臺北縣,永和市,信義里,821,1,652,7,659,938,3,1,3,0,1,0,70.26
臺北縣,永和市,後溪里,822,1,1001,13,1014,1531,3,1,3,0,1,0,66.23
臺北縣,永和市,上溪里,823,1,524,22,546,812,3,1,3,0,1,0,67.24
臺北縣,永和市,上溪里,824,1,735,8,743,1083,3,1,3,0,1,0,68.61
臺北縣,永和市,頂溪里,825,1,690,8,698,989,3,1,3,0,1,0,70.58
臺北縣,永和市,頂溪里,826,1,804,7,811,1162,3,1,3,0,1,0,69.79
臺北縣,永和市,河堤里,827,1,612,9,621,866,3,1,3,0,1,0,71.71
臺北縣,永和市,河堤里,828,1,659,2,661,931,3,1,3,0,1,0,71.00
臺北縣,永和市,新廍里,829,1,695,8,703,1027,3,1,3,0,1,0,68.45
臺北縣,永和市,新廍里,830,1,903,12,915,1264,3,1,3,0,1,0,72.39
臺北縣,新莊市,海山里,831,1,741,5,746,1119,3,1,3,0,1,0,66.67
臺北縣,新莊市,海山里,832,1,955,12,967,1438,3,1,3,0,1,0,67.25
臺北縣,新莊市,海山里,833,1,1016,13,1029,1535,3,1,3,0,1,0,67.04
臺北縣,新莊市,全安里,834,1,1071,14,1085,1499,3,1,3,0,1,0,72.38
臺北縣,新莊市,全安里,835,1,942,10,952,1464,3,1,3,0,1,0,65.03
臺北縣,新莊市,忠孝里,836,1,760,6,766,1144,3,1,3,0,1,0,66.96
臺北縣,新莊市,忠孝里,837,1,788,8,796,1179,3,1,3,0,1,0,67.51
臺北縣,新莊市,忠孝里,838,1,788,9,797,1169,3,1,3,0,1,0,68.18
臺北縣,新莊市,文衡里,839,1,1019,10,1029,1437,3,1,3,0,1,0,71.61
臺北縣,新莊市,文聖里,840,1,1140,10,1150,1652,3,1,3,0,1,0,69.61
臺北縣,新莊市,文聖里,841,1,942,9,951,1442,3,1,3,0,1,0,65.95
臺北縣,新莊市,興漢里,842,1,675,6,681,966,3,1,3,0,1,0,70.50
臺北縣,新莊市,興漢里,843,1,655,5,660,964,3,1,3,0,1,0,68.46
臺北縣,新莊市,興漢里,844,1,615,12,627,911,3,1,3,0,1,0,68.83
臺北縣,新莊市,榮和里,845,1,871,13,884,1314,3,1,3,0,1,0,67.28
臺北縣,新莊市,榮和里,846,1,959,10,969,1354,3,1,3,0,1,0,71.57
臺北縣,新莊市,文明里,847,1,1007,12,1019,1448,3,1,3,0,1,0,70.37
臺北縣,新莊市,文德里,848,1,739,5,744,1083,3,1,3,0,1,0,68.70
臺北縣,新莊市,全泰里,849,1,749,7,756,1151,3,1,3,0,1,0,65.68
臺北縣,新莊市,全泰里,850,1,722,4,726,1072,3,1,3,0,1,0,67.72
臺北縣,新莊市,全泰里,851,1,802,8,810,1181,3,1,3,0,1,0,68.59
臺北縣,新莊市,思賢里,852,1,943,13,956,1373,3,1,3,0,1,0,69.63
臺北縣,新莊市,思賢里,853,1,733,9,742,1156,3,1,3,0,1,0,64.19
臺北縣,新莊市,思源里,854,1,659,9,668,1067,3,1,3,0,1,0,62.61
臺北縣,新莊市,思源里,855,1,784,13,797,1232,3,1,3,0,1,0,64.69
臺北縣,新莊市,思源里,856,1,770,11,781,1181,3,1,3,0,1,0,66.13
臺北縣,新莊市,自立里,857,1,939,10,949,1381,3,1,3,0,1,0,68.72
臺北縣,新莊市,自立里,858,1,679,15,694,1078,3,1,3,0,1,0,64.38
臺北縣,新莊市,自立里,859,1,706,11,717,1098,3,1,3,0,1,0,65.30
臺北縣,新莊市,自強里,860,1,804,15,819,1191,3,1,3,0,1,0,68.77
臺北縣,新莊市,自強里,861,1,780,12,792,1204,3,1,3,0,1,0,65.78
臺北縣,新莊市,仁愛里,862,1,670,7,677,1117,3,1,3,0,1,0,60.61
臺北縣,新莊市,仁愛里,863,1,735,10,745,1136,3,1,3,0,1,0,65.58
臺北縣,新莊市,仁義里,864,1,752,10,762,1216,3,1,3,0,1,0,62.66
臺北縣,新莊市,仁義里,865,1,718,22,740,1177,3,1,3,0,1,0,62.87
臺北縣,新莊市,信義里,866,1,686,13,699,1109,3,1,3,0,1,0,63.03
臺北縣,新莊市,信義里,867,1,608,9,617,972,3,1,3,0,1,0,63.48
臺北縣,新莊市,信義里,868,1,643,10,653,1153,3,1,3,0,1,0,56.63
臺北縣,新莊市,幸福里,869,1,653,6,659,1102,3,1,3,0,1,0,59.80
臺北縣,新莊市,幸福里,870,1,739,14,753,1171,3,1,3,0,1,0,64.30
臺北縣,新莊市,幸福里,871,1,677,14,691,1136,3,1,3,0,1,0,60.83
臺北縣,新莊市,昌明里,872,1,800,14,814,1153,3,1,3,0,1,0,70.60
臺北縣,新莊市,昌明里,873,1,1165,22,1187,1875,3,1,3,0,1,0,63.31
臺北縣,新莊市,昌平里,874,1,360,6,366,561,3,1,3,0,1,0,65.24
臺北縣,新莊市,昌平里,875,1,777,12,789,1317,3,1,3,0,1,0,59.91
臺北縣,新莊市,和平里,876,1,867,9,876,1448,3,1,3,0,1,0,60.50
臺北縣,新莊市,和平里,877,1,928,21,949,1472,3,1,3,0,1,0,64.47
臺北縣,新莊市,自信里,878,1,939,15,954,1478,3,1,3,0,1,0,64.55
臺北縣,新莊市,化成里,879,1,641,10,651,996,3,1,3,0,1,0,65.36
臺北縣,新莊市,化成里,880,1,687,10,697,1002,3,1,3,0,1,0,69.56
臺北縣,新莊市,頭前里,881,1,957,14,971,1414,3,1,3,0,1,0,68.67
臺北縣,新莊市,頭前里,882,1,992,21,1013,1529,3,1,3,0,1,0,66.25
臺北縣,新莊市,福基里,883,1,752,14,766,1087,3,1,3,0,1,0,70.47
臺北縣,新莊市,福基里,884,1,629,11,640,920,3,1,3,0,1,0,69.57
臺北縣,新莊市,福基里,885,1,895,22,917,1373,3,1,3,0,1,0,66.79
臺北縣,新莊市,恆安里,886,1,693,7,700,1073,3,1,3,0,1,0,65.24
臺北縣,新莊市,恆安里,887,1,768,7,775,1137,3,1,3,0,1,0,68.16
臺北縣,新莊市,恆安里,888,1,739,9,748,1133,3,1,3,0,1,0,66.02
臺北縣,新莊市,立人里,889,1,1097,15,1112,1574,3,1,3,0,1,0,70.65
臺北縣,新莊市,中美里,890,1,826,9,835,1224,3,1,3,0,1,0,68.22
臺北縣,新莊市,中美里,891,1,849,12,861,1367,3,1,3,0,1,0,62.98
臺北縣,新莊市,中美里,892,1,903,9,912,1371,3,1,3,0,1,0,66.52
臺北縣,新莊市,中華里,893,1,731,12,743,1139,3,1,3,0,1,0,65.23
臺北縣,新莊市,中隆里,894,1,959,15,974,1531,3,1,3,0,1,0,63.62
臺北縣,新莊市,中原里,895,1,489,10,499,709,3,1,3,0,1,0,70.38
臺北縣,新莊市,中原里,896,1,832,15,847,1270,3,1,3,0,1,0,66.69
臺北縣,新莊市,中原里,897,1,916,20,936,1499,3,1,3,0,1,0,62.44
臺北縣,新莊市,中信里,898,1,717,13,730,1131,3,1,3,0,1,0,64.54
臺北縣,新莊市,中信里,899,1,1049,7,1056,1656,3,1,3,0,1,0,63.77
臺北縣,新莊市,中信里,900,1,769,6,775,1206,3,1,3,0,1,0,64.26
臺北縣,新莊市,中港里,901,1,660,15,675,1119,3,1,3,0,1,0,60.32
臺北縣,新莊市,中港里,902,1,670,18,688,1138,3,1,3,0,1,0,60.46
臺北縣,新莊市,中港里,903,1,820,6,826,1339,3,1,3,0,1,0,61.69
臺北縣,新莊市,中誠里,904,1,1009,21,1030,1626,3,1,3,0,1,0,63.35
臺北縣,新莊市,中泰里,905,1,838,13,851,1260,3,1,3,0,1,0,67.54
臺北縣,新莊市,中泰里,906,1,824,10,834,1323,3,1,3,0,1,0,63.04
臺北縣,新莊市,中泰里,907,1,795,12,807,1257,3,1,3,0,1,0,64.20
臺北縣,新莊市,中宏里,908,1,488,6,494,780,3,1,3,0,1,0,63.33
臺北縣,新莊市,中宏里,909,1,607,9,616,968,3,1,3,0,1,0,63.64
臺北縣,新莊市,中全里,910,1,740,10,750,1193,3,1,3,0,1,0,62.87
臺北縣,新莊市,中全里,911,1,779,8,787,1259,3,1,3,0,1,0,62.51
臺北縣,新莊市,中和里,912,1,747,18,765,1188,3,1,3,0,1,0,64.39
臺北縣,新莊市,中和里,913,1,725,8,733,1099,3,1,3,0,1,0,66.70
臺北縣,新莊市,中和里,914,1,826,16,842,1219,3,1,3,0,1,0,69.07
臺北縣,新莊市,立志里,915,1,916,8,924,1393,3,1,3,0,1,0,66.33
臺北縣,新莊市,立志里,916,1,933,5,938,1466,3,1,3,0,1,0,63.98
臺北縣,新莊市,立基里,917,1,875,6,881,1421,3,1,3,0,1,0,62.00
臺北縣,新莊市,立基里,918,1,658,9,667,1032,3,1,3,0,1,0,64.63
臺北縣,新莊市,立基里,919,1,914,7,921,1377,3,1,3,0,1,0,66.88
臺北縣,新莊市,立功里,920,1,906,13,919,1480,3,1,3,0,1,0,62.09
臺北縣,新莊市,立功里,921,1,977,14,991,1537,3,1,3,0,1,0,64.48
臺北縣,新莊市,立泰里,922,1,916,10,926,1372,3,1,3,0,1,0,67.49
臺北縣,新莊市,立泰里,923,1,855,16,871,1294,3,1,3,0,1,0,67.31
臺北縣,新莊市,立德里,924,1,702,9,711,1045,3,1,3,0,1,0,68.04
臺北縣,新莊市,立德里,925,1,548,3,551,866,3,1,3,0,1,0,63.63
臺北縣,新莊市,立言里,926,1,682,5,687,1056,3,1,3,0,1,0,65.06
臺北縣,新莊市,立言里,927,1,940,12,952,1375,3,1,3,0,1,0,69.24
臺北縣,新莊市,立言里,928,1,568,10,578,926,3,1,3,0,1,0,62.42
臺北縣,新莊市,豐年里,929,1,994,17,1011,1532,3,1,3,0,1,0,65.99
臺北縣,新莊市,豐年里,930,1,755,18,773,1203,3,1,3,0,1,0,64.26
臺北縣,新莊市,豐年里,931,1,814,14,828,1302,3,1,3,0,1,0,63.59
臺北縣,新莊市,國泰里,932,1,1002,18,1020,1436,3,1,3,0,1,0,71.03
臺北縣,新莊市,營盤里,933,1,581,9,590,1131,3,1,3,0,1,0,52.17
臺北縣,新莊市,營盤里,934,1,652,8,660,1015,3,1,3,0,1,0,65.02
臺北縣,新莊市,福營里,935,1,662,9,671,959,3,1,3,0,1,0,69.97
臺北縣,新莊市,福營里,936,1,660,8,668,938,3,1,3,0,1,0,71.22
臺北縣,新莊市,富國里,937,1,643,8,651,1097,3,1,3,0,1,0,59.34
臺北縣,新莊市,富國里,938,1,741,9,750,1236,3,1,3,0,1,0,60.68
臺北縣,新莊市,富國里,939,1,825,13,838,1274,3,1,3,0,1,0,65.78
臺北縣,新莊市,瓊林里,940,1,776,12,788,1132,3,1,3,0,1,0,69.61
臺北縣,新莊市,瓊林里,941,1,689,15,704,1073,3,1,3,0,1,0,65.61
臺北縣,新莊市,瓊林里,942,1,745,11,756,1168,3,1,3,0,1,0,64.73
臺北縣,新莊市,瓊林里,943,1,636,5,641,926,3,1,3,0,1,0,69.22
臺北縣,新莊市,丹鳳里,944,1,906,22,928,1477,3,1,3,0,1,0,62.83
臺北縣,新莊市,丹鳳里,945,1,938,13,951,1535,3,1,3,0,1,0,61.95
臺北縣,新莊市,合鳳里,946,1,1029,14,1043,1609,3,1,3,0,1,0,64.82
臺北縣,新莊市,合鳳里,947,1,1047,18,1065,1615,3,1,3,0,1,0,65.94
臺北縣,新莊市,合鳳里,948,1,699,10,709,1134,3,1,3,0,1,0,62.52
臺北縣,新莊市,雙鳳里,949,1,791,14,805,1258,3,1,3,0,1,0,63.99
臺北縣,新莊市,雙鳳里,950,1,998,5,1003,1534,3,1,3,0,1,0,65.38
臺北縣,新莊市,龍鳳里,951,1,201,0,201,222,3,1,3,0,1,0,90.54
臺北縣,新莊市,龍鳳里,952,1,759,7,766,1242,3,1,3,0,1,0,61.67
臺北縣,新莊市,龍鳳里,953,1,757,11,768,1237,3,1,3,0,1,0,62.09
臺北縣,新莊市,龍鳳里,954,1,587,9,596,1039,3,1,3,0,1,0,57.36
臺北縣,新莊市,裕民里,955,1,695,7,702,1173,3,1,3,0,1,0,59.85
臺北縣,新莊市,裕民里,956,1,809,24,833,1372,3,1,3,0,1,0,60.71
臺北縣,新莊市,裕民里,957,1,851,14,865,1295,3,1,3,0,1,0,66.80
臺北縣,新莊市,龍安里,958,1,497,2,499,741,3,1,3,0,1,0,67.34
臺北縣,新莊市,龍安里,959,1,521,5,526,825,3,1,3,0,1,0,63.76
臺北縣,新莊市,南港里,960,1,797,7,804,1268,3,1,3,0,1,0,63.41
臺北縣,新莊市,南港里,961,1,909,8,917,1462,3,1,3,0,1,0,62.72
臺北縣,新莊市,四維里,962,1,911,16,927,1582,3,1,3,0,1,0,58.60
臺北縣,新莊市,四維里,963,1,952,13,965,1576,3,1,3,0,1,0,61.23
臺北縣,新莊市,後港里,964,1,664,10,674,1117,3,1,3,0,1,0,60.34
臺北縣,新莊市,後港里,965,1,663,5,668,1056,3,1,3,0,1,0,63.26
臺北縣,新莊市,後港里,966,1,620,6,626,1106,3,1,3,0,1,0,56.60
臺北縣,新莊市,後德里,967,1,543,4,547,880,3,1,3,0,1,0,62.16
臺北縣,新莊市,後德里,968,1,574,5,579,889,3,1,3,0,1,0,65.13
臺北縣,新莊市,萬安里,969,1,711,14,725,1182,3,1,3,0,1,0,61.34
臺北縣,新莊市,萬安里,970,1,679,9,688,1102,3,1,3,0,1,0,62.43
臺北縣,新莊市,建福里,971,1,554,9,563,814,3,1,3,0,1,0,69.16
臺北縣,新莊市,建福里,972,1,561,2,563,885,3,1,3,0,1,0,63.62
臺北縣,新莊市,八德里,973,1,610,6,616,1014,3,1,3,0,1,0,60.75
臺北縣,新莊市,八德里,974,1,704,5,709,1110,3,1,3,0,1,0,63.87
臺北縣,新莊市,建安里,975,1,779,13,792,1313,3,1,3,0,1,0,60.32
臺北縣,新莊市,建安里,976,1,622,6,628,1003,3,1,3,0,1,0,62.61
臺北縣,新莊市,民本里,977,1,805,6,811,1313,3,1,3,0,1,0,61.77
臺北縣,新莊市,民本里,978,1,689,10,699,1135,3,1,3,0,1,0,61.59
臺北縣,新莊市,民本里,979,1,741,13,754,1293,3,1,3,0,1,0,58.31
臺北縣,新莊市,民安里,980,1,767,10,777,1210,3,1,3,0,1,0,64.21
臺北縣,新莊市,民安里,981,1,954,17,971,1563,3,1,3,0,1,0,62.12
臺北縣,新莊市,民安里,982,1,857,11,868,1342,3,1,3,0,1,0,64.68
臺北縣,新莊市,成德里,983,1,643,13,656,1033,3,1,3,0,1,0,63.50
臺北縣,新莊市,成德里,984,1,779,10,789,1277,3,1,3,0,1,0,61.79
臺北縣,新莊市,光明里,985,1,573,6,579,914,3,1,3,0,1,0,63.35
臺北縣,新莊市,光明里,986,1,634,11,645,1043,3,1,3,0,1,0,61.84
臺北縣,新莊市,光華里,987,1,836,10,846,1398,3,1,3,0,1,0,60.52
臺北縣,新莊市,光華里,988,1,851,12,863,1463,3,1,3,0,1,0,58.99
臺北縣,新莊市,光榮里,989,1,819,9,828,1234,3,1,3,0,1,0,67.10
臺北縣,新莊市,光榮里,990,1,732,6,738,1148,3,1,3,0,1,0,64.29
臺北縣,新莊市,光榮里,991,1,768,18,786,1222,3,1,3,0,1,0,64.32
臺北縣,新莊市,光榮里,992,1,745,8,753,1210,3,1,3,0,1,0,62.23
臺北縣,新莊市,西盛里,993,1,669,7,676,1076,3,1,3,0,1,0,62.83
臺北縣,新莊市,西盛里,994,1,804,10,814,1398,3,1,3,0,1,0,58.23
臺北縣,新莊市,西盛里,995,1,627,6,633,951,3,1,3,0,1,0,66.56
臺北縣,新店市,新店里,996,1,935,19,954,1339,3,1,3,0,1,0,71.25
臺北縣,新店市,張南里,997,1,758,14,772,1095,3,1,3,0,1,0,70.50
臺北縣,新店市,國校里,998,1,578,7,585,872,3,1,3,0,1,0,67.09
臺北縣,新店市,國校里,999,1,679,10,689,1118,3,1,3,0,1,0,61.63
臺北縣,新店市,文中里,1000,1,812,8,820,1259,3,1,3,0,1,0,65.13
臺北縣,新店市,廣明里,1001,1,587,11,598,882,3,1,3,0,1,0,67.80
臺北縣,新店市,文明里,1002,1,820,7,827,1101,3,1,3,0,1,0,75.11
臺北縣,新店市,文明里,1003,1,738,7,745,1057,3,1,3,0,1,0,70.48
臺北縣,新店市,中興里,1004,1,954,7,961,1354,3,1,3,0,1,0,70.97
臺北縣,新店市,中興里,1005,1,842,6,848,1250,3,1,3,0,1,0,67.84
臺北縣,新店市,中興里,1006,1,849,10,859,1327,3,1,3,0,1,0,64.73
臺北縣,新店市,新生里,1007,1,1079,20,1099,1567,3,1,3,0,1,0,70.13
臺北縣,新店市,新生里,1008,1,988,10,998,1384,3,1,3,0,1,0,72.11
臺北縣,新店市,新生里,1009,1,716,8,724,992,3,1,3,0,1,0,72.98
臺北縣,新店市,新德里,1010,1,867,12,879,1259,3,1,3,0,1,0,69.82
臺北縣,新店市,新德里,1011,1,856,12,868,1230,3,1,3,0,1,0,70.57
臺北縣,新店市,張北里,1012,1,898,7,905,1340,3,1,3,0,1,0,67.54
臺北縣,新店市,張北里,1013,1,861,13,874,1234,3,1,3,0,1,0,70.83
臺北縣,新店市,張北里,1014,1,933,15,948,1443,3,1,3,0,1,0,65.70
臺北縣,新店市,張北里,1015,1,869,13,882,1324,3,1,3,0,1,0,66.62
臺北縣,新店市,五峰里,1016,1,770,4,774,1068,3,1,3,0,1,0,72.47
臺北縣,新店市,五峰里,1017,1,941,5,946,1432,3,1,3,0,1,0,66.06
臺北縣,新店市,五峰里,1018,1,800,9,809,1251,3,1,3,0,1,0,64.67
臺北縣,新店市,五峰里,1019,1,843,6,849,1327,3,1,3,0,1,0,63.98
臺北縣,新店市,五峰里,1020,1,520,4,524,766,3,1,3,0,1,0,68.41
臺北縣,新店市,新安里,1021,1,637,4,641,1000,3,1,3,0,1,0,64.10
臺北縣,新店市,新安里,1022,1,707,7,714,1078,3,1,3,0,1,0,66.23
臺北縣,新店市,新安里,1023,1,675,16,691,1007,3,1,3,0,1,0,68.62
臺北縣,新店市,忠誠里,1024,1,686,4,690,1015,3,1,3,0,1,0,67.98
臺北縣,新店市,忠誠里,1025,1,739,3,742,1098,3,1,3,0,1,0,67.58
臺北縣,新店市,中正里,1026,1,923,11,934,1299,3,1,3,0,1,0,71.90
臺北縣,新店市,中正里,1027,1,804,5,809,1184,3,1,3,0,1,0,68.33
臺北縣,新店市,中正里,1028,1,1043,11,1054,1596,3,1,3,0,1,0,66.04
臺北縣,新店市,中正里,1029,1,943,7,950,1372,3,1,3,0,1,0,69.24
臺北縣,新店市,中華里,1030,1,828,8,836,1238,3,1,3,0,1,0,67.53
臺北縣,新店市,中華里,1031,1,830,13,843,1253,3,1,3,0,1,0,67.28
臺北縣,新店市,中華里,1032,1,696,9,705,1047,3,1,3,0,1,0,67.34
臺北縣,新店市,仁愛里,1033,1,762,8,770,1183,3,1,3,0,1,0,65.09
臺北縣,新店市,仁愛里,1034,1,684,12,696,1011,3,1,3,0,1,0,68.84
臺北縣,新店市,仁愛里,1035,1,892,11,903,1324,3,1,3,0,1,0,68.20
臺北縣,新店市,仁愛里,1036,1,1020,13,1033,1578,3,1,3,0,1,0,65.46
臺北縣,新店市,百忍里,1037,1,728,8,736,1057,3,1,3,0,1,0,69.63
臺北縣,新店市,百忍里,1038,1,789,6,795,1116,3,1,3,0,1,0,71.24
臺北縣,新店市,百忍里,1039,1,906,4,910,1386,3,1,3,0,1,0,65.66
臺北縣,新店市,百和里,1040,1,765,9,774,1153,3,1,3,0,1,0,67.13
臺北縣,新店市,百和里,1041,1,785,11,796,1235,3,1,3,0,1,0,64.45
臺北縣,新店市,福德里,1042,1,957,15,972,1386,3,1,3,0,1,0,70.13
臺北縣,新店市,福德里,1043,1,601,1,602,865,3,1,3,0,1,0,69.60
臺北縣,新店市,福德里,1044,1,645,7,652,990,3,1,3,0,1,0,65.86
臺北縣,新店市,百福里,1045,1,833,8,841,1197,3,1,3,0,1,0,70.26
臺北縣,新店市,百福里,1046,1,895,11,906,1309,3,1,3,0,1,0,69.21
臺北縣,新店市,福民里,1047,1,962,13,975,1373,3,1,3,0,1,0,71.01
臺北縣,新店市,福民里,1048,1,920,9,929,1443,3,1,3,0,1,0,64.38
臺北縣,新店市,中山里,1049,1,518,9,527,842,3,1,3,0,1,0,62.59
臺北縣,新店市,中山里,1050,1,347,6,353,517,3,1,3,0,1,0,68.28
臺北縣,新店市,和平里,1051,1,635,13,648,863,3,1,3,0,1,0,75.09
臺北縣,新店市,中央里,1052,1,803,6,809,1220,3,1,3,0,1,0,66.31
臺北縣,新店市,中央里,1053,1,837,8,845,1278,3,1,3,0,1,0,66.12
臺北縣,新店市,國豐里,1054,1,775,7,782,1139,3,1,3,0,1,0,68.66
臺北縣,新店市,國豐里,1055,1,695,9,704,1091,3,1,3,0,1,0,64.53
臺北縣,新店市,國豐里,1056,1,725,8,733,1084,3,1,3,0,1,0,67.62
臺北縣,新店市,明德里,1057,1,729,8,737,1126,3,1,3,0,1,0,65.45
臺北縣,新店市,明德里,1058,1,840,9,849,1217,3,1,3,0,1,0,69.76
臺北縣,新店市,明德里,1059,1,692,4,696,1048,3,1,3,0,1,0,66.41
臺北縣,新店市,大豐里,1060,1,898,10,908,1332,3,1,3,0,1,0,68.17
臺北縣,新店市,大豐里,1061,1,1131,8,1139,1569,3,1,3,0,1,0,72.59
臺北縣,新店市,大同里,1062,1,1157,9,1166,1605,3,1,3,0,1,0,72.65
臺北縣,新店市,大同里,1063,1,1068,9,1077,1585,3,1,3,0,1,0,67.95
臺北縣,新店市,江陵里,1064,1,901,14,915,1410,3,1,3,0,1,0,64.89
臺北縣,新店市,江陵里,1065,1,1232,16,1248,1812,3,1,3,0,1,0,68.87
臺北縣,新店市,江陵里,1066,1,917,15,932,1388,3,1,3,0,1,0,67.15
臺北縣,新店市,江陵里,1067,1,743,19,762,1188,3,1,3,0,1,0,64.14
臺北縣,新店市,寶興里,1068,1,1106,15,1121,1674,3,1,3,0,1,0,66.97
臺北縣,新店市,寶興里,1069,1,1004,17,1021,1463,3,1,3,0,1,0,69.79
臺北縣,新店市,寶福里,1070,1,672,7,679,1055,3,1,3,0,1,0,64.36
臺北縣,新店市,寶福里,1071,1,1001,16,1017,1465,3,1,3,0,1,0,69.42
臺北縣,新店市,寶福里,1072,1,852,8,860,1228,3,1,3,0,1,0,70.03
臺北縣,新店市,寶安里,1073,1,985,12,997,1493,3,1,3,0,1,0,66.78
臺北縣,新店市,寶安里,1074,1,1052,11,1063,1530,3,1,3,0,1,0,69.48
臺北縣,新店市,寶安里,1075,1,837,6,843,1261,3,1,3,0,1,0,66.85
臺北縣,新店市,信義里,1076,1,863,6,869,1302,3,1,3,0,1,0,66.74
臺北縣,新店市,信義里,1077,1,991,12,1003,1513,3,1,3,0,1,0,66.29
臺北縣,新店市,信義里,1078,1,978,19,997,1458,3,1,3,0,1,0,68.38
臺北縣,新店市,忠孝里,1079,1,768,11,779,1144,3,1,3,0,1,0,68.09
臺北縣,新店市,忠孝里,1080,1,603,7,610,850,3,1,3,0,1,0,71.76
臺北縣,新店市,大鵬里,1081,1,319,6,325,524,3,1,3,0,1,0,62.02
臺北縣,新店市,太平里,1082,1,1152,19,1171,1690,3,1,3,0,1,0,69.29
臺北縣,新店市,太平里,1083,1,794,9,803,1132,3,1,3,0,1,0,70.94
臺北縣,新店市,太平里,1084,1,808,7,815,1206,3,1,3,0,1,0,67.58
臺北縣,新店市,頂城里,1085,1,888,23,911,1484,3,1,3,0,1,0,61.39
臺北縣,新店市,下城里,1086,1,1114,21,1135,1704,3,1,3,0,1,0,66.61
臺北縣,新店市,柴埕里,1087,1,1157,27,1184,1722,3,1,3,0,1,0,68.76
臺北縣,新店市,柴埕里,1088,1,996,16,1012,1531,3,1,3,0,1,0,66.10
臺北縣,新店市,安和里,1089,1,684,15,699,996,3,1,3,0,1,0,70.18
臺北縣,新店市,安和里,1090,1,774,8,782,1182,3,1,3,0,1,0,66.16
臺北縣,新店市,安和里,1091,1,780,10,790,1235,3,1,3,0,1,0,63.97
臺北縣,新店市,永安里,1092,1,1086,21,1107,1691,3,1,3,0,1,0,65.46
臺北縣,新店市,永安里,1093,1,861,15,876,1271,3,1,3,0,1,0,68.92
臺北縣,新店市,永安里,1094,1,599,14,613,974,3,1,3,0,1,0,62.94
臺北縣,新店市,永安里,1095,1,1019,11,1030,1579,3,1,3,0,1,0,65.23
臺北縣,新店市,永安里,1096,1,603,9,612,876,3,1,3,0,1,0,69.86
臺北縣,新店市,永安里,1097,1,730,8,738,1148,3,1,3,0,1,0,64.29
臺北縣,新店市,公崙里,1098,1,755,15,770,1177,3,1,3,0,1,0,65.42
臺北縣,新店市,公崙里,1099,1,1028,11,1039,1490,3,1,3,0,1,0,69.73
臺北縣,新店市,公崙里,1100,1,1094,11,1105,1823,3,1,3,0,1,0,60.61
臺北縣,新店市,公崙里,1101,1,824,12,836,1270,3,1,3,0,1,0,65.83
臺北縣,新店市,德安里,1102,1,827,15,842,1265,3,1,3,0,1,0,66.56
臺北縣,新店市,德安里,1103,1,721,7,728,1012,3,1,3,0,1,0,71.94
臺北縣,新店市,德安里,1104,1,809,18,827,1279,3,1,3,0,1,0,64.66
臺北縣,新店市,明城里,1105,1,758,6,764,1084,3,1,3,0,1,0,70.48
臺北縣,新店市,明城里,1106,1,1095,10,1105,1628,3,1,3,0,1,0,67.87
臺北縣,新店市,明城里,1107,1,766,4,770,1131,3,1,3,0,1,0,68.08
臺北縣,新店市,明城里,1108,1,574,5,579,834,3,1,3,0,1,0,69.42
臺北縣,新店市,雙城里,1109,1,598,5,603,902,3,1,3,0,1,0,66.85
臺北縣,新店市,雙城里,1110,1,567,8,575,804,3,1,3,0,1,0,71.52
臺北縣,新店市,雙城里,1111,1,801,15,816,1225,3,1,3,0,1,0,66.61
臺北縣,新店市,雙城里,1112,1,965,9,974,1517,3,1,3,0,1,0,64.21
臺北縣,新店市,雙城里,1113,1,636,10,646,1037,3,1,3,0,1,0,62.30
臺北縣,新店市,日興里,1114,1,1006,17,1023,1498,3,1,3,0,1,0,68.29
臺北縣,新店市,日興里,1115,1,735,13,748,1141,3,1,3,0,1,0,65.56
臺北縣,新店市,日興里,1116,1,671,7,678,1028,3,1,3,0,1,0,65.95
臺北縣,新店市,玫瑰里,1117,1,931,8,939,1423,3,1,3,0,1,0,65.99
臺北縣,新店市,玫瑰里,1118,1,809,11,820,1174,3,1,3,0,1,0,69.85
臺北縣,新店市,玫瑰里,1119,1,728,4,732,1089,3,1,3,0,1,0,67.22
臺北縣,新店市,吉祥里,1120,1,1141,9,1150,1738,3,1,3,0,1,0,66.17
臺北縣,新店市,吉祥里,1121,1,925,5,930,1351,3,1,3,0,1,0,68.84
臺北縣,新店市,塗潭里,1122,1,425,8,433,680,3,1,3,0,1,0,63.68
臺北縣,新店市,塗潭里,1123,1,230,1,231,378,3,1,3,0,1,0,61.11
臺北縣,新店市,青潭里,1124,1,1090,16,1106,1660,3,1,3,0,1,0,66.63
臺北縣,新店市,青潭里,1125,1,710,10,720,1050,3,1,3,0,1,0,68.57
臺北縣,新店市,美潭里,1126,1,1278,21,1299,1802,3,1,3,0,1,0,72.09
臺北縣,新店市,美潭里,1127,1,786,14,800,1165,3,1,3,0,1,0,68.67
臺北縣,新店市,員潭里,1128,1,640,8,648,944,3,1,3,0,1,0,68.64
臺北縣,新店市,員潭里,1129,1,611,16,627,1017,3,1,3,0,1,0,61.65
臺北縣,新店市,雙坑里,1130,1,485,5,490,790,3,1,3,0,1,0,62.03
臺北縣,新店市,粗坑里,1131,1,253,6,259,342,3,1,3,0,1,0,75.73
臺北縣,新店市,粗坑里,1132,1,1001,6,1007,1592,3,1,3,0,1,0,63.25
臺北縣,新店市,屈尺里,1133,1,660,10,670,915,3,1,3,0,1,0,73.22
臺北縣,新店市,屈尺里,1134,1,784,25,809,1164,3,1,3,0,1,0,69.50
臺北縣,新店市,龜山里,1135,1,913,23,936,1365,3,1,3,0,1,0,68.57
臺北縣,新店市,廣興里,1136,1,717,10,727,1043,3,1,3,0,1,0,69.70
臺北縣,新店市,直潭里,1137,1,382,10,392,598,3,1,3,0,1,0,65.55
臺北縣,土城市,祖田里,1138,1,702,12,714,1081,3,1,3,0,1,0,66.05
臺北縣,土城市,頂新里,1139,1,880,13,893,1178,3,1,3,0,1,0,75.81
臺北縣,土城市,頂福里,1140,1,895,15,910,1376,3,1,3,0,1,0,66.13
臺北縣,土城市,頂福里,1141,1,987,26,1013,1414,3,1,3,0,1,0,71.64
臺北縣,土城市,頂埔里,1142,1,646,18,664,1000,3,1,3,0,1,0,66.40
臺北縣,土城市,頂埔里,1143,1,769,12,781,1221,3,1,3,0,1,0,63.96
臺北縣,土城市,沛陂里,1144,1,1239,38,1277,1942,3,1,3,0,1,0,65.76
臺北縣,土城市,永寧里,1145,1,1022,18,1040,1578,3,1,3,0,1,0,65.91
臺北縣,土城市,永寧里,1146,1,702,15,717,1106,3,1,3,0,1,0,64.83
臺北縣,土城市,永寧里,1147,1,722,10,732,1112,3,1,3,0,1,0,65.83
臺北縣,土城市,大安里,1148,1,769,12,781,1207,3,1,3,0,1,0,64.71
臺北縣,土城市,大安里,1149,1,880,14,894,1266,3,1,3,0,1,0,70.62
臺北縣,土城市,員仁里,1150,1,988,15,1003,1582,3,1,3,0,1,0,63.40
臺北縣,土城市,員仁里,1151,1,1018,17,1035,1668,3,1,3,0,1,0,62.05
臺北縣,土城市,埤塘里,1152,1,1188,19,1207,1764,3,1,3,0,1,0,68.42
臺北縣,土城市,土城里,1153,1,877,8,885,1311,3,1,3,0,1,0,67.51
臺北縣,土城市,長風里,1154,1,602,6,608,805,3,1,3,0,1,0,75.53
臺北縣,土城市,員信里,1155,1,751,12,763,1098,3,1,3,0,1,0,69.49
臺北縣,土城市,員信里,1156,1,759,13,772,1249,3,1,3,0,1,0,61.81
臺北縣,土城市,員林里,1157,1,1172,13,1185,1821,3,1,3,0,1,0,65.07
臺北縣,土城市,員林里,1158,1,992,15,1007,1551,3,1,3,0,1,0,64.93
臺北縣,土城市,員福里,1159,1,1132,12,1144,1716,3,1,3,0,1,0,66.67
臺北縣,土城市,員福里,1160,1,1237,25,1262,1829,3,1,3,0,1,0,69.00
臺北縣,土城市,日和里,1161,1,823,8,831,1169,3,1,3,0,1,0,71.09
臺北縣,土城市,日和里,1162,1,921,22,943,1358,3,1,3,0,1,0,69.44
臺北縣,土城市,日和里,1163,1,555,18,573,850,3,1,3,0,1,0,67.41
臺北縣,土城市,日新里,1164,1,913,20,933,1369,3,1,3,0,1,0,68.15
臺北縣,土城市,日新里,1165,1,1189,26,1215,1804,3,1,3,0,1,0,67.35
臺北縣,土城市,裕生里,1166,1,1054,19,1073,1552,3,1,3,0,1,0,69.14
臺北縣,土城市,裕生里,1167,1,1044,18,1062,1608,3,1,3,0,1,0,66.04
臺北縣,土城市,貨饒里,1168,1,936,19,955,1453,3,1,3,0,1,0,65.73
臺北縣,土城市,貨饒里,1169,1,805,11,816,1298,3,1,3,0,1,0,62.87
臺北縣,土城市,瑞興里,1170,1,800,12,812,1147,3,1,3,0,1,0,70.79
臺北縣,土城市,瑞興里,1171,1,649,10,659,944,3,1,3,0,1,0,69.81
臺北縣,土城市,復興里,1172,1,770,10,780,1254,3,1,3,0,1,0,62.20
臺北縣,土城市,復興里,1173,1,982,12,994,1470,3,1,3,0,1,0,67.62
臺北縣,土城市,廣福里,1174,1,813,12,825,1201,3,1,3,0,1,0,68.69
臺北縣,土城市,廣福里,1175,1,1084,18,1102,1655,3,1,3,0,1,0,66.59
臺北縣,土城市,學成里,1176,1,681,9,690,1094,3,1,3,0,1,0,63.07
臺北縣,土城市,學成里,1177,1,604,6,610,898,3,1,3,0,1,0,67.93
臺北縣,土城市,埤林里,1178,1,719,8,727,1126,3,1,3,0,1,0,64.56
臺北縣,土城市,埤林里,1179,1,1494,20,1514,2429,3,1,3,0,1,0,62.33
臺北縣,土城市,埤林里,1180,1,827,15,842,1268,3,1,3,0,1,0,66.40
臺北縣,土城市,樂利里,1181,1,1096,15,1111,1638,3,1,3,0,1,0,67.83
臺北縣,土城市,樂利里,1182,1,945,9,954,1470,3,1,3,0,1,0,64.90
臺北縣,土城市,學府里,1183,1,692,12,704,1065,3,1,3,0,1,0,66.10
臺北縣,土城市,學府里,1184,1,620,17,637,1015,3,1,3,0,1,0,62.76
臺北縣,土城市,柑林里,1185,1,1085,15,1100,1827,3,1,3,0,1,0,60.21
臺北縣,土城市,柑林里,1186,1,1165,22,1187,1925,3,1,3,0,1,0,61.66
臺北縣,土城市,柑林里,1187,1,886,10,896,1459,3,1,3,0,1,0,61.41
臺北縣,土城市,青雲里,1188,1,1100,16,1116,1557,3,1,3,0,1,0,71.68
臺北縣,土城市,清和里,1189,1,760,9,769,1145,3,1,3,0,1,0,67.16
臺北縣,土城市,清和里,1190,1,591,16,607,932,3,1,3,0,1,0,65.13
臺北縣,土城市,清和里,1191,1,1035,24,1059,1622,3,1,3,0,1,0,65.29
臺北縣,土城市,清化里,1192,1,658,8,666,984,3,1,3,0,1,0,67.68
臺北縣,土城市,清溪里,1193,1,1195,23,1218,1709,3,1,3,0,1,0,71.27
臺北縣,土城市,清溪里,1194,1,963,8,971,1564,3,1,3,0,1,0,62.08
臺北縣,土城市,清溪里,1195,1,399,7,406,612,3,1,3,0,1,0,66.34
臺北縣,土城市,清水里,1196,1,1142,11,1153,1747,3,1,3,0,1,0,66.00
臺北縣,土城市,清水里,1197,1,1109,14,1123,1816,3,1,3,0,1,0,61.84
臺北縣,土城市,清水里,1198,1,604,13,617,946,3,1,3,0,1,0,65.22
臺北縣,土城市,清水里,1199,1,736,11,747,1082,3,1,3,0,1,0,69.04
臺北縣,土城市,永豐里,1200,1,657,10,667,946,3,1,3,0,1,0,70.51
臺北縣,土城市,永豐里,1201,1,708,9,717,1004,3,1,3,0,1,0,71.41
臺北縣,土城市,永富里,1202,1,868,15,883,1390,3,1,3,0,1,0,63.53
臺北縣,土城市,永富里,1203,1,1026,20,1046,1595,3,1,3,0,1,0,65.58
臺北縣,土城市,延和里,1204,1,1029,14,1043,1555,3,1,3,0,1,0,67.07
臺北縣,土城市,延和里,1205,1,986,16,1002,1532,3,1,3,0,1,0,65.40
臺北縣,土城市,廷寮里,1206,1,1237,21,1258,2069,3,1,3,0,1,0,60.80
臺北縣,土城市,廷寮里,1207,1,625,5,630,910,3,1,3,0,1,0,69.23
臺北縣,土城市,峰廷里,1208,1,1088,13,1101,1777,3,1,3,0,1,0,61.96
臺北縣,土城市,峰廷里,1209,1,653,14,667,984,3,1,3,0,1,0,67.78
臺北縣,土城市,峰廷里,1210,1,795,12,807,1287,3,1,3,0,1,0,62.70
臺北縣,土城市,延吉里,1211,1,888,18,906,1345,3,1,3,0,1,0,67.36
臺北縣,土城市,延吉里,1212,1,773,18,791,1221,3,1,3,0,1,0,64.78
臺北縣,土城市,延壽里,1213,1,731,10,741,1081,3,1,3,0,1,0,68.55
臺北縣,土城市,延壽里,1214,1,835,8,843,1364,3,1,3,0,1,0,61.80
臺北縣,土城市,延壽里,1215,1,1115,18,1133,1751,3,1,3,0,1,0,64.71
臺北縣,土城市,平和里,1216,1,768,15,783,1114,3,1,3,0,1,0,70.29
臺北縣,土城市,平和里,1217,1,1311,23,1334,2040,3,1,3,0,1,0,65.39
臺北縣,土城市,平和里,1218,1,491,4,495,792,3,1,3,0,1,0,62.50
臺北縣,土城市,安和里,1219,1,1016,22,1038,1545,3,1,3,0,1,0,67.18
臺北縣,土城市,安和里,1220,1,539,11,550,833,3,1,3,0,1,0,66.03
臺北縣,樹林鎮,保安里,1221,1,1029,13,1042,1517,3,1,3,0,1,0,68.69
臺北縣,樹林鎮,保安里,1222,1,716,6,722,1047,3,1,3,0,1,0,68.96
臺北縣,樹林鎮,保安里,1223,1,835,13,848,1240,3,1,3,0,1,0,68.39
臺北縣,樹林鎮,圳福里,1224,1,971,22,993,1554,3,1,3,0,1,0,63.90
臺北縣,樹林鎮,圳福里,1225,1,652,4,656,931,3,1,3,0,1,0,70.46
臺北縣,樹林鎮,圳安里,1226,1,876,16,892,1482,3,1,3,0,1,0,60.19
臺北縣,樹林鎮,圳安里,1227,1,939,14,953,1608,3,1,3,0,1,0,59.27
臺北縣,樹林鎮,三多里,1228,1,502,10,512,811,3,1,3,0,1,0,63.13
臺北縣,樹林鎮,三多里,1229,1,790,6,796,1187,3,1,3,0,1,0,67.06
臺北縣,樹林鎮,三多里,1230,1,953,20,973,1553,3,1,3,0,1,0,62.65
臺北縣,樹林鎮,三福里,1231,1,956,16,972,1435,3,1,3,0,1,0,67.74
臺北縣,樹林鎮,三福里,1232,1,876,16,892,1354,3,1,3,0,1,0,65.88
臺北縣,樹林鎮,三興里,1233,1,593,15,608,1047,3,1,3,0,1,0,58.07
臺北縣,樹林鎮,三興里,1234,1,650,13,663,1092,3,1,3,0,1,0,60.71
臺北縣,樹林鎮,三興里,1235,1,738,9,747,1234,3,1,3,0,1,0,60.53
臺北縣,樹林鎮,羌寮里,1236,1,626,6,632,911,3,1,3,0,1,0,69.37
臺北縣,樹林鎮,羌寮里,1237,1,737,15,752,1253,3,1,3,0,1,0,60.02
臺北縣,樹林鎮,光興里,1238,1,554,6,560,868,3,1,3,0,1,0,64.52
臺北縣,樹林鎮,光興里,1239,1,573,10,583,954,3,1,3,0,1,0,61.11
臺北縣,樹林鎮,金寮里,1240,1,645,11,656,950,3,1,3,0,1,0,69.05
臺北縣,樹林鎮,金寮里,1241,1,554,16,570,860,3,1,3,0,1,0,66.28
臺北縣,樹林鎮,潭底里,1242,1,930,9,939,1379,3,1,3,0,1,0,68.09
臺北縣,樹林鎮,潭底里,1243,1,991,21,1012,1519,3,1,3,0,1,0,66.62
臺北縣,樹林鎮,文林里,1244,1,682,16,698,1014,3,1,3,0,1,0,68.84
臺北縣,樹林鎮,文林里,1245,1,558,3,561,924,3,1,3,0,1,0,60.71
臺北縣,樹林鎮,樹東里,1246,1,639,7,646,878,3,1,3,0,1,0,73.58
臺北縣,樹林鎮,樹北里,1247,1,752,16,768,1064,3,1,3,0,1,0,72.18
臺北縣,樹林鎮,樹福里,1248,1,637,13,650,921,3,1,3,0,1,0,70.58
臺北縣,樹林鎮,樹福里,1249,1,583,5,588,835,3,1,3,0,1,0,70.42
臺北縣,樹林鎮,樹德里,1250,1,990,12,1002,1368,3,1,3,0,1,0,73.25
臺北縣,樹林鎮,樹德里,1251,1,754,15,769,1145,3,1,3,0,1,0,67.16
臺北縣,樹林鎮,樹西里,1252,1,692,9,701,971,3,1,3,0,1,0,72.19
臺北縣,樹林鎮,樹西里,1253,1,988,11,999,1382,3,1,3,0,1,0,72.29
臺北縣,樹林鎮,樹西里,1254,1,727,12,739,1035,3,1,3,0,1,0,71.40
臺北縣,樹林鎮,育英里,1255,1,648,7,655,964,3,1,3,0,1,0,67.95
臺北縣,樹林鎮,育英里,1256,1,710,10,720,986,3,1,3,0,1,0,73.02
臺北縣,樹林鎮,樹南里,1257,1,949,11,960,1359,3,1,3,0,1,0,70.64
臺北縣,樹林鎮,樹南里,1258,1,794,7,801,1131,3,1,3,0,1,0,70.82
臺北縣,樹林鎮,樹人里,1259,1,694,20,714,1061,3,1,3,0,1,0,67.30
臺北縣,樹林鎮,樹人里,1260,1,751,11,762,1100,3,1,3,0,1,0,69.27
臺北縣,樹林鎮,樹興里,1261,1,960,10,970,1414,3,1,3,0,1,0,68.60
臺北縣,樹林鎮,樹興里,1262,1,723,7,730,1083,3,1,3,0,1,0,67.41
臺北縣,樹林鎮,坡內里,1263,1,745,9,754,1048,3,1,3,0,1,0,71.95
臺北縣,樹林鎮,大同里,1264,1,820,14,834,1395,3,1,3,0,1,0,59.78
臺北縣,樹林鎮,大同里,1265,1,706,8,714,1061,3,1,3,0,1,0,67.30
臺北縣,樹林鎮,大同里,1266,1,772,11,783,1247,3,1,3,0,1,0,62.79
臺北縣,樹林鎮,和平里,1267,1,891,16,907,1341,3,1,3,0,1,0,67.64
臺北縣,樹林鎮,和平里,1268,1,961,14,975,1359,3,1,3,0,1,0,71.74
臺北縣,樹林鎮,彭興里,1269,1,975,25,1000,1606,3,1,3,0,1,0,62.27
臺北縣,樹林鎮,彭興里,1270,1,831,16,847,1445,3,1,3,0,1,0,58.62
臺北縣,樹林鎮,彭厝里,1271,1,760,18,778,1258,3,1,3,0,1,0,61.84
臺北縣,樹林鎮,彭厝里,1272,1,603,8,611,976,3,1,3,0,1,0,62.60
臺北縣,樹林鎮,彭福里,1273,1,751,16,767,1195,3,1,3,0,1,0,64.18
臺北縣,樹林鎮,彭福里,1274,1,843,17,860,1210,3,1,3,0,1,0,71.07
臺北縣,樹林鎮,東昇里,1275,1,991,16,1007,1540,3,1,3,0,1,0,65.39
臺北縣,樹林鎮,東昇里,1276,1,512,5,517,749,3,1,3,0,1,0,69.03
臺北縣,樹林鎮,東陽里,1277,1,826,10,836,1306,3,1,3,0,1,0,64.01
臺北縣,樹林鎮,東陽里,1278,1,865,13,878,1321,3,1,3,0,1,0,66.46
臺北縣,樹林鎮,東山里,1279,1,1200,17,1217,1834,3,1,3,0,1,0,66.36
臺北縣,樹林鎮,山佳里,1280,1,456,9,465,758,3,1,3,0,1,0,61.35
臺北縣,樹林鎮,山佳里,1281,1,668,12,680,1039,3,1,3,0,1,0,65.45
臺北縣,樹林鎮,中山里,1282,1,747,16,763,1116,3,1,3,0,1,0,68.37
臺北縣,樹林鎮,中山里,1283,1,844,9,853,1265,3,1,3,0,1,0,67.43
臺北縣,樹林鎮,樂山里,1284,1,717,13,730,1029,3,1,3,0,1,0,70.94
臺北縣,樹林鎮,東園里,1285,1,735,13,748,1045,3,1,3,0,1,0,71.58
臺北縣,樹林鎮,北園里,1286,1,738,9,747,1073,3,1,3,0,1,0,69.62
臺北縣,樹林鎮,柑園里,1287,1,743,18,761,1083,3,1,3,0,1,0,70.27
臺北縣,樹林鎮,南園里,1288,1,539,4,543,740,3,1,3,0,1,0,73.38
臺北縣,樹林鎮,西園里,1289,1,715,16,731,1047,3,1,3,0,1,0,69.82
臺北縣,鶯歌鎮,建德里,1290,1,328,5,333,438,3,1,3,0,1,0,76.03
臺北縣,鶯歌鎮,東鶯里,1291,1,555,5,560,762,3,1,3,0,1,0,73.49
臺北縣,鶯歌鎮,北鶯里,1292,1,950,10,960,1254,3,1,3,0,1,0,76.56
臺北縣,鶯歌鎮,西鶯里,1293,1,424,9,433,562,3,1,3,0,1,0,77.05
臺北縣,鶯歌鎮,西鶯里,1294,1,767,12,779,1032,3,1,3,0,1,0,75.48
臺北縣,鶯歌鎮,中鶯里,1295,1,587,12,599,772,3,1,3,0,1,0,77.59
臺北縣,鶯歌鎮,南鶯里,1296,1,893,14,907,1245,3,1,3,0,1,0,72.85
臺北縣,鶯歌鎮,南鶯里,1297,1,737,12,749,1033,3,1,3,0,1,0,72.51
臺北縣,鶯歌鎮,南鶯里,1298,1,682,12,694,928,3,1,3,0,1,0,74.78
臺北縣,鶯歌鎮,建國里,1299,1,705,14,719,1021,3,1,3,0,1,0,70.42
臺北縣,鶯歌鎮,建國里,1300,1,1056,21,1077,1676,3,1,3,0,1,0,64.26
臺北縣,鶯歌鎮,南靖里,1301,1,817,22,839,1106,3,1,3,0,1,0,75.86
臺北縣,鶯歌鎮,南靖里,1302,1,838,14,852,1133,3,1,3,0,1,0,75.20
臺北縣,鶯歌鎮,尖山里,1303,1,803,4,807,1116,3,1,3,0,1,0,72.31
臺北縣,鶯歌鎮,尖山里,1304,1,1005,14,1019,1320,3,1,3,0,1,0,77.20
臺北縣,鶯歌鎮,二橋里,1305,1,825,12,837,1101,3,1,3,0,1,0,76.02
臺北縣,鶯歌鎮,二橋里,1306,1,910,18,928,1238,3,1,3,0,1,0,74.96
臺北縣,鶯歌鎮,二橋里,1307,1,734,16,750,1010,3,1,3,0,1,0,74.26
臺北縣,鶯歌鎮,二甲里,1308,1,542,12,554,688,3,1,3,0,1,0,80.52
臺北縣,鶯歌鎮,同慶里,1309,1,743,8,751,1021,3,1,3,0,1,0,73.56
臺北縣,鶯歌鎮,永昌里,1310,1,892,18,910,1353,3,1,3,0,1,0,67.26
臺北縣,鶯歌鎮,永昌里,1311,1,942,10,952,1544,3,1,3,0,1,0,61.66
臺北縣,鶯歌鎮,永昌里,1312,1,904,12,916,1287,3,1,3,0,1,0,71.17
臺北縣,鶯歌鎮,永吉里,1313,1,719,22,741,1071,3,1,3,0,1,0,69.19
臺北縣,鶯歌鎮,永吉里,1314,1,664,11,675,910,3,1,3,0,1,0,74.18
臺北縣,鶯歌鎮,永吉里,1315,1,642,14,656,913,3,1,3,0,1,0,71.85
臺北縣,鶯歌鎮,鳳鳴里,1316,1,868,19,887,1349,3,1,3,0,1,0,65.75
臺北縣,鶯歌鎮,鳳鳴里,1317,1,877,16,893,1247,3,1,3,0,1,0,71.61
臺北縣,鶯歌鎮,鳳祥里,1318,1,714,15,729,1070,3,1,3,0,1,0,68.13
臺北縣,鶯歌鎮,鳳祥里,1319,1,552,10,562,818,3,1,3,0,1,0,68.70
臺北縣,鶯歌鎮,鳳祥里,1320,1,523,14,537,1008,3,1,3,0,1,0,53.27
臺北縣,鶯歌鎮,鳳福里,1321,1,933,16,949,1372,3,1,3,0,1,0,69.17
臺北縣,鶯歌鎮,鳳福里,1322,1,875,20,895,1400,3,1,3,0,1,0,63.93
臺北縣,鶯歌鎮,大湖里,1323,1,720,15,735,1154,3,1,3,0,1,0,63.69
臺北縣,鶯歌鎮,大湖里,1324,1,864,6,870,1294,3,1,3,0,1,0,67.23
臺北縣,鶯歌鎮,大湖里,1325,1,726,16,742,1108,3,1,3,0,1,0,66.97
臺北縣,鶯歌鎮,中湖里,1326,1,774,13,787,1318,3,1,3,0,1,0,59.71
臺北縣,鶯歌鎮,中湖里,1327,1,827,13,840,1225,3,1,3,0,1,0,68.57
臺北縣,鶯歌鎮,中湖里,1328,1,753,22,775,1065,3,1,3,0,1,0,72.77
臺北縣,鶯歌鎮,東湖里,1329,1,177,4,181,254,3,1,3,0,1,0,71.26
臺北縣,三峽鎮,三峽里,1330,1,295,5,300,403,3,1,3,0,1,0,74.44
臺北縣,三峽鎮,秀川里,1331,1,347,4,351,465,3,1,3,0,1,0,75.48
臺北縣,三峽鎮,八張里,1332,1,598,13,611,852,3,1,3,0,1,0,71.71
臺北縣,三峽鎮,八張里,1333,1,658,12,670,986,3,1,3,0,1,0,67.95
臺北縣,三峽鎮,中埔里,1334,1,516,10,526,700,3,1,3,0,1,0,75.14
臺北縣,三峽鎮,弘道里,1335,1,637,13,650,842,3,1,3,0,1,0,77.20
臺北縣,三峽鎮,永舘里,1336,1,836,11,847,1216,3,1,3,0,1,0,69.65
臺北縣,三峽鎮,永舘里,1337,1,639,12,651,916,3,1,3,0,1,0,71.07
臺北縣,三峽鎮,永舘里,1338,1,879,9,888,1252,3,1,3,0,1,0,70.93
臺北縣,三峽鎮,中正里,1339,1,745,8,753,1178,3,1,3,0,1,0,63.92
臺北縣,三峽鎮,中正里,1340,1,702,19,721,1123,3,1,3,0,1,0,64.20
臺北縣,三峽鎮,礁溪里,1341,1,1077,13,1090,1529,3,1,3,0,1,0,71.29
臺北縣,三峽鎮,介壽里,1342,1,744,11,755,1134,3,1,3,0,1,0,66.58
臺北縣,三峽鎮,介壽里,1343,1,650,8,658,1010,3,1,3,0,1,0,65.15
臺北縣,三峽鎮,安溪里,1344,1,904,20,924,1392,3,1,3,0,1,0,66.38
臺北縣,三峽鎮,安溪里,1345,1,803,15,818,1203,3,1,3,0,1,0,68.00
臺北縣,三峽鎮,龍埔里,1346,1,1015,9,1024,1571,3,1,3,0,1,0,65.18
臺北縣,三峽鎮,龍埔里,1347,1,892,18,910,1386,3,1,3,0,1,0,65.66
臺北縣,三峽鎮,龍埔里,1348,1,920,18,938,1331,3,1,3,0,1,0,70.47
臺北縣,三峽鎮,鳶山里,1349,1,922,16,938,1364,3,1,3,0,1,0,68.77
臺北縣,三峽鎮,鳶山里,1350,1,994,16,1010,1571,3,1,3,0,1,0,64.29
臺北縣,三峽鎮,鳶山里,1351,1,879,30,909,1415,3,1,3,0,1,0,64.24
臺北縣,三峽鎮,大埔里,1352,1,882,17,899,1347,3,1,3,0,1,0,66.74
臺北縣,三峽鎮,大埔里,1353,1,953,18,971,1369,3,1,3,0,1,0,70.93
臺北縣,三峽鎮,大埔里,1354,1,1175,23,1198,1859,3,1,3,0,1,0,64.44
臺北縣,三峽鎮,嘉添里,1355,1,1063,18,1081,1528,3,1,3,0,1,0,70.75
臺北縣,三峽鎮,嘉添里,1356,1,889,13,902,1200,3,1,3,0,1,0,75.17
臺北縣,三峽鎮,添福里,1357,1,593,13,606,819,3,1,3,0,1,0,73.99
臺北縣,三峽鎮,五寮里,1358,1,696,14,710,954,3,1,3,0,1,0,74.42
臺北縣,三峽鎮,金圳里,1359,1,331,6,337,464,3,1,3,0,1,0,72.63
臺北縣,三峽鎮,插角里,1360,1,577,12,589,872,3,1,3,0,1,0,67.55
臺北縣,三峽鎮,有木里,1361,1,544,9,553,837,3,1,3,0,1,0,66.07
臺北縣,三峽鎮,溪南里,1362,1,824,13,837,1108,3,1,3,0,1,0,75.54
臺北縣,三峽鎮,溪北里,1363,1,1210,17,1227,1714,3,1,3,0,1,0,71.59
臺北縣,三峽鎮,溪東里,1364,1,710,15,725,975,3,1,3,0,1,0,74.36
臺北縣,三峽鎮,溪東里,1365,1,858,17,875,1220,3,1,3,0,1,0,71.72
臺北縣,三峽鎮,成福里,1366,1,627,5,632,838,3,1,3,0,1,0,75.42
臺北縣,三峽鎮,安坑里,1367,1,846,19,865,1296,3,1,3,0,1,0,66.74
臺北縣,三峽鎮,竹崙里,1368,1,1016,21,1037,1577,3,1,3,0,1,0,65.76
臺北縣,淡水鎮,中和里,1369,1,472,6,478,591,3,1,3,0,1,0,80.88
臺北縣,淡水鎮,屯山里,1370,1,747,7,754,926,3,1,3,0,1,0,81.43
臺北縣,淡水鎮,賢孝里,1371,1,915,21,936,1211,3,1,3,0,1,0,77.29
臺北縣,淡水鎮,興仁里,1372,1,967,16,983,1328,3,1,3,0,1,0,74.02
臺北縣,淡水鎮,蕃薯里,1373,1,389,3,392,559,3,1,3,0,1,0,70.13
臺北縣,淡水鎮,義山里,1374,1,811,13,824,1159,3,1,3,0,1,0,71.10
臺北縣,淡水鎮,義山里,1375,1,729,16,745,1072,3,1,3,0,1,0,69.50
臺北縣,淡水鎮,忠山里,1376,1,552,15,567,698,3,1,3,0,1,0,81.23
臺北縣,淡水鎮,崁頂里,1377,1,894,13,907,1236,3,1,3,0,1,0,73.38
臺北縣,淡水鎮,埤島里,1378,1,832,9,841,1105,3,1,3,0,1,0,76.11
臺北縣,淡水鎮,新興里,1379,1,842,8,850,1183,3,1,3,0,1,0,71.85
臺北縣,淡水鎮,新興里,1380,1,880,15,895,1275,3,1,3,0,1,0,70.20
臺北縣,淡水鎮,新興里,1381,1,913,22,935,1374,3,1,3,0,1,0,68.05
臺北縣,淡水鎮,新興里,1382,1,1041,11,1052,1673,3,1,3,0,1,0,62.88
臺北縣,淡水鎮,新興里,1383,1,836,16,852,1266,3,1,3,0,1,0,67.30
臺北縣,淡水鎮,水碓里,1384,1,975,25,1000,1323,3,1,3,0,1,0,75.59
臺北縣,淡水鎮,水碓里,1385,1,1173,17,1190,1808,3,1,3,0,1,0,65.82
臺北縣,淡水鎮,水碓里,1386,1,1170,14,1184,1659,3,1,3,0,1,0,71.37
臺北縣,淡水鎮,北投里,1387,1,910,13,923,1275,3,1,3,0,1,0,72.39
臺北縣,淡水鎮,水源里,1388,1,953,13,966,1447,3,1,3,0,1,0,66.76
臺北縣,淡水鎮,忠寮里,1389,1,652,14,666,880,3,1,3,0,1,0,75.68
臺北縣,淡水鎮,樹興里,1390,1,443,11,454,665,3,1,3,0,1,0,68.27
臺北縣,淡水鎮,坪頂里,1391,1,537,9,546,765,3,1,3,0,1,0,71.37
臺北縣,淡水鎮,福德里,1392,1,1147,16,1163,1715,3,1,3,0,1,0,67.81
臺北縣,淡水鎮,福德里,1393,1,1076,7,1083,1639,3,1,3,0,1,0,66.08
臺北縣,淡水鎮,竹圍里,1394,1,756,11,767,1211,3,1,3,0,1,0,63.34
臺北縣,淡水鎮,竹圍里,1395,1,799,15,814,1171,3,1,3,0,1,0,69.51
臺北縣,淡水鎮,竹圍里,1396,1,799,11,810,1239,3,1,3,0,1,0,65.38
臺北縣,淡水鎮,民生里,1397,1,894,18,912,1329,3,1,3,0,1,0,68.62
臺北縣,淡水鎮,民生里,1398,1,1090,24,1114,1563,3,1,3,0,1,0,71.27
臺北縣,淡水鎮,八勢里,1399,1,598,10,608,864,3,1,3,0,1,0,70.37
臺北縣,淡水鎮,竿蓁里,1400,1,1061,16,1077,1780,3,1,3,0,1,0,60.51
臺北縣,淡水鎮,鄧公里,1401,1,1147,27,1174,1697,3,1,3,0,1,0,69.18
臺北縣,淡水鎮,鄧公里,1402,1,791,8,799,1149,3,1,3,0,1,0,69.54
臺北縣,淡水鎮,鄧公里,1403,1,1005,15,1020,1519,3,1,3,0,1,0,67.15
臺北縣,淡水鎮,鄧公里,1404,1,756,16,772,1230,3,1,3,0,1,0,62.76
臺北縣,淡水鎮,鄧公里,1405,1,1020,21,1041,1489,3,1,3,0,1,0,69.91
臺北縣,淡水鎮,中興里,1406,1,662,10,672,1154,3,1,3,0,1,0,58.23
臺北縣,淡水鎮,中興里,1407,1,883,14,897,1271,3,1,3,0,1,0,70.57
臺北縣,淡水鎮,中興里,1408,1,872,25,897,1239,3,1,3,0,1,0,72.40
臺北縣,淡水鎮,長庚里,1409,1,1187,18,1205,1672,3,1,3,0,1,0,72.07
臺北縣,淡水鎮,清文里,1410,1,689,12,701,991,3,1,3,0,1,0,70.74
臺北縣,淡水鎮,草東里,1411,1,610,10,620,844,3,1,3,0,1,0,73.46
臺北縣,淡水鎮,協元里,1412,1,888,21,909,1361,3,1,3,0,1,0,66.79
臺北縣,淡水鎮,永吉里,1413,1,538,7,545,741,3,1,3,0,1,0,73.55
臺北縣,淡水鎮,民安里,1414,1,558,7,565,775,3,1,3,0,1,0,72.90
臺北縣,淡水鎮,新生里,1415,1,427,6,433,600,3,1,3,0,1,0,72.17
臺北縣,淡水鎮,文化里,1416,1,753,11,764,1082,3,1,3,0,1,0,70.61
臺北縣,淡水鎮,油車里,1417,1,928,11,939,1297,3,1,3,0,1,0,72.40
臺北縣,淡水鎮,油車里,1418,1,934,18,952,1339,3,1,3,0,1,0,71.10
臺北縣,淡水鎮,沙崙里,1419,1,1090,25,1115,1618,3,1,3,0,1,0,68.91
臺北縣,淡水鎮,沙崙里,1420,1,1002,20,1022,1371,3,1,3,0,1,0,74.54
臺北縣,汐止鎮,仁德里,1421,1,982,15,997,1253,3,1,3,0,1,0,79.57
臺北縣,汐止鎮,義民里,1422,1,883,4,887,1238,3,1,3,0,1,0,71.65
臺北縣,汐止鎮,禮門里,1423,1,741,7,748,987,3,1,3,0,1,0,75.79
臺北縣,汐止鎮,智慧里,1424,1,753,7,760,1090,3,1,3,0,1,0,69.72
臺北縣,汐止鎮,智慧里,1425,1,968,7,975,1406,3,1,3,0,1,0,69.35
臺北縣,汐止鎮,信望里,1426,1,441,4,445,596,3,1,3,0,1,0,74.66
臺北縣,汐止鎮,新昌里,1427,1,859,9,868,1107,3,1,3,0,1,0,78.41
臺北縣,汐止鎮,新昌里,1428,1,824,8,832,1071,3,1,3,0,1,0,77.68
臺北縣,汐止鎮,新昌里,1429,1,845,4,849,1032,3,1,3,0,1,0,82.27
臺北縣,汐止鎮,新昌里,1430,1,868,15,883,1161,3,1,3,0,1,0,76.06
臺北縣,汐止鎮,秀峰里,1431,1,939,17,956,1258,3,1,3,0,1,0,75.99
臺北縣,汐止鎮,秀峰里,1432,1,983,10,993,1338,3,1,3,0,1,0,74.22
臺北縣,汐止鎮,秀峰里,1433,1,1296,7,1303,1652,3,1,3,0,1,0,78.87
臺北縣,汐止鎮,復興里,1434,1,667,9,676,842,3,1,3,0,1,0,80.29
臺北縣,汐止鎮,復興里,1435,1,867,4,871,1154,3,1,3,0,1,0,75.48
臺北縣,汐止鎮,自強里,1436,1,972,4,976,1271,3,1,3,0,1,0,76.79
臺北縣,汐止鎮,自強里,1437,1,811,11,822,1061,3,1,3,0,1,0,77.47
臺北縣,汐止鎮,文化里,1438,1,864,11,875,1207,3,1,3,0,1,0,72.49
臺北縣,汐止鎮,文化里,1439,1,699,13,712,954,3,1,3,0,1,0,74.63
臺北縣,汐止鎮,白雲里,1440,1,1126,17,1143,1598,3,1,3,0,1,0,71.53
臺北縣,汐止鎮,茄苳里,1441,1,1174,17,1191,1535,3,1,3,0,1,0,77.59
臺北縣,汐止鎮,茄苳里,1442,1,1051,14,1065,1433,3,1,3,0,1,0,74.32
臺北縣,汐止鎮,茄苳里,1443,1,1063,6,1069,1505,3,1,3,0,1,0,71.03
臺北縣,汐止鎮,橋東里,1444,1,1147,11,1158,1482,3,1,3,0,1,0,78.14
臺北縣,汐止鎮,橋東里,1445,1,665,3,668,886,3,1,3,0,1,0,75.40
臺北縣,汐止鎮,長安里,1446,1,960,12,972,1314,3,1,3,0,1,0,73.97
臺北縣,汐止鎮,保安里,1447,1,859,6,865,1159,3,1,3,0,1,0,74.63
臺北縣,汐止鎮,東山里,1448,1,311,3,314,407,3,1,3,0,1,0,77.15
臺北縣,汐止鎮,保長里,1449,1,1235,22,1257,1642,3,1,3,0,1,0,76.55
臺北縣,汐止鎮,保長里,1450,1,464,3,467,584,3,1,3,0,1,0,79.97
臺北縣,汐止鎮,鄉長里,1451,1,1027,14,1041,1369,3,1,3,0,1,0,76.04
臺北縣,汐止鎮,江北里,1452,1,873,6,879,1144,3,1,3,0,1,0,76.84
臺北縣,汐止鎮,江北里,1453,1,787,8,795,1059,3,1,3,0,1,0,75.07
臺北縣,汐止鎮,江北里,1454,1,748,7,755,1051,3,1,3,0,1,0,71.84
臺北縣,汐止鎮,拱北里,1455,1,767,9,776,1189,3,1,3,0,1,0,65.26
臺北縣,汐止鎮,拱北里,1456,1,812,7,819,1186,3,1,3,0,1,0,69.06
臺北縣,汐止鎮,烘內里,1457,1,744,9,753,1105,3,1,3,0,1,0,68.14
臺北縣,汐止鎮,八連里,1458,1,549,6,555,798,3,1,3,0,1,0,69.55
臺北縣,汐止鎮,八連里,1459,1,515,3,518,749,3,1,3,0,1,0,69.16
臺北縣,汐止鎮,北峰里,1460,1,947,11,958,1352,3,1,3,0,1,0,70.86
臺北縣,汐止鎮,北峰里,1461,1,933,10,943,1360,3,1,3,0,1,0,69.34
臺北縣,汐止鎮,北峰里,1462,1,1068,13,1081,1596,3,1,3,0,1,0,67.73
臺北縣,汐止鎮,樟樹里,1463,1,1014,13,1027,1494,3,1,3,0,1,0,68.74
臺北縣,汐止鎮,忠孝里,1464,1,926,13,939,1320,3,1,3,0,1,0,71.14
臺北縣,汐止鎮,忠孝里,1465,1,995,16,1011,1416,3,1,3,0,1,0,71.40
臺北縣,汐止鎮,厚德里,1466,1,531,6,537,805,3,1,3,0,1,0,66.71
臺北縣,汐止鎮,厚德里,1467,1,586,11,597,834,3,1,3,0,1,0,71.58
臺北縣,汐止鎮,中興里,1468,1,1250,23,1273,1893,3,1,3,0,1,0,67.25
臺北縣,汐止鎮,中興里,1469,1,1002,11,1013,1434,3,1,3,0,1,0,70.64
臺北縣,汐止鎮,中興里,1470,1,689,10,699,1025,3,1,3,0,1,0,68.20
臺北縣,汐止鎮,中興里,1471,1,734,10,744,1027,3,1,3,0,1,0,72.44
臺北縣,汐止鎮,湖光里,1472,1,739,8,747,1122,3,1,3,0,1,0,66.58
臺北縣,汐止鎮,湖光里,1473,1,695,5,700,1024,3,1,3,0,1,0,68.36
臺北縣,汐止鎮,湖光里,1474,1,771,6,777,1195,3,1,3,0,1,0,65.02
臺北縣,汐止鎮,北山里,1475,1,861,11,872,1395,3,1,3,0,1,0,62.51
臺北縣,汐止鎮,北山里,1476,1,958,13,971,1403,3,1,3,0,1,0,69.21
臺北縣,汐止鎮,北山里,1477,1,656,4,660,1007,3,1,3,0,1,0,65.54
臺北縣,汐止鎮,北山里,1478,1,678,7,685,1005,3,1,3,0,1,0,68.16
臺北縣,汐止鎮,北山里,1479,1,545,6,551,753,3,1,3,0,1,0,73.17
臺北縣,汐止鎮,橫科里,1480,1,980,22,1002,1471,3,1,3,0,1,0,68.12
臺北縣,汐止鎮,橫科里,1481,1,784,6,790,1146,3,1,3,0,1,0,68.94
臺北縣,汐止鎮,橫科里,1482,1,827,14,841,1194,3,1,3,0,1,0,70.44
臺北縣,汐止鎮,福山里,1483,1,717,8,725,1009,3,1,3,0,1,0,71.85
臺北縣,汐止鎮,福山里,1484,1,668,6,674,1021,3,1,3,0,1,0,66.01
臺北縣,汐止鎮,宜興里,1485,1,919,10,929,1345,3,1,3,0,1,0,69.07
臺北縣,汐止鎮,宜興里,1486,1,1168,5,1173,1649,3,1,3,0,1,0,71.13
臺北縣,瑞芳鎮,龍潭里,1487,1,631,5,636,847,3,1,3,0,1,0,75.09
臺北縣,瑞芳鎮,龍興里,1488,1,1167,9,1176,1643,3,1,3,0,1,0,71.58
臺北縣,瑞芳鎮,龍鎮里,1489,1,1025,11,1036,1494,3,1,3,0,1,0,69.34
臺北縣,瑞芳鎮,龍安里,1490,1,451,8,459,646,3,1,3,0,1,0,71.05
臺北縣,瑞芳鎮,龍川里,1491,1,1093,21,1114,1606,3,1,3,0,1,0,69.36
臺北縣,瑞芳鎮,龍山里,1492,1,906,15,921,1304,3,1,3,0,1,0,70.63
臺北縣,瑞芳鎮,爪峰里,1493,1,1002,12,1014,1448,3,1,3,0,1,0,70.03
臺北縣,瑞芳鎮,爪峰里,1494,1,748,6,754,1087,3,1,3,0,1,0,69.37
臺北縣,瑞芳鎮,爪峰里,1495,1,764,7,771,1103,3,1,3,0,1,0,69.90
臺北縣,瑞芳鎮,爪峰里,1496,1,488,3,491,731,3,1,3,0,1,0,67.17
臺北縣,瑞芳鎮,爪峰里,1497,1,980,16,996,1434,3,1,3,0,1,0,69.46
臺北縣,瑞芳鎮,東和里,1498,1,936,9,945,1322,3,1,3,0,1,0,71.48
臺北縣,瑞芳鎮,東和里,1499,1,603,7,610,877,3,1,3,0,1,0,69.56
臺北縣,瑞芳鎮,柑坪里,1500,1,888,14,902,1255,3,1,3,0,1,0,71.87
臺北縣,瑞芳鎮,弓橋里,1501,1,198,1,199,333,3,1,3,0,1,0,59.76
臺北縣,瑞芳鎮,侯硐里,1502,1,378,4,382,598,3,1,3,0,1,0,63.88
臺北縣,瑞芳鎮,光復里,1503,1,248,3,251,408,3,1,3,0,1,0,61.52
臺北縣,瑞芳鎮,碩仁里,1504,1,78,1,79,114,3,1,3,0,1,0,69.30
臺北縣,瑞芳鎮,吉慶里,1505,1,1194,21,1215,1755,3,1,3,0,1,0,69.23
臺北縣,瑞芳鎮,吉安里,1506,1,1034,19,1053,1591,3,1,3,0,1,0,66.18
臺北縣,瑞芳鎮,吉安里,1507,1,919,22,941,1440,3,1,3,0,1,0,65.35
臺北縣,瑞芳鎮,上天里,1508,1,482,9,491,711,3,1,3,0,1,0,69.06
臺北縣,瑞芳鎮,上天里,1509,1,485,9,494,689,3,1,3,0,1,0,71.70
臺北縣,瑞芳鎮,傑魚里,1510,1,691,11,702,1031,3,1,3,0,1,0,68.09
臺北縣,瑞芳鎮,傑魚里,1511,1,669,7,676,944,3,1,3,0,1,0,71.61
臺北縣,瑞芳鎮,基山里,1512,1,412,3,415,631,3,1,3,0,1,0,65.77
臺北縣,瑞芳鎮,永慶里,1513,1,460,6,466,709,3,1,3,0,1,0,65.73
臺北縣,瑞芳鎮,崇文里,1514,1,329,7,336,543,3,1,3,0,1,0,61.88
臺北縣,瑞芳鎮,福住里,1515,1,214,2,216,315,3,1,3,0,1,0,68.57
臺北縣,瑞芳鎮,頌德里,1516,1,320,8,328,494,3,1,3,0,1,0,66.40
臺北縣,瑞芳鎮,瓜山里,1517,1,241,6,247,364,3,1,3,0,1,0,67.86
臺北縣,瑞芳鎮,銅山里,1518,1,231,8,239,327,3,1,3,0,1,0,73.09
臺北縣,瑞芳鎮,新山里,1519,1,342,10,352,523,3,1,3,0,1,0,67.30
臺北縣,瑞芳鎮,石山里,1520,1,344,8,352,502,3,1,3,0,1,0,70.12
臺北縣,瑞芳鎮,濂洞里,1521,1,518,3,521,775,3,1,3,0,1,0,67.23
臺北縣,瑞芳鎮,濂新里,1522,1,245,5,250,391,3,1,3,0,1,0,63.94
臺北縣,瑞芳鎮,南雅里,1523,1,153,0,153,209,3,1,3,0,1,0,73.21
臺北縣,瑞芳鎮,鼻頭里,1524,1,328,5,333,530,3,1,3,0,1,0,62.83
臺北縣,瑞芳鎮,海濱里,1525,1,721,16,737,1051,3,1,3,0,1,0,70.12
臺北縣,瑞芳鎮,瑞濱里,1526,1,549,9,558,847,3,1,3,0,1,0,65.88
臺北縣,瑞芳鎮,瑞濱里,1527,1,595,7,602,876,3,1,3,0,1,0,68.72
臺北縣,瑞芳鎮,深澳里,1528,1,683,13,696,1045,3,1,3,0,1,0,66.60
臺北縣,蘆洲市,光華里,1529,1,997,11,1008,1407,3,1,3,0,1,0,71.64
臺北縣,蘆洲市,光華里,1530,1,1116,22,1138,1673,3,1,3,0,1,0,68.02
臺北縣,蘆洲市,光明里,1531,1,882,14,896,1398,3,1,3,0,1,0,64.09
臺北縣,蘆洲市,光明里,1532,1,748,9,757,1159,3,1,3,0,1,0,65.31
臺北縣,蘆洲市,中華里,1533,1,820,11,831,1157,3,1,3,0,1,0,71.82
臺北縣,蘆洲市,中華里,1534,1,639,5,644,864,3,1,3,0,1,0,74.54
臺北縣,蘆洲市,中路里,1535,1,719,6,725,987,3,1,3,0,1,0,73.45
臺北縣,蘆洲市,中路里,1536,1,892,12,904,1259,3,1,3,0,1,0,71.80
臺北縣,蘆洲市,延平里,1537,1,941,10,951,1332,3,1,3,0,1,0,71.40
臺北縣,蘆洲市,永安里,1538,1,655,13,668,929,3,1,3,0,1,0,71.91
臺北縣,蘆洲市,永安里,1539,1,668,12,680,1028,3,1,3,0,1,0,66.15
臺北縣,蘆洲市,九芎里,1540,1,720,14,734,1113,3,1,3,0,1,0,65.95
臺北縣,蘆洲市,九芎里,1541,1,712,8,720,1087,3,1,3,0,1,0,66.24
臺北縣,蘆洲市,忠義里,1542,1,894,9,903,1317,3,1,3,0,1,0,68.56
臺北縣,蘆洲市,長安里,1543,1,661,15,676,1055,3,1,3,0,1,0,64.08
臺北縣,蘆洲市,長安里,1544,1,789,6,795,1129,3,1,3,0,1,0,70.42
臺北縣,蘆洲市,南港里,1545,1,843,13,856,1361,3,1,3,0,1,0,62.89
臺北縣,蘆洲市,南港里,1546,1,988,12,1000,1573,3,1,3,0,1,0,63.57
臺北縣,蘆洲市,永樂里,1547,1,1230,20,1250,2043,3,1,3,0,1,0,61.18
臺北縣,蘆洲市,永樂里,1548,1,853,10,863,1348,3,1,3,0,1,0,64.02
臺北縣,蘆洲市,永樂里,1549,1,940,12,952,1475,3,1,3,0,1,0,64.54
臺北縣,蘆洲市,永康里,1550,1,946,18,964,1504,3,1,3,0,1,0,64.10
臺北縣,蘆洲市,永康里,1551,1,863,9,872,1320,3,1,3,0,1,0,66.06
臺北縣,蘆洲市,永康里,1552,1,695,8,703,1057,3,1,3,0,1,0,66.51
臺北縣,蘆洲市,正義里,1553,1,444,3,447,615,3,1,3,0,1,0,72.68
臺北縣,蘆洲市,中原里,1554,1,745,12,757,1093,3,1,3,0,1,0,69.26
臺北縣,蘆洲市,中原里,1555,1,860,17,877,1360,3,1,3,0,1,0,64.49
臺北縣,蘆洲市,樓厝里,1556,1,826,16,842,1343,3,1,3,0,1,0,62.70
臺北縣,蘆洲市,樓厝里,1557,1,496,5,501,826,3,1,3,0,1,0,60.65
臺北縣,蘆洲市,復興里,1558,1,1053,15,1068,1612,3,1,3,0,1,0,66.25
臺北縣,蘆洲市,玉清里,1559,1,1108,17,1125,1643,3,1,3,0,1,0,68.47
臺北縣,蘆洲市,信義里,1560,1,887,12,899,1265,3,1,3,0,1,0,71.07
臺北縣,蘆洲市,信義里,1561,1,953,17,970,1371,3,1,3,0,1,0,70.75
臺北縣,蘆洲市,福安里,1562,1,919,17,936,1367,3,1,3,0,1,0,68.47
臺北縣,蘆洲市,鷺江里,1563,1,800,7,807,1217,3,1,3,0,1,0,66.31
臺北縣,蘆洲市,鷺江里,1564,1,674,10,684,1123,3,1,3,0,1,0,60.91
臺北縣,蘆洲市,恆德里,1565,1,1061,16,1077,1683,3,1,3,0,1,0,63.99
臺北縣,蘆洲市,恆德里,1566,1,915,12,927,1399,3,1,3,0,1,0,66.26
臺北縣,蘆洲市,溪墘里,1567,1,789,10,799,1177,3,1,3,0,1,0,67.88
臺北縣,蘆洲市,溪墘里,1568,1,751,9,760,1079,3,1,3,0,1,0,70.44
臺北縣,蘆洲市,樹德里,1569,1,718,11,729,1066,3,1,3,0,1,0,68.39
臺北縣,蘆洲市,樹德里,1570,1,708,12,720,1058,3,1,3,0,1,0,68.05
臺北縣,蘆洲市,得仁里,1571,1,1149,13,1162,1779,3,1,3,0,1,0,65.32
臺北縣,蘆洲市,民和里,1572,1,821,13,834,1163,3,1,3,0,1,0,71.71
臺北縣,蘆洲市,民和里,1573,1,554,11,565,796,3,1,3,0,1,0,70.98
臺北縣,蘆洲市,得勝里,1574,1,960,18,978,1374,3,1,3,0,1,0,71.18
臺北縣,蘆洲市,得勝里,1575,1,932,7,939,1301,3,1,3,0,1,0,72.18
臺北縣,蘆洲市,仁復里,1576,1,1027,16,1043,1474,3,1,3,0,1,0,70.76
臺北縣,蘆洲市,保和里,1577,1,1114,14,1128,1665,3,1,3,0,1,0,67.75
臺北縣,蘆洲市,仁德里,1578,1,994,14,1008,1545,3,1,3,0,1,0,65.24
臺北縣,蘆洲市,仁德里,1579,1,1016,13,1029,1562,3,1,3,0,1,0,65.88
臺北縣,蘆洲市,仁義里,1580,1,1020,11,1031,1668,3,1,3,0,1,0,61.81
臺北縣,蘆洲市,水河里,1581,1,952,33,985,1519,3,1,3,0,1,0,64.85
臺北縣,蘆洲市,水河里,1582,1,1032,13,1045,1568,3,1,3,0,1,0,66.65
臺北縣,蘆洲市,水湳里,1583,1,981,20,1001,1574,3,1,3,0,1,0,63.60
臺北縣,蘆洲市,水湳里,1584,1,1086,19,1105,1740,3,1,3,0,1,0,63.51
臺北縣,蘆洲市,保新里,1585,1,600,12,612,922,3,1,3,0,1,0,66.38
臺北縣,蘆洲市,保新里,1586,1,766,18,784,1102,3,1,3,0,1,0,71.14
臺北縣,蘆洲市,忠孝里,1587,1,811,17,828,1291,3,1,3,0,1,0,64.14
臺北縣,蘆洲市,仁愛里,1588,1,704,12,716,1108,3,1,3,0,1,0,64.62
臺北縣,蘆洲市,仁愛里,1589,1,881,14,895,1290,3,1,3,0,1,0,69.38
臺北縣,蘆洲市,保佑里,1590,1,845,14,859,1286,3,1,3,0,1,0,66.80
臺北縣,蘆洲市,保佑里,1591,1,795,9,804,1210,3,1,3,0,1,0,66.45
臺北縣,五股鄉,興珍村,1592,1,717,15,732,1084,3,1,3,0,1,0,67.53
臺北縣,五股鄉,興珍村,1593,1,672,10,682,960,3,1,3,0,1,0,71.04
臺北縣,五股鄉,興珍村,1594,1,810,10,820,1238,3,1,3,0,1,0,66.24
臺北縣,五股鄉,更寮村,1595,1,750,18,768,1073,3,1,3,0,1,0,71.58
臺北縣,五股鄉,集福村,1596,1,469,7,476,726,3,1,3,0,1,0,65.56
臺北縣,五股鄉,集福村,1597,1,492,9,501,781,3,1,3,0,1,0,64.15
臺北縣,五股鄉,集福村,1598,1,521,8,529,887,3,1,3,0,1,0,59.64
臺北縣,五股鄉,觀音村,1599,1,767,13,780,1141,3,1,3,0,1,0,68.36
臺北縣,五股鄉,成德村,1600,1,659,16,675,1035,3,1,3,0,1,0,65.22
臺北縣,五股鄉,成德村,1601,1,709,11,720,1074,3,1,3,0,1,0,67.04
臺北縣,五股鄉,成州村,1602,1,802,9,811,1165,3,1,3,0,1,0,69.61
臺北縣,五股鄉,成州村,1603,1,625,10,635,980,3,1,3,0,1,0,64.80
臺北縣,五股鄉,成州村,1604,1,655,9,664,1070,3,1,3,0,1,0,62.06
臺北縣,五股鄉,成功村,1605,1,825,14,839,1450,3,1,3,0,1,0,57.86
臺北縣,五股鄉,成功村,1606,1,710,11,721,1205,3,1,3,0,1,0,59.83
臺北縣,五股鄉,成功村,1607,1,556,7,563,931,3,1,3,0,1,0,60.47
臺北縣,五股鄉,五福村,1608,1,823,8,831,1277,3,1,3,0,1,0,65.07
臺北縣,五股鄉,五福村,1609,1,967,16,983,1494,3,1,3,0,1,0,65.80
臺北縣,五股鄉,五福村,1610,1,492,10,502,787,3,1,3,0,1,0,63.79
臺北縣,五股鄉,五龍村,1611,1,606,9,615,873,3,1,3,0,1,0,70.45
臺北縣,五股鄉,五股村,1612,1,689,13,702,1004,3,1,3,0,1,0,69.92
臺北縣,五股鄉,五股村,1613,1,742,5,747,1034,3,1,3,0,1,0,72.24
臺北縣,五股鄉,五股村,1614,1,636,2,638,895,3,1,3,0,1,0,71.28
臺北縣,五股鄉,五股村,1615,1,630,6,636,901,3,1,3,0,1,0,70.59
臺北縣,五股鄉,德音村,1616,1,1002,9,1011,1489,3,1,3,0,1,0,67.90
臺北縣,五股鄉,德音村,1617,1,614,8,622,944,3,1,3,0,1,0,65.89
臺北縣,五股鄉,德音村,1618,1,742,14,756,1116,3,1,3,0,1,0,67.74
臺北縣,五股鄉,德音村,1619,1,635,9,644,935,3,1,3,0,1,0,68.88
臺北縣,五股鄉,德泰村,1620,1,801,17,818,1250,3,1,3,0,1,0,65.44
臺北縣,五股鄉,德泰村,1621,1,682,8,690,978,3,1,3,0,1,0,70.55
臺北縣,五股鄉,陸一村,1622,1,841,13,854,1126,3,1,3,0,1,0,75.84
臺北縣,五股鄉,陸一村,1623,1,784,12,796,1075,3,1,3,0,1,0,74.05
臺北縣,五股鄉,貿商村,1624,1,883,10,893,1174,3,1,3,0,1,0,76.06
臺北縣,泰山鄉,大科村,1625,1,381,8,389,582,3,1,3,0,1,0,66.84
臺北縣,泰山鄉,大科村,1626,1,193,2,195,280,3,1,3,0,1,0,69.64
臺北縣,泰山鄉,黎明村,1627,1,495,11,506,770,3,1,3,0,1,0,65.71
臺北縣,泰山鄉,黎明村,1628,1,419,6,425,674,3,1,3,0,1,0,63.06
臺北縣,泰山鄉,黎明村,1629,1,434,6,440,567,3,1,3,0,1,0,77.60
臺北縣,泰山鄉,山腳村,1630,1,677,10,687,1056,3,1,3,0,1,0,65.06
臺北縣,泰山鄉,山腳村,1631,1,677,18,695,1046,3,1,3,0,1,0,66.44
臺北縣,泰山鄉,山腳村,1632,1,634,8,642,1051,3,1,3,0,1,0,61.08
臺北縣,泰山鄉,山腳村,1633,1,543,6,549,792,3,1,3,0,1,0,69.32
臺北縣,泰山鄉,福泰村,1634,1,693,5,698,1023,3,1,3,0,1,0,68.23
臺北縣,泰山鄉,福泰村,1635,1,624,15,639,938,3,1,3,0,1,0,68.12
臺北縣,泰山鄉,福泰村,1636,1,638,13,651,916,3,1,3,0,1,0,71.07
臺北縣,泰山鄉,福泰村,1637,1,627,9,636,904,3,1,3,0,1,0,70.35
臺北縣,泰山鄉,楓樹村,1638,1,525,2,527,787,3,1,3,0,1,0,66.96
臺北縣,泰山鄉,楓樹村,1639,1,526,9,535,807,3,1,3,0,1,0,66.29
臺北縣,泰山鄉,楓樹村,1640,1,591,9,600,851,3,1,3,0,1,0,70.51
臺北縣,泰山鄉,同榮村,1641,1,846,6,852,1229,3,1,3,0,1,0,69.32
臺北縣,泰山鄉,同榮村,1642,1,787,11,798,1188,3,1,3,0,1,0,67.17
臺北縣,泰山鄉,同興村,1643,1,689,7,696,914,3,1,3,0,1,0,76.15
臺北縣,泰山鄉,同興村,1644,1,584,8,592,817,3,1,3,0,1,0,72.46
臺北縣,泰山鄉,義學村,1645,1,820,13,833,1192,3,1,3,0,1,0,69.88
臺北縣,泰山鄉,義學村,1646,1,729,7,736,1046,3,1,3,0,1,0,70.36
臺北縣,泰山鄉,義仁村,1647,1,857,11,868,1286,3,1,3,0,1,0,67.50
臺北縣,泰山鄉,義仁村,1648,1,923,6,929,1378,3,1,3,0,1,0,67.42
臺北縣,泰山鄉,明志村,1649,1,757,15,772,1201,3,1,3,0,1,0,64.28
臺北縣,泰山鄉,明志村,1650,1,819,12,831,1190,3,1,3,0,1,0,69.83
臺北縣,泰山鄉,泰友村,1651,1,490,6,496,756,3,1,3,0,1,0,65.61
臺北縣,泰山鄉,泰友村,1652,1,557,7,564,856,3,1,3,0,1,0,65.89
臺北縣,泰山鄉,新明村,1653,1,710,12,722,1058,3,1,3,0,1,0,68.24
臺北縣,泰山鄉,新明村,1654,1,726,13,739,1082,3,1,3,0,1,0,68.30
臺北縣,泰山鄉,貴子村,1655,1,573,9,582,869,3,1,3,0,1,0,66.97
臺北縣,泰山鄉,貴子村,1656,1,561,6,567,875,3,1,3,0,1,0,64.80
臺北縣,泰山鄉,貴子村,1657,1,494,6,500,765,3,1,3,0,1,0,65.36
臺北縣,泰山鄉,貴賢村,1658,1,776,6,782,1069,3,1,3,0,1,0,73.15
臺北縣,泰山鄉,貴賢村,1659,1,880,20,900,1266,3,1,3,0,1,0,71.09
臺北縣,泰山鄉,貴和村,1660,1,653,9,662,938,3,1,3,0,1,0,70.58
臺北縣,泰山鄉,貴和村,1661,1,614,8,622,897,3,1,3,0,1,0,69.34
臺北縣,泰山鄉,貴和村,1662,1,610,8,618,976,3,1,3,0,1,0,63.32
臺北縣,林口鄉,東林村,1663,1,708,5,713,1056,3,1,3,0,1,0,67.52
臺北縣,林口鄉,東林村,1664,1,577,3,580,870,3,1,3,0,1,0,66.67
臺北縣,林口鄉,東林村,1665,1,761,9,770,1145,3,1,3,0,1,0,67.25
臺北縣,林口鄉,林口村,1666,1,974,15,989,1671,3,1,3,0,1,0,59.19
臺北縣,林口鄉,林口村,1667,1,979,11,990,1330,3,1,3,0,1,0,74.44
臺北縣,林口鄉,西林村,1668,1,915,23,938,1360,3,1,3,0,1,0,68.97
臺北縣,林口鄉,西林村,1669,1,927,10,937,1387,3,1,3,0,1,0,67.56
臺北縣,林口鄉,菁湖村,1670,1,940,16,956,1294,3,1,3,0,1,0,73.88
臺北縣,林口鄉,菁湖村,1671,1,918,23,941,1265,3,1,3,0,1,0,74.39
臺北縣,林口鄉,中湖村,1672,1,854,9,863,1198,3,1,3,0,1,0,72.04
臺北縣,林口鄉,中湖村,1673,1,825,9,834,1115,3,1,3,0,1,0,74.80
臺北縣,林口鄉,湖北村,1674,1,761,14,775,1049,3,1,3,0,1,0,73.88
臺北縣,林口鄉,湖南村,1675,1,953,22,975,1303,3,1,3,0,1,0,74.83
臺北縣,林口鄉,南勢村,1676,1,616,9,625,911,3,1,3,0,1,0,68.61
臺北縣,林口鄉,南勢村,1677,1,1239,17,1256,2067,3,1,3,0,1,0,60.76
臺北縣,林口鄉,東勢村,1678,1,954,13,967,1549,3,1,3,0,1,0,62.43
臺北縣,林口鄉,東勢村,1679,1,741,12,753,1114,3,1,3,0,1,0,67.59
臺北縣,林口鄉,頂福村,1680,1,669,7,676,895,3,1,3,0,1,0,75.53
臺北縣,林口鄉,下福村,1681,1,686,9,695,904,3,1,3,0,1,0,76.88
臺北縣,林口鄉,嘉寶村,1682,1,467,8,475,608,3,1,3,0,1,0,78.13
臺北縣,林口鄉,瑞平村,1683,1,345,8,353,472,3,1,3,0,1,0,74.79
臺北縣,林口鄉,太平村,1684,1,499,5,504,783,3,1,3,0,1,0,64.37
臺北縣,深坑鄉,深坑村,1685,1,887,9,896,1282,3,1,3,0,1,0,69.89
臺北縣,深坑鄉,深坑村,1686,1,942,16,958,1444,3,1,3,0,1,0,66.34
臺北縣,深坑鄉,深坑村,1687,1,988,9,997,1445,3,1,3,0,1,0,69.00
臺北縣,深坑鄉,萬順村,1688,1,686,13,699,1004,3,1,3,0,1,0,69.62
臺北縣,深坑鄉,萬順村,1689,1,706,13,719,1075,3,1,3,0,1,0,66.88
臺北縣,深坑鄉,萬順村,1690,1,630,15,645,986,3,1,3,0,1,0,65.42
臺北縣,深坑鄉,土庫村,1691,1,941,22,963,1418,3,1,3,0,1,0,67.91
臺北縣,深坑鄉,土庫村,1692,1,814,8,822,1229,3,1,3,0,1,0,66.88
臺北縣,深坑鄉,昇高村,1693,1,766,10,776,1157,3,1,3,0,1,0,67.07
臺北縣,深坑鄉,阿柔村,1694,1,311,3,314,432,3,1,3,0,1,0,72.69
臺北縣,石碇鄉,石碇村,1695,1,294,2,296,395,3,1,3,0,1,0,74.94
臺北縣,石碇鄉,潭邊村,1696,1,417,6,423,622,3,1,3,0,1,0,68.01
臺北縣,石碇鄉,烏塗村,1697,1,399,10,409,569,3,1,3,0,1,0,71.88
臺北縣,石碇鄉,彭山村,1698,1,173,0,173,256,3,1,3,0,1,0,67.58
臺北縣,石碇鄉,豐田村,1699,1,245,5,250,366,3,1,3,0,1,0,68.31
臺北縣,石碇鄉,隆盛村,1700,1,488,16,504,709,3,1,3,0,1,0,71.09
臺北縣,石碇鄉,豐林村,1701,1,175,1,176,254,3,1,3,0,1,0,69.29
臺北縣,石碇鄉,中民村,1702,1,544,14,558,756,3,1,3,0,1,0,73.81
臺北縣,石碇鄉,永定村,1703,1,374,4,378,530,3,1,3,0,1,0,71.32
臺北縣,石碇鄉,光明村,1704,1,137,1,138,203,3,1,3,0,1,0,67.98
臺北縣,石碇鄉,永安村,1705,1,268,3,271,399,3,1,3,0,1,0,67.92
臺北縣,石碇鄉,格頭村,1706,1,400,6,406,572,3,1,3,0,1,0,70.98
臺北縣,石碇鄉,碧山村,1707,1,214,4,218,379,3,1,3,0,1,0,57.52
臺北縣,坪林鄉,坪林村,1708,1,676,3,679,944,3,1,3,0,1,0,71.93
臺北縣,坪林鄉,水德村,1709,1,301,0,301,468,3,1,3,0,1,0,64.32
臺北縣,坪林鄉,大林村,1710,1,498,5,503,878,3,1,3,0,1,0,57.29
臺北縣,坪林鄉,石曹村,1711,1,219,2,221,369,3,1,3,0,1,0,59.89
臺北縣,坪林鄉,粗窟村,1712,1,287,9,296,460,3,1,3,0,1,0,64.35
臺北縣,坪林鄉,粗窟村,1713,1,113,1,114,194,3,1,3,0,1,0,58.76
臺北縣,坪林鄉,上德村,1714,1,223,3,226,332,3,1,3,0,1,0,68.07
臺北縣,坪林鄉,上德村,1715,1,221,1,222,370,3,1,3,0,1,0,60.00
臺北縣,坪林鄉,漁光村,1716,1,174,4,178,306,3,1,3,0,1,0,58.17
臺北縣,坪林鄉,漁光村,1717,1,193,2,195,296,3,1,3,0,1,0,65.88
臺北縣,三芝鄉,八賢村,1718,1,228,3,231,312,3,1,3,0,1,0,74.04
臺北縣,三芝鄉,埔頭村,1719,1,960,29,989,1379,3,1,3,0,1,0,71.72
臺北縣,三芝鄉,埔頭村,1720,1,766,6,772,1091,3,1,3,0,1,0,70.76
臺北縣,三芝鄉,古庄村,1721,1,532,8,540,733,3,1,3,0,1,0,73.67
臺北縣,三芝鄉,新庄村,1722,1,535,11,546,783,3,1,3,0,1,0,69.73
臺北縣,三芝鄉,埔坪村,1723,1,1251,16,1267,1777,3,1,3,0,1,0,71.30
臺北縣,三芝鄉,埔坪村,1724,1,937,24,961,1356,3,1,3,0,1,0,70.87
臺北縣,三芝鄉,茂長村,1725,1,234,3,237,359,3,1,3,0,1,0,66.02
臺北縣,三芝鄉,橫山村,1726,1,406,1,407,549,3,1,3,0,1,0,74.13
臺北縣,三芝鄉,錫板村,1727,1,527,8,535,784,3,1,3,0,1,0,68.24
臺北縣,三芝鄉,後厝村,1728,1,805,12,817,1093,3,1,3,0,1,0,74.75
臺北縣,三芝鄉,福德村,1729,1,332,16,348,463,3,1,3,0,1,0,75.16
臺北縣,三芝鄉,圓山村,1730,1,311,3,314,465,3,1,3,0,1,0,67.53
臺北縣,三芝鄉,店子村,1731,1,419,7,426,634,3,1,3,0,1,0,67.19
臺北縣,三芝鄉,興華村,1732,1,713,19,732,1051,3,1,3,0,1,0,69.65
臺北縣,石門鄉,德茂村,1733,1,505,7,512,692,3,1,3,0,1,0,73.99
臺北縣,石門鄉,富基村,1734,1,681,11,692,940,3,1,3,0,1,0,73.62
臺北縣,石門鄉,老梅村,1735,1,989,27,1016,1453,3,1,3,0,1,0,69.92
臺北縣,石門鄉,山溪村,1736,1,384,5,389,579,3,1,3,0,1,0,67.18
臺北縣,石門鄉,石門村,1737,1,710,9,719,1026,3,1,3,0,1,0,70.08
臺北縣,石門鄉,尖鹿村,1738,1,763,8,771,1074,3,1,3,0,1,0,71.79
臺北縣,石門鄉,乾華村,1739,1,135,1,136,212,3,1,3,0,1,0,64.15
臺北縣,石門鄉,茂林村,1740,1,327,2,329,427,3,1,3,0,1,0,77.05
臺北縣,石門鄉,草里村,1741,1,411,6,417,618,3,1,3,0,1,0,67.48
臺北縣,八里鄉,龍源村,1742,1,1033,21,1054,1512,3,1,3,0,1,0,69.71
臺北縣,八里鄉,龍源村,1743,1,774,16,790,1128,3,1,3,0,1,0,70.04
臺北縣,八里鄉,米倉村,1744,1,1120,25,1145,1665,3,1,3,0,1,0,68.77
臺北縣,八里鄉,大崁村,1745,1,671,15,686,928,3,1,3,0,1,0,73.92
臺北縣,八里鄉,埤頭村,1746,1,1023,27,1050,1561,3,1,3,0,1,0,67.26
臺北縣,八里鄉,頂罟村,1747,1,563,15,578,780,3,1,3,0,1,0,74.10
臺北縣,八里鄉,舊城村,1748,1,721,10,731,1103,3,1,3,0,1,0,66.27
臺北縣,八里鄉,舊城村,1749,1,565,7,572,837,3,1,3,0,1,0,68.34
臺北縣,八里鄉,訊塘村,1750,1,621,15,636,926,3,1,3,0,1,0,68.68
臺北縣,八里鄉,訊塘村,1751,1,671,15,686,929,3,1,3,0,1,0,73.84
臺北縣,八里鄉,荖阡村,1752,1,625,10,635,882,3,1,3,0,1,0,72.00
臺北縣,八里鄉,下罟村,1753,1,748,12,760,922,3,1,3,0,1,0,82.43
臺北縣,八里鄉,長坑村,1754,1,734,12,746,1005,3,1,3,0,1,0,74.23
臺北縣,平溪鄉,薯榔村,1755,1,336,3,339,457,3,1,3,0,1,0,74.18
臺北縣,平溪鄉,菁桐村,1756,1,239,1,240,315,3,1,3,0,1,0,76.19
臺北縣,平溪鄉,白石村,1757,1,266,8,274,352,3,1,3,0,1,0,77.84
臺北縣,平溪鄉,石底村,1758,1,381,4,385,564,3,1,3,0,1,0,68.26
臺北縣,平溪鄉,平溪村,1759,1,238,2,240,326,3,1,3,0,1,0,73.62
臺北縣,平溪鄉,嶺腳村,1760,1,536,1,537,717,3,1,3,0,1,0,74.90
臺北縣,平溪鄉,東勢村,1761,1,239,5,244,350,3,1,3,0,1,0,69.71
臺北縣,平溪鄉,十分村,1762,1,813,7,820,1185,3,1,3,0,1,0,69.20
臺北縣,平溪鄉,望古村,1763,1,72,1,73,103,3,1,3,0,1,0,70.87
臺北縣,平溪鄉,南山村,1764,1,366,8,374,530,3,1,3,0,1,0,70.57
臺北縣,平溪鄉,新寮村,1765,1,105,2,107,171,3,1,3,0,1,0,62.57
臺北縣,平溪鄉,平湖村,1766,1,80,0,80,120,3,1,3,0,1,0,66.67
臺北縣,雙溪鄉,雙溪村,1767,1,460,6,466,623,3,1,3,0,1,0,74.80
臺北縣,雙溪鄉,新基村,1768,1,270,3,273,348,3,1,3,0,1,0,78.45
臺北縣,雙溪鄉,新基村,1769,1,503,8,511,701,3,1,3,0,1,0,72.90
臺北縣,雙溪鄉,三港村,1770,1,321,5,326,477,3,1,3,0,1,0,68.34
臺北縣,雙溪鄉,牡丹村,1771,1,805,7,812,1139,3,1,3,0,1,0,71.29
臺北縣,雙溪鄉,牡丹村,1772,1,629,6,635,820,3,1,3,0,1,0,77.44
臺北縣,雙溪鄉,三貂村,1773,1,223,4,227,325,3,1,3,0,1,0,69.85
臺北縣,雙溪鄉,平林村,1774,1,454,2,456,598,3,1,3,0,1,0,76.25
臺北縣,雙溪鄉,平林村,1775,1,210,1,211,294,3,1,3,0,1,0,71.77
臺北縣,雙溪鄉,上林村,1776,1,540,6,546,763,3,1,3,0,1,0,71.56
臺北縣,雙溪鄉,外柑村,1777,1,308,2,310,526,3,1,3,0,1,0,58.94
臺北縣,雙溪鄉,長源村,1778,1,292,1,293,395,3,1,3,0,1,0,74.18
臺北縣,雙溪鄉,共和村,1779,1,382,4,386,517,3,1,3,0,1,0,74.66
臺北縣,雙溪鄉,魚行村,1780,1,214,4,218,316,3,1,3,0,1,0,68.99
臺北縣,雙溪鄉,魚行村,1781,1,213,0,213,298,3,1,3,0,1,0,71.48
臺北縣,雙溪鄉,泰平村,1782,1,127,0,127,209,3,1,3,0,1,0,60.77
臺北縣,雙溪鄉,泰平村,1783,1,75,0,75,94,3,1,3,0,1,0,79.79
臺北縣,貢寮鄉,貢寮村,1784,1,701,10,711,968,3,1,3,0,1,0,73.45
臺北縣,貢寮鄉,龍崗村,1785,1,276,7,283,422,3,1,3,0,1,0,67.06
臺北縣,貢寮鄉,吉林村,1786,1,259,4,263,414,3,1,3,0,1,0,63.53
臺北縣,貢寮鄉,雙玉村,1787,1,314,3,317,451,3,1,3,0,1,0,70.29
臺北縣,貢寮鄉,雙玉村,1788,1,243,6,249,356,3,1,3,0,1,0,69.94
臺北縣,貢寮鄉,福隆村,1789,1,588,13,601,841,3,1,3,0,1,0,71.46
臺北縣,貢寮鄉,福隆村,1790,1,497,10,507,686,3,1,3,0,1,0,73.91
臺北縣,貢寮鄉,福連村,1791,1,455,7,462,730,3,1,3,0,1,0,63.29
臺北縣,貢寮鄉,龍門村,1792,1,435,5,440,652,3,1,3,0,1,0,67.48
臺北縣,貢寮鄉,仁里村,1793,1,1003,13,1016,1392,3,1,3,0,1,0,72.99
臺北縣,貢寮鄉,真理村,1794,1,722,9,731,1044,3,1,3,0,1,0,70.02
臺北縣,貢寮鄉,真理村,1795,1,501,9,510,765,3,1,3,0,1,0,66.67
臺北縣,貢寮鄉,美豐村,1796,1,273,2,275,407,3,1,3,0,1,0,67.57
臺北縣,貢寮鄉,美豐村,1797,1,258,2,260,412,3,1,3,0,1,0,63.11
臺北縣,貢寮鄉,和美村,1798,1,294,5,299,473,3,1,3,0,1,0,63.21
臺北縣,貢寮鄉,和美村,1799,1,264,3,267,443,3,1,3,0,1,0,60.27
臺北縣,金山鄉,和平村,1800,1,289,5,294,425,3,1,3,0,1,0,69.18
臺北縣,金山鄉,大同村,1801,1,493,7,500,674,3,1,3,0,1,0,74.18
臺北縣,金山鄉,豐漁村,1802,1,292,3,295,441,3,1,3,0,1,0,66.89
臺北縣,金山鄉,磺港村,1803,1,861,6,867,1342,3,1,3,0,1,0,64.61
臺北縣,金山鄉,美田村,1804,1,1027,12,1039,1406,3,1,3,0,1,0,73.90
臺北縣,金山鄉,美田村,1805,1,1402,20,1422,2060,3,1,3,0,1,0,69.03
臺北縣,金山鄉,美田村,1806,1,1121,15,1136,1651,3,1,3,0,1,0,68.81
臺北縣,金山鄉,五湖村,1807,1,917,19,936,1355,3,1,3,0,1,0,69.08
臺北縣,金山鄉,重和村,1808,1,513,9,522,749,3,1,3,0,1,0,69.69
臺北縣,金山鄉,兩湖村,1809,1,222,7,229,338,3,1,3,0,1,0,67.75
臺北縣,金山鄉,六股村,1810,1,343,7,350,510,3,1,3,0,1,0,68.63
臺北縣,金山鄉,三界村,1811,1,373,5,378,567,3,1,3,0,1,0,66.67
臺北縣,金山鄉,清泉村,1812,1,511,12,523,753,3,1,3,0,1,0,69.46
臺北縣,金山鄉,西湖村,1813,1,141,0,141,216,3,1,3,0,1,0,65.28
臺北縣,金山鄉,萬壽村,1814,1,307,4,311,426,3,1,3,0,1,0,73.00
臺北縣,金山鄉,永興村,1815,1,330,4,334,527,3,1,3,0,1,0,63.38
臺北縣,萬里鄉,萬里村,1816,1,1012,17,1029,1443,3,1,3,0,1,0,71.31
臺北縣,萬里鄉,萬里村,1817,1,1019,19,1038,1434,3,1,3,0,1,0,72.38
臺北縣,萬里鄉,龜吼村,1818,1,421,19,440,638,3,1,3,0,1,0,68.97
臺北縣,萬里鄉,龜吼村,1819,1,641,7,648,967,3,1,3,0,1,0,67.01
臺北縣,萬里鄉,野柳村,1820,1,764,12,776,1066,3,1,3,0,1,0,72.80
臺北縣,萬里鄉,野柳村,1821,1,793,12,805,1061,3,1,3,0,1,0,75.87
臺北縣,萬里鄉,大鵬村,1822,1,434,7,441,623,3,1,3,0,1,0,70.79
臺北縣,萬里鄉,大鵬村,1823,1,996,14,1010,1462,3,1,3,0,1,0,69.08
臺北縣,萬里鄉,磺潭村,1824,1,317,7,324,474,3,1,3,0,1,0,68.35
臺北縣,萬里鄉,雙興村,1825,1,518,11,529,784,3,1,3,0,1,0,67.47
臺北縣,萬里鄉,溪底村,1826,1,341,1,342,530,3,1,3,0,1,0,64.53
臺北縣,萬里鄉,崁腳村,1827,1,352,6,358,561,3,1,3,0,1,0,63.81
臺北縣,萬里鄉,中幅村,1828,1,511,17,528,800,3,1,3,0,1,0,66.00
臺北縣,萬里鄉,北基村,1829,1,1180,22,1202,1842,3,1,3,0,1,0,65.26
臺北縣,烏來鄉,忠治村,1830,1,250,2,252,366,3,1,3,0,1,0,68.85
臺北縣,烏來鄉,烏來村,1831,1,519,7,526,773,3,1,3,0,1,0,68.05
臺北縣,烏來鄉,孝義村,1832,1,47,0,47,64,3,1,3,0,1,0,73.44
臺北縣,烏來鄉,信賢村,1833,1,95,1,96,148,3,1,3,0,1,0,64.86
臺北縣,烏來鄉,福山村,1834,1,36,0,36,54,3,1,3,0,1,0,66.67
宜蘭縣,宜蘭市,南門里,1,1,460,12,472,864,3,1,3,0,1,0,54.63
宜蘭縣,宜蘭市,負郭里,2,1,579,8,587,913,3,1,3,0,1,0,64.29
宜蘭縣,宜蘭市,負郭里,3,1,747,12,759,1257,3,1,3,0,1,0,60.38
宜蘭縣,宜蘭市,民族里,4,1,677,10,687,1172,3,1,3,0,1,0,58.62
宜蘭縣,宜蘭市,民族里,5,1,672,19,691,1158,3,1,3,0,1,0,59.67
宜蘭縣,宜蘭市,建軍里,6,1,649,12,661,1150,3,1,3,0,1,0,57.48
宜蘭縣,宜蘭市,建軍里,7,1,567,14,581,1063,3,1,3,0,1,0,54.66
宜蘭縣,宜蘭市,復興里,8,1,914,17,931,1542,3,1,3,0,1,0,60.38
宜蘭縣,宜蘭市,復興里,9,1,742,11,753,1320,3,1,3,0,1,0,57.05
宜蘭縣,宜蘭市,思源里,10,1,500,10,510,882,3,1,3,0,1,0,57.82
宜蘭縣,宜蘭市,思源里,11,1,959,21,980,1647,3,1,3,0,1,0,59.50
宜蘭縣,宜蘭市,文化里,12,1,689,8,697,1086,3,1,3,0,1,0,64.18
宜蘭縣,宜蘭市,文化里,13,1,728,23,751,1286,3,1,3,0,1,0,58.40
宜蘭縣,宜蘭市,神農里,14,1,471,5,476,794,3,1,3,0,1,0,59.95
宜蘭縣,宜蘭市,民權里,15,1,461,8,469,741,3,1,3,0,1,0,63.29
宜蘭縣,宜蘭市,民權里,16,1,373,6,379,689,3,1,3,0,1,0,55.01
宜蘭縣,宜蘭市,民生里,17,1,326,3,329,533,3,1,3,0,1,0,61.73
宜蘭縣,宜蘭市,昇平里,18,1,457,6,463,747,3,1,3,0,1,0,61.98
宜蘭縣,宜蘭市,大東里,19,1,331,4,335,569,3,1,3,0,1,0,58.88
宜蘭縣,宜蘭市,新興里,20,1,357,5,362,648,3,1,3,0,1,0,55.86
宜蘭縣,宜蘭市,和睦里,21,1,484,10,494,869,3,1,3,0,1,0,56.85
宜蘭縣,宜蘭市,和睦里,22,1,583,14,597,1125,3,1,3,0,1,0,53.07
宜蘭縣,宜蘭市,進士里,23,1,958,14,972,1646,3,1,3,0,1,0,59.05
宜蘭縣,宜蘭市,進士里,24,1,396,7,403,624,3,1,3,0,1,0,64.58
宜蘭縣,宜蘭市,進士里,25,1,776,14,790,1313,3,1,3,0,1,0,60.17
宜蘭縣,宜蘭市,南橋里,26,1,275,1,276,511,3,1,3,0,1,0,54.01
宜蘭縣,宜蘭市,建業里,27,1,519,7,526,1047,3,1,3,0,1,0,50.24
宜蘭縣,宜蘭市,南津里,28,1,406,7,413,763,3,1,3,0,1,0,54.13
宜蘭縣,宜蘭市,凱旋里,29,1,634,5,639,1169,3,1,3,0,1,0,54.66
宜蘭縣,宜蘭市,黎明里,30,1,618,12,630,1098,3,1,3,0,1,0,57.38
宜蘭縣,宜蘭市,東村里,31,1,674,20,694,1212,3,1,3,0,1,0,57.26
宜蘭縣,宜蘭市,東村里,32,1,927,14,941,1643,3,1,3,0,1,0,57.27
宜蘭縣,宜蘭市,延平里,33,1,599,14,613,1027,3,1,3,0,1,0,59.69
宜蘭縣,宜蘭市,延平里,34,1,535,4,539,948,3,1,3,0,1,0,56.86
宜蘭縣,宜蘭市,延平里,35,1,506,11,517,975,3,1,3,0,1,0,53.03
宜蘭縣,宜蘭市,七張里,36,1,606,3,609,1007,3,1,3,0,1,0,60.48
宜蘭縣,宜蘭市,慈安里,37,1,737,9,746,1404,3,1,3,0,1,0,53.13
宜蘭縣,宜蘭市,慈安里,38,1,491,8,499,944,3,1,3,0,1,0,52.86
宜蘭縣,宜蘭市,慈安里,39,1,648,15,663,1241,3,1,3,0,1,0,53.42
宜蘭縣,宜蘭市,新民里,40,1,409,7,416,669,3,1,3,0,1,0,62.18
宜蘭縣,宜蘭市,東門里,41,1,375,7,382,590,3,1,3,0,1,0,64.75
宜蘭縣,宜蘭市,中正里,42,1,456,5,461,703,3,1,3,0,1,0,65.58
宜蘭縣,宜蘭市,小東里,43,1,748,21,769,1330,3,1,3,0,1,0,57.82
宜蘭縣,宜蘭市,菜園里,44,1,797,11,808,1346,3,1,3,0,1,0,60.03
宜蘭縣,宜蘭市,孝廉里,45,1,664,5,669,1152,3,1,3,0,1,0,58.07
宜蘭縣,宜蘭市,新生里,46,1,655,5,660,1215,3,1,3,0,1,0,54.32
宜蘭縣,宜蘭市,新生里,47,1,433,9,442,796,3,1,3,0,1,0,55.53
宜蘭縣,宜蘭市,茭白里,48,1,763,9,772,1490,3,1,3,0,1,0,51.81
宜蘭縣,宜蘭市,北津里,49,1,691,12,703,1257,3,1,3,0,1,0,55.93
宜蘭縣,宜蘭市,梅洲里,50,1,745,10,755,1295,3,1,3,0,1,0,58.30
宜蘭縣,宜蘭市,梅洲里,51,1,550,8,558,977,3,1,3,0,1,0,57.11
宜蘭縣,宜蘭市,北門里,52,1,543,10,553,977,3,1,3,0,1,0,56.60
宜蘭縣,宜蘭市,慶和里,53,1,521,15,536,818,3,1,3,0,1,0,65.53
宜蘭縣,宜蘭市,鄂王里,54,1,510,7,517,866,3,1,3,0,1,0,59.70
宜蘭縣,宜蘭市,西門里,55,1,768,10,778,1302,3,1,3,0,1,0,59.75
宜蘭縣,宜蘭市,中山里,56,1,520,5,525,891,3,1,3,0,1,0,58.92
宜蘭縣,宜蘭市,大道里,57,1,748,11,759,1369,3,1,3,0,1,0,55.44
宜蘭縣,羅東鎮,開羅里,58,1,312,0,312,474,3,1,3,0,1,0,65.82
宜蘭縣,羅東鎮,開元里,59,1,385,6,391,594,3,1,3,0,1,0,65.82
宜蘭縣,羅東鎮,東明里,60,1,338,3,341,581,3,1,3,0,1,0,58.69
宜蘭縣,羅東鎮,大新里,61,1,657,6,663,1179,3,1,3,0,1,0,56.23
宜蘭縣,羅東鎮,東安里,62,1,847,14,861,1467,3,1,3,0,1,0,58.69
宜蘭縣,羅東鎮,新群里,63,1,582,4,586,935,3,1,3,0,1,0,62.67
宜蘭縣,羅東鎮,新群里,64,1,445,8,453,772,3,1,3,0,1,0,58.68
宜蘭縣,羅東鎮,羅莊里,65,1,586,6,592,1138,3,1,3,0,1,0,52.02
宜蘭縣,羅東鎮,南昌里,66,1,665,12,677,1123,3,1,3,0,1,0,60.28
宜蘭縣,羅東鎮,南昌里,67,1,572,14,586,981,3,1,3,0,1,0,59.73
宜蘭縣,羅東鎮,南豪里,68,1,804,7,811,1395,3,1,3,0,1,0,58.14
宜蘭縣,羅東鎮,成功里,69,1,759,9,768,1228,3,1,3,0,1,0,62.54
宜蘭縣,羅東鎮,仁德里,70,1,522,5,527,862,3,1,3,0,1,0,61.14
宜蘭縣,羅東鎮,居仁里,71,1,424,4,428,709,3,1,3,0,1,0,60.37
宜蘭縣,羅東鎮,義和里,72,1,559,2,561,974,3,1,3,0,1,0,57.60
宜蘭縣,羅東鎮,羅東里,73,1,425,5,430,707,3,1,3,0,1,0,60.82
宜蘭縣,羅東鎮,浮崙里,74,1,438,11,449,713,3,1,3,0,1,0,62.97
宜蘭縣,羅東鎮,漢民里,75,1,629,7,636,1062,3,1,3,0,1,0,59.89
宜蘭縣,羅東鎮,漢民里,76,1,690,9,699,1260,3,1,3,0,1,0,55.48
宜蘭縣,羅東鎮,漢民里,77,1,601,8,609,1092,3,1,3,0,1,0,55.77
宜蘭縣,羅東鎮,西安里,78,1,480,6,486,839,3,1,3,0,1,0,57.93
宜蘭縣,羅東鎮,西安里,79,1,636,8,644,1089,3,1,3,0,1,0,59.14
宜蘭縣,羅東鎮,西安里,80,1,599,6,605,1018,3,1,3,0,1,0,59.43
宜蘭縣,羅東鎮,西安里,81,1,635,7,642,1162,3,1,3,0,1,0,55.25
宜蘭縣,羅東鎮,北成里,82,1,785,7,792,1359,3,1,3,0,1,0,58.28
宜蘭縣,羅東鎮,北成里,83,1,717,9,726,1227,3,1,3,0,1,0,59.17
宜蘭縣,羅東鎮,北成里,84,1,738,9,747,1283,3,1,3,0,1,0,58.22
宜蘭縣,羅東鎮,賢文里,85,1,703,8,711,1305,3,1,3,0,1,0,54.48
宜蘭縣,羅東鎮,賢文里,86,1,553,6,559,970,3,1,3,0,1,0,57.63
宜蘭縣,羅東鎮,賢文里,87,1,606,6,612,1034,3,1,3,0,1,0,59.19
宜蘭縣,羅東鎮,公正里,88,1,491,6,497,891,3,1,3,0,1,0,55.78
宜蘭縣,羅東鎮,公正里,89,1,451,5,456,829,3,1,3,0,1,0,55.01
宜蘭縣,羅東鎮,集祥里,90,1,571,8,579,1004,3,1,3,0,1,0,57.67
宜蘭縣,羅東鎮,信義里,91,1,754,9,763,1290,3,1,3,0,1,0,59.15
宜蘭縣,羅東鎮,信義里,92,1,696,14,710,1228,3,1,3,0,1,0,57.82
宜蘭縣,羅東鎮,樹林里,93,1,811,9,820,1427,3,1,3,0,1,0,57.46
宜蘭縣,羅東鎮,樹林里,94,1,771,8,779,1370,3,1,3,0,1,0,56.86
宜蘭縣,羅東鎮,竹林里,95,1,789,15,804,1336,3,1,3,0,1,0,60.18
宜蘭縣,羅東鎮,竹林里,96,1,663,11,674,1219,3,1,3,0,1,0,55.29
宜蘭縣,羅東鎮,仁愛里,97,1,621,7,628,1025,3,1,3,0,1,0,61.27
宜蘭縣,羅東鎮,仁愛里,98,1,563,7,570,1016,3,1,3,0,1,0,56.10
宜蘭縣,蘇澳鎮,龍德里,99,1,664,7,671,1214,3,1,3,0,1,0,55.27
宜蘭縣,蘇澳鎮,龍德里,100,1,848,10,858,1574,3,1,3,0,1,0,54.51
宜蘭縣,蘇澳鎮,頂寮里,101,1,392,4,396,688,3,1,3,0,1,0,57.56
宜蘭縣,蘇澳鎮,永榮里,102,1,700,9,709,1269,3,1,3,0,1,0,55.87
宜蘭縣,蘇澳鎮,永榮里,103,1,713,6,719,1247,3,1,3,0,1,0,57.66
宜蘭縣,蘇澳鎮,存仁里,104,1,365,2,367,637,3,1,3,0,1,0,57.61
宜蘭縣,蘇澳鎮,存仁里,105,1,242,2,244,449,3,1,3,0,1,0,54.34
宜蘭縣,蘇澳鎮,港邊里,106,1,491,4,495,924,3,1,3,0,1,0,53.57
宜蘭縣,蘇澳鎮,港邊里,107,1,276,2,278,449,3,1,3,0,1,0,61.92
宜蘭縣,蘇澳鎮,岳明里,108,1,129,15,144,390,3,1,3,0,1,0,36.92
宜蘭縣,蘇澳鎮,隘丁里,109,1,565,6,571,976,3,1,3,0,1,0,58.50
宜蘭縣,蘇澳鎮,隘丁里,110,1,508,3,511,930,3,1,3,0,1,0,54.95
宜蘭縣,蘇澳鎮,新城里,111,1,529,7,536,1024,3,1,3,0,1,0,52.34
宜蘭縣,蘇澳鎮,聖湖里,112,1,715,13,728,1342,3,1,3,0,1,0,54.25
宜蘭縣,蘇澳鎮,聖湖里,113,1,832,14,846,1621,3,1,3,0,1,0,52.19
宜蘭縣,蘇澳鎮,聖湖里,114,1,757,5,762,1415,3,1,3,0,1,0,53.85
宜蘭縣,蘇澳鎮,蘇西里,115,1,676,5,681,1250,3,1,3,0,1,0,54.48
宜蘭縣,蘇澳鎮,蘇西里,116,1,524,8,532,936,3,1,3,0,1,0,56.84
宜蘭縣,蘇澳鎮,蘇北里,117,1,731,6,737,1315,3,1,3,0,1,0,56.05
宜蘭縣,蘇澳鎮,蘇南里,118,1,357,3,360,632,3,1,3,0,1,0,56.96
宜蘭縣,蘇澳鎮,蘇東里,119,1,293,7,300,607,3,1,3,0,1,0,49.42
宜蘭縣,蘇澳鎮,長安里,120,1,366,8,374,664,3,1,3,0,1,0,56.33
宜蘭縣,蘇澳鎮,永光里,121,1,415,6,421,678,3,1,3,0,1,0,62.09
宜蘭縣,蘇澳鎮,永春里,122,1,363,13,376,703,3,1,3,0,1,0,53.49
宜蘭縣,蘇澳鎮,永樂里,123,1,352,5,357,568,3,1,3,0,1,0,62.85
宜蘭縣,蘇澳鎮,南安里,124,1,613,9,622,1209,3,1,3,0,1,0,51.45
宜蘭縣,蘇澳鎮,南正里,125,1,573,10,583,1185,3,1,3,0,1,0,49.20
宜蘭縣,蘇澳鎮,南成里,126,1,614,11,625,1344,3,1,3,0,1,0,46.50
宜蘭縣,蘇澳鎮,南興里,127,1,422,3,425,916,3,1,3,0,1,0,46.40
宜蘭縣,蘇澳鎮,南興里,128,1,328,3,331,804,3,1,3,0,1,0,41.17
宜蘭縣,蘇澳鎮,南寧里,129,1,598,5,603,1259,3,1,3,0,1,0,47.90
宜蘭縣,蘇澳鎮,南建里,130,1,603,10,613,1353,3,1,3,0,1,0,45.31
宜蘭縣,蘇澳鎮,東澳里,131,1,209,1,210,369,3,1,3,0,1,0,56.91
宜蘭縣,蘇澳鎮,南強里,132,1,466,5,471,883,3,1,3,0,1,0,53.34
宜蘭縣,蘇澳鎮,朝陽里,133,1,290,4,294,550,3,1,3,0,1,0,53.45
宜蘭縣,蘇澳鎮,朝陽里,134,1,153,1,154,286,3,1,3,0,1,0,53.85
宜蘭縣,頭城鎮,石城里,135,1,206,1,207,413,3,1,3,0,1,0,50.12
宜蘭縣,頭城鎮,大里里,136,1,239,5,244,696,3,1,3,0,1,0,35.06
宜蘭縣,頭城鎮,大溪里,137,1,607,8,615,1532,3,1,3,0,1,0,40.14
宜蘭縣,頭城鎮,合興里,138,1,196,7,203,428,3,1,3,0,1,0,47.43
宜蘭縣,頭城鎮,更新里,139,1,645,6,651,1307,3,1,3,0,1,0,49.81
宜蘭縣,頭城鎮,外澳里,140,1,438,6,444,880,3,1,3,0,1,0,50.45
宜蘭縣,頭城鎮,港口里,141,1,316,10,326,611,3,1,3,0,1,0,53.36
宜蘭縣,頭城鎮,武營里,142,1,686,6,692,1315,3,1,3,0,1,0,52.62
宜蘭縣,頭城鎮,大坑里,143,1,612,9,621,1099,3,1,3,0,1,0,56.51
宜蘭縣,頭城鎮,城東里,144,1,433,3,436,761,3,1,3,0,1,0,57.29
宜蘭縣,頭城鎮,城北里,145,1,350,5,355,651,3,1,3,0,1,0,54.53
宜蘭縣,頭城鎮,城西里,146,1,407,4,411,712,3,1,3,0,1,0,57.72
宜蘭縣,頭城鎮,城南里,147,1,325,5,330,615,3,1,3,0,1,0,53.66
宜蘭縣,頭城鎮,竹安里,148,1,439,6,445,906,3,1,3,0,1,0,49.12
宜蘭縣,頭城鎮,竹安里,149,1,497,5,502,942,3,1,3,0,1,0,53.29
宜蘭縣,頭城鎮,新建里,150,1,909,19,928,1687,3,1,3,0,1,0,55.01
宜蘭縣,頭城鎮,拔雅里,151,1,646,7,653,1182,3,1,3,0,1,0,55.25
宜蘭縣,頭城鎮,福成里,152,1,509,6,515,980,3,1,3,0,1,0,52.55
宜蘭縣,頭城鎮,金面里,153,1,761,8,769,1576,3,1,3,0,1,0,48.79
宜蘭縣,頭城鎮,金盈里,154,1,374,5,379,720,3,1,3,0,1,0,52.64
宜蘭縣,頭城鎮,頂埔里,155,1,660,7,667,1298,3,1,3,0,1,0,51.39
宜蘭縣,頭城鎮,下埔里,156,1,489,3,492,945,3,1,3,0,1,0,52.06
宜蘭縣,頭城鎮,中崙里,157,1,546,4,550,913,3,1,3,0,1,0,60.24
宜蘭縣,頭城鎮,二城里,158,1,562,8,570,1069,3,1,3,0,1,0,53.32
宜蘭縣,礁溪鄉,白雲村,159,1,758,8,766,1400,3,1,3,0,1,0,54.71
宜蘭縣,礁溪鄉,玉石村,160,1,904,12,916,1621,3,1,3,0,1,0,56.51
宜蘭縣,礁溪鄉,德陽村,161,1,902,12,914,1692,3,1,3,0,1,0,54.02
宜蘭縣,礁溪鄉,德陽村,162,1,868,20,888,1570,3,1,3,0,1,0,56.56
宜蘭縣,礁溪鄉,大忠村,163,1,636,11,647,1137,3,1,3,0,1,0,56.90
宜蘭縣,礁溪鄉,大忠村,164,1,489,1,490,760,3,1,3,0,1,0,64.47
宜蘭縣,礁溪鄉,大義村,165,1,427,3,430,676,3,1,3,0,1,0,63.61
宜蘭縣,礁溪鄉,六結村,166,1,789,7,796,1334,3,1,3,0,1,0,59.67
宜蘭縣,礁溪鄉,二龍村,167,1,594,8,602,1125,3,1,3,0,1,0,53.51
宜蘭縣,礁溪鄉,時潮村,168,1,606,4,610,1253,3,1,3,0,1,0,48.68
宜蘭縣,礁溪鄉,玉田村,169,1,438,7,445,802,3,1,3,0,1,0,55.49
宜蘭縣,礁溪鄉,玉田村,170,1,502,7,509,892,3,1,3,0,1,0,57.06
宜蘭縣,礁溪鄉,三民村,171,1,743,20,763,1303,3,1,3,0,1,0,58.56
宜蘭縣,礁溪鄉,三民村,172,1,474,7,481,863,3,1,3,0,1,0,55.74
宜蘭縣,礁溪鄉,林美村,173,1,594,9,603,1039,3,1,3,0,1,0,58.04
宜蘭縣,礁溪鄉,白鵝村,174,1,366,2,368,649,3,1,3,0,1,0,56.70
宜蘭縣,礁溪鄉,玉光村,175,1,474,8,482,877,3,1,3,0,1,0,54.96
宜蘭縣,礁溪鄉,光武村,176,1,586,9,595,1056,3,1,3,0,1,0,56.34
宜蘭縣,礁溪鄉,吳沙村,177,1,552,3,555,913,3,1,3,0,1,0,60.79
宜蘭縣,礁溪鄉,吳沙村,178,1,652,6,658,1116,3,1,3,0,1,0,58.96
宜蘭縣,礁溪鄉,龍潭村,179,1,724,11,735,1277,3,1,3,0,1,0,57.56
宜蘭縣,礁溪鄉,龍潭村,180,1,685,6,691,1251,3,1,3,0,1,0,55.24
宜蘭縣,礁溪鄉,匏崙村,181,1,482,10,492,882,3,1,3,0,1,0,55.78
宜蘭縣,礁溪鄉,二結村,182,1,199,7,206,389,3,1,3,0,1,0,52.96
宜蘭縣,壯圍鄉,吉祥村,183,1,648,12,660,1254,3,1,3,0,1,0,52.63
宜蘭縣,壯圍鄉,吉祥村,184,1,622,9,631,1162,3,1,3,0,1,0,54.30
宜蘭縣,壯圍鄉,美福村,185,1,742,10,752,1440,3,1,3,0,1,0,52.22
宜蘭縣,壯圍鄉,新南村,186,1,425,5,430,827,3,1,3,0,1,0,52.00
宜蘭縣,壯圍鄉,東港村,187,1,510,7,517,983,3,1,3,0,1,0,52.59
宜蘭縣,壯圍鄉,復興村,188,1,793,11,804,1547,3,1,3,0,1,0,51.97
宜蘭縣,壯圍鄉,過嶺村,189,1,719,4,723,1417,3,1,3,0,1,0,51.02
宜蘭縣,壯圍鄉,永鎮村,190,1,375,4,379,820,3,1,3,0,1,0,46.22
宜蘭縣,壯圍鄉,忠孝村,191,1,396,4,400,718,3,1,3,0,1,0,55.71
宜蘭縣,壯圍鄉,忠孝村,192,1,602,7,609,1010,3,1,3,0,1,0,60.30
宜蘭縣,壯圍鄉,古亭村,193,1,603,12,615,1155,3,1,3,0,1,0,53.25
宜蘭縣,壯圍鄉,功勞村,194,1,540,6,546,936,3,1,3,0,1,0,58.33
宜蘭縣,壯圍鄉,美城村,195,1,470,3,473,932,3,1,3,0,1,0,50.75
宜蘭縣,壯圍鄉,美城村,196,1,454,1,455,799,3,1,3,0,1,0,56.95
宜蘭縣,壯圍鄉,新社村,197,1,530,5,535,1079,3,1,3,0,1,0,49.58
宜蘭縣,壯圍鄉,大福村,198,1,811,11,822,1487,3,1,3,0,1,0,55.28
宜蘭縣,員山鄉,員山村,199,1,582,8,590,1043,3,1,3,0,1,0,56.57
宜蘭縣,員山鄉,員山村,200,1,682,5,687,1259,3,1,3,0,1,0,54.57
宜蘭縣,員山鄉,員山村,201,1,663,9,672,1256,3,1,3,0,1,0,53.50
宜蘭縣,員山鄉,尚德村,202,1,963,17,980,1729,3,1,3,0,1,0,56.68
宜蘭縣,員山鄉,惠好村,203,1,644,9,653,1110,3,1,3,0,1,0,58.83
宜蘭縣,員山鄉,七賢村,204,1,495,4,499,955,3,1,3,0,1,0,52.25
宜蘭縣,員山鄉,深溝村,205,1,709,9,718,1282,3,1,3,0,1,0,56.01
宜蘭縣,員山鄉,蓁巷村,206,1,581,9,590,1069,3,1,3,0,1,0,55.19
宜蘭縣,員山鄉,內城村,207,1,552,8,560,944,3,1,3,0,1,0,59.32
宜蘭縣,員山鄉,內城村,208,1,300,4,304,511,3,1,3,0,1,0,59.49
宜蘭縣,員山鄉,中華村,209,1,206,2,208,454,3,1,3,0,1,0,45.81
宜蘭縣,員山鄉,中華村,210,1,144,2,146,304,3,1,3,0,1,0,48.03
宜蘭縣,員山鄉,永和村,211,1,804,14,818,1504,3,1,3,0,1,0,54.39
宜蘭縣,員山鄉,頭分村,212,1,606,8,614,1010,3,1,3,0,1,0,60.79
宜蘭縣,員山鄉,枕山村,213,1,888,10,898,1476,3,1,3,0,1,0,60.84
宜蘭縣,員山鄉,枕山村,214,1,280,4,284,528,3,1,3,0,1,0,53.79
宜蘭縣,員山鄉,同樂村,215,1,735,10,745,1258,3,1,3,0,1,0,59.22
宜蘭縣,員山鄉,同樂村,216,1,515,9,524,960,3,1,3,0,1,0,54.58
宜蘭縣,員山鄉,湖東村,217,1,439,6,445,835,3,1,3,0,1,0,53.29
宜蘭縣,員山鄉,逸仙村,218,1,445,4,449,828,3,1,3,0,1,0,54.23
宜蘭縣,員山鄉,湖北村,219,1,514,6,520,978,3,1,3,0,1,0,53.17
宜蘭縣,員山鄉,湖西村,220,1,785,11,796,1560,3,1,3,0,1,0,51.03
宜蘭縣,冬山鄉,武淵村,221,1,600,5,605,1046,3,1,3,0,1,0,57.84
宜蘭縣,冬山鄉,珍珠村,222,1,661,8,669,1093,3,1,3,0,1,0,61.21
宜蘭縣,冬山鄉,補城村,223,1,555,2,557,913,3,1,3,0,1,0,61.01
宜蘭縣,冬山鄉,三奇村,224,1,454,9,463,779,3,1,3,0,1,0,59.44
宜蘭縣,冬山鄉,大興村,225,1,564,10,574,905,3,1,3,0,1,0,63.43
宜蘭縣,冬山鄉,東城村,226,1,628,8,636,1112,3,1,3,0,1,0,57.19
宜蘭縣,冬山鄉,香和村,227,1,532,7,539,859,3,1,3,0,1,0,62.75
宜蘭縣,冬山鄉,香和村,228,1,502,7,509,830,3,1,3,0,1,0,61.33
宜蘭縣,冬山鄉,南興村,229,1,494,3,497,835,3,1,3,0,1,0,59.52
宜蘭縣,冬山鄉,南興村,230,1,489,13,502,862,3,1,3,0,1,0,58.24
宜蘭縣,冬山鄉,冬山村,231,1,539,7,546,855,3,1,3,0,1,0,63.86
宜蘭縣,冬山鄉,安平村,232,1,418,5,423,688,3,1,3,0,1,0,61.48
宜蘭縣,冬山鄉,太和村,233,1,758,10,768,1282,3,1,3,0,1,0,59.91
宜蘭縣,冬山鄉,八寶村,234,1,473,6,479,798,3,1,3,0,1,0,60.03
宜蘭縣,冬山鄉,丸山村,235,1,646,10,656,1187,3,1,3,0,1,0,55.27
宜蘭縣,冬山鄉,中山村,236,1,246,7,253,414,3,1,3,0,1,0,61.11
宜蘭縣,冬山鄉,順安村,237,1,705,8,713,1247,3,1,3,0,1,0,57.18
宜蘭縣,冬山鄉,順安村,238,1,738,8,746,1282,3,1,3,0,1,0,58.19
宜蘭縣,冬山鄉,順安村,239,1,673,5,678,1274,3,1,3,0,1,0,53.22
宜蘭縣,冬山鄉,永美村,240,1,550,6,556,952,3,1,3,0,1,0,58.40
宜蘭縣,冬山鄉,永美村,241,1,538,5,543,947,3,1,3,0,1,0,57.34
宜蘭縣,冬山鄉,群英村,242,1,637,11,648,1098,3,1,3,0,1,0,59.02
宜蘭縣,冬山鄉,群英村,243,1,589,12,601,1141,3,1,3,0,1,0,52.67
宜蘭縣,冬山鄉,群英村,244,1,635,9,644,1137,3,1,3,0,1,0,56.64
宜蘭縣,冬山鄉,群英村,245,1,660,9,669,1134,3,1,3,0,1,0,58.99
宜蘭縣,冬山鄉,清溝村,246,1,710,9,719,1247,3,1,3,0,1,0,57.66
宜蘭縣,冬山鄉,清溝村,247,1,772,8,780,1307,3,1,3,0,1,0,59.68
宜蘭縣,冬山鄉,鹿埔村,248,1,554,4,558,936,3,1,3,0,1,0,59.62
宜蘭縣,冬山鄉,鹿埔村,249,1,653,8,661,1140,3,1,3,0,1,0,57.98
宜蘭縣,冬山鄉,得安村,250,1,562,8,570,1029,3,1,3,0,1,0,55.39
宜蘭縣,冬山鄉,廣興村,251,1,569,6,575,1019,3,1,3,0,1,0,56.43
宜蘭縣,冬山鄉,廣興村,252,1,579,6,585,1030,3,1,3,0,1,0,56.80
宜蘭縣,冬山鄉,廣安村,253,1,643,8,651,1070,3,1,3,0,1,0,60.84
宜蘭縣,冬山鄉,柯林村,254,1,478,7,485,804,3,1,3,0,1,0,60.32
宜蘭縣,冬山鄉,大進村,255,1,443,6,449,766,3,1,3,0,1,0,58.62
宜蘭縣,五結鄉,三興村,256,1,991,6,997,1592,3,1,3,0,1,0,62.63
宜蘭縣,五結鄉,二結村,257,1,882,14,896,1396,3,1,3,0,1,0,64.18
宜蘭縣,五結鄉,鎮安村,258,1,548,7,555,903,3,1,3,0,1,0,61.46
宜蘭縣,五結鄉,鎮安村,259,1,576,5,581,922,3,1,3,0,1,0,63.02
宜蘭縣,五結鄉,上四村,260,1,880,11,891,1438,3,1,3,0,1,0,61.96
宜蘭縣,五結鄉,中興村,261,1,538,6,544,890,3,1,3,0,1,0,61.12
宜蘭縣,五結鄉,四結村,262,1,589,10,599,989,3,1,3,0,1,0,60.57
宜蘭縣,五結鄉,四結村,263,1,667,3,670,1109,3,1,3,0,1,0,60.41
宜蘭縣,五結鄉,福興村,264,1,973,6,979,1533,3,1,3,0,1,0,63.86
宜蘭縣,五結鄉,五結村,265,1,848,12,860,1356,3,1,3,0,1,0,63.42
宜蘭縣,五結鄉,五結村,266,1,550,6,556,1013,3,1,3,0,1,0,54.89
宜蘭縣,五結鄉,大吉村,267,1,796,9,805,1366,3,1,3,0,1,0,58.93
宜蘭縣,五結鄉,大吉村,268,1,634,6,640,1070,3,1,3,0,1,0,59.81
宜蘭縣,五結鄉,協和村,269,1,725,7,732,1212,3,1,3,0,1,0,60.40
宜蘭縣,五結鄉,協和村,270,1,434,6,440,707,3,1,3,0,1,0,62.23
宜蘭縣,五結鄉,孝威村,271,1,742,5,747,1216,3,1,3,0,1,0,61.43
宜蘭縣,五結鄉,錦眾村,272,1,810,4,814,1463,3,1,3,0,1,0,55.64
宜蘭縣,五結鄉,利澤村,273,1,639,7,646,1021,3,1,3,0,1,0,63.27
宜蘭縣,五結鄉,利澤村,274,1,581,12,593,1012,3,1,3,0,1,0,58.60
宜蘭縣,五結鄉,成興村,275,1,885,12,897,1541,3,1,3,0,1,0,58.21
宜蘭縣,五結鄉,成興村,276,1,371,3,374,700,3,1,3,0,1,0,53.43
宜蘭縣,五結鄉,季新村,277,1,650,5,655,1147,3,1,3,0,1,0,57.11
宜蘭縣,五結鄉,季新村,278,1,404,1,405,741,3,1,3,0,1,0,54.66
宜蘭縣,三星鄉,員山村,279,1,138,1,139,243,3,1,3,0,1,0,57.20
宜蘭縣,三星鄉,天山村,280,1,342,7,349,666,3,1,3,0,1,0,52.40
宜蘭縣,三星鄉,天福村,281,1,446,4,450,861,3,1,3,0,1,0,52.26
宜蘭縣,三星鄉,雙賢村,282,1,369,3,372,662,3,1,3,0,1,0,56.19
宜蘭縣,三星鄉,人和村,283,1,295,3,298,485,3,1,3,0,1,0,61.44
宜蘭縣,三星鄉,義德村,284,1,660,11,671,1180,3,1,3,0,1,0,56.86
宜蘭縣,三星鄉,集慶村,285,1,628,9,637,1095,3,1,3,0,1,0,58.17
宜蘭縣,三星鄉,月眉村,286,1,481,9,490,843,3,1,3,0,1,0,58.13
宜蘭縣,三星鄉,拱照村,287,1,557,3,560,1185,3,1,3,0,1,0,47.26
宜蘭縣,三星鄉,大隱村,288,1,729,8,737,1205,3,1,3,0,1,0,61.16
宜蘭縣,三星鄉,大隱村,289,1,797,13,810,1378,3,1,3,0,1,0,58.78
宜蘭縣,三星鄉,行健村,290,1,360,5,365,660,3,1,3,0,1,0,55.30
宜蘭縣,三星鄉,萬德村,291,1,306,10,316,555,3,1,3,0,1,0,56.94
宜蘭縣,三星鄉,貴林村,292,1,248,1,249,468,3,1,3,0,1,0,53.21
宜蘭縣,三星鄉,萬富村,293,1,363,3,366,658,3,1,3,0,1,0,55.62
宜蘭縣,三星鄉,大義村,294,1,644,12,656,1039,3,1,3,0,1,0,63.14
宜蘭縣,三星鄉,尚武村,295,1,461,4,465,790,3,1,3,0,1,0,58.86
宜蘭縣,三星鄉,大洲村,296,1,846,11,857,1232,3,1,3,0,1,0,69.56
宜蘭縣,三星鄉,尾塹村,297,1,673,6,679,1075,3,1,3,0,1,0,63.16
宜蘭縣,大同鄉,寒溪村,298,1,52,0,52,98,3,1,3,0,1,0,53.06
宜蘭縣,大同鄉,崙埤村,299,1,46,0,46,101,3,1,3,0,1,0,45.54
宜蘭縣,大同鄉,松羅村,300,1,109,1,110,223,3,1,3,0,1,0,49.33
宜蘭縣,大同鄉,復興村,301,1,118,2,120,222,3,1,3,0,1,0,54.05
宜蘭縣,大同鄉,英士村,302,1,39,0,39,89,3,1,3,0,1,0,43.82
宜蘭縣,大同鄉,樂水村,303,1,27,2,29,73,3,1,3,0,1,0,39.73
宜蘭縣,大同鄉,太平村,304,1,38,1,39,65,3,1,3,0,1,0,60.00
宜蘭縣,大同鄉,茂安村,305,1,11,0,11,14,3,1,3,0,1,0,78.57
宜蘭縣,大同鄉,四季村,306,1,22,0,22,49,3,1,3,0,1,0,44.90
宜蘭縣,大同鄉,南山村,307,1,27,0,27,60,3,1,3,0,1,0,45.00
宜蘭縣,南澳鄉,東岳村,308,1,46,1,47,82,3,1,3,0,1,0,57.32
宜蘭縣,南澳鄉,南澳村,309,1,144,3,147,299,3,1,3,0,1,0,49.16
宜蘭縣,南澳鄉,碧候村,310,1,38,0,38,105,3,1,3,0,1,0,36.19
宜蘭縣,南澳鄉,金岳村,311,1,32,1,33,57,3,1,3,0,1,0,57.89
宜蘭縣,南澳鄉,武塔村,312,1,66,1,67,143,3,1,3,0,1,0,46.85
宜蘭縣,南澳鄉,金洋村,313,1,21,0,21,41,3,1,3,0,1,0,51.22
宜蘭縣,南澳鄉,澳花村,314,1,88,0,88,194,3,1,3,0,1,0,45.36
桃園縣,桃園市,武陵里,1,1,955,9,964,1531,3,1,3,0,1,0,62.97
桃園縣,桃園市,民生里,2,1,955,11,966,1400,3,1,3,0,1,0,69.00
桃園縣,桃園市,東門里,3,1,600,6,606,927,3,1,3,0,1,0,65.37
桃園縣,桃園市,東門里,4,1,763,9,772,1234,3,1,3,0,1,0,62.56
桃園縣,桃園市,東山里,5,1,682,11,693,1010,3,1,3,0,1,0,68.61
桃園縣,桃園市,東山里,6,1,566,3,569,927,3,1,3,0,1,0,61.38
桃園縣,桃園市,萬壽里,7,1,665,12,677,1009,3,1,3,0,1,0,67.10
桃園縣,桃園市,雲林里,8,1,844,7,851,1353,3,1,3,0,1,0,62.90
桃園縣,桃園市,雲林里,9,1,961,12,973,1467,3,1,3,0,1,0,66.33
桃園縣,桃園市,大豐里,10,1,821,12,833,1254,3,1,3,0,1,0,66.43
桃園縣,桃園市,大豐里,11,1,776,6,782,1217,3,1,3,0,1,0,64.26
桃園縣,桃園市,大豐里,12,1,667,11,678,1065,3,1,3,0,1,0,63.66
桃園縣,桃園市,建國里,13,1,798,7,805,1224,3,1,3,0,1,0,65.77
桃園縣,桃園市,建國里,14,1,680,13,693,1062,3,1,3,0,1,0,65.25
桃園縣,桃園市,建國里,15,1,924,16,940,1527,3,1,3,0,1,0,61.56
桃園縣,桃園市,豐林里,16,1,940,18,958,1431,3,1,3,0,1,0,66.95
桃園縣,桃園市,豐林里,17,1,937,16,953,1442,3,1,3,0,1,0,66.09
桃園縣,桃園市,豐林里,18,1,1225,12,1237,1761,3,1,3,0,1,0,70.24
桃園縣,桃園市,福林里,19,1,903,12,915,1252,3,1,3,0,1,0,73.08
桃園縣,桃園市,福林里,20,1,996,16,1012,1471,3,1,3,0,1,0,68.80
桃園縣,桃園市,福林里,21,1,868,10,878,1335,3,1,3,0,1,0,65.77
桃園縣,桃園市,福安里,22,1,909,11,920,1364,3,1,3,0,1,0,67.45
桃園縣,桃園市,福安里,23,1,1031,8,1039,1482,3,1,3,0,1,0,70.11
桃園縣,桃園市,大林里,24,1,640,7,647,932,3,1,3,0,1,0,69.42
桃園縣,桃園市,大林里,25,1,1083,15,1098,1719,3,1,3,0,1,0,63.87
桃園縣,桃園市,大林里,26,1,979,17,996,1583,3,1,3,0,1,0,62.92
桃園縣,桃園市,文化里,27,1,567,7,574,861,3,1,3,0,1,0,66.67
桃園縣,桃園市,文明里,28,1,1020,7,1027,1504,3,1,3,0,1,0,68.28
桃園縣,桃園市,文昌里,29,1,760,18,778,1154,3,1,3,0,1,0,67.42
桃園縣,桃園市,南門里,30,1,1179,21,1200,1843,3,1,3,0,1,0,65.11
桃園縣,桃園市,南門里,31,1,736,11,747,1124,3,1,3,0,1,0,66.46
桃園縣,桃園市,南門里,32,1,691,9,700,1075,3,1,3,0,1,0,65.12
桃園縣,桃園市,南華里,33,1,971,13,984,1495,3,1,3,0,1,0,65.82
桃園縣,桃園市,中路里,34,1,986,16,1002,1581,3,1,3,0,1,0,63.38
桃園縣,桃園市,中路里,35,1,1058,19,1077,1694,3,1,3,0,1,0,63.58
桃園縣,桃園市,中路里,36,1,830,12,842,1312,3,1,3,0,1,0,64.18
桃園縣,桃園市,中山里,37,1,1292,9,1301,1985,3,1,3,0,1,0,65.54
桃園縣,桃園市,中山里,38,1,1396,21,1417,2422,3,1,3,0,1,0,58.51
桃園縣,桃園市,中山里,39,1,1176,14,1190,1925,3,1,3,0,1,0,61.82
桃園縣,桃園市,中德里,40,1,1288,25,1313,1986,3,1,3,0,1,0,66.11
桃園縣,桃園市,中德里,41,1,788,7,795,1091,3,1,3,0,1,0,72.87
桃園縣,桃園市,玉山里,42,1,766,13,779,1193,3,1,3,0,1,0,65.30
桃園縣,桃園市,玉山里,43,1,957,19,976,1517,3,1,3,0,1,0,64.34
桃園縣,桃園市,玉山里,44,1,898,10,908,1378,3,1,3,0,1,0,65.89
桃園縣,桃園市,泰山里,45,1,884,13,897,1365,3,1,3,0,1,0,65.71
桃園縣,桃園市,泰山里,46,1,827,11,838,1267,3,1,3,0,1,0,66.14
桃園縣,桃園市,文中里,47,1,825,8,833,1387,3,1,3,0,1,0,60.06
桃園縣,桃園市,文中里,48,1,847,9,856,1231,3,1,3,0,1,0,69.54
桃園縣,桃園市,中正里,49,1,825,10,835,1218,3,1,3,0,1,0,68.56
桃園縣,桃園市,中正里,50,1,815,13,828,1227,3,1,3,0,1,0,67.48
桃園縣,桃園市,中正里,51,1,842,15,857,1320,3,1,3,0,1,0,64.92
桃園縣,桃園市,中成里,52,1,582,7,589,813,3,1,3,0,1,0,72.45
桃園縣,桃園市,中成里,53,1,839,19,858,1256,3,1,3,0,1,0,68.31
桃園縣,桃園市,中成里,54,1,445,3,448,662,3,1,3,0,1,0,67.67
桃園縣,桃園市,中興里,55,1,968,11,979,1459,3,1,3,0,1,0,67.10
桃園縣,桃園市,中興里,56,1,964,10,974,1527,3,1,3,0,1,0,63.79
桃園縣,桃園市,中興里,57,1,886,11,897,1338,3,1,3,0,1,0,67.04
桃園縣,桃園市,光興里,58,1,968,16,984,1452,3,1,3,0,1,0,67.77
桃園縣,桃園市,光興里,59,1,968,10,978,1473,3,1,3,0,1,0,66.40
桃園縣,桃園市,光興里,60,1,941,11,952,1420,3,1,3,0,1,0,67.04
桃園縣,桃園市,龍岡里,61,1,840,17,857,1412,3,1,3,0,1,0,60.69
桃園縣,桃園市,龍岡里,62,1,979,15,994,1571,3,1,3,0,1,0,63.27
桃園縣,桃園市,龍岡里,63,1,774,8,782,1152,3,1,3,0,1,0,67.88
桃園縣,桃園市,龍岡里,64,1,845,10,855,1247,3,1,3,0,1,0,68.56
桃園縣,桃園市,龍祥里,65,1,617,6,623,928,3,1,3,0,1,0,67.13
桃園縣,桃園市,龍祥里,66,1,1253,20,1273,1870,3,1,3,0,1,0,68.07
桃園縣,桃園市,龍山里,67,1,1104,28,1132,1749,3,1,3,0,1,0,64.72
桃園縣,桃園市,龍山里,68,1,1061,23,1084,1518,3,1,3,0,1,0,71.41
桃園縣,桃園市,長美里,69,1,731,9,740,1131,3,1,3,0,1,0,65.43
桃園縣,桃園市,永興里,70,1,570,2,572,891,3,1,3,0,1,0,64.20
桃園縣,桃園市,永興里,71,1,655,3,658,977,3,1,3,0,1,0,67.35
桃園縣,桃園市,西門里,72,1,952,6,958,1520,3,1,3,0,1,0,63.03
桃園縣,桃園市,西湖里,73,1,814,12,826,1208,3,1,3,0,1,0,68.38
桃園縣,桃園市,東埔里,74,1,1085,25,1110,1854,3,1,3,0,1,0,59.87
桃園縣,桃園市,東埔里,75,1,1094,9,1103,1722,3,1,3,0,1,0,64.05
桃園縣,桃園市,信光里,76,1,718,14,732,1213,3,1,3,0,1,0,60.35
桃園縣,桃園市,信光里,77,1,692,10,702,1091,3,1,3,0,1,0,64.34
桃園縣,桃園市,信光里,78,1,661,10,671,1096,3,1,3,0,1,0,61.22
桃園縣,桃園市,永安里,79,1,1116,14,1130,1744,3,1,3,0,1,0,64.79
桃園縣,桃園市,永安里,80,1,1193,23,1216,1896,3,1,3,0,1,0,64.14
桃園縣,桃園市,長安里,81,1,939,12,951,1559,3,1,3,0,1,0,61.00
桃園縣,桃園市,長安里,82,1,920,5,925,1421,3,1,3,0,1,0,65.10
桃園縣,桃園市,長安里,83,1,1125,19,1144,1772,3,1,3,0,1,0,64.56
桃園縣,桃園市,西埔里,84,1,1301,17,1318,1876,3,1,3,0,1,0,70.26
桃園縣,桃園市,中埔里,85,1,993,20,1013,1519,3,1,3,0,1,0,66.69
桃園縣,桃園市,中埔里,86,1,1036,19,1055,1594,3,1,3,0,1,0,66.19
桃園縣,桃園市,中埔里,87,1,1748,30,1778,2889,3,1,3,0,1,0,61.54
桃園縣,桃園市,中寧里,88,1,982,13,995,1613,3,1,3,0,1,0,61.69
桃園縣,桃園市,中寧里,89,1,796,10,806,1249,3,1,3,0,1,0,64.53
桃園縣,桃園市,新埔里,90,1,752,9,761,1221,3,1,3,0,1,0,62.33
桃園縣,桃園市,新埔里,91,1,1239,20,1259,1837,3,1,3,0,1,0,68.54
桃園縣,桃園市,同安里,92,1,754,21,775,1164,3,1,3,0,1,0,66.58
桃園縣,桃園市,同安里,93,1,876,33,909,1507,3,1,3,0,1,0,60.32
桃園縣,桃園市,莊敬里,94,1,943,21,964,1501,3,1,3,0,1,0,64.22
桃園縣,桃園市,莊敬里,95,1,1024,9,1033,1655,3,1,3,0,1,0,62.42
桃園縣,桃園市,慈文里,96,1,656,13,669,1062,3,1,3,0,1,0,62.99
桃園縣,桃園市,慈文里,97,1,799,15,814,1270,3,1,3,0,1,0,64.09
桃園縣,桃園市,慈文里,98,1,762,14,776,1248,3,1,3,0,1,0,62.18
桃園縣,桃園市,中和里,99,1,1079,11,1090,1614,3,1,3,0,1,0,67.53
桃園縣,桃園市,北門里,100,1,1019,15,1034,1582,3,1,3,0,1,0,65.36
桃園縣,桃園市,青溪里,101,1,842,18,860,1366,3,1,3,0,1,0,62.96
桃園縣,桃園市,青溪里,102,1,709,12,721,1170,3,1,3,0,1,0,61.62
桃園縣,桃園市,青溪里,103,1,951,10,961,1467,3,1,3,0,1,0,65.51
桃園縣,桃園市,朝陽里,104,1,1045,13,1058,1625,3,1,3,0,1,0,65.11
桃園縣,桃園市,成功里,105,1,1014,5,1019,1512,3,1,3,0,1,0,67.39
桃園縣,桃園市,成功里,106,1,860,10,870,1317,3,1,3,0,1,0,66.06
桃園縣,桃園市,三民里,107,1,1044,5,1049,1459,3,1,3,0,1,0,71.90
桃園縣,桃園市,三民里,108,1,822,14,836,1257,3,1,3,0,1,0,66.51
桃園縣,桃園市,會稽里,109,1,739,12,751,1288,3,1,3,0,1,0,58.31
桃園縣,桃園市,會稽里,110,1,843,14,857,1471,3,1,3,0,1,0,58.26
桃園縣,桃園市,會稽里,111,1,820,9,829,1340,3,1,3,0,1,0,61.87
桃園縣,桃園市,大興里,112,1,589,10,599,1004,3,1,3,0,1,0,59.66
桃園縣,桃園市,大興里,113,1,882,19,901,1397,3,1,3,0,1,0,64.50
桃園縣,桃園市,大興里,114,1,753,12,765,1267,3,1,3,0,1,0,60.38
桃園縣,桃園市,春日里,115,1,772,14,786,1157,3,1,3,0,1,0,67.93
桃園縣,桃園市,春日里,116,1,790,19,809,1289,3,1,3,0,1,0,62.76
桃園縣,桃園市,忠義里,117,1,887,17,904,1536,3,1,3,0,1,0,58.85
桃園縣,桃園市,忠義里,118,1,678,17,695,1066,3,1,3,0,1,0,65.20
桃園縣,桃園市,汴洲里,119,1,881,11,892,1372,3,1,3,0,1,0,65.01
桃園縣,桃園市,汴洲里,120,1,890,15,905,1371,3,1,3,0,1,0,66.01
桃園縣,龜山鄉,龜山村,121,1,723,9,732,1081,3,1,3,0,1,0,67.72
桃園縣,龜山鄉,龜山村,122,1,902,11,913,1342,3,1,3,0,1,0,68.03
桃園縣,龜山鄉,龜山村,123,1,1014,14,1028,1656,3,1,3,0,1,0,62.08
桃園縣,龜山鄉,新路村,124,1,984,19,1003,1392,3,1,3,0,1,0,72.05
桃園縣,龜山鄉,新路村,125,1,1164,18,1182,1772,3,1,3,0,1,0,66.70
桃園縣,龜山鄉,大同村,126,1,1208,19,1227,1727,3,1,3,0,1,0,71.05
桃園縣,龜山鄉,大同村,127,1,1258,13,1271,1949,3,1,3,0,1,0,65.21
桃園縣,龜山鄉,中興村,128,1,918,13,931,1455,3,1,3,0,1,0,63.99
桃園縣,龜山鄉,中興村,129,1,1107,18,1125,1734,3,1,3,0,1,0,64.88
桃園縣,龜山鄉,中興村,130,1,1139,24,1163,1776,3,1,3,0,1,0,65.48
桃園縣,龜山鄉,中興村,131,1,803,11,814,1280,3,1,3,0,1,0,63.59
桃園縣,龜山鄉,陸光村,132,1,957,17,974,1228,3,1,3,0,1,0,79.32
桃園縣,龜山鄉,陸光村,133,1,964,25,989,1312,3,1,3,0,1,0,75.38
桃園縣,龜山鄉,精忠村,134,1,975,13,988,1319,3,1,3,0,1,0,74.91
桃園縣,龜山鄉,精忠村,135,1,818,9,827,1067,3,1,3,0,1,0,77.51
桃園縣,龜山鄉,兔坑村,136,1,888,26,914,1423,3,1,3,0,1,0,64.23
桃園縣,龜山鄉,兔坑村,137,1,636,13,649,1140,3,1,3,0,1,0,56.93
桃園縣,龜山鄉,龍壽村,138,1,710,10,720,1255,3,1,3,0,1,0,57.37
桃園縣,龜山鄉,龍壽村,139,1,724,10,734,1272,3,1,3,0,1,0,57.70
桃園縣,龜山鄉,龍壽村,140,1,1019,18,1037,1908,3,1,3,0,1,0,54.35
桃園縣,龜山鄉,龍壽村,141,1,791,22,813,1442,3,1,3,0,1,0,56.38
桃園縣,龜山鄉,嶺頂村,142,1,989,24,1013,1701,3,1,3,0,1,0,59.55
桃園縣,龜山鄉,嶺頂村,143,1,762,24,786,1370,3,1,3,0,1,0,57.37
桃園縣,龜山鄉,嶺頂村,144,1,777,16,793,1390,3,1,3,0,1,0,57.05
桃園縣,龜山鄉,舊路村,145,1,1107,13,1120,1729,3,1,3,0,1,0,64.78
桃園縣,龜山鄉,山德村,146,1,988,11,999,1586,3,1,3,0,1,0,62.99
桃園縣,龜山鄉,山德村,147,1,922,22,944,1446,3,1,3,0,1,0,65.28
桃園縣,龜山鄉,山德村,148,1,959,25,984,1512,3,1,3,0,1,0,65.08
桃園縣,龜山鄉,山頂村,149,1,1154,15,1169,1770,3,1,3,0,1,0,66.05
桃園縣,龜山鄉,山頂村,150,1,827,9,836,3531,3,1,3,0,1,0,23.68
桃園縣,龜山鄉,山福村,151,1,757,9,766,1203,3,1,3,0,1,0,63.67
桃園縣,龜山鄉,山福村,152,1,786,15,801,1285,3,1,3,0,1,0,62.33
桃園縣,龜山鄉,山福村,153,1,721,16,737,1224,3,1,3,0,1,0,60.21
桃園縣,龜山鄉,山福村,154,1,725,11,736,1365,3,1,3,0,1,0,53.92
桃園縣,龜山鄉,山福村,155,1,741,16,757,1311,3,1,3,0,1,0,57.74
桃園縣,龜山鄉,大崗村,156,1,1394,21,1415,2280,3,1,3,0,1,0,62.06
桃園縣,龜山鄉,大崗村,157,1,1148,16,1164,1733,3,1,3,0,1,0,67.17
桃園縣,龜山鄉,公西村,158,1,1210,20,1230,2010,3,1,3,0,1,0,61.19
桃園縣,龜山鄉,樂善村,159,1,1539,20,1559,2836,3,1,3,0,1,0,54.97
桃園縣,龜山鄉,大坑村,160,1,665,12,677,1037,3,1,3,0,1,0,65.28
桃園縣,龜山鄉,南上村,161,1,1303,20,1323,2065,3,1,3,0,1,0,64.07
桃園縣,龜山鄉,楓樹村,162,1,1212,18,1230,1834,3,1,3,0,1,0,67.07
桃園縣,八德市,興仁里,163,1,811,15,826,1246,3,1,3,0,1,0,66.29
桃園縣,八德市,興仁里,164,1,680,12,692,1097,3,1,3,0,1,0,63.08
桃園縣,八德市,福興里,165,1,835,14,849,1179,3,1,3,0,1,0,72.01
桃園縣,八德市,福興里,166,1,738,33,771,1064,3,1,3,0,1,0,72.46
桃園縣,八德市,瑞豐里,167,1,1087,26,1113,1610,3,1,3,0,1,0,69.13
桃園縣,八德市,瑞豐里,168,1,890,12,902,1219,3,1,3,0,1,0,74.00
桃園縣,八德市,瑞泰里,169,1,857,13,870,1396,3,1,3,0,1,0,62.32
桃園縣,八德市,瑞泰里,170,1,801,11,812,1214,3,1,3,0,1,0,66.89
桃園縣,八德市,瑞發里,171,1,999,18,1017,1412,3,1,3,0,1,0,72.03
桃園縣,八德市,瑞發里,172,1,1136,15,1151,1613,3,1,3,0,1,0,71.36
桃園縣,八德市,瑞德里,173,1,1074,17,1091,1527,3,1,3,0,1,0,71.45
桃園縣,八德市,瑞德里,174,1,992,21,1013,1389,3,1,3,0,1,0,72.93
桃園縣,八德市,瑞祥里,175,1,1083,18,1101,1541,3,1,3,0,1,0,71.45
桃園縣,八德市,瑞祥里,176,1,838,10,848,1143,3,1,3,0,1,0,74.19
桃園縣,八德市,廣興里,177,1,1153,26,1179,1754,3,1,3,0,1,0,67.22
桃園縣,八德市,廣興里,178,1,1055,27,1082,1564,3,1,3,0,1,0,69.18
桃園縣,八德市,廣隆里,179,1,1295,20,1315,1758,3,1,3,0,1,0,74.80
桃園縣,八德市,廣隆里,180,1,519,11,530,759,3,1,3,0,1,0,69.83
桃園縣,八德市,竹園里,181,1,800,19,819,1184,3,1,3,0,1,0,69.17
桃園縣,八德市,竹園里,182,1,614,8,622,977,3,1,3,0,1,0,63.66
桃園縣,八德市,霄裡里,183,1,1044,25,1069,1585,3,1,3,0,1,0,67.44
桃園縣,八德市,霄裡里,184,1,833,20,853,1111,3,1,3,0,1,0,76.78
桃園縣,八德市,霄裡里,185,1,636,15,651,928,3,1,3,0,1,0,70.15
桃園縣,八德市,茄苳里,186,1,908,23,931,1437,3,1,3,0,1,0,64.79
桃園縣,八德市,茄苳里,187,1,1007,20,1027,1479,3,1,3,0,1,0,69.44
桃園縣,八德市,茄苳里,188,1,1114,23,1137,1781,3,1,3,0,1,0,63.84
桃園縣,八德市,高明里,189,1,933,19,952,1387,3,1,3,0,1,0,68.64
桃園縣,八德市,高明里,190,1,1033,25,1058,1677,3,1,3,0,1,0,63.09
桃園縣,八德市,高明里,191,1,904,9,913,1293,3,1,3,0,1,0,70.61
桃園縣,八德市,白鷺里,192,1,1278,33,1311,1826,3,1,3,0,1,0,71.80
桃園縣,八德市,大湳里,193,1,1223,20,1243,2016,3,1,3,0,1,0,61.66
桃園縣,八德市,大發里,194,1,883,7,890,1267,3,1,3,0,1,0,70.24
桃園縣,八德市,大仁里,195,1,875,20,895,1414,3,1,3,0,1,0,63.30
桃園縣,八德市,大仁里,196,1,715,11,726,1088,3,1,3,0,1,0,66.73
桃園縣,八德市,大明里,197,1,1094,19,1113,1832,3,1,3,0,1,0,60.75
桃園縣,八德市,大安里,198,1,806,20,826,1173,3,1,3,0,1,0,70.42
桃園縣,八德市,大竹里,199,1,713,7,720,1059,3,1,3,0,1,0,67.99
桃園縣,八德市,大興里,200,1,1034,19,1053,1645,3,1,3,0,1,0,64.01
桃園縣,八德市,大興里,201,1,947,19,966,1437,3,1,3,0,1,0,67.22
桃園縣,八德市,大華里,202,1,803,10,813,1171,3,1,3,0,1,0,69.43
桃園縣,八德市,大華里,203,1,587,9,596,959,3,1,3,0,1,0,62.15
桃園縣,八德市,大華里,204,1,909,18,927,1336,3,1,3,0,1,0,69.39
桃園縣,八德市,大信里,205,1,613,7,620,1023,3,1,3,0,1,0,60.61
桃園縣,八德市,大信里,206,1,770,12,782,1182,3,1,3,0,1,0,66.16
桃園縣,八德市,大信里,207,1,741,12,753,1267,3,1,3,0,1,0,59.43
桃園縣,八德市,大信里,208,1,768,22,790,1271,3,1,3,0,1,0,62.16
桃園縣,八德市,大信里,209,1,781,25,806,1246,3,1,3,0,1,0,64.69
桃園縣,八德市,大和里,210,1,609,7,616,922,3,1,3,0,1,0,66.81
桃園縣,八德市,大和里,211,1,509,11,520,784,3,1,3,0,1,0,66.33
桃園縣,八德市,大昌里,212,1,584,14,598,860,3,1,3,0,1,0,69.53
桃園縣,八德市,大昌里,213,1,989,14,1003,1505,3,1,3,0,1,0,66.64
桃園縣,八德市,大同里,214,1,438,9,447,566,3,1,3,0,1,0,78.98
桃園縣,八德市,大同里,215,1,1045,16,1061,1507,3,1,3,0,1,0,70.40
桃園縣,八德市,大成里,216,1,956,17,973,1456,3,1,3,0,1,0,66.83
桃園縣,八德市,大成里,217,1,1097,19,1116,1610,3,1,3,0,1,0,69.32
桃園縣,八德市,大成里,218,1,966,14,980,1451,3,1,3,0,1,0,67.54
桃園縣,八德市,大義里,219,1,1085,13,1098,1563,3,1,3,0,1,0,70.25
桃園縣,八德市,大義里,220,1,798,9,807,1277,3,1,3,0,1,0,63.19
桃園縣,八德市,大義里,221,1,772,8,780,1161,3,1,3,0,1,0,67.18
桃園縣,八德市,大忠里,222,1,635,9,644,901,3,1,3,0,1,0,71.48
桃園縣,八德市,大忠里,223,1,614,10,624,896,3,1,3,0,1,0,69.64
桃園縣,八德市,大智里,224,1,1334,18,1352,1903,3,1,3,0,1,0,71.05
桃園縣,八德市,大智里,225,1,1104,15,1119,1629,3,1,3,0,1,0,68.69
桃園縣,八德市,大正里,226,1,723,13,736,986,3,1,3,0,1,0,74.65
桃園縣,八德市,大正里,227,1,850,15,865,1329,3,1,3,0,1,0,65.09
桃園縣,八德市,大福里,228,1,1113,14,1127,1732,3,1,3,0,1,0,65.07
桃園縣,八德市,大福里,229,1,535,10,545,810,3,1,3,0,1,0,67.28
桃園縣,八德市,大強里,230,1,1316,22,1338,1934,3,1,3,0,1,0,69.18
桃園縣,八德市,大勇里,231,1,746,16,762,1158,3,1,3,0,1,0,65.80
桃園縣,八德市,大勇里,232,1,1085,15,1100,1580,3,1,3,0,1,0,69.62
桃園縣,蘆竹鄉,新興村,233,1,670,10,680,955,3,1,3,0,1,0,71.20
桃園縣,蘆竹鄉,新興村,234,1,897,15,912,1416,3,1,3,0,1,0,64.41
桃園縣,蘆竹鄉,中福村,235,1,1487,29,1516,2148,3,1,3,0,1,0,70.58
桃園縣,蘆竹鄉,新莊村,236,1,918,14,932,1310,3,1,3,0,1,0,71.15
桃園縣,蘆竹鄉,新莊村,237,1,692,14,706,985,3,1,3,0,1,0,71.68
桃園縣,蘆竹鄉,富竹村,238,1,574,9,583,790,3,1,3,0,1,0,73.80
桃園縣,蘆竹鄉,上竹村,239,1,1019,14,1033,1471,3,1,3,0,1,0,70.22
桃園縣,蘆竹鄉,大竹村,240,1,1168,28,1196,1702,3,1,3,0,1,0,70.27
桃園縣,蘆竹鄉,宏竹村,241,1,1235,17,1252,1753,3,1,3,0,1,0,71.42
桃園縣,蘆竹鄉,大華村,242,1,175,2,177,221,3,1,3,0,1,0,80.09
桃園縣,蘆竹鄉,大華村,243,1,1293,23,1316,1640,3,1,3,0,1,0,80.24
桃園縣,蘆竹鄉,蘆竹村,244,1,976,16,992,1345,3,1,3,0,1,0,73.75
桃園縣,蘆竹鄉,蘆竹村,245,1,961,19,980,1321,3,1,3,0,1,0,74.19
桃園縣,蘆竹鄉,南崁村,246,1,1215,23,1238,1816,3,1,3,0,1,0,68.17
桃園縣,蘆竹鄉,南榮村,247,1,930,18,948,1464,3,1,3,0,1,0,64.75
桃園縣,蘆竹鄉,南興村,248,1,1222,29,1251,1875,3,1,3,0,1,0,66.72
桃園縣,蘆竹鄉,錦興村,249,1,1210,25,1235,1900,3,1,3,0,1,0,65.00
桃園縣,蘆竹鄉,錦中村,250,1,1042,22,1064,1551,3,1,3,0,1,0,68.60
桃園縣,蘆竹鄉,長興村,251,1,591,11,602,897,3,1,3,0,1,0,67.11
桃園縣,蘆竹鄉,五福村,252,1,1269,18,1287,2097,3,1,3,0,1,0,61.37
桃園縣,蘆竹鄉,五福村,253,1,1045,22,1067,1786,3,1,3,0,1,0,59.74
桃園縣,蘆竹鄉,內厝村,254,1,1116,16,1132,1579,3,1,3,0,1,0,71.69
桃園縣,蘆竹鄉,山鼻村,255,1,769,12,781,1155,3,1,3,0,1,0,67.62
桃園縣,蘆竹鄉,坑子村,256,1,1013,13,1026,1511,3,1,3,0,1,0,67.90
桃園縣,蘆竹鄉,外社村,257,1,822,12,834,1155,3,1,3,0,1,0,72.21
桃園縣,蘆竹鄉,山腳村,258,1,861,17,878,1179,3,1,3,0,1,0,74.47
桃園縣,蘆竹鄉,山腳村,259,1,1035,29,1064,1541,3,1,3,0,1,0,69.05
桃園縣,蘆竹鄉,坑口村,260,1,1363,20,1383,1888,3,1,3,0,1,0,73.25
桃園縣,蘆竹鄉,海湖村,261,1,878,17,895,1350,3,1,3,0,1,0,66.30
桃園縣,蘆竹鄉,海湖村,262,1,843,14,857,1191,3,1,3,0,1,0,71.96
桃園縣,大園鄉,大園村,263,1,1000,17,1017,1386,3,1,3,0,1,0,73.38
桃園縣,大園鄉,大園村,264,1,1268,17,1285,1709,3,1,3,0,1,0,75.19
桃園縣,大園鄉,大園村,265,1,1197,18,1215,1581,3,1,3,0,1,0,76.85
桃園縣,大園鄉,田心村,266,1,1335,15,1350,1915,3,1,3,0,1,0,70.50
桃園縣,大園鄉,田心村,267,1,1083,6,1089,1515,3,1,3,0,1,0,71.88
桃園縣,大園鄉,溪海村,268,1,692,13,705,1023,3,1,3,0,1,0,68.91
桃園縣,大園鄉,溪海村,269,1,748,13,761,1151,3,1,3,0,1,0,66.12
桃園縣,大園鄉,和平村,270,1,968,8,976,1393,3,1,3,0,1,0,70.06
桃園縣,大園鄉,橫峰村,271,1,1036,20,1056,1546,3,1,3,0,1,0,68.31
桃園縣,大園鄉,橫峰村,272,1,872,12,884,1288,3,1,3,0,1,0,68.63
桃園縣,大園鄉,橫峰村,273,1,952,7,959,1399,3,1,3,0,1,0,68.55
桃園縣,大園鄉,五權村,274,1,1167,17,1184,1583,3,1,3,0,1,0,74.79
桃園縣,大園鄉,五權村,275,1,903,18,921,1359,3,1,3,0,1,0,67.77
桃園縣,大園鄉,埔心村,276,1,807,9,816,1093,3,1,3,0,1,0,74.66
桃園縣,大園鄉,埔心村,277,1,704,11,715,1047,3,1,3,0,1,0,68.29
桃園縣,大園鄉,埔心村,278,1,1058,24,1082,1500,3,1,3,0,1,0,72.13
桃園縣,大園鄉,大海村,279,1,877,13,890,1178,3,1,3,0,1,0,75.55
桃園縣,大園鄉,建華村,280,1,779,12,791,984,3,1,3,0,1,0,80.39
桃園縣,大園鄉,三石村,281,1,632,6,638,860,3,1,3,0,1,0,74.19
桃園縣,大園鄉,三石村,282,1,1007,17,1024,1321,3,1,3,0,1,0,77.52
桃園縣,大園鄉,菓林村,283,1,1062,21,1083,1516,3,1,3,0,1,0,71.44
桃園縣,大園鄉,菓林村,284,1,1217,22,1239,1867,3,1,3,0,1,0,66.36
桃園縣,大園鄉,竹圍村,285,1,629,4,633,867,3,1,3,0,1,0,73.01
桃園縣,大園鄉,竹圍村,286,1,818,7,825,1201,3,1,3,0,1,0,68.69
桃園縣,大園鄉,海口村,287,1,854,22,876,1261,3,1,3,0,1,0,69.47
桃園縣,大園鄉,沙崙村,288,1,713,10,723,1032,3,1,3,0,1,0,70.06
桃園縣,大園鄉,沙崙村,289,1,708,12,720,1115,3,1,3,0,1,0,64.57
桃園縣,大園鄉,后厝村,290,1,855,12,867,1244,3,1,3,0,1,0,69.69
桃園縣,大園鄉,圳頭村,291,1,1160,17,1177,1683,3,1,3,0,1,0,69.93
桃園縣,大園鄉,內海村,292,1,1125,13,1138,1609,3,1,3,0,1,0,70.73
桃園縣,大園鄉,北港村,293,1,952,13,965,1393,3,1,3,0,1,0,69.27
桃園縣,大園鄉,南港村,294,1,1017,9,1026,1593,3,1,3,0,1,0,64.41
桃園縣,大溪鎮,興和里,295,1,627,8,635,907,3,1,3,0,1,0,70.01
桃園縣,大溪鎮,興和里,296,1,553,4,557,803,3,1,3,0,1,0,69.36
桃園縣,大溪鎮,福仁里,297,1,796,15,811,1148,3,1,3,0,1,0,70.64
桃園縣,大溪鎮,一心里,298,1,992,8,1000,1457,3,1,3,0,1,0,68.63
桃園縣,大溪鎮,一心里,299,1,830,20,850,1309,3,1,3,0,1,0,64.94
桃園縣,大溪鎮,一心里,300,1,872,18,890,1344,3,1,3,0,1,0,66.22
桃園縣,大溪鎮,一心里,301,1,909,11,920,1357,3,1,3,0,1,0,67.80
桃園縣,大溪鎮,一德里,302,1,744,13,757,1185,3,1,3,0,1,0,63.88
桃園縣,大溪鎮,一德里,303,1,732,13,745,1072,3,1,3,0,1,0,69.50
桃園縣,大溪鎮,一德里,304,1,629,6,635,1029,3,1,3,0,1,0,61.71
桃園縣,大溪鎮,月眉里,305,1,644,15,659,964,3,1,3,0,1,0,68.36
桃園縣,大溪鎮,永福里,306,1,601,10,611,891,3,1,3,0,1,0,68.57
桃園縣,大溪鎮,康安里,307,1,690,11,701,993,3,1,3,0,1,0,70.59
桃園縣,大溪鎮,義和里,308,1,664,6,670,984,3,1,3,0,1,0,68.09
桃園縣,大溪鎮,義和里,309,1,403,7,410,598,3,1,3,0,1,0,68.56
桃園縣,大溪鎮,美華里,310,1,983,18,1001,1540,3,1,3,0,1,0,65.00
桃園縣,大溪鎮,美華里,311,1,383,9,392,638,3,1,3,0,1,0,61.44
桃園縣,大溪鎮,福安里,312,1,722,10,732,1121,3,1,3,0,1,0,65.30
桃園縣,大溪鎮,福安里,313,1,683,8,691,970,3,1,3,0,1,0,71.24
桃園縣,大溪鎮,復興里,314,1,586,16,602,950,3,1,3,0,1,0,63.37
桃園縣,大溪鎮,新峰里,315,1,454,10,464,697,3,1,3,0,1,0,66.57
桃園縣,大溪鎮,新峰里,316,1,191,1,192,306,3,1,3,0,1,0,62.75
桃園縣,大溪鎮,中新里,317,1,1038,24,1062,1544,3,1,3,0,1,0,68.78
桃園縣,大溪鎮,瑞興里,318,1,914,26,940,1360,3,1,3,0,1,0,69.12
桃園縣,大溪鎮,瑞興里,319,1,386,5,391,552,3,1,3,0,1,0,70.83
桃園縣,大溪鎮,仁善里,320,1,869,18,887,1321,3,1,3,0,1,0,67.15
桃園縣,大溪鎮,仁善里,321,1,605,12,617,878,3,1,3,0,1,0,70.27
桃園縣,大溪鎮,僑愛里,322,1,1107,13,1120,1446,3,1,3,0,1,0,77.46
桃園縣,大溪鎮,仁義里,323,1,880,25,905,1257,3,1,3,0,1,0,72.00
桃園縣,大溪鎮,仁義里,324,1,1005,28,1033,1434,3,1,3,0,1,0,72.04
桃園縣,大溪鎮,仁愛里,325,1,573,12,585,848,3,1,3,0,1,0,68.99
桃園縣,大溪鎮,仁愛里,326,1,692,24,716,1129,3,1,3,0,1,0,63.42
桃園縣,大溪鎮,仁愛里,327,1,913,8,921,1281,3,1,3,0,1,0,71.90
桃園縣,大溪鎮,仁武里,328,1,757,9,766,1105,3,1,3,0,1,0,69.32
桃園縣,大溪鎮,仁武里,329,1,1099,12,1111,1510,3,1,3,0,1,0,73.58
桃園縣,大溪鎮,仁武里,330,1,891,21,912,1355,3,1,3,0,1,0,67.31
桃園縣,大溪鎮,仁武里,331,1,885,13,898,1365,3,1,3,0,1,0,65.79
桃園縣,大溪鎮,南興里,332,1,765,16,781,1130,3,1,3,0,1,0,69.12
桃園縣,大溪鎮,南興里,333,1,821,12,833,1202,3,1,3,0,1,0,69.30
桃園縣,大溪鎮,南興里,334,1,720,22,742,1066,3,1,3,0,1,0,69.61
桃園縣,大溪鎮,員林里,335,1,897,14,911,1186,3,1,3,0,1,0,76.81
桃園縣,大溪鎮,員林里,336,1,881,9,890,1248,3,1,3,0,1,0,71.31
桃園縣,大溪鎮,員林里,337,1,808,10,818,1232,3,1,3,0,1,0,66.40
桃園縣,大溪鎮,員林里,338,1,1076,23,1099,1489,3,1,3,0,1,0,73.81
桃園縣,大溪鎮,瑞源里,339,1,792,11,803,1246,3,1,3,0,1,0,64.45
桃園縣,大溪鎮,瑞源里,340,1,815,11,826,1191,3,1,3,0,1,0,69.35
桃園縣,復興鄉,三民村,341,1,711,12,723,1228,3,1,3,0,1,0,58.88
桃園縣,復興鄉,澤仁村,342,1,411,2,413,604,3,1,3,0,1,0,68.38
桃園縣,復興鄉,長興村,343,1,67,1,68,121,3,1,3,0,1,0,56.20
桃園縣,復興鄉,奎輝村,344,1,23,0,23,41,3,1,3,0,1,0,56.10
桃園縣,復興鄉,羅浮村,345,1,183,1,184,302,3,1,3,0,1,0,60.93
桃園縣,復興鄉,霞雲村,346,1,23,0,23,40,3,1,3,0,1,0,57.50
桃園縣,復興鄉,義盛村,347,1,26,1,27,42,3,1,3,0,1,0,64.29
桃園縣,復興鄉,高義村,348,1,25,1,26,53,3,1,3,0,1,0,49.06
桃園縣,復興鄉,三光村,349,1,26,0,26,58,3,1,3,0,1,0,44.83
桃園縣,復興鄉,華陵村,350,1,89,0,89,231,3,1,3,0,1,0,38.53
桃園縣,中壢市,後寮里,351,1,1155,21,1176,1797,3,1,3,0,1,0,65.44
桃園縣,中壢市,後寮里,352,1,1237,25,1262,1911,3,1,3,0,1,0,66.04
桃園縣,中壢市,後寮里,353,1,1014,7,1021,1486,3,1,3,0,1,0,68.71
桃園縣,中壢市,後寮里,354,1,1150,13,1163,1733,3,1,3,0,1,0,67.11
桃園縣,中壢市,龍興里,355,1,1045,20,1065,1516,3,1,3,0,1,0,70.25
桃園縣,中壢市,龍興里,356,1,935,12,947,1394,3,1,3,0,1,0,67.93
桃園縣,中壢市,龍興里,357,1,1027,10,1037,1442,3,1,3,0,1,0,71.91
桃園縣,中壢市,龍興里,358,1,887,15,902,1320,3,1,3,0,1,0,68.33
桃園縣,中壢市,龍岡里,359,1,1177,16,1193,1667,3,1,3,0,1,0,71.57
桃園縣,中壢市,龍岡里,360,1,1185,29,1214,1669,3,1,3,0,1,0,72.74
桃園縣,中壢市,龍東里,361,1,1420,21,1441,2007,3,1,3,0,1,0,71.80
桃園縣,中壢市,龍東里,362,1,1369,25,1394,1875,3,1,3,0,1,0,74.35
桃園縣,中壢市,龍昌里,363,1,1341,27,1368,1983,3,1,3,0,1,0,68.99
桃園縣,中壢市,龍昌里,364,1,1183,25,1208,1622,3,1,3,0,1,0,74.48
桃園縣,中壢市,龍平里,365,1,1364,28,1392,1885,3,1,3,0,1,0,73.85
桃園縣,中壢市,龍平里,366,1,1294,28,1322,1819,3,1,3,0,1,0,72.68
桃園縣,中壢市,龍平里,367,1,1197,15,1212,1671,3,1,3,0,1,0,72.53
桃園縣,中壢市,仁美里,368,1,882,9,891,1260,3,1,3,0,1,0,70.71
桃園縣,中壢市,仁美里,369,1,826,30,856,1249,3,1,3,0,1,0,68.53
桃園縣,中壢市,仁美里,370,1,1121,20,1141,1693,3,1,3,0,1,0,67.40
桃園縣,中壢市,仁美里,371,1,889,12,901,1229,3,1,3,0,1,0,73.31
桃園縣,中壢市,仁愛里,372,1,1006,18,1024,1522,3,1,3,0,1,0,67.28
桃園縣,中壢市,仁愛里,373,1,1003,24,1027,1523,3,1,3,0,1,0,67.43
桃園縣,中壢市,仁德里,374,1,877,17,894,1223,3,1,3,0,1,0,73.10
桃園縣,中壢市,仁德里,375,1,835,21,856,1299,3,1,3,0,1,0,65.90
桃園縣,中壢市,仁德里,376,1,751,9,760,1142,3,1,3,0,1,0,66.55
桃園縣,中壢市,仁祥里,377,1,1087,15,1102,1664,3,1,3,0,1,0,66.23
桃園縣,中壢市,仁祥里,378,1,1145,21,1166,1710,3,1,3,0,1,0,68.19
桃園縣,中壢市,仁祥里,379,1,1162,22,1184,1678,3,1,3,0,1,0,70.56
桃園縣,中壢市,中堅里,380,1,1226,21,1247,1641,3,1,3,0,1,0,75.99
桃園縣,中壢市,中堅里,381,1,771,15,786,1059,3,1,3,0,1,0,74.22
桃園縣,中壢市,中堅里,382,1,748,12,760,1050,3,1,3,0,1,0,72.38
桃園縣,中壢市,普仁里,383,1,998,17,1015,1573,3,1,3,0,1,0,64.53
桃園縣,中壢市,普仁里,384,1,1002,15,1017,1682,3,1,3,0,1,0,60.46
桃園縣,中壢市,普仁里,385,1,760,17,777,1225,3,1,3,0,1,0,63.43
桃園縣,中壢市,普仁里,386,1,898,12,910,1247,3,1,3,0,1,0,72.98
桃園縣,中壢市,普仁里,387,1,818,3,821,1163,3,1,3,0,1,0,70.59
桃園縣,中壢市,普慶里,388,1,839,11,850,1318,3,1,3,0,1,0,64.49
桃園縣,中壢市,普慶里,389,1,713,13,726,1024,3,1,3,0,1,0,70.90
桃園縣,中壢市,普義里,390,1,873,14,887,1272,3,1,3,0,1,0,69.73
桃園縣,中壢市,普義里,391,1,949,14,963,1490,3,1,3,0,1,0,64.63
桃園縣,中壢市,普義里,392,1,996,16,1012,1415,3,1,3,0,1,0,71.52
桃園縣,中壢市,普義里,393,1,886,9,895,1329,3,1,3,0,1,0,67.34
桃園縣,中壢市,信義里,394,1,1290,11,1301,1961,3,1,3,0,1,0,66.34
桃園縣,中壢市,信義里,395,1,1450,13,1463,2248,3,1,3,0,1,0,65.08
桃園縣,中壢市,信義里,396,1,882,20,902,1326,3,1,3,0,1,0,68.02
桃園縣,中壢市,忠義里,397,1,946,13,959,1447,3,1,3,0,1,0,66.28
桃園縣,中壢市,興仁里,398,1,888,7,895,1234,3,1,3,0,1,0,72.53
桃園縣,中壢市,興仁里,399,1,730,20,750,1136,3,1,3,0,1,0,66.02
桃園縣,中壢市,興仁里,400,1,788,11,799,1167,3,1,3,0,1,0,68.47
桃園縣,中壢市,中正里,401,1,921,14,935,1303,3,1,3,0,1,0,71.76
桃園縣,中壢市,中正里,402,1,895,19,914,1395,3,1,3,0,1,0,65.52
桃園縣,中壢市,中正里,403,1,921,11,932,1404,3,1,3,0,1,0,66.38
桃園縣,中壢市,篤行里,404,1,1089,22,1111,1514,3,1,3,0,1,0,73.38
桃園縣,中壢市,內壢里,405,1,828,17,845,1186,3,1,3,0,1,0,71.25
桃園縣,中壢市,內壢里,406,1,945,22,967,1344,3,1,3,0,1,0,71.95
桃園縣,中壢市,成功里,407,1,895,3,898,1240,3,1,3,0,1,0,72.42
桃園縣,中壢市,成功里,408,1,1411,21,1432,2083,3,1,3,0,1,0,68.75
桃園縣,中壢市,成功里,409,1,856,17,873,1275,3,1,3,0,1,0,68.47
桃園縣,中壢市,中原里,410,1,688,13,701,964,3,1,3,0,1,0,72.72
桃園縣,中壢市,中原里,411,1,878,8,886,1175,3,1,3,0,1,0,75.40
桃園縣,中壢市,中原里,412,1,763,13,776,1145,3,1,3,0,1,0,67.77
桃園縣,中壢市,中原里,413,1,1079,17,1096,1535,3,1,3,0,1,0,71.40
桃園縣,中壢市,復興里,414,1,1016,9,1025,1472,3,1,3,0,1,0,69.63
桃園縣,中壢市,復興里,415,1,962,10,972,1386,3,1,3,0,1,0,70.13
桃園縣,中壢市,復興里,416,1,867,14,881,1288,3,1,3,0,1,0,68.40
桃園縣,中壢市,復興里,417,1,989,21,1010,1463,3,1,3,0,1,0,69.04
桃園縣,中壢市,文化里,418,1,718,16,734,1066,3,1,3,0,1,0,68.86
桃園縣,中壢市,文化里,419,1,804,14,818,1207,3,1,3,0,1,0,67.77
桃園縣,中壢市,文化里,420,1,914,26,940,1366,3,1,3,0,1,0,68.81
桃園縣,中壢市,文化里,421,1,884,12,896,1361,3,1,3,0,1,0,65.83
桃園縣,中壢市,自立里,422,1,1054,11,1065,1366,3,1,3,0,1,0,77.96
桃園縣,中壢市,自立里,423,1,1088,12,1100,1465,3,1,3,0,1,0,75.09
桃園縣,中壢市,自強里,424,1,1153,12,1165,1539,3,1,3,0,1,0,75.70
桃園縣,中壢市,自強里,425,1,1045,17,1062,1398,3,1,3,0,1,0,75.97
桃園縣,中壢市,自強里,426,1,1052,6,1058,1462,3,1,3,0,1,0,72.37
桃園縣,中壢市,內定里,427,1,835,17,852,1099,3,1,3,0,1,0,77.53
桃園縣,中壢市,內定里,428,1,805,11,816,1199,3,1,3,0,1,0,68.06
桃園縣,中壢市,石頭里,429,1,565,9,574,931,3,1,3,0,1,0,61.65
桃園縣,中壢市,石頭里,430,1,648,15,663,1108,3,1,3,0,1,0,59.84
桃園縣,中壢市,中央里,431,1,819,15,834,1227,3,1,3,0,1,0,67.97
桃園縣,中壢市,中央里,432,1,667,8,675,1040,3,1,3,0,1,0,64.90
桃園縣,中壢市,中央里,433,1,817,8,825,1201,3,1,3,0,1,0,68.69
桃園縣,中壢市,新興里,434,1,856,16,872,1276,3,1,3,0,1,0,68.34
桃園縣,中壢市,新興里,435,1,1041,17,1058,1507,3,1,3,0,1,0,70.21
桃園縣,中壢市,新興里,436,1,850,8,858,1277,3,1,3,0,1,0,67.19
桃園縣,中壢市,振興里,437,1,599,7,606,853,3,1,3,0,1,0,71.04
桃園縣,中壢市,振興里,438,1,866,21,887,1279,3,1,3,0,1,0,69.35
桃園縣,中壢市,振興里,439,1,867,19,886,1236,3,1,3,0,1,0,71.68
桃園縣,中壢市,東興里,440,1,1023,14,1037,1522,3,1,3,0,1,0,68.13
桃園縣,中壢市,東興里,441,1,1064,11,1075,1610,3,1,3,0,1,0,66.77
桃園縣,中壢市,東興里,442,1,1051,12,1063,1566,3,1,3,0,1,0,67.88
桃園縣,中壢市,水尾里,443,1,963,15,978,1410,3,1,3,0,1,0,69.36
桃園縣,中壢市,水尾里,444,1,1225,10,1235,1902,3,1,3,0,1,0,64.93
桃園縣,中壢市,忠福里,445,1,943,15,958,1441,3,1,3,0,1,0,66.48
桃園縣,中壢市,忠福里,446,1,901,12,913,1512,3,1,3,0,1,0,60.38
桃園縣,中壢市,忠福里,447,1,1051,10,1061,1753,3,1,3,0,1,0,60.52
桃園縣,中壢市,忠福里,448,1,893,21,914,1529,3,1,3,0,1,0,59.78
桃園縣,中壢市,忠福里,449,1,808,8,816,1201,3,1,3,0,1,0,67.94
桃園縣,中壢市,忠福里,450,1,663,8,671,1042,3,1,3,0,1,0,64.40
桃園縣,中壢市,忠福里,451,1,924,14,938,1265,3,1,3,0,1,0,74.15
桃園縣,中壢市,青埔里,452,1,920,9,929,1283,3,1,3,0,1,0,72.41
桃園縣,中壢市,新街里,453,1,1189,15,1204,1762,3,1,3,0,1,0,68.33
桃園縣,中壢市,興南里,454,1,980,18,998,1493,3,1,3,0,1,0,66.85
桃園縣,中壢市,興國里,455,1,855,9,864,1359,3,1,3,0,1,0,63.58
桃園縣,中壢市,興國里,456,1,915,10,925,1357,3,1,3,0,1,0,68.17
桃園縣,中壢市,興國里,457,1,985,8,993,1482,3,1,3,0,1,0,67.00
桃園縣,中壢市,興和里,458,1,711,6,717,991,3,1,3,0,1,0,72.35
桃園縣,中壢市,興和里,459,1,872,21,893,1294,3,1,3,0,1,0,69.01
桃園縣,中壢市,永興里,460,1,689,14,703,1099,3,1,3,0,1,0,63.97
桃園縣,中壢市,中壢里,461,1,644,11,655,979,3,1,3,0,1,0,66.91
桃園縣,中壢市,中榮里,462,1,752,6,758,1190,3,1,3,0,1,0,63.70
桃園縣,中壢市,中建里,463,1,803,2,805,1145,3,1,3,0,1,0,70.31
桃園縣,中壢市,舊明里,464,1,865,9,874,1249,3,1,3,0,1,0,69.98
桃園縣,中壢市,舊明里,465,1,750,10,760,1027,3,1,3,0,1,0,74.00
桃園縣,中壢市,新明里,466,1,762,14,776,1131,3,1,3,0,1,0,68.61
桃園縣,中壢市,新明里,467,1,753,13,766,1126,3,1,3,0,1,0,68.03
桃園縣,中壢市,新明里,468,1,833,6,839,1271,3,1,3,0,1,0,66.01
桃園縣,中壢市,光明里,469,1,810,14,824,1254,3,1,3,0,1,0,65.71
桃園縣,中壢市,光明里,470,1,909,10,919,1329,3,1,3,0,1,0,69.15
桃園縣,中壢市,光明里,471,1,1024,11,1035,1564,3,1,3,0,1,0,66.18
桃園縣,中壢市,永光里,472,1,751,15,766,1108,3,1,3,0,1,0,69.13
桃園縣,中壢市,永光里,473,1,986,7,993,1508,3,1,3,0,1,0,65.85
桃園縣,中壢市,三民里,474,1,744,11,755,1101,3,1,3,0,1,0,68.57
桃園縣,中壢市,三民里,475,1,783,14,797,1208,3,1,3,0,1,0,65.98
桃園縣,中壢市,五權里,476,1,676,16,692,1077,3,1,3,0,1,0,64.25
桃園縣,中壢市,五權里,477,1,646,11,657,966,3,1,3,0,1,0,68.01
桃園縣,中壢市,五權里,478,1,1032,20,1052,1686,3,1,3,0,1,0,62.40
桃園縣,中壢市,五權里,479,1,952,18,970,1490,3,1,3,0,1,0,65.10
桃園縣,中壢市,五權里,480,1,1011,16,1027,1497,3,1,3,0,1,0,68.60
桃園縣,中壢市,芝芭里,481,1,1280,19,1299,1776,3,1,3,0,1,0,73.14
桃園縣,中壢市,洽溪里,482,1,905,28,933,1277,3,1,3,0,1,0,73.06
桃園縣,中壢市,內厝里,483,1,1006,15,1021,1507,3,1,3,0,1,0,67.75
桃園縣,中壢市,內厝里,484,1,848,12,860,1288,3,1,3,0,1,0,66.77
桃園縣,中壢市,月眉里,485,1,740,9,749,1079,3,1,3,0,1,0,69.42
桃園縣,中壢市,月眉里,486,1,934,11,945,1303,3,1,3,0,1,0,72.52
桃園縣,中壢市,山東里,487,1,912,21,933,1299,3,1,3,0,1,0,71.82
桃園縣,中壢市,山東里,488,1,732,14,746,1099,3,1,3,0,1,0,67.88
桃園縣,中壢市,過嶺里,489,1,744,7,751,1087,3,1,3,0,1,0,69.09
桃園縣,中壢市,過嶺里,490,1,701,9,710,1018,3,1,3,0,1,0,69.74
桃園縣,平鎮市,新勢里,491,1,1032,11,1043,1521,3,1,3,0,1,0,68.57
桃園縣,平鎮市,新勢里,492,1,1026,19,1045,1500,3,1,3,0,1,0,69.67
桃園縣,平鎮市,新榮里,493,1,896,23,919,1256,3,1,3,0,1,0,73.17
桃園縣,平鎮市,新榮里,494,1,996,16,1012,1457,3,1,3,0,1,0,69.46
桃園縣,平鎮市,新富里,495,1,675,5,680,1005,3,1,3,0,1,0,67.66
桃園縣,平鎮市,新富里,496,1,862,14,876,1395,3,1,3,0,1,0,62.80
桃園縣,平鎮市,北華里,497,1,1187,21,1208,1728,3,1,3,0,1,0,69.91
桃園縣,平鎮市,北安里,498,1,1106,16,1122,1581,3,1,3,0,1,0,70.97
桃園縣,平鎮市,北勢里,499,1,754,5,759,1076,3,1,3,0,1,0,70.54
桃園縣,平鎮市,北勢里,500,1,713,9,722,1008,3,1,3,0,1,0,71.63
桃園縣,平鎮市,新貴里,501,1,873,14,887,1333,3,1,3,0,1,0,66.54
桃園縣,平鎮市,新貴里,502,1,651,8,659,922,3,1,3,0,1,0,71.48
桃園縣,平鎮市,金陵里,503,1,1106,9,1115,1481,3,1,3,0,1,0,75.29
桃園縣,平鎮市,北興里,504,1,1013,12,1025,1464,3,1,3,0,1,0,70.01
桃園縣,平鎮市,北興里,505,1,948,20,968,1370,3,1,3,0,1,0,70.66
桃園縣,平鎮市,北貴里,506,1,808,7,815,1146,3,1,3,0,1,0,71.12
桃園縣,平鎮市,北貴里,507,1,936,14,950,1284,3,1,3,0,1,0,73.99
桃園縣,平鎮市,北富里,508,1,1325,19,1344,1927,3,1,3,0,1,0,69.75
桃園縣,平鎮市,龍恩里,509,1,878,25,903,1269,3,1,3,0,1,0,71.16
桃園縣,平鎮市,龍恩里,510,1,782,23,805,1122,3,1,3,0,1,0,71.75
桃園縣,平鎮市,東社里,511,1,1032,17,1049,1455,3,1,3,0,1,0,72.10
桃園縣,平鎮市,東社里,512,1,967,18,985,1321,3,1,3,0,1,0,74.56
桃園縣,平鎮市,龍興里,513,1,750,20,770,1052,3,1,3,0,1,0,73.19
桃園縣,平鎮市,龍興里,514,1,763,19,782,1165,3,1,3,0,1,0,67.12
桃園縣,平鎮市,忠貞里,515,1,963,26,989,1339,3,1,3,0,1,0,73.86
桃園縣,平鎮市,中正里,516,1,903,12,915,1198,3,1,3,0,1,0,76.38
桃園縣,平鎮市,貿易里,517,1,1100,26,1126,1425,3,1,3,0,1,0,79.02
桃園縣,平鎮市,貿易里,518,1,737,15,752,992,3,1,3,0,1,0,75.81
桃園縣,平鎮市,建安里,519,1,824,19,843,1237,3,1,3,0,1,0,68.15
桃園縣,平鎮市,建安里,520,1,931,9,940,1322,3,1,3,0,1,0,71.10
桃園縣,平鎮市,華安里,521,1,898,26,924,1305,3,1,3,0,1,0,70.80
桃園縣,平鎮市,華安里,522,1,850,15,865,1200,3,1,3,0,1,0,72.08
桃園縣,平鎮市,東安里,523,1,1335,25,1360,1917,3,1,3,0,1,0,70.94
桃園縣,平鎮市,新安里,524,1,1510,35,1545,2217,3,1,3,0,1,0,69.69
桃園縣,平鎮市,東勢里,525,1,730,14,744,1017,3,1,3,0,1,0,73.16
桃園縣,平鎮市,東勢里,526,1,718,9,727,987,3,1,3,0,1,0,73.66
桃園縣,平鎮市,東勢里,527,1,598,11,609,994,3,1,3,0,1,0,61.27
桃園縣,平鎮市,莊敬里,528,1,881,13,894,1256,3,1,3,0,1,0,71.18
桃園縣,平鎮市,莊敬里,529,1,880,17,897,1266,3,1,3,0,1,0,70.85
桃園縣,平鎮市,莊敬里,530,1,787,17,804,1237,3,1,3,0,1,0,65.00
桃園縣,平鎮市,湧豐里,531,1,895,18,913,1273,3,1,3,0,1,0,71.72
桃園縣,平鎮市,湧光里,532,1,915,10,925,1275,3,1,3,0,1,0,72.55
桃園縣,平鎮市,湧光里,533,1,871,23,894,1229,3,1,3,0,1,0,72.74
桃園縣,平鎮市,湧光里,534,1,965,27,992,1412,3,1,3,0,1,0,70.25
桃園縣,平鎮市,湧安里,535,1,722,10,732,1100,3,1,3,0,1,0,66.55
桃園縣,平鎮市,湧安里,536,1,808,13,821,1229,3,1,3,0,1,0,66.80
桃園縣,平鎮市,廣興里,537,1,1028,18,1046,1499,3,1,3,0,1,0,69.78
桃園縣,平鎮市,廣興里,538,1,1041,14,1055,1525,3,1,3,0,1,0,69.18
桃園縣,平鎮市,廣達里,539,1,1068,9,1077,1565,3,1,3,0,1,0,68.82
桃園縣,平鎮市,廣達里,540,1,767,9,776,1135,3,1,3,0,1,0,68.37
桃園縣,平鎮市,復旦里,541,1,749,12,761,1220,3,1,3,0,1,0,62.38
桃園縣,平鎮市,復旦里,542,1,742,12,754,1094,3,1,3,0,1,0,68.92
桃園縣,平鎮市,復旦里,543,1,1016,22,1038,1593,3,1,3,0,1,0,65.16
桃園縣,平鎮市,義興里,544,1,866,20,886,1279,3,1,3,0,1,0,69.27
桃園縣,平鎮市,義興里,545,1,824,13,837,1281,3,1,3,0,1,0,65.34
桃園縣,平鎮市,義興里,546,1,778,16,794,1135,3,1,3,0,1,0,69.96
桃園縣,平鎮市,義民里,547,1,850,12,862,1286,3,1,3,0,1,0,67.03
桃園縣,平鎮市,義民里,548,1,891,18,909,1396,3,1,3,0,1,0,65.11
桃園縣,平鎮市,宋屋里,549,1,1000,15,1015,1545,3,1,3,0,1,0,65.70
桃園縣,平鎮市,宋屋里,550,1,581,14,595,840,3,1,3,0,1,0,70.83
桃園縣,平鎮市,廣仁里,551,1,657,13,670,997,3,1,3,0,1,0,67.20
桃園縣,平鎮市,廣仁里,552,1,625,19,644,982,3,1,3,0,1,0,65.58
桃園縣,平鎮市,廣仁里,553,1,589,8,597,1040,3,1,3,0,1,0,57.40
桃園縣,平鎮市,雙連里,554,1,978,23,1001,1439,3,1,3,0,1,0,69.56
桃園縣,平鎮市,雙連里,555,1,1111,17,1128,1645,3,1,3,0,1,0,68.57
桃園縣,平鎮市,高雙里,556,1,694,8,702,1056,3,1,3,0,1,0,66.48
桃園縣,平鎮市,高雙里,557,1,702,5,707,1063,3,1,3,0,1,0,66.51
桃園縣,平鎮市,平鎮里,558,1,992,22,1014,1485,3,1,3,0,1,0,68.28
桃園縣,平鎮市,平鎮里,559,1,999,24,1023,1417,3,1,3,0,1,0,72.19
桃園縣,平鎮市,鎮興里,560,1,763,19,782,1114,3,1,3,0,1,0,70.20
桃園縣,平鎮市,鎮興里,561,1,590,6,596,817,3,1,3,0,1,0,72.95
桃園縣,平鎮市,金星里,562,1,962,17,979,1514,3,1,3,0,1,0,64.66
桃園縣,平鎮市,金星里,563,1,798,17,815,1288,3,1,3,0,1,0,63.28
桃園縣,平鎮市,金星里,564,1,812,19,831,1170,3,1,3,0,1,0,71.03
桃園縣,平鎮市,金星里,565,1,913,11,924,1307,3,1,3,0,1,0,70.70
桃園縣,平鎮市,南勢里,566,1,904,9,913,1373,3,1,3,0,1,0,66.50
桃園縣,平鎮市,南勢里,567,1,954,13,967,1400,3,1,3,0,1,0,69.07
桃園縣,平鎮市,福林里,568,1,528,7,535,734,3,1,3,0,1,0,72.89
桃園縣,平鎮市,福林里,569,1,776,21,797,1062,3,1,3,0,1,0,75.05
桃園縣,平鎮市,山峰里,570,1,727,18,745,1133,3,1,3,0,1,0,65.75
桃園縣,平鎮市,山峰里,571,1,751,11,762,1049,3,1,3,0,1,0,72.64
桃園縣,楊梅鎮,仁美里,572,1,754,10,764,1154,3,1,3,0,1,0,66.20
桃園縣,楊梅鎮,仁美里,573,1,1059,13,1072,1474,3,1,3,0,1,0,72.73
桃園縣,楊梅鎮,仁美里,574,1,734,19,753,1041,3,1,3,0,1,0,72.33
桃園縣,楊梅鎮,埔心里,575,1,1125,19,1144,1580,3,1,3,0,1,0,72.41
桃園縣,楊梅鎮,光華里,576,1,907,18,925,1244,3,1,3,0,1,0,74.36
桃園縣,楊梅鎮,光華里,577,1,854,16,870,1241,3,1,3,0,1,0,70.10
桃園縣,楊梅鎮,金龍里,578,1,723,13,736,940,3,1,3,0,1,0,78.30
桃園縣,楊梅鎮,金龍里,579,1,524,11,535,721,3,1,3,0,1,0,74.20
桃園縣,楊梅鎮,四維里,580,1,615,9,624,839,3,1,3,0,1,0,74.37
桃園縣,楊梅鎮,四維里,581,1,652,7,659,883,3,1,3,0,1,0,74.63
桃園縣,楊梅鎮,瑞塘里,582,1,798,6,804,1303,3,1,3,0,1,0,61.70
桃園縣,楊梅鎮,瑞塘里,583,1,784,23,807,1288,3,1,3,0,1,0,62.66
桃園縣,楊梅鎮,瑞塘里,584,1,848,15,863,1257,3,1,3,0,1,0,68.66
桃園縣,楊梅鎮,瑞塘里,585,1,929,14,943,1421,3,1,3,0,1,0,66.36
桃園縣,楊梅鎮,梅溪里,586,1,895,12,907,1352,3,1,3,0,1,0,67.09
桃園縣,楊梅鎮,梅溪里,587,1,468,3,471,736,3,1,3,0,1,0,63.99
桃園縣,楊梅鎮,梅溪里,588,1,686,9,695,1258,3,1,3,0,1,0,55.25
桃園縣,楊梅鎮,梅溪里,589,1,1038,26,1064,1647,3,1,3,0,1,0,64.60
桃園縣,楊梅鎮,大同里,590,1,849,16,865,1153,3,1,3,0,1,0,75.02
桃園縣,楊梅鎮,大同里,591,1,822,15,837,1261,3,1,3,0,1,0,66.38
桃園縣,楊梅鎮,大同里,592,1,918,10,928,1317,3,1,3,0,1,0,70.46
桃園縣,楊梅鎮,楊梅里,593,1,1009,9,1018,1406,3,1,3,0,1,0,72.40
桃園縣,楊梅鎮,楊梅里,594,1,941,13,954,1339,3,1,3,0,1,0,71.25
桃園縣,楊梅鎮,楊江里,595,1,794,7,801,1140,3,1,3,0,1,0,70.26
桃園縣,楊梅鎮,梅新里,596,1,1044,19,1063,1639,3,1,3,0,1,0,64.86
桃園縣,楊梅鎮,紅梅里,597,1,628,11,639,961,3,1,3,0,1,0,66.49
桃園縣,楊梅鎮,紅梅里,598,1,753,14,767,1086,3,1,3,0,1,0,70.63
桃園縣,楊梅鎮,永寧里,599,1,1028,16,1044,1462,3,1,3,0,1,0,71.41
桃園縣,楊梅鎮,永寧里,600,1,1009,18,1027,1442,3,1,3,0,1,0,71.22
桃園縣,楊梅鎮,大平里,601,1,861,14,875,1250,3,1,3,0,1,0,70.00
桃園縣,楊梅鎮,大平里,602,1,923,13,936,1321,3,1,3,0,1,0,70.86
桃園縣,楊梅鎮,大平里,603,1,897,24,921,1289,3,1,3,0,1,0,71.45
桃園縣,楊梅鎮,大平里,604,1,884,15,899,1383,3,1,3,0,1,0,65.00
桃園縣,楊梅鎮,東流里,605,1,998,16,1014,1406,3,1,3,0,1,0,72.12
桃園縣,楊梅鎮,豐野里,606,1,942,19,961,1440,3,1,3,0,1,0,66.74
桃園縣,楊梅鎮,豐野里,607,1,868,12,880,1281,3,1,3,0,1,0,68.70
桃園縣,楊梅鎮,富岡里,608,1,890,13,903,1290,3,1,3,0,1,0,70.00
桃園縣,楊梅鎮,富岡里,609,1,858,13,871,1250,3,1,3,0,1,0,69.68
桃園縣,楊梅鎮,富岡里,610,1,821,18,839,1304,3,1,3,0,1,0,64.34
桃園縣,楊梅鎮,員本里,611,1,956,21,977,1488,3,1,3,0,1,0,65.66
桃園縣,楊梅鎮,三湖里,612,1,1035,14,1049,1497,3,1,3,0,1,0,70.07
桃園縣,楊梅鎮,上湖里,613,1,741,24,765,1188,3,1,3,0,1,0,64.39
桃園縣,楊梅鎮,上湖里,614,1,724,14,738,1159,3,1,3,0,1,0,63.68
桃園縣,楊梅鎮,上田里,615,1,667,13,680,1027,3,1,3,0,1,0,66.21
桃園縣,楊梅鎮,上田里,616,1,525,9,534,815,3,1,3,0,1,0,65.52
桃園縣,楊梅鎮,高山里,617,1,604,9,613,1001,3,1,3,0,1,0,61.24
桃園縣,楊梅鎮,高山里,618,1,625,9,634,1049,3,1,3,0,1,0,60.44
桃園縣,楊梅鎮,高山里,619,1,825,30,855,1299,3,1,3,0,1,0,65.82
桃園縣,楊梅鎮,高榮里,620,1,997,19,1016,1471,3,1,3,0,1,0,69.07
桃園縣,楊梅鎮,高榮里,621,1,542,14,556,981,3,1,3,0,1,0,56.68
桃園縣,楊梅鎮,高榮里,622,1,760,10,770,1110,3,1,3,0,1,0,69.37
桃園縣,楊梅鎮,高榮里,623,1,526,11,537,810,3,1,3,0,1,0,66.30
桃園縣,楊梅鎮,水美里,624,1,931,18,949,1356,3,1,3,0,1,0,69.99
桃園縣,楊梅鎮,水美里,625,1,882,15,897,1322,3,1,3,0,1,0,67.85
桃園縣,楊梅鎮,瑞原里,626,1,854,18,872,1254,3,1,3,0,1,0,69.54
桃園縣,楊梅鎮,瑞原里,627,1,772,18,790,1264,3,1,3,0,1,0,62.50
桃園縣,龍潭鄉,黃唐村,628,1,1191,11,1202,1795,3,1,3,0,1,0,66.96
桃園縣,龍潭鄉,黃唐村,629,1,998,24,1022,1531,3,1,3,0,1,0,66.75
桃園縣,龍潭鄉,黃唐村,630,1,972,17,989,1446,3,1,3,0,1,0,68.40
桃園縣,龍潭鄉,中山村,631,1,1244,9,1253,1680,3,1,3,0,1,0,74.58
桃園縣,龍潭鄉,中山村,632,1,1013,15,1028,1435,3,1,3,0,1,0,71.64
桃園縣,龍潭鄉,烏林村,633,1,902,21,923,1353,3,1,3,0,1,0,68.22
桃園縣,龍潭鄉,烏林村,634,1,942,18,960,1398,3,1,3,0,1,0,68.67
桃園縣,龍潭鄉,烏林村,635,1,1029,18,1047,1496,3,1,3,0,1,0,69.99
桃園縣,龍潭鄉,干城村,636,1,574,11,585,735,3,1,3,0,1,0,79.59
桃園縣,龍潭鄉,凌雲村,637,1,1178,13,1191,1606,3,1,3,0,1,0,74.16
桃園縣,龍潭鄉,凌雲村,638,1,1092,18,1110,1690,3,1,3,0,1,0,65.68
桃園縣,龍潭鄉,凌雲村,639,1,949,11,960,1389,3,1,3,0,1,0,69.11
桃園縣,龍潭鄉,八德村,640,1,713,12,725,1101,3,1,3,0,1,0,65.85
桃園縣,龍潭鄉,八德村,641,1,575,13,588,929,3,1,3,0,1,0,63.29
桃園縣,龍潭鄉,八德村,642,1,708,14,722,1111,3,1,3,0,1,0,64.99
桃園縣,龍潭鄉,八德村,643,1,813,11,824,1179,3,1,3,0,1,0,69.89
桃園縣,龍潭鄉,上林村,644,1,1329,30,1359,1979,3,1,3,0,1,0,68.67
桃園縣,龍潭鄉,龍潭村,645,1,728,2,730,1004,3,1,3,0,1,0,72.71
桃園縣,龍潭鄉,龍潭村,646,1,761,10,771,1018,3,1,3,0,1,0,75.74
桃園縣,龍潭鄉,中正村,647,1,1172,15,1187,1550,3,1,3,0,1,0,76.58
桃園縣,龍潭鄉,中正村,648,1,1471,29,1500,2211,3,1,3,0,1,0,67.84
桃園縣,龍潭鄉,中正村,649,1,1057,21,1078,1522,3,1,3,0,1,0,70.83
桃園縣,龍潭鄉,九龍村,650,1,983,18,1001,1503,3,1,3,0,1,0,66.60
桃園縣,龍潭鄉,九龍村,651,1,1283,30,1313,1994,3,1,3,0,1,0,65.85
桃園縣,龍潭鄉,中興村,652,1,871,10,881,1207,3,1,3,0,1,0,72.99
桃園縣,龍潭鄉,中興村,653,1,1142,25,1167,1650,3,1,3,0,1,0,70.73
桃園縣,龍潭鄉,中興村,654,1,1151,34,1185,1748,3,1,3,0,1,0,67.79
桃園縣,龍潭鄉,中興村,655,1,1168,29,1197,1880,3,1,3,0,1,0,63.67
桃園縣,龍潭鄉,佳安村,656,1,1059,6,1065,1516,3,1,3,0,1,0,70.25
桃園縣,龍潭鄉,佳安村,657,1,914,12,926,1193,3,1,3,0,1,0,77.62
桃園縣,龍潭鄉,三坑村,658,1,840,14,854,1264,3,1,3,0,1,0,67.56
桃園縣,龍潭鄉,大平村,659,1,488,7,495,759,3,1,3,0,1,0,65.22
桃園縣,龍潭鄉,三林村,660,1,1115,9,1124,1537,3,1,3,0,1,0,73.13
桃園縣,龍潭鄉,三林村,661,1,1093,11,1104,1498,3,1,3,0,1,0,73.70
桃園縣,龍潭鄉,三林村,662,1,1140,13,1153,1555,3,1,3,0,1,0,74.15
桃園縣,龍潭鄉,三林村,663,1,993,15,1008,1417,3,1,3,0,1,0,71.14
桃園縣,龍潭鄉,高平村,664,1,1211,23,1234,1810,3,1,3,0,1,0,68.18
桃園縣,龍潭鄉,高原村,665,1,1253,23,1276,1855,3,1,3,0,1,0,68.79
桃園縣,龍潭鄉,三和村,666,1,579,13,592,818,3,1,3,0,1,0,72.37
桃園縣,龍潭鄉,三水村,667,1,492,8,500,653,3,1,3,0,1,0,76.57
桃園縣,新屋鄉,新屋村,668,1,898,11,909,1230,3,1,3,0,1,0,73.90
桃園縣,新屋鄉,新屋村,669,1,728,6,734,1027,3,1,3,0,1,0,71.47
桃園縣,新屋鄉,新生村,670,1,878,10,888,1186,3,1,3,0,1,0,74.87
桃園縣,新屋鄉,新生村,671,1,1051,11,1062,1429,3,1,3,0,1,0,74.32
桃園縣,新屋鄉,後湖村,672,1,757,10,767,1036,3,1,3,0,1,0,74.03
桃園縣,新屋鄉,清華村,673,1,926,16,942,1271,3,1,3,0,1,0,74.11
桃園縣,新屋鄉,清華村,674,1,791,8,799,1158,3,1,3,0,1,0,69.00
桃園縣,新屋鄉,石磊村,675,1,1109,13,1122,1525,3,1,3,0,1,0,73.57
桃園縣,新屋鄉,東明村,676,1,742,10,752,1017,3,1,3,0,1,0,73.94
桃園縣,新屋鄉,社子村,677,1,972,12,984,1303,3,1,3,0,1,0,75.52
桃園縣,新屋鄉,埔頂村,678,1,1190,22,1212,1783,3,1,3,0,1,0,67.98
桃園縣,新屋鄉,九斗村,679,1,1088,15,1103,1565,3,1,3,0,1,0,70.48
桃園縣,新屋鄉,頭洲村,680,1,1014,23,1037,1475,3,1,3,0,1,0,70.31
桃園縣,新屋鄉,頭洲村,681,1,690,11,701,1018,3,1,3,0,1,0,68.86
桃園縣,新屋鄉,大坡村,682,1,953,9,962,1370,3,1,3,0,1,0,70.22
桃園縣,新屋鄉,望間村,683,1,1110,10,1120,1536,3,1,3,0,1,0,72.92
桃園縣,新屋鄉,後庄村,684,1,749,16,765,1127,3,1,3,0,1,0,67.88
桃園縣,新屋鄉,蚵間村,685,1,527,11,538,796,3,1,3,0,1,0,67.59
桃園縣,新屋鄉,深圳村,686,1,473,6,479,716,3,1,3,0,1,0,66.90
桃園縣,新屋鄉,康榔村,687,1,725,2,727,1079,3,1,3,0,1,0,67.38
桃園縣,新屋鄉,笨港村,688,1,771,18,789,1102,3,1,3,0,1,0,71.60
桃園縣,新屋鄉,永安村,689,1,602,4,606,862,3,1,3,0,1,0,70.30
桃園縣,新屋鄉,永安村,690,1,883,5,888,1201,3,1,3,0,1,0,73.94
桃園縣,新屋鄉,永興村,691,1,546,5,551,939,3,1,3,0,1,0,58.68
桃園縣,新屋鄉,下埔村,692,1,501,10,511,737,3,1,3,0,1,0,69.34
桃園縣,新屋鄉,石牌村,693,1,594,5,599,827,3,1,3,0,1,0,72.43
桃園縣,新屋鄉,下田村,694,1,1022,12,1034,1433,3,1,3,0,1,0,72.16
桃園縣,新屋鄉,赤欄村,695,1,728,16,744,1032,3,1,3,0,1,0,72.09
桃園縣,觀音鄉,觀音村,696,1,732,12,744,1042,3,1,3,0,1,0,71.40
桃園縣,觀音鄉,觀音村,697,1,771,12,783,1096,3,1,3,0,1,0,71.44
桃園縣,觀音鄉,白玉村,698,1,819,11,830,1150,3,1,3,0,1,0,72.17
桃園縣,觀音鄉,廣興村,699,1,844,15,859,1280,3,1,3,0,1,0,67.11
桃園縣,觀音鄉,大潭村,700,1,763,12,775,1084,3,1,3,0,1,0,71.49
桃園縣,觀音鄉,保生村,701,1,1015,19,1034,1376,3,1,3,0,1,0,75.15
桃園縣,觀音鄉,武威村,702,1,477,8,485,688,3,1,3,0,1,0,70.49
桃園縣,觀音鄉,三和村,703,1,552,6,558,736,3,1,3,0,1,0,75.82
桃園縣,觀音鄉,新興村,704,1,470,9,479,675,3,1,3,0,1,0,70.96
桃園縣,觀音鄉,坑尾村,705,1,763,13,776,1032,3,1,3,0,1,0,75.19
桃園縣,觀音鄉,金湖村,706,1,1003,18,1021,1508,3,1,3,0,1,0,67.71
桃園縣,觀音鄉,藍埔村,707,1,1080,15,1095,1540,3,1,3,0,1,0,71.10
桃園縣,觀音鄉,大同村,708,1,980,8,988,1465,3,1,3,0,1,0,67.44
桃園縣,觀音鄉,大堀村,709,1,585,10,595,862,3,1,3,0,1,0,69.03
桃園縣,觀音鄉,崙坪村,710,1,969,13,982,1453,3,1,3,0,1,0,67.58
桃園縣,觀音鄉,崙坪村,711,1,1056,22,1078,1558,3,1,3,0,1,0,69.19
桃園縣,觀音鄉,富源村,712,1,955,13,968,1447,3,1,3,0,1,0,66.90
桃園縣,觀音鄉,上大村,713,1,890,9,899,1289,3,1,3,0,1,0,69.74
桃園縣,觀音鄉,新坡村,714,1,808,6,814,1215,3,1,3,0,1,0,67.00
桃園縣,觀音鄉,新坡村,715,1,793,8,801,1225,3,1,3,0,1,0,65.39
桃園縣,觀音鄉,廣福村,716,1,1116,19,1135,1614,3,1,3,0,1,0,70.32
桃園縣,觀音鄉,保障村,717,1,701,10,711,971,3,1,3,0,1,0,73.22
桃園縣,觀音鄉,保障村,718,1,1008,13,1021,1483,3,1,3,0,1,0,68.85
桃園縣,觀音鄉,草漯村,719,1,775,7,782,1107,3,1,3,0,1,0,70.64
桃園縣,觀音鄉,草漯村,720,1,872,12,884,1385,3,1,3,0,1,0,63.83
桃園縣,觀音鄉,樹林村,721,1,854,18,872,1370,3,1,3,0,1,0,63.65
桃園縣,觀音鄉,富林村,722,1,830,14,844,1206,3,1,3,0,1,0,69.98
新竹縣,竹北市,鹿場里,1,1,682,13,695,943,3,1,3,0,1,0,73.70
新竹縣,竹北市,東平里,2,1,343,6,349,433,3,1,3,0,1,0,80.60
新竹縣,竹北市,中興里,3,1,829,19,848,1184,3,1,3,0,1,0,71.62
新竹縣,竹北市,隘口里,4,1,527,4,531,738,3,1,3,0,1,0,71.95
新竹縣,竹北市,東海里,5,1,718,7,725,1088,3,1,3,0,1,0,66.64
新竹縣,竹北市,東海里,6,1,708,9,717,1016,3,1,3,0,1,0,70.57
新竹縣,竹北市,十興里,7,1,875,18,893,1293,3,1,3,0,1,0,69.06
新竹縣,竹北市,十興里,8,1,726,19,745,1081,3,1,3,0,1,0,68.92
新竹縣,竹北市,十興里,9,1,659,7,666,1010,3,1,3,0,1,0,65.94
新竹縣,竹北市,斗崙里,10,1,695,11,706,1123,3,1,3,0,1,0,62.87
新竹縣,竹北市,斗崙里,11,1,816,20,836,1298,3,1,3,0,1,0,64.41
新竹縣,竹北市,斗崙里,12,1,785,14,799,1347,3,1,3,0,1,0,59.32
新竹縣,竹北市,斗崙里,13,1,462,12,474,782,3,1,3,0,1,0,60.61
新竹縣,竹北市,斗崙里,14,1,506,2,508,766,3,1,3,0,1,0,66.32
新竹縣,竹北市,竹北里,15,1,894,15,909,1440,3,1,3,0,1,0,63.13
新竹縣,竹北市,竹北里,16,1,567,8,575,941,3,1,3,0,1,0,61.11
新竹縣,竹北市,竹仁里,17,1,608,11,619,1044,3,1,3,0,1,0,59.29
新竹縣,竹北市,竹仁里,18,1,714,11,725,1184,3,1,3,0,1,0,61.23
新竹縣,竹北市,竹仁里,19,1,648,8,656,1151,3,1,3,0,1,0,56.99
新竹縣,竹北市,竹仁里,20,1,705,12,717,1133,3,1,3,0,1,0,63.28
新竹縣,竹北市,竹義里,21,1,842,8,850,1247,3,1,3,0,1,0,68.16
新竹縣,竹北市,竹義里,22,1,793,17,810,1304,3,1,3,0,1,0,62.12
新竹縣,竹北市,竹義里,23,1,650,12,662,1132,3,1,3,0,1,0,58.48
新竹縣,竹北市,竹義里,24,1,578,10,588,940,3,1,3,0,1,0,62.55
新竹縣,竹北市,竹義里,25,1,604,9,613,1001,3,1,3,0,1,0,61.24
新竹縣,竹北市,泰和里,26,1,726,10,736,1051,3,1,3,0,1,0,70.03
新竹縣,竹北市,泰和里,27,1,912,6,918,1572,3,1,3,0,1,0,58.40
新竹縣,竹北市,新社里,28,1,754,13,767,1286,3,1,3,0,1,0,59.64
新竹縣,竹北市,新社里,29,1,596,11,607,1074,3,1,3,0,1,0,56.52
新竹縣,竹北市,新社里,30,1,690,18,708,1280,3,1,3,0,1,0,55.31
新竹縣,竹北市,新國里,31,1,726,12,738,1332,3,1,3,0,1,0,55.41
新竹縣,竹北市,新國里,32,1,758,16,774,1363,3,1,3,0,1,0,56.79
新竹縣,竹北市,聯興里,33,1,802,20,822,1225,3,1,3,0,1,0,67.10
新竹縣,竹北市,聯興里,34,1,623,13,636,1032,3,1,3,0,1,0,61.63
新竹縣,竹北市,麻園里,35,1,667,18,685,991,3,1,3,0,1,0,69.12
新竹縣,竹北市,溪州里,36,1,777,17,794,1400,3,1,3,0,1,0,56.71
新竹縣,竹北市,新庄里,37,1,437,9,446,713,3,1,3,0,1,0,62.55
新竹縣,竹北市,白地里,38,1,771,22,793,1347,3,1,3,0,1,0,58.87
新竹縣,竹北市,新港里,39,1,538,12,550,962,3,1,3,0,1,0,57.17
新竹縣,竹北市,大眉里,40,1,662,19,681,1194,3,1,3,0,1,0,57.04
新竹縣,竹北市,大義里,41,1,717,9,726,1188,3,1,3,0,1,0,61.11
新竹縣,竹北市,尚義里,42,1,730,9,739,1241,3,1,3,0,1,0,59.55
新竹縣,竹北市,崇義里,43,1,796,4,800,1324,3,1,3,0,1,0,60.42
新竹縣,竹東鎮,上坪里,44,1,325,2,327,464,3,1,3,0,1,0,70.47
新竹縣,竹東鎮,瑞峰里,45,1,235,3,238,359,3,1,3,0,1,0,66.30
新竹縣,竹東鎮,軟橋里,46,1,283,6,289,400,3,1,3,0,1,0,72.25
新竹縣,竹東鎮,員崠里,47,1,489,10,499,725,3,1,3,0,1,0,68.83
新竹縣,竹東鎮,員崠里,48,1,596,5,601,901,3,1,3,0,1,0,66.70
新竹縣,竹東鎮,上舘里,49,1,696,11,707,1049,3,1,3,0,1,0,67.40
新竹縣,竹東鎮,上舘里,50,1,643,13,656,966,3,1,3,0,1,0,67.91
新竹縣,竹東鎮,上舘里,51,1,550,13,563,820,3,1,3,0,1,0,68.66
新竹縣,竹東鎮,上舘里,52,1,593,7,600,920,3,1,3,0,1,0,65.22
新竹縣,竹東鎮,上舘里,53,1,631,14,645,929,3,1,3,0,1,0,69.43
新竹縣,竹東鎮,東寧里,54,1,522,6,528,817,3,1,3,0,1,0,64.63
新竹縣,竹東鎮,東寧里,55,1,550,8,558,842,3,1,3,0,1,0,66.27
新竹縣,竹東鎮,東寧里,56,1,629,8,637,891,3,1,3,0,1,0,71.49
新竹縣,竹東鎮,中正里,57,1,472,13,485,692,3,1,3,0,1,0,70.09
新竹縣,竹東鎮,中正里,58,1,542,6,548,748,3,1,3,0,1,0,73.26
新竹縣,竹東鎮,大鄉里,59,1,604,12,616,885,3,1,3,0,1,0,69.60
新竹縣,竹東鎮,大鄉里,60,1,655,9,664,960,3,1,3,0,1,0,69.17
新竹縣,竹東鎮,大鄉里,61,1,624,15,639,888,3,1,3,0,1,0,71.96
新竹縣,竹東鎮,中山里,62,1,684,5,689,961,3,1,3,0,1,0,71.70
新竹縣,竹東鎮,中山里,63,1,692,9,701,961,3,1,3,0,1,0,72.94
新竹縣,竹東鎮,南華里,64,1,867,12,879,1201,3,1,3,0,1,0,73.19
新竹縣,竹東鎮,東華里,65,1,572,7,579,822,3,1,3,0,1,0,70.44
新竹縣,竹東鎮,商華里,66,1,678,13,691,1021,3,1,3,0,1,0,67.68
新竹縣,竹東鎮,商華里,67,1,697,14,711,982,3,1,3,0,1,0,72.40
新竹縣,竹東鎮,鷄林里,68,1,626,12,638,939,3,1,3,0,1,0,67.94
新竹縣,竹東鎮,鷄林里,69,1,832,20,852,1236,3,1,3,0,1,0,68.93
新竹縣,竹東鎮,鷄林里,70,1,719,12,731,1032,3,1,3,0,1,0,70.83
新竹縣,竹東鎮,仁愛里,71,1,725,12,737,1113,3,1,3,0,1,0,66.22
新竹縣,竹東鎮,仁愛里,72,1,882,13,895,1278,3,1,3,0,1,0,70.03
新竹縣,竹東鎮,竹東里,73,1,510,9,519,681,3,1,3,0,1,0,76.21
新竹縣,竹東鎮,竹東里,74,1,612,5,617,845,3,1,3,0,1,0,73.02
新竹縣,竹東鎮,忠孝里,75,1,818,16,834,1246,3,1,3,0,1,0,66.93
新竹縣,竹東鎮,榮樂里,76,1,496,5,501,709,3,1,3,0,1,0,70.66
新竹縣,竹東鎮,榮樂里,77,1,501,7,508,726,3,1,3,0,1,0,69.97
新竹縣,竹東鎮,榮華里,78,1,670,13,683,1003,3,1,3,0,1,0,68.10
新竹縣,竹東鎮,榮華里,79,1,732,14,746,1048,3,1,3,0,1,0,71.18
新竹縣,竹東鎮,榮華里,80,1,585,11,596,862,3,1,3,0,1,0,69.14
新竹縣,竹東鎮,榮華里,81,1,685,11,696,1026,3,1,3,0,1,0,67.84
新竹縣,竹東鎮,榮華里,82,1,592,10,602,932,3,1,3,0,1,0,64.59
新竹縣,竹東鎮,五豐里,83,1,661,7,668,1055,3,1,3,0,1,0,63.32
新竹縣,竹東鎮,五豐里,84,1,512,9,521,761,3,1,3,0,1,0,68.46
新竹縣,竹東鎮,五豐里,85,1,574,9,583,865,3,1,3,0,1,0,67.40
新竹縣,竹東鎮,五豐里,86,1,550,10,560,796,3,1,3,0,1,0,70.35
新竹縣,竹東鎮,陸豐里,87,1,308,3,311,439,3,1,3,0,1,0,70.84
新竹縣,竹東鎮,三重里,88,1,875,14,889,1386,3,1,3,0,1,0,64.14
新竹縣,竹東鎮,三重里,89,1,487,12,499,771,3,1,3,0,1,0,64.72
新竹縣,竹東鎮,三重里,90,1,460,6,466,649,3,1,3,0,1,0,71.80
新竹縣,竹東鎮,三重里,91,1,643,10,653,978,3,1,3,0,1,0,66.77
新竹縣,竹東鎮,二重里,92,1,828,15,843,1229,3,1,3,0,1,0,68.59
新竹縣,竹東鎮,二重里,93,1,762,11,773,1118,3,1,3,0,1,0,69.14
新竹縣,竹東鎮,二重里,94,1,845,10,855,1320,3,1,3,0,1,0,64.77
新竹縣,竹東鎮,二重里,95,1,818,22,840,1283,3,1,3,0,1,0,65.47
新竹縣,竹東鎮,頭重里,96,1,683,9,692,1029,3,1,3,0,1,0,67.25
新竹縣,竹東鎮,頭重里,97,1,581,9,590,865,3,1,3,0,1,0,68.21
新竹縣,竹東鎮,頭重里,98,1,820,16,836,1166,3,1,3,0,1,0,71.70
新竹縣,竹東鎮,員山里,99,1,897,20,917,1286,3,1,3,0,1,0,71.31
新竹縣,竹東鎮,柯湖里,100,1,462,8,470,705,3,1,3,0,1,0,66.67
新竹縣,新埔鎮,新埔里,101,1,702,7,709,976,3,1,3,0,1,0,72.64
新竹縣,新埔鎮,新生里,102,1,463,3,466,659,3,1,3,0,1,0,70.71
新竹縣,新埔鎮,新民里,103,1,681,12,693,1004,3,1,3,0,1,0,69.02
新竹縣,新埔鎮,田新里,104,1,1012,11,1023,1467,3,1,3,0,1,0,69.73
新竹縣,新埔鎮,田新里,105,1,520,6,526,745,3,1,3,0,1,0,70.60
新竹縣,新埔鎮,旱坑里,106,1,1182,24,1206,1581,3,1,3,0,1,0,76.28
新竹縣,新埔鎮,五埔里,107,1,1082,24,1106,1572,3,1,3,0,1,0,70.36
新竹縣,新埔鎮,四座里,108,1,899,22,921,1327,3,1,3,0,1,0,69.40
新竹縣,新埔鎮,四座里,109,1,762,11,773,1143,3,1,3,0,1,0,67.63
新竹縣,新埔鎮,照門里,110,1,956,14,970,1393,3,1,3,0,1,0,69.63
新竹縣,新埔鎮,清水里,111,1,333,3,336,438,3,1,3,0,1,0,76.71
新竹縣,新埔鎮,鹿鳴里,112,1,467,7,474,712,3,1,3,0,1,0,66.57
新竹縣,新埔鎮,新北里,113,1,395,11,406,613,3,1,3,0,1,0,66.23
新竹縣,新埔鎮,巨埔里,114,1,736,19,755,1122,3,1,3,0,1,0,67.29
新竹縣,新埔鎮,內立里,115,1,739,15,754,1112,3,1,3,0,1,0,67.81
新竹縣,新埔鎮,寶石里,116,1,479,8,487,697,3,1,3,0,1,0,69.87
新竹縣,新埔鎮,文山里,117,1,745,16,761,1198,3,1,3,0,1,0,63.52
新竹縣,新埔鎮,文山里,118,1,684,16,700,984,3,1,3,0,1,0,71.14
新竹縣,新埔鎮,文山里,119,1,655,5,660,1101,3,1,3,0,1,0,59.95
新竹縣,新埔鎮,上寮里,120,1,997,20,1017,1479,3,1,3,0,1,0,68.76
新竹縣,新埔鎮,下寮里,121,1,1100,17,1117,1603,3,1,3,0,1,0,69.68
新竹縣,新埔鎮,南平里,122,1,637,13,650,945,3,1,3,0,1,0,68.78
新竹縣,新埔鎮,北平里,123,1,475,4,479,647,3,1,3,0,1,0,74.03
新竹縣,關西鎮,東興里,124,1,443,6,449,618,3,1,3,0,1,0,72.65
新竹縣,關西鎮,西安里,125,1,1008,24,1032,1458,3,1,3,0,1,0,70.78
新竹縣,關西鎮,南雄里,126,1,503,8,511,737,3,1,3,0,1,0,69.34
新竹縣,關西鎮,北斗里,127,1,564,3,567,831,3,1,3,0,1,0,68.23
新竹縣,關西鎮,北斗里,128,1,756,6,762,1105,3,1,3,0,1,0,68.96
新竹縣,關西鎮,北斗里,129,1,908,16,924,1363,3,1,3,0,1,0,67.79
新竹縣,關西鎮,北山里,130,1,533,8,541,764,3,1,3,0,1,0,70.81
新竹縣,關西鎮,仁安里,131,1,592,17,609,885,3,1,3,0,1,0,68.81
新竹縣,關西鎮,南山里,132,1,688,7,695,1038,3,1,3,0,1,0,66.96
新竹縣,關西鎮,東安里,133,1,776,15,791,1175,3,1,3,0,1,0,67.32
新竹縣,關西鎮,東安里,134,1,762,18,780,1213,3,1,3,0,1,0,64.30
新竹縣,關西鎮,東山里,135,1,495,11,506,728,3,1,3,0,1,0,69.51
新竹縣,關西鎮,東光里,136,1,757,13,770,1109,3,1,3,0,1,0,69.43
新竹縣,關西鎮,南新里,137,1,655,13,668,1010,3,1,3,0,1,0,66.14
新竹縣,關西鎮,新富里,138,1,383,6,389,608,3,1,3,0,1,0,63.98
新竹縣,關西鎮,玉山里,139,1,340,4,344,546,3,1,3,0,1,0,63.00
新竹縣,關西鎮,金山里,140,1,422,6,428,671,3,1,3,0,1,0,63.79
新竹縣,關西鎮,錦山里,141,1,594,17,611,936,3,1,3,0,1,0,65.28
新竹縣,關西鎮,大同里,142,1,511,4,515,709,3,1,3,0,1,0,72.64
新竹縣,關西鎮,石光里,143,1,617,9,626,902,3,1,3,0,1,0,69.40
新竹縣,關西鎮,石光里,144,1,606,10,616,937,3,1,3,0,1,0,65.74
新竹縣,關西鎮,東平里,145,1,639,18,657,991,3,1,3,0,1,0,66.30
新竹縣,關西鎮,上林里,146,1,603,7,610,864,3,1,3,0,1,0,70.60
新竹縣,關西鎮,新力里,147,1,412,7,419,601,3,1,3,0,1,0,69.72
新竹縣,關西鎮,南和里,148,1,535,6,541,768,3,1,3,0,1,0,70.44
新竹縣,湖口鄉,和興村,149,1,882,15,897,1338,3,1,3,0,1,0,67.04
新竹縣,湖口鄉,和興村,150,1,821,16,837,1355,3,1,3,0,1,0,61.77
新竹縣,湖口鄉,和興村,151,1,966,13,979,1453,3,1,3,0,1,0,67.38
新竹縣,湖口鄉,德盛村,152,1,917,17,934,1325,3,1,3,0,1,0,70.49
新竹縣,湖口鄉,德盛村,153,1,884,13,897,1388,3,1,3,0,1,0,64.63
新竹縣,湖口鄉,愛勢村,154,1,792,9,801,1127,3,1,3,0,1,0,71.07
新竹縣,湖口鄉,愛勢村,155,1,819,20,839,1219,3,1,3,0,1,0,68.83
新竹縣,湖口鄉,愛勢村,156,1,684,18,702,1085,3,1,3,0,1,0,64.70
新竹縣,湖口鄉,仁勢村,157,1,519,10,529,812,3,1,3,0,1,0,65.15
新竹縣,湖口鄉,孝勢村,158,1,736,21,757,1066,3,1,3,0,1,0,71.01
新竹縣,湖口鄉,中勢村,159,1,800,18,818,1264,3,1,3,0,1,0,64.72
新竹縣,湖口鄉,中勢村,160,1,1089,16,1105,1571,3,1,3,0,1,0,70.34
新竹縣,湖口鄉,中勢村,161,1,825,7,832,1190,3,1,3,0,1,0,69.92
新竹縣,湖口鄉,信勢村,162,1,1090,24,1114,1582,3,1,3,0,1,0,70.42
新竹縣,湖口鄉,信勢村,163,1,900,10,910,1362,3,1,3,0,1,0,66.81
新竹縣,湖口鄉,信勢村,164,1,852,12,864,1334,3,1,3,0,1,0,64.77
新竹縣,湖口鄉,波羅村,165,1,518,4,522,812,3,1,3,0,1,0,64.29
新竹縣,湖口鄉,長嶺村,166,1,633,18,651,909,3,1,3,0,1,0,71.62
新竹縣,湖口鄉,長嶺村,167,1,661,22,683,1105,3,1,3,0,1,0,61.81
新竹縣,湖口鄉,長安村,168,1,659,14,673,982,3,1,3,0,1,0,68.53
新竹縣,湖口鄉,湖口村,169,1,857,21,878,1306,3,1,3,0,1,0,67.23
新竹縣,湖口鄉,湖口村,170,1,426,4,430,642,3,1,3,0,1,0,66.98
新竹縣,湖口鄉,湖鏡村,171,1,730,9,739,1117,3,1,3,0,1,0,66.16
新竹縣,湖口鄉,湖鏡村,172,1,594,11,605,863,3,1,3,0,1,0,70.10
新竹縣,湖口鄉,湖南村,173,1,755,14,769,1243,3,1,3,0,1,0,61.87
新竹縣,湖口鄉,中興村,174,1,1015,21,1036,1497,3,1,3,0,1,0,69.21
新竹縣,湖口鄉,中興村,175,1,954,26,980,1379,3,1,3,0,1,0,71.07
新竹縣,湖口鄉,鳳凰村,176,1,605,8,613,968,3,1,3,0,1,0,63.33
新竹縣,湖口鄉,鳳凰村,177,1,879,20,899,1458,3,1,3,0,1,0,61.66
新竹縣,湖口鄉,鳳凰村,178,1,1109,26,1135,1734,3,1,3,0,1,0,65.46
新竹縣,湖口鄉,鳳山村,179,1,631,19,650,1136,3,1,3,0,1,0,57.22
新竹縣,湖口鄉,鳳山村,180,1,789,15,804,1216,3,1,3,0,1,0,66.12
新竹縣,新豐鄉,福興村,181,1,540,11,551,747,3,1,3,0,1,0,73.76
新竹縣,新豐鄉,後湖村,182,1,1055,17,1072,1529,3,1,3,0,1,0,70.11
新竹縣,新豐鄉,青埔村,183,1,902,24,926,1261,3,1,3,0,1,0,73.43
新竹縣,新豐鄉,埔和村,184,1,637,10,647,1111,3,1,3,0,1,0,58.24
新竹縣,新豐鄉,埔和村,185,1,444,1,445,798,3,1,3,0,1,0,55.76
新竹縣,新豐鄉,坡頭村,186,1,453,9,462,717,3,1,3,0,1,0,64.44
新竹縣,新豐鄉,新豐村,187,1,620,12,632,1015,3,1,3,0,1,0,62.27
新竹縣,新豐鄉,新豐村,188,1,579,6,585,949,3,1,3,0,1,0,61.64
新竹縣,新豐鄉,瑞興村,189,1,756,13,769,1080,3,1,3,0,1,0,71.20
新竹縣,新豐鄉,中崙村,190,1,938,19,957,1467,3,1,3,0,1,0,65.24
新竹縣,新豐鄉,重興村,191,1,1135,17,1152,1902,3,1,3,0,1,0,60.57
新竹縣,新豐鄉,重興村,192,1,1098,20,1118,1779,3,1,3,0,1,0,62.84
新竹縣,新豐鄉,重興村,193,1,564,20,584,967,3,1,3,0,1,0,60.39
新竹縣,新豐鄉,上坑村,194,1,692,8,700,1137,3,1,3,0,1,0,61.57
新竹縣,新豐鄉,鳳坑村,195,1,614,20,634,899,3,1,3,0,1,0,70.52
新竹縣,新豐鄉,員山村,196,1,811,19,830,1283,3,1,3,0,1,0,64.69
新竹縣,新豐鄉,員山村,197,1,846,9,855,1229,3,1,3,0,1,0,69.57
新竹縣,新豐鄉,員山村,198,1,784,11,795,1231,3,1,3,0,1,0,64.58
新竹縣,新豐鄉,員山村,199,1,829,8,837,1301,3,1,3,0,1,0,64.34
新竹縣,新豐鄉,松林村,200,1,655,11,666,1027,3,1,3,0,1,0,64.85
新竹縣,新豐鄉,松林村,201,1,665,9,674,1201,3,1,3,0,1,0,56.12
新竹縣,新豐鄉,松林村,202,1,673,9,682,1207,3,1,3,0,1,0,56.50
新竹縣,芎林鄉,華龍村,203,1,291,3,294,419,3,1,3,0,1,0,70.17
新竹縣,芎林鄉,五龍村,204,1,367,8,375,495,3,1,3,0,1,0,75.76
新竹縣,芎林鄉,秀湖村,205,1,498,12,510,738,3,1,3,0,1,0,69.11
新竹縣,芎林鄉,永興村,206,1,296,6,302,400,3,1,3,0,1,0,75.50
新竹縣,芎林鄉,石潭村,207,1,796,18,814,1206,3,1,3,0,1,0,67.50
新竹縣,芎林鄉,石潭村,208,1,556,12,568,862,3,1,3,0,1,0,65.89
新竹縣,芎林鄉,新鳳村,209,1,982,19,1001,1443,3,1,3,0,1,0,69.37
新竹縣,芎林鄉,中坑村,210,1,344,7,351,521,3,1,3,0,1,0,67.37
新竹縣,芎林鄉,水坑村,211,1,399,13,412,597,3,1,3,0,1,0,69.01
新竹縣,芎林鄉,文林村,212,1,656,7,663,996,3,1,3,0,1,0,66.57
新竹縣,芎林鄉,文林村,213,1,535,11,546,774,3,1,3,0,1,0,70.54
新竹縣,芎林鄉,芎林村,214,1,928,22,950,1357,3,1,3,0,1,0,70.01
新竹縣,芎林鄉,上山村,215,1,727,12,739,1098,3,1,3,0,1,0,67.30
新竹縣,芎林鄉,上山村,216,1,568,7,575,913,3,1,3,0,1,0,62.98
新竹縣,芎林鄉,下山村,217,1,695,12,707,983,3,1,3,0,1,0,71.92
新竹縣,橫山鄉,橫山村,218,1,805,13,818,1135,3,1,3,0,1,0,72.07
新竹縣,橫山鄉,橫山村,219,1,644,8,652,952,3,1,3,0,1,0,68.49
新竹縣,橫山鄉,橫山村,220,1,728,17,745,1132,3,1,3,0,1,0,65.81
新竹縣,橫山鄉,田寮村,221,1,584,6,590,821,3,1,3,0,1,0,71.86
新竹縣,橫山鄉,南昌村,222,1,97,1,98,139,3,1,3,0,1,0,70.50
新竹縣,橫山鄉,豐鄉村,223,1,96,0,96,128,3,1,3,0,1,0,75.00
新竹縣,橫山鄉,豐田村,224,1,215,4,219,317,3,1,3,0,1,0,69.09
新竹縣,橫山鄉,內灣村,225,1,796,16,812,1180,3,1,3,0,1,0,68.81
新竹縣,橫山鄉,力行村,226,1,388,12,400,595,3,1,3,0,1,0,67.23
新竹縣,橫山鄉,力行村,227,1,185,5,190,252,3,1,3,0,1,0,75.40
新竹縣,橫山鄉,福興村,228,1,337,2,339,480,3,1,3,0,1,0,70.63
新竹縣,橫山鄉,沙坑村,229,1,545,8,553,776,3,1,3,0,1,0,71.26
新竹縣,橫山鄉,沙坑村,230,1,264,4,268,373,3,1,3,0,1,0,71.85
新竹縣,橫山鄉,新興村,231,1,525,8,533,738,3,1,3,0,1,0,72.22
新竹縣,橫山鄉,新興村,232,1,589,8,597,795,3,1,3,0,1,0,75.09
新竹縣,橫山鄉,大肚村,233,1,890,19,909,1289,3,1,3,0,1,0,70.52
新竹縣,北埔鄉,北埔村,234,1,749,9,758,1125,3,1,3,0,1,0,67.38
新竹縣,北埔鄉,南興村,235,1,922,17,939,1321,3,1,3,0,1,0,71.08
新竹縣,北埔鄉,大湖村,236,1,312,2,314,466,3,1,3,0,1,0,67.38
新竹縣,北埔鄉,埔尾村,237,1,640,12,652,908,3,1,3,0,1,0,71.81
新竹縣,北埔鄉,埔尾村,238,1,947,14,961,1436,3,1,3,0,1,0,66.92
新竹縣,北埔鄉,水際村,239,1,476,14,490,785,3,1,3,0,1,0,62.42
新竹縣,北埔鄉,南埔村,240,1,257,5,262,337,3,1,3,0,1,0,77.74
新竹縣,北埔鄉,大林村,241,1,433,6,439,614,3,1,3,0,1,0,71.50
新竹縣,北埔鄉,南坑村,242,1,229,3,232,341,3,1,3,0,1,0,68.04
新竹縣,北埔鄉,外坪村,243,1,185,3,188,296,3,1,3,0,1,0,63.51
新竹縣,寶山鄉,雙溪村,244,1,634,11,645,990,3,1,3,0,1,0,65.15
新竹縣,寶山鄉,雙溪村,245,1,1061,10,1071,1662,3,1,3,0,1,0,64.44
新竹縣,寶山鄉,大崎村,246,1,563,9,572,890,3,1,3,0,1,0,64.27
新竹縣,寶山鄉,三峰村,247,1,484,12,496,728,3,1,3,0,1,0,68.13
新竹縣,寶山鄉,新城村,248,1,668,9,677,1076,3,1,3,0,1,0,62.92
新竹縣,寶山鄉,寶斗村,249,1,396,5,401,654,3,1,3,0,1,0,61.31
新竹縣,寶山鄉,深井村,250,1,422,6,428,693,3,1,3,0,1,0,61.76
新竹縣,寶山鄉,寶山村,251,1,430,9,439,597,3,1,3,0,1,0,73.53
新竹縣,寶山鄉,油田村,252,1,379,8,387,557,3,1,3,0,1,0,69.48
新竹縣,寶山鄉,山湖村,253,1,368,4,372,516,3,1,3,0,1,0,72.09
新竹縣,峨眉鄉,峨眉村,254,1,615,7,622,874,3,1,3,0,1,0,71.17
新竹縣,峨眉鄉,中盛村,255,1,483,9,492,708,3,1,3,0,1,0,69.49
新竹縣,峨眉鄉,石井村,256,1,424,5,429,618,3,1,3,0,1,0,69.42
新竹縣,峨眉鄉,七星村,257,1,214,2,216,330,3,1,3,0,1,0,65.45
新竹縣,峨眉鄉,七星村,258,1,218,4,222,310,3,1,3,0,1,0,71.61
新竹縣,峨眉鄉,富興村,259,1,744,6,750,1208,3,1,3,0,1,0,62.09
新竹縣,峨眉鄉,湖光村,260,1,329,4,333,566,3,1,3,0,1,0,58.83
新竹縣,峨眉鄉,湖光村,261,1,256,5,261,412,3,1,3,0,1,0,63.35
新竹縣,尖石鄉,嘉樂村,262,1,299,7,306,425,3,1,3,0,1,0,72.00
新竹縣,尖石鄉,義興村,263,1,14,2,16,31,3,1,3,0,1,0,51.61
新竹縣,尖石鄉,嘉樂村,264,1,92,2,94,150,3,1,3,0,1,0,62.67
新竹縣,尖石鄉,新樂村,265,1,96,0,96,178,3,1,3,0,1,0,53.93
新竹縣,尖石鄉,錦屏村,266,1,32,1,33,69,3,1,3,0,1,0,47.83
新竹縣,尖石鄉,錦屏村,267,1,43,1,44,79,3,1,3,0,1,0,55.70
新竹縣,尖石鄉,梅花村,268,1,31,1,32,50,3,1,3,0,1,0,64.00
新竹縣,尖石鄉,玉峰村,269,1,12,1,13,23,3,1,3,0,1,0,56.52
新竹縣,尖石鄉,玉峰村,270,1,6,0,6,12,3,1,3,0,1,0,50.00
新竹縣,尖石鄉,秀巒村,271,1,8,0,8,16,3,1,3,0,1,0,50.00
新竹縣,尖石鄉,秀巒村,272,1,13,0,13,40,3,1,3,0,1,0,32.50
新竹縣,尖石鄉,秀巒村,273,1,9,0,9,14,3,1,3,0,1,0,64.29
新竹縣,五峰鄉,大隘村,274,1,92,1,93,150,3,1,3,0,1,0,62.00
新竹縣,五峰鄉,大隘村,275,1,13,0,13,43,3,1,3,0,1,0,30.23
新竹縣,五峰鄉,花園村,276,1,53,0,53,88,3,1,3,0,1,0,60.23
新竹縣,五峰鄉,竹林村,277,1,7,0,7,14,3,1,3,0,1,0,50.00
新竹縣,五峰鄉,桃山村,278,1,29,1,30,43,3,1,3,0,1,0,69.77
新竹縣,五峰鄉,桃山村,279,1,20,2,22,70,3,1,3,0,1,0,31.43
苗栗縣,苗栗市,中苗里,1,1,606,12,618,830,3,1,3,0,1,0,74.46
苗栗縣,苗栗市,青苗里,2,1,766,6,772,1081,3,1,3,0,1,0,71.42
苗栗縣,苗栗市,維祥里,3,1,967,13,980,1397,3,1,3,0,1,0,70.15
苗栗縣,苗栗市,維祥里,4,1,1037,13,1050,1394,3,1,3,0,1,0,75.32
苗栗縣,苗栗市,維新里,5,1,930,8,938,1321,3,1,3,0,1,0,71.01
苗栗縣,苗栗市,維新里,6,1,802,15,817,1121,3,1,3,0,1,0,72.88
苗栗縣,苗栗市,維新里,7,1,789,9,798,1101,3,1,3,0,1,0,72.48
苗栗縣,苗栗市,玉清里,8,1,727,9,736,1024,3,1,3,0,1,0,71.88
苗栗縣,苗栗市,玉清里,9,1,774,12,786,1060,3,1,3,0,1,0,74.15
苗栗縣,苗栗市,玉華里,10,1,1142,23,1165,1580,3,1,3,0,1,0,73.73
苗栗縣,苗栗市,玉華里,11,1,1145,12,1157,1592,3,1,3,0,1,0,72.68
苗栗縣,苗栗市,綠苗里,12,1,633,9,642,895,3,1,3,0,1,0,71.73
苗栗縣,苗栗市,高苗里,13,1,798,20,818,1166,3,1,3,0,1,0,70.15
苗栗縣,苗栗市,高苗里,14,1,831,13,844,1247,3,1,3,0,1,0,67.68
苗栗縣,苗栗市,新苗里,15,1,731,6,737,1000,3,1,3,0,1,0,73.70
苗栗縣,苗栗市,玉苗里,16,1,845,13,858,1200,3,1,3,0,1,0,71.50
苗栗縣,苗栗市,大同里,17,1,434,14,448,682,3,1,3,0,1,0,65.69
苗栗縣,苗栗市,恭敬里,18,1,1070,11,1081,1489,3,1,3,0,1,0,72.60
苗栗縣,苗栗市,水源里,19,1,946,11,957,1318,3,1,3,0,1,0,72.61
苗栗縣,苗栗市,水源里,20,1,691,8,699,884,3,1,3,0,1,0,79.07
苗栗縣,苗栗市,勝利里,21,1,918,18,936,1319,3,1,3,0,1,0,70.96
苗栗縣,苗栗市,勝利里,22,1,904,9,913,1220,3,1,3,0,1,0,74.84
苗栗縣,苗栗市,勝利里,23,1,710,7,717,1006,3,1,3,0,1,0,71.27
苗栗縣,苗栗市,清華里,24,1,1205,13,1218,1604,3,1,3,0,1,0,75.94
苗栗縣,苗栗市,清華里,25,1,943,10,953,1262,3,1,3,0,1,0,75.52
苗栗縣,苗栗市,上苗里,26,1,664,8,672,879,3,1,3,0,1,0,76.45
苗栗縣,苗栗市,上苗里,27,1,646,9,655,904,3,1,3,0,1,0,72.46
苗栗縣,苗栗市,北苗里,28,1,774,13,787,1118,3,1,3,0,1,0,70.39
苗栗縣,苗栗市,北苗里,29,1,616,17,633,915,3,1,3,0,1,0,69.18
苗栗縣,苗栗市,北苗里,30,1,991,11,1002,1431,3,1,3,0,1,0,70.02
苗栗縣,苗栗市,嘉盛里,31,1,1063,12,1075,1514,3,1,3,0,1,0,71.00
苗栗縣,苗栗市,嘉盛里,32,1,854,18,872,1150,3,1,3,0,1,0,75.83
苗栗縣,苗栗市,嘉盛里,33,1,919,16,935,1263,3,1,3,0,1,0,74.03
苗栗縣,苗栗市,嘉盛里,34,1,983,18,1001,1227,3,1,3,0,1,0,81.58
苗栗縣,苗栗市,福星里,35,1,1142,12,1154,1579,3,1,3,0,1,0,73.08
苗栗縣,苗栗市,福星里,36,1,1264,27,1291,1755,3,1,3,0,1,0,73.56
苗栗縣,苗栗市,福星里,37,1,1041,12,1053,1493,3,1,3,0,1,0,70.53
苗栗縣,苗栗市,建功里,38,1,686,3,689,917,3,1,3,0,1,0,75.14
苗栗縣,苗栗市,建功里,39,1,835,10,845,1149,3,1,3,0,1,0,73.54
苗栗縣,苗栗市,建功里,40,1,833,11,844,1153,3,1,3,0,1,0,73.20
苗栗縣,苗栗市,福麗里,41,1,866,18,884,1247,3,1,3,0,1,0,70.89
苗栗縣,苗栗市,福麗里,42,1,888,11,899,1313,3,1,3,0,1,0,68.47
苗栗縣,苗栗市,福麗里,43,1,889,12,901,1299,3,1,3,0,1,0,69.36
苗栗縣,苗栗市,文山里,44,1,942,17,959,1271,3,1,3,0,1,0,75.45
苗栗縣,苗栗市,文山里,45,1,966,18,984,1333,3,1,3,0,1,0,73.82
苗栗縣,苗栗市,文山里,46,1,732,11,743,998,3,1,3,0,1,0,74.45
苗栗縣,苗栗市,新川里,47,1,775,13,788,1043,3,1,3,0,1,0,75.55
苗栗縣,苗栗市,新英里,48,1,1118,31,1149,1608,3,1,3,0,1,0,71.46
苗栗縣,苗栗市,新英里,49,1,778,11,789,1128,3,1,3,0,1,0,69.95
苗栗縣,苑裡鎮,苑東里,50,1,535,6,541,723,3,1,3,0,1,0,74.83
苗栗縣,苑裡鎮,苑東里,51,1,593,6,599,807,3,1,3,0,1,0,74.23
苗栗縣,苑裡鎮,苑南里,52,1,625,7,632,890,3,1,3,0,1,0,71.01
苗栗縣,苑裡鎮,苑南里,53,1,492,6,498,676,3,1,3,0,1,0,73.67
苗栗縣,苑裡鎮,苑北里,54,1,701,6,707,931,3,1,3,0,1,0,75.94
苗栗縣,苑裡鎮,西平里,55,1,931,11,942,1270,3,1,3,0,1,0,74.17
苗栗縣,苑裡鎮,苑港里,56,1,743,4,747,1048,3,1,3,0,1,0,71.28
苗栗縣,苑裡鎮,西勢里,57,1,549,7,556,754,3,1,3,0,1,0,73.74
苗栗縣,苑裡鎮,西勢里,58,1,523,5,528,690,3,1,3,0,1,0,76.52
苗栗縣,苑裡鎮,海岸里,59,1,707,7,714,965,3,1,3,0,1,0,73.99
苗栗縣,苑裡鎮,房裡里,60,1,661,10,671,903,3,1,3,0,1,0,74.31
苗栗縣,苑裡鎮,房裡里,61,1,719,11,730,980,3,1,3,0,1,0,74.49
苗栗縣,苑裡鎮,客庄里,62,1,1074,15,1089,1457,3,1,3,0,1,0,74.74
苗栗縣,苑裡鎮,客庄里,63,1,925,8,933,1228,3,1,3,0,1,0,75.98
苗栗縣,苑裡鎮,中正里,64,1,664,7,671,904,3,1,3,0,1,0,74.23
苗栗縣,苑裡鎮,中正里,65,1,563,5,568,808,3,1,3,0,1,0,70.30
苗栗縣,苑裡鎮,苑坑里,66,1,653,14,667,991,3,1,3,0,1,0,67.31
苗栗縣,苑裡鎮,水坡里,67,1,426,4,430,614,3,1,3,0,1,0,70.03
苗栗縣,苑裡鎮,新復里,68,1,773,15,788,1094,3,1,3,0,1,0,72.03
苗栗縣,苑裡鎮,山腳里,69,1,554,10,564,831,3,1,3,0,1,0,67.87
苗栗縣,苑裡鎮,山腳里,70,1,561,8,569,796,3,1,3,0,1,0,71.48
苗栗縣,苑裡鎮,舊社里,71,1,1054,23,1077,1451,3,1,3,0,1,0,74.22
苗栗縣,苑裡鎮,福田里,72,1,909,19,928,1285,3,1,3,0,1,0,72.22
苗栗縣,苑裡鎮,石鎮里,73,1,500,8,508,638,3,1,3,0,1,0,79.62
苗栗縣,苑裡鎮,蕉埔里,74,1,722,7,729,967,3,1,3,0,1,0,75.39
苗栗縣,苑裡鎮,南勢里,75,1,545,9,554,757,3,1,3,0,1,0,73.18
苗栗縣,苑裡鎮,泰田里,76,1,993,7,1000,1317,3,1,3,0,1,0,75.93
苗栗縣,苑裡鎮,上館里,77,1,1127,28,1155,1539,3,1,3,0,1,0,75.05
苗栗縣,苑裡鎮,玉田里,78,1,918,13,931,1346,3,1,3,0,1,0,69.17
苗栗縣,苑裡鎮,社苓里,79,1,681,11,692,931,3,1,3,0,1,0,74.33
苗栗縣,苑裡鎮,社苓里,80,1,617,15,632,874,3,1,3,0,1,0,72.31
苗栗縣,苑裡鎮,山柑里,81,1,728,3,731,1008,3,1,3,0,1,0,72.52
苗栗縣,苑裡鎮,田心里,82,1,834,10,844,1090,3,1,3,0,1,0,77.43
苗栗縣,通霄鎮,通東里,83,1,926,11,937,1274,3,1,3,0,1,0,73.55
苗栗縣,通霄鎮,通西里,84,1,917,10,927,1217,3,1,3,0,1,0,76.17
苗栗縣,通霄鎮,通西里,85,1,703,9,712,919,3,1,3,0,1,0,77.48
苗栗縣,通霄鎮,平元里,86,1,853,5,858,1173,3,1,3,0,1,0,73.15
苗栗縣,通霄鎮,平元里,87,1,731,13,744,953,3,1,3,0,1,0,78.07
苗栗縣,通霄鎮,平元里,88,1,692,6,698,986,3,1,3,0,1,0,70.79
苗栗縣,通霄鎮,五南里,89,1,971,14,985,1255,3,1,3,0,1,0,78.49
苗栗縣,通霄鎮,五北里,90,1,482,3,485,649,3,1,3,0,1,0,74.73
苗栗縣,通霄鎮,五北里,91,1,537,9,546,728,3,1,3,0,1,0,75.00
苗栗縣,通霄鎮,梅南里,92,1,520,10,530,738,3,1,3,0,1,0,71.82
苗栗縣,通霄鎮,梅南里,93,1,507,7,514,644,3,1,3,0,1,0,79.81
苗栗縣,通霄鎮,通南里,94,1,768,8,776,1086,3,1,3,0,1,0,71.45
苗栗縣,通霄鎮,通南里,95,1,813,6,819,1143,3,1,3,0,1,0,71.65
苗栗縣,通霄鎮,坪頂里,96,1,867,16,883,1230,3,1,3,0,1,0,71.79
苗栗縣,通霄鎮,福興里,97,1,481,6,487,701,3,1,3,0,1,0,69.47
苗栗縣,通霄鎮,南和里,98,1,642,6,648,853,3,1,3,0,1,0,75.97
苗栗縣,通霄鎮,城南里,99,1,781,13,794,1069,3,1,3,0,1,0,74.28
苗栗縣,通霄鎮,城北里,100,1,545,12,557,732,3,1,3,0,1,0,76.09
苗栗縣,通霄鎮,圳頭里,101,1,609,6,615,783,3,1,3,0,1,0,78.54
苗栗縣,通霄鎮,內湖里,102,1,734,5,739,948,3,1,3,0,1,0,77.95
苗栗縣,通霄鎮,內湖里,103,1,555,4,559,731,3,1,3,0,1,0,76.47
苗栗縣,通霄鎮,楓樹里,104,1,459,4,463,592,3,1,3,0,1,0,78.21
苗栗縣,通霄鎮,烏眉里,105,1,750,8,758,976,3,1,3,0,1,0,77.66
苗栗縣,通霄鎮,福龍里,106,1,354,0,354,539,3,1,3,0,1,0,65.68
苗栗縣,通霄鎮,福源里,107,1,480,7,487,640,3,1,3,0,1,0,76.09
苗栗縣,通霄鎮,通灣里,108,1,754,6,760,988,3,1,3,0,1,0,76.92
苗栗縣,通霄鎮,通灣里,109,1,756,7,763,1051,3,1,3,0,1,0,72.60
苗栗縣,通霄鎮,新埔里,110,1,884,12,896,1249,3,1,3,0,1,0,71.74
苗栗縣,通霄鎮,內島里,111,1,564,8,572,768,3,1,3,0,1,0,74.48
苗栗縣,通霄鎮,白東里,112,1,919,13,932,1348,3,1,3,0,1,0,69.14
苗栗縣,通霄鎮,白西里,113,1,615,4,619,852,3,1,3,0,1,0,72.65
苗栗縣,竹南鎮,竹南里,114,1,561,8,569,728,3,1,3,0,1,0,78.16
苗栗縣,竹南鎮,竹南里,115,1,597,9,606,840,3,1,3,0,1,0,72.14
苗栗縣,竹南鎮,照南里,116,1,905,13,918,1211,3,1,3,0,1,0,75.81
苗栗縣,竹南鎮,照南里,117,1,795,9,804,1071,3,1,3,0,1,0,75.07
苗栗縣,竹南鎮,正南里,118,1,728,9,737,964,3,1,3,0,1,0,76.45
苗栗縣,竹南鎮,正南里,119,1,772,14,786,1026,3,1,3,0,1,0,76.61
苗栗縣,竹南鎮,新南里,120,1,992,15,1007,1369,3,1,3,0,1,0,73.56
苗栗縣,竹南鎮,新南里,121,1,803,18,821,1106,3,1,3,0,1,0,74.23
苗栗縣,竹南鎮,大厝里,122,1,918,16,934,1185,3,1,3,0,1,0,78.82
苗栗縣,竹南鎮,大厝里,123,1,685,12,697,969,3,1,3,0,1,0,71.93
苗栗縣,竹南鎮,大厝里,124,1,556,6,562,758,3,1,3,0,1,0,74.14
苗栗縣,竹南鎮,營盤里,125,1,706,8,714,1041,3,1,3,0,1,0,68.59
苗栗縣,竹南鎮,營盤里,126,1,808,6,814,1114,3,1,3,0,1,0,73.07
苗栗縣,竹南鎮,聖福里,127,1,701,13,714,941,3,1,3,0,1,0,75.88
苗栗縣,竹南鎮,聖福里,128,1,739,14,753,1010,3,1,3,0,1,0,74.55
苗栗縣,竹南鎮,竹興里,129,1,583,12,595,805,3,1,3,0,1,0,73.91
苗栗縣,竹南鎮,竹興里,130,1,562,8,570,815,3,1,3,0,1,0,69.94
苗栗縣,竹南鎮,竹興里,131,1,667,13,680,919,3,1,3,0,1,0,73.99
苗栗縣,竹南鎮,龍鳳里,132,1,831,11,842,1062,3,1,3,0,1,0,79.28
苗栗縣,竹南鎮,龍鳳里,133,1,796,34,830,1043,3,1,3,0,1,0,79.58
苗栗縣,竹南鎮,龍鳳里,134,1,778,14,792,993,3,1,3,0,1,0,79.76
苗栗縣,竹南鎮,山佳里,135,1,725,8,733,1007,3,1,3,0,1,0,72.79
苗栗縣,竹南鎮,山佳里,136,1,773,17,790,1149,3,1,3,0,1,0,68.76
苗栗縣,竹南鎮,山佳里,137,1,709,11,720,976,3,1,3,0,1,0,73.77
苗栗縣,竹南鎮,山佳里,138,1,733,14,747,1000,3,1,3,0,1,0,74.70
苗栗縣,竹南鎮,中港里,139,1,700,10,710,933,3,1,3,0,1,0,76.10
苗栗縣,竹南鎮,中華里,140,1,628,15,643,843,3,1,3,0,1,0,76.28
苗栗縣,竹南鎮,中華里,141,1,677,12,689,881,3,1,3,0,1,0,78.21
苗栗縣,竹南鎮,中英里,142,1,780,10,790,1051,3,1,3,0,1,0,75.17
苗栗縣,竹南鎮,中美里,143,1,896,13,909,1151,3,1,3,0,1,0,78.97
苗栗縣,竹南鎮,開元里,144,1,394,3,397,502,3,1,3,0,1,0,79.08
苗栗縣,竹南鎮,海口里,145,1,604,13,617,827,3,1,3,0,1,0,74.61
苗栗縣,竹南鎮,海口里,146,1,683,17,700,964,3,1,3,0,1,0,72.61
苗栗縣,竹南鎮,港墘里,147,1,922,3,925,1160,3,1,3,0,1,0,79.74
苗栗縣,竹南鎮,公館里,148,1,748,14,762,983,3,1,3,0,1,0,77.52
苗栗縣,竹南鎮,大埔里,149,1,604,7,611,777,3,1,3,0,1,0,78.64
苗栗縣,竹南鎮,大埔里,150,1,806,17,823,1068,3,1,3,0,1,0,77.06
苗栗縣,竹南鎮,大埔里,151,1,680,14,694,891,3,1,3,0,1,0,77.89
苗栗縣,竹南鎮,頂埔里,152,1,788,13,801,1053,3,1,3,0,1,0,76.07
苗栗縣,竹南鎮,頂埔里,153,1,678,24,702,952,3,1,3,0,1,0,73.74
苗栗縣,竹南鎮,崎頂里,154,1,905,16,921,1253,3,1,3,0,1,0,73.50
苗栗縣,竹南鎮,崎頂里,155,1,540,6,546,716,3,1,3,0,1,0,76.26
苗栗縣,竹南鎮,公義里,156,1,615,13,628,857,3,1,3,0,1,0,73.28
苗栗縣,頭份鎮,流東里,157,1,556,5,561,740,3,1,3,0,1,0,75.81
苗栗縣,頭份鎮,流東里,158,1,781,18,799,1118,3,1,3,0,1,0,71.47
苗栗縣,頭份鎮,珊湖里,159,1,659,11,670,893,3,1,3,0,1,0,75.03
苗栗縣,頭份鎮,珊湖里,160,1,692,9,701,975,3,1,3,0,1,0,71.90
苗栗縣,頭份鎮,斗煥里,161,1,889,16,905,1191,3,1,3,0,1,0,75.99
苗栗縣,頭份鎮,斗煥里,162,1,1097,22,1119,1499,3,1,3,0,1,0,74.65
苗栗縣,頭份鎮,新華里,163,1,795,10,805,1009,3,1,3,0,1,0,79.78
苗栗縣,頭份鎮,新華里,164,1,818,13,831,1138,3,1,3,0,1,0,73.02
苗栗縣,頭份鎮,新華里,165,1,889,13,902,1249,3,1,3,0,1,0,72.22
苗栗縣,頭份鎮,興隆里,166,1,837,12,849,1229,3,1,3,0,1,0,69.08
苗栗縣,頭份鎮,興隆里,167,1,905,15,920,1344,3,1,3,0,1,0,68.45
苗栗縣,頭份鎮,上埔里,168,1,868,8,876,1141,3,1,3,0,1,0,76.77
苗栗縣,頭份鎮,上埔里,169,1,727,21,748,972,3,1,3,0,1,0,76.95
苗栗縣,頭份鎮,土牛里,170,1,599,14,613,850,3,1,3,0,1,0,72.12
苗栗縣,頭份鎮,頭份里,171,1,734,10,744,1022,3,1,3,0,1,0,72.80
苗栗縣,頭份鎮,頭份里,172,1,666,10,676,944,3,1,3,0,1,0,71.61
苗栗縣,頭份鎮,忠孝里,173,1,701,2,703,1042,3,1,3,0,1,0,67.47
苗栗縣,頭份鎮,忠孝里,174,1,924,22,946,1279,3,1,3,0,1,0,73.96
苗栗縣,頭份鎮,忠孝里,175,1,963,13,976,1418,3,1,3,0,1,0,68.83
苗栗縣,頭份鎮,信義里,176,1,558,4,562,754,3,1,3,0,1,0,74.54
苗栗縣,頭份鎮,仁愛里,177,1,1093,20,1113,1442,3,1,3,0,1,0,77.18
苗栗縣,頭份鎮,上興里,178,1,775,7,782,999,3,1,3,0,1,0,78.28
苗栗縣,頭份鎮,下興里,179,1,632,8,640,852,3,1,3,0,1,0,75.12
苗栗縣,頭份鎮,下興里,180,1,583,7,590,764,3,1,3,0,1,0,77.23
苗栗縣,頭份鎮,山下里,181,1,678,2,680,933,3,1,3,0,1,0,72.88
苗栗縣,頭份鎮,山下里,182,1,619,10,629,827,3,1,3,0,1,0,76.06
苗栗縣,頭份鎮,後庄里,183,1,1127,20,1147,1587,3,1,3,0,1,0,72.27
苗栗縣,頭份鎮,後庄里,184,1,1036,18,1054,1476,3,1,3,0,1,0,71.41
苗栗縣,頭份鎮,蟠桃里,185,1,971,19,990,1382,3,1,3,0,1,0,71.64
苗栗縣,頭份鎮,蟠桃里,186,1,961,22,983,1361,3,1,3,0,1,0,72.23
苗栗縣,頭份鎮,蟠桃里,187,1,981,17,998,1404,3,1,3,0,1,0,71.08
苗栗縣,頭份鎮,蟠桃里,188,1,861,13,874,1256,3,1,3,0,1,0,69.59
苗栗縣,頭份鎮,東庄里,189,1,724,6,730,1022,3,1,3,0,1,0,71.43
苗栗縣,頭份鎮,東庄里,190,1,729,9,738,1098,3,1,3,0,1,0,67.21
苗栗縣,頭份鎮,和平里,191,1,828,4,832,1070,3,1,3,0,1,0,77.76
苗栗縣,頭份鎮,民族里,192,1,634,7,641,910,3,1,3,0,1,0,70.44
苗栗縣,頭份鎮,民族里,193,1,736,10,746,1100,3,1,3,0,1,0,67.82
苗栗縣,頭份鎮,民族里,194,1,937,18,955,1322,3,1,3,0,1,0,72.24
苗栗縣,頭份鎮,民族里,195,1,771,8,779,1114,3,1,3,0,1,0,69.93
苗栗縣,頭份鎮,田寮里,196,1,950,12,962,1293,3,1,3,0,1,0,74.40
苗栗縣,頭份鎮,田寮里,197,1,808,18,826,1205,3,1,3,0,1,0,68.55
苗栗縣,頭份鎮,蘆竹里,198,1,1059,14,1073,1337,3,1,3,0,1,0,80.25
苗栗縣,頭份鎮,尖山里,199,1,977,26,1003,1311,3,1,3,0,1,0,76.51
苗栗縣,頭份鎮,廣興里,200,1,605,7,612,799,3,1,3,0,1,0,76.60
苗栗縣,頭份鎮,尖下里,201,1,843,9,852,1141,3,1,3,0,1,0,74.67
苗栗縣,頭份鎮,尖下里,202,1,866,13,879,1220,3,1,3,0,1,0,72.05
苗栗縣,頭份鎮,濫坑里,203,1,589,15,604,769,3,1,3,0,1,0,78.54
苗栗縣,頭份鎮,濫坑里,204,1,603,10,613,829,3,1,3,0,1,0,73.94
苗栗縣,後龍鎮,南龍里,205,1,1011,16,1027,1489,3,1,3,0,1,0,68.97
苗栗縣,後龍鎮,中龍里,206,1,734,8,742,950,3,1,3,0,1,0,78.11
苗栗縣,後龍鎮,北龍里,207,1,1062,12,1074,1438,3,1,3,0,1,0,74.69
苗栗縣,後龍鎮,大庄里,208,1,962,12,974,1342,3,1,3,0,1,0,72.58
苗栗縣,後龍鎮,大庄里,209,1,1061,8,1069,1454,3,1,3,0,1,0,73.52
苗栗縣,後龍鎮,溪洲里,210,1,676,7,683,963,3,1,3,0,1,0,70.92
苗栗縣,後龍鎮,溪洲里,211,1,758,7,765,1046,3,1,3,0,1,0,73.14
苗栗縣,後龍鎮,豐富里,212,1,957,6,963,1265,3,1,3,0,1,0,76.13
苗栗縣,後龍鎮,校椅里,213,1,905,13,918,1164,3,1,3,0,1,0,78.87
苗栗縣,後龍鎮,埔頂里,214,1,788,10,798,1022,3,1,3,0,1,0,78.08
苗栗縣,後龍鎮,埔頂里,215,1,736,12,748,993,3,1,3,0,1,0,75.33
苗栗縣,後龍鎮,新民里,216,1,1005,14,1019,1291,3,1,3,0,1,0,78.93
苗栗縣,後龍鎮,復興里,217,1,505,6,511,656,3,1,3,0,1,0,77.90
苗栗縣,後龍鎮,東明里,218,1,942,11,953,1311,3,1,3,0,1,0,72.69
苗栗縣,後龍鎮,大山里,219,1,572,10,582,781,3,1,3,0,1,0,74.52
苗栗縣,後龍鎮,大山里,220,1,587,7,594,850,3,1,3,0,1,0,69.88
苗栗縣,後龍鎮,灣寶里,221,1,985,17,1002,1412,3,1,3,0,1,0,70.96
苗栗縣,後龍鎮,海寶里,222,1,752,7,759,1034,3,1,3,0,1,0,73.40
苗栗縣,後龍鎮,外埔里,223,1,832,11,843,1186,3,1,3,0,1,0,71.08
苗栗縣,後龍鎮,海埔里,224,1,759,10,769,1120,3,1,3,0,1,0,68.66
苗栗縣,後龍鎮,秀水里,225,1,599,5,604,809,3,1,3,0,1,0,74.66
苗栗縣,後龍鎮,水尾里,226,1,799,27,826,1123,3,1,3,0,1,0,73.55
苗栗縣,後龍鎮,龍津里,227,1,480,7,487,650,3,1,3,0,1,0,74.92
苗栗縣,後龍鎮,龍坑里,228,1,863,17,880,1278,3,1,3,0,1,0,68.86
苗栗縣,後龍鎮,福寧里,229,1,597,5,602,859,3,1,3,0,1,0,70.08
苗栗縣,後龍鎮,中和里,230,1,853,13,866,1341,3,1,3,0,1,0,64.58
苗栗縣,後龍鎮,南港里,231,1,884,16,900,1339,3,1,3,0,1,0,67.21
苗栗縣,卓蘭鎮,老庄里,232,1,991,10,1001,1201,3,1,3,0,1,0,83.35
苗栗縣,卓蘭鎮,老庄里,233,1,700,9,709,878,3,1,3,0,1,0,80.75
苗栗縣,卓蘭鎮,新榮里,234,1,913,6,919,1153,3,1,3,0,1,0,79.71
苗栗縣,卓蘭鎮,中街里,235,1,629,2,631,790,3,1,3,0,1,0,79.87
苗栗縣,卓蘭鎮,新厝里,236,1,1123,12,1135,1474,3,1,3,0,1,0,77.00
苗栗縣,卓蘭鎮,豐田里,237,1,807,7,814,1010,3,1,3,0,1,0,80.59
苗栗縣,卓蘭鎮,西坪里,238,1,449,11,460,579,3,1,3,0,1,0,79.45
苗栗縣,卓蘭鎮,苗豐里,239,1,554,9,563,687,3,1,3,0,1,0,81.95
苗栗縣,卓蘭鎮,上新里,240,1,1125,13,1138,1433,3,1,3,0,1,0,79.41
苗栗縣,卓蘭鎮,上新里,241,1,349,1,350,437,3,1,3,0,1,0,80.09
苗栗縣,卓蘭鎮,內灣里,242,1,1138,20,1158,1417,3,1,3,0,1,0,81.72
苗栗縣,卓蘭鎮,內灣里,243,1,508,9,517,644,3,1,3,0,1,0,80.28
苗栗縣,卓蘭鎮,坪林里,244,1,748,20,768,991,3,1,3,0,1,0,77.50
苗栗縣,卓蘭鎮,坪林里,245,1,404,7,411,505,3,1,3,0,1,0,81.39
苗栗縣,卓蘭鎮,景山里,246,1,525,8,533,743,3,1,3,0,1,0,71.74
苗栗縣,大湖鄉,大湖村,247,1,615,9,624,819,3,1,3,0,1,0,76.19
苗栗縣,大湖鄉,大湖村,248,1,639,10,649,926,3,1,3,0,1,0,70.09
苗栗縣,大湖鄉,明湖村,249,1,586,11,597,741,3,1,3,0,1,0,80.57
苗栗縣,大湖鄉,靜湖村,250,1,660,7,667,873,3,1,3,0,1,0,76.40
苗栗縣,大湖鄉,靜湖村,251,1,541,5,546,756,3,1,3,0,1,0,72.22
苗栗縣,大湖鄉,富興村,252,1,1014,10,1024,1368,3,1,3,0,1,0,74.85
苗栗縣,大湖鄉,大南村,253,1,486,8,494,733,3,1,3,0,1,0,67.39
苗栗縣,大湖鄉,大寮村,254,1,973,12,985,1302,3,1,3,0,1,0,75.65
苗栗縣,大湖鄉,南湖村,255,1,581,8,589,781,3,1,3,0,1,0,75.42
苗栗縣,大湖鄉,義和村,256,1,1094,16,1110,1492,3,1,3,0,1,0,74.40
苗栗縣,大湖鄉,東興村,257,1,580,14,594,786,3,1,3,0,1,0,75.57
苗栗縣,大湖鄉,武榮村,258,1,407,2,409,566,3,1,3,0,1,0,72.26
苗栗縣,大湖鄉,栗林村,259,1,722,10,732,988,3,1,3,0,1,0,74.09
苗栗縣,大湖鄉,新開村,260,1,651,8,659,928,3,1,3,0,1,0,71.01
苗栗縣,公舘鄉,館中村,261,1,619,8,627,818,3,1,3,0,1,0,76.65
苗栗縣,公舘鄉,館中村,262,1,502,7,509,652,3,1,3,0,1,0,78.07
苗栗縣,公舘鄉,館東村,263,1,780,7,787,1046,3,1,3,0,1,0,75.24
苗栗縣,公舘鄉,館東村,264,1,814,11,825,1102,3,1,3,0,1,0,74.86
苗栗縣,公舘鄉,館南村,265,1,852,12,864,1175,3,1,3,0,1,0,73.53
苗栗縣,公舘鄉,館南村,266,1,818,11,829,1162,3,1,3,0,1,0,71.34
苗栗縣,公舘鄉,中義村,267,1,652,17,669,893,3,1,3,0,1,0,74.92
苗栗縣,公舘鄉,中義村,268,1,668,6,674,873,3,1,3,0,1,0,77.21
苗栗縣,公舘鄉,玉泉村,269,1,539,5,544,746,3,1,3,0,1,0,72.92
苗栗縣,公舘鄉,玉泉村,270,1,563,5,568,786,3,1,3,0,1,0,72.26
苗栗縣,公舘鄉,大坑村,271,1,637,15,652,930,3,1,3,0,1,0,70.11
苗栗縣,公舘鄉,福基村,272,1,823,9,832,1070,3,1,3,0,1,0,77.76
苗栗縣,公舘鄉,福德村,273,1,320,4,324,439,3,1,3,0,1,0,73.80
苗栗縣,公舘鄉,福星村,274,1,974,11,985,1341,3,1,3,0,1,0,73.45
苗栗縣,公舘鄉,石墻村,275,1,554,11,565,697,3,1,3,0,1,0,81.06
苗栗縣,公舘鄉,石墻村,276,1,509,6,515,689,3,1,3,0,1,0,74.75
苗栗縣,公舘鄉,開礦村,277,1,289,2,291,356,3,1,3,0,1,0,81.74
苗栗縣,公舘鄉,五谷村,278,1,586,9,595,814,3,1,3,0,1,0,73.10
苗栗縣,公舘鄉,五谷村,279,1,588,4,592,822,3,1,3,0,1,0,72.02
苗栗縣,公舘鄉,玉谷村,280,1,782,11,793,988,3,1,3,0,1,0,80.26
苗栗縣,公舘鄉,鶴岡村,281,1,1026,15,1041,1322,3,1,3,0,1,0,78.74
苗栗縣,公舘鄉,鶴山村,282,1,1000,11,1011,1319,3,1,3,0,1,0,76.65
苗栗縣,公舘鄉,尖山村,283,1,1044,10,1054,1338,3,1,3,0,1,0,78.77
苗栗縣,公舘鄉,仁安村,284,1,925,12,937,1191,3,1,3,0,1,0,78.67
苗栗縣,公舘鄉,南河村,285,1,160,3,163,217,3,1,3,0,1,0,75.12
苗栗縣,公舘鄉,北河村,286,1,275,3,278,336,3,1,3,0,1,0,82.74
苗栗縣,銅鑼鄉,福興村,287,1,806,11,817,1057,3,1,3,0,1,0,77.29
苗栗縣,銅鑼鄉,朝陽村,288,1,1206,19,1225,1609,3,1,3,0,1,0,76.13
苗栗縣,銅鑼鄉,竹森村,289,1,766,13,779,1119,3,1,3,0,1,0,69.62
苗栗縣,銅鑼鄉,銅鑼村,290,1,1129,12,1141,1405,3,1,3,0,1,0,81.21
苗栗縣,銅鑼鄉,銅鑼村,291,1,1206,24,1230,1577,3,1,3,0,1,0,78.00
苗栗縣,銅鑼鄉,銅鑼村,292,1,572,7,579,834,3,1,3,0,1,0,69.42
苗栗縣,銅鑼鄉,樟樹村,293,1,932,15,947,1234,3,1,3,0,1,0,76.74
苗栗縣,銅鑼鄉,九湖村,294,1,952,19,971,1315,3,1,3,0,1,0,73.84
苗栗縣,銅鑼鄉,中平村,295,1,890,17,907,1186,3,1,3,0,1,0,76.48
苗栗縣,銅鑼鄉,中平村,296,1,894,15,909,1205,3,1,3,0,1,0,75.44
苗栗縣,銅鑼鄉,興隆村,297,1,456,13,469,646,3,1,3,0,1,0,72.60
苗栗縣,銅鑼鄉,盛隆村,298,1,400,4,404,585,3,1,3,0,1,0,69.06
苗栗縣,銅鑼鄉,新隆村,299,1,478,7,485,666,3,1,3,0,1,0,72.82
苗栗縣,南庄鄉,東村,300,1,519,8,527,685,3,1,3,0,1,0,76.93
苗栗縣,南庄鄉,東村,301,1,552,4,556,738,3,1,3,0,1,0,75.34
苗栗縣,南庄鄉,西村,302,1,521,4,525,712,3,1,3,0,1,0,73.74
苗栗縣,南庄鄉,南江村,303,1,502,6,508,725,3,1,3,0,1,0,70.07
苗栗縣,南庄鄉,南江村,304,1,300,4,304,452,3,1,3,0,1,0,67.26
苗栗縣,南庄鄉,田美村,305,1,658,7,665,938,3,1,3,0,1,0,70.90
苗栗縣,南庄鄉,獅山村,306,1,463,9,472,686,3,1,3,0,1,0,68.80
苗栗縣,南庄鄉,獅山村,307,1,306,5,311,443,3,1,3,0,1,0,70.20
苗栗縣,南庄鄉,南富村,308,1,804,14,818,1127,3,1,3,0,1,0,72.58
苗栗縣,南庄鄉,員林村,309,1,730,6,736,1087,3,1,3,0,1,0,67.71
苗栗縣,南庄鄉,蓬萊村,310,1,316,4,320,477,3,1,3,0,1,0,67.09
苗栗縣,南庄鄉,東河村,311,1,216,1,217,308,3,1,3,0,1,0,70.45
苗栗縣,頭屋鄉,頭屋村,312,1,895,13,908,1172,3,1,3,0,1,0,77.47
苗栗縣,頭屋鄉,頭屋村,313,1,846,14,860,1097,3,1,3,0,1,0,78.40
苗栗縣,頭屋鄉,象山村,314,1,638,11,649,847,3,1,3,0,1,0,76.62
苗栗縣,頭屋鄉,象山村,315,1,689,14,703,903,3,1,3,0,1,0,77.85
苗栗縣,頭屋鄉,北坑村,316,1,434,7,441,569,3,1,3,0,1,0,77.50
苗栗縣,頭屋鄉,獅潭村,317,1,534,10,544,686,3,1,3,0,1,0,79.30
苗栗縣,頭屋鄉,獅潭村,318,1,612,9,621,764,3,1,3,0,1,0,81.28
苗栗縣,頭屋鄉,曲洞村,319,1,661,31,692,879,3,1,3,0,1,0,78.73
苗栗縣,頭屋鄉,飛鳳村,320,1,269,5,274,359,3,1,3,0,1,0,76.32
苗栗縣,頭屋鄉,明德村,321,1,731,14,745,926,3,1,3,0,1,0,80.45
苗栗縣,頭屋鄉,明德村,322,1,180,4,184,229,3,1,3,0,1,0,80.35
苗栗縣,頭屋鄉,鳴鳳村,323,1,276,2,278,370,3,1,3,0,1,0,75.14
苗栗縣,三義鄉,廣盛村,324,1,805,14,819,1043,3,1,3,0,1,0,78.52
苗栗縣,三義鄉,廣盛村,325,1,749,15,764,986,3,1,3,0,1,0,77.48
苗栗縣,三義鄉,廣盛村,326,1,626,4,630,816,3,1,3,0,1,0,77.21
苗栗縣,三義鄉,廣盛村,327,1,832,10,842,1038,3,1,3,0,1,0,81.12
苗栗縣,三義鄉,勝興村,328,1,933,13,946,1138,3,1,3,0,1,0,83.13
苗栗縣,三義鄉,勝興村,329,1,929,10,939,1247,3,1,3,0,1,0,75.30
苗栗縣,三義鄉,雙湖村,330,1,705,10,715,908,3,1,3,0,1,0,78.74
苗栗縣,三義鄉,雙湖村,331,1,542,12,554,712,3,1,3,0,1,0,77.81
苗栗縣,三義鄉,雙潭村,332,1,587,7,594,725,3,1,3,0,1,0,81.93
苗栗縣,三義鄉,雙潭村,333,1,508,5,513,655,3,1,3,0,1,0,78.32
苗栗縣,三義鄉,西湖村,334,1,990,13,1003,1257,3,1,3,0,1,0,79.79
苗栗縣,三義鄉,龍騰村,335,1,317,5,322,386,3,1,3,0,1,0,83.42
苗栗縣,三義鄉,鯉魚潭村,336,1,883,6,889,1117,3,1,3,0,1,0,79.59
苗栗縣,西湖鄉,高埔村,337,1,488,7,495,654,3,1,3,0,1,0,75.69
苗栗縣,西湖鄉,下埔村,338,1,470,10,480,609,3,1,3,0,1,0,78.82
苗栗縣,西湖鄉,五湖村,339,1,701,15,716,972,3,1,3,0,1,0,73.66
苗栗縣,西湖鄉,四湖村,340,1,582,4,586,702,3,1,3,0,1,0,83.48
苗栗縣,西湖鄉,三湖村,341,1,767,5,772,1088,3,1,3,0,1,0,70.96
苗栗縣,西湖鄉,龍洞村,342,1,425,5,430,554,3,1,3,0,1,0,77.62
苗栗縣,西湖鄉,金獅村,343,1,418,11,429,566,3,1,3,0,1,0,75.80
苗栗縣,西湖鄉,湖東村,344,1,783,47,830,1144,3,1,3,0,1,0,72.55
苗栗縣,西湖鄉,二湖村,345,1,507,9,516,714,3,1,3,0,1,0,72.27
苗栗縣,造橋鄉,造橋村,346,1,1215,12,1227,1556,3,1,3,0,1,0,78.86
苗栗縣,造橋鄉,平興村,347,1,447,7,454,556,3,1,3,0,1,0,81.65
苗栗縣,造橋鄉,豐湖村,348,1,738,5,743,946,3,1,3,0,1,0,78.54
苗栗縣,造橋鄉,大西村,349,1,1238,7,1245,1492,3,1,3,0,1,0,83.45
苗栗縣,造橋鄉,大西村,350,1,1036,15,1051,1292,3,1,3,0,1,0,81.35
苗栗縣,造橋鄉,錦水村,351,1,479,4,483,574,3,1,3,0,1,0,84.15
苗栗縣,造橋鄉,大龍村,352,1,454,7,461,546,3,1,3,0,1,0,84.43
苗栗縣,造橋鄉,朝陽村,353,1,983,18,1001,1319,3,1,3,0,1,0,75.89
苗栗縣,造橋鄉,談文村,354,1,571,8,579,721,3,1,3,0,1,0,80.31
苗栗縣,造橋鄉,龍昇村,355,1,818,12,830,1053,3,1,3,0,1,0,78.82
苗栗縣,三灣鄉,三灣村,356,1,844,11,855,1101,3,1,3,0,1,0,77.66
苗栗縣,三灣鄉,三灣村,357,1,717,8,725,1015,3,1,3,0,1,0,71.43
苗栗縣,三灣鄉,內灣村,358,1,456,5,461,580,3,1,3,0,1,0,79.48
苗栗縣,三灣鄉,銅鏡村,359,1,650,8,658,877,3,1,3,0,1,0,75.03
苗栗縣,三灣鄉,頂寮村,360,1,204,3,207,254,3,1,3,0,1,0,81.50
苗栗縣,三灣鄉,北埔村,361,1,437,4,441,608,3,1,3,0,1,0,72.53
苗栗縣,三灣鄉,大河村,362,1,500,7,507,705,3,1,3,0,1,0,71.91
苗栗縣,三灣鄉,大坪村,363,1,401,5,406,508,3,1,3,0,1,0,79.92
苗栗縣,三灣鄉,永和村,364,1,261,4,265,337,3,1,3,0,1,0,78.64
苗栗縣,獅潭鄉,百壽村,365,1,216,0,216,302,3,1,3,0,1,0,71.52
苗栗縣,獅潭鄉,永興村,366,1,478,11,489,683,3,1,3,0,1,0,71.60
苗栗縣,獅潭鄉,新店村,367,1,692,11,703,1032,3,1,3,0,1,0,68.12
苗栗縣,獅潭鄉,和興村,368,1,417,9,426,632,3,1,3,0,1,0,67.41
苗栗縣,獅潭鄉,豐林村,369,1,469,7,476,695,3,1,3,0,1,0,68.49
苗栗縣,獅潭鄉,新豐村,370,1,295,0,295,391,3,1,3,0,1,0,75.45
苗栗縣,獅潭鄉,竹木村,371,1,600,17,617,820,3,1,3,0,1,0,75.24
苗栗縣,泰安鄉,八卦村,372,1,98,1,99,126,3,1,3,0,1,0,78.57
苗栗縣,泰安鄉,錦水村,373,1,231,1,232,368,3,1,3,0,1,0,63.04
苗栗縣,泰安鄉,清安村,374,1,227,3,230,318,3,1,3,0,1,0,72.33
苗栗縣,泰安鄉,清安村,375,1,275,3,278,361,3,1,3,0,1,0,77.01
苗栗縣,泰安鄉,大興村,376,1,81,1,82,107,3,1,3,0,1,0,76.64
苗栗縣,泰安鄉,中興村,377,1,91,3,94,133,3,1,3,0,1,0,70.68
苗栗縣,泰安鄉,梅園村,378,1,17,0,17,25,3,1,3,0,1,0,68.00
苗栗縣,泰安鄉,象鼻村,379,1,39,1,40,62,3,1,3,0,1,0,64.52
苗栗縣,泰安鄉,士林村,380,1,16,0,16,34,3,1,3,0,1,0,47.06
臺中縣,豐原市,豐原里,1,1,708,17,725,1013,3,1,3,0,1,0,71.57
臺中縣,豐原市,豐原里,2,1,773,9,782,1039,3,1,3,0,1,0,75.26
臺中縣,豐原市,豐榮里,3,1,639,8,647,918,3,1,3,0,1,0,70.48
臺中縣,豐原市,頂街里,4,1,556,4,560,789,3,1,3,0,1,0,70.98
臺中縣,豐原市,中山里,5,1,716,16,732,1011,3,1,3,0,1,0,72.40
臺中縣,豐原市,下街里,6,1,664,11,675,859,3,1,3,0,1,0,78.58
臺中縣,豐原市,中陽里,7,1,970,8,978,1354,3,1,3,0,1,0,72.23
臺中縣,豐原市,中陽里,8,1,975,18,993,1352,3,1,3,0,1,0,73.45
臺中縣,豐原市,中陽里,9,1,1145,13,1158,1559,3,1,3,0,1,0,74.28
臺中縣,豐原市,大湳里,10,1,729,11,740,1031,3,1,3,0,1,0,71.77
臺中縣,豐原市,大湳里,11,1,763,11,774,994,3,1,3,0,1,0,77.87
臺中縣,豐原市,北湳里,12,1,700,14,714,905,3,1,3,0,1,0,78.90
臺中縣,豐原市,北湳里,13,1,804,16,820,1061,3,1,3,0,1,0,77.29
臺中縣,豐原市,東湳里,14,1,1316,24,1340,1790,3,1,3,0,1,0,74.86
臺中縣,豐原市,東湳里,15,1,1037,24,1061,1488,3,1,3,0,1,0,71.30
臺中縣,豐原市,西湳里,16,1,1134,36,1170,1677,3,1,3,0,1,0,69.77
臺中縣,豐原市,西湳里,17,1,1145,26,1171,1609,3,1,3,0,1,0,72.78
臺中縣,豐原市,西湳里,18,1,1201,22,1223,1832,3,1,3,0,1,0,66.76
臺中縣,豐原市,豐西里,19,1,1136,15,1151,1601,3,1,3,0,1,0,71.89
臺中縣,豐原市,圳寮里,20,1,903,8,911,1152,3,1,3,0,1,0,79.08
臺中縣,豐原市,豐圳里,21,1,866,9,875,1143,3,1,3,0,1,0,76.55
臺中縣,豐原市,豐圳里,22,1,962,22,984,1336,3,1,3,0,1,0,73.65
臺中縣,豐原市,富春里,23,1,693,9,702,911,3,1,3,0,1,0,77.06
臺中縣,豐原市,葫蘆里,24,1,685,4,689,929,3,1,3,0,1,0,74.17
臺中縣,豐原市,西安里,25,1,1107,13,1120,1490,3,1,3,0,1,0,75.17
臺中縣,豐原市,西安里,26,1,1105,22,1127,1632,3,1,3,0,1,0,69.06
臺中縣,豐原市,西安里,27,1,1015,17,1032,1451,3,1,3,0,1,0,71.12
臺中縣,豐原市,西勢里,28,1,741,13,754,1039,3,1,3,0,1,0,72.57
臺中縣,豐原市,西勢里,29,1,785,9,794,1057,3,1,3,0,1,0,75.12
臺中縣,豐原市,中興里,30,1,962,9,971,1347,3,1,3,0,1,0,72.09
臺中縣,豐原市,中興里,31,1,1008,17,1025,1382,3,1,3,0,1,0,74.17
臺中縣,豐原市,社皮里,32,1,1109,19,1128,1592,3,1,3,0,1,0,70.85
臺中縣,豐原市,社皮里,33,1,1076,15,1091,1488,3,1,3,0,1,0,73.32
臺中縣,豐原市,社皮里,34,1,944,15,959,1510,3,1,3,0,1,0,63.51
臺中縣,豐原市,社皮里,35,1,1101,30,1131,1581,3,1,3,0,1,0,71.54
臺中縣,豐原市,三村里,36,1,1352,30,1382,1882,3,1,3,0,1,0,73.43
臺中縣,豐原市,三村里,37,1,1256,29,1285,1891,3,1,3,0,1,0,67.95
臺中縣,豐原市,東勢里,38,1,1006,17,1023,1432,3,1,3,0,1,0,71.44
臺中縣,豐原市,民生里,39,1,776,9,785,1130,3,1,3,0,1,0,69.47
臺中縣,豐原市,田心里,40,1,918,23,941,1343,3,1,3,0,1,0,70.07
臺中縣,豐原市,田心里,41,1,986,14,1000,1433,3,1,3,0,1,0,69.78
臺中縣,豐原市,田心里,42,1,956,13,969,1318,3,1,3,0,1,0,73.52
臺中縣,豐原市,豐田里,43,1,998,15,1013,1421,3,1,3,0,1,0,71.29
臺中縣,豐原市,豐田里,44,1,1015,13,1028,1523,3,1,3,0,1,0,67.50
臺中縣,豐原市,豐田里,45,1,1012,19,1031,1429,3,1,3,0,1,0,72.15
臺中縣,豐原市,豐田里,46,1,1056,20,1076,1474,3,1,3,0,1,0,73.00
臺中縣,豐原市,豐田里,47,1,961,17,978,1341,3,1,3,0,1,0,72.93
臺中縣,豐原市,鐮村里,48,1,1196,22,1218,1598,3,1,3,0,1,0,76.22
臺中縣,豐原市,鐮村里,49,1,1013,24,1037,1438,3,1,3,0,1,0,72.11
臺中縣,豐原市,陽明里,50,1,940,16,956,1306,3,1,3,0,1,0,73.20
臺中縣,豐原市,陽明里,51,1,708,12,720,1023,3,1,3,0,1,0,70.38
臺中縣,豐原市,南陽里,52,1,1157,19,1176,1599,3,1,3,0,1,0,73.55
臺中縣,豐原市,南陽里,53,1,1121,21,1142,1631,3,1,3,0,1,0,70.02
臺中縣,豐原市,南陽里,54,1,1230,12,1242,1741,3,1,3,0,1,0,71.34
臺中縣,豐原市,北陽里,55,1,1214,17,1231,1699,3,1,3,0,1,0,72.45
臺中縣,豐原市,北陽里,56,1,1392,16,1408,1960,3,1,3,0,1,0,71.84
臺中縣,豐原市,北陽里,57,1,1228,24,1252,1736,3,1,3,0,1,0,72.12
臺中縣,豐原市,北陽里,58,1,1151,19,1170,1659,3,1,3,0,1,0,70.52
臺中縣,豐原市,北陽里,59,1,1149,12,1161,1627,3,1,3,0,1,0,71.36
臺中縣,豐原市,東陽里,60,1,1146,18,1164,1510,3,1,3,0,1,0,77.09
臺中縣,豐原市,南村里,61,1,1115,24,1139,1520,3,1,3,0,1,0,74.93
臺中縣,豐原市,南村里,62,1,1228,19,1247,1730,3,1,3,0,1,0,72.08
臺中縣,豐原市,南田里,63,1,1224,22,1246,1657,3,1,3,0,1,0,75.20
臺中縣,豐原市,南田里,64,1,938,14,952,1264,3,1,3,0,1,0,75.32
臺中縣,豐原市,南嵩里,65,1,977,20,997,1319,3,1,3,0,1,0,75.59
臺中縣,豐原市,南嵩里,66,1,931,8,939,1349,3,1,3,0,1,0,69.61
臺中縣,豐原市,翁明里,67,1,993,25,1018,1355,3,1,3,0,1,0,75.13
臺中縣,豐原市,翁子里,68,1,906,14,920,1228,3,1,3,0,1,0,74.92
臺中縣,豐原市,翁子里,69,1,658,16,674,947,3,1,3,0,1,0,71.17
臺中縣,豐原市,翁社里,70,1,1289,36,1325,1749,3,1,3,0,1,0,75.76
臺中縣,豐原市,朴子里,71,1,1052,18,1070,1423,3,1,3,0,1,0,75.19
臺中縣,豐原市,朴子里,72,1,818,16,834,1160,3,1,3,0,1,0,71.90
臺中縣,東勢鎮,北興里,73,1,808,7,815,1125,3,1,3,0,1,0,72.44
臺中縣,東勢鎮,中寧里,74,1,674,8,682,898,3,1,3,0,1,0,75.95
臺中縣,東勢鎮,東安里,75,1,1143,14,1157,1562,3,1,3,0,1,0,74.07
臺中縣,東勢鎮,南平里,76,1,699,13,712,906,3,1,3,0,1,0,78.59
臺中縣,東勢鎮,南平里,77,1,771,17,788,1053,3,1,3,0,1,0,74.83
臺中縣,東勢鎮,延平里,78,1,825,10,835,1153,3,1,3,0,1,0,72.42
臺中縣,東勢鎮,延平里,79,1,797,13,810,1144,3,1,3,0,1,0,70.80
臺中縣,東勢鎮,上新里,80,1,786,5,791,1059,3,1,3,0,1,0,74.69
臺中縣,東勢鎮,廣興里,81,1,1126,26,1152,1575,3,1,3,0,1,0,73.14
臺中縣,東勢鎮,泰昌里,82,1,1237,8,1245,1717,3,1,3,0,1,0,72.51
臺中縣,東勢鎮,泰昌里,83,1,1036,16,1052,1474,3,1,3,0,1,0,71.37
臺中縣,東勢鎮,中嵙里,84,1,1262,17,1279,1838,3,1,3,0,1,0,69.59
臺中縣,東勢鎮,福隆里,85,1,678,11,689,944,3,1,3,0,1,0,72.99
臺中縣,東勢鎮,福隆里,86,1,991,19,1010,1437,3,1,3,0,1,0,70.29
臺中縣,東勢鎮,隆興里,87,1,1031,18,1049,1477,3,1,3,0,1,0,71.02
臺中縣,東勢鎮,新盛里,88,1,880,20,900,1244,3,1,3,0,1,0,72.35
臺中縣,東勢鎮,新盛里,89,1,1088,14,1102,1470,3,1,3,0,1,0,74.97
臺中縣,東勢鎮,新盛里,90,1,1074,16,1090,1519,3,1,3,0,1,0,71.76
臺中縣,東勢鎮,詒福里,91,1,1114,24,1138,1492,3,1,3,0,1,0,76.27
臺中縣,東勢鎮,上城里,92,1,735,8,743,998,3,1,3,0,1,0,74.45
臺中縣,東勢鎮,下城里,93,1,697,7,704,899,3,1,3,0,1,0,78.31
臺中縣,東勢鎮,慶東里,94,1,789,7,796,1059,3,1,3,0,1,0,75.17
臺中縣,東勢鎮,慶東里,95,1,673,4,677,892,3,1,3,0,1,0,75.90
臺中縣,東勢鎮,慶福里,96,1,906,14,920,1393,3,1,3,0,1,0,66.04
臺中縣,東勢鎮,東新里,97,1,1211,24,1235,1705,3,1,3,0,1,0,72.43
臺中縣,東勢鎮,粵寧里,98,1,1373,22,1395,1834,3,1,3,0,1,0,76.06
臺中縣,東勢鎮,下新里,99,1,1106,18,1124,1492,3,1,3,0,1,0,75.34
臺中縣,東勢鎮,興隆里,100,1,866,8,874,1221,3,1,3,0,1,0,71.58
臺中縣,東勢鎮,茂興里,101,1,1045,18,1063,1543,3,1,3,0,1,0,68.89
臺中縣,東勢鎮,泰興里,102,1,547,8,555,754,3,1,3,0,1,0,73.61
臺中縣,東勢鎮,埤頭里,103,1,532,7,539,674,3,1,3,0,1,0,79.97
臺中縣,東勢鎮,明正里,104,1,949,24,973,1350,3,1,3,0,1,0,72.07
臺中縣,大甲鎮,朝陽里,105,1,814,18,832,1155,3,1,3,0,1,0,72.03
臺中縣,大甲鎮,大甲里,106,1,878,8,886,1209,3,1,3,0,1,0,73.28
臺中縣,大甲鎮,順天里,107,1,659,10,669,893,3,1,3,0,1,0,74.92
臺中縣,大甲鎮,順天里,108,1,632,7,639,880,3,1,3,0,1,0,72.61
臺中縣,大甲鎮,孔門里,109,1,524,9,533,717,3,1,3,0,1,0,74.34
臺中縣,大甲鎮,平安里,110,1,669,7,676,888,3,1,3,0,1,0,76.13
臺中縣,大甲鎮,平安里,111,1,576,8,584,757,3,1,3,0,1,0,77.15
臺中縣,大甲鎮,庄美里,112,1,576,9,585,853,3,1,3,0,1,0,68.58
臺中縣,大甲鎮,庄美里,113,1,696,8,704,977,3,1,3,0,1,0,72.06
臺中縣,大甲鎮,新美里,114,1,683,16,699,963,3,1,3,0,1,0,72.59
臺中縣,大甲鎮,新美里,115,1,736,9,745,1017,3,1,3,0,1,0,73.25
臺中縣,大甲鎮,新美里,116,1,728,9,737,995,3,1,3,0,1,0,74.07
臺中縣,大甲鎮,岷山里,117,1,1150,21,1171,1457,3,1,3,0,1,0,80.37
臺中縣,大甲鎮,中山里,118,1,625,12,637,872,3,1,3,0,1,0,73.05
臺中縣,大甲鎮,中山里,119,1,1274,18,1292,1777,3,1,3,0,1,0,72.71
臺中縣,大甲鎮,南陽里,120,1,640,13,653,903,3,1,3,0,1,0,72.31
臺中縣,大甲鎮,薰風里,121,1,663,4,667,908,3,1,3,0,1,0,73.46
臺中縣,大甲鎮,義和里,122,1,820,9,829,1077,3,1,3,0,1,0,76.97
臺中縣,大甲鎮,義和里,123,1,901,20,921,1217,3,1,3,0,1,0,75.68
臺中縣,大甲鎮,武陵里,124,1,813,15,828,1001,3,1,3,0,1,0,82.72
臺中縣,大甲鎮,文曲里,125,1,813,12,825,1038,3,1,3,0,1,0,79.48
臺中縣,大甲鎮,武曲里,126,1,1024,18,1042,1295,3,1,3,0,1,0,80.46
臺中縣,大甲鎮,文武里,127,1,889,9,898,1186,3,1,3,0,1,0,75.72
臺中縣,大甲鎮,文武里,128,1,867,18,885,1169,3,1,3,0,1,0,75.71
臺中縣,大甲鎮,文武里,129,1,951,13,964,1307,3,1,3,0,1,0,73.76
臺中縣,大甲鎮,奉化里,130,1,753,16,769,983,3,1,3,0,1,0,78.23
臺中縣,大甲鎮,德化里,131,1,1015,14,1029,1316,3,1,3,0,1,0,78.19
臺中縣,大甲鎮,江南里,132,1,634,8,642,805,3,1,3,0,1,0,79.75
臺中縣,大甲鎮,頂店里,133,1,653,15,668,860,3,1,3,0,1,0,77.67
臺中縣,大甲鎮,頂店里,134,1,764,11,775,961,3,1,3,0,1,0,80.65
臺中縣,大甲鎮,頂店里,135,1,777,16,793,1031,3,1,3,0,1,0,76.92
臺中縣,大甲鎮,太白里,136,1,849,9,858,1136,3,1,3,0,1,0,75.53
臺中縣,大甲鎮,孟春里,137,1,1125,22,1147,1477,3,1,3,0,1,0,77.66
臺中縣,大甲鎮,孟春里,138,1,969,18,987,1284,3,1,3,0,1,0,76.87
臺中縣,大甲鎮,幸福里,139,1,798,13,811,1097,3,1,3,0,1,0,73.93
臺中縣,大甲鎮,幸福里,140,1,829,11,840,1142,3,1,3,0,1,0,73.56
臺中縣,大甲鎮,日南里,141,1,844,14,858,1239,3,1,3,0,1,0,69.25
臺中縣,大甲鎮,日南里,142,1,717,19,736,1104,3,1,3,0,1,0,66.67
臺中縣,大甲鎮,日南里,143,1,562,7,569,864,3,1,3,0,1,0,65.86
臺中縣,大甲鎮,龍泉里,144,1,994,11,1005,1254,3,1,3,0,1,0,80.14
臺中縣,大甲鎮,西岐里,145,1,1068,19,1087,1457,3,1,3,0,1,0,74.61
臺中縣,大甲鎮,銅安里,146,1,846,17,863,1128,3,1,3,0,1,0,76.51
臺中縣,大甲鎮,福德里,147,1,839,12,851,1033,3,1,3,0,1,0,82.38
臺中縣,大甲鎮,建興里,148,1,887,13,900,1172,3,1,3,0,1,0,76.79
臺中縣,清水鎮,鰲峰里,149,1,868,17,885,1250,3,1,3,0,1,0,70.80
臺中縣,清水鎮,靈泉里,150,1,815,10,825,1069,3,1,3,0,1,0,77.17
臺中縣,清水鎮,清水里,151,1,1424,21,1445,1994,3,1,3,0,1,0,72.47
臺中縣,清水鎮,文昌里,152,1,543,6,549,753,3,1,3,0,1,0,72.91
臺中縣,清水鎮,南寧里,153,1,703,11,714,987,3,1,3,0,1,0,72.34
臺中縣,清水鎮,南寧里,154,1,738,8,746,1016,3,1,3,0,1,0,73.43
臺中縣,清水鎮,西寧里,155,1,1032,16,1048,1345,3,1,3,0,1,0,77.92
臺中縣,清水鎮,北寧里,156,1,544,4,548,719,3,1,3,0,1,0,76.22
臺中縣,清水鎮,中興里,157,1,335,6,341,495,3,1,3,0,1,0,68.89
臺中縣,清水鎮,西社里,158,1,1011,12,1023,1387,3,1,3,0,1,0,73.76
臺中縣,清水鎮,西社里,159,1,752,10,762,968,3,1,3,0,1,0,78.72
臺中縣,清水鎮,南社里,160,1,1219,18,1237,1686,3,1,3,0,1,0,73.37
臺中縣,清水鎮,南社里,161,1,1262,14,1276,1637,3,1,3,0,1,0,77.95
臺中縣,清水鎮,裕嘉里,162,1,736,12,748,967,3,1,3,0,1,0,77.35
臺中縣,清水鎮,臨江里,163,1,988,29,1017,1310,3,1,3,0,1,0,77.63
臺中縣,清水鎮,秀水里,164,1,979,17,996,1275,3,1,3,0,1,0,78.12
臺中縣,清水鎮,秀水里,165,1,1249,28,1277,1650,3,1,3,0,1,0,77.39
臺中縣,清水鎮,武鹿里,166,1,993,18,1011,1277,3,1,3,0,1,0,79.17
臺中縣,清水鎮,武鹿里,167,1,836,12,848,1094,3,1,3,0,1,0,77.51
臺中縣,清水鎮,海濱里,168,1,1346,18,1364,1665,3,1,3,0,1,0,81.92
臺中縣,清水鎮,康榔里,169,1,1154,17,1171,1483,3,1,3,0,1,0,78.96
臺中縣,清水鎮,康榔里,170,1,754,8,762,1082,3,1,3,0,1,0,70.43
臺中縣,清水鎮,中社里,171,1,1517,16,1533,1989,3,1,3,0,1,0,77.07
臺中縣,清水鎮,高西里,172,1,971,16,987,1243,3,1,3,0,1,0,79.40
臺中縣,清水鎮,高南里,173,1,924,9,933,1213,3,1,3,0,1,0,76.92
臺中縣,清水鎮,高東里,174,1,923,21,944,1230,3,1,3,0,1,0,76.75
臺中縣,清水鎮,高北里,175,1,762,16,778,961,3,1,3,0,1,0,80.96
臺中縣,清水鎮,高美里,176,1,962,8,970,1220,3,1,3,0,1,0,79.51
臺中縣,清水鎮,國姓里,177,1,1351,11,1362,1897,3,1,3,0,1,0,71.80
臺中縣,清水鎮,菁埔里,178,1,1561,25,1586,2019,3,1,3,0,1,0,78.55
臺中縣,清水鎮,頂湳里,179,1,1201,21,1222,1653,3,1,3,0,1,0,73.93
臺中縣,清水鎮,田寮里,180,1,1402,26,1428,1971,3,1,3,0,1,0,72.45
臺中縣,清水鎮,橋頭里,181,1,966,22,988,1440,3,1,3,0,1,0,68.61
臺中縣,清水鎮,橋頭里,182,1,1072,15,1087,1586,3,1,3,0,1,0,68.54
臺中縣,清水鎮,橋頭里,183,1,1001,12,1013,1455,3,1,3,0,1,0,69.62
臺中縣,清水鎮,下湳里,184,1,847,9,856,1186,3,1,3,0,1,0,72.18
臺中縣,清水鎮,下湳里,185,1,1119,18,1137,1560,3,1,3,0,1,0,72.88
臺中縣,清水鎮,東山里,186,1,863,15,878,1059,3,1,3,0,1,0,82.91
臺中縣,清水鎮,吳厝里,187,1,797,6,803,1034,3,1,3,0,1,0,77.66
臺中縣,清水鎮,楊厝里,188,1,718,15,733,949,3,1,3,0,1,0,77.24
臺中縣,清水鎮,海風里,189,1,804,10,814,1050,3,1,3,0,1,0,77.52
臺中縣,沙鹿鎮,居仁里,190,1,1003,14,1017,1296,3,1,3,0,1,0,78.47
臺中縣,沙鹿鎮,洛泉里,191,1,785,15,800,1045,3,1,3,0,1,0,76.56
臺中縣,沙鹿鎮,洛泉里,192,1,961,7,968,1184,3,1,3,0,1,0,81.76
臺中縣,沙鹿鎮,沙鹿里,193,1,874,12,886,1167,3,1,3,0,1,0,75.92
臺中縣,沙鹿鎮,美仁里,194,1,468,4,472,564,3,1,3,0,1,0,83.69
臺中縣,沙鹿鎮,興仁里,195,1,918,17,935,1219,3,1,3,0,1,0,76.70
臺中縣,沙鹿鎮,興仁里,196,1,675,6,681,980,3,1,3,0,1,0,69.49
臺中縣,沙鹿鎮,興安里,197,1,695,20,715,907,3,1,3,0,1,0,78.83
臺中縣,沙鹿鎮,興安里,198,1,1072,9,1081,1427,3,1,3,0,1,0,75.75
臺中縣,沙鹿鎮,斗抵里,199,1,1461,22,1483,2005,3,1,3,0,1,0,73.97
臺中縣,沙鹿鎮,斗抵里,200,1,761,10,771,985,3,1,3,0,1,0,78.27
臺中縣,沙鹿鎮,鹿峰里,201,1,1316,18,1334,1728,3,1,3,0,1,0,77.20
臺中縣,沙鹿鎮,鹿峰里,202,1,1204,22,1226,1570,3,1,3,0,1,0,78.09
臺中縣,沙鹿鎮,鹿寮里,203,1,964,12,976,1302,3,1,3,0,1,0,74.96
臺中縣,沙鹿鎮,鹿寮里,204,1,1268,13,1281,1631,3,1,3,0,1,0,78.54
臺中縣,沙鹿鎮,鹿寮里,205,1,993,12,1005,1333,3,1,3,0,1,0,75.39
臺中縣,沙鹿鎮,竹林里,206,1,1140,11,1151,1515,3,1,3,0,1,0,75.97
臺中縣,沙鹿鎮,竹林里,207,1,1260,12,1272,1655,3,1,3,0,1,0,76.86
臺中縣,沙鹿鎮,竹林里,208,1,891,18,909,1200,3,1,3,0,1,0,75.75
臺中縣,沙鹿鎮,犁分里,209,1,670,10,680,838,3,1,3,0,1,0,81.15
臺中縣,沙鹿鎮,福興里,210,1,1359,16,1375,1791,3,1,3,0,1,0,76.77
臺中縣,沙鹿鎮,北勢里,211,1,1012,11,1023,1332,3,1,3,0,1,0,76.80
臺中縣,沙鹿鎮,北勢里,212,1,908,18,926,1227,3,1,3,0,1,0,75.47
臺中縣,沙鹿鎮,晉江里,213,1,841,13,854,1095,3,1,3,0,1,0,77.99
臺中縣,沙鹿鎮,六路里,214,1,859,14,873,1222,3,1,3,0,1,0,71.44
臺中縣,沙鹿鎮,南勢里,215,1,1079,22,1101,1423,3,1,3,0,1,0,77.37
臺中縣,沙鹿鎮,埔子里,216,1,1119,13,1132,1460,3,1,3,0,1,0,77.53
臺中縣,沙鹿鎮,埔子里,217,1,1168,17,1185,1536,3,1,3,0,1,0,77.15
臺中縣,沙鹿鎮,公明里,218,1,1198,19,1217,1590,3,1,3,0,1,0,76.54
臺中縣,沙鹿鎮,公明里,219,1,1201,16,1217,1644,3,1,3,0,1,0,74.03
臺中縣,沙鹿鎮,清泉里,220,1,1111,20,1131,1373,3,1,3,0,1,0,82.37
臺中縣,沙鹿鎮,西勢里,221,1,1419,24,1443,1889,3,1,3,0,1,0,76.39
臺中縣,梧棲鎮,頂寮里,222,1,1263,17,1280,1817,3,1,3,0,1,0,70.45
臺中縣,梧棲鎮,下寮里,223,1,1516,24,1540,2043,3,1,3,0,1,0,75.38
臺中縣,梧棲鎮,中正里,224,1,749,9,758,1025,3,1,3,0,1,0,73.95
臺中縣,梧棲鎮,中正里,225,1,1169,22,1191,1848,3,1,3,0,1,0,64.45
臺中縣,梧棲鎮,中和里,226,1,392,7,399,549,3,1,3,0,1,0,72.68
臺中縣,梧棲鎮,文化里,227,1,828,17,845,1096,3,1,3,0,1,0,77.10
臺中縣,梧棲鎮,安仁里,228,1,561,8,569,748,3,1,3,0,1,0,76.07
臺中縣,梧棲鎮,草湳里,229,1,1391,31,1422,1872,3,1,3,0,1,0,75.96
臺中縣,梧棲鎮,草湳里,230,1,1349,22,1371,1786,3,1,3,0,1,0,76.76
臺中縣,梧棲鎮,南簡里,231,1,1258,21,1279,1678,3,1,3,0,1,0,76.22
臺中縣,梧棲鎮,福德里,232,1,882,9,891,1166,3,1,3,0,1,0,76.42
臺中縣,梧棲鎮,福德里,233,1,712,9,721,1019,3,1,3,0,1,0,70.76
臺中縣,梧棲鎮,大庄里,234,1,1122,21,1143,1626,3,1,3,0,1,0,70.30
臺中縣,梧棲鎮,大庄里,235,1,834,20,854,1154,3,1,3,0,1,0,74.00
臺中縣,梧棲鎮,大庄里,236,1,930,12,942,1311,3,1,3,0,1,0,71.85
臺中縣,梧棲鎮,大村里,237,1,797,5,802,1076,3,1,3,0,1,0,74.54
臺中縣,梧棲鎮,大村里,238,1,1159,13,1172,1617,3,1,3,0,1,0,72.48
臺中縣,梧棲鎮,興農里,239,1,1125,13,1138,1585,3,1,3,0,1,0,71.80
臺中縣,梧棲鎮,永寧里,240,1,1392,35,1427,1867,3,1,3,0,1,0,76.43
臺中縣,梧棲鎮,永安里,241,1,1384,21,1405,1837,3,1,3,0,1,0,76.48
臺中縣,后里鄉,廣福村,242,1,1353,28,1381,1844,3,1,3,0,1,0,74.89
臺中縣,后里鄉,仁里村,243,1,690,11,701,887,3,1,3,0,1,0,79.03
臺中縣,后里鄉,仁里村,244,1,1133,15,1148,1370,3,1,3,0,1,0,83.80
臺中縣,后里鄉,義里村,245,1,763,19,782,1045,3,1,3,0,1,0,74.83
臺中縣,后里鄉,義里村,246,1,1259,17,1276,1756,3,1,3,0,1,0,72.67
臺中縣,后里鄉,義里村,247,1,1334,30,1364,1821,3,1,3,0,1,0,74.90
臺中縣,后里鄉,后里村,248,1,1086,16,1102,1385,3,1,3,0,1,0,79.57
臺中縣,后里鄉,后里村,249,1,1299,24,1323,1642,3,1,3,0,1,0,80.57
臺中縣,后里鄉,厚里村,250,1,1280,11,1291,1570,3,1,3,0,1,0,82.23
臺中縣,后里鄉,墩東村,251,1,1424,30,1454,1834,3,1,3,0,1,0,79.28
臺中縣,后里鄉,墩東村,252,1,1333,29,1362,1659,3,1,3,0,1,0,82.10
臺中縣,后里鄉,墩西村,253,1,1433,20,1453,1779,3,1,3,0,1,0,81.68
臺中縣,后里鄉,墩南村,254,1,1593,36,1629,2112,3,1,3,0,1,0,77.13
臺中縣,后里鄉,墩北村,255,1,964,13,977,1195,3,1,3,0,1,0,81.76
臺中縣,后里鄉,墩北村,256,1,1107,25,1132,1383,3,1,3,0,1,0,81.85
臺中縣,后里鄉,中和村,257,1,1333,25,1358,1673,3,1,3,0,1,0,81.17
臺中縣,后里鄉,舊社村,258,1,861,18,879,1084,3,1,3,0,1,0,81.09
臺中縣,后里鄉,聯合村,259,1,1128,25,1153,1411,3,1,3,0,1,0,81.72
臺中縣,后里鄉,太平村,260,1,1400,27,1427,1740,3,1,3,0,1,0,82.01
臺中縣,后里鄉,眉山村,261,1,1581,29,1610,2040,3,1,3,0,1,0,78.92
臺中縣,后里鄉,樂業村,262,1,265,6,271,330,3,1,3,0,1,0,82.12
臺中縣,后里鄉,月眉村,263,1,1104,17,1121,1394,3,1,3,0,1,0,80.42
臺中縣,后里鄉,公舘村,264,1,1251,20,1271,1655,3,1,3,0,1,0,76.80
臺中縣,后里鄉,泰安村,265,1,936,9,945,1215,3,1,3,0,1,0,77.78
臺中縣,神岡鄉,神岡村,266,1,829,16,845,1115,3,1,3,0,1,0,75.78
臺中縣,神岡鄉,神岡村,267,1,719,17,736,1001,3,1,3,0,1,0,73.53
臺中縣,神岡鄉,庄前村,268,1,957,18,975,1238,3,1,3,0,1,0,78.76
臺中縣,神岡鄉,北庄村,269,1,1456,23,1479,1897,3,1,3,0,1,0,77.97
臺中縣,神岡鄉,庄後村,270,1,1367,26,1393,1741,3,1,3,0,1,0,80.01
臺中縣,神岡鄉,圳前村,271,1,790,7,797,1007,3,1,3,0,1,0,79.15
臺中縣,神岡鄉,圳前村,272,1,750,14,764,1011,3,1,3,0,1,0,75.57
臺中縣,神岡鄉,圳堵村,273,1,1470,31,1501,1898,3,1,3,0,1,0,79.08
臺中縣,神岡鄉,新庄村,274,1,1185,16,1201,1511,3,1,3,0,1,0,79.48
臺中縣,神岡鄉,新庄村,275,1,1146,30,1176,1551,3,1,3,0,1,0,75.82
臺中縣,神岡鄉,山皮村,276,1,715,9,724,891,3,1,3,0,1,0,81.26
臺中縣,神岡鄉,社口村,277,1,1101,21,1122,1391,3,1,3,0,1,0,80.66
臺中縣,神岡鄉,社口村,278,1,1125,15,1140,1457,3,1,3,0,1,0,78.24
臺中縣,神岡鄉,社口村,279,1,902,19,921,1215,3,1,3,0,1,0,75.80
臺中縣,神岡鄉,社南村,280,1,1040,10,1050,1390,3,1,3,0,1,0,75.54
臺中縣,神岡鄉,社南村,281,1,1217,23,1240,1688,3,1,3,0,1,0,73.46
臺中縣,神岡鄉,三角村,282,1,1336,22,1358,1780,3,1,3,0,1,0,76.29
臺中縣,神岡鄉,大社村,283,1,1094,26,1120,1540,3,1,3,0,1,0,72.73
臺中縣,神岡鄉,岸裡村,284,1,726,11,737,1035,3,1,3,0,1,0,71.21
臺中縣,神岡鄉,岸裡村,285,1,768,12,780,1076,3,1,3,0,1,0,72.49
臺中縣,神岡鄉,豐洲村,286,1,1333,29,1362,1835,3,1,3,0,1,0,74.22
臺中縣,神岡鄉,豐洲村,287,1,1256,28,1284,1688,3,1,3,0,1,0,76.07
臺中縣,神岡鄉,豐洲村,288,1,1346,36,1382,1827,3,1,3,0,1,0,75.64
臺中縣,神岡鄉,神洲村,289,1,743,12,755,969,3,1,3,0,1,0,77.92
臺中縣,神岡鄉,神洲村,290,1,798,16,814,1017,3,1,3,0,1,0,80.04
臺中縣,神岡鄉,溪洲村,291,1,855,25,880,1085,3,1,3,0,1,0,81.11
臺中縣,神岡鄉,溪洲村,292,1,811,20,831,1086,3,1,3,0,1,0,76.52
臺中縣,潭子鄉,潭秀村,293,1,1081,12,1093,1484,3,1,3,0,1,0,73.65
臺中縣,潭子鄉,潭北村,294,1,1324,17,1341,1854,3,1,3,0,1,0,72.33
臺中縣,潭子鄉,潭陽村,295,1,1061,20,1081,1522,3,1,3,0,1,0,71.02
臺中縣,潭子鄉,潭陽村,296,1,1270,22,1292,1843,3,1,3,0,1,0,70.10
臺中縣,潭子鄉,潭陽村,297,1,1159,7,1166,1763,3,1,3,0,1,0,66.14
臺中縣,潭子鄉,潭陽村,298,1,1087,19,1106,1563,3,1,3,0,1,0,70.76
臺中縣,潭子鄉,福仁村,299,1,1174,20,1194,1598,3,1,3,0,1,0,74.72
臺中縣,潭子鄉,福仁村,300,1,917,16,933,1371,3,1,3,0,1,0,68.05
臺中縣,潭子鄉,福仁村,301,1,1350,22,1372,1923,3,1,3,0,1,0,71.35
臺中縣,潭子鄉,頭家村,302,1,1371,19,1390,2412,3,1,3,0,1,0,57.63
臺中縣,潭子鄉,頭家村,303,1,1196,27,1223,1751,3,1,3,0,1,0,69.85
臺中縣,潭子鄉,頭家村,304,1,1201,20,1221,1755,3,1,3,0,1,0,69.57
臺中縣,潭子鄉,頭家村,305,1,987,19,1006,1336,3,1,3,0,1,0,75.30
臺中縣,潭子鄉,頭家村,306,1,1320,21,1341,1971,3,1,3,0,1,0,68.04
臺中縣,潭子鄉,甘蔗村,307,1,937,13,950,1275,3,1,3,0,1,0,74.51
臺中縣,潭子鄉,甘蔗村,308,1,1005,19,1024,1545,3,1,3,0,1,0,66.28
臺中縣,潭子鄉,東寶村,309,1,693,13,706,913,3,1,3,0,1,0,77.33
臺中縣,潭子鄉,東寶村,310,1,1260,45,1305,1822,3,1,3,0,1,0,71.62
臺中縣,潭子鄉,東寶村,311,1,1075,14,1089,1477,3,1,3,0,1,0,73.73
臺中縣,潭子鄉,東寶村,312,1,1015,11,1026,1388,3,1,3,0,1,0,73.92
臺中縣,潭子鄉,東寶村,313,1,784,18,802,1037,3,1,3,0,1,0,77.34
臺中縣,潭子鄉,大富村,314,1,946,19,965,1140,3,1,3,0,1,0,84.65
臺中縣,潭子鄉,大豐村,315,1,613,11,624,812,3,1,3,0,1,0,76.85
臺中縣,潭子鄉,大豐村,316,1,901,18,919,1314,3,1,3,0,1,0,69.94
臺中縣,潭子鄉,栗林村,317,1,1017,20,1037,1428,3,1,3,0,1,0,72.62
臺中縣,潭子鄉,栗林村,318,1,899,11,910,1245,3,1,3,0,1,0,73.09
臺中縣,潭子鄉,栗林村,319,1,745,13,758,1017,3,1,3,0,1,0,74.53
臺中縣,潭子鄉,嘉仁村,320,1,1114,18,1132,1483,3,1,3,0,1,0,76.33
臺中縣,潭子鄉,嘉仁村,321,1,1005,17,1022,1378,3,1,3,0,1,0,74.17
臺中縣,潭子鄉,新田村,322,1,1073,21,1094,1458,3,1,3,0,1,0,75.03
臺中縣,潭子鄉,聚興村,323,1,994,15,1009,1302,3,1,3,0,1,0,77.50
臺中縣,潭子鄉,聚興村,324,1,926,27,953,1316,3,1,3,0,1,0,72.42
臺中縣,大雅鄉,大雅村,325,1,1291,17,1308,1815,3,1,3,0,1,0,72.07
臺中縣,大雅鄉,大雅村,326,1,1348,21,1369,1897,3,1,3,0,1,0,72.17
臺中縣,大雅鄉,大雅村,327,1,1181,23,1204,1683,3,1,3,0,1,0,71.54
臺中縣,大雅鄉,大雅村,328,1,1357,30,1387,2017,3,1,3,0,1,0,68.77
臺中縣,大雅鄉,大雅村,329,1,1410,20,1430,2035,3,1,3,0,1,0,70.27
臺中縣,大雅鄉,三和村,330,1,1611,32,1643,2439,3,1,3,0,1,0,67.36
臺中縣,大雅鄉,三和村,331,1,1154,27,1181,1642,3,1,3,0,1,0,71.92
臺中縣,大雅鄉,三和村,332,1,987,22,1009,1335,3,1,3,0,1,0,75.58
臺中縣,大雅鄉,三和村,333,1,947,19,966,1286,3,1,3,0,1,0,75.12
臺中縣,大雅鄉,西寶村,334,1,1498,23,1521,2053,3,1,3,0,1,0,74.09
臺中縣,大雅鄉,上楓村,335,1,1506,25,1531,2176,3,1,3,0,1,0,70.36
臺中縣,大雅鄉,上楓村,336,1,1353,36,1389,2058,3,1,3,0,1,0,67.49
臺中縣,大雅鄉,上楓村,337,1,716,13,729,954,3,1,3,0,1,0,76.42
臺中縣,大雅鄉,上楓村,338,1,995,21,1016,1612,3,1,3,0,1,0,63.03
臺中縣,大雅鄉,員林村,339,1,1005,22,1027,1305,3,1,3,0,1,0,78.70
臺中縣,大雅鄉,員林村,340,1,964,26,990,1309,3,1,3,0,1,0,75.63
臺中縣,大雅鄉,員林村,341,1,1140,28,1168,1547,3,1,3,0,1,0,75.50
臺中縣,大雅鄉,六寶村,342,1,1238,22,1260,1644,3,1,3,0,1,0,76.64
臺中縣,大雅鄉,六寶村,343,1,1224,28,1252,1699,3,1,3,0,1,0,73.69
臺中縣,大雅鄉,六寶村,344,1,970,23,993,1308,3,1,3,0,1,0,75.92
臺中縣,大雅鄉,秀山村,345,1,1065,18,1083,1335,3,1,3,0,1,0,81.12
臺中縣,大雅鄉,秀山村,346,1,740,14,754,975,3,1,3,0,1,0,77.33
臺中縣,大雅鄉,橫山村,347,1,1095,27,1122,1412,3,1,3,0,1,0,79.46
臺中縣,大雅鄉,橫山村,348,1,832,19,851,1114,3,1,3,0,1,0,76.39
臺中縣,大雅鄉,忠義村,349,1,1040,23,1063,1353,3,1,3,0,1,0,78.57
臺中縣,大雅鄉,忠義村,350,1,1218,30,1248,1759,3,1,3,0,1,0,70.95
臺中縣,新社鄉,新社村,351,1,1819,31,1850,2393,3,1,3,0,1,0,77.31
臺中縣,新社鄉,復盛村,352,1,1302,22,1324,1666,3,1,3,0,1,0,79.47
臺中縣,新社鄉,中正村,353,1,938,18,956,1179,3,1,3,0,1,0,81.09
臺中縣,新社鄉,月湖村,354,1,690,10,700,848,3,1,3,0,1,0,82.55
臺中縣,新社鄉,崑山村,355,1,939,17,956,1219,3,1,3,0,1,0,78.42
臺中縣,新社鄉,大南村,356,1,1524,26,1550,1954,3,1,3,0,1,0,79.32
臺中縣,新社鄉,永源村,357,1,1387,31,1418,1743,3,1,3,0,1,0,81.35
臺中縣,新社鄉,永源村,358,1,493,10,503,637,3,1,3,0,1,0,78.96
臺中縣,新社鄉,中興村,359,1,687,4,691,878,3,1,3,0,1,0,78.70
臺中縣,新社鄉,協成村,360,1,864,13,877,1124,3,1,3,0,1,0,78.02
臺中縣,新社鄉,協成村,361,1,996,17,1013,1290,3,1,3,0,1,0,78.53
臺中縣,新社鄉,東興村,362,1,1011,14,1025,1264,3,1,3,0,1,0,81.09
臺中縣,新社鄉,慶西村,363,1,232,3,235,280,3,1,3,0,1,0,83.93
臺中縣,新社鄉,慶西村,364,1,478,8,486,628,3,1,3,0,1,0,77.39
臺中縣,新社鄉,中和村,365,1,474,1,475,618,3,1,3,0,1,0,76.86
臺中縣,新社鄉,福興村,366,1,814,13,827,1113,3,1,3,0,1,0,74.30
臺中縣,新社鄉,福興村,367,1,212,0,212,278,3,1,3,0,1,0,76.26
臺中縣,石岡鄉,石岡村,368,1,674,11,685,881,3,1,3,0,1,0,77.75
臺中縣,石岡鄉,萬安村,369,1,817,16,833,1078,3,1,3,0,1,0,77.27
臺中縣,石岡鄉,九房村,370,1,711,12,723,932,3,1,3,0,1,0,77.58
臺中縣,石岡鄉,金星村,371,1,780,10,790,1051,3,1,3,0,1,0,75.17
臺中縣,石岡鄉,龍興村,372,1,480,6,486,632,3,1,3,0,1,0,76.90
臺中縣,石岡鄉,萬興村,373,1,945,23,968,1193,3,1,3,0,1,0,81.14
臺中縣,石岡鄉,梅子村,374,1,1211,26,1237,1599,3,1,3,0,1,0,77.36
臺中縣,石岡鄉,土牛村,375,1,751,12,763,966,3,1,3,0,1,0,78.99
臺中縣,石岡鄉,德興村,376,1,982,16,998,1264,3,1,3,0,1,0,78.96
臺中縣,石岡鄉,和盛村,377,1,994,13,1007,1272,3,1,3,0,1,0,79.17
臺中縣,外埔鄉,永豐村,378,1,775,10,785,930,3,1,3,0,1,0,84.41
臺中縣,外埔鄉,六分村,379,1,986,20,1006,1244,3,1,3,0,1,0,80.87
臺中縣,外埔鄉,三崁村,380,1,1193,22,1215,1507,3,1,3,0,1,0,80.62
臺中縣,外埔鄉,大同村,381,1,1244,23,1267,1634,3,1,3,0,1,0,77.54
臺中縣,外埔鄉,大同村,382,1,1162,23,1185,1488,3,1,3,0,1,0,79.64
臺中縣,外埔鄉,水美村,383,1,1538,29,1567,2004,3,1,3,0,1,0,78.19
臺中縣,外埔鄉,大東村,384,1,1278,35,1313,1648,3,1,3,0,1,0,79.67
臺中縣,外埔鄉,大東村,385,1,1468,34,1502,1926,3,1,3,0,1,0,77.99
臺中縣,外埔鄉,馬鳴村,386,1,1012,15,1027,1264,3,1,3,0,1,0,81.25
臺中縣,外埔鄉,中山村,387,1,725,8,733,865,3,1,3,0,1,0,84.74
臺中縣,外埔鄉,鐵山村,388,1,1473,23,1496,1848,3,1,3,0,1,0,80.95
臺中縣,外埔鄉,土城村,389,1,1159,23,1182,1425,3,1,3,0,1,0,82.95
臺中縣,外埔鄉,廍子村,390,1,860,15,875,1080,3,1,3,0,1,0,81.02
臺中縣,大安鄉,南埔村,391,1,814,7,821,1009,3,1,3,0,1,0,81.37
臺中縣,大安鄉,南庄村,392,1,780,12,792,1036,3,1,3,0,1,0,76.45
臺中縣,大安鄉,中庄村,393,1,1492,18,1510,2093,3,1,3,0,1,0,72.15
臺中縣,大安鄉,東安村,394,1,887,11,898,1116,3,1,3,0,1,0,80.47
臺中縣,大安鄉,福興村,395,1,786,6,792,999,3,1,3,0,1,0,79.28
臺中縣,大安鄉,龜殼村,396,1,1232,16,1248,1600,3,1,3,0,1,0,78.00
臺中縣,大安鄉,頂安村,397,1,616,4,620,802,3,1,3,0,1,0,77.31
臺中縣,大安鄉,永安村,398,1,1074,17,1091,1443,3,1,3,0,1,0,75.61
臺中縣,大安鄉,福住村,399,1,668,11,679,922,3,1,3,0,1,0,73.64
臺中縣,大安鄉,海墘村,400,1,1034,12,1046,1311,3,1,3,0,1,0,79.79
臺中縣,大安鄉,西安村,401,1,828,12,840,1147,3,1,3,0,1,0,73.23
臺中縣,大安鄉,松雅村,402,1,501,5,506,630,3,1,3,0,1,0,80.32
臺中縣,烏日鄉,烏日村,403,1,1575,28,1603,2195,3,1,3,0,1,0,73.03
臺中縣,烏日鄉,烏日村,404,1,1684,20,1704,2357,3,1,3,0,1,0,72.30
臺中縣,烏日鄉,湖日村,405,1,1527,30,1557,2278,3,1,3,0,1,0,68.35
臺中縣,烏日鄉,三和村,406,1,1460,37,1497,2090,3,1,3,0,1,0,71.63
臺中縣,烏日鄉,三和村,407,1,1137,28,1165,1541,3,1,3,0,1,0,75.60
臺中縣,烏日鄉,榮泉村,408,1,1143,13,1156,1427,3,1,3,0,1,0,81.01
臺中縣,烏日鄉,榮泉村,409,1,754,18,772,1074,3,1,3,0,1,0,71.88
臺中縣,烏日鄉,學田村,410,1,1504,26,1530,1944,3,1,3,0,1,0,78.70
臺中縣,烏日鄉,九德村,411,1,1594,23,1617,2348,3,1,3,0,1,0,68.87
臺中縣,烏日鄉,九德村,412,1,1416,27,1443,2027,3,1,3,0,1,0,71.19
臺中縣,烏日鄉,九德村,413,1,1568,18,1586,2246,3,1,3,0,1,0,70.61
臺中縣,烏日鄉,仁德村,414,1,1512,30,1542,2117,3,1,3,0,1,0,72.84
臺中縣,烏日鄉,仁德村,415,1,1160,10,1170,1674,3,1,3,0,1,0,69.89
臺中縣,烏日鄉,前竹村,416,1,1396,21,1417,1907,3,1,3,0,1,0,74.31
臺中縣,烏日鄉,五光村,417,1,933,12,945,1198,3,1,3,0,1,0,78.88
臺中縣,烏日鄉,光明村,418,1,1315,25,1340,1830,3,1,3,0,1,0,73.22
臺中縣,烏日鄉,東園村,419,1,1051,10,1061,1343,3,1,3,0,1,0,79.00
臺中縣,烏日鄉,溪埧村,420,1,1183,19,1202,1467,3,1,3,0,1,0,81.94
臺中縣,烏日鄉,溪埧村,421,1,1041,22,1063,1353,3,1,3,0,1,0,78.57
臺中縣,烏日鄉,螺潭村,422,1,1049,17,1066,1347,3,1,3,0,1,0,79.14
臺中縣,烏日鄉,北里村,423,1,810,19,829,1127,3,1,3,0,1,0,73.56
臺中縣,烏日鄉,南里村,424,1,673,16,689,927,3,1,3,0,1,0,74.33
臺中縣,烏日鄉,溪尾村,425,1,603,10,613,807,3,1,3,0,1,0,75.96
臺中縣,大肚鄉,王田村,426,1,1132,13,1145,1496,3,1,3,0,1,0,76.54
臺中縣,大肚鄉,王田村,427,1,1122,19,1141,1539,3,1,3,0,1,0,74.14
臺中縣,大肚鄉,中和村,428,1,627,7,634,722,3,1,3,0,1,0,87.81
臺中縣,大肚鄉,福山村,429,1,983,18,1001,1308,3,1,3,0,1,0,76.53
臺中縣,大肚鄉,福山村,430,1,1094,11,1105,1443,3,1,3,0,1,0,76.58
臺中縣,大肚鄉,營埔村,431,1,857,12,869,1053,3,1,3,0,1,0,82.53
臺中縣,大肚鄉,社腳村,432,1,841,9,850,995,3,1,3,0,1,0,85.43
臺中縣,大肚鄉,社腳村,433,1,750,16,766,949,3,1,3,0,1,0,80.72
臺中縣,大肚鄉,新興村,434,1,734,8,742,916,3,1,3,0,1,0,81.00
臺中縣,大肚鄉,新興村,435,1,552,8,560,904,3,1,3,0,1,0,61.95
臺中縣,大肚鄉,大東村,436,1,867,11,878,1099,3,1,3,0,1,0,79.89
臺中縣,大肚鄉,大東村,437,1,738,11,749,944,3,1,3,0,1,0,79.34
臺中縣,大肚鄉,大肚村,438,1,692,5,697,879,3,1,3,0,1,0,79.29
臺中縣,大肚鄉,大肚村,439,1,657,10,667,859,3,1,3,0,1,0,77.65
臺中縣,大肚鄉,永和村,440,1,644,11,655,800,3,1,3,0,1,0,81.88
臺中縣,大肚鄉,磺溪村,441,1,961,9,970,1171,3,1,3,0,1,0,82.84
臺中縣,大肚鄉,永順村,442,1,1120,13,1133,1445,3,1,3,0,1,0,78.41
臺中縣,大肚鄉,成功村,443,1,667,3,670,777,3,1,3,0,1,0,86.23
臺中縣,大肚鄉,山陽村,444,1,1014,20,1034,1312,3,1,3,0,1,0,78.81
臺中縣,大肚鄉,頂街村,445,1,1157,21,1178,1442,3,1,3,0,1,0,81.69
臺中縣,大肚鄉,頂街村,446,1,846,11,857,1165,3,1,3,0,1,0,73.56
臺中縣,大肚鄉,瑞井村,447,1,1181,28,1209,1641,3,1,3,0,1,0,73.67
臺中縣,大肚鄉,瑞井村,448,1,1142,35,1177,1633,3,1,3,0,1,0,72.08
臺中縣,大肚鄉,蔗廍村,449,1,1001,17,1018,1430,3,1,3,0,1,0,71.19
臺中縣,大肚鄉,蔗廍村,450,1,909,20,929,1322,3,1,3,0,1,0,70.27
臺中縣,大肚鄉,蔗廍村,451,1,753,13,766,1233,3,1,3,0,1,0,62.12
臺中縣,大肚鄉,蔗廍村,452,1,1131,16,1147,1493,3,1,3,0,1,0,76.83
臺中縣,龍井鄉,竹坑村,453,1,1034,22,1056,1440,3,1,3,0,1,0,73.33
臺中縣,龍井鄉,龍東村,454,1,1403,23,1426,1851,3,1,3,0,1,0,77.04
臺中縣,龍井鄉,龍西村,455,1,1056,19,1075,1299,3,1,3,0,1,0,82.76
臺中縣,龍井鄉,田中村,456,1,793,11,804,1113,3,1,3,0,1,0,72.24
臺中縣,龍井鄉,田中村,457,1,626,14,640,881,3,1,3,0,1,0,72.64
臺中縣,龍井鄉,福田村,458,1,696,8,704,902,3,1,3,0,1,0,78.05
臺中縣,龍井鄉,麗水村,459,1,1393,18,1411,1760,3,1,3,0,1,0,80.17
臺中縣,龍井鄉,龍津村,460,1,1143,22,1165,1435,3,1,3,0,1,0,81.18
臺中縣,龍井鄉,龍津村,461,1,1088,25,1113,1359,3,1,3,0,1,0,81.90
臺中縣,龍井鄉,龍津村,462,1,520,9,529,743,3,1,3,0,1,0,71.20
臺中縣,龍井鄉,三德村,463,1,860,12,872,1104,3,1,3,0,1,0,78.99
臺中縣,龍井鄉,三德村,464,1,656,2,658,855,3,1,3,0,1,0,76.96
臺中縣,龍井鄉,忠和村,465,1,1017,12,1029,1397,3,1,3,0,1,0,73.66
臺中縣,龍井鄉,忠和村,466,1,1255,18,1273,1771,3,1,3,0,1,0,71.88
臺中縣,龍井鄉,山腳村,467,1,791,15,806,1073,3,1,3,0,1,0,75.12
臺中縣,龍井鄉,山腳村,468,1,919,13,932,1286,3,1,3,0,1,0,72.47
臺中縣,龍井鄉,龍泉村,469,1,1286,35,1321,1764,3,1,3,0,1,0,74.89
臺中縣,龍井鄉,龍泉村,470,1,1013,20,1033,1397,3,1,3,0,1,0,73.94
臺中縣,龍井鄉,龍崗村,471,1,1069,18,1087,1421,3,1,3,0,1,0,76.50
臺中縣,龍井鄉,新庄村,472,1,1089,11,1100,1535,3,1,3,0,1,0,71.66
臺中縣,龍井鄉,新庄村,473,1,1181,30,1211,1739,3,1,3,0,1,0,69.64
臺中縣,龍井鄉,南寮村,474,1,862,11,873,1105,3,1,3,0,1,0,79.00
臺中縣,龍井鄉,新東村,475,1,1220,20,1240,1954,3,1,3,0,1,0,63.46
臺中縣,龍井鄉,新東村,476,1,985,11,996,1567,3,1,3,0,1,0,63.56
臺中縣,龍井鄉,新東村,477,1,825,18,843,1287,3,1,3,0,1,0,65.50
臺中縣,龍井鄉,新東村,478,1,791,11,802,1230,3,1,3,0,1,0,65.20
臺中縣,霧峰鄉,桐林村,479,1,803,15,818,1120,3,1,3,0,1,0,73.04
臺中縣,霧峰鄉,吉峰村,480,1,1704,22,1726,2412,3,1,3,0,1,0,71.56
臺中縣,霧峰鄉,吉峰村,481,1,1520,24,1544,2146,3,1,3,0,1,0,71.95
臺中縣,霧峰鄉,吉峰村,482,1,966,12,978,1398,3,1,3,0,1,0,69.96
臺中縣,霧峰鄉,甲寅村,483,1,1443,29,1472,2154,3,1,3,0,1,0,68.34
臺中縣,霧峰鄉,甲寅村,484,1,1330,16,1346,1792,3,1,3,0,1,0,75.11
臺中縣,霧峰鄉,本鄉村,485,1,1235,17,1252,1816,3,1,3,0,1,0,68.94
臺中縣,霧峰鄉,中正村,486,1,1042,17,1059,1452,3,1,3,0,1,0,72.93
臺中縣,霧峰鄉,錦榮村,487,1,616,14,630,816,3,1,3,0,1,0,77.21
臺中縣,霧峰鄉,萊園村,488,1,788,15,803,1135,3,1,3,0,1,0,70.75
臺中縣,霧峰鄉,本堂村,489,1,1150,11,1161,1620,3,1,3,0,1,0,71.67
臺中縣,霧峰鄉,本堂村,490,1,1034,19,1053,1478,3,1,3,0,1,0,71.24
臺中縣,霧峰鄉,本堂村,491,1,1116,15,1131,1576,3,1,3,0,1,0,71.76
臺中縣,霧峰鄉,北柳村,492,1,995,22,1017,1315,3,1,3,0,1,0,77.34
臺中縣,霧峰鄉,北柳村,493,1,869,28,897,1191,3,1,3,0,1,0,75.31
臺中縣,霧峰鄉,南柳村,494,1,1005,12,1017,1266,3,1,3,0,1,0,80.33
臺中縣,霧峰鄉,四德村,495,1,1414,19,1433,1865,3,1,3,0,1,0,76.84
臺中縣,霧峰鄉,五福村,496,1,1619,27,1646,2076,3,1,3,0,1,0,79.29
臺中縣,霧峰鄉,丁台村,497,1,1219,30,1249,1637,3,1,3,0,1,0,76.30
臺中縣,霧峰鄉,北勢村,498,1,1100,14,1114,1357,3,1,3,0,1,0,82.09
臺中縣,霧峰鄉,南勢村,499,1,741,11,752,966,3,1,3,0,1,0,77.85
臺中縣,霧峰鄉,萬豐村,500,1,840,10,850,1126,3,1,3,0,1,0,75.49
臺中縣,霧峰鄉,萬豐村,501,1,831,4,835,1235,3,1,3,0,1,0,67.61
臺中縣,霧峰鄉,舊正村,502,1,1440,15,1455,1913,3,1,3,0,1,0,76.06
臺中縣,霧峰鄉,坑口村,503,1,1570,23,1593,2101,3,1,3,0,1,0,75.82
臺中縣,霧峰鄉,坑口村,504,1,548,9,557,724,3,1,3,0,1,0,76.93
臺中縣,霧峰鄉,峰谷村,505,1,817,12,829,1089,3,1,3,0,1,0,76.12
臺中縣,霧峰鄉,六股村,506,1,1564,31,1595,2011,3,1,3,0,1,0,79.31
臺中縣,太平市,太平里,507,1,1168,18,1186,1648,3,1,3,0,1,0,71.97
臺中縣,太平市,太平里,508,1,1128,18,1146,1534,3,1,3,0,1,0,74.71
臺中縣,太平市,太平里,509,1,973,17,990,1424,3,1,3,0,1,0,69.52
臺中縣,太平市,長億里,510,1,989,25,1014,1493,3,1,3,0,1,0,67.92
臺中縣,太平市,長億里,511,1,986,13,999,1429,3,1,3,0,1,0,69.91
臺中縣,太平市,長億里,512,1,1454,39,1493,2245,3,1,3,0,1,0,66.50
臺中縣,太平市,中平里,513,1,1255,23,1278,1859,3,1,3,0,1,0,68.75
臺中縣,太平市,中平里,514,1,1218,27,1245,1713,3,1,3,0,1,0,72.68
臺中縣,太平市,中平里,515,1,1053,25,1078,1636,3,1,3,0,1,0,65.89
臺中縣,太平市,中興里,516,1,1155,17,1172,1643,3,1,3,0,1,0,71.33
臺中縣,太平市,中興里,517,1,1146,23,1169,1647,3,1,3,0,1,0,70.98
臺中縣,太平市,中興里,518,1,980,12,992,1340,3,1,3,0,1,0,74.03
臺中縣,太平市,東平里,519,1,1346,16,1362,1867,3,1,3,0,1,0,72.95
臺中縣,太平市,東平里,520,1,1062,30,1092,1504,3,1,3,0,1,0,72.61
臺中縣,太平市,東平里,521,1,1160,25,1185,1718,3,1,3,0,1,0,68.98
臺中縣,太平市,東平里,522,1,1157,21,1178,1581,3,1,3,0,1,0,74.51
臺中縣,太平市,建國里,523,1,894,25,919,1392,3,1,3,0,1,0,66.02
臺中縣,太平市,建國里,524,1,989,15,1004,1374,3,1,3,0,1,0,73.07
臺中縣,太平市,建國里,525,1,912,19,931,1307,3,1,3,0,1,0,71.23
臺中縣,太平市,坪林里,526,1,1154,25,1179,1720,3,1,3,0,1,0,68.55
臺中縣,太平市,坪林里,527,1,1284,18,1302,1752,3,1,3,0,1,0,74.32
臺中縣,太平市,坪林里,528,1,1200,17,1217,1563,3,1,3,0,1,0,77.86
臺中縣,太平市,坪林里,529,1,1128,24,1152,1590,3,1,3,0,1,0,72.45
臺中縣,太平市,光華里,530,1,1372,31,1403,1911,3,1,3,0,1,0,73.42
臺中縣,太平市,光華里,531,1,1098,24,1122,1520,3,1,3,0,1,0,73.82
臺中縣,太平市,光華里,532,1,806,16,822,1190,3,1,3,0,1,0,69.08
臺中縣,太平市,光華里,533,1,1033,10,1043,1522,3,1,3,0,1,0,68.53
臺中縣,太平市,中山里,534,1,1017,22,1039,1474,3,1,3,0,1,0,70.49
臺中縣,太平市,中山里,535,1,851,18,869,1192,3,1,3,0,1,0,72.90
臺中縣,太平市,中山里,536,1,972,10,982,1358,3,1,3,0,1,0,72.31
臺中縣,太平市,中山里,537,1,1110,23,1133,1616,3,1,3,0,1,0,70.11
臺中縣,太平市,宜欣里,538,1,1063,30,1093,1627,3,1,3,0,1,0,67.18
臺中縣,太平市,宜欣里,539,1,1180,14,1194,1914,3,1,3,0,1,0,62.38
臺中縣,太平市,宜欣里,540,1,1077,17,1094,1699,3,1,3,0,1,0,64.39
臺中縣,太平市,宜欣里,541,1,1031,22,1053,1535,3,1,3,0,1,0,68.60
臺中縣,太平市,宜欣里,542,1,1028,18,1046,1612,3,1,3,0,1,0,64.89
臺中縣,太平市,宜欣里,543,1,856,11,867,1282,3,1,3,0,1,0,67.63
臺中縣,太平市,新坪里,544,1,1046,17,1063,1639,3,1,3,0,1,0,64.86
臺中縣,太平市,新坪里,545,1,1045,23,1068,1661,3,1,3,0,1,0,64.30
臺中縣,太平市,新坪里,546,1,1199,23,1222,2291,3,1,3,0,1,0,53.34
臺中縣,太平市,新坪里,547,1,1279,30,1309,1939,3,1,3,0,1,0,67.51
臺中縣,太平市,新光里,548,1,913,23,936,1377,3,1,3,0,1,0,67.97
臺中縣,太平市,新光里,549,1,1324,29,1353,1976,3,1,3,0,1,0,68.47
臺中縣,太平市,新光里,550,1,826,11,837,1197,3,1,3,0,1,0,69.92
臺中縣,太平市,新光里,551,1,1095,18,1113,1786,3,1,3,0,1,0,62.32
臺中縣,太平市,新福里,552,1,1087,24,1111,1522,3,1,3,0,1,0,73.00
臺中縣,太平市,新福里,553,1,889,19,908,1384,3,1,3,0,1,0,65.61
臺中縣,太平市,頭汴里,554,1,781,12,793,1098,3,1,3,0,1,0,72.22
臺中縣,太平市,頭汴里,555,1,897,13,910,1257,3,1,3,0,1,0,72.39
臺中縣,太平市,頭汴里,556,1,793,15,808,1106,3,1,3,0,1,0,73.06
臺中縣,太平市,東汴里,557,1,916,21,937,1271,3,1,3,0,1,0,73.72
臺中縣,太平市,興隆里,558,1,1051,18,1069,1432,3,1,3,0,1,0,74.65
臺中縣,太平市,興隆里,559,1,1123,33,1156,1605,3,1,3,0,1,0,72.02
臺中縣,太平市,興隆里,560,1,1138,22,1160,1603,3,1,3,0,1,0,72.36
臺中縣,太平市,黃竹里,561,1,719,7,726,921,3,1,3,0,1,0,78.83
臺中縣,太平市,光隆里,562,1,1026,26,1052,1430,3,1,3,0,1,0,73.57
臺中縣,太平市,光隆里,563,1,994,10,1004,1390,3,1,3,0,1,0,72.23
臺中縣,太平市,光隆里,564,1,874,17,891,1181,3,1,3,0,1,0,75.44
臺中縣,太平市,德隆里,565,1,976,15,991,1420,3,1,3,0,1,0,69.79
臺中縣,太平市,德隆里,566,1,928,15,943,1327,3,1,3,0,1,0,71.06
臺中縣,大里市,大里里,567,1,997,15,1012,1318,3,1,3,0,1,0,76.78
臺中縣,大里市,大里里,568,1,856,10,866,1102,3,1,3,0,1,0,78.58
臺中縣,大里市,新里里,569,1,1076,11,1087,1501,3,1,3,0,1,0,72.42
臺中縣,大里市,新里里,570,1,1051,12,1063,1558,3,1,3,0,1,0,68.23
臺中縣,大里市,新里里,571,1,822,13,835,1122,3,1,3,0,1,0,74.42
臺中縣,大里市,新里里,572,1,1167,26,1193,1708,3,1,3,0,1,0,69.85
臺中縣,大里市,樹王里,573,1,947,15,962,1219,3,1,3,0,1,0,78.92
臺中縣,大里市,樹王里,574,1,868,21,889,1205,3,1,3,0,1,0,73.78
臺中縣,大里市,祥興里,575,1,1263,15,1278,1967,3,1,3,0,1,0,64.97
臺中縣,大里市,祥興里,576,1,748,11,759,1222,3,1,3,0,1,0,62.11
臺中縣,大里市,祥興里,577,1,720,5,725,1134,3,1,3,0,1,0,63.93
臺中縣,大里市,祥興里,578,1,621,18,639,850,3,1,3,0,1,0,75.18
臺中縣,大里市,內新里,579,1,1198,20,1218,1776,3,1,3,0,1,0,68.58
臺中縣,大里市,內新里,580,1,1201,23,1224,1808,3,1,3,0,1,0,67.70
臺中縣,大里市,內新里,581,1,970,12,982,1417,3,1,3,0,1,0,69.30
臺中縣,大里市,內新里,582,1,1327,14,1341,2019,3,1,3,0,1,0,66.42
臺中縣,大里市,東昇里,583,1,904,22,926,1231,3,1,3,0,1,0,75.22
臺中縣,大里市,東昇里,584,1,904,8,912,1273,3,1,3,0,1,0,71.64
臺中縣,大里市,大元里,585,1,1098,15,1113,1609,3,1,3,0,1,0,69.17
臺中縣,大里市,大元里,586,1,794,9,803,1148,3,1,3,0,1,0,69.95
臺中縣,大里市,西湖里,587,1,983,22,1005,1292,3,1,3,0,1,0,77.79
臺中縣,大里市,夏田里,588,1,747,3,750,898,3,1,3,0,1,0,83.52
臺中縣,大里市,仁化里,589,1,1260,11,1271,1791,3,1,3,0,1,0,70.97
臺中縣,大里市,仁化里,590,1,1426,21,1447,2039,3,1,3,0,1,0,70.97
臺中縣,大里市,仁化里,591,1,1040,17,1057,1636,3,1,3,0,1,0,64.61
臺中縣,大里市,仁化里,592,1,1229,20,1249,1767,3,1,3,0,1,0,70.68
臺中縣,大里市,健民里,593,1,547,12,559,726,3,1,3,0,1,0,77.00
臺中縣,大里市,健民里,594,1,1373,22,1395,1859,3,1,3,0,1,0,75.04
臺中縣,大里市,健民里,595,1,464,6,470,624,3,1,3,0,1,0,75.32
臺中縣,大里市,塗城里,596,1,1095,12,1107,1591,3,1,3,0,1,0,69.58
臺中縣,大里市,塗城里,597,1,1165,25,1190,1751,3,1,3,0,1,0,67.96
臺中縣,大里市,塗城里,598,1,1229,25,1254,1891,3,1,3,0,1,0,66.31
臺中縣,大里市,東湖里,599,1,1161,16,1177,1929,3,1,3,0,1,0,61.02
臺中縣,大里市,東湖里,600,1,1074,22,1096,1605,3,1,3,0,1,0,68.29
臺中縣,大里市,東湖里,601,1,1197,10,1207,1720,3,1,3,0,1,0,70.17
臺中縣,大里市,東興里,602,1,445,15,460,644,3,1,3,0,1,0,71.43
臺中縣,大里市,東興里,603,1,986,10,996,1560,3,1,3,0,1,0,63.85
臺中縣,大里市,東興里,604,1,895,11,906,1283,3,1,3,0,1,0,70.62
臺中縣,大里市,東興里,605,1,984,12,996,1452,3,1,3,0,1,0,68.60
臺中縣,大里市,東興里,606,1,923,22,945,1394,3,1,3,0,1,0,67.79
臺中縣,大里市,東興里,607,1,592,7,599,924,3,1,3,0,1,0,64.83
臺中縣,大里市,日新里,608,1,936,23,959,1397,3,1,3,0,1,0,68.65
臺中縣,大里市,日新里,609,1,1012,24,1036,1419,3,1,3,0,1,0,73.01
臺中縣,大里市,西榮里,610,1,1231,20,1251,1792,3,1,3,0,1,0,69.81
臺中縣,大里市,西榮里,611,1,1292,22,1314,1968,3,1,3,0,1,0,66.77
臺中縣,大里市,西榮里,612,1,1197,27,1224,1885,3,1,3,0,1,0,64.93
臺中縣,大里市,西榮里,613,1,1204,17,1221,1878,3,1,3,0,1,0,65.02
臺中縣,大里市,西榮里,614,1,1312,16,1328,1937,3,1,3,0,1,0,68.56
臺中縣,大里市,金城里,615,1,1108,13,1121,1969,3,1,3,0,1,0,56.93
臺中縣,大里市,金城里,616,1,1070,14,1084,1728,3,1,3,0,1,0,62.73
臺中縣,大里市,金城里,617,1,1254,15,1269,1861,3,1,3,0,1,0,68.19
臺中縣,大里市,金城里,618,1,1268,12,1280,1830,3,1,3,0,1,0,69.95
臺中縣,大里市,立仁里,619,1,1039,24,1063,1641,3,1,3,0,1,0,64.78
臺中縣,大里市,立仁里,620,1,1128,26,1154,1773,3,1,3,0,1,0,65.09
臺中縣,大里市,立仁里,621,1,818,5,823,1323,3,1,3,0,1,0,62.21
臺中縣,大里市,立仁里,622,1,945,17,962,1478,3,1,3,0,1,0,65.09
臺中縣,大里市,新仁里,623,1,1134,19,1153,1697,3,1,3,0,1,0,67.94
臺中縣,大里市,新仁里,624,1,1008,14,1022,1553,3,1,3,0,1,0,65.81
臺中縣,大里市,新仁里,625,1,970,15,985,1547,3,1,3,0,1,0,63.67
臺中縣,大里市,瑞城里,626,1,1055,11,1066,1574,3,1,3,0,1,0,67.73
臺中縣,大里市,瑞城里,627,1,1070,13,1083,1583,3,1,3,0,1,0,68.41
臺中縣,大里市,瑞城里,628,1,1063,16,1079,1571,3,1,3,0,1,0,68.68
臺中縣,大里市,瑞城里,629,1,1074,18,1092,1769,3,1,3,0,1,0,61.73
臺中縣,和平鄉,南勢村,630,1,101,0,101,144,3,1,3,0,1,0,70.14
臺中縣,和平鄉,南勢村,631,1,521,10,531,695,3,1,3,0,1,0,76.40
臺中縣,和平鄉,南勢村,632,1,401,4,405,530,3,1,3,0,1,0,76.42
臺中縣,和平鄉,天輪村,633,1,295,11,306,450,3,1,3,0,1,0,68.00
臺中縣,和平鄉,博愛村,634,1,427,10,437,612,3,1,3,0,1,0,71.41
臺中縣,和平鄉,博愛村,635,1,336,4,340,481,3,1,3,0,1,0,70.69
臺中縣,和平鄉,自由村,636,1,56,0,56,84,3,1,3,0,1,0,66.67
臺中縣,和平鄉,自由村,637,1,84,3,87,130,3,1,3,0,1,0,66.92
臺中縣,和平鄉,自由村,638,1,206,2,208,270,3,1,3,0,1,0,77.04
臺中縣,和平鄉,達觀村,639,1,262,2,264,378,3,1,3,0,1,0,69.84
臺中縣,和平鄉,達觀村,640,1,57,2,59,94,3,1,3,0,1,0,62.77
臺中縣,和平鄉,中坑村,641,1,204,2,206,257,3,1,3,0,1,0,80.16
臺中縣,和平鄉,梨山村,642,1,122,2,124,212,3,1,3,0,1,0,58.49
臺中縣,和平鄉,梨山村,643,1,483,5,488,768,3,1,3,0,1,0,63.54
臺中縣,和平鄉,梨山村,644,1,155,3,158,260,3,1,3,0,1,0,60.77
臺中縣,和平鄉,梨山村,645,1,43,1,44,97,3,1,3,0,1,0,45.36
臺中縣,和平鄉,平等村,646,1,149,2,151,230,3,1,3,0,1,0,65.65
臺中縣,和平鄉,平等村,647,1,71,1,72,143,3,1,3,0,1,0,50.35
彰化縣,彰化市,桃源里,1,1,1050,16,1066,1381,3,1,3,0,1,0,77.19
彰化縣,彰化市,桃源里,2,1,889,12,901,1280,3,1,3,0,1,0,70.39
彰化縣,彰化市,卦山里,3,1,814,10,824,1104,3,1,3,0,1,0,74.64
彰化縣,彰化市,卦山里,4,1,753,18,771,1080,3,1,3,0,1,0,71.39
彰化縣,彰化市,東興里,5,1,1022,10,1032,1470,3,1,3,0,1,0,70.20
彰化縣,彰化市,華北里,6,1,1161,19,1180,1650,3,1,3,0,1,0,71.52
彰化縣,彰化市,華陽里,7,1,768,13,781,1112,3,1,3,0,1,0,70.23
彰化縣,彰化市,華陽里,8,1,778,19,797,1117,3,1,3,0,1,0,71.35
彰化縣,彰化市,建寶里,9,1,813,9,822,1160,3,1,3,0,1,0,70.86
彰化縣,彰化市,建寶里,10,1,828,19,847,1165,3,1,3,0,1,0,72.70
彰化縣,彰化市,光南里,11,1,897,10,907,1249,3,1,3,0,1,0,72.62
彰化縣,彰化市,介壽里,12,1,874,15,889,1196,3,1,3,0,1,0,74.33
彰化縣,彰化市,介壽里,13,1,492,4,496,705,3,1,3,0,1,0,70.35
彰化縣,彰化市,延平里,14,1,898,9,907,1320,3,1,3,0,1,0,68.71
彰化縣,彰化市,延平里,15,1,849,11,860,1285,3,1,3,0,1,0,66.93
彰化縣,彰化市,延平里,16,1,1052,13,1065,1536,3,1,3,0,1,0,69.34
彰化縣,彰化市,延和里,17,1,994,16,1010,1327,3,1,3,0,1,0,76.11
彰化縣,彰化市,延和里,18,1,1004,23,1027,1490,3,1,3,0,1,0,68.93
彰化縣,彰化市,南興里,19,1,1173,28,1201,1652,3,1,3,0,1,0,72.70
彰化縣,彰化市,南興里,20,1,1217,20,1237,1781,3,1,3,0,1,0,69.46
彰化縣,彰化市,南磘里,21,1,1228,22,1250,1833,3,1,3,0,1,0,68.19
彰化縣,彰化市,南磘里,22,1,941,17,958,1488,3,1,3,0,1,0,64.38
彰化縣,彰化市,南磘里,23,1,1324,24,1348,2020,3,1,3,0,1,0,66.73
彰化縣,彰化市,成功里,24,1,989,17,1006,1437,3,1,3,0,1,0,70.01
彰化縣,彰化市,大同里,25,1,906,12,918,1243,3,1,3,0,1,0,73.85
彰化縣,彰化市,永生里,26,1,1083,16,1099,1535,3,1,3,0,1,0,71.60
彰化縣,彰化市,福安里,27,1,808,10,818,1102,3,1,3,0,1,0,74.23
彰化縣,彰化市,西安里,28,1,877,6,883,1277,3,1,3,0,1,0,69.15
彰化縣,彰化市,西安里,29,1,782,7,789,1179,3,1,3,0,1,0,66.92
彰化縣,彰化市,彰安里,30,1,989,19,1008,1445,3,1,3,0,1,0,69.76
彰化縣,彰化市,彰安里,31,1,1026,10,1036,1493,3,1,3,0,1,0,69.39
彰化縣,彰化市,中央里,32,1,699,9,708,985,3,1,3,0,1,0,71.88
彰化縣,彰化市,富貴里,33,1,753,10,763,1091,3,1,3,0,1,0,69.94
彰化縣,彰化市,民權里,34,1,1023,11,1034,1347,3,1,3,0,1,0,76.76
彰化縣,彰化市,長樂里,35,1,959,11,970,1367,3,1,3,0,1,0,70.96
彰化縣,彰化市,萬壽里,36,1,763,11,774,1090,3,1,3,0,1,0,71.01
彰化縣,彰化市,西興里,37,1,1285,21,1306,1851,3,1,3,0,1,0,70.56
彰化縣,彰化市,平和里,38,1,902,14,916,1310,3,1,3,0,1,0,69.92
彰化縣,彰化市,平和里,39,1,1278,21,1299,1862,3,1,3,0,1,0,69.76
彰化縣,彰化市,平和里,40,1,1037,18,1055,1502,3,1,3,0,1,0,70.24
彰化縣,彰化市,平和里,41,1,971,18,989,1449,3,1,3,0,1,0,68.25
彰化縣,彰化市,平和里,42,1,1039,17,1056,1636,3,1,3,0,1,0,64.55
彰化縣,彰化市,莿桐里,43,1,1393,27,1420,1911,3,1,3,0,1,0,74.31
彰化縣,彰化市,南美里,44,1,1060,15,1075,1362,3,1,3,0,1,0,78.93
彰化縣,彰化市,南安里,45,1,1093,27,1120,1475,3,1,3,0,1,0,75.93
彰化縣,彰化市,東芳里,46,1,976,15,991,1276,3,1,3,0,1,0,77.66
彰化縣,彰化市,東芳里,47,1,898,18,916,1171,3,1,3,0,1,0,78.22
彰化縣,彰化市,磚磘里,48,1,719,11,730,1078,3,1,3,0,1,0,67.72
彰化縣,彰化市,磚磘里,49,1,988,17,1005,1248,3,1,3,0,1,0,80.53
彰化縣,彰化市,西勢里,50,1,709,14,723,1004,3,1,3,0,1,0,72.01
彰化縣,彰化市,西勢里,51,1,725,13,738,1040,3,1,3,0,1,0,70.96
彰化縣,彰化市,忠權里,52,1,1257,20,1277,1838,3,1,3,0,1,0,69.48
彰化縣,彰化市,忠孝里,53,1,800,36,836,1177,3,1,3,0,1,0,71.03
彰化縣,彰化市,五權里,54,1,754,7,761,1148,3,1,3,0,1,0,66.29
彰化縣,彰化市,五權里,55,1,882,7,889,1261,3,1,3,0,1,0,70.50
彰化縣,彰化市,新興里,56,1,1255,14,1269,1811,3,1,3,0,1,0,70.07
彰化縣,彰化市,新興里,57,1,1148,21,1169,1637,3,1,3,0,1,0,71.41
彰化縣,彰化市,新華里,58,1,680,10,690,958,3,1,3,0,1,0,72.03
彰化縣,彰化市,新華里,59,1,644,10,654,943,3,1,3,0,1,0,69.35
彰化縣,彰化市,興北里,60,1,956,12,968,1384,3,1,3,0,1,0,69.94
彰化縣,彰化市,信義里,61,1,726,13,739,1024,3,1,3,0,1,0,72.17
彰化縣,彰化市,民生里,62,1,992,12,1004,1387,3,1,3,0,1,0,72.39
彰化縣,彰化市,光復里,63,1,602,10,612,820,3,1,3,0,1,0,74.63
彰化縣,彰化市,永福里,64,1,768,15,783,1056,3,1,3,0,1,0,74.15
彰化縣,彰化市,光華里,65,1,676,8,684,947,3,1,3,0,1,0,72.23
彰化縣,彰化市,中正里,66,1,904,13,917,1230,3,1,3,0,1,0,74.55
彰化縣,彰化市,中山里,67,1,625,11,636,898,3,1,3,0,1,0,70.82
彰化縣,彰化市,龍山里,68,1,716,8,724,1050,3,1,3,0,1,0,68.95
彰化縣,彰化市,龍山里,69,1,791,15,806,1085,3,1,3,0,1,0,74.29
彰化縣,彰化市,文化里,70,1,995,19,1014,1429,3,1,3,0,1,0,70.96
彰化縣,彰化市,陽明里,71,1,684,9,693,906,3,1,3,0,1,0,76.49
彰化縣,彰化市,陽明里,72,1,732,9,741,1030,3,1,3,0,1,0,71.94
彰化縣,彰化市,萬安里,73,1,1098,12,1110,1484,3,1,3,0,1,0,74.80
彰化縣,彰化市,萬安里,74,1,1166,24,1190,1687,3,1,3,0,1,0,70.54
彰化縣,彰化市,下廍里,75,1,1182,22,1204,1588,3,1,3,0,1,0,75.82
彰化縣,彰化市,下廍里,76,1,1097,26,1123,1523,3,1,3,0,1,0,73.74
彰化縣,彰化市,茄苳里,77,1,574,15,589,750,3,1,3,0,1,0,78.53
彰化縣,彰化市,茄南里,78,1,1211,20,1231,1676,3,1,3,0,1,0,73.45
彰化縣,彰化市,寶廍里,79,1,777,20,797,1013,3,1,3,0,1,0,78.68
彰化縣,彰化市,古夷里,80,1,1370,24,1394,1816,3,1,3,0,1,0,76.76
彰化縣,彰化市,阿夷里,81,1,1128,30,1158,1464,3,1,3,0,1,0,79.10
彰化縣,彰化市,阿夷里,82,1,1157,32,1189,1523,3,1,3,0,1,0,78.07
彰化縣,彰化市,和調里,83,1,640,13,653,929,3,1,3,0,1,0,70.29
彰化縣,彰化市,和調里,84,1,805,8,813,1167,3,1,3,0,1,0,69.67
彰化縣,彰化市,復興里,85,1,1267,21,1288,1766,3,1,3,0,1,0,72.93
彰化縣,彰化市,復興里,86,1,1131,22,1153,1603,3,1,3,0,1,0,71.93
彰化縣,彰化市,中庄里,87,1,641,15,656,978,3,1,3,0,1,0,67.08
彰化縣,彰化市,中庄里,88,1,560,10,570,838,3,1,3,0,1,0,68.02
彰化縣,彰化市,國聖里,89,1,575,12,587,755,3,1,3,0,1,0,77.75
彰化縣,彰化市,國聖里,90,1,962,20,982,1302,3,1,3,0,1,0,75.42
彰化縣,彰化市,福山里,91,1,1136,21,1157,1595,3,1,3,0,1,0,72.54
彰化縣,彰化市,福山里,92,1,1045,14,1059,1532,3,1,3,0,1,0,69.13
彰化縣,彰化市,福山里,93,1,1163,28,1191,1732,3,1,3,0,1,0,68.76
彰化縣,彰化市,安溪里,94,1,569,11,580,800,3,1,3,0,1,0,72.50
彰化縣,彰化市,竹中里,95,1,1104,18,1122,1523,3,1,3,0,1,0,73.67
彰化縣,彰化市,三村里,96,1,733,7,740,928,3,1,3,0,1,0,79.74
彰化縣,彰化市,大竹里,97,1,796,20,816,1067,3,1,3,0,1,0,76.48
彰化縣,彰化市,大竹里,98,1,753,13,766,1086,3,1,3,0,1,0,70.53
彰化縣,彰化市,香山里,99,1,1471,24,1495,1907,3,1,3,0,1,0,78.40
彰化縣,彰化市,牛埔里,100,1,1035,20,1055,1379,3,1,3,0,1,0,76.50
彰化縣,彰化市,牛埔里,101,1,847,7,854,1142,3,1,3,0,1,0,74.78
彰化縣,彰化市,台鳳里,102,1,999,23,1022,1525,3,1,3,0,1,0,67.02
彰化縣,彰化市,台鳳里,103,1,670,23,693,1122,3,1,3,0,1,0,61.76
彰化縣,彰化市,田中里,104,1,592,8,600,749,3,1,3,0,1,0,80.11
彰化縣,彰化市,快官里,105,1,700,11,711,934,3,1,3,0,1,0,76.12
彰化縣,彰化市,竹巷里,106,1,561,7,568,711,3,1,3,0,1,0,79.89
彰化縣,彰化市,福田里,107,1,785,13,798,1039,3,1,3,0,1,0,76.80
彰化縣,彰化市,石牌里,108,1,795,11,806,1048,3,1,3,0,1,0,76.91
彰化縣,花壇鄉,花壇村,109,1,737,15,752,1050,3,1,3,0,1,0,71.62
彰化縣,花壇鄉,花壇村,110,1,1175,13,1188,1573,3,1,3,0,1,0,75.52
彰化縣,花壇鄉,金墩村,111,1,1144,12,1156,1470,3,1,3,0,1,0,78.64
彰化縣,花壇鄉,中庄村,112,1,579,10,589,801,3,1,3,0,1,0,73.53
彰化縣,花壇鄉,中庄村,113,1,863,16,879,1159,3,1,3,0,1,0,75.84
彰化縣,花壇鄉,劉厝村,114,1,825,12,837,984,3,1,3,0,1,0,85.06
彰化縣,花壇鄉,崙雅村,115,1,936,13,949,1195,3,1,3,0,1,0,79.41
彰化縣,花壇鄉,南口村,116,1,946,10,956,1285,3,1,3,0,1,0,74.40
彰化縣,花壇鄉,中口村,117,1,536,5,541,671,3,1,3,0,1,0,80.63
彰化縣,花壇鄉,北口村,118,1,1071,12,1083,1427,3,1,3,0,1,0,75.89
彰化縣,花壇鄉,長沙村,119,1,852,16,868,1176,3,1,3,0,1,0,73.81
彰化縣,花壇鄉,長沙村,120,1,1249,12,1261,1789,3,1,3,0,1,0,70.49
彰化縣,花壇鄉,文德村,121,1,708,16,724,956,3,1,3,0,1,0,75.73
彰化縣,花壇鄉,文德村,122,1,631,11,642,865,3,1,3,0,1,0,74.22
彰化縣,花壇鄉,白沙村,123,1,969,19,988,1330,3,1,3,0,1,0,74.29
彰化縣,花壇鄉,白沙村,124,1,898,18,916,1267,3,1,3,0,1,0,72.30
彰化縣,花壇鄉,岩竹村,125,1,885,14,899,1270,3,1,3,0,1,0,70.79
彰化縣,花壇鄉,橋頭村,126,1,1111,14,1125,1584,3,1,3,0,1,0,71.02
彰化縣,花壇鄉,橋頭村,127,1,733,11,744,985,3,1,3,0,1,0,75.53
彰化縣,花壇鄉,灣雅村,128,1,586,8,594,791,3,1,3,0,1,0,75.09
彰化縣,花壇鄉,灣東村,129,1,688,9,697,948,3,1,3,0,1,0,73.52
彰化縣,花壇鄉,三春村,130,1,1073,9,1082,1420,3,1,3,0,1,0,76.20
彰化縣,花壇鄉,永春村,131,1,703,5,708,994,3,1,3,0,1,0,71.23
彰化縣,花壇鄉,長春村,132,1,868,10,878,1268,3,1,3,0,1,0,69.24
彰化縣,芬園鄉,舊社村,133,1,1226,20,1246,1565,3,1,3,0,1,0,79.62
彰化縣,芬園鄉,大埔村,134,1,992,12,1004,1298,3,1,3,0,1,0,77.35
彰化縣,芬園鄉,竹林村,135,1,1165,23,1188,1466,3,1,3,0,1,0,81.04
彰化縣,芬園鄉,楓坑村,136,1,460,4,464,555,3,1,3,0,1,0,83.60
彰化縣,芬園鄉,社口村,137,1,606,5,611,768,3,1,3,0,1,0,79.56
彰化縣,芬園鄉,社口村,138,1,818,15,833,1131,3,1,3,0,1,0,73.65
彰化縣,芬園鄉,茄荖村,139,1,844,17,861,1168,3,1,3,0,1,0,73.72
彰化縣,芬園鄉,茄荖村,140,1,623,11,634,800,3,1,3,0,1,0,79.25
彰化縣,芬園鄉,嘉興村,141,1,1044,16,1060,1374,3,1,3,0,1,0,77.15
彰化縣,芬園鄉,芬園村,142,1,652,12,664,839,3,1,3,0,1,0,79.14
彰化縣,芬園鄉,進芬村,143,1,676,7,683,916,3,1,3,0,1,0,74.56
彰化縣,芬園鄉,縣庄村,144,1,751,10,761,957,3,1,3,0,1,0,79.52
彰化縣,芬園鄉,圳墘村,145,1,567,5,572,715,3,1,3,0,1,0,80.00
彰化縣,芬園鄉,溪頭村,146,1,1118,12,1130,1367,3,1,3,0,1,0,82.66
彰化縣,芬園鄉,同安村,147,1,910,8,918,1263,3,1,3,0,1,0,72.68
彰化縣,芬園鄉,中崙村,148,1,694,12,706,999,3,1,3,0,1,0,70.67
彰化縣,芬園鄉,大竹村,149,1,751,12,763,1032,3,1,3,0,1,0,73.93
彰化縣,鹿港鎮,大有里,150,1,726,9,735,1168,3,1,3,0,1,0,62.93
彰化縣,鹿港鎮,中興里,151,1,396,6,402,576,3,1,3,0,1,0,69.79
彰化縣,鹿港鎮,洛津里,152,1,729,4,733,1146,3,1,3,0,1,0,63.96
彰化縣,鹿港鎮,順興里,153,1,677,14,691,996,3,1,3,0,1,0,69.38
彰化縣,鹿港鎮,菜園里,154,1,653,7,660,1059,3,1,3,0,1,0,62.32
彰化縣,鹿港鎮,街尾里,155,1,1082,21,1103,1752,3,1,3,0,1,0,62.96
彰化縣,鹿港鎮,泰興里,156,1,838,6,844,1238,3,1,3,0,1,0,68.17
彰化縣,鹿港鎮,長興里,157,1,230,3,233,354,3,1,3,0,1,0,65.82
彰化縣,鹿港鎮,興化里,158,1,483,8,491,759,3,1,3,0,1,0,64.69
彰化縣,鹿港鎮,龍山里,159,1,543,8,551,858,3,1,3,0,1,0,64.22
彰化縣,鹿港鎮,景福里,160,1,822,10,832,1223,3,1,3,0,1,0,68.03
彰化縣,鹿港鎮,郭厝里,161,1,428,10,438,595,3,1,3,0,1,0,73.61
彰化縣,鹿港鎮,新宮里,162,1,683,10,693,1013,3,1,3,0,1,0,68.41
彰化縣,鹿港鎮,玉順里,163,1,822,11,833,1320,3,1,3,0,1,0,63.11
彰化縣,鹿港鎮,東石里,164,1,820,12,832,1269,3,1,3,0,1,0,65.56
彰化縣,鹿港鎮,東石里,165,1,876,4,880,1286,3,1,3,0,1,0,68.43
彰化縣,鹿港鎮,埔崙里,166,1,1289,16,1305,1928,3,1,3,0,1,0,67.69
彰化縣,鹿港鎮,埔崙里,167,1,1185,18,1203,1859,3,1,3,0,1,0,64.71
彰化縣,鹿港鎮,埔崙里,168,1,912,14,926,1513,3,1,3,0,1,0,61.20
彰化縣,鹿港鎮,頂厝里,169,1,778,13,791,1162,3,1,3,0,1,0,68.07
彰化縣,鹿港鎮,頂厝里,170,1,1133,20,1153,1654,3,1,3,0,1,0,69.71
彰化縣,鹿港鎮,頂厝里,171,1,823,12,835,1138,3,1,3,0,1,0,73.37
彰化縣,鹿港鎮,東崎里,172,1,1231,14,1245,1696,3,1,3,0,1,0,73.41
彰化縣,鹿港鎮,東崎里,173,1,772,13,785,1182,3,1,3,0,1,0,66.41
彰化縣,鹿港鎮,廖厝里,174,1,890,22,912,1214,3,1,3,0,1,0,75.12
彰化縣,鹿港鎮,廖厝里,175,1,969,7,976,1354,3,1,3,0,1,0,72.08
彰化縣,鹿港鎮,詔安里,176,1,964,11,975,1429,3,1,3,0,1,0,68.23
彰化縣,鹿港鎮,海埔里,177,1,894,16,910,1351,3,1,3,0,1,0,67.36
彰化縣,鹿港鎮,海埔里,178,1,693,14,707,1008,3,1,3,0,1,0,70.14
彰化縣,鹿港鎮,洋厝里,179,1,532,5,537,778,3,1,3,0,1,0,69.02
彰化縣,鹿港鎮,洋厝里,180,1,920,11,931,1341,3,1,3,0,1,0,69.43
彰化縣,鹿港鎮,草中里,181,1,872,11,883,1292,3,1,3,0,1,0,68.34
彰化縣,鹿港鎮,草中里,182,1,1011,19,1030,1388,3,1,3,0,1,0,74.21
彰化縣,鹿港鎮,山崙里,183,1,615,9,624,855,3,1,3,0,1,0,72.98
彰化縣,鹿港鎮,山崙里,184,1,1199,17,1216,1691,3,1,3,0,1,0,71.91
彰化縣,鹿港鎮,頭南里,185,1,1153,20,1173,1584,3,1,3,0,1,0,74.05
彰化縣,鹿港鎮,頭崙里,186,1,967,14,981,1224,3,1,3,0,1,0,80.15
彰化縣,鹿港鎮,頭崙里,187,1,566,10,576,702,3,1,3,0,1,0,82.05
彰化縣,鹿港鎮,頂番里,188,1,857,17,874,1264,3,1,3,0,1,0,69.15
彰化縣,鹿港鎮,頂番里,189,1,1065,20,1085,1456,3,1,3,0,1,0,74.52
彰化縣,鹿港鎮,溝墘里,190,1,811,10,821,1075,3,1,3,0,1,0,76.37
彰化縣,鹿港鎮,溝墘里,191,1,674,19,693,1018,3,1,3,0,1,0,68.07
彰化縣,鹿港鎮,溝墘里,192,1,538,11,549,698,3,1,3,0,1,0,78.65
彰化縣,福興鄉,番婆村,193,1,597,14,611,903,3,1,3,0,1,0,67.66
彰化縣,福興鄉,番婆村,194,1,572,10,582,845,3,1,3,0,1,0,68.88
彰化縣,福興鄉,大崙村,195,1,751,13,764,1067,3,1,3,0,1,0,71.60
彰化縣,福興鄉,外埔村,196,1,655,12,667,906,3,1,3,0,1,0,73.62
彰化縣,福興鄉,三汴村,197,1,847,5,852,1133,3,1,3,0,1,0,75.20
彰化縣,福興鄉,萬豐村,198,1,449,5,454,615,3,1,3,0,1,0,73.82
彰化縣,福興鄉,外中村,199,1,836,10,846,1103,3,1,3,0,1,0,76.70
彰化縣,福興鄉,元中村,200,1,690,15,705,965,3,1,3,0,1,0,73.06
彰化縣,福興鄉,橋頭村,201,1,605,12,617,846,3,1,3,0,1,0,72.93
彰化縣,福興鄉,橋頭村,202,1,616,2,618,870,3,1,3,0,1,0,71.03
彰化縣,福興鄉,社尾村,203,1,739,17,756,1148,3,1,3,0,1,0,65.85
彰化縣,福興鄉,番社村,204,1,820,19,839,1167,3,1,3,0,1,0,71.89
彰化縣,福興鄉,同安村,205,1,667,10,677,898,3,1,3,0,1,0,75.39
彰化縣,福興鄉,同安村,206,1,480,9,489,801,3,1,3,0,1,0,61.05
彰化縣,福興鄉,西勢村,207,1,529,14,543,793,3,1,3,0,1,0,68.47
彰化縣,福興鄉,西勢村,208,1,376,9,385,646,3,1,3,0,1,0,59.60
彰化縣,福興鄉,秀厝村,209,1,489,9,498,737,3,1,3,0,1,0,67.57
彰化縣,福興鄉,秀厝村,210,1,653,10,663,940,3,1,3,0,1,0,70.53
彰化縣,福興鄉,鎮平村,211,1,684,14,698,1004,3,1,3,0,1,0,69.52
彰化縣,福興鄉,三和村,212,1,676,3,679,1024,3,1,3,0,1,0,66.31
彰化縣,福興鄉,麥厝村,213,1,636,8,644,934,3,1,3,0,1,0,68.95
彰化縣,福興鄉,麥厝村,214,1,591,12,603,950,3,1,3,0,1,0,63.47
彰化縣,福興鄉,廈粘村,215,1,558,8,566,739,3,1,3,0,1,0,76.59
彰化縣,福興鄉,廈粘村,216,1,587,12,599,829,3,1,3,0,1,0,72.26
彰化縣,福興鄉,頂粘村,217,1,632,14,646,832,3,1,3,0,1,0,77.64
彰化縣,福興鄉,頂粘村,218,1,732,9,741,945,3,1,3,0,1,0,78.41
彰化縣,福興鄉,福寶村,219,1,703,18,721,1014,3,1,3,0,1,0,71.10
彰化縣,福興鄉,二港村,220,1,798,14,812,1144,3,1,3,0,1,0,70.98
彰化縣,福興鄉,福興村,221,1,916,26,942,1316,3,1,3,0,1,0,71.58
彰化縣,福興鄉,福興村,222,1,691,11,702,1005,3,1,3,0,1,0,69.85
彰化縣,福興鄉,福南村,223,1,578,4,582,880,3,1,3,0,1,0,66.14
彰化縣,福興鄉,福南村,224,1,596,10,606,921,3,1,3,0,1,0,65.80
彰化縣,秀水鄉,秀水村,225,1,633,10,643,860,3,1,3,0,1,0,74.77
彰化縣,秀水鄉,秀水村,226,1,436,10,446,554,3,1,3,0,1,0,80.51
彰化縣,秀水鄉,安溪村,227,1,929,20,949,1272,3,1,3,0,1,0,74.61
彰化縣,秀水鄉,莊雅村,228,1,1220,25,1245,1687,3,1,3,0,1,0,73.80
彰化縣,秀水鄉,陝西村,229,1,824,13,837,1008,3,1,3,0,1,0,83.04
彰化縣,秀水鄉,金興村,230,1,572,9,581,723,3,1,3,0,1,0,80.36
彰化縣,秀水鄉,金興村,231,1,546,2,548,722,3,1,3,0,1,0,75.90
彰化縣,秀水鄉,安東村,232,1,807,6,813,1037,3,1,3,0,1,0,78.40
彰化縣,秀水鄉,安東村,233,1,532,15,547,708,3,1,3,0,1,0,77.26
彰化縣,秀水鄉,安東村,234,1,715,19,734,986,3,1,3,0,1,0,74.44
彰化縣,秀水鄉,鶴鳴村,235,1,952,12,964,1314,3,1,3,0,1,0,73.36
彰化縣,秀水鄉,鶴鳴村,236,1,689,11,700,918,3,1,3,0,1,0,76.25
彰化縣,秀水鄉,馬興村,237,1,681,17,698,905,3,1,3,0,1,0,77.13
彰化縣,秀水鄉,馬興村,238,1,551,9,560,719,3,1,3,0,1,0,77.89
彰化縣,秀水鄉,義興村,239,1,748,15,763,974,3,1,3,0,1,0,78.34
彰化縣,秀水鄉,福安村,240,1,915,18,933,1244,3,1,3,0,1,0,75.00
彰化縣,秀水鄉,福安村,241,1,1002,17,1019,1336,3,1,3,0,1,0,76.27
彰化縣,秀水鄉,埔崙村,242,1,383,6,389,521,3,1,3,0,1,0,74.66
彰化縣,秀水鄉,埔崙村,243,1,710,14,724,992,3,1,3,0,1,0,72.98
彰化縣,秀水鄉,曾厝村,244,1,896,18,914,1185,3,1,3,0,1,0,77.13
彰化縣,秀水鄉,金陵村,245,1,962,14,976,1240,3,1,3,0,1,0,78.71
彰化縣,秀水鄉,下崙村,246,1,870,11,881,1065,3,1,3,0,1,0,82.72
彰化縣,秀水鄉,下崙村,247,1,492,4,496,640,3,1,3,0,1,0,77.50
彰化縣,和美鎮,竹營里,248,1,1010,19,1029,1383,3,1,3,0,1,0,74.40
彰化縣,和美鎮,竹營里,249,1,1136,16,1152,1512,3,1,3,0,1,0,76.19
彰化縣,和美鎮,和東里,250,1,1124,25,1149,1506,3,1,3,0,1,0,76.29
彰化縣,和美鎮,和東里,251,1,849,9,858,1270,3,1,3,0,1,0,67.56
彰化縣,和美鎮,和南里,252,1,392,1,393,474,3,1,3,0,1,0,82.91
彰化縣,和美鎮,和北里,253,1,917,21,938,1228,3,1,3,0,1,0,76.38
彰化縣,和美鎮,和西里,254,1,831,10,841,1180,3,1,3,0,1,0,71.27
彰化縣,和美鎮,和西里,255,1,1144,18,1162,1665,3,1,3,0,1,0,69.79
彰化縣,和美鎮,四張里,256,1,563,11,574,801,3,1,3,0,1,0,71.66
彰化縣,和美鎮,四張里,257,1,749,9,758,1078,3,1,3,0,1,0,70.32
彰化縣,和美鎮,頭前里,258,1,714,19,733,1006,3,1,3,0,1,0,72.86
彰化縣,和美鎮,還社里,259,1,561,9,570,692,3,1,3,0,1,0,82.37
彰化縣,和美鎮,面前里,260,1,376,5,381,459,3,1,3,0,1,0,83.01
彰化縣,和美鎮,面前里,261,1,723,7,730,919,3,1,3,0,1,0,79.43
彰化縣,和美鎮,鎮平里,262,1,751,17,768,1024,3,1,3,0,1,0,75.00
彰化縣,和美鎮,鎮平里,263,1,707,10,717,955,3,1,3,0,1,0,75.08
彰化縣,和美鎮,大霞里,264,1,831,19,850,1060,3,1,3,0,1,0,80.19
彰化縣,和美鎮,源埤里,265,1,1060,29,1089,1397,3,1,3,0,1,0,77.95
彰化縣,和美鎮,南佃里,266,1,1014,25,1039,1311,3,1,3,0,1,0,79.25
彰化縣,和美鎮,雅溝里,267,1,935,18,953,1148,3,1,3,0,1,0,83.01
彰化縣,和美鎮,山犁里,268,1,1328,15,1343,1784,3,1,3,0,1,0,75.28
彰化縣,和美鎮,山犁里,269,1,1398,19,1417,1986,3,1,3,0,1,0,71.35
彰化縣,和美鎮,嘉犁里,270,1,926,20,946,1296,3,1,3,0,1,0,72.99
彰化縣,和美鎮,詔安里,271,1,896,13,909,1226,3,1,3,0,1,0,74.14
彰化縣,和美鎮,鐵山里,272,1,804,20,824,1062,3,1,3,0,1,0,77.59
彰化縣,和美鎮,鐵山里,273,1,690,9,699,938,3,1,3,0,1,0,74.52
彰化縣,和美鎮,柑井里,274,1,903,23,926,1205,3,1,3,0,1,0,76.85
彰化縣,和美鎮,柑井里,275,1,893,11,904,1170,3,1,3,0,1,0,77.26
彰化縣,和美鎮,竹園里,276,1,554,7,561,674,3,1,3,0,1,0,83.23
彰化縣,和美鎮,新庄里,277,1,1425,42,1467,1927,3,1,3,0,1,0,76.13
彰化縣,和美鎮,犁盛里,278,1,710,12,722,946,3,1,3,0,1,0,76.32
彰化縣,和美鎮,犁盛里,279,1,741,13,754,941,3,1,3,0,1,0,80.13
彰化縣,和美鎮,中寮里,280,1,758,15,773,1050,3,1,3,0,1,0,73.62
彰化縣,和美鎮,中圍里,281,1,728,13,741,970,3,1,3,0,1,0,76.39
彰化縣,和美鎮,中圍里,282,1,863,21,884,1292,3,1,3,0,1,0,68.42
彰化縣,和美鎮,糖友里,283,1,827,19,846,1187,3,1,3,0,1,0,71.27
彰化縣,和美鎮,塗厝里,284,1,1169,21,1190,1550,3,1,3,0,1,0,76.77
彰化縣,和美鎮,地潭里,285,1,655,7,662,852,3,1,3,0,1,0,77.70
彰化縣,和美鎮,湖內里,286,1,896,8,904,1150,3,1,3,0,1,0,78.61
彰化縣,和美鎮,嘉寶里,287,1,1182,23,1205,1589,3,1,3,0,1,0,75.83
彰化縣,和美鎮,月眉里,288,1,1055,20,1075,1466,3,1,3,0,1,0,73.33
彰化縣,和美鎮,月眉里,289,1,818,15,833,1146,3,1,3,0,1,0,72.69
彰化縣,和美鎮,好修里,290,1,491,8,499,622,3,1,3,0,1,0,80.23
彰化縣,和美鎮,好修里,291,1,718,9,727,889,3,1,3,0,1,0,81.78
彰化縣,線西鄉,線西村,292,1,1286,15,1301,1698,3,1,3,0,1,0,76.62
彰化縣,線西鄉,頂庄村,293,1,809,10,819,1055,3,1,3,0,1,0,77.63
彰化縣,線西鄉,寓埔村,294,1,1139,12,1151,1593,3,1,3,0,1,0,72.25
彰化縣,線西鄉,塭仔村,295,1,832,8,840,1098,3,1,3,0,1,0,76.50
彰化縣,線西鄉,溝內村,296,1,653,16,669,909,3,1,3,0,1,0,73.60
彰化縣,線西鄉,下犁村,297,1,1085,18,1103,1475,3,1,3,0,1,0,74.78
彰化縣,線西鄉,頂犁村,298,1,1384,34,1418,1796,3,1,3,0,1,0,78.95
彰化縣,線西鄉,德興村,299,1,731,16,747,887,3,1,3,0,1,0,84.22
彰化縣,伸港鄉,新港村,300,1,1088,17,1105,1538,3,1,3,0,1,0,71.85
彰化縣,伸港鄉,新港村,301,1,1275,22,1297,1856,3,1,3,0,1,0,69.88
彰化縣,伸港鄉,什股村,302,1,966,14,980,1339,3,1,3,0,1,0,73.19
彰化縣,伸港鄉,大同村,303,1,811,12,823,1045,3,1,3,0,1,0,78.76
彰化縣,伸港鄉,海尾村,304,1,1070,17,1087,1405,3,1,3,0,1,0,77.37
彰化縣,伸港鄉,全興村,305,1,923,17,940,1217,3,1,3,0,1,0,77.24
彰化縣,伸港鄉,溪底村,306,1,1061,13,1074,1359,3,1,3,0,1,0,79.03
彰化縣,伸港鄉,定興村,307,1,1214,30,1244,1737,3,1,3,0,1,0,71.62
彰化縣,伸港鄉,泉州村,308,1,1008,12,1020,1325,3,1,3,0,1,0,76.98
彰化縣,伸港鄉,泉厝村,309,1,667,6,673,967,3,1,3,0,1,0,69.60
彰化縣,伸港鄉,曾家村,310,1,1007,13,1020,1393,3,1,3,0,1,0,73.22
彰化縣,伸港鄉,蚵寮村,311,1,790,14,804,1087,3,1,3,0,1,0,73.97
彰化縣,伸港鄉,埤墘村,312,1,460,4,464,619,3,1,3,0,1,0,74.96
彰化縣,伸港鄉,七嘉村,313,1,993,15,1008,1378,3,1,3,0,1,0,73.15
彰化縣,伸港鄉,汴頭村,314,1,1305,16,1321,1660,3,1,3,0,1,0,79.58
彰化縣,員林鎮,東和里,315,1,836,12,848,1134,3,1,3,0,1,0,74.78
彰化縣,員林鎮,民生里,316,1,699,9,708,1019,3,1,3,0,1,0,69.48
彰化縣,員林鎮,民生里,317,1,1012,16,1028,1482,3,1,3,0,1,0,69.37
彰化縣,員林鎮,中正里,318,1,1106,10,1116,1572,3,1,3,0,1,0,70.99
彰化縣,員林鎮,仁美里,319,1,784,8,792,1142,3,1,3,0,1,0,69.35
彰化縣,員林鎮,仁美里,320,1,1045,15,1060,1489,3,1,3,0,1,0,71.19
彰化縣,員林鎮,新興里,321,1,588,15,603,815,3,1,3,0,1,0,73.99
彰化縣,員林鎮,和平里,322,1,744,5,749,1081,3,1,3,0,1,0,69.29
彰化縣,員林鎮,和平里,323,1,962,16,978,1394,3,1,3,0,1,0,70.16
彰化縣,員林鎮,光明里,324,1,769,10,779,1012,3,1,3,0,1,0,76.98
彰化縣,員林鎮,中山里,325,1,559,2,561,786,3,1,3,0,1,0,71.37
彰化縣,員林鎮,黎明里,326,1,605,8,613,871,3,1,3,0,1,0,70.38
彰化縣,員林鎮,黎明里,327,1,605,13,618,858,3,1,3,0,1,0,72.03
彰化縣,員林鎮,惠來里,328,1,771,10,781,1144,3,1,3,0,1,0,68.27
彰化縣,員林鎮,惠來里,329,1,779,12,791,1226,3,1,3,0,1,0,64.52
彰化縣,員林鎮,惠來里,330,1,799,23,822,1189,3,1,3,0,1,0,69.13
彰化縣,員林鎮,三義里,331,1,689,6,695,1006,3,1,3,0,1,0,69.09
彰化縣,員林鎮,三義里,332,1,758,12,770,1151,3,1,3,0,1,0,66.90
彰化縣,員林鎮,新生里,333,1,690,18,708,968,3,1,3,0,1,0,73.14
彰化縣,員林鎮,新生里,334,1,1072,18,1090,1505,3,1,3,0,1,0,72.43
彰化縣,員林鎮,新生里,335,1,683,9,692,1007,3,1,3,0,1,0,68.72
彰化縣,員林鎮,南平里,336,1,1035,23,1058,1534,3,1,3,0,1,0,68.97
彰化縣,員林鎮,南平里,337,1,947,29,976,1348,3,1,3,0,1,0,72.40
彰化縣,員林鎮,南興里,338,1,963,21,984,1387,3,1,3,0,1,0,70.94
彰化縣,員林鎮,南興里,339,1,900,10,910,1259,3,1,3,0,1,0,72.28
彰化縣,員林鎮,南興里,340,1,874,11,885,1244,3,1,3,0,1,0,71.14
彰化縣,員林鎮,源潭里,341,1,1107,16,1123,1470,3,1,3,0,1,0,76.39
彰化縣,員林鎮,大埔里,342,1,1008,19,1027,1298,3,1,3,0,1,0,79.12
彰化縣,員林鎮,三條里,343,1,757,13,770,1087,3,1,3,0,1,0,70.84
彰化縣,員林鎮,三條里,344,1,670,9,679,975,3,1,3,0,1,0,69.64
彰化縣,員林鎮,三條里,345,1,846,17,863,1193,3,1,3,0,1,0,72.34
彰化縣,員林鎮,三條里,346,1,916,11,927,1310,3,1,3,0,1,0,70.76
彰化縣,員林鎮,三和里,347,1,869,6,875,1223,3,1,3,0,1,0,71.55
彰化縣,員林鎮,三和里,348,1,938,18,956,1342,3,1,3,0,1,0,71.24
彰化縣,員林鎮,三和里,349,1,1161,19,1180,1635,3,1,3,0,1,0,72.17
彰化縣,員林鎮,三橋里,350,1,794,9,803,1071,3,1,3,0,1,0,74.98
彰化縣,員林鎮,三橋里,351,1,754,13,767,1107,3,1,3,0,1,0,69.29
彰化縣,員林鎮,三愛里,352,1,609,5,614,878,3,1,3,0,1,0,69.93
彰化縣,員林鎮,三愛里,353,1,625,10,635,942,3,1,3,0,1,0,67.41
彰化縣,員林鎮,三信里,354,1,654,6,660,906,3,1,3,0,1,0,72.85
彰化縣,員林鎮,三信里,355,1,649,8,657,933,3,1,3,0,1,0,70.42
彰化縣,員林鎮,三多里,356,1,688,4,692,1010,3,1,3,0,1,0,68.51
彰化縣,員林鎮,三多里,357,1,443,6,449,665,3,1,3,0,1,0,67.52
彰化縣,員林鎮,中央里,358,1,968,16,984,1287,3,1,3,0,1,0,76.46
彰化縣,員林鎮,溝皂里,359,1,595,17,612,872,3,1,3,0,1,0,70.18
彰化縣,員林鎮,溝皂里,360,1,651,14,665,927,3,1,3,0,1,0,71.74
彰化縣,員林鎮,大饒里,361,1,798,21,819,1082,3,1,3,0,1,0,75.69
彰化縣,員林鎮,大饒里,362,1,665,14,679,953,3,1,3,0,1,0,71.25
彰化縣,員林鎮,大明里,363,1,1222,20,1242,1697,3,1,3,0,1,0,73.19
彰化縣,員林鎮,萬年里,364,1,1226,22,1248,1718,3,1,3,0,1,0,72.64
彰化縣,員林鎮,萬年里,365,1,647,12,659,934,3,1,3,0,1,0,70.56
彰化縣,員林鎮,崙雅里,366,1,760,12,772,999,3,1,3,0,1,0,77.28
彰化縣,員林鎮,崙雅里,367,1,744,7,751,1031,3,1,3,0,1,0,72.84
彰化縣,員林鎮,振興里,368,1,516,7,523,729,3,1,3,0,1,0,71.74
彰化縣,員林鎮,振興里,369,1,736,13,749,1035,3,1,3,0,1,0,72.37
彰化縣,員林鎮,林厝里,370,1,605,13,618,879,3,1,3,0,1,0,70.31
彰化縣,員林鎮,林厝里,371,1,734,16,750,1078,3,1,3,0,1,0,69.57
彰化縣,員林鎮,出水里,372,1,1023,19,1042,1616,3,1,3,0,1,0,64.48
彰化縣,員林鎮,湖水里,373,1,911,13,924,1261,3,1,3,0,1,0,73.28
彰化縣,員林鎮,大峰里,374,1,480,10,490,739,3,1,3,0,1,0,66.31
彰化縣,員林鎮,鎮興里,375,1,585,7,592,851,3,1,3,0,1,0,69.57
彰化縣,員林鎮,鎮興里,376,1,594,13,607,840,3,1,3,0,1,0,72.26
彰化縣,員林鎮,浮圳里,377,1,751,12,763,1021,3,1,3,0,1,0,74.73
彰化縣,員林鎮,浮圳里,378,1,543,6,549,799,3,1,3,0,1,0,68.71
彰化縣,員林鎮,西東里,379,1,984,18,1002,1384,3,1,3,0,1,0,72.40
彰化縣,員林鎮,南東里,380,1,1015,19,1034,1542,3,1,3,0,1,0,67.06
彰化縣,員林鎮,中東里,381,1,871,33,904,1262,3,1,3,0,1,0,71.63
彰化縣,員林鎮,東北里,382,1,653,21,674,849,3,1,3,0,1,0,79.39
彰化縣,員林鎮,東北里,383,1,684,11,695,868,3,1,3,0,1,0,80.07
彰化縣,大村鄉,大村村,384,1,1181,25,1206,1588,3,1,3,0,1,0,75.94
彰化縣,大村鄉,茄苳村,385,1,1150,26,1176,1498,3,1,3,0,1,0,78.50
彰化縣,大村鄉,田洋村,386,1,589,6,595,750,3,1,3,0,1,0,79.33
彰化縣,大村鄉,貢旗村,387,1,854,12,866,1155,3,1,3,0,1,0,74.98
彰化縣,大村鄉,加錫村,388,1,826,10,836,1128,3,1,3,0,1,0,74.11
彰化縣,大村鄉,大崙村,389,1,1083,18,1101,1431,3,1,3,0,1,0,76.94
彰化縣,大村鄉,新興村,390,1,750,12,762,1073,3,1,3,0,1,0,71.02
彰化縣,大村鄉,南勢村,391,1,755,12,767,983,3,1,3,0,1,0,78.03
彰化縣,大村鄉,擺塘村,392,1,1328,21,1349,1823,3,1,3,0,1,0,74.00
彰化縣,大村鄉,過溝村,393,1,1022,8,1030,1332,3,1,3,0,1,0,77.33
彰化縣,大村鄉,大橋村,394,1,1208,29,1237,1684,3,1,3,0,1,0,73.46
彰化縣,大村鄉,村上村,395,1,833,12,845,1063,3,1,3,0,1,0,79.49
彰化縣,大村鄉,美港村,396,1,977,11,988,1266,3,1,3,0,1,0,78.04
彰化縣,大村鄉,美港村,397,1,679,25,704,943,3,1,3,0,1,0,74.66
彰化縣,大村鄉,黃厝村,398,1,1081,19,1100,1441,3,1,3,0,1,0,76.34
彰化縣,大村鄉,福興村,399,1,1087,46,1133,1544,3,1,3,0,1,0,73.38
彰化縣,大村鄉,平和村,400,1,1361,24,1385,1761,3,1,3,0,1,0,78.65
彰化縣,永靖鄉,永東村,401,1,585,10,595,779,3,1,3,0,1,0,76.38
彰化縣,永靖鄉,永西村,402,1,928,18,946,1334,3,1,3,0,1,0,70.91
彰化縣,永靖鄉,永南村,403,1,1217,29,1246,1692,3,1,3,0,1,0,73.64
彰化縣,永靖鄉,永北村,404,1,1071,20,1091,1496,3,1,3,0,1,0,72.93
彰化縣,永靖鄉,港西村,405,1,1066,28,1094,1539,3,1,3,0,1,0,71.09
彰化縣,永靖鄉,五福村,406,1,817,20,837,1198,3,1,3,0,1,0,69.87
彰化縣,永靖鄉,湳港村,407,1,563,8,571,770,3,1,3,0,1,0,74.16
彰化縣,永靖鄉,新莊村,408,1,561,7,568,764,3,1,3,0,1,0,74.35
彰化縣,永靖鄉,瑚璉村,409,1,1268,25,1293,1755,3,1,3,0,1,0,73.68
彰化縣,永靖鄉,五汴村,410,1,855,11,866,1170,3,1,3,0,1,0,74.02
彰化縣,永靖鄉,浮圳村,411,1,674,10,684,955,3,1,3,0,1,0,71.62
彰化縣,永靖鄉,光雲村,412,1,904,18,922,1263,3,1,3,0,1,0,73.00
彰化縣,永靖鄉,東寧村,413,1,1032,19,1051,1428,3,1,3,0,1,0,73.60
彰化縣,永靖鄉,永興村,414,1,1024,18,1042,1353,3,1,3,0,1,0,77.01
彰化縣,永靖鄉,崙子村,415,1,746,16,762,1008,3,1,3,0,1,0,75.60
彰化縣,永靖鄉,獨鰲村,416,1,608,15,623,844,3,1,3,0,1,0,73.82
彰化縣,永靖鄉,敦厚村,417,1,438,9,447,592,3,1,3,0,1,0,75.51
彰化縣,永靖鄉,崙美村,418,1,505,21,526,680,3,1,3,0,1,0,77.35
彰化縣,永靖鄉,同安村,419,1,426,7,433,554,3,1,3,0,1,0,78.16
彰化縣,永靖鄉,同仁村,420,1,690,12,702,905,3,1,3,0,1,0,77.57
彰化縣,永靖鄉,湳墘村,421,1,576,18,594,801,3,1,3,0,1,0,74.16
彰化縣,永靖鄉,四芳村,422,1,504,9,513,688,3,1,3,0,1,0,74.56
彰化縣,永靖鄉,福興村,423,1,873,7,880,1121,3,1,3,0,1,0,78.50
彰化縣,永靖鄉,竹子村,424,1,942,15,957,1333,3,1,3,0,1,0,71.79
彰化縣,溪湖鎮,光平里,425,1,845,2,847,1177,3,1,3,0,1,0,71.96
彰化縣,溪湖鎮,平和里,426,1,554,3,557,747,3,1,3,0,1,0,74.56
彰化縣,溪湖鎮,太平里,427,1,816,12,828,1136,3,1,3,0,1,0,72.89
彰化縣,溪湖鎮,光華里,428,1,407,3,410,556,3,1,3,0,1,0,73.74
彰化縣,溪湖鎮,東寮里,429,1,865,17,882,1242,3,1,3,0,1,0,71.01
彰化縣,溪湖鎮,東寮里,430,1,885,13,898,1225,3,1,3,0,1,0,73.31
彰化縣,溪湖鎮,西寮里,431,1,1152,16,1168,1563,3,1,3,0,1,0,74.73
彰化縣,溪湖鎮,大突里,432,1,1204,25,1229,1671,3,1,3,0,1,0,73.55
彰化縣,溪湖鎮,北勢里,433,1,850,18,868,1191,3,1,3,0,1,0,72.88
彰化縣,溪湖鎮,汴頭里,434,1,1073,14,1087,1553,3,1,3,0,1,0,69.99
彰化縣,溪湖鎮,大竹里,435,1,761,6,767,1057,3,1,3,0,1,0,72.56
彰化縣,溪湖鎮,大竹里,436,1,799,14,813,1098,3,1,3,0,1,0,74.04
彰化縣,溪湖鎮,湖西里,437,1,1117,14,1131,1577,3,1,3,0,1,0,71.72
彰化縣,溪湖鎮,田中里,438,1,538,5,543,722,3,1,3,0,1,0,75.21
彰化縣,溪湖鎮,河東里,439,1,1038,24,1062,1454,3,1,3,0,1,0,73.04
彰化縣,溪湖鎮,中山里,440,1,854,13,867,1083,3,1,3,0,1,0,80.06
彰化縣,溪湖鎮,中山里,441,1,694,3,697,1016,3,1,3,0,1,0,68.60
彰化縣,溪湖鎮,中竹里,442,1,496,9,505,675,3,1,3,0,1,0,74.81
彰化縣,溪湖鎮,東溪里,443,1,748,13,761,1157,3,1,3,0,1,0,65.77
彰化縣,溪湖鎮,西溪里,444,1,918,14,932,1285,3,1,3,0,1,0,72.53
彰化縣,溪湖鎮,湖東里,445,1,1184,16,1200,1735,3,1,3,0,1,0,69.16
彰化縣,溪湖鎮,湖東里,446,1,918,15,933,1286,3,1,3,0,1,0,72.55
彰化縣,溪湖鎮,頂庄里,447,1,429,8,437,630,3,1,3,0,1,0,69.37
彰化縣,溪湖鎮,忠覺里,448,1,879,9,888,1084,3,1,3,0,1,0,81.92
彰化縣,溪湖鎮,湳底里,449,1,559,7,566,690,3,1,3,0,1,0,82.03
彰化縣,溪湖鎮,大庭里,450,1,835,16,851,1081,3,1,3,0,1,0,78.72
彰化縣,溪湖鎮,媽厝里,451,1,894,13,907,1289,3,1,3,0,1,0,70.36
彰化縣,溪湖鎮,西勢里,452,1,1133,11,1144,1600,3,1,3,0,1,0,71.50
彰化縣,溪湖鎮,番婆里,453,1,888,20,908,1397,3,1,3,0,1,0,65.00
彰化縣,埔鹽鄉,埔鹽村,454,1,990,26,1016,1338,3,1,3,0,1,0,75.93
彰化縣,埔鹽鄉,埔南村,455,1,963,12,975,1257,3,1,3,0,1,0,77.57
彰化縣,埔鹽鄉,廍子村,456,1,799,17,816,1052,3,1,3,0,1,0,77.57
彰化縣,埔鹽鄉,出水村,457,1,556,13,569,708,3,1,3,0,1,0,80.37
彰化縣,埔鹽鄉,南港村,458,1,1184,24,1208,1474,3,1,3,0,1,0,81.95
彰化縣,埔鹽鄉,打廉村,459,1,697,17,714,893,3,1,3,0,1,0,79.96
彰化縣,埔鹽鄉,豐澤村,460,1,853,15,868,1167,3,1,3,0,1,0,74.38
彰化縣,埔鹽鄉,崑崙村,461,1,735,12,747,957,3,1,3,0,1,0,78.06
彰化縣,埔鹽鄉,角樹村,462,1,527,7,534,634,3,1,3,0,1,0,84.23
彰化縣,埔鹽鄉,瓦磘村,463,1,747,9,756,966,3,1,3,0,1,0,78.26
彰化縣,埔鹽鄉,好修村,464,1,841,10,851,1087,3,1,3,0,1,0,78.29
彰化縣,埔鹽鄉,西湖村,465,1,1369,21,1390,1837,3,1,3,0,1,0,75.67
彰化縣,埔鹽鄉,大有村,466,1,943,16,959,1189,3,1,3,0,1,0,80.66
彰化縣,埔鹽鄉,新興村,467,1,282,2,284,367,3,1,3,0,1,0,77.38
彰化縣,埔鹽鄉,永平村,468,1,698,10,708,957,3,1,3,0,1,0,73.98
彰化縣,埔鹽鄉,永樂村,469,1,538,5,543,689,3,1,3,0,1,0,78.81
彰化縣,埔鹽鄉,石埤村,470,1,930,10,940,1248,3,1,3,0,1,0,75.32
彰化縣,埔鹽鄉,天盛村,471,1,632,12,644,816,3,1,3,0,1,0,78.92
彰化縣,埔鹽鄉,太平村,472,1,987,18,1005,1397,3,1,3,0,1,0,71.94
彰化縣,埔鹽鄉,新水村,473,1,892,11,903,1196,3,1,3,0,1,0,75.50
彰化縣,埔鹽鄉,三省村,474,1,939,11,950,1214,3,1,3,0,1,0,78.25
彰化縣,埔鹽鄉,南新村,475,1,906,10,916,1182,3,1,3,0,1,0,77.50
彰化縣,埔心鄉,東門村,476,1,813,16,829,1084,3,1,3,0,1,0,76.48
彰化縣,埔心鄉,東門村,477,1,815,7,822,1058,3,1,3,0,1,0,77.69
彰化縣,埔心鄉,埔心村,478,1,810,14,824,1114,3,1,3,0,1,0,73.97
彰化縣,埔心鄉,義民村,479,1,964,19,983,1285,3,1,3,0,1,0,76.50
彰化縣,埔心鄉,油車村,480,1,751,14,765,964,3,1,3,0,1,0,79.36
彰化縣,埔心鄉,瓦北村,481,1,1087,12,1099,1405,3,1,3,0,1,0,78.22
彰化縣,埔心鄉,瓦中村,482,1,1136,18,1154,1448,3,1,3,0,1,0,79.70
彰化縣,埔心鄉,瓦南村,483,1,944,15,959,1204,3,1,3,0,1,0,79.65
彰化縣,埔心鄉,經口村,484,1,920,8,928,1238,3,1,3,0,1,0,74.96
彰化縣,埔心鄉,太平村,485,1,1085,25,1110,1497,3,1,3,0,1,0,74.15
彰化縣,埔心鄉,大華村,486,1,443,8,451,598,3,1,3,0,1,0,75.42
彰化縣,埔心鄉,仁里村,487,1,638,12,650,894,3,1,3,0,1,0,72.71
彰化縣,埔心鄉,舊舘村,488,1,675,9,684,947,3,1,3,0,1,0,72.23
彰化縣,埔心鄉,南舘村,489,1,456,9,465,687,3,1,3,0,1,0,67.69
彰化縣,埔心鄉,新舘村,490,1,539,13,552,765,3,1,3,0,1,0,72.16
彰化縣,埔心鄉,芎蕉村,491,1,1020,17,1037,1526,3,1,3,0,1,0,67.96
彰化縣,埔心鄉,羅厝村,492,1,889,14,903,1271,3,1,3,0,1,0,71.05
彰化縣,埔心鄉,梧鳳村,493,1,667,5,672,851,3,1,3,0,1,0,78.97
彰化縣,埔心鄉,二重村,494,1,872,13,885,1102,3,1,3,0,1,0,80.31
彰化縣,埔心鄉,埤霞村,495,1,551,8,559,696,3,1,3,0,1,0,80.32
彰化縣,埔心鄉,埤腳村,496,1,652,8,660,833,3,1,3,0,1,0,79.23
彰化縣,田中鎮,香山里,497,1,594,9,603,864,3,1,3,0,1,0,69.79
彰化縣,田中鎮,碧峰里,498,1,669,30,699,1014,3,1,3,0,1,0,68.93
彰化縣,田中鎮,碧峰里,499,1,716,23,739,997,3,1,3,0,1,0,74.12
彰化縣,田中鎮,碧峰里,500,1,490,8,498,760,3,1,3,0,1,0,65.53
彰化縣,田中鎮,東源里,501,1,411,6,417,651,3,1,3,0,1,0,64.06
彰化縣,田中鎮,復興里,502,1,954,14,968,1368,3,1,3,0,1,0,70.76
彰化縣,田中鎮,平和里,503,1,929,21,950,1433,3,1,3,0,1,0,66.29
彰化縣,田中鎮,頂潭里,504,1,732,19,751,1043,3,1,3,0,1,0,72.00
彰化縣,田中鎮,中潭里,505,1,1063,14,1077,1561,3,1,3,0,1,0,68.99
彰化縣,田中鎮,龍潭里,506,1,468,7,475,673,3,1,3,0,1,0,70.58
彰化縣,田中鎮,北路里,507,1,994,15,1009,1488,3,1,3,0,1,0,67.81
彰化縣,田中鎮,北路里,508,1,604,7,611,819,3,1,3,0,1,0,74.60
彰化縣,田中鎮,西路里,509,1,629,7,636,890,3,1,3,0,1,0,71.46
彰化縣,田中鎮,西路里,510,1,673,18,691,970,3,1,3,0,1,0,71.24
彰化縣,田中鎮,東路里,511,1,786,13,799,1108,3,1,3,0,1,0,72.11
彰化縣,田中鎮,南路里,512,1,916,11,927,1314,3,1,3,0,1,0,70.55
彰化縣,田中鎮,中路里,513,1,599,6,605,930,3,1,3,0,1,0,65.05
彰化縣,田中鎮,中路里,514,1,732,10,742,1063,3,1,3,0,1,0,69.80
彰化縣,田中鎮,新庄里,515,1,1114,28,1142,1663,3,1,3,0,1,0,68.67
彰化縣,田中鎮,三安里,516,1,1067,33,1100,1559,3,1,3,0,1,0,70.56
彰化縣,田中鎮,大崙里,517,1,818,22,840,1165,3,1,3,0,1,0,72.10
彰化縣,田中鎮,沙崙里,518,1,938,22,960,1422,3,1,3,0,1,0,67.51
彰化縣,田中鎮,新民里,519,1,1056,23,1079,1495,3,1,3,0,1,0,72.17
彰化縣,田中鎮,新民里,520,1,728,17,745,1155,3,1,3,0,1,0,64.50
彰化縣,田中鎮,梅州里,521,1,890,18,908,1285,3,1,3,0,1,0,70.66
彰化縣,田中鎮,三民里,522,1,962,18,980,1353,3,1,3,0,1,0,72.43
彰化縣,田中鎮,三光里,523,1,636,8,644,876,3,1,3,0,1,0,73.52
彰化縣,田中鎮,大社里,524,1,499,9,508,729,3,1,3,0,1,0,69.68
彰化縣,社頭鄉,社頭村,525,1,745,12,757,1106,3,1,3,0,1,0,68.44
彰化縣,社頭鄉,社頭村,526,1,879,12,891,1270,3,1,3,0,1,0,70.16
彰化縣,社頭鄉,廣興村,527,1,754,10,764,993,3,1,3,0,1,0,76.94
彰化縣,社頭鄉,廣興村,528,1,724,20,744,999,3,1,3,0,1,0,74.47
彰化縣,社頭鄉,廣興村,529,1,660,18,678,907,3,1,3,0,1,0,74.75
彰化縣,社頭鄉,仁雅村,530,1,654,10,664,908,3,1,3,0,1,0,73.13
彰化縣,社頭鄉,仁雅村,531,1,821,16,837,1244,3,1,3,0,1,0,67.28
彰化縣,社頭鄉,崙雅村,532,1,476,15,491,700,3,1,3,0,1,0,70.14
彰化縣,社頭鄉,美雅村,533,1,691,11,702,927,3,1,3,0,1,0,75.73
彰化縣,社頭鄉,里仁村,534,1,727,13,740,995,3,1,3,0,1,0,74.37
彰化縣,社頭鄉,舊社村,535,1,881,11,892,1241,3,1,3,0,1,0,71.88
彰化縣,社頭鄉,松竹村,536,1,607,14,621,806,3,1,3,0,1,0,77.05
彰化縣,社頭鄉,東興村,537,1,783,13,796,1116,3,1,3,0,1,0,71.33
彰化縣,社頭鄉,廣福村,538,1,577,8,585,757,3,1,3,0,1,0,77.28
彰化縣,社頭鄉,橋頭村,539,1,1242,32,1274,1693,3,1,3,0,1,0,75.25
彰化縣,社頭鄉,湳底村,540,1,982,18,1000,1270,3,1,3,0,1,0,78.74
彰化縣,社頭鄉,新厝村,541,1,979,19,998,1322,3,1,3,0,1,0,75.49
彰化縣,社頭鄉,張厝村,542,1,749,14,763,990,3,1,3,0,1,0,77.07
彰化縣,社頭鄉,埤斗村,543,1,767,12,779,945,3,1,3,0,1,0,82.43
彰化縣,社頭鄉,清水村,544,1,734,12,746,965,3,1,3,0,1,0,77.31
彰化縣,社頭鄉,山湖村,545,1,665,11,676,863,3,1,3,0,1,0,78.33
彰化縣,社頭鄉,朝興村,546,1,634,10,644,883,3,1,3,0,1,0,72.93
彰化縣,社頭鄉,仁和村,547,1,459,14,473,605,3,1,3,0,1,0,78.18
彰化縣,社頭鄉,泰安村,548,1,589,12,601,757,3,1,3,0,1,0,79.39
彰化縣,社頭鄉,平和村,549,1,592,15,607,774,3,1,3,0,1,0,78.42
彰化縣,社頭鄉,龍井村,550,1,567,4,571,733,3,1,3,0,1,0,77.90
彰化縣,社頭鄉,湳雅村,551,1,912,15,927,1243,3,1,3,0,1,0,74.58
彰化縣,社頭鄉,協和村,552,1,1156,27,1183,1683,3,1,3,0,1,0,70.29
彰化縣,二水鄉,復興村,553,1,742,15,757,1047,3,1,3,0,1,0,72.30
彰化縣,二水鄉,十五村,554,1,471,7,478,710,3,1,3,0,1,0,67.32
彰化縣,二水鄉,合和村,555,1,596,13,609,836,3,1,3,0,1,0,72.85
彰化縣,二水鄉,上豐村,556,1,717,13,730,1016,3,1,3,0,1,0,71.85
彰化縣,二水鄉,過圳村,557,1,496,9,505,682,3,1,3,0,1,0,74.05
彰化縣,二水鄉,五伯村,558,1,548,8,556,742,3,1,3,0,1,0,74.93
彰化縣,二水鄉,光化村,559,1,677,18,695,932,3,1,3,0,1,0,74.57
彰化縣,二水鄉,文化村,560,1,656,11,667,886,3,1,3,0,1,0,75.28
彰化縣,二水鄉,二水村,561,1,612,9,621,843,3,1,3,0,1,0,73.67
彰化縣,二水鄉,聖化村,562,1,411,1,412,553,3,1,3,0,1,0,74.50
彰化縣,二水鄉,裕民村,563,1,635,9,644,878,3,1,3,0,1,0,73.35
彰化縣,二水鄉,惠民村,564,1,642,11,653,909,3,1,3,0,1,0,71.84
彰化縣,二水鄉,大園村,565,1,512,11,523,681,3,1,3,0,1,0,76.80
彰化縣,二水鄉,修仁村,566,1,592,9,601,800,3,1,3,0,1,0,75.13
彰化縣,二水鄉,合興村,567,1,594,7,601,856,3,1,3,0,1,0,70.21
彰化縣,二水鄉,源泉村,568,1,481,15,496,661,3,1,3,0,1,0,75.04
彰化縣,二水鄉,倡和村,569,1,483,11,494,653,3,1,3,0,1,0,75.65
彰化縣,北斗鎮,中寮里,570,1,782,15,797,1100,3,1,3,0,1,0,72.45
彰化縣,北斗鎮,中寮里,571,1,729,17,746,1036,3,1,3,0,1,0,72.01
彰化縣,北斗鎮,大道里,572,1,1121,15,1136,1537,3,1,3,0,1,0,73.91
彰化縣,北斗鎮,西德里,573,1,662,15,677,927,3,1,3,0,1,0,73.03
彰化縣,北斗鎮,西德里,574,1,760,5,765,1040,3,1,3,0,1,0,73.56
彰化縣,北斗鎮,西德里,575,1,864,16,880,1223,3,1,3,0,1,0,71.95
彰化縣,北斗鎮,西安里,576,1,1008,19,1027,1461,3,1,3,0,1,0,70.29
彰化縣,北斗鎮,光復里,577,1,808,18,826,1191,3,1,3,0,1,0,69.35
彰化縣,北斗鎮,新政里,578,1,602,4,606,820,3,1,3,0,1,0,73.90
彰化縣,北斗鎮,重慶里,579,1,476,11,487,701,3,1,3,0,1,0,69.47
彰化縣,北斗鎮,五權里,580,1,581,6,587,802,3,1,3,0,1,0,73.19
彰化縣,北斗鎮,七星里,581,1,923,5,928,1317,3,1,3,0,1,0,70.46
彰化縣,北斗鎮,居仁里,582,1,958,12,970,1315,3,1,3,0,1,0,73.76
彰化縣,北斗鎮,東光里,583,1,970,21,991,1392,3,1,3,0,1,0,71.19
彰化縣,北斗鎮,文昌里,584,1,1196,30,1226,1722,3,1,3,0,1,0,71.20
彰化縣,北斗鎮,中和里,585,1,737,11,748,1007,3,1,3,0,1,0,74.28
彰化縣,北斗鎮,新生里,586,1,1076,28,1104,1520,3,1,3,0,1,0,72.63
彰化縣,北斗鎮,大新里,587,1,783,18,801,1217,3,1,3,0,1,0,65.82
彰化縣,溪州鄉,溪厝村,588,1,465,11,476,687,3,1,3,0,1,0,69.29
彰化縣,溪州鄉,溪厝村,589,1,627,41,668,1035,3,1,3,0,1,0,64.54
彰化縣,溪州鄉,坑厝村,590,1,414,9,423,626,3,1,3,0,1,0,67.57
彰化縣,溪州鄉,瓦厝村,591,1,656,10,666,955,3,1,3,0,1,0,69.74
彰化縣,溪州鄉,溪州村,592,1,567,3,570,747,3,1,3,0,1,0,76.31
彰化縣,溪州鄉,溪州村,593,1,576,10,586,850,3,1,3,0,1,0,68.94
彰化縣,溪州鄉,尾厝村,594,1,840,14,854,1151,3,1,3,0,1,0,74.20
彰化縣,溪州鄉,東州村,595,1,556,8,564,815,3,1,3,0,1,0,69.20
彰化縣,溪州鄉,東州村,596,1,589,10,599,880,3,1,3,0,1,0,68.07
彰化縣,溪州鄉,舊眉村,597,1,833,8,841,1159,3,1,3,0,1,0,72.56
彰化縣,溪州鄉,圳寮村,598,1,891,8,899,1336,3,1,3,0,1,0,67.29
彰化縣,溪州鄉,西畔村,599,1,691,14,705,1045,3,1,3,0,1,0,67.46
彰化縣,溪州鄉,西畔村,600,1,569,12,581,887,3,1,3,0,1,0,65.50
彰化縣,溪州鄉,成功村,601,1,536,8,544,878,3,1,3,0,1,0,61.96
彰化縣,溪州鄉,成功村,602,1,531,8,539,820,3,1,3,0,1,0,65.73
彰化縣,溪州鄉,大庄村,603,1,658,14,672,936,3,1,3,0,1,0,71.79
彰化縣,溪州鄉,大庄村,604,1,590,10,600,943,3,1,3,0,1,0,63.63
彰化縣,溪州鄉,榮光村,605,1,546,14,560,787,3,1,3,0,1,0,71.16
彰化縣,溪州鄉,柑園村,606,1,727,14,741,1037,3,1,3,0,1,0,71.46
彰化縣,溪州鄉,潮洋村,607,1,582,14,596,951,3,1,3,0,1,0,62.67
彰化縣,溪州鄉,張厝村,608,1,459,7,466,726,3,1,3,0,1,0,64.19
彰化縣,溪州鄉,菜公村,609,1,570,8,578,863,3,1,3,0,1,0,66.98
彰化縣,溪州鄉,三圳村,610,1,776,21,797,1160,3,1,3,0,1,0,68.71
彰化縣,溪州鄉,三條村,611,1,618,17,635,871,3,1,3,0,1,0,72.90
彰化縣,溪州鄉,水尾村,612,1,787,32,819,1150,3,1,3,0,1,0,71.22
彰化縣,田尾鄉,田尾村,613,1,786,14,800,1160,3,1,3,0,1,0,68.97
彰化縣,田尾鄉,豐田村,614,1,414,3,417,582,3,1,3,0,1,0,71.65
彰化縣,田尾鄉,饒平村,615,1,1168,22,1190,1557,3,1,3,0,1,0,76.43
彰化縣,田尾鄉,北曾村,616,1,754,14,768,1026,3,1,3,0,1,0,74.85
彰化縣,田尾鄉,南曾村,617,1,816,17,833,1089,3,1,3,0,1,0,76.49
彰化縣,田尾鄉,睦宜村,618,1,684,14,698,965,3,1,3,0,1,0,72.33
彰化縣,田尾鄉,新生村,619,1,786,9,795,1045,3,1,3,0,1,0,76.08
彰化縣,田尾鄉,北鎮村,620,1,561,6,567,769,3,1,3,0,1,0,73.73
彰化縣,田尾鄉,南鎮村,621,1,441,11,452,618,3,1,3,0,1,0,73.14
彰化縣,田尾鄉,福田村,622,1,608,15,623,850,3,1,3,0,1,0,73.29
彰化縣,田尾鄉,新興村,623,1,708,6,714,937,3,1,3,0,1,0,76.20
彰化縣,田尾鄉,溪畔村,624,1,843,12,855,1121,3,1,3,0,1,0,76.27
彰化縣,田尾鄉,打簾村,625,1,1148,27,1175,1626,3,1,3,0,1,0,72.26
彰化縣,田尾鄉,柳鳳村,626,1,574,11,585,755,3,1,3,0,1,0,77.48
彰化縣,田尾鄉,陸豐村,627,1,601,7,608,824,3,1,3,0,1,0,73.79
彰化縣,田尾鄉,海豐村,628,1,1020,13,1033,1468,3,1,3,0,1,0,70.37
彰化縣,田尾鄉,仁里村,629,1,1050,17,1067,1438,3,1,3,0,1,0,74.20
彰化縣,田尾鄉,新厝村,630,1,226,4,230,324,3,1,3,0,1,0,70.99
彰化縣,田尾鄉,溪頂村,631,1,453,4,457,627,3,1,3,0,1,0,72.89
彰化縣,田尾鄉,正義村,632,1,436,5,441,602,3,1,3,0,1,0,73.26
彰化縣,埤頭鄉,和豐村,633,1,692,19,711,970,3,1,3,0,1,0,73.30
彰化縣,埤頭鄉,和豐村,634,1,764,22,786,1180,3,1,3,0,1,0,66.61
彰化縣,埤頭鄉,興農村,635,1,970,16,986,1389,3,1,3,0,1,0,70.99
彰化縣,埤頭鄉,埤頭村,636,1,1044,22,1066,1484,3,1,3,0,1,0,71.83
彰化縣,埤頭鄉,豐崙村,637,1,647,14,661,938,3,1,3,0,1,0,70.47
彰化縣,埤頭鄉,豐崙村,638,1,744,11,755,1017,3,1,3,0,1,0,74.24
彰化縣,埤頭鄉,崙子村,639,1,727,14,741,1087,3,1,3,0,1,0,68.17
彰化縣,埤頭鄉,永豐村,640,1,1006,32,1038,1442,3,1,3,0,1,0,71.98
彰化縣,埤頭鄉,合興村,641,1,979,18,997,1321,3,1,3,0,1,0,75.47
彰化縣,埤頭鄉,合興村,642,1,936,11,947,1339,3,1,3,0,1,0,70.72
彰化縣,埤頭鄉,平原村,643,1,1088,22,1110,1514,3,1,3,0,1,0,73.32
彰化縣,埤頭鄉,崙腳村,644,1,443,2,445,665,3,1,3,0,1,0,66.92
彰化縣,埤頭鄉,元埔村,645,1,411,6,417,606,3,1,3,0,1,0,68.81
彰化縣,埤頭鄉,芙朝村,646,1,1052,25,1077,1566,3,1,3,0,1,0,68.77
彰化縣,埤頭鄉,新庄村,647,1,808,17,825,1222,3,1,3,0,1,0,67.51
彰化縣,埤頭鄉,陸嘉村,648,1,555,7,562,818,3,1,3,0,1,0,68.70
彰化縣,埤頭鄉,竹圍村,649,1,507,17,524,751,3,1,3,0,1,0,69.77
彰化縣,埤頭鄉,中和村,650,1,817,14,831,1211,3,1,3,0,1,0,68.62
彰化縣,埤頭鄉,庄內村,651,1,596,12,608,930,3,1,3,0,1,0,65.38
彰化縣,埤頭鄉,大湖村,652,1,650,12,662,976,3,1,3,0,1,0,67.83
彰化縣,二林鎮,東和里,653,1,644,4,648,851,3,1,3,0,1,0,76.15
彰化縣,二林鎮,東和里,654,1,870,11,881,1254,3,1,3,0,1,0,70.26
彰化縣,二林鎮,南光里,655,1,846,15,861,1165,3,1,3,0,1,0,73.91
彰化縣,二林鎮,南光里,656,1,946,13,959,1345,3,1,3,0,1,0,71.30
彰化縣,二林鎮,西平里,657,1,987,11,998,1411,3,1,3,0,1,0,70.73
彰化縣,二林鎮,北平里,658,1,658,11,669,898,3,1,3,0,1,0,74.50
彰化縣,二林鎮,北平里,659,1,803,17,820,1192,3,1,3,0,1,0,68.79
彰化縣,二林鎮,中西里,660,1,1089,20,1109,1556,3,1,3,0,1,0,71.27
彰化縣,二林鎮,廣興里,661,1,976,13,989,1482,3,1,3,0,1,0,66.73
彰化縣,二林鎮,香田里,662,1,770,13,783,1195,3,1,3,0,1,0,65.52
彰化縣,二林鎮,外竹里,663,1,812,3,815,1097,3,1,3,0,1,0,74.29
彰化縣,二林鎮,興華里,664,1,645,13,658,1040,3,1,3,0,1,0,63.27
彰化縣,二林鎮,東興里,665,1,766,8,774,1123,3,1,3,0,1,0,68.92
彰化縣,二林鎮,後厝里,666,1,1265,19,1284,1954,3,1,3,0,1,0,65.71
彰化縣,二林鎮,豐田里,667,1,473,9,482,708,3,1,3,0,1,0,68.08
彰化縣,二林鎮,豐田里,668,1,870,10,880,1340,3,1,3,0,1,0,65.67
彰化縣,二林鎮,頂厝里,669,1,853,13,866,1249,3,1,3,0,1,0,69.34
彰化縣,二林鎮,趙甲里,670,1,1124,32,1156,1613,3,1,3,0,1,0,71.67
彰化縣,二林鎮,振興里,671,1,908,11,919,1204,3,1,3,0,1,0,76.33
彰化縣,二林鎮,萬興里,672,1,569,8,577,758,3,1,3,0,1,0,76.12
彰化縣,二林鎮,永興里,673,1,999,14,1013,1366,3,1,3,0,1,0,74.16
彰化縣,二林鎮,西庄里,674,1,793,13,806,1085,3,1,3,0,1,0,74.29
彰化縣,二林鎮,梅芳里,675,1,801,16,817,1018,3,1,3,0,1,0,80.26
彰化縣,二林鎮,華崙里,676,1,808,20,828,1078,3,1,3,0,1,0,76.81
彰化縣,二林鎮,華崙里,677,1,764,14,778,997,3,1,3,0,1,0,78.03
彰化縣,二林鎮,華崙里,678,1,927,16,943,1201,3,1,3,0,1,0,78.52
彰化縣,二林鎮,萬合里,679,1,918,8,926,1303,3,1,3,0,1,0,71.07
彰化縣,二林鎮,東勢里,680,1,721,16,737,999,3,1,3,0,1,0,73.77
彰化縣,二林鎮,大永里,681,1,608,6,614,869,3,1,3,0,1,0,70.66
彰化縣,二林鎮,原斗里,682,1,835,11,846,1174,3,1,3,0,1,0,72.06
彰化縣,二林鎮,西斗里,683,1,709,9,718,1013,3,1,3,0,1,0,70.88
彰化縣,二林鎮,東華里,684,1,732,6,738,974,3,1,3,0,1,0,75.77
彰化縣,二林鎮,復豐里,685,1,540,8,548,764,3,1,3,0,1,0,71.73
彰化縣,芳苑鄉,芳苑村,686,1,664,15,679,1113,3,1,3,0,1,0,61.01
彰化縣,芳苑鄉,芳中村,687,1,341,5,346,605,3,1,3,0,1,0,57.19
彰化縣,芳苑鄉,仁愛村,688,1,604,8,612,968,3,1,3,0,1,0,63.22
彰化縣,芳苑鄉,信義村,689,1,364,5,369,716,3,1,3,0,1,0,51.54
彰化縣,芳苑鄉,後寮村,690,1,568,8,576,881,3,1,3,0,1,0,65.38
彰化縣,芳苑鄉,三合村,691,1,1119,25,1144,1595,3,1,3,0,1,0,71.72
彰化縣,芳苑鄉,永興村,692,1,883,3,886,1458,3,1,3,0,1,0,60.77
彰化縣,芳苑鄉,新街村,693,1,681,16,697,1143,3,1,3,0,1,0,60.98
彰化縣,芳苑鄉,路上村,694,1,455,6,461,796,3,1,3,0,1,0,57.91
彰化縣,芳苑鄉,路平村,695,1,535,8,543,787,3,1,3,0,1,0,69.00
彰化縣,芳苑鄉,三成村,696,1,680,11,691,1008,3,1,3,0,1,0,68.55
彰化縣,芳苑鄉,福榮村,697,1,443,5,448,736,3,1,3,0,1,0,60.87
彰化縣,芳苑鄉,頂廍村,698,1,434,7,441,701,3,1,3,0,1,0,62.91
彰化縣,芳苑鄉,博愛村,699,1,555,6,561,824,3,1,3,0,1,0,68.08
彰化縣,芳苑鄉,和平村,700,1,486,2,488,832,3,1,3,0,1,0,58.65
彰化縣,芳苑鄉,興仁村,701,1,728,20,748,1330,3,1,3,0,1,0,56.24
彰化縣,芳苑鄉,民生村,702,1,471,6,477,766,3,1,3,0,1,0,62.27
彰化縣,芳苑鄉,新寶村,703,1,873,8,881,1327,3,1,3,0,1,0,66.39
彰化縣,芳苑鄉,五俊村,704,1,329,8,337,638,3,1,3,0,1,0,52.82
彰化縣,芳苑鄉,草湖村,705,1,855,13,868,1304,3,1,3,0,1,0,66.56
彰化縣,芳苑鄉,建平村,706,1,679,12,691,955,3,1,3,0,1,0,72.36
彰化縣,芳苑鄉,建平村,707,1,681,9,690,971,3,1,3,0,1,0,71.06
彰化縣,芳苑鄉,崙腳村,708,1,524,7,531,727,3,1,3,0,1,0,73.04
彰化縣,芳苑鄉,文津村,709,1,672,10,682,980,3,1,3,0,1,0,69.59
彰化縣,芳苑鄉,新生村,710,1,820,17,837,1310,3,1,3,0,1,0,63.89
彰化縣,芳苑鄉,漢寶村,711,1,893,17,910,1345,3,1,3,0,1,0,67.66
彰化縣,芳苑鄉,漢寶村,712,1,738,14,752,1179,3,1,3,0,1,0,63.78
彰化縣,芳苑鄉,王功村,713,1,633,16,649,1059,3,1,3,0,1,0,61.28
彰化縣,芳苑鄉,王功村,714,1,553,10,563,923,3,1,3,0,1,0,61.00
彰化縣,大城鄉,潭墘村,715,1,882,24,906,1454,3,1,3,0,1,0,62.31
彰化縣,大城鄉,山腳村,716,1,804,22,826,1414,3,1,3,0,1,0,58.42
彰化縣,大城鄉,西城村,717,1,515,8,523,851,3,1,3,0,1,0,61.46
彰化縣,大城鄉,東城村,718,1,833,12,845,1244,3,1,3,0,1,0,67.93
彰化縣,大城鄉,大城村,719,1,717,13,730,1052,3,1,3,0,1,0,69.39
彰化縣,大城鄉,上山村,720,1,392,6,398,638,3,1,3,0,1,0,62.38
彰化縣,大城鄉,上山村,721,1,350,4,354,513,3,1,3,0,1,0,69.01
彰化縣,大城鄉,永和村,722,1,456,12,468,784,3,1,3,0,1,0,59.69
彰化縣,大城鄉,公館村,723,1,291,2,293,474,3,1,3,0,1,0,61.81
彰化縣,大城鄉,公館村,724,1,465,10,475,753,3,1,3,0,1,0,63.08
彰化縣,大城鄉,豐美村,725,1,525,4,529,860,3,1,3,0,1,0,61.51
彰化縣,大城鄉,三豐村,726,1,411,5,416,763,3,1,3,0,1,0,54.52
彰化縣,大城鄉,菜寮村,727,1,739,17,756,1185,3,1,3,0,1,0,63.80
彰化縣,大城鄉,東港村,728,1,732,12,744,1301,3,1,3,0,1,0,57.19
彰化縣,大城鄉,西港村,729,1,629,8,637,1081,3,1,3,0,1,0,58.93
彰化縣,大城鄉,頂庄村,730,1,477,4,481,859,3,1,3,0,1,0,56.00
彰化縣,大城鄉,台西村,731,1,591,10,601,1040,3,1,3,0,1,0,57.79
彰化縣,竹塘鄉,竹元村,732,1,638,6,644,999,3,1,3,0,1,0,64.46
彰化縣,竹塘鄉,竹塘村,733,1,1136,14,1150,1527,3,1,3,0,1,0,75.31
彰化縣,竹塘鄉,小西村,734,1,562,4,566,836,3,1,3,0,1,0,67.70
彰化縣,竹塘鄉,民靖村,735,1,564,7,571,816,3,1,3,0,1,0,69.98
彰化縣,竹塘鄉,五庄村,736,1,953,18,971,1426,3,1,3,0,1,0,68.09
彰化縣,竹塘鄉,樹腳村,737,1,410,7,417,631,3,1,3,0,1,0,66.09
彰化縣,竹塘鄉,田頭村,738,1,623,7,630,930,3,1,3,0,1,0,67.74
彰化縣,竹塘鄉,新廣村,739,1,854,10,864,1214,3,1,3,0,1,0,71.17
彰化縣,竹塘鄉,溪墘村,740,1,426,5,431,583,3,1,3,0,1,0,73.93
彰化縣,竹塘鄉,竹林村,741,1,611,13,624,894,3,1,3,0,1,0,69.80
彰化縣,竹塘鄉,土庫村,742,1,517,9,526,754,3,1,3,0,1,0,69.76
彰化縣,竹塘鄉,內新村,743,1,462,1,463,661,3,1,3,0,1,0,70.05
彰化縣,竹塘鄉,長安村,744,1,531,5,536,787,3,1,3,0,1,0,68.11
彰化縣,竹塘鄉,永安村,745,1,486,4,490,739,3,1,3,0,1,0,66.31
南投縣,南投市,龍泉里,1,1,648,4,652,986,3,1,3,0,1,0,66.13
南投縣,南投市,康壽里,2,1,829,9,838,1297,3,1,3,0,1,0,64.61
南投縣,南投市,三民里,3,1,494,7,501,769,3,1,3,0,1,0,65.15
南投縣,南投市,仁和里,4,1,417,2,419,578,3,1,3,0,1,0,72.49
南投縣,南投市,南投里,5,1,501,10,511,739,3,1,3,0,1,0,69.15
南投縣,南投市,彰仁里,6,1,277,6,283,439,3,1,3,0,1,0,64.46
南投縣,南投市,崇文里,7,1,697,8,705,1069,3,1,3,0,1,0,65.95
南投縣,南投市,三興里,8,1,670,10,680,1143,3,1,3,0,1,0,59.49
南投縣,南投市,三興里,9,1,532,7,539,872,3,1,3,0,1,0,61.81
南投縣,南投市,三興里,10,1,996,15,1011,1581,3,1,3,0,1,0,63.95
南投縣,南投市,三和里,11,1,771,8,779,1279,3,1,3,0,1,0,60.91
南投縣,南投市,三和里,12,1,972,13,985,1478,3,1,3,0,1,0,66.64
南投縣,南投市,嘉興里,13,1,928,27,955,1527,3,1,3,0,1,0,62.54
南投縣,南投市,嘉和里,14,1,927,9,936,1418,3,1,3,0,1,0,66.01
南投縣,南投市,嘉和里,15,1,550,11,561,841,3,1,3,0,1,0,66.71
南投縣,南投市,平和里,16,1,1053,11,1064,1657,3,1,3,0,1,0,64.21
南投縣,南投市,平和里,17,1,1071,10,1081,1615,3,1,3,0,1,0,66.93
南投縣,南投市,平和里,18,1,954,6,960,1471,3,1,3,0,1,0,65.26
南投縣,南投市,振興里,19,1,330,10,340,534,3,1,3,0,1,0,63.67
南投縣,南投市,振興里,20,1,926,10,936,1432,3,1,3,0,1,0,65.36
南投縣,南投市,千秋里,21,1,521,4,525,815,3,1,3,0,1,0,64.42
南投縣,南投市,軍功里,22,1,1073,8,1081,1558,3,1,3,0,1,0,69.38
南投縣,南投市,軍功里,23,1,896,18,914,1464,3,1,3,0,1,0,62.43
南投縣,南投市,軍功里,24,1,259,3,262,312,3,1,3,0,1,0,83.97
南投縣,南投市,東山里,25,1,286,7,293,467,3,1,3,0,1,0,62.74
南投縣,南投市,營南里,26,1,642,12,654,995,3,1,3,0,1,0,65.73
南投縣,南投市,營南里,27,1,595,4,599,824,3,1,3,0,1,0,72.69
南投縣,南投市,營北里,28,1,1043,6,1049,1467,3,1,3,0,1,0,71.51
南投縣,南投市,營北里,29,1,945,6,951,1343,3,1,3,0,1,0,70.81
南投縣,南投市,營北里,30,1,916,14,930,1318,3,1,3,0,1,0,70.56
南投縣,南投市,內興里,31,1,1161,11,1172,1756,3,1,3,0,1,0,66.74
南投縣,南投市,內興里,32,1,1030,12,1042,1584,3,1,3,0,1,0,65.78
南投縣,南投市,內興里,33,1,343,7,350,481,3,1,3,0,1,0,72.77
南投縣,南投市,內新里,34,1,893,8,901,1250,3,1,3,0,1,0,72.08
南投縣,南投市,光輝里,35,1,448,5,453,618,3,1,3,0,1,0,73.30
南投縣,南投市,光榮里,36,1,602,16,618,894,3,1,3,0,1,0,69.13
南投縣,南投市,光榮里,37,1,805,4,809,1185,3,1,3,0,1,0,68.27
南投縣,南投市,光明里,38,1,817,6,823,1123,3,1,3,0,1,0,73.29
南投縣,南投市,光明里,39,1,847,12,859,1192,3,1,3,0,1,0,72.06
南投縣,南投市,光華里,40,1,569,8,577,814,3,1,3,0,1,0,70.88
南投縣,南投市,光華里,41,1,704,8,712,924,3,1,3,0,1,0,77.06
南投縣,南投市,漳興里,42,1,612,7,619,935,3,1,3,0,1,0,66.20
南投縣,南投市,漳興里,43,1,737,6,743,1100,3,1,3,0,1,0,67.55
南投縣,南投市,漳和里,44,1,668,10,678,1031,3,1,3,0,1,0,65.76
南投縣,南投市,漳和里,45,1,710,7,717,1183,3,1,3,0,1,0,60.61
南投縣,南投市,漳和里,46,1,830,9,839,1248,3,1,3,0,1,0,67.23
南投縣,南投市,漳和里,47,1,939,15,954,1575,3,1,3,0,1,0,60.57
南投縣,南投市,平山里,48,1,836,12,848,1470,3,1,3,0,1,0,57.69
南投縣,南投市,平山里,49,1,1082,12,1094,1775,3,1,3,0,1,0,61.63
南投縣,南投市,新興里,50,1,621,8,629,952,3,1,3,0,1,0,66.07
南投縣,南投市,新興里,51,1,1018,13,1031,1578,3,1,3,0,1,0,65.34
南投縣,南投市,永豐里,52,1,671,10,681,1116,3,1,3,0,1,0,61.02
南投縣,南投市,永豐里,53,1,504,25,529,886,3,1,3,0,1,0,59.71
南投縣,南投市,福興里,54,1,649,18,667,1066,3,1,3,0,1,0,62.57
南投縣,南投市,福興里,55,1,743,6,749,1270,3,1,3,0,1,0,58.98
南投縣,南投市,鳳山里,56,1,716,11,727,1244,3,1,3,0,1,0,58.44
南投縣,南投市,永興里,57,1,491,7,498,736,3,1,3,0,1,0,67.66
南投縣,南投市,鳳鳴里,58,1,507,10,517,787,3,1,3,0,1,0,65.69
南投縣,南投市,福山里,59,1,998,16,1014,1511,3,1,3,0,1,0,67.11
南投縣,埔里鎮,東門里,60,1,614,5,619,979,3,1,3,0,1,0,63.23
南投縣,埔里鎮,東門里,61,1,730,4,734,1123,3,1,3,0,1,0,65.36
南投縣,埔里鎮,東門里,62,1,613,12,625,966,3,1,3,0,1,0,64.70
南投縣,埔里鎮,西門里,63,1,425,1,426,706,3,1,3,0,1,0,60.34
南投縣,埔里鎮,西門里,64,1,682,10,692,1145,3,1,3,0,1,0,60.44
南投縣,埔里鎮,西門里,65,1,818,2,820,1331,3,1,3,0,1,0,61.61
南投縣,埔里鎮,南門里,66,1,668,1,669,983,3,1,3,0,1,0,68.06
南投縣,埔里鎮,北門里,67,1,678,6,684,1067,3,1,3,0,1,0,64.10
南投縣,埔里鎮,北門里,68,1,811,5,816,1344,3,1,3,0,1,0,60.71
南投縣,埔里鎮,北安里,69,1,956,4,960,1474,3,1,3,0,1,0,65.13
南投縣,埔里鎮,北安里,70,1,921,7,928,1412,3,1,3,0,1,0,65.72
南投縣,埔里鎮,泰安里,71,1,995,8,1003,1632,3,1,3,0,1,0,61.46
南投縣,埔里鎮,北梅里,72,1,552,3,555,836,3,1,3,0,1,0,66.39
南投縣,埔里鎮,北梅里,73,1,556,5,561,891,3,1,3,0,1,0,62.96
南投縣,埔里鎮,同聲里,74,1,712,19,731,1091,3,1,3,0,1,0,67.00
南投縣,埔里鎮,同聲里,75,1,676,15,691,1068,3,1,3,0,1,0,64.70
南投縣,埔里鎮,清新里,76,1,662,6,668,1102,3,1,3,0,1,0,60.62
南投縣,埔里鎮,清新里,77,1,653,10,663,1010,3,1,3,0,1,0,65.64
南投縣,埔里鎮,清新里,78,1,810,8,818,1366,3,1,3,0,1,0,59.88
南投縣,埔里鎮,薰化里,79,1,933,13,946,1378,3,1,3,0,1,0,68.65
南投縣,埔里鎮,大城里,80,1,803,9,812,1309,3,1,3,0,1,0,62.03
南投縣,埔里鎮,大城里,81,1,773,14,787,1179,3,1,3,0,1,0,66.75
南投縣,埔里鎮,大城里,82,1,746,8,754,1184,3,1,3,0,1,0,63.68
南投縣,埔里鎮,大城里,83,1,823,10,833,1362,3,1,3,0,1,0,61.16
南投縣,埔里鎮,籃城里,84,1,534,1,535,746,3,1,3,0,1,0,71.72
南投縣,埔里鎮,杷城里,85,1,740,11,751,1016,3,1,3,0,1,0,73.92
南投縣,埔里鎮,杷城里,86,1,755,6,761,1038,3,1,3,0,1,0,73.31
南投縣,埔里鎮,枇杷里,87,1,749,9,758,1190,3,1,3,0,1,0,63.70
南投縣,埔里鎮,枇杷里,88,1,504,4,508,834,3,1,3,0,1,0,60.91
南投縣,埔里鎮,枇杷里,89,1,825,11,836,1327,3,1,3,0,1,0,63.00
南投縣,埔里鎮,枇杷里,90,1,801,7,808,1295,3,1,3,0,1,0,62.39
南投縣,埔里鎮,水頭里,91,1,900,16,916,1493,3,1,3,0,1,0,61.35
南投縣,埔里鎮,水頭里,92,1,632,5,637,1039,3,1,3,0,1,0,61.31
南投縣,埔里鎮,麒麟里,93,1,593,8,601,916,3,1,3,0,1,0,65.61
南投縣,埔里鎮,珠格里,94,1,619,8,627,910,3,1,3,0,1,0,68.90
南投縣,埔里鎮,溪南里,95,1,454,6,460,707,3,1,3,0,1,0,65.06
南投縣,埔里鎮,桃米里,96,1,540,5,545,945,3,1,3,0,1,0,57.67
南投縣,埔里鎮,成功里,97,1,202,1,203,371,3,1,3,0,1,0,54.72
南投縣,埔里鎮,南村里,98,1,748,7,755,1197,3,1,3,0,1,0,63.07
南投縣,埔里鎮,愛蘭里,99,1,788,5,793,1200,3,1,3,0,1,0,66.08
南投縣,埔里鎮,鐵山里,100,1,951,11,962,1469,3,1,3,0,1,0,65.49
南投縣,埔里鎮,房里里,101,1,547,3,550,840,3,1,3,0,1,0,65.48
南投縣,埔里鎮,房里里,102,1,197,2,199,319,3,1,3,0,1,0,62.38
南投縣,埔里鎮,向善里,103,1,465,1,466,683,3,1,3,0,1,0,68.23
南投縣,埔里鎮,一新里,104,1,487,4,491,805,3,1,3,0,1,0,60.99
南投縣,埔里鎮,合成里,105,1,778,7,785,1229,3,1,3,0,1,0,63.87
南投縣,埔里鎮,合成里,106,1,154,1,155,266,3,1,3,0,1,0,58.27
南投縣,埔里鎮,廣成里,107,1,667,7,674,1125,3,1,3,0,1,0,59.91
南投縣,埔里鎮,史港里,108,1,402,0,402,640,3,1,3,0,1,0,62.81
南投縣,埔里鎮,福興里,109,1,599,4,603,941,3,1,3,0,1,0,64.08
南投縣,埔里鎮,牛眠里,110,1,696,3,699,1031,3,1,3,0,1,0,67.80
南投縣,埔里鎮,牛眠里,111,1,880,10,890,1331,3,1,3,0,1,0,66.87
南投縣,埔里鎮,大湳里,112,1,678,10,688,1069,3,1,3,0,1,0,64.36
南投縣,埔里鎮,蜈蚣里,113,1,598,8,606,920,3,1,3,0,1,0,65.87
南投縣,埔里鎮,蜈蚣里,114,1,561,11,572,887,3,1,3,0,1,0,64.49
南投縣,埔里鎮,蜈蚣里,115,1,364,2,366,623,3,1,3,0,1,0,58.75
南投縣,草屯鎮,玉峰里,116,1,1165,12,1177,1686,3,1,3,0,1,0,69.81
南投縣,草屯鎮,明正里,117,1,671,8,679,989,3,1,3,0,1,0,68.66
南投縣,草屯鎮,明正里,118,1,710,10,720,1065,3,1,3,0,1,0,67.61
南投縣,草屯鎮,明正里,119,1,656,4,660,976,3,1,3,0,1,0,67.62
南投縣,草屯鎮,炎峰里,120,1,698,6,704,956,3,1,3,0,1,0,73.64
南投縣,草屯鎮,炎峰里,121,1,677,4,681,946,3,1,3,0,1,0,71.99
南投縣,草屯鎮,中正里,122,1,524,4,528,728,3,1,3,0,1,0,72.53
南投縣,草屯鎮,和平里,123,1,1065,11,1076,1470,3,1,3,0,1,0,73.20
南投縣,草屯鎮,中山里,124,1,675,7,682,983,3,1,3,0,1,0,69.38
南投縣,草屯鎮,中山里,125,1,919,10,929,1306,3,1,3,0,1,0,71.13
南投縣,草屯鎮,敦和里,126,1,854,9,863,1217,3,1,3,0,1,0,70.91
南投縣,草屯鎮,敦和里,127,1,800,14,814,1197,3,1,3,0,1,0,68.00
南投縣,草屯鎮,敦和里,128,1,739,6,745,1108,3,1,3,0,1,0,67.24
南投縣,草屯鎮,敦和里,129,1,652,4,656,977,3,1,3,0,1,0,67.14
南投縣,草屯鎮,山腳里,130,1,962,18,980,1501,3,1,3,0,1,0,65.29
南投縣,草屯鎮,山腳里,131,1,1147,9,1156,1723,3,1,3,0,1,0,67.09
南投縣,草屯鎮,山腳里,132,1,1073,11,1084,1515,3,1,3,0,1,0,71.55
南投縣,草屯鎮,新厝里,133,1,948,7,955,1323,3,1,3,0,1,0,72.18
南投縣,草屯鎮,新厝里,134,1,886,7,893,1298,3,1,3,0,1,0,68.80
南投縣,草屯鎮,上林里,135,1,807,7,814,1128,3,1,3,0,1,0,72.16
南投縣,草屯鎮,上林里,136,1,611,3,614,895,3,1,3,0,1,0,68.60
南投縣,草屯鎮,碧峰里,137,1,952,13,965,1448,3,1,3,0,1,0,66.64
南投縣,草屯鎮,碧峰里,138,1,871,10,881,1358,3,1,3,0,1,0,64.87
南投縣,草屯鎮,碧洲里,139,1,623,7,630,866,3,1,3,0,1,0,72.75
南投縣,草屯鎮,碧洲里,140,1,383,6,389,586,3,1,3,0,1,0,66.38
南投縣,草屯鎮,復興里,141,1,873,10,883,1301,3,1,3,0,1,0,67.87
南投縣,草屯鎮,復興里,142,1,857,10,867,1336,3,1,3,0,1,0,64.90
南投縣,草屯鎮,御史里,143,1,958,7,965,1349,3,1,3,0,1,0,71.53
南投縣,草屯鎮,御史里,144,1,596,12,608,980,3,1,3,0,1,0,62.04
南投縣,草屯鎮,御史里,145,1,505,4,509,790,3,1,3,0,1,0,64.43
南投縣,草屯鎮,御史里,146,1,688,6,694,1056,3,1,3,0,1,0,65.72
南投縣,草屯鎮,新豐里,147,1,1006,8,1014,1457,3,1,3,0,1,0,69.60
南投縣,草屯鎮,新豐里,148,1,1046,11,1057,1587,3,1,3,0,1,0,66.60
南投縣,草屯鎮,新庄里,149,1,781,21,802,1227,3,1,3,0,1,0,65.36
南投縣,草屯鎮,新庄里,150,1,820,18,838,1216,3,1,3,0,1,0,68.91
南投縣,草屯鎮,加老里,151,1,1105,13,1118,1706,3,1,3,0,1,0,65.53
南投縣,草屯鎮,石川里,152,1,748,12,760,1052,3,1,3,0,1,0,72.24
南投縣,草屯鎮,北投里,153,1,863,15,878,1201,3,1,3,0,1,0,73.11
南投縣,草屯鎮,北投里,154,1,500,13,513,809,3,1,3,0,1,0,63.41
南投縣,草屯鎮,富寮里,155,1,742,6,748,1103,3,1,3,0,1,0,67.82
南投縣,草屯鎮,富寮里,156,1,826,8,834,1317,3,1,3,0,1,0,63.33
南投縣,草屯鎮,富寮里,157,1,374,2,376,511,3,1,3,0,1,0,73.58
南投縣,草屯鎮,富寮里,158,1,444,6,450,671,3,1,3,0,1,0,67.06
南投縣,草屯鎮,北勢里,159,1,880,8,888,1269,3,1,3,0,1,0,69.98
南投縣,草屯鎮,北勢里,160,1,342,2,344,524,3,1,3,0,1,0,65.65
南投縣,草屯鎮,中原里,161,1,647,4,651,909,3,1,3,0,1,0,71.62
南投縣,草屯鎮,中原里,162,1,516,7,523,775,3,1,3,0,1,0,67.48
南投縣,草屯鎮,南埔里,163,1,1101,10,1111,1642,3,1,3,0,1,0,67.66
南投縣,草屯鎮,南埔里,164,1,730,8,738,1107,3,1,3,0,1,0,66.67
南投縣,草屯鎮,坪頂里,165,1,674,7,681,976,3,1,3,0,1,0,69.77
南投縣,草屯鎮,土城里,166,1,954,16,970,1523,3,1,3,0,1,0,63.69
南投縣,草屯鎮,平林里,167,1,635,5,640,935,3,1,3,0,1,0,68.45
南投縣,草屯鎮,雙冬里,168,1,649,8,657,1086,3,1,3,0,1,0,60.50
南投縣,草屯鎮,雙冬里,169,1,737,15,752,1183,3,1,3,0,1,0,63.57
南投縣,竹山鎮,竹山里,170,1,760,9,769,1258,3,1,3,0,1,0,61.13
南投縣,竹山鎮,竹山里,171,1,654,5,659,1051,3,1,3,0,1,0,62.70
南投縣,竹山鎮,中正里,172,1,452,5,457,777,3,1,3,0,1,0,58.82
南投縣,竹山鎮,中山里,173,1,701,9,710,1134,3,1,3,0,1,0,62.61
南投縣,竹山鎮,中山里,174,1,832,8,840,1505,3,1,3,0,1,0,55.81
南投縣,竹山鎮,中山里,175,1,851,13,864,1573,3,1,3,0,1,0,54.93
南投縣,竹山鎮,雲林里,176,1,924,5,929,1521,3,1,3,0,1,0,61.08
南投縣,竹山鎮,雲林里,177,1,867,13,880,1592,3,1,3,0,1,0,55.28
南投縣,竹山鎮,竹圍里,178,1,419,8,427,769,3,1,3,0,1,0,55.53
南投縣,竹山鎮,竹圍里,179,1,641,14,655,1181,3,1,3,0,1,0,55.46
南投縣,竹山鎮,桂林里,180,1,889,5,894,1584,3,1,3,0,1,0,56.44
南投縣,竹山鎮,桂林里,181,1,895,11,906,1587,3,1,3,0,1,0,57.09
南投縣,竹山鎮,下坪里,182,1,279,3,282,503,3,1,3,0,1,0,56.06
南投縣,竹山鎮,下坪里,183,1,207,3,210,377,3,1,3,0,1,0,55.70
南投縣,竹山鎮,中和里,184,1,606,2,608,947,3,1,3,0,1,0,64.20
南投縣,竹山鎮,中崎里,185,1,705,5,710,1170,3,1,3,0,1,0,60.68
南投縣,竹山鎮,秀林里,186,1,189,2,191,323,3,1,3,0,1,0,59.13
南投縣,竹山鎮,秀林里,187,1,159,0,159,264,3,1,3,0,1,0,60.23
南投縣,竹山鎮,秀林里,188,1,168,1,169,271,3,1,3,0,1,0,62.36
南投縣,竹山鎮,大鞍里,189,1,104,0,104,174,3,1,3,0,1,0,59.77
南投縣,竹山鎮,延和里,190,1,665,8,673,1246,3,1,3,0,1,0,54.01
南投縣,竹山鎮,延和里,191,1,662,9,671,1237,3,1,3,0,1,0,54.24
南投縣,竹山鎮,延和里,192,1,671,7,678,1122,3,1,3,0,1,0,60.43
南投縣,竹山鎮,延祥里,193,1,858,18,876,1480,3,1,3,0,1,0,59.19
南投縣,竹山鎮,延祥里,194,1,738,10,748,1286,3,1,3,0,1,0,58.16
南投縣,竹山鎮,延正里,195,1,361,9,370,645,3,1,3,0,1,0,57.36
南投縣,竹山鎮,延正里,196,1,556,7,563,951,3,1,3,0,1,0,59.20
南投縣,竹山鎮,延平里,197,1,623,8,631,1092,3,1,3,0,1,0,57.78
南投縣,竹山鎮,延平里,198,1,601,7,608,916,3,1,3,0,1,0,66.38
南投縣,竹山鎮,延平里,199,1,369,4,373,575,3,1,3,0,1,0,64.87
南投縣,竹山鎮,延山里,200,1,340,1,341,668,3,1,3,0,1,0,51.05
南投縣,竹山鎮,山崇里,201,1,660,6,666,1211,3,1,3,0,1,0,55.00
南投縣,竹山鎮,山崇里,202,1,379,2,381,712,3,1,3,0,1,0,53.51
南投縣,竹山鎮,社寮里,203,1,517,5,522,862,3,1,3,0,1,0,60.56
南投縣,竹山鎮,中央里,204,1,864,6,870,1500,3,1,3,0,1,0,58.00
南投縣,竹山鎮,富州里,205,1,420,8,428,749,3,1,3,0,1,0,57.14
南投縣,竹山鎮,田子里,206,1,232,2,234,468,3,1,3,0,1,0,50.00
南投縣,竹山鎮,田子里,207,1,134,2,136,219,3,1,3,0,1,0,62.10
南投縣,竹山鎮,硘磘里,208,1,649,11,660,1140,3,1,3,0,1,0,57.89
南投縣,竹山鎮,德興里,209,1,251,3,254,400,3,1,3,0,1,0,63.50
南投縣,竹山鎮,德興里,210,1,311,3,314,490,3,1,3,0,1,0,64.08
南投縣,竹山鎮,福興里,211,1,134,1,135,204,3,1,3,0,1,0,66.18
南投縣,竹山鎮,福興里,212,1,224,6,230,380,3,1,3,0,1,0,60.53
南投縣,竹山鎮,鯉魚里,213,1,318,5,323,597,3,1,3,0,1,0,54.10
南投縣,竹山鎮,鯉魚里,214,1,214,4,218,395,3,1,3,0,1,0,55.19
南投縣,竹山鎮,坪頂里,215,1,321,6,327,611,3,1,3,0,1,0,53.52
南投縣,竹山鎮,瑞竹里,216,1,451,6,457,821,3,1,3,0,1,0,55.66
南投縣,竹山鎮,桶頭里,217,1,296,7,303,623,3,1,3,0,1,0,48.64
南投縣,竹山鎮,桶頭里,218,1,233,5,238,454,3,1,3,0,1,0,52.42
南投縣,集集鎮,集集里,219,1,572,7,579,882,3,1,3,0,1,0,65.65
南投縣,集集鎮,和平里,220,1,545,13,558,1008,3,1,3,0,1,0,55.36
南投縣,集集鎮,林尾里,221,1,397,5,402,597,3,1,3,0,1,0,67.34
南投縣,集集鎮,田寮里,222,1,695,12,707,1162,3,1,3,0,1,0,60.84
南投縣,集集鎮,隘寮里,223,1,354,1,355,546,3,1,3,0,1,0,65.02
南投縣,集集鎮,玉映里,224,1,285,5,290,454,3,1,3,0,1,0,63.88
南投縣,集集鎮,吳厝里,225,1,589,7,596,929,3,1,3,0,1,0,64.16
南投縣,集集鎮,八張里,226,1,760,9,769,1261,3,1,3,0,1,0,60.98
南投縣,集集鎮,永昌里,227,1,538,10,548,818,3,1,3,0,1,0,66.99
南投縣,集集鎮,廣明里,228,1,315,4,319,541,3,1,3,0,1,0,58.96
南投縣,集集鎮,廣明里,229,1,238,3,241,405,3,1,3,0,1,0,59.51
南投縣,集集鎮,富山里,230,1,249,2,251,433,3,1,3,0,1,0,57.97
南投縣,名間鄉,南雅村,231,1,579,4,583,992,3,1,3,0,1,0,58.77
南投縣,名間鄉,中正村,232,1,731,11,742,1160,3,1,3,0,1,0,63.97
南投縣,名間鄉,中正村,233,1,816,13,829,1430,3,1,3,0,1,0,57.97
南投縣,名間鄉,中山村,234,1,398,4,402,688,3,1,3,0,1,0,58.43
南投縣,名間鄉,中山村,235,1,695,11,706,1100,3,1,3,0,1,0,64.18
南投縣,名間鄉,濁水村,236,1,956,10,966,1522,3,1,3,0,1,0,63.47
南投縣,名間鄉,新民村,237,1,635,8,643,999,3,1,3,0,1,0,64.36
南投縣,名間鄉,炭寮村,238,1,606,5,611,980,3,1,3,0,1,0,62.35
南投縣,名間鄉,新街村,239,1,849,9,858,1303,3,1,3,0,1,0,65.85
南投縣,名間鄉,新街村,240,1,993,18,1011,1699,3,1,3,0,1,0,59.51
南投縣,名間鄉,東湖村,241,1,471,14,485,777,3,1,3,0,1,0,62.42
南投縣,名間鄉,東湖村,242,1,481,6,487,788,3,1,3,0,1,0,61.80
南投縣,名間鄉,仁和村,243,1,535,3,538,755,3,1,3,0,1,0,71.26
南投縣,名間鄉,萬丹村,244,1,702,11,713,1052,3,1,3,0,1,0,67.78
南投縣,名間鄉,田仔村,245,1,654,6,660,1034,3,1,3,0,1,0,63.83
南投縣,名間鄉,大坑村,246,1,536,5,541,841,3,1,3,0,1,0,64.33
南投縣,名間鄉,大庄村,247,1,676,8,684,1107,3,1,3,0,1,0,61.79
南投縣,名間鄉,大庄村,248,1,494,6,500,797,3,1,3,0,1,0,62.74
南投縣,名間鄉,廍下村,249,1,453,6,459,781,3,1,3,0,1,0,58.77
南投縣,名間鄉,赤水村,250,1,439,6,445,688,3,1,3,0,1,0,64.68
南投縣,名間鄉,赤水村,251,1,303,5,308,556,3,1,3,0,1,0,55.40
南投縣,名間鄉,竹圍村,252,1,559,4,563,881,3,1,3,0,1,0,63.90
南投縣,名間鄉,三崙村,253,1,575,10,585,954,3,1,3,0,1,0,61.32
南投縣,名間鄉,三崙村,254,1,304,3,307,479,3,1,3,0,1,0,64.09
南投縣,名間鄉,松山村,255,1,692,8,700,1299,3,1,3,0,1,0,53.89
南投縣,名間鄉,松山村,256,1,585,6,591,999,3,1,3,0,1,0,59.16
南投縣,名間鄉,崁腳村,257,1,454,8,462,741,3,1,3,0,1,0,62.35
南投縣,名間鄉,埔中村,258,1,484,2,486,832,3,1,3,0,1,0,58.41
南投縣,名間鄉,新厝村,259,1,540,2,542,847,3,1,3,0,1,0,63.99
南投縣,名間鄉,新光村,260,1,428,2,430,718,3,1,3,0,1,0,59.89
南投縣,名間鄉,新光村,261,1,481,8,489,784,3,1,3,0,1,0,62.37
南投縣,鹿谷鄉,初鄉村,262,1,811,7,818,1492,3,1,3,0,1,0,54.83
南投縣,鹿谷鄉,鹿谷村,263,1,917,7,924,1567,3,1,3,0,1,0,58.97
南投縣,鹿谷鄉,彰雅村,264,1,456,4,460,693,3,1,3,0,1,0,66.38
南投縣,鹿谷鄉,彰雅村,265,1,207,6,213,378,3,1,3,0,1,0,56.35
南投縣,鹿谷鄉,廣興村,266,1,482,8,490,801,3,1,3,0,1,0,61.17
南投縣,鹿谷鄉,廣興村,267,1,557,8,565,961,3,1,3,0,1,0,58.79
南投縣,鹿谷鄉,內湖村,268,1,295,5,300,636,3,1,3,0,1,0,47.17
南投縣,鹿谷鄉,內湖村,269,1,301,2,303,471,3,1,3,0,1,0,64.33
南投縣,鹿谷鄉,和雅村,270,1,372,2,374,687,3,1,3,0,1,0,54.44
南投縣,鹿谷鄉,竹林村,271,1,826,3,829,1580,3,1,3,0,1,0,52.47
南投縣,鹿谷鄉,竹豐村,272,1,537,3,540,910,3,1,3,0,1,0,59.34
南投縣,鹿谷鄉,鳳凰村,273,1,63,0,63,110,3,1,3,0,1,0,57.27
南投縣,鹿谷鄉,鳳凰村,274,1,773,8,781,1173,3,1,3,0,1,0,66.58
南投縣,鹿谷鄉,永隆村,275,1,742,5,747,1202,3,1,3,0,1,0,62.15
南投縣,鹿谷鄉,永隆村,276,1,234,2,236,468,3,1,3,0,1,0,50.43
南投縣,鹿谷鄉,秀峰村,277,1,385,5,390,727,3,1,3,0,1,0,53.65
南投縣,鹿谷鄉,清水村,278,1,426,2,428,800,3,1,3,0,1,0,53.50
南投縣,鹿谷鄉,瑞田村,279,1,469,5,474,837,3,1,3,0,1,0,56.63
南投縣,中寮鄉,廣興村,280,1,551,7,558,930,3,1,3,0,1,0,60.00
南投縣,中寮鄉,崁頂村,281,1,231,3,234,324,3,1,3,0,1,0,72.22
南投縣,中寮鄉,崁頂村,282,1,152,0,152,237,3,1,3,0,1,0,64.14
南投縣,中寮鄉,八仙村,283,1,236,3,239,399,3,1,3,0,1,0,59.90
南投縣,中寮鄉,八仙村,284,1,245,2,247,402,3,1,3,0,1,0,61.44
南投縣,中寮鄉,福盛村,285,1,271,3,274,494,3,1,3,0,1,0,55.47
南投縣,中寮鄉,福盛村,286,1,196,6,202,411,3,1,3,0,1,0,49.15
南投縣,中寮鄉,和興村,287,1,424,2,426,746,3,1,3,0,1,0,57.10
南投縣,中寮鄉,復興村,288,1,178,1,179,298,3,1,3,0,1,0,60.07
南投縣,中寮鄉,永平村,289,1,637,11,648,1044,3,1,3,0,1,0,62.07
南投縣,中寮鄉,永平村,290,1,524,9,533,836,3,1,3,0,1,0,63.76
南投縣,中寮鄉,中寮村,291,1,429,6,435,728,3,1,3,0,1,0,59.75
南投縣,中寮鄉,廣福村,292,1,344,4,348,574,3,1,3,0,1,0,60.63
南投縣,中寮鄉,永福村,293,1,242,2,244,384,3,1,3,0,1,0,63.54
南投縣,中寮鄉,永福村,294,1,376,4,380,600,3,1,3,0,1,0,63.33
南投縣,中寮鄉,義和村,295,1,301,4,305,468,3,1,3,0,1,0,65.17
南投縣,中寮鄉,義和村,296,1,389,9,398,652,3,1,3,0,1,0,61.04
南投縣,中寮鄉,清水村,297,1,564,9,573,966,3,1,3,0,1,0,59.32
南投縣,中寮鄉,內城村,298,1,333,4,337,498,3,1,3,0,1,0,67.67
南投縣,中寮鄉,龍安村,299,1,519,5,524,764,3,1,3,0,1,0,68.59
南投縣,中寮鄉,爽文村,300,1,375,13,388,609,3,1,3,0,1,0,63.71
南投縣,中寮鄉,龍岩村,301,1,455,7,462,715,3,1,3,0,1,0,64.62
南投縣,中寮鄉,永芳村,302,1,267,2,269,424,3,1,3,0,1,0,63.44
南投縣,中寮鄉,永和村,303,1,391,2,393,599,3,1,3,0,1,0,65.61
南投縣,魚池鄉,魚池村,304,1,1030,7,1037,1777,3,1,3,0,1,0,58.36
南投縣,魚池鄉,東池村,305,1,834,8,842,1518,3,1,3,0,1,0,55.47
南投縣,魚池鄉,大林村,306,1,281,3,284,509,3,1,3,0,1,0,55.80
南投縣,魚池鄉,大林村,307,1,315,1,316,529,3,1,3,0,1,0,59.74
南投縣,魚池鄉,東光村,308,1,654,11,665,1193,3,1,3,0,1,0,55.74
南投縣,魚池鄉,共和村,309,1,147,1,148,247,3,1,3,0,1,0,59.92
南投縣,魚池鄉,新城村,310,1,287,2,289,539,3,1,3,0,1,0,53.62
南投縣,魚池鄉,共和村,311,1,126,1,127,217,3,1,3,0,1,0,58.53
南投縣,魚池鄉,新城村,312,1,418,2,420,683,3,1,3,0,1,0,61.49
南投縣,魚池鄉,新城村,313,1,160,3,163,281,3,1,3,0,1,0,58.01
南投縣,魚池鄉,新城村,314,1,142,0,142,266,3,1,3,0,1,0,53.38
南投縣,魚池鄉,大雁村,315,1,163,1,164,263,3,1,3,0,1,0,62.36
南投縣,魚池鄉,大雁村,316,1,235,0,235,359,3,1,3,0,1,0,65.46
南投縣,魚池鄉,五城村,317,1,342,3,345,573,3,1,3,0,1,0,60.21
南投縣,魚池鄉,五城村,318,1,91,0,91,171,3,1,3,0,1,0,53.22
南投縣,魚池鄉,中明村,319,1,367,2,369,621,3,1,3,0,1,0,59.42
南投縣,魚池鄉,中明村,320,1,195,2,197,354,3,1,3,0,1,0,55.65
南投縣,魚池鄉,水社村,321,1,457,4,461,756,3,1,3,0,1,0,60.98
南投縣,魚池鄉,日月村,322,1,323,2,325,539,3,1,3,0,1,0,60.30
南投縣,魚池鄉,頭社村,323,1,239,3,242,462,3,1,3,0,1,0,52.38
南投縣,魚池鄉,頭社村,324,1,269,3,272,603,3,1,3,0,1,0,45.11
南投縣,魚池鄉,武登村,325,1,239,6,245,483,3,1,3,0,1,0,50.72
南投縣,魚池鄉,武登村,326,1,199,3,202,336,3,1,3,0,1,0,60.12
南投縣,國姓鄉,國姓村,327,1,1062,8,1070,1735,3,1,3,0,1,0,61.67
南投縣,國姓鄉,石門村,328,1,952,18,970,1546,3,1,3,0,1,0,62.74
南投縣,國姓鄉,大旗村,329,1,511,5,516,821,3,1,3,0,1,0,62.85
南投縣,國姓鄉,長流村,330,1,918,13,931,1626,3,1,3,0,1,0,57.26
南投縣,國姓鄉,長福村,331,1,476,5,481,783,3,1,3,0,1,0,61.43
南投縣,國姓鄉,長豐村,332,1,526,11,537,957,3,1,3,0,1,0,56.11
南投縣,國姓鄉,北港村,333,1,676,11,687,1171,3,1,3,0,1,0,58.67
南投縣,國姓鄉,北港村,334,1,550,5,555,977,3,1,3,0,1,0,56.81
南投縣,國姓鄉,福龜村,335,1,677,4,681,988,3,1,3,0,1,0,68.93
南投縣,國姓鄉,福龜村,336,1,688,13,701,1008,3,1,3,0,1,0,69.54
南投縣,國姓鄉,乾溝村,337,1,599,3,602,922,3,1,3,0,1,0,65.29
南投縣,國姓鄉,柑林村,338,1,825,7,832,1246,3,1,3,0,1,0,66.77
南投縣,國姓鄉,大石村,339,1,509,7,516,847,3,1,3,0,1,0,60.92
南投縣,國姓鄉,北山村,340,1,759,12,771,1193,3,1,3,0,1,0,64.63
南投縣,國姓鄉,北山村,341,1,345,2,347,502,3,1,3,0,1,0,69.12
南投縣,國姓鄉,南港村,342,1,826,10,836,1469,3,1,3,0,1,0,56.91
南投縣,國姓鄉,南港村,343,1,314,3,317,554,3,1,3,0,1,0,57.22
南投縣,水里鄉,水里村,344,1,470,10,480,924,3,1,3,0,1,0,51.95
南投縣,水里鄉,新城村,345,1,342,6,348,612,3,1,3,0,1,0,56.86
南投縣,水里鄉,新城村,346,1,627,14,641,1138,3,1,3,0,1,0,56.33
南投縣,水里鄉,中央村,347,1,442,7,449,740,3,1,3,0,1,0,60.68
南投縣,水里鄉,城中村,348,1,585,8,593,1030,3,1,3,0,1,0,57.57
南投縣,水里鄉,農富村,349,1,354,1,355,559,3,1,3,0,1,0,63.51
南投縣,水里鄉,北埔村,350,1,642,9,651,1085,3,1,3,0,1,0,60.00
南投縣,水里鄉,南光村,351,1,720,8,728,1257,3,1,3,0,1,0,57.92
南投縣,水里鄉,鉅工村,352,1,701,10,711,1130,3,1,3,0,1,0,62.92
南投縣,水里鄉,永豐村,353,1,828,14,842,1346,3,1,3,0,1,0,62.56
南投縣,水里鄉,民和村,354,1,619,4,623,1050,3,1,3,0,1,0,59.33
南投縣,水里鄉,頂崁村,355,1,609,9,618,1122,3,1,3,0,1,0,55.08
南投縣,水里鄉,新山村,356,1,240,3,243,417,3,1,3,0,1,0,58.27
南投縣,水里鄉,郡坑村,357,1,285,4,289,415,3,1,3,0,1,0,69.64
南投縣,水里鄉,上安村,358,1,676,7,683,1287,3,1,3,0,1,0,53.07
南投縣,水里鄉,興隆村,359,1,219,2,221,366,3,1,3,0,1,0,60.38
南投縣,水里鄉,永興村,360,1,232,6,238,383,3,1,3,0,1,0,62.14
南投縣,水里鄉,玉峰村,361,1,582,8,590,923,3,1,3,0,1,0,63.92
南投縣,水里鄉,車埕村,362,1,368,9,377,636,3,1,3,0,1,0,59.28
南投縣,水里鄉,新興村,363,1,371,3,374,692,3,1,3,0,1,0,54.05
南投縣,信義鄉,明德村,364,1,414,2,416,703,3,1,3,0,1,0,59.17
南投縣,信義鄉,明德村,365,1,260,0,260,443,3,1,3,0,1,0,58.69
南投縣,信義鄉,愛國村,366,1,312,3,315,567,3,1,3,0,1,0,55.56
南投縣,信義鄉,自強村,367,1,240,6,246,422,3,1,3,0,1,0,58.29
南投縣,信義鄉,自強村,368,1,207,4,211,330,3,1,3,0,1,0,63.94
南投縣,信義鄉,豐丘村,369,1,207,1,208,330,3,1,3,0,1,0,63.03
南投縣,信義鄉,新鄉村,370,1,42,0,42,84,3,1,3,0,1,0,50.00
南投縣,信義鄉,羅娜村,371,1,110,2,112,224,3,1,3,0,1,0,50.00
南投縣,信義鄉,望美村,372,1,13,0,13,19,3,1,3,0,1,0,68.42
南投縣,信義鄉,望美村,373,1,131,1,132,268,3,1,3,0,1,0,49.25
南投縣,信義鄉,東埔村,374,1,120,0,120,231,3,1,3,0,1,0,51.95
南投縣,信義鄉,神木村,375,1,278,6,284,505,3,1,3,0,1,0,56.24
南投縣,信義鄉,神木村,376,1,163,3,166,273,3,1,3,0,1,0,60.81
南投縣,信義鄉,同富村,377,1,580,3,583,940,3,1,3,0,1,0,62.02
南投縣,信義鄉,同富村,378,1,238,2,240,433,3,1,3,0,1,0,55.43
南投縣,信義鄉,人和村,379,1,25,3,28,68,3,1,3,0,1,0,41.18
南投縣,信義鄉,人和村,380,1,86,0,86,192,3,1,3,0,1,0,44.79
南投縣,信義鄉,雙龍村,381,1,12,0,12,18,3,1,3,0,1,0,66.67
南投縣,信義鄉,地利村,382,1,60,2,62,93,3,1,3,0,1,0,66.67
南投縣,信義鄉,潭南村,383,1,25,0,25,41,3,1,3,0,1,0,60.98
南投縣,仁愛鄉,南豐村,384,1,113,1,114,224,3,1,3,0,1,0,50.89
南投縣,仁愛鄉,南豐村,385,1,186,1,187,312,3,1,3,0,1,0,59.94
南投縣,仁愛鄉,大同村,386,1,296,3,299,531,3,1,3,0,1,0,56.31
南投縣,仁愛鄉,大同村,387,1,193,6,199,329,3,1,3,0,1,0,60.49
南投縣,仁愛鄉,大同村,388,1,125,4,129,202,3,1,3,0,1,0,63.86
南投縣,仁愛鄉,榮興村,389,1,63,0,63,89,3,1,3,0,1,0,70.79
南投縣,仁愛鄉,春陽村,390,1,23,1,24,50,3,1,3,0,1,0,48.00
南投縣,仁愛鄉,精英村,391,1,74,1,75,121,3,1,3,0,1,0,61.98
南投縣,仁愛鄉,精英村,392,1,14,1,15,28,3,1,3,0,1,0,53.57
南投縣,仁愛鄉,合作村,393,1,15,1,16,27,3,1,3,0,1,0,59.26
南投縣,仁愛鄉,力行村,394,1,6,1,7,26,3,1,3,0,1,0,26.92
南投縣,仁愛鄉,力行村,395,1,2,1,3,15,3,1,3,0,1,0,20.00
南投縣,仁愛鄉,力行村,396,1,159,2,161,214,3,1,3,0,1,0,75.23
南投縣,仁愛鄉,發祥村,397,1,8,0,8,13,3,1,3,0,1,0,61.54
南投縣,仁愛鄉,發祥村,398,1,3,0,3,12,3,1,3,0,1,0,25.00
南投縣,仁愛鄉,發祥村,399,1,12,0,12,29,3,1,3,0,1,0,41.38
南投縣,仁愛鄉,親愛村,400,1,12,0,12,34,3,1,3,0,1,0,35.29
南投縣,仁愛鄉,親愛村,401,1,2,1,3,3,3,1,3,0,1,0,100.00
南投縣,仁愛鄉,親愛村,402,1,22,0,22,51,3,1,3,0,1,0,43.14
南投縣,仁愛鄉,萬豐村,403,1,32,0,32,65,3,1,3,0,1,0,49.23
南投縣,仁愛鄉,法治村,404,1,18,3,21,44,3,1,3,0,1,0,47.73
南投縣,仁愛鄉,中正村,405,1,44,1,45,85,3,1,3,0,1,0,52.94
南投縣,仁愛鄉,互助村,406,1,41,3,44,92,3,1,3,0,1,0,47.83
南投縣,仁愛鄉,互助村,407,1,9,2,11,28,3,1,3,0,1,0,39.29
南投縣,仁愛鄉,新生村,408,1,38,1,39,62,3,1,3,0,1,0,62.90
雲林縣,斗六市,信義里,1,1,708,2,710,978,3,1,3,0,1,0,72.60
雲林縣,斗六市,四維里,2,1,529,4,533,689,3,1,3,0,1,0,77.36
雲林縣,斗六市,太平里,3,1,564,8,572,775,3,1,3,0,1,0,73.81
雲林縣,斗六市,中和里,4,1,496,4,500,655,3,1,3,0,1,0,76.34
雲林縣,斗六市,光興里,5,1,690,13,703,1001,3,1,3,0,1,0,70.23
雲林縣,斗六市,鎮西里,6,1,717,13,730,1068,3,1,3,0,1,0,68.35
雲林縣,斗六市,鎮西里,7,1,831,14,845,1168,3,1,3,0,1,0,72.35
雲林縣,斗六市,鎮東里,8,1,706,12,718,950,3,1,3,0,1,0,75.58
雲林縣,斗六市,鎮東里,9,1,760,10,770,1045,3,1,3,0,1,0,73.68
雲林縣,斗六市,鎮東里,10,1,902,12,914,1230,3,1,3,0,1,0,74.31
雲林縣,斗六市,三平里,11,1,909,20,929,1297,3,1,3,0,1,0,71.63
雲林縣,斗六市,三平里,12,1,990,18,1008,1415,3,1,3,0,1,0,71.24
雲林縣,斗六市,鎮北里,13,1,999,27,1026,1480,3,1,3,0,1,0,69.32
雲林縣,斗六市,鎮北里,14,1,815,7,822,1176,3,1,3,0,1,0,69.90
雲林縣,斗六市,鎮北里,15,1,865,13,878,1256,3,1,3,0,1,0,69.90
雲林縣,斗六市,鎮北里,16,1,742,18,760,1060,3,1,3,0,1,0,71.70
雲林縣,斗六市,忠孝里,17,1,642,10,652,863,3,1,3,0,1,0,75.55
雲林縣,斗六市,忠孝里,18,1,526,7,533,740,3,1,3,0,1,0,72.03
雲林縣,斗六市,仁愛里,19,1,811,17,828,1157,3,1,3,0,1,0,71.56
雲林縣,斗六市,八德里,20,1,712,18,730,957,3,1,3,0,1,0,76.28
雲林縣,斗六市,八德里,21,1,775,20,795,1168,3,1,3,0,1,0,68.07
雲林縣,斗六市,公正里,22,1,1212,24,1236,1774,3,1,3,0,1,0,69.67
雲林縣,斗六市,重光里,23,1,620,14,634,871,3,1,3,0,1,0,72.79
雲林縣,斗六市,重光里,24,1,670,10,680,951,3,1,3,0,1,0,71.50
雲林縣,斗六市,林頭里,25,1,909,13,922,1344,3,1,3,0,1,0,68.60
雲林縣,斗六市,林頭里,26,1,767,13,780,1088,3,1,3,0,1,0,71.69
雲林縣,斗六市,林頭里,27,1,881,18,899,1255,3,1,3,0,1,0,71.63
雲林縣,斗六市,林頭里,28,1,901,14,915,1141,3,1,3,0,1,0,80.19
雲林縣,斗六市,鎮南里,29,1,942,12,954,1333,3,1,3,0,1,0,71.57
雲林縣,斗六市,鎮南里,30,1,1008,11,1019,1459,3,1,3,0,1,0,69.84
雲林縣,斗六市,社口里,31,1,639,11,650,900,3,1,3,0,1,0,72.22
雲林縣,斗六市,社口里,32,1,874,18,892,1172,3,1,3,0,1,0,76.11
雲林縣,斗六市,龍潭里,33,1,595,11,606,822,3,1,3,0,1,0,73.72
雲林縣,斗六市,嘉東里,34,1,463,4,467,579,3,1,3,0,1,0,80.66
雲林縣,斗六市,崙峰里,35,1,652,9,661,871,3,1,3,0,1,0,75.89
雲林縣,斗六市,崙峰里,36,1,505,11,516,668,3,1,3,0,1,0,77.25
雲林縣,斗六市,溝埧里,37,1,397,7,404,516,3,1,3,0,1,0,78.29
雲林縣,斗六市,江厝里,38,1,742,15,757,1061,3,1,3,0,1,0,71.35
雲林縣,斗六市,三光里,39,1,457,12,469,633,3,1,3,0,1,0,74.09
雲林縣,斗六市,久安里,40,1,804,13,817,1050,3,1,3,0,1,0,77.81
雲林縣,斗六市,久安里,41,1,403,7,410,549,3,1,3,0,1,0,74.68
雲林縣,斗六市,虎溪里,42,1,746,15,761,1035,3,1,3,0,1,0,73.53
雲林縣,斗六市,虎溪里,43,1,1028,24,1052,1473,3,1,3,0,1,0,71.42
雲林縣,斗六市,虎溪里,44,1,885,17,902,1152,3,1,3,0,1,0,78.30
雲林縣,斗六市,保庄里,45,1,1022,15,1037,1399,3,1,3,0,1,0,74.12
雲林縣,斗六市,保庄里,46,1,848,20,868,1132,3,1,3,0,1,0,76.68
雲林縣,斗六市,長平里,47,1,1029,11,1040,1345,3,1,3,0,1,0,77.32
雲林縣,斗六市,榴中里,48,1,1043,16,1059,1451,3,1,3,0,1,0,72.98
雲林縣,斗六市,榴中里,49,1,1244,37,1281,1774,3,1,3,0,1,0,72.21
雲林縣,斗六市,榴北里,50,1,590,12,602,809,3,1,3,0,1,0,74.41
雲林縣,斗六市,榴南里,51,1,560,9,569,753,3,1,3,0,1,0,75.56
雲林縣,斗六市,梅林里,52,1,621,22,643,839,3,1,3,0,1,0,76.64
雲林縣,斗六市,梅林里,53,1,692,15,707,919,3,1,3,0,1,0,76.93
雲林縣,斗六市,湖山里,54,1,879,22,901,1217,3,1,3,0,1,0,74.03
雲林縣,斗六市,長安里,55,1,710,21,731,945,3,1,3,0,1,0,77.35
雲林縣,斗六市,長安里,56,1,839,18,857,1133,3,1,3,0,1,0,75.64
雲林縣,斗六市,溪洲里,57,1,616,9,625,853,3,1,3,0,1,0,73.27
雲林縣,斗六市,溪洲里,58,1,694,26,720,1040,3,1,3,0,1,0,69.23
雲林縣,斗六市,十三里,59,1,797,15,812,1071,3,1,3,0,1,0,75.82
雲林縣,斗南鎮,東仁里,60,1,810,19,829,1118,3,1,3,0,1,0,74.15
雲林縣,斗南鎮,西岐里,61,1,890,9,899,1262,3,1,3,0,1,0,71.24
雲林縣,斗南鎮,西岐里,62,1,737,17,754,1097,3,1,3,0,1,0,68.73
雲林縣,斗南鎮,西岐里,63,1,705,14,719,1066,3,1,3,0,1,0,67.45
雲林縣,斗南鎮,南昌里,64,1,706,17,723,1125,3,1,3,0,1,0,64.27
雲林縣,斗南鎮,南昌里,65,1,539,5,544,761,3,1,3,0,1,0,71.48
雲林縣,斗南鎮,北銘里,66,1,851,9,860,1198,3,1,3,0,1,0,71.79
雲林縣,斗南鎮,中天里,67,1,928,15,943,1334,3,1,3,0,1,0,70.69
雲林縣,斗南鎮,舊社里,68,1,927,15,942,1412,3,1,3,0,1,0,66.71
雲林縣,斗南鎮,林子里,69,1,753,6,759,1053,3,1,3,0,1,0,72.08
雲林縣,斗南鎮,石龜里,70,1,615,6,621,831,3,1,3,0,1,0,74.73
雲林縣,斗南鎮,石溪里,71,1,654,12,666,903,3,1,3,0,1,0,73.75
雲林縣,斗南鎮,靖興里,72,1,675,9,684,890,3,1,3,0,1,0,76.85
雲林縣,斗南鎮,新南里,73,1,502,5,507,714,3,1,3,0,1,0,71.01
雲林縣,斗南鎮,阿丹里,74,1,915,9,924,1180,3,1,3,0,1,0,78.31
雲林縣,斗南鎮,將軍里,75,1,985,13,998,1320,3,1,3,0,1,0,75.61
雲林縣,斗南鎮,東明里,76,1,689,18,707,971,3,1,3,0,1,0,72.81
雲林縣,斗南鎮,新光里,77,1,665,13,678,911,3,1,3,0,1,0,74.42
雲林縣,斗南鎮,新光里,78,1,892,23,915,1256,3,1,3,0,1,0,72.85
雲林縣,斗南鎮,田頭里,79,1,728,8,736,975,3,1,3,0,1,0,75.49
雲林縣,斗南鎮,田頭里,80,1,681,21,702,953,3,1,3,0,1,0,73.66
雲林縣,斗南鎮,明昌里,81,1,1085,23,1108,1510,3,1,3,0,1,0,73.38
雲林縣,斗南鎮,明昌里,82,1,770,13,783,1097,3,1,3,0,1,0,71.38
雲林縣,斗南鎮,明昌里,83,1,827,18,845,1246,3,1,3,0,1,0,67.82
雲林縣,斗南鎮,大東里,84,1,708,10,718,992,3,1,3,0,1,0,72.38
雲林縣,斗南鎮,埤麻里,85,1,622,7,629,889,3,1,3,0,1,0,70.75
雲林縣,斗南鎮,西伯里,86,1,669,14,683,922,3,1,3,0,1,0,74.08
雲林縣,斗南鎮,新崙里,87,1,553,7,560,790,3,1,3,0,1,0,70.89
雲林縣,斗南鎮,新崙里,88,1,572,4,576,786,3,1,3,0,1,0,73.28
雲林縣,斗南鎮,小東里,89,1,1080,12,1092,1533,3,1,3,0,1,0,71.23
雲林縣,虎尾鎮,東仁里,90,1,768,11,779,1102,3,1,3,0,1,0,70.69
雲林縣,虎尾鎮,東仁里,91,1,818,14,832,1200,3,1,3,0,1,0,69.33
雲林縣,虎尾鎮,新興里,92,1,512,9,521,718,3,1,3,0,1,0,72.56
雲林縣,虎尾鎮,新興里,93,1,629,10,639,935,3,1,3,0,1,0,68.34
雲林縣,虎尾鎮,公安里,94,1,739,12,751,1137,3,1,3,0,1,0,66.05
雲林縣,虎尾鎮,公安里,95,1,930,9,939,1320,3,1,3,0,1,0,71.14
雲林縣,虎尾鎮,德興里,96,1,671,8,679,1007,3,1,3,0,1,0,67.43
雲林縣,虎尾鎮,德興里,97,1,937,13,950,1452,3,1,3,0,1,0,65.43
雲林縣,虎尾鎮,中山里,98,1,779,11,790,1136,3,1,3,0,1,0,69.54
雲林縣,虎尾鎮,西安里,99,1,860,9,869,1290,3,1,3,0,1,0,67.36
雲林縣,虎尾鎮,西安里,100,1,1005,21,1026,1492,3,1,3,0,1,0,68.77
雲林縣,虎尾鎮,立仁里,101,1,948,17,965,1322,3,1,3,0,1,0,73.00
雲林縣,虎尾鎮,立仁里,102,1,1017,18,1035,1551,3,1,3,0,1,0,66.73
雲林縣,虎尾鎮,安慶里,103,1,911,11,922,1241,3,1,3,0,1,0,74.29
雲林縣,虎尾鎮,平和里,104,1,697,9,706,1007,3,1,3,0,1,0,70.11
雲林縣,虎尾鎮,興南里,105,1,800,8,808,1362,3,1,3,0,1,0,59.32
雲林縣,虎尾鎮,新吉里,106,1,1056,19,1075,1574,3,1,3,0,1,0,68.30
雲林縣,虎尾鎮,穎川里,107,1,1060,11,1071,1514,3,1,3,0,1,0,70.74
雲林縣,虎尾鎮,延平里,108,1,541,12,553,750,3,1,3,0,1,0,73.73
雲林縣,虎尾鎮,建國里,109,1,470,8,478,716,3,1,3,0,1,0,66.76
雲林縣,虎尾鎮,埒內里,110,1,686,10,696,993,3,1,3,0,1,0,70.09
雲林縣,虎尾鎮,埒內里,111,1,724,10,734,971,3,1,3,0,1,0,75.59
雲林縣,虎尾鎮,堀頭里,112,1,561,9,570,726,3,1,3,0,1,0,78.51
雲林縣,虎尾鎮,安溪里,113,1,1048,15,1063,1448,3,1,3,0,1,0,73.41
雲林縣,虎尾鎮,興中里,114,1,992,31,1023,1413,3,1,3,0,1,0,72.40
雲林縣,虎尾鎮,廉使里,115,1,810,13,823,1256,3,1,3,0,1,0,65.53
雲林縣,虎尾鎮,廉使里,116,1,894,15,909,1357,3,1,3,0,1,0,66.99
雲林縣,虎尾鎮,惠來里,117,1,725,8,733,1135,3,1,3,0,1,0,64.58
雲林縣,虎尾鎮,惠來里,118,1,643,10,653,985,3,1,3,0,1,0,66.29
雲林縣,虎尾鎮,頂溪里,119,1,699,12,711,1026,3,1,3,0,1,0,69.30
雲林縣,虎尾鎮,頂溪里,120,1,710,13,723,1064,3,1,3,0,1,0,67.95
雲林縣,虎尾鎮,中溪里,121,1,730,10,740,1139,3,1,3,0,1,0,64.97
雲林縣,虎尾鎮,下溪里,122,1,874,5,879,1192,3,1,3,0,1,0,73.74
雲林縣,虎尾鎮,東屯里,123,1,791,11,802,1044,3,1,3,0,1,0,76.82
雲林縣,虎尾鎮,西屯里,124,1,1057,11,1068,1400,3,1,3,0,1,0,76.29
雲林縣,虎尾鎮,芳草里,125,1,604,8,612,853,3,1,3,0,1,0,71.75
雲林縣,虎尾鎮,墾地里,126,1,654,12,666,926,3,1,3,0,1,0,71.92
雲林縣,虎尾鎮,北溪里,127,1,508,6,514,740,3,1,3,0,1,0,69.46
雲林縣,虎尾鎮,三合里,128,1,629,6,635,977,3,1,3,0,1,0,64.99
雲林縣,西螺鎮,振興里,129,1,1047,10,1057,1485,3,1,3,0,1,0,71.18
雲林縣,西螺鎮,大園里,130,1,905,14,919,1225,3,1,3,0,1,0,75.02
雲林縣,西螺鎮,廣福里,131,1,1136,14,1150,1545,3,1,3,0,1,0,74.43
雲林縣,西螺鎮,正興里,132,1,928,8,936,1388,3,1,3,0,1,0,67.44
雲林縣,西螺鎮,正興里,133,1,802,11,813,1139,3,1,3,0,1,0,71.38
雲林縣,西螺鎮,永安里,134,1,387,2,389,533,3,1,3,0,1,0,72.98
雲林縣,西螺鎮,中和里,135,1,556,4,560,811,3,1,3,0,1,0,69.05
雲林縣,西螺鎮,福興里,136,1,494,5,499,711,3,1,3,0,1,0,70.18
雲林縣,西螺鎮,光華里,137,1,721,7,728,1020,3,1,3,0,1,0,71.37
雲林縣,西螺鎮,中興里,138,1,798,9,807,1160,3,1,3,0,1,0,69.57
雲林縣,西螺鎮,中興里,139,1,603,3,606,873,3,1,3,0,1,0,69.42
雲林縣,西螺鎮,漢光里,140,1,1023,11,1034,1480,3,1,3,0,1,0,69.86
雲林縣,西螺鎮,漢光里,141,1,1011,10,1021,1429,3,1,3,0,1,0,71.45
雲林縣,西螺鎮,新安里,142,1,851,8,859,1172,3,1,3,0,1,0,73.29
雲林縣,西螺鎮,新豐里,143,1,964,8,972,1334,3,1,3,0,1,0,72.86
雲林縣,西螺鎮,大新里,144,1,706,7,713,990,3,1,3,0,1,0,72.02
雲林縣,西螺鎮,大新里,145,1,499,8,507,748,3,1,3,0,1,0,67.78
雲林縣,西螺鎮,埤頭里,146,1,623,4,627,906,3,1,3,0,1,0,69.21
雲林縣,西螺鎮,東興里,147,1,810,14,824,1168,3,1,3,0,1,0,70.55
雲林縣,西螺鎮,鹿場里,148,1,993,16,1009,1414,3,1,3,0,1,0,71.36
雲林縣,西螺鎮,廣興里,149,1,600,8,608,855,3,1,3,0,1,0,71.11
雲林縣,西螺鎮,頂湳里,150,1,714,7,721,1003,3,1,3,0,1,0,71.88
雲林縣,西螺鎮,吳厝里,151,1,905,7,912,1348,3,1,3,0,1,0,67.66
雲林縣,西螺鎮,九隆里,152,1,490,5,495,709,3,1,3,0,1,0,69.82
雲林縣,西螺鎮,下湳里,153,1,574,5,579,764,3,1,3,0,1,0,75.79
雲林縣,西螺鎮,七座里,154,1,677,10,687,1016,3,1,3,0,1,0,67.62
雲林縣,西螺鎮,公舘里,155,1,947,9,956,1311,3,1,3,0,1,0,72.92
雲林縣,西螺鎮,詔安里,156,1,636,6,642,951,3,1,3,0,1,0,67.51
雲林縣,西螺鎮,河南里,157,1,598,8,606,896,3,1,3,0,1,0,67.63
雲林縣,西螺鎮,安定里,158,1,577,6,583,884,3,1,3,0,1,0,65.95
雲林縣,西螺鎮,安定里,159,1,485,5,490,810,3,1,3,0,1,0,60.49
雲林縣,西螺鎮,福田里,160,1,986,10,996,1352,3,1,3,0,1,0,73.67
雲林縣,土庫鎮,忠正里,161,1,662,6,668,921,3,1,3,0,1,0,72.53
雲林縣,土庫鎮,順天里,162,1,765,15,780,1055,3,1,3,0,1,0,73.93
雲林縣,土庫鎮,宮北里,163,1,945,16,961,1327,3,1,3,0,1,0,72.42
雲林縣,土庫鎮,越港里,164,1,576,10,586,798,3,1,3,0,1,0,73.43
雲林縣,土庫鎮,溪邊里,165,1,486,2,488,699,3,1,3,0,1,0,69.81
雲林縣,土庫鎮,溪邊里,166,1,332,4,336,417,3,1,3,0,1,0,80.58
雲林縣,土庫鎮,石廟里,167,1,881,26,907,1327,3,1,3,0,1,0,68.35
雲林縣,土庫鎮,興新里,168,1,398,5,403,566,3,1,3,0,1,0,71.20
雲林縣,土庫鎮,興新里,169,1,346,2,348,552,3,1,3,0,1,0,63.04
雲林縣,土庫鎮,奮起里,170,1,460,5,465,845,3,1,3,0,1,0,55.03
雲林縣,土庫鎮,奮起里,171,1,395,4,399,604,3,1,3,0,1,0,66.06
雲林縣,土庫鎮,埤腳里,172,1,561,7,568,918,3,1,3,0,1,0,61.87
雲林縣,土庫鎮,埤腳里,173,1,394,4,398,570,3,1,3,0,1,0,69.82
雲林縣,土庫鎮,後埔里,174,1,808,16,824,1282,3,1,3,0,1,0,64.27
雲林縣,土庫鎮,後埔里,175,1,679,4,683,967,3,1,3,0,1,0,70.63
雲林縣,土庫鎮,崙內里,176,1,484,4,488,736,3,1,3,0,1,0,66.30
雲林縣,土庫鎮,崙內里,177,1,422,8,430,674,3,1,3,0,1,0,63.80
雲林縣,土庫鎮,大荖里,178,1,500,6,506,809,3,1,3,0,1,0,62.55
雲林縣,土庫鎮,東平里,179,1,574,8,582,957,3,1,3,0,1,0,60.82
雲林縣,土庫鎮,東平里,180,1,425,1,426,742,3,1,3,0,1,0,57.41
雲林縣,土庫鎮,南平里,181,1,597,4,601,930,3,1,3,0,1,0,64.62
雲林縣,土庫鎮,南平里,182,1,514,10,524,814,3,1,3,0,1,0,64.37
雲林縣,土庫鎮,西平里,183,1,573,14,587,940,3,1,3,0,1,0,62.45
雲林縣,土庫鎮,西平里,184,1,448,7,455,833,3,1,3,0,1,0,54.62
雲林縣,土庫鎮,北平里,185,1,639,3,642,986,3,1,3,0,1,0,65.11
雲林縣,土庫鎮,新庄里,186,1,944,10,954,1399,3,1,3,0,1,0,68.19
雲林縣,北港鎮,東陽里,187,1,593,7,600,881,3,1,3,0,1,0,68.10
雲林縣,北港鎮,光民里,188,1,564,9,573,801,3,1,3,0,1,0,71.54
雲林縣,北港鎮,東華里,189,1,427,2,429,586,3,1,3,0,1,0,73.21
雲林縣,北港鎮,南安里,190,1,723,13,736,1080,3,1,3,0,1,0,68.15
雲林縣,北港鎮,中和里,191,1,317,4,321,460,3,1,3,0,1,0,69.78
雲林縣,北港鎮,義民里,192,1,344,6,350,482,3,1,3,0,1,0,72.61
雲林縣,北港鎮,共榮里,193,1,377,7,384,559,3,1,3,0,1,0,68.69
雲林縣,北港鎮,西勢里,194,1,513,4,517,764,3,1,3,0,1,0,67.67
雲林縣,北港鎮,仁和里,195,1,422,4,426,595,3,1,3,0,1,0,71.60
雲林縣,北港鎮,賜福里,196,1,293,5,298,453,3,1,3,0,1,0,65.78
雲林縣,北港鎮,公舘里,197,1,484,14,498,704,3,1,3,0,1,0,70.74
雲林縣,北港鎮,大同里,198,1,387,4,391,580,3,1,3,0,1,0,67.41
雲林縣,北港鎮,大同里,199,1,503,6,509,803,3,1,3,0,1,0,63.39
雲林縣,北港鎮,仁安里,200,1,353,1,354,534,3,1,3,0,1,0,66.29
雲林縣,北港鎮,華勝里,201,1,722,7,729,1074,3,1,3,0,1,0,67.88
雲林縣,北港鎮,華勝里,202,1,903,16,919,1426,3,1,3,0,1,0,64.45
雲林縣,北港鎮,華勝里,203,1,671,12,683,987,3,1,3,0,1,0,69.20
雲林縣,北港鎮,華勝里,204,1,868,14,882,1348,3,1,3,0,1,0,65.43
雲林縣,北港鎮,光復里,205,1,805,9,814,1208,3,1,3,0,1,0,67.38
雲林縣,北港鎮,新街里,206,1,636,16,652,961,3,1,3,0,1,0,67.85
雲林縣,北港鎮,新街里,207,1,1188,18,1206,1681,3,1,3,0,1,0,71.74
雲林縣,北港鎮,新街里,208,1,1002,11,1013,1566,3,1,3,0,1,0,64.69
雲林縣,北港鎮,劉厝里,209,1,703,14,717,1127,3,1,3,0,1,0,63.62
雲林縣,北港鎮,後溝里,210,1,372,5,377,642,3,1,3,0,1,0,58.72
雲林縣,北港鎮,後溝里,211,1,179,1,180,330,3,1,3,0,1,0,54.55
雲林縣,北港鎮,新厝里,212,1,265,2,267,403,3,1,3,0,1,0,66.25
雲林縣,北港鎮,府番里,213,1,511,2,513,868,3,1,3,0,1,0,59.10
雲林縣,北港鎮,草湖里,214,1,879,20,899,1399,3,1,3,0,1,0,64.26
雲林縣,北港鎮,溝皂里,215,1,696,11,707,1272,3,1,3,0,1,0,55.58
雲林縣,北港鎮,番溝里,216,1,684,12,696,1137,3,1,3,0,1,0,61.21
雲林縣,北港鎮,大北里,217,1,380,7,387,711,3,1,3,0,1,0,54.43
雲林縣,北港鎮,好收里,218,1,666,17,683,988,3,1,3,0,1,0,69.13
雲林縣,北港鎮,好收里,219,1,414,8,422,614,3,1,3,0,1,0,68.73
雲林縣,北港鎮,樹腳里,220,1,736,15,751,1265,3,1,3,0,1,0,59.37
雲林縣,北港鎮,樹腳里,221,1,839,14,853,1302,3,1,3,0,1,0,65.51
雲林縣,北港鎮,扶朝里,222,1,636,12,648,1090,3,1,3,0,1,0,59.45
雲林縣,北港鎮,水埔里,223,1,365,4,369,600,3,1,3,0,1,0,61.50
雲林縣,古坑鄉,棋盤村,224,1,793,12,805,1176,3,1,3,0,1,0,68.45
雲林縣,古坑鄉,棋盤村,225,1,627,9,636,899,3,1,3,0,1,0,70.75
雲林縣,古坑鄉,新庄村,226,1,1019,14,1033,1564,3,1,3,0,1,0,66.05
雲林縣,古坑鄉,東和村,227,1,808,10,818,1130,3,1,3,0,1,0,72.39
雲林縣,古坑鄉,東和村,228,1,887,18,905,1300,3,1,3,0,1,0,69.62
雲林縣,古坑鄉,荷苞村,229,1,783,15,798,1102,3,1,3,0,1,0,72.41
雲林縣,古坑鄉,荷苞村,230,1,226,4,230,303,3,1,3,0,1,0,75.91
雲林縣,古坑鄉,高林村,231,1,827,13,840,1105,3,1,3,0,1,0,76.02
雲林縣,古坑鄉,水碓村,232,1,935,12,947,1237,3,1,3,0,1,0,76.56
雲林縣,古坑鄉,田心村,233,1,639,9,648,848,3,1,3,0,1,0,76.42
雲林縣,古坑鄉,古坑村,234,1,712,11,723,995,3,1,3,0,1,0,72.66
雲林縣,古坑鄉,古坑村,235,1,722,9,731,975,3,1,3,0,1,0,74.97
雲林縣,古坑鄉,朝陽村,236,1,642,9,651,905,3,1,3,0,1,0,71.93
雲林縣,古坑鄉,朝陽村,237,1,653,9,662,917,3,1,3,0,1,0,72.19
雲林縣,古坑鄉,西平村,238,1,978,8,986,1387,3,1,3,0,1,0,71.09
雲林縣,古坑鄉,湳仔村,239,1,561,3,564,726,3,1,3,0,1,0,77.69
雲林縣,古坑鄉,永光村,240,1,751,5,756,995,3,1,3,0,1,0,75.98
雲林縣,古坑鄉,永光村,241,1,623,6,629,868,3,1,3,0,1,0,72.47
雲林縣,古坑鄉,永昌村,242,1,713,12,725,993,3,1,3,0,1,0,73.01
雲林縣,古坑鄉,永昌村,243,1,701,14,715,986,3,1,3,0,1,0,72.52
雲林縣,古坑鄉,麻園村,244,1,517,5,522,662,3,1,3,0,1,0,78.85
雲林縣,古坑鄉,崁腳村,245,1,979,15,994,1340,3,1,3,0,1,0,74.18
雲林縣,古坑鄉,華南村,246,1,267,3,270,339,3,1,3,0,1,0,79.65
雲林縣,古坑鄉,華山村,247,1,674,8,682,1050,3,1,3,0,1,0,64.95
雲林縣,古坑鄉,桂林村,248,1,635,6,641,960,3,1,3,0,1,0,66.77
雲林縣,古坑鄉,樟湖村,249,1,385,1,386,571,3,1,3,0,1,0,67.60
雲林縣,古坑鄉,草嶺村,250,1,520,3,523,715,3,1,3,0,1,0,73.15
雲林縣,大埤鄉,北和村,251,1,543,11,554,825,3,1,3,0,1,0,67.15
雲林縣,大埤鄉,南和村,252,1,995,16,1011,1408,3,1,3,0,1,0,71.80
雲林縣,大埤鄉,南和村,253,1,396,5,401,564,3,1,3,0,1,0,71.10
雲林縣,大埤鄉,大德村,254,1,739,14,753,1134,3,1,3,0,1,0,66.40
雲林縣,大埤鄉,松竹村,255,1,745,8,753,1095,3,1,3,0,1,0,68.77
雲林縣,大埤鄉,尚義村,256,1,802,12,814,1230,3,1,3,0,1,0,66.18
雲林縣,大埤鄉,尚義村,257,1,332,3,335,524,3,1,3,0,1,0,63.93
雲林縣,大埤鄉,嘉興村,258,1,937,15,952,1284,3,1,3,0,1,0,74.14
雲林縣,大埤鄉,嘉興村,259,1,362,3,365,476,3,1,3,0,1,0,76.68
雲林縣,大埤鄉,豐田村,260,1,719,15,734,1048,3,1,3,0,1,0,70.04
雲林縣,大埤鄉,三結村,261,1,862,11,873,1267,3,1,3,0,1,0,68.90
雲林縣,大埤鄉,吉田村,262,1,523,7,530,834,3,1,3,0,1,0,63.55
雲林縣,大埤鄉,豐岡村,263,1,525,6,531,759,3,1,3,0,1,0,69.96
雲林縣,大埤鄉,聯美村,264,1,846,17,863,1239,3,1,3,0,1,0,69.65
雲林縣,大埤鄉,怡然村,265,1,598,3,601,844,3,1,3,0,1,0,71.21
雲林縣,大埤鄉,北鎮村,266,1,466,6,472,733,3,1,3,0,1,0,64.39
雲林縣,大埤鄉,興安村,267,1,556,8,564,870,3,1,3,0,1,0,64.83
雲林縣,大埤鄉,西鎮村,268,1,612,5,617,906,3,1,3,0,1,0,68.10
雲林縣,莿桐鄉,莿桐村,269,1,998,13,1011,1409,3,1,3,0,1,0,71.75
雲林縣,莿桐鄉,莿桐村,270,1,1133,23,1156,1544,3,1,3,0,1,0,74.87
雲林縣,莿桐鄉,甘厝村,271,1,680,10,690,919,3,1,3,0,1,0,75.08
雲林縣,莿桐鄉,甘西村,272,1,1000,11,1011,1513,3,1,3,0,1,0,66.82
雲林縣,莿桐鄉,興桐村,273,1,384,8,392,585,3,1,3,0,1,0,67.01
雲林縣,莿桐鄉,興桐村,274,1,509,10,519,749,3,1,3,0,1,0,69.29
雲林縣,莿桐鄉,義和村,275,1,772,11,783,1112,3,1,3,0,1,0,70.41
雲林縣,莿桐鄉,埔子村,276,1,1105,21,1126,1626,3,1,3,0,1,0,69.25
雲林縣,莿桐鄉,大美村,277,1,793,10,803,1102,3,1,3,0,1,0,72.87
雲林縣,莿桐鄉,大美村,278,1,657,12,669,926,3,1,3,0,1,0,72.25
雲林縣,莿桐鄉,埔尾村,279,1,839,10,849,1119,3,1,3,0,1,0,75.87
雲林縣,莿桐鄉,興貴村,280,1,594,12,606,870,3,1,3,0,1,0,69.66
雲林縣,莿桐鄉,興貴村,281,1,630,11,641,904,3,1,3,0,1,0,70.91
雲林縣,莿桐鄉,饒平村,282,1,826,19,845,1124,3,1,3,0,1,0,75.18
雲林縣,莿桐鄉,四合村,283,1,1070,20,1090,1622,3,1,3,0,1,0,67.20
雲林縣,莿桐鄉,麻園村,284,1,1032,14,1046,1502,3,1,3,0,1,0,69.64
雲林縣,莿桐鄉,五華村,285,1,808,20,828,1260,3,1,3,0,1,0,65.71
雲林縣,莿桐鄉,六合村,286,1,1066,13,1079,1565,3,1,3,0,1,0,68.95
雲林縣,林內鄉,林南村,287,1,777,10,787,1012,3,1,3,0,1,0,77.77
雲林縣,林內鄉,林中村,288,1,1022,18,1040,1406,3,1,3,0,1,0,73.97
雲林縣,林內鄉,林中村,289,1,1162,24,1186,1551,3,1,3,0,1,0,76.47
雲林縣,林內鄉,林北村,290,1,917,25,942,1323,3,1,3,0,1,0,71.20
雲林縣,林內鄉,林北村,291,1,495,11,506,724,3,1,3,0,1,0,69.89
雲林縣,林內鄉,坪頂村,292,1,506,4,510,657,3,1,3,0,1,0,77.63
雲林縣,林內鄉,林茂村,293,1,708,26,734,999,3,1,3,0,1,0,73.47
雲林縣,林內鄉,九芎村,294,1,755,18,773,1018,3,1,3,0,1,0,75.93
雲林縣,林內鄉,九芎村,295,1,972,22,994,1374,3,1,3,0,1,0,72.34
雲林縣,林內鄉,湖本村,296,1,407,13,420,609,3,1,3,0,1,0,68.97
雲林縣,林內鄉,烏塗村,297,1,871,15,886,1102,3,1,3,0,1,0,80.40
雲林縣,林內鄉,烏塗村,298,1,759,8,767,1093,3,1,3,0,1,0,70.17
雲林縣,林內鄉,重興村,299,1,610,14,624,829,3,1,3,0,1,0,75.27
雲林縣,林內鄉,重興村,300,1,545,11,556,799,3,1,3,0,1,0,69.59
雲林縣,二崙鄉,崙東村,301,1,879,8,887,1335,3,1,3,0,1,0,66.44
雲林縣,二崙鄉,崙西村,302,1,1001,10,1011,1520,3,1,3,0,1,0,66.51
雲林縣,二崙鄉,來惠村,303,1,489,3,492,738,3,1,3,0,1,0,66.67
雲林縣,二崙鄉,來惠村,304,1,705,7,712,1102,3,1,3,0,1,0,64.61
雲林縣,二崙鄉,三和村,305,1,326,4,330,516,3,1,3,0,1,0,63.95
雲林縣,二崙鄉,三和村,306,1,808,16,824,1246,3,1,3,0,1,0,66.13
雲林縣,二崙鄉,湳仔村,307,1,828,13,841,1221,3,1,3,0,1,0,68.88
雲林縣,二崙鄉,田尾村,308,1,635,10,645,956,3,1,3,0,1,0,67.47
雲林縣,二崙鄉,田尾村,309,1,666,5,671,947,3,1,3,0,1,0,70.86
雲林縣,二崙鄉,定安村,310,1,606,12,618,946,3,1,3,0,1,0,65.33
雲林縣,二崙鄉,永定村,311,1,863,10,873,1258,3,1,3,0,1,0,69.40
雲林縣,二崙鄉,大華村,312,1,634,5,639,949,3,1,3,0,1,0,67.33
雲林縣,二崙鄉,義庄村,313,1,479,4,483,796,3,1,3,0,1,0,60.68
雲林縣,二崙鄉,楊賢村,314,1,998,9,1007,1449,3,1,3,0,1,0,69.50
雲林縣,二崙鄉,港後村,315,1,739,7,746,1243,3,1,3,0,1,0,60.02
雲林縣,二崙鄉,港後村,316,1,509,5,514,735,3,1,3,0,1,0,69.93
雲林縣,二崙鄉,大義村,317,1,571,9,580,907,3,1,3,0,1,0,63.95
雲林縣,二崙鄉,油車村,318,1,761,8,769,1076,3,1,3,0,1,0,71.47
雲林縣,二崙鄉,油車村,319,1,426,5,431,686,3,1,3,0,1,0,62.83
雲林縣,二崙鄉,大庄村,320,1,897,14,911,1435,3,1,3,0,1,0,63.48
雲林縣,二崙鄉,庄西村,321,1,602,5,607,1031,3,1,3,0,1,0,58.87
雲林縣,二崙鄉,大同村,322,1,571,8,579,810,3,1,3,0,1,0,71.48
雲林縣,二崙鄉,復興村,323,1,699,8,707,1015,3,1,3,0,1,0,69.66
雲林縣,崙背鄉,東明村,324,1,926,17,943,1286,3,1,3,0,1,0,73.33
雲林縣,崙背鄉,西榮村,325,1,924,17,941,1235,3,1,3,0,1,0,76.19
雲林縣,崙背鄉,南陽村,326,1,674,14,688,952,3,1,3,0,1,0,72.27
雲林縣,崙背鄉,南陽村,327,1,871,5,876,1114,3,1,3,0,1,0,78.64
雲林縣,崙背鄉,崙前村,328,1,651,9,660,944,3,1,3,0,1,0,69.92
雲林縣,崙背鄉,崙前村,329,1,576,8,584,931,3,1,3,0,1,0,62.73
雲林縣,崙背鄉,羅厝村,330,1,558,5,563,870,3,1,3,0,1,0,64.71
雲林縣,崙背鄉,羅厝村,331,1,611,9,620,916,3,1,3,0,1,0,67.69
雲林縣,崙背鄉,港尾村,332,1,834,11,845,1318,3,1,3,0,1,0,64.11
雲林縣,崙背鄉,阿勸村,333,1,631,10,641,980,3,1,3,0,1,0,65.41
雲林縣,崙背鄉,阿勸村,334,1,611,3,614,872,3,1,3,0,1,0,70.41
雲林縣,崙背鄉,五魁村,335,1,554,3,557,876,3,1,3,0,1,0,63.58
雲林縣,崙背鄉,大有村,336,1,530,10,540,804,3,1,3,0,1,0,67.16
雲林縣,崙背鄉,大有村,337,1,601,11,612,926,3,1,3,0,1,0,66.09
雲林縣,崙背鄉,豐榮村,338,1,576,8,584,978,3,1,3,0,1,0,59.71
雲林縣,崙背鄉,豐榮村,339,1,602,12,614,1033,3,1,3,0,1,0,59.44
雲林縣,崙背鄉,草湖村,340,1,949,20,969,1402,3,1,3,0,1,0,69.12
雲林縣,崙背鄉,舊庄村,341,1,767,12,779,1165,3,1,3,0,1,0,66.87
雲林縣,崙背鄉,水尾村,342,1,809,12,821,1248,3,1,3,0,1,0,65.79
雲林縣,崙背鄉,枋南村,343,1,633,7,640,898,3,1,3,0,1,0,71.27
雲林縣,麥寮鄉,麥豐村,344,1,348,2,350,546,3,1,3,0,1,0,64.10
雲林縣,麥寮鄉,麥豐村,345,1,811,13,824,1240,3,1,3,0,1,0,66.45
雲林縣,麥寮鄉,麥豐村,346,1,627,6,633,947,3,1,3,0,1,0,66.84
雲林縣,麥寮鄉,麥津村,347,1,687,12,699,1099,3,1,3,0,1,0,63.60
雲林縣,麥寮鄉,麥津村,348,1,744,7,751,1179,3,1,3,0,1,0,63.70
雲林縣,麥寮鄉,瓦窯村,349,1,304,5,309,492,3,1,3,0,1,0,62.80
雲林縣,麥寮鄉,瓦窯村,350,1,471,3,474,816,3,1,3,0,1,0,58.09
雲林縣,麥寮鄉,興華村,351,1,429,5,434,711,3,1,3,0,1,0,61.04
雲林縣,麥寮鄉,興華村,352,1,646,2,648,1121,3,1,3,0,1,0,57.81
雲林縣,麥寮鄉,海豐村,353,1,506,4,510,778,3,1,3,0,1,0,65.55
雲林縣,麥寮鄉,海豐村,354,1,350,4,354,552,3,1,3,0,1,0,64.13
雲林縣,麥寮鄉,後安村,355,1,581,7,588,903,3,1,3,0,1,0,65.12
雲林縣,麥寮鄉,後安村,356,1,639,8,647,965,3,1,3,0,1,0,67.05
雲林縣,麥寮鄉,三盛村,357,1,481,8,489,816,3,1,3,0,1,0,59.93
雲林縣,麥寮鄉,三盛村,358,1,706,12,718,1137,3,1,3,0,1,0,63.15
雲林縣,麥寮鄉,崙後村,359,1,504,9,513,869,3,1,3,0,1,0,59.03
雲林縣,麥寮鄉,崙後村,360,1,554,16,570,931,3,1,3,0,1,0,61.22
雲林縣,麥寮鄉,橋頭村,361,1,509,10,519,716,3,1,3,0,1,0,72.49
雲林縣,麥寮鄉,橋頭村,362,1,1031,16,1047,1634,3,1,3,0,1,0,64.08
雲林縣,麥寮鄉,新吉村,363,1,460,7,467,757,3,1,3,0,1,0,61.69
雲林縣,麥寮鄉,施厝村,364,1,661,10,671,1054,3,1,3,0,1,0,63.66
雲林縣,麥寮鄉,施厝村,365,1,645,7,652,947,3,1,3,0,1,0,68.85
雲林縣,麥寮鄉,雷厝村,366,1,774,23,797,1363,3,1,3,0,1,0,58.47
雲林縣,東勢鄉,月眉村,367,1,712,13,725,1350,3,1,3,0,1,0,53.70
雲林縣,東勢鄉,復興村,368,1,292,2,294,456,3,1,3,0,1,0,64.47
雲林縣,東勢鄉,嘉隆村,369,1,554,9,563,1007,3,1,3,0,1,0,55.91
雲林縣,東勢鄉,嘉隆村,370,1,438,6,444,758,3,1,3,0,1,0,58.58
雲林縣,東勢鄉,東南村,371,1,864,11,875,1410,3,1,3,0,1,0,62.06
雲林縣,東勢鄉,東北村,372,1,698,4,702,1143,3,1,3,0,1,0,61.42
雲林縣,東勢鄉,昌南村,373,1,563,7,570,963,3,1,3,0,1,0,59.19
雲林縣,東勢鄉,同安村,374,1,616,12,628,1028,3,1,3,0,1,0,61.09
雲林縣,東勢鄉,同安村,375,1,656,12,668,1057,3,1,3,0,1,0,63.20
雲林縣,東勢鄉,四美村,376,1,580,4,584,810,3,1,3,0,1,0,72.10
雲林縣,東勢鄉,四美村,377,1,292,4,296,451,3,1,3,0,1,0,65.63
雲林縣,東勢鄉,新坤村,378,1,661,5,666,1212,3,1,3,0,1,0,54.95
雲林縣,東勢鄉,安南村,379,1,550,8,558,975,3,1,3,0,1,0,57.23
雲林縣,東勢鄉,龍潭村,380,1,581,4,585,1036,3,1,3,0,1,0,56.47
雲林縣,東勢鄉,程海村,381,1,352,6,358,579,3,1,3,0,1,0,61.83
雲林縣,褒忠鄉,中民村,382,1,1197,14,1211,1688,3,1,3,0,1,0,71.74
雲林縣,褒忠鄉,埔姜村,383,1,853,6,859,1275,3,1,3,0,1,0,67.37
雲林縣,褒忠鄉,中勝村,384,1,871,12,883,1274,3,1,3,0,1,0,69.31
雲林縣,褒忠鄉,馬鳴村,385,1,240,1,241,396,3,1,3,0,1,0,60.86
雲林縣,褒忠鄉,馬鳴村,386,1,594,10,604,919,3,1,3,0,1,0,65.72
雲林縣,褒忠鄉,新湖村,387,1,319,4,323,491,3,1,3,0,1,0,65.78
雲林縣,褒忠鄉,新湖村,388,1,492,8,500,761,3,1,3,0,1,0,65.70
雲林縣,褒忠鄉,有才村,389,1,549,8,557,891,3,1,3,0,1,0,62.51
雲林縣,褒忠鄉,田洋村,390,1,572,13,585,858,3,1,3,0,1,0,68.18
雲林縣,褒忠鄉,龍岩村,391,1,760,10,770,1241,3,1,3,0,1,0,62.05
雲林縣,褒忠鄉,潮厝村,392,1,583,6,589,973,3,1,3,0,1,0,60.53
雲林縣,台西鄉,台西村,393,1,969,12,981,1347,3,1,3,0,1,0,72.83
雲林縣,台西鄉,海南村,394,1,655,11,666,985,3,1,3,0,1,0,67.61
雲林縣,台西鄉,海北村,395,1,717,11,728,964,3,1,3,0,1,0,75.52
雲林縣,台西鄉,海口村,396,1,755,11,766,983,3,1,3,0,1,0,77.92
雲林縣,台西鄉,海口村,397,1,586,14,600,839,3,1,3,0,1,0,71.51
雲林縣,台西鄉,山寮村,398,1,673,9,682,968,3,1,3,0,1,0,70.45
雲林縣,台西鄉,溪頂村,399,1,803,15,818,1557,3,1,3,0,1,0,52.54
雲林縣,台西鄉,牛厝村,400,1,796,8,804,1394,3,1,3,0,1,0,57.68
雲林縣,台西鄉,牛厝村,401,1,450,14,464,719,3,1,3,0,1,0,64.53
雲林縣,台西鄉,泉州村,402,1,394,7,401,621,3,1,3,0,1,0,64.57
雲林縣,台西鄉,五榔村,403,1,351,2,353,578,3,1,3,0,1,0,61.07
雲林縣,台西鄉,光華村,404,1,516,14,530,696,3,1,3,0,1,0,76.15
雲林縣,台西鄉,五港村,405,1,883,7,890,1170,3,1,3,0,1,0,76.07
雲林縣,台西鄉,五港村,406,1,489,2,491,618,3,1,3,0,1,0,79.45
雲林縣,台西鄉,富琦村,407,1,715,10,725,1011,3,1,3,0,1,0,71.71
雲林縣,台西鄉,富琦村,408,1,418,2,420,528,3,1,3,0,1,0,79.55
雲林縣,台西鄉,永豐村,409,1,1039,16,1055,1390,3,1,3,0,1,0,75.90
雲林縣,台西鄉,和豐村,410,1,767,3,770,1050,3,1,3,0,1,0,73.33
雲林縣,台西鄉,和豐村,411,1,778,10,788,1022,3,1,3,0,1,0,77.10
雲林縣,台西鄉,和豐村,412,1,709,15,724,1157,3,1,3,0,1,0,62.58
雲林縣,台西鄉,蚊港村,413,1,972,8,980,1220,3,1,3,0,1,0,80.33
雲林縣,台西鄉,蚊港村,414,1,541,4,545,704,3,1,3,0,1,0,77.41
雲林縣,元長鄉,長南村,415,1,1022,13,1035,1582,3,1,3,0,1,0,65.42
雲林縣,元長鄉,長南村,416,1,772,6,778,1308,3,1,3,0,1,0,59.48
雲林縣,元長鄉,長北村,417,1,489,6,495,816,3,1,3,0,1,0,60.66
雲林縣,元長鄉,長北村,418,1,438,5,443,768,3,1,3,0,1,0,57.68
雲林縣,元長鄉,子茂村,419,1,831,6,837,1449,3,1,3,0,1,0,57.76
雲林縣,元長鄉,後湖村,420,1,482,4,486,765,3,1,3,0,1,0,63.53
雲林縣,元長鄉,山內村,421,1,678,5,683,1032,3,1,3,0,1,0,66.18
雲林縣,元長鄉,合和村,422,1,646,3,649,1165,3,1,3,0,1,0,55.71
雲林縣,元長鄉,五塊村,423,1,584,5,589,1059,3,1,3,0,1,0,55.62
雲林縣,元長鄉,潭西村,424,1,524,6,530,1005,3,1,3,0,1,0,52.74
雲林縣,元長鄉,潭東村,425,1,434,2,436,720,3,1,3,0,1,0,60.56
雲林縣,元長鄉,客厝村,426,1,456,3,459,832,3,1,3,0,1,0,55.17
雲林縣,元長鄉,卓運村,427,1,280,4,284,483,3,1,3,0,1,0,58.80
雲林縣,元長鄉,頂寮村,428,1,688,7,695,1236,3,1,3,0,1,0,56.23
雲林縣,元長鄉,下寮村,429,1,801,7,808,1491,3,1,3,0,1,0,54.19
雲林縣,元長鄉,龍岩村,430,1,664,5,669,1147,3,1,3,0,1,0,58.33
雲林縣,元長鄉,西莊村,431,1,519,10,529,931,3,1,3,0,1,0,56.82
雲林縣,元長鄉,鹿北村,432,1,892,7,899,1381,3,1,3,0,1,0,65.10
雲林縣,元長鄉,鹿南村,433,1,630,3,633,1067,3,1,3,0,1,0,59.33
雲林縣,元長鄉,瓦窯村,434,1,466,5,471,804,3,1,3,0,1,0,58.58
雲林縣,元長鄉,瓦窯村,435,1,574,8,582,910,3,1,3,0,1,0,63.96
雲林縣,元長鄉,內寮村,436,1,433,3,436,741,3,1,3,0,1,0,58.84
雲林縣,元長鄉,崙仔村,437,1,586,11,597,994,3,1,3,0,1,0,60.06
雲林縣,元長鄉,新吉村,438,1,487,3,490,747,3,1,3,0,1,0,65.60
雲林縣,四湖鄉,四湖村,439,1,937,9,946,1691,3,1,3,0,1,0,55.94
雲林縣,四湖鄉,湖西村,440,1,894,11,905,1449,3,1,3,0,1,0,62.46
雲林縣,四湖鄉,湖西村,441,1,338,6,344,643,3,1,3,0,1,0,53.50
雲林縣,四湖鄉,新庄村,442,1,425,7,432,777,3,1,3,0,1,0,55.60
雲林縣,四湖鄉,溪底村,443,1,706,10,716,1225,3,1,3,0,1,0,58.45
雲林縣,四湖鄉,鹿場村,444,1,572,5,577,1176,3,1,3,0,1,0,49.06
雲林縣,四湖鄉,蔡厝村,445,1,562,4,566,1042,3,1,3,0,1,0,54.32
雲林縣,四湖鄉,湖寮村,446,1,418,6,424,917,3,1,3,0,1,0,46.24
雲林縣,四湖鄉,施湖村,447,1,625,8,633,1330,3,1,3,0,1,0,47.59
雲林縣,四湖鄉,羊調村,448,1,583,10,593,1148,3,1,3,0,1,0,51.66
雲林縣,四湖鄉,內湖村,449,1,396,7,403,1009,3,1,3,0,1,0,39.94
雲林縣,四湖鄉,飛東村,450,1,474,3,477,705,3,1,3,0,1,0,67.66
雲林縣,四湖鄉,飛沙村,451,1,848,12,860,1060,3,1,3,0,1,0,81.13
雲林縣,四湖鄉,三姓村,452,1,222,5,227,421,3,1,3,0,1,0,53.92
雲林縣,四湖鄉,崙北村,453,1,534,8,542,996,3,1,3,0,1,0,54.42
雲林縣,四湖鄉,崙北村,454,1,425,7,432,800,3,1,3,0,1,0,54.00
雲林縣,四湖鄉,崙南村,455,1,489,10,499,983,3,1,3,0,1,0,50.76
雲林縣,四湖鄉,廣溝村,456,1,454,6,460,784,3,1,3,0,1,0,58.67
雲林縣,四湖鄉,箔子村,457,1,670,8,678,1050,3,1,3,0,1,0,64.57
雲林縣,四湖鄉,箔東村,458,1,726,11,737,1177,3,1,3,0,1,0,62.62
雲林縣,四湖鄉,林厝村,459,1,634,10,644,1347,3,1,3,0,1,0,47.81
雲林縣,四湖鄉,林東村,460,1,516,9,525,1129,3,1,3,0,1,0,46.50
雲林縣,四湖鄉,溪尾村,461,1,414,6,420,917,3,1,3,0,1,0,45.80
雲林縣,口湖鄉,口湖村,462,1,602,4,606,942,3,1,3,0,1,0,64.33
雲林縣,口湖鄉,湖東村,463,1,785,16,801,1252,3,1,3,0,1,0,63.98
雲林縣,口湖鄉,頂湖村,464,1,491,5,496,779,3,1,3,0,1,0,63.67
雲林縣,口湖鄉,埔南村,465,1,408,2,410,651,3,1,3,0,1,0,62.98
雲林縣,口湖鄉,埔北村,466,1,481,8,489,957,3,1,3,0,1,0,51.10
雲林縣,口湖鄉,謝厝村,467,1,562,8,570,939,3,1,3,0,1,0,60.70
雲林縣,口湖鄉,蚵寮村,468,1,878,14,892,1419,3,1,3,0,1,0,62.86
雲林縣,口湖鄉,下崙村,469,1,418,18,436,923,3,1,3,0,1,0,47.24
雲林縣,口湖鄉,下崙村,470,1,570,2,572,1037,3,1,3,0,1,0,55.16
雲林縣,口湖鄉,崙中村,471,1,479,12,491,882,3,1,3,0,1,0,55.67
雲林縣,口湖鄉,崙中村,472,1,491,5,496,879,3,1,3,0,1,0,56.43
雲林縣,口湖鄉,崙東村,473,1,861,11,872,1500,3,1,3,0,1,0,58.13
雲林縣,口湖鄉,青蚶村,474,1,338,1,339,556,3,1,3,0,1,0,60.97
雲林縣,口湖鄉,港東村,475,1,899,10,909,1344,3,1,3,0,1,0,67.63
雲林縣,口湖鄉,港西村,476,1,520,8,528,780,3,1,3,0,1,0,67.69
雲林縣,口湖鄉,台子村,477,1,206,2,208,347,3,1,3,0,1,0,59.94
雲林縣,口湖鄉,台子村,478,1,759,9,768,1145,3,1,3,0,1,0,67.07
雲林縣,口湖鄉,成龍村,479,1,697,12,709,1042,3,1,3,0,1,0,68.04
雲林縣,口湖鄉,梧南村,480,1,525,5,530,903,3,1,3,0,1,0,58.69
雲林縣,口湖鄉,梧南村,481,1,556,7,563,932,3,1,3,0,1,0,60.41
雲林縣,口湖鄉,梧北村,482,1,743,6,749,1344,3,1,3,0,1,0,55.73
雲林縣,口湖鄉,水井村,483,1,627,4,631,1058,3,1,3,0,1,0,59.64
雲林縣,口湖鄉,後厝村,484,1,464,3,467,808,3,1,3,0,1,0,57.80
雲林縣,口湖鄉,湖口村,485,1,560,8,568,993,3,1,3,0,1,0,57.20
雲林縣,口湖鄉,過港村,486,1,471,4,475,747,3,1,3,0,1,0,63.59
雲林縣,水林鄉,水北村,487,1,803,15,818,1290,3,1,3,0,1,0,63.41
雲林縣,水林鄉,水北村,488,1,585,14,599,858,3,1,3,0,1,0,69.81
雲林縣,水林鄉,水南村,489,1,704,13,717,981,3,1,3,0,1,0,73.09
雲林縣,水林鄉,水南村,490,1,516,9,525,789,3,1,3,0,1,0,66.54
雲林縣,水林鄉,萬興村,491,1,497,9,506,818,3,1,3,0,1,0,61.86
雲林縣,水林鄉,尖山村,492,1,460,6,466,728,3,1,3,0,1,0,64.01
雲林縣,水林鄉,大溝村,493,1,737,12,749,1109,3,1,3,0,1,0,67.54
雲林縣,水林鄉,順興村,494,1,490,16,506,935,3,1,3,0,1,0,54.12
雲林縣,水林鄉,大山村,495,1,802,8,810,1248,3,1,3,0,1,0,64.90
雲林縣,水林鄉,後寮村,496,1,519,15,534,851,3,1,3,0,1,0,62.75
雲林縣,水林鄉,春埔村,497,1,628,5,633,1130,3,1,3,0,1,0,56.02
雲林縣,水林鄉,西井村,498,1,425,7,432,719,3,1,3,0,1,0,60.08
雲林縣,水林鄉,車港村,499,1,409,6,415,722,3,1,3,0,1,0,57.48
雲林縣,水林鄉,蘇秦村,500,1,741,11,752,1310,3,1,3,0,1,0,57.40
雲林縣,水林鄉,灣東村,501,1,443,3,446,801,3,1,3,0,1,0,55.68
雲林縣,水林鄉,灣西村,502,1,627,8,635,1121,3,1,3,0,1,0,56.65
雲林縣,水林鄉,蕃薯村,503,1,598,5,603,1089,3,1,3,0,1,0,55.37
雲林縣,水林鄉,山腳村,504,1,555,11,566,918,3,1,3,0,1,0,61.66
雲林縣,水林鄉,松北村,505,1,764,11,775,1256,3,1,3,0,1,0,61.70
雲林縣,水林鄉,松中村,506,1,387,3,390,668,3,1,3,0,1,0,58.38
雲林縣,水林鄉,松西村,507,1,500,12,512,915,3,1,3,0,1,0,55.96
雲林縣,水林鄉,舊埔村,508,1,532,6,538,916,3,1,3,0,1,0,58.73
雲林縣,水林鄉,塭底村,509,1,494,7,501,834,3,1,3,0,1,0,60.07
雲林縣,水林鄉,海埔村,510,1,727,9,736,1118,3,1,3,0,1,0,65.83
雲林縣,水林鄉,土厝村,511,1,856,8,864,1300,3,1,3,0,1,0,66.46
雲林縣,水林鄉,溪墘村,512,1,531,7,538,840,3,1,3,0,1,0,64.05
嘉義縣,太保市,太保里,1,1,898,15,913,1478,3,1,3,0,1,0,61.77
嘉義縣,太保市,後庄里,2,1,287,3,290,438,3,1,3,0,1,0,66.21
嘉義縣,太保市,前潭里,3,1,832,8,840,1354,3,1,3,0,1,0,62.04
嘉義縣,太保市,後潭里,4,1,811,10,821,1362,3,1,3,0,1,0,60.28
嘉義縣,太保市,梅埔里,5,1,489,6,495,698,3,1,3,0,1,0,70.92
嘉義縣,太保市,梅埔里,6,1,251,6,257,360,3,1,3,0,1,0,71.39
嘉義縣,太保市,春珠里,7,1,438,5,443,752,3,1,3,0,1,0,58.91
嘉義縣,太保市,崙頂里,8,1,523,10,533,772,3,1,3,0,1,0,69.04
嘉義縣,太保市,安仁里,9,1,161,0,161,227,3,1,3,0,1,0,70.93
嘉義縣,太保市,安仁里,10,1,277,3,280,442,3,1,3,0,1,0,63.35
嘉義縣,太保市,東勢里,11,1,520,5,525,856,3,1,3,0,1,0,61.33
嘉義縣,太保市,新埤里,12,1,658,14,672,1169,3,1,3,0,1,0,57.49
嘉義縣,太保市,舊埤里,13,1,478,5,483,904,3,1,3,0,1,0,53.43
嘉義縣,太保市,田尾里,14,1,297,9,306,498,3,1,3,0,1,0,61.45
嘉義縣,太保市,田尾里,15,1,152,2,154,231,3,1,3,0,1,0,66.67
嘉義縣,太保市,港尾里,16,1,194,4,198,326,3,1,3,0,1,0,60.74
嘉義縣,太保市,港尾里,17,1,170,3,173,258,3,1,3,0,1,0,67.05
嘉義縣,太保市,過溝里,18,1,323,8,331,589,3,1,3,0,1,0,56.20
嘉義縣,太保市,過溝里,19,1,548,4,552,943,3,1,3,0,1,0,58.54
嘉義縣,太保市,麻寮里,20,1,493,18,511,809,3,1,3,0,1,0,63.16
嘉義縣,太保市,麻寮里,21,1,693,12,705,1259,3,1,3,0,1,0,56.00
嘉義縣,太保市,南新里,22,1,852,13,865,1597,3,1,3,0,1,0,54.16
嘉義縣,太保市,北新里,23,1,1002,18,1020,1891,3,1,3,0,1,0,53.94
嘉義縣,太保市,埤鄉里,24,1,404,9,413,724,3,1,3,0,1,0,57.04
嘉義縣,朴子市,安福里,25,1,427,8,435,751,3,1,3,0,1,0,57.92
嘉義縣,朴子市,安福里,26,1,632,5,637,1059,3,1,3,0,1,0,60.15
嘉義縣,朴子市,平和里,27,1,1023,10,1033,1718,3,1,3,0,1,0,60.13
嘉義縣,朴子市,內厝里,28,1,726,6,732,1142,3,1,3,0,1,0,64.10
嘉義縣,朴子市,開元里,29,1,353,1,354,562,3,1,3,0,1,0,62.99
嘉義縣,朴子市,順天里,30,1,435,9,444,782,3,1,3,0,1,0,56.78
嘉義縣,朴子市,中正里,31,1,490,5,495,746,3,1,3,0,1,0,66.35
嘉義縣,朴子市,博厚里,32,1,514,7,521,791,3,1,3,0,1,0,65.87
嘉義縣,朴子市,文化里,33,1,544,2,546,916,3,1,3,0,1,0,59.61
嘉義縣,朴子市,文化里,34,1,575,6,581,965,3,1,3,0,1,0,60.21
嘉義縣,朴子市,永和里,35,1,576,10,586,913,3,1,3,0,1,0,64.18
嘉義縣,朴子市,永和里,36,1,820,14,834,1341,3,1,3,0,1,0,62.19
嘉義縣,朴子市,竹圍里,37,1,981,12,993,1610,3,1,3,0,1,0,61.68
嘉義縣,朴子市,竹圍里,38,1,908,14,922,1489,3,1,3,0,1,0,61.92
嘉義縣,朴子市,新寮里,39,1,395,9,404,600,3,1,3,0,1,0,67.33
嘉義縣,朴子市,双溪里,40,1,498,1,499,776,3,1,3,0,1,0,64.30
嘉義縣,朴子市,溪口里,41,1,520,3,523,806,3,1,3,0,1,0,64.89
嘉義縣,朴子市,德興里,42,1,621,5,626,955,3,1,3,0,1,0,65.55
嘉義縣,朴子市,仁和里,43,1,260,8,268,428,3,1,3,0,1,0,62.62
嘉義縣,朴子市,大鄉里,44,1,764,18,782,1200,3,1,3,0,1,0,65.17
嘉義縣,朴子市,大鄉里,45,1,774,14,788,1227,3,1,3,0,1,0,64.22
嘉義縣,朴子市,大葛里,46,1,944,24,968,1494,3,1,3,0,1,0,64.79
嘉義縣,朴子市,佳禾里,47,1,359,5,364,559,3,1,3,0,1,0,65.12
嘉義縣,朴子市,竹村里,48,1,505,7,512,921,3,1,3,0,1,0,55.59
嘉義縣,朴子市,崁前里,49,1,586,8,594,1005,3,1,3,0,1,0,59.10
嘉義縣,朴子市,崁後里,50,1,516,10,526,911,3,1,3,0,1,0,57.74
嘉義縣,朴子市,順安里,51,1,202,1,203,308,3,1,3,0,1,0,65.91
嘉義縣,朴子市,德家里,52,1,462,9,471,811,3,1,3,0,1,0,58.08
嘉義縣,朴子市,新庄里,53,1,366,3,369,569,3,1,3,0,1,0,64.85
嘉義縣,朴子市,梅華里,54,1,715,9,724,1204,3,1,3,0,1,0,60.13
嘉義縣,朴子市,松華里,55,1,830,12,842,1517,3,1,3,0,1,0,55.50
嘉義縣,朴子市,南竹里,56,1,345,4,349,581,3,1,3,0,1,0,60.07
嘉義縣,布袋鎮,岱江里,57,1,443,5,448,809,3,1,3,0,1,0,55.38
嘉義縣,布袋鎮,九龍里,58,1,261,5,266,449,3,1,3,0,1,0,59.24
嘉義縣,布袋鎮,岑海里,59,1,710,8,718,1170,3,1,3,0,1,0,61.37
嘉義縣,布袋鎮,興中里,60,1,696,19,715,1225,3,1,3,0,1,0,58.37
嘉義縣,布袋鎮,光復里,61,1,1078,16,1094,1805,3,1,3,0,1,0,60.61
嘉義縣,布袋鎮,見龍里,62,1,568,7,575,901,3,1,3,0,1,0,63.82
嘉義縣,布袋鎮,新厝里,63,1,457,12,469,791,3,1,3,0,1,0,59.29
嘉義縣,布袋鎮,龍江里,64,1,514,17,531,921,3,1,3,0,1,0,57.65
嘉義縣,布袋鎮,西安里,65,1,841,7,848,1528,3,1,3,0,1,0,55.50
嘉義縣,布袋鎮,中安里,66,1,865,12,877,1641,3,1,3,0,1,0,53.44
嘉義縣,布袋鎮,東安里,67,1,929,8,937,1608,3,1,3,0,1,0,58.27
嘉義縣,布袋鎮,樹林里,68,1,211,1,212,312,3,1,3,0,1,0,67.95
嘉義縣,布袋鎮,樹林里,69,1,173,8,181,284,3,1,3,0,1,0,63.73
嘉義縣,布袋鎮,貴舍里,70,1,270,2,272,471,3,1,3,0,1,0,57.75
嘉義縣,布袋鎮,貴舍里,71,1,179,2,181,293,3,1,3,0,1,0,61.77
嘉義縣,布袋鎮,永安里,72,1,747,13,760,1332,3,1,3,0,1,0,57.06
嘉義縣,布袋鎮,東港里,73,1,582,13,595,939,3,1,3,0,1,0,63.37
嘉義縣,布袋鎮,東港里,74,1,559,13,572,984,3,1,3,0,1,0,58.13
嘉義縣,布袋鎮,江山里,75,1,228,5,233,399,3,1,3,0,1,0,58.40
嘉義縣,布袋鎮,菜舖里,76,1,143,0,143,239,3,1,3,0,1,0,59.83
嘉義縣,布袋鎮,菜舖里,77,1,146,5,151,244,3,1,3,0,1,0,61.89
嘉義縣,布袋鎮,考試里,78,1,103,1,104,166,3,1,3,0,1,0,62.65
嘉義縣,布袋鎮,考試里,79,1,148,0,148,228,3,1,3,0,1,0,64.91
嘉義縣,布袋鎮,振寮里,80,1,567,12,579,845,3,1,3,0,1,0,68.52
嘉義縣,布袋鎮,新岑里,81,1,648,6,654,994,3,1,3,0,1,0,65.79
嘉義縣,布袋鎮,新民里,82,1,637,6,643,1178,3,1,3,0,1,0,54.58
嘉義縣,布袋鎮,復興里,83,1,579,1,580,1064,3,1,3,0,1,0,54.51
嘉義縣,布袋鎮,復興里,84,1,630,10,640,1211,3,1,3,0,1,0,52.85
嘉義縣,布袋鎮,好美里,85,1,625,8,633,1044,3,1,3,0,1,0,60.63
嘉義縣,大林鎮,東林里,86,1,335,8,343,546,3,1,3,0,1,0,62.82
嘉義縣,大林鎮,西林里,87,1,1132,16,1148,1868,3,1,3,0,1,0,61.46
嘉義縣,大林鎮,吉林里,88,1,606,5,611,1032,3,1,3,0,1,0,59.21
嘉義縣,大林鎮,平林里,89,1,1338,23,1361,2314,3,1,3,0,1,0,58.82
嘉義縣,大林鎮,平林里,90,1,887,18,905,1594,3,1,3,0,1,0,56.78
嘉義縣,大林鎮,明華里,91,1,745,10,755,1209,3,1,3,0,1,0,62.45
嘉義縣,大林鎮,明和里,92,1,763,2,765,1155,3,1,3,0,1,0,66.23
嘉義縣,大林鎮,排路里,93,1,438,1,439,714,3,1,3,0,1,0,61.48
嘉義縣,大林鎮,西結里,94,1,452,5,457,890,3,1,3,0,1,0,51.35
嘉義縣,大林鎮,湖北里,95,1,493,11,504,717,3,1,3,0,1,0,70.29
嘉義縣,大林鎮,大糖里,96,1,254,4,258,368,3,1,3,0,1,0,70.11
嘉義縣,大林鎮,大美里,97,1,1100,21,1121,1806,3,1,3,0,1,0,62.07
嘉義縣,大林鎮,過溪里,98,1,949,19,968,1527,3,1,3,0,1,0,63.39
嘉義縣,大林鎮,中坑里,99,1,804,18,822,1193,3,1,3,0,1,0,68.90
嘉義縣,大林鎮,中坑里,100,1,239,3,242,480,3,1,3,0,1,0,50.42
嘉義縣,大林鎮,上林里,101,1,613,6,619,972,3,1,3,0,1,0,63.68
嘉義縣,大林鎮,中林里,102,1,895,12,907,1564,3,1,3,0,1,0,57.99
嘉義縣,大林鎮,三和里,103,1,1053,7,1060,1719,3,1,3,0,1,0,61.66
嘉義縣,大林鎮,溝背里,104,1,639,13,652,1034,3,1,3,0,1,0,63.06
嘉義縣,大林鎮,義和里,105,1,434,6,440,701,3,1,3,0,1,0,62.77
嘉義縣,大林鎮,內林里,106,1,558,8,566,826,3,1,3,0,1,0,68.52
嘉義縣,大林鎮,三角里,107,1,770,15,785,1191,3,1,3,0,1,0,65.91
嘉義縣,大林鎮,三村里,108,1,432,7,439,705,3,1,3,0,1,0,62.27
嘉義縣,民雄鄉,東榮村,109,1,670,11,681,1101,3,1,3,0,1,0,61.85
嘉義縣,民雄鄉,東榮村,110,1,538,2,540,892,3,1,3,0,1,0,60.54
嘉義縣,民雄鄉,中樂村,111,1,876,13,889,1518,3,1,3,0,1,0,58.56
嘉義縣,民雄鄉,西安村,112,1,770,7,777,1339,3,1,3,0,1,0,58.03
嘉義縣,民雄鄉,西安村,113,1,782,7,789,1322,3,1,3,0,1,0,59.68
嘉義縣,民雄鄉,寮頂村,114,1,1042,20,1062,1812,3,1,3,0,1,0,58.61
嘉義縣,民雄鄉,福權村,115,1,652,9,661,1033,3,1,3,0,1,0,63.99
嘉義縣,民雄鄉,東湖村,116,1,1161,17,1178,1748,3,1,3,0,1,0,67.39
嘉義縣,民雄鄉,頂崙村,117,1,772,12,784,1294,3,1,3,0,1,0,60.59
嘉義縣,民雄鄉,豐收村,118,1,854,19,873,1342,3,1,3,0,1,0,65.05
嘉義縣,民雄鄉,豐收村,119,1,281,2,283,399,3,1,3,0,1,0,70.93
嘉義縣,民雄鄉,三興村,120,1,495,12,507,794,3,1,3,0,1,0,63.85
嘉義縣,民雄鄉,東興村,121,1,331,0,331,626,3,1,3,0,1,0,52.88
嘉義縣,民雄鄉,鎮北村,122,1,492,8,500,753,3,1,3,0,1,0,66.40
嘉義縣,民雄鄉,菁埔村,123,1,953,14,967,1624,3,1,3,0,1,0,59.54
嘉義縣,民雄鄉,中和村,124,1,426,11,437,674,3,1,3,0,1,0,64.84
嘉義縣,民雄鄉,平和村,125,1,407,3,410,621,3,1,3,0,1,0,66.02
嘉義縣,民雄鄉,西昌村,126,1,411,4,415,695,3,1,3,0,1,0,59.71
嘉義縣,民雄鄉,興中村,127,1,834,20,854,1467,3,1,3,0,1,0,58.21
嘉義縣,民雄鄉,興南村,128,1,989,26,1015,1853,3,1,3,0,1,0,54.78
嘉義縣,民雄鄉,金興村,129,1,1191,17,1208,2066,3,1,3,0,1,0,58.47
嘉義縣,民雄鄉,福興村,130,1,883,23,906,1523,3,1,3,0,1,0,59.49
嘉義縣,民雄鄉,文隆村,131,1,1021,18,1039,1783,3,1,3,0,1,0,58.27
嘉義縣,民雄鄉,山中村,132,1,1067,13,1080,1637,3,1,3,0,1,0,65.97
嘉義縣,民雄鄉,山中村,133,1,802,12,814,1269,3,1,3,0,1,0,64.14
嘉義縣,民雄鄉,中央村,134,1,751,4,755,1090,3,1,3,0,1,0,69.27
嘉義縣,民雄鄉,北斗村,135,1,1162,20,1182,2183,3,1,3,0,1,0,54.15
嘉義縣,民雄鄉,北斗村,136,1,279,5,284,435,3,1,3,0,1,0,65.29
嘉義縣,民雄鄉,雙福村,137,1,852,15,867,1376,3,1,3,0,1,0,63.01
嘉義縣,民雄鄉,福樂村,138,1,1395,29,1424,2577,3,1,3,0,1,0,55.26
嘉義縣,民雄鄉,大崎村,139,1,1055,25,1080,1743,3,1,3,0,1,0,61.96
嘉義縣,民雄鄉,秀林村,140,1,1025,17,1042,1758,3,1,3,0,1,0,59.27
嘉義縣,民雄鄉,松山村,141,1,774,7,781,1505,3,1,3,0,1,0,51.89
嘉義縣,溪口鄉,溪東村,142,1,806,8,814,1352,3,1,3,0,1,0,60.21
嘉義縣,溪口鄉,溪西村,143,1,452,9,461,826,3,1,3,0,1,0,55.81
嘉義縣,溪口鄉,溪北村,144,1,245,1,246,414,3,1,3,0,1,0,59.42
嘉義縣,溪口鄉,溪北村,145,1,165,3,168,331,3,1,3,0,1,0,50.76
嘉義縣,溪口鄉,柴林村,146,1,463,3,466,875,3,1,3,0,1,0,53.26
嘉義縣,溪口鄉,林腳村,147,1,509,6,515,976,3,1,3,0,1,0,52.77
嘉義縣,溪口鄉,美南村,148,1,671,11,682,1222,3,1,3,0,1,0,55.81
嘉義縣,溪口鄉,美北村,149,1,528,11,539,1023,3,1,3,0,1,0,52.69
嘉義縣,溪口鄉,本厝村,150,1,370,7,377,579,3,1,3,0,1,0,65.11
嘉義縣,溪口鄉,本厝村,151,1,259,1,260,378,3,1,3,0,1,0,68.78
嘉義縣,溪口鄉,游東村,152,1,622,10,632,1121,3,1,3,0,1,0,56.38
嘉義縣,溪口鄉,游西村,153,1,409,7,416,802,3,1,3,0,1,0,51.87
嘉義縣,溪口鄉,柳溝村,154,1,739,12,751,1242,3,1,3,0,1,0,60.47
嘉義縣,溪口鄉,疊溪村,155,1,522,5,527,949,3,1,3,0,1,0,55.53
嘉義縣,溪口鄉,妙崙村,156,1,430,3,433,764,3,1,3,0,1,0,56.68
嘉義縣,溪口鄉,坪頂村,157,1,533,16,549,861,3,1,3,0,1,0,63.76
嘉義縣,新港鄉,宮前村,158,1,908,8,916,1574,3,1,3,0,1,0,58.20
嘉義縣,新港鄉,宮後村,159,1,904,16,920,1697,3,1,3,0,1,0,54.21
嘉義縣,新港鄉,大興村,160,1,819,11,830,1350,3,1,3,0,1,0,61.48
嘉義縣,新港鄉,福德村,161,1,749,12,761,1412,3,1,3,0,1,0,53.90
嘉義縣,新港鄉,古民村,162,1,648,6,654,1178,3,1,3,0,1,0,55.52
嘉義縣,新港鄉,中庄村,163,1,869,9,878,1507,3,1,3,0,1,0,58.26
嘉義縣,新港鄉,大潭村,164,1,906,19,925,1571,3,1,3,0,1,0,58.88
嘉義縣,新港鄉,西庄村,165,1,489,7,496,920,3,1,3,0,1,0,53.91
嘉義縣,新港鄉,月眉村,166,1,921,24,945,1605,3,1,3,0,1,0,58.88
嘉義縣,新港鄉,月潭村,167,1,858,17,875,1434,3,1,3,0,1,0,61.02
嘉義縣,新港鄉,溪北村,168,1,809,12,821,1397,3,1,3,0,1,0,58.77
嘉義縣,新港鄉,菜公村,169,1,489,4,493,808,3,1,3,0,1,0,61.01
嘉義縣,新港鄉,中洋村,170,1,71,8,79,957,3,1,3,0,1,0,8.25
嘉義縣,新港鄉,三間村,171,1,55,1,56,692,3,1,3,0,1,0,8.09
嘉義縣,新港鄉,安和村,172,1,674,15,689,1153,3,1,3,0,1,0,59.76
嘉義縣,新港鄉,潭大村,173,1,599,10,609,1155,3,1,3,0,1,0,52.73
嘉義縣,新港鄉,南港村,174,1,541,27,568,1104,3,1,3,0,1,0,51.45
嘉義縣,新港鄉,板頭村,175,1,380,6,386,666,3,1,3,0,1,0,57.96
嘉義縣,新港鄉,共和村,176,1,395,4,399,797,3,1,3,0,1,0,50.06
嘉義縣,新港鄉,埤子村,177,1,317,6,323,599,3,1,3,0,1,0,53.92
嘉義縣,新港鄉,南崙村,178,1,517,8,525,979,3,1,3,0,1,0,53.63
嘉義縣,新港鄉,北崙村,179,1,329,2,331,646,3,1,3,0,1,0,51.24
嘉義縣,新港鄉,海瀛村,180,1,289,2,291,502,3,1,3,0,1,0,57.97
嘉義縣,六腳鄉,蒜頭村,181,1,784,13,797,1275,3,1,3,0,1,0,62.51
嘉義縣,六腳鄉,蒜東村,182,1,509,4,513,964,3,1,3,0,1,0,53.22
嘉義縣,六腳鄉,蒜南村,183,1,500,12,512,867,3,1,3,0,1,0,59.05
嘉義縣,六腳鄉,工廠村,184,1,286,14,300,403,3,1,3,0,1,0,74.44
嘉義縣,六腳鄉,灣南村,185,1,765,12,777,1251,3,1,3,0,1,0,62.11
嘉義縣,六腳鄉,灣北村,186,1,760,8,768,1382,3,1,3,0,1,0,55.57
嘉義縣,六腳鄉,雙涵村,187,1,490,5,495,869,3,1,3,0,1,0,56.96
嘉義縣,六腳鄉,塗師村,188,1,488,4,492,760,3,1,3,0,1,0,64.74
嘉義縣,六腳鄉,三義村,189,1,327,4,331,611,3,1,3,0,1,0,54.17
嘉義縣,六腳鄉,三義村,190,1,115,2,117,202,3,1,3,0,1,0,57.92
嘉義縣,六腳鄉,正義村,191,1,146,1,147,274,3,1,3,0,1,0,53.65
嘉義縣,六腳鄉,正義村,192,1,183,1,184,310,3,1,3,0,1,0,59.35
嘉義縣,六腳鄉,正義村,193,1,242,1,243,407,3,1,3,0,1,0,59.71
嘉義縣,六腳鄉,正義村,194,1,241,5,246,409,3,1,3,0,1,0,60.15
嘉義縣,六腳鄉,溪厝村,195,1,379,8,387,676,3,1,3,0,1,0,57.25
嘉義縣,六腳鄉,港美村,196,1,445,9,454,805,3,1,3,0,1,0,56.40
嘉義縣,六腳鄉,豐美村,197,1,578,9,587,1132,3,1,3,0,1,0,51.86
嘉義縣,六腳鄉,六斗村,198,1,461,14,475,825,3,1,3,0,1,0,57.58
嘉義縣,六腳鄉,崙陽村,199,1,555,7,562,1046,3,1,3,0,1,0,53.73
嘉義縣,六腳鄉,蘇厝村,200,1,753,7,760,1396,3,1,3,0,1,0,54.44
嘉義縣,六腳鄉,竹本村,201,1,390,5,395,752,3,1,3,0,1,0,52.53
嘉義縣,六腳鄉,永賢村,202,1,333,5,338,618,3,1,3,0,1,0,54.69
嘉義縣,六腳鄉,魚寮村,203,1,455,3,458,870,3,1,3,0,1,0,52.64
嘉義縣,六腳鄉,潭墘村,204,1,547,9,556,998,3,1,3,0,1,0,55.71
嘉義縣,六腳鄉,六腳村,205,1,539,7,546,975,3,1,3,0,1,0,56.00
嘉義縣,六腳鄉,六南村,206,1,399,5,404,725,3,1,3,0,1,0,55.72
嘉義縣,六腳鄉,崩山村,207,1,459,6,465,835,3,1,3,0,1,0,55.69
嘉義縣,六腳鄉,古林村,208,1,512,9,521,936,3,1,3,0,1,0,55.66
嘉義縣,六腳鄉,更寮村,209,1,231,2,233,417,3,1,3,0,1,0,55.88
嘉義縣,六腳鄉,更寮村,210,1,170,2,172,288,3,1,3,0,1,0,59.72
嘉義縣,東石鄉,東石村,211,1,893,14,907,1617,3,1,3,0,1,0,56.09
嘉義縣,東石鄉,猿樹村,212,1,540,6,546,1010,3,1,3,0,1,0,54.06
嘉義縣,東石鄉,塭港村,213,1,825,15,840,1477,3,1,3,0,1,0,56.87
嘉義縣,東石鄉,型厝村,214,1,869,13,882,1476,3,1,3,0,1,0,59.76
嘉義縣,東石鄉,三家村,215,1,672,5,677,1251,3,1,3,0,1,0,54.12
嘉義縣,東石鄉,永屯村,216,1,405,4,409,715,3,1,3,0,1,0,57.20
嘉義縣,東石鄉,海埔村,217,1,265,1,266,475,3,1,3,0,1,0,56.00
嘉義縣,東石鄉,龍港村,218,1,602,5,607,1094,3,1,3,0,1,0,55.48
嘉義縣,東石鄉,副瀨村,219,1,771,12,783,1132,3,1,3,0,1,0,69.17
嘉義縣,東石鄉,下揖村,220,1,506,9,515,937,3,1,3,0,1,0,54.96
嘉義縣,東石鄉,頂揖村,221,1,128,0,128,214,3,1,3,0,1,0,59.81
嘉義縣,東石鄉,頂揖村,222,1,118,0,118,266,3,1,3,0,1,0,44.36
嘉義縣,東石鄉,溪下村,223,1,616,9,625,1136,3,1,3,0,1,0,55.02
嘉義縣,東石鄉,港口村,224,1,223,0,223,418,3,1,3,0,1,0,53.35
嘉義縣,東石鄉,鰲鼓村,225,1,649,13,662,1052,3,1,3,0,1,0,62.93
嘉義縣,東石鄉,鰲鼓村,226,1,185,0,185,332,3,1,3,0,1,0,55.72
嘉義縣,東石鄉,港墘村,227,1,811,14,825,1298,3,1,3,0,1,0,63.56
嘉義縣,東石鄉,蔦松村,228,1,601,3,604,938,3,1,3,0,1,0,64.39
嘉義縣,東石鄉,圍潭村,229,1,433,11,444,830,3,1,3,0,1,0,53.49
嘉義縣,東石鄉,洲仔村,230,1,548,7,555,936,3,1,3,0,1,0,59.29
嘉義縣,東石鄉,東崙村,231,1,242,4,246,428,3,1,3,0,1,0,57.48
嘉義縣,東石鄉,東崙村,232,1,247,5,252,420,3,1,3,0,1,0,60.00
嘉義縣,東石鄉,西崙村,233,1,600,13,613,991,3,1,3,0,1,0,61.86
嘉義縣,東石鄉,塭仔村,234,1,589,5,594,1022,3,1,3,0,1,0,58.12
嘉義縣,東石鄉,網寮村,235,1,636,3,639,1211,3,1,3,0,1,0,52.77
嘉義縣,東石鄉,掌潭村,236,1,277,1,278,471,3,1,3,0,1,0,59.02
嘉義縣,東石鄉,掌潭村,237,1,231,3,234,354,3,1,3,0,1,0,66.10
嘉義縣,義竹鄉,岸腳村,238,1,575,17,592,869,3,1,3,0,1,0,68.12
嘉義縣,義竹鄉,義竹村,239,1,993,18,1011,1597,3,1,3,0,1,0,63.31
嘉義縣,義竹鄉,六桂村,240,1,959,9,968,1382,3,1,3,0,1,0,70.04
嘉義縣,義竹鄉,仁里村,241,1,677,7,684,898,3,1,3,0,1,0,76.17
嘉義縣,義竹鄉,傳芳村,242,1,429,8,437,695,3,1,3,0,1,0,62.88
嘉義縣,義竹鄉,頭竹村,243,1,921,15,936,1316,3,1,3,0,1,0,71.12
嘉義縣,義竹鄉,五厝村,244,1,269,2,271,403,3,1,3,0,1,0,67.25
嘉義縣,義竹鄉,中平村,245,1,257,2,259,396,3,1,3,0,1,0,65.40
嘉義縣,義竹鄉,中平村,246,1,91,0,91,137,3,1,3,0,1,0,66.42
嘉義縣,義竹鄉,埤前村,247,1,570,9,579,819,3,1,3,0,1,0,70.70
嘉義縣,義竹鄉,平溪村,248,1,296,2,298,434,3,1,3,0,1,0,68.66
嘉義縣,義竹鄉,後鎮村,249,1,376,6,382,546,3,1,3,0,1,0,69.96
嘉義縣,義竹鄉,北華村,250,1,394,2,396,569,3,1,3,0,1,0,69.60
嘉義縣,義竹鄉,新店村,251,1,964,7,971,1479,3,1,3,0,1,0,65.65
嘉義縣,義竹鄉,東過村,252,1,538,8,546,871,3,1,3,0,1,0,62.69
嘉義縣,義竹鄉,西過村,253,1,563,9,572,947,3,1,3,0,1,0,60.40
嘉義縣,義竹鄉,官和村,254,1,552,6,558,835,3,1,3,0,1,0,66.83
嘉義縣,義竹鄉,官順村,255,1,335,5,340,570,3,1,3,0,1,0,59.65
嘉義縣,義竹鄉,新富村,256,1,415,7,422,546,3,1,3,0,1,0,77.29
嘉義縣,義竹鄉,東光村,257,1,491,5,496,727,3,1,3,0,1,0,68.23
嘉義縣,義竹鄉,東光村,258,1,115,3,118,186,3,1,3,0,1,0,63.44
嘉義縣,義竹鄉,東榮村,259,1,345,5,350,531,3,1,3,0,1,0,65.91
嘉義縣,義竹鄉,龍蛟村,260,1,479,4,483,773,3,1,3,0,1,0,62.48
嘉義縣,義竹鄉,溪洲村,261,1,512,4,516,840,3,1,3,0,1,0,61.43
嘉義縣,鹿草鄉,後寮村,262,1,294,4,298,493,3,1,3,0,1,0,60.45
嘉義縣,鹿草鄉,鹿東村,263,1,408,7,415,659,3,1,3,0,1,0,62.97
嘉義縣,鹿草鄉,鹿草村,264,1,795,10,805,1250,3,1,3,0,1,0,64.40
嘉義縣,鹿草鄉,西井村,265,1,689,15,704,1162,3,1,3,0,1,0,60.59
嘉義縣,鹿草鄉,豐稠村,266,1,178,2,180,286,3,1,3,0,1,0,62.94
嘉義縣,鹿草鄉,豐稠村,267,1,72,0,72,127,3,1,3,0,1,0,56.69
嘉義縣,鹿草鄉,重寮村,268,1,739,10,749,1179,3,1,3,0,1,0,63.53
嘉義縣,鹿草鄉,施家村,269,1,326,8,334,561,3,1,3,0,1,0,59.54
嘉義縣,鹿草鄉,下潭村,270,1,593,6,599,1017,3,1,3,0,1,0,58.90
嘉義縣,鹿草鄉,光潭村,271,1,680,14,694,1173,3,1,3,0,1,0,59.16
嘉義縣,鹿草鄉,碧潭村,272,1,668,16,684,1149,3,1,3,0,1,0,59.53
嘉義縣,鹿草鄉,松竹村,273,1,553,11,564,973,3,1,3,0,1,0,57.97
嘉義縣,鹿草鄉,竹山村,274,1,409,5,414,700,3,1,3,0,1,0,59.14
嘉義縣,鹿草鄉,竹山村,275,1,126,3,129,237,3,1,3,0,1,0,54.43
嘉義縣,鹿草鄉,後堀村,276,1,663,11,674,1033,3,1,3,0,1,0,65.25
嘉義縣,鹿草鄉,後堀村,277,1,196,4,200,317,3,1,3,0,1,0,63.09
嘉義縣,鹿草鄉,三角村,278,1,702,12,714,1169,3,1,3,0,1,0,61.08
嘉義縣,鹿草鄉,三角村,279,1,237,1,238,364,3,1,3,0,1,0,65.38
嘉義縣,鹿草鄉,下麻村,280,1,191,2,193,300,3,1,3,0,1,0,64.33
嘉義縣,鹿草鄉,下麻村,281,1,178,2,180,278,3,1,3,0,1,0,64.75
嘉義縣,水上鄉,水上村,282,1,767,13,780,1204,3,1,3,0,1,0,64.78
嘉義縣,水上鄉,水上村,283,1,817,18,835,1322,3,1,3,0,1,0,63.16
嘉義縣,水上鄉,水頭村,284,1,799,14,813,1242,3,1,3,0,1,0,65.46
嘉義縣,水上鄉,水頭村,285,1,326,4,330,492,3,1,3,0,1,0,67.07
嘉義縣,水上鄉,大堀村,286,1,331,2,333,461,3,1,3,0,1,0,72.23
嘉義縣,水上鄉,大堀村,287,1,311,8,319,490,3,1,3,0,1,0,65.10
嘉義縣,水上鄉,大堀村,288,1,200,5,205,323,3,1,3,0,1,0,63.47
嘉義縣,水上鄉,大崙村,289,1,1082,22,1104,1746,3,1,3,0,1,0,63.23
嘉義縣,水上鄉,塗溝村,290,1,471,5,476,765,3,1,3,0,1,0,62.22
嘉義縣,水上鄉,粗溪村,291,1,611,7,618,995,3,1,3,0,1,0,62.11
嘉義縣,水上鄉,粗溪村,292,1,256,2,258,369,3,1,3,0,1,0,69.92
嘉義縣,水上鄉,下寮村,293,1,293,5,298,450,3,1,3,0,1,0,66.22
嘉義縣,水上鄉,下寮村,294,1,668,16,684,1031,3,1,3,0,1,0,66.34
嘉義縣,水上鄉,三和村,295,1,760,18,778,1124,3,1,3,0,1,0,69.22
嘉義縣,水上鄉,三和村,296,1,308,3,311,453,3,1,3,0,1,0,68.65
嘉義縣,水上鄉,回歸村,297,1,434,9,443,662,3,1,3,0,1,0,66.92
嘉義縣,水上鄉,三鎮村,298,1,438,13,451,691,3,1,3,0,1,0,65.27
嘉義縣,水上鄉,靖和村,299,1,394,4,398,549,3,1,3,0,1,0,72.50
嘉義縣,水上鄉,南和村,300,1,523,9,532,783,3,1,3,0,1,0,67.94
嘉義縣,水上鄉,南和村,301,1,227,14,241,381,3,1,3,0,1,0,63.25
嘉義縣,水上鄉,龍德村,302,1,1052,11,1063,1596,3,1,3,0,1,0,66.60
嘉義縣,水上鄉,溪洲村,303,1,646,7,653,998,3,1,3,0,1,0,65.43
嘉義縣,水上鄉,柳新村,304,1,1292,40,1332,2004,3,1,3,0,1,0,66.47
嘉義縣,水上鄉,柳林村,305,1,955,18,973,1645,3,1,3,0,1,0,59.15
嘉義縣,水上鄉,柳鄉村,306,1,994,10,1004,1574,3,1,3,0,1,0,63.79
嘉義縣,水上鄉,內溪村,307,1,567,11,578,888,3,1,3,0,1,0,65.09
嘉義縣,水上鄉,寬士村,308,1,828,10,838,1336,3,1,3,0,1,0,62.72
嘉義縣,水上鄉,寬士村,309,1,720,8,728,1298,3,1,3,0,1,0,56.09
嘉義縣,水上鄉,民生村,310,1,713,16,729,1207,3,1,3,0,1,0,60.40
嘉義縣,水上鄉,民生村,311,1,863,19,882,1415,3,1,3,0,1,0,62.33
嘉義縣,水上鄉,義興村,312,1,487,6,493,729,3,1,3,0,1,0,67.63
嘉義縣,水上鄉,中庄村,313,1,1125,16,1141,1738,3,1,3,0,1,0,65.65
嘉義縣,水上鄉,忠和村,314,1,1094,27,1121,1768,3,1,3,0,1,0,63.40
嘉義縣,水上鄉,南鄉村,315,1,475,4,479,830,3,1,3,0,1,0,57.71
嘉義縣,水上鄉,三界村,316,1,650,8,658,1017,3,1,3,0,1,0,64.70
嘉義縣,水上鄉,國姓村,317,1,715,10,725,1263,3,1,3,0,1,0,57.40
嘉義縣,中埔鄉,中埔村,318,1,981,21,1002,1533,3,1,3,0,1,0,65.36
嘉義縣,中埔鄉,塩舘村,319,1,430,6,436,746,3,1,3,0,1,0,58.45
嘉義縣,中埔鄉,龍門村,320,1,450,12,462,712,3,1,3,0,1,0,64.89
嘉義縣,中埔鄉,裕民村,321,1,455,14,469,818,3,1,3,0,1,0,57.33
嘉義縣,中埔鄉,金蘭村,322,1,747,13,760,1278,3,1,3,0,1,0,59.47
嘉義縣,中埔鄉,富收村,323,1,561,6,567,1004,3,1,3,0,1,0,56.47
嘉義縣,中埔鄉,富收村,324,1,695,8,703,1147,3,1,3,0,1,0,61.29
嘉義縣,中埔鄉,和睦村,325,1,1121,15,1136,2105,3,1,3,0,1,0,53.97
嘉義縣,中埔鄉,和美村,326,1,881,17,898,1544,3,1,3,0,1,0,58.16
嘉義縣,中埔鄉,和美村,327,1,799,13,812,1519,3,1,3,0,1,0,53.46
嘉義縣,中埔鄉,和美村,328,1,875,16,891,1618,3,1,3,0,1,0,55.07
嘉義縣,中埔鄉,和興村,329,1,1038,13,1051,2036,3,1,3,0,1,0,51.62
嘉義縣,中埔鄉,和興村,330,1,1123,23,1146,2241,3,1,3,0,1,0,51.14
嘉義縣,中埔鄉,隆興村,331,1,958,17,975,1588,3,1,3,0,1,0,61.40
嘉義縣,中埔鄉,義仁村,332,1,745,12,757,1208,3,1,3,0,1,0,62.67
嘉義縣,中埔鄉,社口村,333,1,909,5,914,1513,3,1,3,0,1,0,60.41
嘉義縣,中埔鄉,社口村,334,1,265,3,268,455,3,1,3,0,1,0,58.90
嘉義縣,中埔鄉,灣潭村,335,1,721,7,728,1111,3,1,3,0,1,0,65.53
嘉義縣,中埔鄉,石硦村,336,1,586,7,593,835,3,1,3,0,1,0,71.02
嘉義縣,中埔鄉,石硦村,337,1,228,3,231,319,3,1,3,0,1,0,72.41
嘉義縣,中埔鄉,頂埔村,338,1,570,7,577,907,3,1,3,0,1,0,63.62
嘉義縣,中埔鄉,同仁村,339,1,733,7,740,1175,3,1,3,0,1,0,62.98
嘉義縣,中埔鄉,同仁村,340,1,411,10,421,643,3,1,3,0,1,0,65.47
嘉義縣,中埔鄉,深坑村,341,1,521,6,527,726,3,1,3,0,1,0,72.59
嘉義縣,中埔鄉,三層村,342,1,407,3,410,622,3,1,3,0,1,0,65.92
嘉義縣,中埔鄉,瑞豐村,343,1,475,2,477,703,3,1,3,0,1,0,67.85
嘉義縣,中埔鄉,沄水村,344,1,356,0,356,538,3,1,3,0,1,0,66.17
嘉義縣,中埔鄉,沄水村,345,1,382,6,388,574,3,1,3,0,1,0,67.60
嘉義縣,中埔鄉,東興村,346,1,200,2,202,317,3,1,3,0,1,0,63.72
嘉義縣,中埔鄉,中崙村,347,1,217,2,219,331,3,1,3,0,1,0,66.16
嘉義縣,竹崎鄉,竹崎村,348,1,656,17,673,1059,3,1,3,0,1,0,63.55
嘉義縣,竹崎鄉,竹崎村,349,1,591,15,606,979,3,1,3,0,1,0,61.90
嘉義縣,竹崎鄉,和平村,350,1,1085,15,1100,1686,3,1,3,0,1,0,65.24
嘉義縣,竹崎鄉,坑頭村,351,1,414,2,416,737,3,1,3,0,1,0,56.45
嘉義縣,竹崎鄉,沙坑村,352,1,543,12,555,840,3,1,3,0,1,0,66.07
嘉義縣,竹崎鄉,獅埜村,353,1,731,5,736,1256,3,1,3,0,1,0,58.60
嘉義縣,竹崎鄉,義和村,354,1,366,3,369,542,3,1,3,0,1,0,68.08
嘉義縣,竹崎鄉,義仁村,355,1,642,6,648,1027,3,1,3,0,1,0,63.10
嘉義縣,竹崎鄉,灣橋村,356,1,665,5,670,1074,3,1,3,0,1,0,62.38
嘉義縣,竹崎鄉,灣橋村,357,1,1006,8,1014,1569,3,1,3,0,1,0,64.63
嘉義縣,竹崎鄉,灣橋村,358,1,833,8,841,1506,3,1,3,0,1,0,55.84
嘉義縣,竹崎鄉,鹿滿村,359,1,754,13,767,1256,3,1,3,0,1,0,61.07
嘉義縣,竹崎鄉,紫雲村,360,1,845,5,850,1292,3,1,3,0,1,0,65.79
嘉義縣,竹崎鄉,內埔村,361,1,1010,10,1020,1560,3,1,3,0,1,0,65.38
嘉義縣,竹崎鄉,昇平村,362,1,476,3,479,677,3,1,3,0,1,0,70.75
嘉義縣,竹崎鄉,昇平村,363,1,652,18,670,994,3,1,3,0,1,0,67.40
嘉義縣,竹崎鄉,桃源村,364,1,478,4,482,737,3,1,3,0,1,0,65.40
嘉義縣,竹崎鄉,桃源村,365,1,245,0,245,371,3,1,3,0,1,0,66.04
嘉義縣,竹崎鄉,白杞村,366,1,481,5,486,737,3,1,3,0,1,0,65.94
嘉義縣,竹崎鄉,塘興村,367,1,323,5,328,490,3,1,3,0,1,0,66.94
嘉義縣,竹崎鄉,塘興村,368,1,259,1,260,403,3,1,3,0,1,0,64.52
嘉義縣,竹崎鄉,義隆村,369,1,343,3,346,535,3,1,3,0,1,0,64.67
嘉義縣,竹崎鄉,龍山村,370,1,145,0,145,234,3,1,3,0,1,0,61.97
嘉義縣,竹崎鄉,文峯村,371,1,828,15,843,1358,3,1,3,0,1,0,62.08
嘉義縣,竹崎鄉,金獅村,372,1,485,10,495,844,3,1,3,0,1,0,58.65
嘉義縣,竹崎鄉,復金村,373,1,288,4,292,524,3,1,3,0,1,0,55.73
嘉義縣,竹崎鄉,復金村,374,1,1050,11,1061,1770,3,1,3,0,1,0,59.94
嘉義縣,竹崎鄉,緞繻村,375,1,490,11,501,973,3,1,3,0,1,0,51.49
嘉義縣,竹崎鄉,緞繻村,376,1,82,1,83,152,3,1,3,0,1,0,54.61
嘉義縣,竹崎鄉,仁壽村,377,1,167,1,168,349,3,1,3,0,1,0,48.14
嘉義縣,竹崎鄉,中和村,378,1,232,3,235,423,3,1,3,0,1,0,55.56
嘉義縣,竹崎鄉,中和村,379,1,274,1,275,386,3,1,3,0,1,0,71.24
嘉義縣,竹崎鄉,光華村,380,1,294,3,297,428,3,1,3,0,1,0,69.39
嘉義縣,竹崎鄉,光華村,381,1,168,1,169,331,3,1,3,0,1,0,51.06
嘉義縣,梅山鄉,梅東村,382,1,576,14,590,972,3,1,3,0,1,0,60.70
嘉義縣,梅山鄉,梅東村,383,1,845,14,859,1527,3,1,3,0,1,0,56.25
嘉義縣,梅山鄉,梅南村,384,1,654,14,668,1010,3,1,3,0,1,0,66.14
嘉義縣,梅山鄉,梅北村,385,1,774,8,782,1345,3,1,3,0,1,0,58.14
嘉義縣,梅山鄉,梅北村,386,1,1197,18,1215,2079,3,1,3,0,1,0,58.44
嘉義縣,梅山鄉,過山村,387,1,394,6,400,597,3,1,3,0,1,0,67.00
嘉義縣,梅山鄉,圳南村,388,1,334,4,338,547,3,1,3,0,1,0,61.79
嘉義縣,梅山鄉,圳北村,389,1,438,3,441,720,3,1,3,0,1,0,61.25
嘉義縣,梅山鄉,双溪村,390,1,410,4,414,589,3,1,3,0,1,0,70.29
嘉義縣,梅山鄉,大南村,391,1,999,16,1015,1701,3,1,3,0,1,0,59.67
嘉義縣,梅山鄉,安靖村,392,1,552,9,561,972,3,1,3,0,1,0,57.72
嘉義縣,梅山鄉,永興村,393,1,276,2,278,535,3,1,3,0,1,0,51.96
嘉義縣,梅山鄉,半天村,394,1,296,4,300,489,3,1,3,0,1,0,61.35
嘉義縣,梅山鄉,太平村,395,1,331,10,341,532,3,1,3,0,1,0,64.10
嘉義縣,梅山鄉,太興村,396,1,280,1,281,413,3,1,3,0,1,0,68.04
嘉義縣,梅山鄉,龍眼村,397,1,319,7,326,489,3,1,3,0,1,0,66.67
嘉義縣,梅山鄉,碧湖村,398,1,198,3,201,353,3,1,3,0,1,0,56.94
嘉義縣,梅山鄉,瑞峯村,399,1,457,4,461,717,3,1,3,0,1,0,64.30
嘉義縣,梅山鄉,瑞里村,400,1,478,20,498,730,3,1,3,0,1,0,68.22
嘉義縣,梅山鄉,太和村,401,1,353,5,358,559,3,1,3,0,1,0,64.04
嘉義縣,梅山鄉,太和村,402,1,297,8,305,468,3,1,3,0,1,0,65.17
嘉義縣,番路鄉,江西村,403,1,573,8,581,878,3,1,3,0,1,0,66.17
嘉義縣,番路鄉,內甕村,404,1,213,2,215,352,3,1,3,0,1,0,61.08
嘉義縣,番路鄉,新福村,405,1,510,3,513,743,3,1,3,0,1,0,69.04
嘉義縣,番路鄉,下坑村,406,1,925,10,935,1450,3,1,3,0,1,0,64.48
嘉義縣,番路鄉,番路村,407,1,529,8,537,794,3,1,3,0,1,0,67.63
嘉義縣,番路鄉,民和村,408,1,503,9,512,783,3,1,3,0,1,0,65.39
嘉義縣,番路鄉,觸口村,409,1,597,8,605,865,3,1,3,0,1,0,69.94
嘉義縣,番路鄉,大湖村,410,1,486,1,487,884,3,1,3,0,1,0,55.09
嘉義縣,番路鄉,公田村,411,1,239,1,240,416,3,1,3,0,1,0,57.69
嘉義縣,番路鄉,公田村,412,1,266,7,273,467,3,1,3,0,1,0,58.46
嘉義縣,番路鄉,公興村,413,1,310,4,314,575,3,1,3,0,1,0,54.61
嘉義縣,番路鄉,草山村,414,1,108,0,108,142,3,1,3,0,1,0,76.06
嘉義縣,番路鄉,草山村,415,1,141,0,141,208,3,1,3,0,1,0,67.79
嘉義縣,大埔鄉,大埔村,416,1,454,64,518,981,3,1,3,0,1,0,52.80
嘉義縣,大埔鄉,和平村,417,1,129,7,136,248,3,1,3,0,1,0,54.84
嘉義縣,大埔鄉,和平村,418,1,98,30,128,242,3,1,3,0,1,0,52.89
嘉義縣,大埔鄉,永樂村,419,1,77,11,88,152,3,1,3,0,1,0,57.89
嘉義縣,大埔鄉,永樂村,420,1,93,2,95,153,3,1,3,0,1,0,62.09
嘉義縣,大埔鄉,茄苳村,421,1,167,8,175,342,3,1,3,0,1,0,51.17
嘉義縣,大埔鄉,茄苳村,422,1,79,3,82,144,3,1,3,0,1,0,56.94
嘉義縣,大埔鄉,茄苳村,423,1,86,6,92,214,3,1,3,0,1,0,42.99
嘉義縣,大埔鄉,西興村,424,1,202,5,207,358,3,1,3,0,1,0,57.82
嘉義縣,阿里山鄉,中山村,425,1,213,2,215,374,3,1,3,0,1,0,57.49
嘉義縣,阿里山鄉,中正村,426,1,104,2,106,206,3,1,3,0,1,0,51.46
嘉義縣,阿里山鄉,香林村,427,1,121,2,123,238,3,1,3,0,1,0,51.68
嘉義縣,阿里山鄉,十字村,428,1,115,2,117,238,3,1,3,0,1,0,49.16
嘉義縣,阿里山鄉,達邦村,429,1,58,0,58,149,3,1,3,0,1,0,38.93
嘉義縣,阿里山鄉,樂野村,430,1,129,0,129,234,3,1,3,0,1,0,55.13
嘉義縣,阿里山鄉,來吉村,431,1,14,0,14,99,3,1,3,0,1,0,14.14
嘉義縣,阿里山鄉,豐山村,432,1,162,1,163,264,3,1,3,0,1,0,61.74
嘉義縣,阿里山鄉,里佳村,433,1,8,0,8,27,3,1,3,0,1,0,29.63
嘉義縣,阿里山鄉,山美村,434,1,12,1,13,24,3,1,3,0,1,0,54.17
嘉義縣,阿里山鄉,新美村,435,1,8,0,8,20,3,1,3,0,1,0,40.00
嘉義縣,阿里山鄉,茶山村,436,1,55,0,55,100,3,1,3,0,1,0,55.00
臺南縣,新營市,忠政里,1,1,676,9,685,1071,3,1,3,0,1,0,63.96
臺南縣,新營市,忠政里,2,1,754,12,766,1187,3,1,3,0,1,0,64.53
臺南縣,新營市,忠政里,3,1,780,5,785,1204,3,1,3,0,1,0,65.20
臺南縣,新營市,忠政里,4,1,868,8,876,1354,3,1,3,0,1,0,64.70
臺南縣,新營市,民權里,5,1,886,9,895,1379,3,1,3,0,1,0,64.90
臺南縣,新營市,三仙里,6,1,745,6,751,1224,3,1,3,0,1,0,61.36
臺南縣,新營市,三仙里,7,1,754,12,766,1270,3,1,3,0,1,0,60.31
臺南縣,新營市,好平里,8,1,527,10,537,952,3,1,3,0,1,0,56.41
臺南縣,新營市,延平里,9,1,790,15,805,1382,3,1,3,0,1,0,58.25
臺南縣,新營市,永生里,10,1,732,4,736,1051,3,1,3,0,1,0,70.03
臺南縣,新營市,大宏里,11,1,577,8,585,910,3,1,3,0,1,0,64.29
臺南縣,新營市,大宏里,12,1,588,7,595,973,3,1,3,0,1,0,61.15
臺南縣,新營市,大宏里,13,1,711,8,719,1212,3,1,3,0,1,0,59.32
臺南縣,新營市,王公里,14,1,852,7,859,1427,3,1,3,0,1,0,60.20
臺南縣,新營市,王公里,15,1,828,11,839,1342,3,1,3,0,1,0,62.52
臺南縣,新營市,王公里,16,1,916,12,928,1494,3,1,3,0,1,0,62.12
臺南縣,新營市,中營里,17,1,520,5,525,855,3,1,3,0,1,0,61.40
臺南縣,新營市,中營里,18,1,488,15,503,791,3,1,3,0,1,0,63.59
臺南縣,新營市,土庫里,19,1,979,13,992,1465,3,1,3,0,1,0,67.71
臺南縣,新營市,興安里,20,1,81,1,82,121,3,1,3,0,1,0,67.77
臺南縣,新營市,南興里,21,1,734,13,747,1145,3,1,3,0,1,0,65.24
臺南縣,新營市,南興里,22,1,829,10,839,1337,3,1,3,0,1,0,62.75
臺南縣,新營市,興業里,23,1,790,16,806,1153,3,1,3,0,1,0,69.90
臺南縣,新營市,民生里,24,1,716,8,724,1199,3,1,3,0,1,0,60.38
臺南縣,新營市,民生里,25,1,706,6,712,1262,3,1,3,0,1,0,56.42
臺南縣,新營市,民生里,26,1,742,6,748,1274,3,1,3,0,1,0,58.71
臺南縣,新營市,民生里,27,1,691,11,702,1266,3,1,3,0,1,0,55.45
臺南縣,新營市,民生里,28,1,711,12,723,1174,3,1,3,0,1,0,61.58
臺南縣,新營市,民生里,29,1,770,11,781,1208,3,1,3,0,1,0,64.65
臺南縣,新營市,民榮里,30,1,575,9,584,919,3,1,3,0,1,0,63.55
臺南縣,新營市,民榮里,31,1,671,7,678,1160,3,1,3,0,1,0,58.45
臺南縣,新營市,民榮里,32,1,791,9,800,1328,3,1,3,0,1,0,60.24
臺南縣,新營市,埤寮里,33,1,748,7,755,1153,3,1,3,0,1,0,65.48
臺南縣,新營市,埤寮里,34,1,635,10,645,854,3,1,3,0,1,0,75.53
臺南縣,新營市,護鎮里,35,1,732,9,741,1161,3,1,3,0,1,0,63.82
臺南縣,新營市,太南里,36,1,882,15,897,1336,3,1,3,0,1,0,67.14
臺南縣,新營市,太北里,37,1,912,9,921,1405,3,1,3,0,1,0,65.55
臺南縣,新營市,南紙里,38,1,541,9,550,830,3,1,3,0,1,0,66.27
臺南縣,新營市,南紙里,39,1,737,14,751,1178,3,1,3,0,1,0,63.75
臺南縣,新營市,嘉芳里,40,1,813,18,831,1336,3,1,3,0,1,0,62.20
臺南縣,新營市,舊埔里,41,1,271,0,271,391,3,1,3,0,1,0,69.31
臺南縣,新營市,角帶里,42,1,346,1,347,462,3,1,3,0,1,0,75.11
臺南縣,新營市,鐵線里,43,1,499,6,505,783,3,1,3,0,1,0,64.50
臺南縣,新營市,五興里,44,1,626,10,636,986,3,1,3,0,1,0,64.50
臺南縣,新營市,姑爺里,45,1,424,3,427,608,3,1,3,0,1,0,70.23
臺南縣,鹽水鎮,水秀里,46,1,512,8,520,818,3,1,3,0,1,0,63.57
臺南縣,鹽水鎮,水秀里,47,1,334,2,336,522,3,1,3,0,1,0,64.37
臺南縣,鹽水鎮,福得里,48,1,366,4,370,549,3,1,3,0,1,0,67.40
臺南縣,鹽水鎮,三生里,49,1,248,4,252,372,3,1,3,0,1,0,67.74
臺南縣,鹽水鎮,武廟里,50,1,394,6,400,604,3,1,3,0,1,0,66.23
臺南縣,鹽水鎮,中境里,51,1,356,30,386,581,3,1,3,0,1,0,66.44
臺南縣,鹽水鎮,水仙里,52,1,274,2,276,433,3,1,3,0,1,0,63.74
臺南縣,鹽水鎮,水正里,53,1,516,5,521,764,3,1,3,0,1,0,68.19
臺南縣,鹽水鎮,橋南里,54,1,911,13,924,1506,3,1,3,0,1,0,61.35
臺南縣,鹽水鎮,橋南里,55,1,690,5,695,1105,3,1,3,0,1,0,62.90
臺南縣,鹽水鎮,舊營里,56,1,462,7,469,687,3,1,3,0,1,0,68.27
臺南縣,鹽水鎮,汫水里,57,1,628,13,641,1083,3,1,3,0,1,0,59.19
臺南縣,鹽水鎮,岸內里,58,1,1035,18,1053,1652,3,1,3,0,1,0,63.74
臺南縣,鹽水鎮,岸內里,59,1,769,9,778,1269,3,1,3,0,1,0,61.31
臺南縣,鹽水鎮,義稠里,60,1,405,5,410,589,3,1,3,0,1,0,69.61
臺南縣,鹽水鎮,下中里,61,1,496,9,505,781,3,1,3,0,1,0,64.66
臺南縣,鹽水鎮,歡雅里,62,1,434,7,441,727,3,1,3,0,1,0,60.66
臺南縣,鹽水鎮,歡雅里,63,1,414,3,417,767,3,1,3,0,1,0,54.37
臺南縣,鹽水鎮,大莊里,64,1,346,1,347,569,3,1,3,0,1,0,60.98
臺南縣,鹽水鎮,桐寮里,65,1,189,1,190,297,3,1,3,0,1,0,63.97
臺南縣,鹽水鎮,後宅里,66,1,465,8,473,686,3,1,3,0,1,0,68.95
臺南縣,鹽水鎮,孫厝里,67,1,333,4,337,521,3,1,3,0,1,0,64.68
臺南縣,鹽水鎮,竹埔里,68,1,617,10,627,876,3,1,3,0,1,0,71.58
臺南縣,鹽水鎮,下林里,69,1,261,3,264,439,3,1,3,0,1,0,60.14
臺南縣,鹽水鎮,田寮里,70,1,207,5,212,290,3,1,3,0,1,0,73.10
臺南縣,鹽水鎮,大豐里,71,1,255,1,256,383,3,1,3,0,1,0,66.84
臺南縣,鹽水鎮,飯店里,72,1,286,1,287,427,3,1,3,0,1,0,67.21
臺南縣,鹽水鎮,河南里,73,1,405,4,409,641,3,1,3,0,1,0,63.81
臺南縣,鹽水鎮,南港里,74,1,672,14,686,951,3,1,3,0,1,0,72.13
臺南縣,白河鎮,白河里,75,1,815,6,821,1285,3,1,3,0,1,0,63.89
臺南縣,白河鎮,白河里,76,1,427,10,437,659,3,1,3,0,1,0,66.31
臺南縣,白河鎮,永安里,77,1,875,7,882,1442,3,1,3,0,1,0,61.17
臺南縣,白河鎮,永安里,78,1,743,3,746,1112,3,1,3,0,1,0,67.09
臺南縣,白河鎮,外角里,79,1,909,17,926,1458,3,1,3,0,1,0,63.51
臺南縣,白河鎮,庄內里,80,1,914,16,930,1489,3,1,3,0,1,0,62.46
臺南縣,白河鎮,秀祐里,81,1,528,8,536,811,3,1,3,0,1,0,66.09
臺南縣,白河鎮,河東里,82,1,838,8,846,1388,3,1,3,0,1,0,60.95
臺南縣,白河鎮,虎山里,83,1,301,5,306,493,3,1,3,0,1,0,62.07
臺南縣,白河鎮,大林里,84,1,369,5,374,637,3,1,3,0,1,0,58.71
臺南縣,白河鎮,崁頭里,85,1,340,2,342,495,3,1,3,0,1,0,69.09
臺南縣,白河鎮,六溪里,86,1,366,4,370,658,3,1,3,0,1,0,56.23
臺南縣,白河鎮,關嶺里,87,1,796,10,806,1325,3,1,3,0,1,0,60.83
臺南縣,白河鎮,仙草里,88,1,499,4,503,830,3,1,3,0,1,0,60.60
臺南縣,白河鎮,仙草里,89,1,348,10,358,613,3,1,3,0,1,0,58.40
臺南縣,白河鎮,仙草里,90,1,452,13,465,592,3,1,3,0,1,0,78.55
臺南縣,白河鎮,仙草里,91,1,410,10,420,563,3,1,3,0,1,0,74.60
臺南縣,白河鎮,玉豐里,92,1,765,8,773,1174,3,1,3,0,1,0,65.84
臺南縣,白河鎮,大竹里,93,1,881,4,885,1349,3,1,3,0,1,0,65.60
臺南縣,白河鎮,詔安里,94,1,617,11,628,898,3,1,3,0,1,0,69.93
臺南縣,白河鎮,廣安里,95,1,442,9,451,691,3,1,3,0,1,0,65.27
臺南縣,白河鎮,蓮潭里,96,1,658,8,666,938,3,1,3,0,1,0,71.00
臺南縣,白河鎮,竹門里,97,1,686,6,692,982,3,1,3,0,1,0,70.47
臺南縣,白河鎮,崎內里,98,1,529,9,538,872,3,1,3,0,1,0,61.70
臺南縣,白河鎮,昇安里,99,1,778,14,792,1257,3,1,3,0,1,0,63.01
臺南縣,白河鎮,汴頭里,100,1,509,10,519,814,3,1,3,0,1,0,63.76
臺南縣,白河鎮,內角里,101,1,586,8,594,815,3,1,3,0,1,0,72.88
臺南縣,白河鎮,草店里,102,1,632,7,639,960,3,1,3,0,1,0,66.56
臺南縣,白河鎮,甘宅里,103,1,458,10,468,763,3,1,3,0,1,0,61.34
臺南縣,柳營鄉,士林村,104,1,828,9,837,1267,3,1,3,0,1,0,66.06
臺南縣,柳營鄉,光福村,105,1,554,13,567,825,3,1,3,0,1,0,68.73
臺南縣,柳營鄉,光福村,106,1,603,11,614,913,3,1,3,0,1,0,67.25
臺南縣,柳營鄉,中埕村,107,1,488,4,492,693,3,1,3,0,1,0,71.00
臺南縣,柳營鄉,東昇村,108,1,749,5,754,1069,3,1,3,0,1,0,70.53
臺南縣,柳營鄉,東昇村,109,1,833,12,845,1195,3,1,3,0,1,0,70.71
臺南縣,柳營鄉,八翁村,110,1,780,11,791,1191,3,1,3,0,1,0,66.41
臺南縣,柳營鄉,人和村,111,1,298,2,300,481,3,1,3,0,1,0,62.37
臺南縣,柳營鄉,人和村,112,1,229,1,230,311,3,1,3,0,1,0,73.95
臺南縣,柳營鄉,太康村,113,1,1052,12,1064,1489,3,1,3,0,1,0,71.46
臺南縣,柳營鄉,重溪村,114,1,880,7,887,1422,3,1,3,0,1,0,62.38
臺南縣,柳營鄉,重溪村,115,1,212,1,213,312,3,1,3,0,1,0,68.27
臺南縣,柳營鄉,篤農村,116,1,862,14,876,1390,3,1,3,0,1,0,63.02
臺南縣,柳營鄉,大農村,117,1,457,7,464,652,3,1,3,0,1,0,71.17
臺南縣,柳營鄉,神農村,118,1,742,9,751,1188,3,1,3,0,1,0,63.22
臺南縣,柳營鄉,神農村,119,1,147,3,150,232,3,1,3,0,1,0,64.66
臺南縣,柳營鄉,果毅村,120,1,823,14,837,1260,3,1,3,0,1,0,66.43
臺南縣,柳營鄉,旭山村,121,1,668,9,677,1017,3,1,3,0,1,0,66.57
臺南縣,柳營鄉,旭山村,122,1,352,3,355,486,3,1,3,0,1,0,73.05
臺南縣,柳營鄉,旭山村,123,1,150,4,154,205,3,1,3,0,1,0,75.12
臺南縣,後壁鄉,後壁村,124,1,419,3,422,686,3,1,3,0,1,0,61.52
臺南縣,後壁鄉,後壁村,125,1,508,9,517,748,3,1,3,0,1,0,69.12
臺南縣,後壁鄉,侯伯村,126,1,841,7,848,1202,3,1,3,0,1,0,70.55
臺南縣,後壁鄉,嘉苳村,127,1,695,2,697,1057,3,1,3,0,1,0,65.94
臺南縣,後壁鄉,嘉苳村,128,1,152,6,158,252,3,1,3,0,1,0,62.70
臺南縣,後壁鄉,土溝村,129,1,915,18,933,1300,3,1,3,0,1,0,71.77
臺南縣,後壁鄉,嘉田村,130,1,732,6,738,1176,3,1,3,0,1,0,62.76
臺南縣,後壁鄉,嘉民村,131,1,805,17,822,1229,3,1,3,0,1,0,66.88
臺南縣,後壁鄉,菁豐村,132,1,581,5,586,832,3,1,3,0,1,0,70.43
臺南縣,後壁鄉,崁頂村,133,1,396,4,400,566,3,1,3,0,1,0,70.67
臺南縣,後壁鄉,後壁村,134,1,365,24,389,654,3,1,3,0,1,0,59.48
臺南縣,後壁鄉,墨林村,135,1,584,9,593,862,3,1,3,0,1,0,68.79
臺南縣,後壁鄉,菁寮村,136,1,357,3,360,501,3,1,3,0,1,0,71.86
臺南縣,後壁鄉,新嘉村,137,1,769,9,778,1227,3,1,3,0,1,0,63.41
臺南縣,後壁鄉,頂長村,138,1,392,1,393,537,3,1,3,0,1,0,73.18
臺南縣,後壁鄉,平安村,139,1,765,10,775,1071,3,1,3,0,1,0,72.36
臺南縣,後壁鄉,仕安村,140,1,389,1,390,584,3,1,3,0,1,0,66.78
臺南縣,後壁鄉,竹新村,141,1,729,10,739,1045,3,1,3,0,1,0,70.72
臺南縣,後壁鄉,竹新村,142,1,278,3,281,401,3,1,3,0,1,0,70.07
臺南縣,後壁鄉,新東村,143,1,892,15,907,1406,3,1,3,0,1,0,64.51
臺南縣,後壁鄉,頂安村,144,1,743,12,755,1086,3,1,3,0,1,0,69.52
臺南縣,後壁鄉,長安村,145,1,506,3,509,743,3,1,3,0,1,0,68.51
臺南縣,後壁鄉,長安村,146,1,442,6,448,668,3,1,3,0,1,0,67.07
臺南縣,後壁鄉,福安村,147,1,728,4,732,1065,3,1,3,0,1,0,68.73
臺南縣,後壁鄉,烏樹村,148,1,443,5,448,743,3,1,3,0,1,0,60.30
臺南縣,後壁鄉,烏林村,149,1,137,4,141,209,3,1,3,0,1,0,67.46
臺南縣,東山鄉,東山村,150,1,826,6,832,1442,3,1,3,0,1,0,57.70
臺南縣,東山鄉,東中村,151,1,770,3,773,1154,3,1,3,0,1,0,66.98
臺南縣,東山鄉,東中村,152,1,666,6,672,1104,3,1,3,0,1,0,60.87
臺南縣,東山鄉,東正村,153,1,924,11,935,1605,3,1,3,0,1,0,58.26
臺南縣,東山鄉,三榮村,154,1,606,2,608,1005,3,1,3,0,1,0,60.50
臺南縣,東山鄉,大客村,155,1,707,12,719,1204,3,1,3,0,1,0,59.72
臺南縣,東山鄉,科里村,156,1,526,12,538,825,3,1,3,0,1,0,65.21
臺南縣,東山鄉,科里村,157,1,419,3,422,641,3,1,3,0,1,0,65.83
臺南縣,東山鄉,東河村,158,1,543,7,550,957,3,1,3,0,1,0,57.47
臺南縣,東山鄉,聖賢村,159,1,524,7,531,836,3,1,3,0,1,0,63.52
臺南縣,東山鄉,聖賢村,160,1,648,7,655,1009,3,1,3,0,1,0,64.92
臺南縣,東山鄉,南溪村,161,1,370,4,374,582,3,1,3,0,1,0,64.26
臺南縣,東山鄉,水雲村,162,1,296,4,300,563,3,1,3,0,1,0,53.29
臺南縣,東山鄉,林安村,163,1,237,2,239,406,3,1,3,0,1,0,58.87
臺南縣,東山鄉,東原村,164,1,593,7,600,1036,3,1,3,0,1,0,57.92
臺南縣,東山鄉,東原村,165,1,692,11,703,1273,3,1,3,0,1,0,55.22
臺南縣,東山鄉,嶺南村,166,1,392,4,396,796,3,1,3,0,1,0,49.75
臺南縣,東山鄉,南勢村,167,1,665,8,673,1151,3,1,3,0,1,0,58.47
臺南縣,東山鄉,青山村,168,1,636,5,641,1156,3,1,3,0,1,0,55.45
臺南縣,東山鄉,高原村,169,1,504,7,511,1022,3,1,3,0,1,0,50.00
臺南縣,麻豆鎮,穀興里,170,1,499,4,503,664,3,1,3,0,1,0,75.75
臺南縣,麻豆鎮,保安里,171,1,436,2,438,599,3,1,3,0,1,0,73.12
臺南縣,麻豆鎮,東角里,172,1,672,9,681,921,3,1,3,0,1,0,73.94
臺南縣,麻豆鎮,東角里,173,1,540,6,546,774,3,1,3,0,1,0,70.54
臺南縣,麻豆鎮,晉江里,174,1,805,4,809,1114,3,1,3,0,1,0,72.62
臺南縣,麻豆鎮,晉江里,175,1,735,7,742,1134,3,1,3,0,1,0,65.43
臺南縣,麻豆鎮,巷口里,176,1,966,10,976,1301,3,1,3,0,1,0,75.02
臺南縣,麻豆鎮,中興里,177,1,628,3,631,870,3,1,3,0,1,0,72.53
臺南縣,麻豆鎮,中興里,178,1,588,6,594,811,3,1,3,0,1,0,73.24
臺南縣,麻豆鎮,興農里,179,1,823,13,836,1133,3,1,3,0,1,0,73.79
臺南縣,麻豆鎮,新建里,180,1,671,7,678,903,3,1,3,0,1,0,75.08
臺南縣,麻豆鎮,油車里,181,1,819,10,829,1258,3,1,3,0,1,0,65.90
臺南縣,麻豆鎮,油車里,182,1,967,4,971,1392,3,1,3,0,1,0,69.76
臺南縣,麻豆鎮,北勢里,183,1,822,14,836,1185,3,1,3,0,1,0,70.55
臺南縣,麻豆鎮,大埕里,184,1,843,9,852,1224,3,1,3,0,1,0,69.61
臺南縣,麻豆鎮,大埕里,185,1,746,8,754,1082,3,1,3,0,1,0,69.69
臺南縣,麻豆鎮,總榮里,186,1,459,6,465,624,3,1,3,0,1,0,74.52
臺南縣,麻豆鎮,龍泉里,187,1,537,8,545,702,3,1,3,0,1,0,77.64
臺南縣,麻豆鎮,南勢里,188,1,638,6,644,887,3,1,3,0,1,0,72.60
臺南縣,麻豆鎮,南勢里,189,1,935,15,950,1331,3,1,3,0,1,0,71.37
臺南縣,麻豆鎮,寮廍里,190,1,978,8,986,1351,3,1,3,0,1,0,72.98
臺南縣,麻豆鎮,小埤里,191,1,527,6,533,706,3,1,3,0,1,0,75.50
臺南縣,麻豆鎮,埤頭里,192,1,944,10,954,1270,3,1,3,0,1,0,75.12
臺南縣,麻豆鎮,大山里,193,1,420,3,423,518,3,1,3,0,1,0,81.66
臺南縣,麻豆鎮,海埔里,194,1,752,9,761,1013,3,1,3,0,1,0,75.12
臺南縣,麻豆鎮,莊禮里,195,1,415,5,420,563,3,1,3,0,1,0,74.60
臺南縣,麻豆鎮,港尾里,196,1,822,14,836,1168,3,1,3,0,1,0,71.58
臺南縣,麻豆鎮,麻口里,197,1,692,12,704,962,3,1,3,0,1,0,73.18
臺南縣,麻豆鎮,安東里,198,1,449,7,456,584,3,1,3,0,1,0,78.08
臺南縣,麻豆鎮,安業里,199,1,483,13,496,658,3,1,3,0,1,0,75.38
臺南縣,麻豆鎮,安西里,200,1,471,4,475,622,3,1,3,0,1,0,76.37
臺南縣,麻豆鎮,謝安里,201,1,678,5,683,827,3,1,3,0,1,0,82.59
臺南縣,麻豆鎮,中民里,202,1,628,5,633,795,3,1,3,0,1,0,79.62
臺南縣,麻豆鎮,安正里,203,1,555,7,562,763,3,1,3,0,1,0,73.66
臺南縣,麻豆鎮,磚井里,204,1,871,8,879,1152,3,1,3,0,1,0,76.30
臺南縣,下營鄉,下營村,205,1,736,14,750,1079,3,1,3,0,1,0,69.51
臺南縣,下營鄉,仁里村,206,1,819,10,829,1223,3,1,3,0,1,0,67.78
臺南縣,下營鄉,仁里村,207,1,793,11,804,1187,3,1,3,0,1,0,67.73
臺南縣,下營鄉,宅內村,208,1,815,5,820,1164,3,1,3,0,1,0,70.45
臺南縣,下營鄉,後街村,209,1,1061,15,1076,1494,3,1,3,0,1,0,72.02
臺南縣,下營鄉,新興村,210,1,838,8,846,1190,3,1,3,0,1,0,71.09
臺南縣,下營鄉,新興村,211,1,519,3,522,755,3,1,3,0,1,0,69.14
臺南縣,下營鄉,營前村,212,1,653,8,661,957,3,1,3,0,1,0,69.07
臺南縣,下營鄉,營前村,213,1,700,11,711,1045,3,1,3,0,1,0,68.04
臺南縣,下營鄉,大屯村,214,1,582,10,592,806,3,1,3,0,1,0,73.45
臺南縣,下營鄉,大埤村,215,1,593,3,596,805,3,1,3,0,1,0,74.04
臺南縣,下營鄉,茅港村,216,1,801,13,814,1166,3,1,3,0,1,0,69.81
臺南縣,下營鄉,中營村,217,1,732,6,738,1048,3,1,3,0,1,0,70.42
臺南縣,下營鄉,開化村,218,1,1096,15,1111,1687,3,1,3,0,1,0,65.86
臺南縣,下營鄉,西連村,219,1,637,11,648,884,3,1,3,0,1,0,73.30
臺南縣,下營鄉,賀建村,220,1,857,9,866,1269,3,1,3,0,1,0,68.24
臺南縣,下營鄉,甲中村,221,1,825,5,830,1210,3,1,3,0,1,0,68.60
臺南縣,下營鄉,紅厝村,222,1,904,14,918,1245,3,1,3,0,1,0,73.73
臺南縣,六甲鄉,六甲村,223,1,959,18,977,1391,3,1,3,0,1,0,70.24
臺南縣,六甲鄉,六甲村,224,1,808,23,831,1179,3,1,3,0,1,0,70.48
臺南縣,六甲鄉,甲東村,225,1,856,6,862,1247,3,1,3,0,1,0,69.13
臺南縣,六甲鄉,甲東村,226,1,783,15,798,1164,3,1,3,0,1,0,68.56
臺南縣,六甲鄉,甲南村,227,1,888,10,898,1280,3,1,3,0,1,0,70.16
臺南縣,六甲鄉,龍湖村,228,1,712,7,719,1031,3,1,3,0,1,0,69.74
臺南縣,六甲鄉,七甲村,229,1,592,4,596,846,3,1,3,0,1,0,70.45
臺南縣,六甲鄉,二甲村,230,1,810,8,818,1221,3,1,3,0,1,0,66.99
臺南縣,六甲鄉,二甲村,231,1,893,11,904,1327,3,1,3,0,1,0,68.12
臺南縣,六甲鄉,水林村,232,1,625,5,630,904,3,1,3,0,1,0,69.69
臺南縣,六甲鄉,水林村,233,1,579,12,591,804,3,1,3,0,1,0,73.51
臺南縣,六甲鄉,中社村,234,1,1071,17,1088,1491,3,1,3,0,1,0,72.97
臺南縣,六甲鄉,龜港村,235,1,712,7,719,1017,3,1,3,0,1,0,70.70
臺南縣,六甲鄉,菁埔村,236,1,390,3,393,542,3,1,3,0,1,0,72.51
臺南縣,六甲鄉,王爺村,237,1,573,8,581,958,3,1,3,0,1,0,60.65
臺南縣,六甲鄉,大丘村,238,1,482,6,488,826,3,1,3,0,1,0,59.08
臺南縣,官田鄉,官田村,239,1,842,11,853,1162,3,1,3,0,1,0,73.41
臺南縣,官田鄉,官田村,240,1,540,5,545,787,3,1,3,0,1,0,69.25
臺南縣,官田鄉,二鎮村,241,1,739,5,744,1058,3,1,3,0,1,0,70.32
臺南縣,官田鄉,二鎮村,242,1,674,3,677,941,3,1,3,0,1,0,71.94
臺南縣,官田鄉,湖山村,243,1,726,12,738,1040,3,1,3,0,1,0,70.96
臺南縣,官田鄉,嘉南村,244,1,527,7,534,686,3,1,3,0,1,0,77.84
臺南縣,官田鄉,大崎村,245,1,344,1,345,499,3,1,3,0,1,0,69.14
臺南縣,官田鄉,隆田村,246,1,671,12,683,943,3,1,3,0,1,0,72.43
臺南縣,官田鄉,隆田村,247,1,610,6,616,852,3,1,3,0,1,0,72.30
臺南縣,官田鄉,隆本村,248,1,532,10,542,785,3,1,3,0,1,0,69.04
臺南縣,官田鄉,隆本村,249,1,628,8,636,884,3,1,3,0,1,0,71.95
臺南縣,官田鄉,隆本村,250,1,623,7,630,852,3,1,3,0,1,0,73.94
臺南縣,官田鄉,南廍村,251,1,654,15,669,958,3,1,3,0,1,0,69.83
臺南縣,官田鄉,東庄村,252,1,955,11,966,1389,3,1,3,0,1,0,69.55
臺南縣,官田鄉,西庄村,253,1,480,5,485,692,3,1,3,0,1,0,70.09
臺南縣,官田鄉,拔林村,254,1,466,5,471,627,3,1,3,0,1,0,75.12
臺南縣,官田鄉,渡頭村,255,1,603,7,610,884,3,1,3,0,1,0,69.00
臺南縣,官田鄉,渡頭村,256,1,608,9,617,864,3,1,3,0,1,0,71.41
臺南縣,官田鄉,渡頭村,257,1,375,8,383,573,3,1,3,0,1,0,66.84
臺南縣,官田鄉,社子村,258,1,657,10,667,913,3,1,3,0,1,0,73.06
臺南縣,大內鄉,石湖村,259,1,816,4,820,1207,3,1,3,0,1,0,67.94
臺南縣,大內鄉,石林村,260,1,594,6,600,817,3,1,3,0,1,0,73.44
臺南縣,大內鄉,石城村,261,1,975,7,982,1392,3,1,3,0,1,0,70.55
臺南縣,大內鄉,內江村,262,1,780,9,789,1069,3,1,3,0,1,0,73.81
臺南縣,大內鄉,大內村,263,1,620,6,626,842,3,1,3,0,1,0,74.35
臺南縣,大內鄉,內郭村,264,1,449,8,457,668,3,1,3,0,1,0,68.41
臺南縣,大內鄉,頭社村,265,1,699,7,706,1059,3,1,3,0,1,0,66.67
臺南縣,大內鄉,環湖村,266,1,584,11,595,920,3,1,3,0,1,0,64.67
臺南縣,大內鄉,二溪村,267,1,663,6,669,953,3,1,3,0,1,0,70.20
臺南縣,大內鄉,曲溪村,268,1,472,8,480,682,3,1,3,0,1,0,70.38
臺南縣,佳里鎮,東寧里,269,1,585,12,597,867,3,1,3,0,1,0,68.86
臺南縣,佳里鎮,東寧里,270,1,565,5,570,826,3,1,3,0,1,0,69.01
臺南縣,佳里鎮,忠仁里,271,1,764,9,773,1176,3,1,3,0,1,0,65.73
臺南縣,佳里鎮,忠仁里,272,1,846,9,855,1243,3,1,3,0,1,0,68.79
臺南縣,佳里鎮,鎮山里,273,1,650,3,653,949,3,1,3,0,1,0,68.81
臺南縣,佳里鎮,鎮山里,274,1,625,0,625,961,3,1,3,0,1,0,65.04
臺南縣,佳里鎮,鎮山里,275,1,624,8,632,945,3,1,3,0,1,0,66.88
臺南縣,佳里鎮,鎮山里,276,1,680,6,686,1043,3,1,3,0,1,0,65.77
臺南縣,佳里鎮,建南里,277,1,829,6,835,1210,3,1,3,0,1,0,69.01
臺南縣,佳里鎮,建南里,278,1,837,5,842,1225,3,1,3,0,1,0,68.73
臺南縣,佳里鎮,建南里,279,1,663,6,669,1055,3,1,3,0,1,0,63.41
臺南縣,佳里鎮,建南里,280,1,840,5,845,1328,3,1,3,0,1,0,63.63
臺南縣,佳里鎮,安西里,281,1,811,6,817,1217,3,1,3,0,1,0,67.13
臺南縣,佳里鎮,安西里,282,1,766,6,772,1140,3,1,3,0,1,0,67.72
臺南縣,佳里鎮,安西里,283,1,744,4,748,1108,3,1,3,0,1,0,67.51
臺南縣,佳里鎮,安西里,284,1,867,8,875,1174,3,1,3,0,1,0,74.53
臺南縣,佳里鎮,安西里,285,1,682,9,691,1007,3,1,3,0,1,0,68.62
臺南縣,佳里鎮,安西里,286,1,751,7,758,1114,3,1,3,0,1,0,68.04
臺南縣,佳里鎮,六安里,287,1,630,8,638,914,3,1,3,0,1,0,69.80
臺南縣,佳里鎮,六安里,288,1,631,6,637,995,3,1,3,0,1,0,64.02
臺南縣,佳里鎮,六安里,289,1,614,8,622,910,3,1,3,0,1,0,68.35
臺南縣,佳里鎮,佳化里,290,1,629,9,638,959,3,1,3,0,1,0,66.53
臺南縣,佳里鎮,佳化里,291,1,561,7,568,782,3,1,3,0,1,0,72.63
臺南縣,佳里鎮,禮化里,292,1,621,6,627,839,3,1,3,0,1,0,74.73
臺南縣,佳里鎮,興化里,293,1,938,6,944,1351,3,1,3,0,1,0,69.87
臺南縣,佳里鎮,營頂里,294,1,457,3,460,654,3,1,3,0,1,0,70.34
臺南縣,佳里鎮,溪洲里,295,1,282,3,285,381,3,1,3,0,1,0,74.80
臺南縣,佳里鎮,海澄里,296,1,691,14,705,1062,3,1,3,0,1,0,66.38
臺南縣,佳里鎮,漳洲里,297,1,405,5,410,572,3,1,3,0,1,0,71.68
臺南縣,佳里鎮,頂廍里,298,1,457,5,462,670,3,1,3,0,1,0,68.96
臺南縣,佳里鎮,嘉福里,299,1,679,7,686,962,3,1,3,0,1,0,71.31
臺南縣,佳里鎮,通興里,300,1,762,2,764,1065,3,1,3,0,1,0,71.74
臺南縣,佳里鎮,蚶寮里,301,1,591,6,597,835,3,1,3,0,1,0,71.50
臺南縣,佳里鎮,龍安里,302,1,706,9,715,962,3,1,3,0,1,0,74.32
臺南縣,佳里鎮,民安里,303,1,798,14,812,1180,3,1,3,0,1,0,68.81
臺南縣,佳里鎮,子龍里,304,1,989,13,1002,1440,3,1,3,0,1,0,69.58
臺南縣,佳里鎮,三協里,305,1,574,7,581,807,3,1,3,0,1,0,72.00
臺南縣,學甲鎮,一秀里,306,1,394,9,403,624,3,1,3,0,1,0,64.58
臺南縣,學甲鎮,一秀里,307,1,280,0,280,404,3,1,3,0,1,0,69.31
臺南縣,學甲鎮,西明里,308,1,728,10,738,1164,3,1,3,0,1,0,63.40
臺南縣,學甲鎮,宜民里,309,1,355,2,357,545,3,1,3,0,1,0,65.50
臺南縣,學甲鎮,煥昌里,310,1,540,4,544,849,3,1,3,0,1,0,64.08
臺南縣,學甲鎮,慈生里,311,1,420,5,425,610,3,1,3,0,1,0,69.67
臺南縣,學甲鎮,仁得里,312,1,655,5,660,1043,3,1,3,0,1,0,63.28
臺南縣,學甲鎮,仁得里,313,1,549,4,553,892,3,1,3,0,1,0,62.00
臺南縣,學甲鎮,仁得里,314,1,786,7,793,1233,3,1,3,0,1,0,64.31
臺南縣,學甲鎮,新生里,315,1,910,9,919,1374,3,1,3,0,1,0,66.89
臺南縣,學甲鎮,百福里,316,1,353,2,355,545,3,1,3,0,1,0,65.14
臺南縣,學甲鎮,百福里,317,1,494,2,496,703,3,1,3,0,1,0,70.55
臺南縣,學甲鎮,新榮里,318,1,777,7,784,1148,3,1,3,0,1,0,68.29
臺南縣,學甲鎮,文化里,319,1,349,4,353,492,3,1,3,0,1,0,71.75
臺南縣,學甲鎮,大安里,320,1,349,3,352,517,3,1,3,0,1,0,68.09
臺南縣,學甲鎮,美豐里,321,1,530,7,537,811,3,1,3,0,1,0,66.21
臺南縣,學甲鎮,美和里,322,1,240,4,244,361,3,1,3,0,1,0,67.59
臺南縣,學甲鎮,達明里,323,1,508,8,516,710,3,1,3,0,1,0,72.68
臺南縣,學甲鎮,光明里,324,1,218,3,221,369,3,1,3,0,1,0,59.89
臺南縣,學甲鎮,民吉里,325,1,276,6,282,450,3,1,3,0,1,0,62.67
臺南縣,學甲鎮,西進里,326,1,330,4,334,546,3,1,3,0,1,0,61.17
臺南縣,學甲鎮,白渚里,327,1,244,3,247,347,3,1,3,0,1,0,71.18
臺南縣,學甲鎮,光華里,328,1,298,5,303,454,3,1,3,0,1,0,66.74
臺南縣,學甲鎮,光華里,329,1,227,2,229,283,3,1,3,0,1,0,80.92
臺南縣,學甲鎮,頭港里,330,1,382,1,383,596,3,1,3,0,1,0,64.26
臺南縣,學甲鎮,宅港里,331,1,439,7,446,730,3,1,3,0,1,0,61.10
臺南縣,學甲鎮,宅港里,332,1,324,4,328,503,3,1,3,0,1,0,65.21
臺南縣,學甲鎮,平東里,333,1,350,2,352,558,3,1,3,0,1,0,63.08
臺南縣,學甲鎮,平西里,334,1,443,2,445,777,3,1,3,0,1,0,57.27
臺南縣,學甲鎮,頂洲里,335,1,475,4,479,667,3,1,3,0,1,0,71.81
臺南縣,學甲鎮,紅茄里,336,1,323,0,323,542,3,1,3,0,1,0,59.59
臺南縣,學甲鎮,新芳里,337,1,315,4,319,499,3,1,3,0,1,0,63.93
臺南縣,西港鄉,西港村,338,1,864,4,868,1238,3,1,3,0,1,0,70.11
臺南縣,西港鄉,西港村,339,1,745,7,752,1036,3,1,3,0,1,0,72.59
臺南縣,西港鄉,慶安村,340,1,653,6,659,977,3,1,3,0,1,0,67.45
臺南縣,西港鄉,慶安村,341,1,669,11,680,919,3,1,3,0,1,0,73.99
臺南縣,西港鄉,慶安村,342,1,614,9,623,878,3,1,3,0,1,0,70.96
臺南縣,西港鄉,南海村,343,1,832,13,845,1159,3,1,3,0,1,0,72.91
臺南縣,西港鄉,南海村,344,1,440,7,447,602,3,1,3,0,1,0,74.25
臺南縣,西港鄉,港東村,345,1,601,7,608,821,3,1,3,0,1,0,74.06
臺南縣,西港鄉,港東村,346,1,271,2,273,405,3,1,3,0,1,0,67.41
臺南縣,西港鄉,檨林村,347,1,538,6,544,741,3,1,3,0,1,0,73.41
臺南縣,西港鄉,檨林村,348,1,554,5,559,805,3,1,3,0,1,0,69.44
臺南縣,西港鄉,後營村,349,1,865,7,872,1244,3,1,3,0,1,0,70.10
臺南縣,西港鄉,營西村,350,1,850,10,860,1203,3,1,3,0,1,0,71.49
臺南縣,西港鄉,金砂村,351,1,300,5,305,418,3,1,3,0,1,0,72.97
臺南縣,西港鄉,金砂村,352,1,303,0,303,410,3,1,3,0,1,0,73.90
臺南縣,西港鄉,劉厝村,353,1,775,21,796,1114,3,1,3,0,1,0,71.45
臺南縣,西港鄉,竹林村,354,1,816,6,822,1141,3,1,3,0,1,0,72.04
臺南縣,西港鄉,永樂村,355,1,636,7,643,843,3,1,3,0,1,0,76.28
臺南縣,西港鄉,新復村,356,1,315,2,317,421,3,1,3,0,1,0,75.30
臺南縣,西港鄉,永樂村,357,1,450,4,454,650,3,1,3,0,1,0,69.85
臺南縣,七股鄉,後港村,358,1,428,4,432,577,3,1,3,0,1,0,74.87
臺南縣,七股鄉,大潭村,359,1,509,3,512,786,3,1,3,0,1,0,65.14
臺南縣,七股鄉,城內村,360,1,388,4,392,499,3,1,3,0,1,0,78.56
臺南縣,七股鄉,篤加村,361,1,595,5,600,851,3,1,3,0,1,0,70.51
臺南縣,七股鄉,頂山村,362,1,694,7,701,984,3,1,3,0,1,0,71.24
臺南縣,七股鄉,西寮村,363,1,384,1,385,555,3,1,3,0,1,0,69.37
臺南縣,七股鄉,鹽埕村,364,1,337,3,340,470,3,1,3,0,1,0,72.34
臺南縣,七股鄉,中寮村,365,1,592,3,595,762,3,1,3,0,1,0,78.08
臺南縣,七股鄉,龍山村,366,1,505,6,511,771,3,1,3,0,1,0,66.28
臺南縣,七股鄉,龍山村,367,1,597,5,602,855,3,1,3,0,1,0,70.41
臺南縣,七股鄉,溪南村,368,1,262,2,264,349,3,1,3,0,1,0,75.64
臺南縣,七股鄉,七股村,369,1,538,7,545,839,3,1,3,0,1,0,64.96
臺南縣,七股鄉,玉成村,370,1,514,3,517,778,3,1,3,0,1,0,66.45
臺南縣,七股鄉,大埕村,371,1,774,11,785,1236,3,1,3,0,1,0,63.51
臺南縣,七股鄉,大寮村,372,1,661,6,667,987,3,1,3,0,1,0,67.58
臺南縣,七股鄉,看坪村,373,1,403,3,406,560,3,1,3,0,1,0,72.50
臺南縣,七股鄉,樹林村,374,1,699,3,702,919,3,1,3,0,1,0,76.39
臺南縣,七股鄉,竹港村,375,1,417,5,422,552,3,1,3,0,1,0,76.45
臺南縣,七股鄉,竹港村,376,1,550,2,552,760,3,1,3,0,1,0,72.63
臺南縣,七股鄉,義合村,377,1,596,5,601,812,3,1,3,0,1,0,74.01
臺南縣,七股鄉,康榔村,378,1,468,2,470,634,3,1,3,0,1,0,74.13
臺南縣,七股鄉,永吉村,379,1,555,2,557,772,3,1,3,0,1,0,72.15
臺南縣,七股鄉,三股村,380,1,771,11,782,1104,3,1,3,0,1,0,70.83
臺南縣,七股鄉,三股村,381,1,860,11,871,1095,3,1,3,0,1,0,79.54
臺南縣,七股鄉,十份村,382,1,895,12,907,1267,3,1,3,0,1,0,71.59
臺南縣,將軍鄉,長榮村,383,1,594,4,598,809,3,1,3,0,1,0,73.92
臺南縣,將軍鄉,西華村,384,1,808,5,813,1187,3,1,3,0,1,0,68.49
臺南縣,將軍鄉,西和村,385,1,763,11,774,1101,3,1,3,0,1,0,70.30
臺南縣,將軍鄉,忠興村,386,1,1041,3,1044,1461,3,1,3,0,1,0,71.46
臺南縣,將軍鄉,嘉昌村,387,1,254,2,256,357,3,1,3,0,1,0,71.71
臺南縣,將軍鄉,嘉昌村,388,1,425,6,431,568,3,1,3,0,1,0,75.88
臺南縣,將軍鄉,保源村,389,1,337,2,339,464,3,1,3,0,1,0,73.06
臺南縣,將軍鄉,保源村,390,1,417,5,422,590,3,1,3,0,1,0,71.53
臺南縣,將軍鄉,苓和村,391,1,432,4,436,635,3,1,3,0,1,0,68.66
臺南縣,將軍鄉,苓和村,392,1,220,1,221,330,3,1,3,0,1,0,66.97
臺南縣,將軍鄉,仁和村,393,1,526,2,528,846,3,1,3,0,1,0,62.41
臺南縣,將軍鄉,北埔村,394,1,447,4,451,663,3,1,3,0,1,0,68.02
臺南縣,將軍鄉,將富村,395,1,501,5,506,746,3,1,3,0,1,0,67.83
臺南縣,將軍鄉,將貴村,396,1,482,1,483,650,3,1,3,0,1,0,74.31
臺南縣,將軍鄉,三吉村,397,1,294,2,296,438,3,1,3,0,1,0,67.58
臺南縣,將軍鄉,玉山村,398,1,642,4,646,925,3,1,3,0,1,0,69.84
臺南縣,將軍鄉,廣山村,399,1,510,6,516,790,3,1,3,0,1,0,65.32
臺南縣,將軍鄉,長沙村,400,1,970,8,978,1374,3,1,3,0,1,0,71.18
臺南縣,將軍鄉,平沙村,401,1,817,10,827,1177,3,1,3,0,1,0,70.26
臺南縣,將軍鄉,鯤鯓村,402,1,683,9,692,975,3,1,3,0,1,0,70.97
臺南縣,將軍鄉,鯤鯓村,403,1,519,4,523,770,3,1,3,0,1,0,67.92
臺南縣,將軍鄉,鯤溟村,404,1,574,7,581,944,3,1,3,0,1,0,61.55
臺南縣,北門鄉,北門村,405,1,359,3,362,528,3,1,3,0,1,0,68.56
臺南縣,北門鄉,北門村,406,1,283,5,288,415,3,1,3,0,1,0,69.40
臺南縣,北門鄉,永隆村,407,1,341,7,348,521,3,1,3,0,1,0,66.79
臺南縣,北門鄉,永華村,408,1,254,2,256,379,3,1,3,0,1,0,67.55
臺南縣,北門鄉,玉港村,409,1,345,2,347,516,3,1,3,0,1,0,67.25
臺南縣,北門鄉,玉港村,410,1,235,0,235,339,3,1,3,0,1,0,69.32
臺南縣,北門鄉,保吉村,411,1,525,2,527,780,3,1,3,0,1,0,67.56
臺南縣,北門鄉,保吉村,412,1,355,4,359,491,3,1,3,0,1,0,73.12
臺南縣,北門鄉,東壁村,413,1,460,5,465,689,3,1,3,0,1,0,67.49
臺南縣,北門鄉,鯤江村,414,1,277,2,279,429,3,1,3,0,1,0,65.03
臺南縣,北門鄉,鯤江村,415,1,221,0,221,334,3,1,3,0,1,0,66.17
臺南縣,北門鄉,雙春村,416,1,353,0,353,579,3,1,3,0,1,0,60.97
臺南縣,北門鄉,錦湖村,417,1,651,8,659,1112,3,1,3,0,1,0,59.26
臺南縣,北門鄉,慈安村,418,1,413,2,415,661,3,1,3,0,1,0,62.78
臺南縣,北門鄉,三光村,419,1,417,10,427,685,3,1,3,0,1,0,62.34
臺南縣,北門鄉,三光村,420,1,329,0,329,450,3,1,3,0,1,0,73.11
臺南縣,北門鄉,中樞村,421,1,488,3,491,766,3,1,3,0,1,0,64.10
臺南縣,北門鄉,仁里村,422,1,501,5,506,749,3,1,3,0,1,0,67.56
臺南縣,新化鎮,武安里,423,1,511,5,516,712,3,1,3,0,1,0,72.47
臺南縣,新化鎮,武安里,424,1,524,7,531,791,3,1,3,0,1,0,67.13
臺南縣,新化鎮,東榮里,425,1,816,9,825,1255,3,1,3,0,1,0,65.74
臺南縣,新化鎮,東榮里,426,1,826,11,837,1163,3,1,3,0,1,0,71.97
臺南縣,新化鎮,東榮里,427,1,697,14,711,1035,3,1,3,0,1,0,68.70
臺南縣,新化鎮,護國里,428,1,552,15,567,777,3,1,3,0,1,0,72.97
臺南縣,新化鎮,護國里,429,1,330,6,336,749,3,1,3,0,1,0,44.86
臺南縣,新化鎮,太平里,430,1,627,11,638,849,3,1,3,0,1,0,75.15
臺南縣,新化鎮,太平里,431,1,540,11,551,766,3,1,3,0,1,0,71.93
臺南縣,新化鎮,太平里,432,1,544,4,548,757,3,1,3,0,1,0,72.39
臺南縣,新化鎮,太平里,433,1,588,10,598,798,3,1,3,0,1,0,74.94
臺南縣,新化鎮,中央里,434,1,357,5,362,500,3,1,3,0,1,0,72.40
臺南縣,新化鎮,觀音里,435,1,440,7,447,634,3,1,3,0,1,0,70.50
臺南縣,新化鎮,竹林里,436,1,345,4,349,473,3,1,3,0,1,0,73.78
臺南縣,新化鎮,清水里,437,1,653,6,659,924,3,1,3,0,1,0,71.32
臺南縣,新化鎮,協興里,438,1,545,7,552,783,3,1,3,0,1,0,70.50
臺南縣,新化鎮,協興里,439,1,657,4,661,939,3,1,3,0,1,0,70.39
臺南縣,新化鎮,協興里,440,1,572,12,584,853,3,1,3,0,1,0,68.46
臺南縣,新化鎮,唪口里,441,1,879,13,892,1239,3,1,3,0,1,0,71.99
臺南縣,新化鎮,北勢里,442,1,598,6,604,784,3,1,3,0,1,0,77.04
臺南縣,新化鎮,豐榮里,443,1,642,6,648,930,3,1,3,0,1,0,69.68
臺南縣,新化鎮,豐榮里,444,1,739,9,748,959,3,1,3,0,1,0,78.00
臺南縣,新化鎮,全興里,445,1,972,15,987,1360,3,1,3,0,1,0,72.57
臺南縣,新化鎮,崙頂里,446,1,656,9,665,899,3,1,3,0,1,0,73.97
臺南縣,新化鎮,崙頂里,447,1,564,7,571,750,3,1,3,0,1,0,76.13
臺南縣,新化鎮,知義里,448,1,741,14,755,963,3,1,3,0,1,0,78.40
臺南縣,新化鎮,知義里,449,1,698,24,722,1105,3,1,3,0,1,0,65.34
臺南縣,新化鎮,山腳里,450,1,884,17,901,1149,3,1,3,0,1,0,78.42
臺南縣,新化鎮,大坑里,451,1,367,6,373,529,3,1,3,0,1,0,70.51
臺南縣,新化鎮,那拔里,452,1,669,15,684,979,3,1,3,0,1,0,69.87
臺南縣,新化鎮,那拔里,453,1,697,10,707,1002,3,1,3,0,1,0,70.56
臺南縣,新化鎮,羊林里,454,1,559,9,568,858,3,1,3,0,1,0,66.20
臺南縣,新化鎮,礁坑里,455,1,732,7,739,1096,3,1,3,0,1,0,67.43
臺南縣,善化鎮,東關里,456,1,704,8,712,1035,3,1,3,0,1,0,68.79
臺南縣,善化鎮,坐駕里,457,1,701,8,709,987,3,1,3,0,1,0,71.83
臺南縣,善化鎮,坐駕里,458,1,967,11,978,1356,3,1,3,0,1,0,72.12
臺南縣,善化鎮,光文里,459,1,717,16,733,1015,3,1,3,0,1,0,72.22
臺南縣,善化鎮,光文里,460,1,871,11,882,1229,3,1,3,0,1,0,71.77
臺南縣,善化鎮,光文里,461,1,943,14,957,1301,3,1,3,0,1,0,73.56
臺南縣,善化鎮,文昌里,462,1,595,5,600,875,3,1,3,0,1,0,68.57
臺南縣,善化鎮,文昌里,463,1,674,10,684,979,3,1,3,0,1,0,69.87
臺南縣,善化鎮,南關里,464,1,817,15,832,1193,3,1,3,0,1,0,69.74
臺南縣,善化鎮,西關里,465,1,498,3,501,691,3,1,3,0,1,0,72.50
臺南縣,善化鎮,北關里,466,1,343,3,346,495,3,1,3,0,1,0,69.90
臺南縣,善化鎮,文正里,467,1,702,9,711,988,3,1,3,0,1,0,71.96
臺南縣,善化鎮,胡家里,468,1,910,4,914,1254,3,1,3,0,1,0,72.89
臺南縣,善化鎮,胡厝里,469,1,889,16,905,1191,3,1,3,0,1,0,75.99
臺南縣,善化鎮,胡厝里,470,1,507,18,525,743,3,1,3,0,1,0,70.66
臺南縣,善化鎮,什乃里,471,1,564,10,574,794,3,1,3,0,1,0,72.29
臺南縣,善化鎮,溪美里,472,1,595,14,609,836,3,1,3,0,1,0,72.85
臺南縣,善化鎮,溪美里,473,1,531,5,536,750,3,1,3,0,1,0,71.47
臺南縣,善化鎮,六分里,474,1,462,7,469,677,3,1,3,0,1,0,69.28
臺南縣,善化鎮,六德里,475,1,727,9,736,1039,3,1,3,0,1,0,70.84
臺南縣,善化鎮,田寮里,476,1,488,4,492,712,3,1,3,0,1,0,69.10
臺南縣,善化鎮,田寮里,477,1,636,5,641,956,3,1,3,0,1,0,67.05
臺南縣,善化鎮,東隆里,478,1,531,11,542,778,3,1,3,0,1,0,69.67
臺南縣,善化鎮,東昌里,479,1,632,10,642,957,3,1,3,0,1,0,67.08
臺南縣,善化鎮,牛庄里,480,1,952,12,964,1375,3,1,3,0,1,0,70.11
臺南縣,善化鎮,嘉北里,481,1,950,13,963,1337,3,1,3,0,1,0,72.03
臺南縣,善化鎮,嘉南里,482,1,701,6,707,971,3,1,3,0,1,0,72.81
臺南縣,善化鎮,小新里,483,1,751,12,763,1052,3,1,3,0,1,0,72.53
臺南縣,善化鎮,小新里,484,1,801,11,812,1114,3,1,3,0,1,0,72.89
臺南縣,新市鄉,新市村,485,1,616,8,624,885,3,1,3,0,1,0,70.51
臺南縣,新市鄉,新市村,486,1,687,11,698,1060,3,1,3,0,1,0,65.85
臺南縣,新市鄉,新和村,487,1,952,21,973,1409,3,1,3,0,1,0,69.06
臺南縣,新市鄉,新和村,488,1,466,5,471,657,3,1,3,0,1,0,71.69
臺南縣,新市鄉,新和村,489,1,804,10,814,1176,3,1,3,0,1,0,69.22
臺南縣,新市鄉,新和村,490,1,805,6,811,1200,3,1,3,0,1,0,67.58
臺南縣,新市鄉,社內村,491,1,567,7,574,779,3,1,3,0,1,0,73.68
臺南縣,新市鄉,社內村,492,1,624,6,630,864,3,1,3,0,1,0,72.92
臺南縣,新市鄉,大洲村,493,1,467,2,469,610,3,1,3,0,1,0,76.89
臺南縣,新市鄉,豐華村,494,1,532,7,539,816,3,1,3,0,1,0,66.05
臺南縣,新市鄉,三舍村,495,1,620,9,629,881,3,1,3,0,1,0,71.40
臺南縣,新市鄉,大營村,496,1,586,4,590,797,3,1,3,0,1,0,74.03
臺南縣,新市鄉,大營村,497,1,430,5,435,583,3,1,3,0,1,0,74.61
臺南縣,新市鄉,大營村,498,1,406,7,413,549,3,1,3,0,1,0,75.23
臺南縣,新市鄉,大社村,499,1,847,13,860,1327,3,1,3,0,1,0,64.81
臺南縣,新市鄉,大社村,500,1,918,13,931,1346,3,1,3,0,1,0,69.17
臺南縣,新市鄉,潭頂村,501,1,911,18,929,1338,3,1,3,0,1,0,69.43
臺南縣,新市鄉,港墘村,502,1,467,9,476,682,3,1,3,0,1,0,69.79
臺南縣,新市鄉,港墘村,503,1,573,8,581,834,3,1,3,0,1,0,69.66
臺南縣,新市鄉,港墘村,504,1,626,11,637,916,3,1,3,0,1,0,69.54
臺南縣,新市鄉,永就村,505,1,340,9,349,445,3,1,3,0,1,0,78.43
臺南縣,新市鄉,永就村,506,1,553,6,559,750,3,1,3,0,1,0,74.53
臺南縣,安定鄉,蘇林村,507,1,816,4,820,1086,3,1,3,0,1,0,75.51
臺南縣,安定鄉,蘇林村,508,1,658,8,666,897,3,1,3,0,1,0,74.25
臺南縣,安定鄉,蘇厝村,509,1,608,10,618,877,3,1,3,0,1,0,70.47
臺南縣,安定鄉,蘇厝村,510,1,561,8,569,761,3,1,3,0,1,0,74.77
臺南縣,安定鄉,安定村,511,1,928,11,939,1275,3,1,3,0,1,0,73.65
臺南縣,安定鄉,安加村,512,1,835,8,843,1121,3,1,3,0,1,0,75.20
臺南縣,安定鄉,保西村,513,1,516,6,522,687,3,1,3,0,1,0,75.98
臺南縣,安定鄉,港尾村,514,1,971,11,982,1329,3,1,3,0,1,0,73.89
臺南縣,安定鄉,中榮村,515,1,728,11,739,968,3,1,3,0,1,0,76.34
臺南縣,安定鄉,港口村,516,1,648,4,652,929,3,1,3,0,1,0,70.18
臺南縣,安定鄉,港口村,517,1,679,13,692,926,3,1,3,0,1,0,74.73
臺南縣,安定鄉,港南村,518,1,772,6,778,1065,3,1,3,0,1,0,73.05
臺南縣,安定鄉,港南村,519,1,630,11,641,876,3,1,3,0,1,0,73.17
臺南縣,安定鄉,大同村,520,1,439,9,448,585,3,1,3,0,1,0,76.58
臺南縣,安定鄉,六嘉村,521,1,905,12,917,1247,3,1,3,0,1,0,73.54
臺南縣,安定鄉,中沙村,522,1,507,2,509,689,3,1,3,0,1,0,73.88
臺南縣,安定鄉,新吉村,523,1,1103,10,1113,1466,3,1,3,0,1,0,75.92
臺南縣,安定鄉,海寮村,524,1,736,8,744,945,3,1,3,0,1,0,78.73
臺南縣,安定鄉,海寮村,525,1,722,9,731,981,3,1,3,0,1,0,74.52
臺南縣,安定鄉,管寮村,526,1,646,9,655,887,3,1,3,0,1,0,73.84
臺南縣,安定鄉,南安村,527,1,349,4,353,437,3,1,3,0,1,0,80.78
臺南縣,山上鄉,明和村,528,1,626,5,631,847,3,1,3,0,1,0,74.50
臺南縣,山上鄉,明和村,529,1,525,4,529,784,3,1,3,0,1,0,67.47
臺南縣,山上鄉,南洲村,530,1,503,6,509,709,3,1,3,0,1,0,71.79
臺南縣,山上鄉,南洲村,531,1,534,5,539,751,3,1,3,0,1,0,71.77
臺南縣,山上鄉,山上村,532,1,605,14,619,860,3,1,3,0,1,0,71.98
臺南縣,山上鄉,新莊村,533,1,450,3,453,661,3,1,3,0,1,0,68.53
臺南縣,山上鄉,玉峰村,534,1,413,4,417,567,3,1,3,0,1,0,73.54
臺南縣,山上鄉,平陽村,535,1,292,2,294,369,3,1,3,0,1,0,79.67
臺南縣,山上鄉,豐德村,536,1,224,3,227,307,3,1,3,0,1,0,73.94
臺南縣,玉井鄉,玉井村,537,1,732,6,738,1054,3,1,3,0,1,0,70.02
臺南縣,玉井鄉,玉田村,538,1,1369,11,1380,2068,3,1,3,0,1,0,66.73
臺南縣,玉井鄉,玉田村,539,1,1338,12,1350,1918,3,1,3,0,1,0,70.39
臺南縣,玉井鄉,中正村,540,1,882,9,891,1282,3,1,3,0,1,0,69.50
臺南縣,玉井鄉,竹圍村,541,1,833,7,840,1260,3,1,3,0,1,0,66.67
臺南縣,玉井鄉,沙田村,542,1,339,5,344,496,3,1,3,0,1,0,69.35
臺南縣,玉井鄉,三埔村,543,1,308,2,310,501,3,1,3,0,1,0,61.88
臺南縣,玉井鄉,三和村,544,1,556,5,561,772,3,1,3,0,1,0,72.67
臺南縣,玉井鄉,望明村,545,1,1025,10,1035,1523,3,1,3,0,1,0,67.96
臺南縣,玉井鄉,層林村,546,1,514,2,516,710,3,1,3,0,1,0,72.68
臺南縣,玉井鄉,豐里村,547,1,737,6,743,1073,3,1,3,0,1,0,69.25
臺南縣,楠西鄉,楠西村,548,1,648,6,654,1018,3,1,3,0,1,0,64.24
臺南縣,楠西鄉,楠西村,549,1,563,4,567,854,3,1,3,0,1,0,66.39
臺南縣,楠西鄉,灣丘村,550,1,814,12,826,1305,3,1,3,0,1,0,63.30
臺南縣,楠西鄉,密枝村,551,1,583,11,594,903,3,1,3,0,1,0,65.78
臺南縣,楠西鄉,照興村,552,1,664,3,667,1102,3,1,3,0,1,0,60.53
臺南縣,楠西鄉,鹿田村,553,1,743,11,754,1108,3,1,3,0,1,0,68.05
臺南縣,楠西鄉,龜丹村,554,1,466,4,470,689,3,1,3,0,1,0,68.21
臺南縣,楠西鄉,東勢村,555,1,718,8,726,1043,3,1,3,0,1,0,69.61
臺南縣,楠西鄉,東勢村,556,1,763,9,772,1193,3,1,3,0,1,0,64.71
臺南縣,南化鄉,南化村,557,1,932,13,945,1404,3,1,3,0,1,0,67.31
臺南縣,南化鄉,小崙村,558,1,548,5,553,789,3,1,3,0,1,0,70.09
臺南縣,南化鄉,中坑村,559,1,360,5,365,493,3,1,3,0,1,0,74.04
臺南縣,南化鄉,北平村,560,1,385,3,388,550,3,1,3,0,1,0,70.55
臺南縣,南化鄉,東和村,561,1,397,10,407,670,3,1,3,0,1,0,60.75
臺南縣,南化鄉,西埔村,562,1,571,8,579,846,3,1,3,0,1,0,68.44
臺南縣,南化鄉,北寮村,563,1,815,6,821,1184,3,1,3,0,1,0,69.34
臺南縣,南化鄉,玉山村,564,1,668,3,671,921,3,1,3,0,1,0,72.86
臺南縣,南化鄉,關山村,565,1,260,5,265,518,3,1,3,0,1,0,51.16
臺南縣,左鎮鄉,光和村,566,1,319,9,328,489,3,1,3,0,1,0,67.08
臺南縣,左鎮鄉,榮和村,567,1,488,7,495,747,3,1,3,0,1,0,66.27
臺南縣,左鎮鄉,左鎮村,568,1,382,7,389,549,3,1,3,0,1,0,70.86
臺南縣,左鎮鄉,中正村,569,1,681,5,686,916,3,1,3,0,1,0,74.89
臺南縣,左鎮鄉,睦光村,570,1,258,1,259,333,3,1,3,0,1,0,77.78
臺南縣,左鎮鄉,內庄村,571,1,331,6,337,481,3,1,3,0,1,0,70.06
臺南縣,左鎮鄉,岡林村,572,1,290,6,296,431,3,1,3,0,1,0,68.68
臺南縣,左鎮鄉,草山村,573,1,220,2,222,303,3,1,3,0,1,0,73.27
臺南縣,左鎮鄉,二寮村,574,1,156,2,158,217,3,1,3,0,1,0,72.81
臺南縣,左鎮鄉,澄山村,575,1,381,6,387,606,3,1,3,0,1,0,63.86
臺南縣,仁德鄉,太子村,576,1,965,7,972,1383,3,1,3,0,1,0,70.28
臺南縣,仁德鄉,太子村,577,1,799,11,810,1107,3,1,3,0,1,0,73.17
臺南縣,仁德鄉,太子村,578,1,736,9,745,1130,3,1,3,0,1,0,65.93
臺南縣,仁德鄉,土庫村,579,1,680,4,684,962,3,1,3,0,1,0,71.10
臺南縣,仁德鄉,土庫村,580,1,751,7,758,1087,3,1,3,0,1,0,69.73
臺南縣,仁德鄉,一甲村,581,1,493,7,500,702,3,1,3,0,1,0,71.23
臺南縣,仁德鄉,一甲村,582,1,513,6,519,817,3,1,3,0,1,0,63.53
臺南縣,仁德鄉,仁德村,583,1,779,14,793,1131,3,1,3,0,1,0,70.11
臺南縣,仁德鄉,仁德村,584,1,602,8,610,954,3,1,3,0,1,0,63.94
臺南縣,仁德鄉,仁德村,585,1,716,4,720,1117,3,1,3,0,1,0,64.46
臺南縣,仁德鄉,仁義村,586,1,785,9,794,1056,3,1,3,0,1,0,75.19
臺南縣,仁德鄉,仁義村,587,1,743,9,752,1033,3,1,3,0,1,0,72.80
臺南縣,仁德鄉,仁義村,588,1,813,8,821,1332,3,1,3,0,1,0,61.64
臺南縣,仁德鄉,仁義村,589,1,497,6,503,736,3,1,3,0,1,0,68.34
臺南縣,仁德鄉,仁義村,590,1,737,17,754,1089,3,1,3,0,1,0,69.24
臺南縣,仁德鄉,新田村,591,1,870,11,881,1331,3,1,3,0,1,0,66.19
臺南縣,仁德鄉,新田村,592,1,495,7,502,737,3,1,3,0,1,0,68.11
臺南縣,仁德鄉,後壁村,593,1,639,9,648,1056,3,1,3,0,1,0,61.36
臺南縣,仁德鄉,後壁村,594,1,792,13,805,1173,3,1,3,0,1,0,68.63
臺南縣,仁德鄉,後壁村,595,1,760,14,774,1160,3,1,3,0,1,0,66.72
臺南縣,仁德鄉,後壁村,596,1,746,16,762,1335,3,1,3,0,1,0,57.08
臺南縣,仁德鄉,上崙村,597,1,729,16,745,1216,3,1,3,0,1,0,61.27
臺南縣,仁德鄉,上崙村,598,1,889,9,898,1368,3,1,3,0,1,0,65.64
臺南縣,仁德鄉,上崙村,599,1,447,12,459,646,3,1,3,0,1,0,71.05
臺南縣,仁德鄉,田厝村,600,1,855,15,870,1162,3,1,3,0,1,0,74.87
臺南縣,仁德鄉,三甲村,601,1,451,5,456,625,3,1,3,0,1,0,72.96
臺南縣,仁德鄉,保安村,602,1,473,5,478,728,3,1,3,0,1,0,65.66
臺南縣,仁德鄉,保安村,603,1,777,7,784,1221,3,1,3,0,1,0,64.21
臺南縣,仁德鄉,成功村,604,1,742,14,756,1132,3,1,3,0,1,0,66.78
臺南縣,仁德鄉,成功村,605,1,621,10,631,936,3,1,3,0,1,0,67.41
臺南縣,仁德鄉,成功村,606,1,705,11,716,1057,3,1,3,0,1,0,67.74
臺南縣,仁德鄉,成功村,607,1,207,7,214,343,3,1,3,0,1,0,62.39
臺南縣,仁德鄉,仁和村,608,1,868,20,888,1249,3,1,3,0,1,0,71.10
臺南縣,仁德鄉,仁愛村,609,1,697,9,706,1001,3,1,3,0,1,0,70.53
臺南縣,仁德鄉,仁愛村,610,1,654,9,663,963,3,1,3,0,1,0,68.85
臺南縣,仁德鄉,二行村,611,1,702,17,719,1097,3,1,3,0,1,0,65.54
臺南縣,仁德鄉,二行村,612,1,549,11,560,800,3,1,3,0,1,0,70.00
臺南縣,仁德鄉,大甲村,613,1,556,12,568,772,3,1,3,0,1,0,73.58
臺南縣,仁德鄉,大甲村,614,1,684,9,693,991,3,1,3,0,1,0,69.93
臺南縣,仁德鄉,中洲村,615,1,727,6,733,1219,3,1,3,0,1,0,60.13
臺南縣,仁德鄉,中生村,616,1,827,14,841,1307,3,1,3,0,1,0,64.35
臺南縣,歸仁鄉,南保村,617,1,900,15,915,1282,3,1,3,0,1,0,71.37
臺南縣,歸仁鄉,南保村,618,1,775,11,786,1163,3,1,3,0,1,0,67.58
臺南縣,歸仁鄉,南保村,619,1,885,13,898,1222,3,1,3,0,1,0,73.49
臺南縣,歸仁鄉,南興村,620,1,756,11,767,1143,3,1,3,0,1,0,67.10
臺南縣,歸仁鄉,南興村,621,1,677,8,685,998,3,1,3,0,1,0,68.64
臺南縣,歸仁鄉,六甲村,622,1,692,6,698,1004,3,1,3,0,1,0,69.52
臺南縣,歸仁鄉,六甲村,623,1,669,7,676,1028,3,1,3,0,1,0,65.76
臺南縣,歸仁鄉,六甲村,624,1,722,9,731,1035,3,1,3,0,1,0,70.63
臺南縣,歸仁鄉,六甲村,625,1,844,15,859,1277,3,1,3,0,1,0,67.27
臺南縣,歸仁鄉,後市村,626,1,786,4,790,1098,3,1,3,0,1,0,71.95
臺南縣,歸仁鄉,後市村,627,1,719,6,725,1019,3,1,3,0,1,0,71.15
臺南縣,歸仁鄉,後市村,628,1,666,8,674,1015,3,1,3,0,1,0,66.40
臺南縣,歸仁鄉,後市村,629,1,764,6,770,1126,3,1,3,0,1,0,68.38
臺南縣,歸仁鄉,辜厝村,630,1,957,12,969,1395,3,1,3,0,1,0,69.46
臺南縣,歸仁鄉,辜厝村,631,1,858,10,868,1344,3,1,3,0,1,0,64.58
臺南縣,歸仁鄉,辜厝村,632,1,811,9,820,1178,3,1,3,0,1,0,69.61
臺南縣,歸仁鄉,許厝村,633,1,997,10,1007,1423,3,1,3,0,1,0,70.77
臺南縣,歸仁鄉,許厝村,634,1,719,2,721,958,3,1,3,0,1,0,75.26
臺南縣,歸仁鄉,看西村,635,1,859,9,868,1200,3,1,3,0,1,0,72.33
臺南縣,歸仁鄉,看東村,636,1,857,17,874,1194,3,1,3,0,1,0,73.20
臺南縣,歸仁鄉,崙頂村,637,1,584,4,588,773,3,1,3,0,1,0,76.07
臺南縣,歸仁鄉,崙頂村,638,1,652,5,657,851,3,1,3,0,1,0,77.20
臺南縣,歸仁鄉,沙崙村,639,1,334,4,338,484,3,1,3,0,1,0,69.83
臺南縣,歸仁鄉,大潭村,640,1,602,8,610,835,3,1,3,0,1,0,73.05
臺南縣,歸仁鄉,大潭村,641,1,489,3,492,710,3,1,3,0,1,0,69.30
臺南縣,歸仁鄉,武東村,642,1,746,17,763,1348,3,1,3,0,1,0,56.60
臺南縣,歸仁鄉,歸仁村,643,1,554,10,564,844,3,1,3,0,1,0,66.82
臺南縣,歸仁鄉,歸仁村,644,1,538,2,540,760,3,1,3,0,1,0,71.05
臺南縣,歸仁鄉,八甲村,645,1,742,1,743,1045,3,1,3,0,1,0,71.10
臺南縣,歸仁鄉,八甲村,646,1,459,8,467,652,3,1,3,0,1,0,71.63
臺南縣,歸仁鄉,七甲村,647,1,960,8,968,1397,3,1,3,0,1,0,69.29
臺南縣,歸仁鄉,媽廟村,648,1,624,6,630,888,3,1,3,0,1,0,70.95
臺南縣,歸仁鄉,媽廟村,649,1,523,11,534,764,3,1,3,0,1,0,69.90
臺南縣,歸仁鄉,西埔村,650,1,500,9,509,659,3,1,3,0,1,0,77.24
臺南縣,歸仁鄉,西埔村,651,1,387,6,393,567,3,1,3,0,1,0,69.31
臺南縣,歸仁鄉,大廟村,652,1,776,16,792,1150,3,1,3,0,1,0,68.87
臺南縣,歸仁鄉,大廟村,653,1,566,13,579,767,3,1,3,0,1,0,75.49
臺南縣,關廟鄉,關廟村,654,1,563,3,566,806,3,1,3,0,1,0,70.22
臺南縣,關廟鄉,關廟村,655,1,683,7,690,937,3,1,3,0,1,0,73.64
臺南縣,關廟鄉,山西村,656,1,586,5,591,835,3,1,3,0,1,0,70.78
臺南縣,關廟鄉,山西村,657,1,609,5,614,850,3,1,3,0,1,0,72.24
臺南縣,關廟鄉,香洋村,658,1,725,5,730,1038,3,1,3,0,1,0,70.33
臺南縣,關廟鄉,香洋村,659,1,761,4,765,1144,3,1,3,0,1,0,66.87
臺南縣,關廟鄉,香洋村,660,1,838,14,852,1237,3,1,3,0,1,0,68.88
臺南縣,關廟鄉,北勢村,661,1,855,12,867,1272,3,1,3,0,1,0,68.16
臺南縣,關廟鄉,北勢村,662,1,794,8,802,1192,3,1,3,0,1,0,67.28
臺南縣,關廟鄉,新埔村,663,1,538,4,542,758,3,1,3,0,1,0,71.50
臺南縣,關廟鄉,新光村,664,1,531,7,538,794,3,1,3,0,1,0,67.76
臺南縣,關廟鄉,五甲村,665,1,882,14,896,1254,3,1,3,0,1,0,71.45
臺南縣,關廟鄉,五甲村,666,1,732,8,740,1001,3,1,3,0,1,0,73.93
臺南縣,關廟鄉,東勢村,667,1,922,7,929,1354,3,1,3,0,1,0,68.61
臺南縣,關廟鄉,東勢村,668,1,832,6,838,1208,3,1,3,0,1,0,69.37
臺南縣,關廟鄉,松腳村,669,1,571,7,578,855,3,1,3,0,1,0,67.60
臺南縣,關廟鄉,松腳村,670,1,730,6,736,1030,3,1,3,0,1,0,71.46
臺南縣,關廟鄉,南花村,671,1,878,11,889,1278,3,1,3,0,1,0,69.56
臺南縣,關廟鄉,北花村,672,1,649,8,657,905,3,1,3,0,1,0,72.60
臺南縣,關廟鄉,北花村,673,1,801,7,808,1170,3,1,3,0,1,0,69.06
臺南縣,關廟鄉,深坑村,674,1,1049,9,1058,1412,3,1,3,0,1,0,74.93
臺南縣,關廟鄉,布袋村,675,1,768,10,778,1170,3,1,3,0,1,0,66.50
臺南縣,關廟鄉,田中村,676,1,513,5,518,774,3,1,3,0,1,0,66.93
臺南縣,關廟鄉,龜洞村,677,1,526,5,531,719,3,1,3,0,1,0,73.85
臺南縣,關廟鄉,埤頭村,678,1,924,7,931,1335,3,1,3,0,1,0,69.74
臺南縣,關廟鄉,下湖村,679,1,299,6,305,396,3,1,3,0,1,0,77.02
臺南縣,龍崎鄉,崎頂村,680,1,811,8,819,1200,3,1,3,0,1,0,68.25
臺南縣,龍崎鄉,土崎村,681,1,501,6,507,693,3,1,3,0,1,0,73.16
臺南縣,龍崎鄉,中坑村,682,1,111,1,112,202,3,1,3,0,1,0,55.45
臺南縣,龍崎鄉,楠坑村,683,1,224,4,228,306,3,1,3,0,1,0,74.51
臺南縣,龍崎鄉,牛埔村,684,1,213,2,215,285,3,1,3,0,1,0,75.44
臺南縣,龍崎鄉,大坪村,685,1,230,0,230,325,3,1,3,0,1,0,70.77
臺南縣,龍崎鄉,龍船村,686,1,322,2,324,437,3,1,3,0,1,0,74.14
臺南縣,龍崎鄉,石曹村,687,1,253,3,256,393,3,1,3,0,1,0,65.14
臺南縣,永康市,五王里,688,1,768,9,777,1270,3,1,3,0,1,0,61.18
臺南縣,永康市,五王里,689,1,623,7,630,1031,3,1,3,0,1,0,61.11
臺南縣,永康市,五王里,690,1,672,6,678,1126,3,1,3,0,1,0,60.21
臺南縣,永康市,三合里,691,1,733,16,749,1183,3,1,3,0,1,0,63.31
臺南縣,永康市,三合里,692,1,635,13,648,1046,3,1,3,0,1,0,61.95
臺南縣,永康市,六合里,693,1,731,12,743,1118,3,1,3,0,1,0,66.46
臺南縣,永康市,六合里,694,1,386,6,392,661,3,1,3,0,1,0,59.30
臺南縣,永康市,網寮里,695,1,995,16,1011,1672,3,1,3,0,1,0,60.47
臺南縣,永康市,網寮里,696,1,759,7,766,1200,3,1,3,0,1,0,63.83
臺南縣,永康市,二王里,697,1,658,6,664,990,3,1,3,0,1,0,67.07
臺南縣,永康市,二王里,698,1,764,7,771,1244,3,1,3,0,1,0,61.98
臺南縣,永康市,二王里,699,1,587,5,592,917,3,1,3,0,1,0,64.56
臺南縣,永康市,二王里,700,1,703,10,713,1188,3,1,3,0,1,0,60.02
臺南縣,永康市,永康里,701,1,717,10,727,1082,3,1,3,0,1,0,67.19
臺南縣,永康市,永康里,702,1,878,8,886,1247,3,1,3,0,1,0,71.05
臺南縣,永康市,永康里,703,1,838,4,842,1245,3,1,3,0,1,0,67.63
臺南縣,永康市,永康里,704,1,600,7,607,1037,3,1,3,0,1,0,58.53
臺南縣,永康市,埔園里,705,1,730,13,743,1027,3,1,3,0,1,0,72.35
臺南縣,永康市,埔園里,706,1,751,11,762,1103,3,1,3,0,1,0,69.08
臺南縣,永康市,埔園里,707,1,865,17,882,1289,3,1,3,0,1,0,68.43
臺南縣,永康市,正強里,708,1,737,6,743,1083,3,1,3,0,1,0,68.61
臺南縣,永康市,正強里,709,1,674,6,680,1012,3,1,3,0,1,0,67.19
臺南縣,永康市,正強里,710,1,859,11,870,1394,3,1,3,0,1,0,62.41
臺南縣,永康市,正強里,711,1,700,9,709,1048,3,1,3,0,1,0,67.65
臺南縣,永康市,大橋里,712,1,890,19,909,1531,3,1,3,0,1,0,59.37
臺南縣,永康市,大橋里,713,1,700,8,708,1090,3,1,3,0,1,0,64.95
臺南縣,永康市,大橋里,714,1,591,3,594,943,3,1,3,0,1,0,62.99
臺南縣,永康市,東橋里,715,1,433,8,441,697,3,1,3,0,1,0,63.27
臺南縣,永康市,東橋里,716,1,492,3,495,776,3,1,3,0,1,0,63.79
臺南縣,永康市,東橋里,717,1,473,8,481,709,3,1,3,0,1,0,67.84
臺南縣,永康市,西橋里,718,1,629,19,648,1085,3,1,3,0,1,0,59.72
臺南縣,永康市,西橋里,719,1,640,6,646,1025,3,1,3,0,1,0,63.02
臺南縣,永康市,安康里,720,1,587,7,594,1015,3,1,3,0,1,0,58.52
臺南縣,永康市,安康里,721,1,642,15,657,1068,3,1,3,0,1,0,61.52
臺南縣,永康市,蔦松里,722,1,822,11,833,1171,3,1,3,0,1,0,71.14
臺南縣,永康市,三民里,723,1,729,9,738,1010,3,1,3,0,1,0,73.07
臺南縣,永康市,鹽行里,724,1,732,15,747,988,3,1,3,0,1,0,75.61
臺南縣,永康市,鹽行里,725,1,681,9,690,1015,3,1,3,0,1,0,67.98
臺南縣,永康市,鹽行里,726,1,660,8,668,1030,3,1,3,0,1,0,64.85
臺南縣,永康市,鹽行里,727,1,583,8,591,993,3,1,3,0,1,0,59.52
臺南縣,永康市,鹽行里,728,1,606,8,614,895,3,1,3,0,1,0,68.60
臺南縣,永康市,鹽洲里,729,1,841,15,856,1245,3,1,3,0,1,0,68.76
臺南縣,永康市,鹽洲里,730,1,735,15,750,1090,3,1,3,0,1,0,68.81
臺南縣,永康市,鹽洲里,731,1,620,7,627,910,3,1,3,0,1,0,68.90
臺南縣,永康市,甲頂里,732,1,521,5,526,698,3,1,3,0,1,0,75.36
臺南縣,永康市,甲頂里,733,1,481,1,482,790,3,1,3,0,1,0,61.01
臺南縣,永康市,甲頂里,734,1,499,5,504,740,3,1,3,0,1,0,68.11
臺南縣,永康市,尚頂里,735,1,631,5,636,913,3,1,3,0,1,0,69.66
臺南縣,永康市,尚頂里,736,1,580,6,586,952,3,1,3,0,1,0,61.55
臺南縣,永康市,尚頂里,737,1,523,8,531,790,3,1,3,0,1,0,67.22
臺南縣,永康市,龍潭里,738,1,814,13,827,1189,3,1,3,0,1,0,69.55
臺南縣,永康市,龍潭里,739,1,674,10,684,1036,3,1,3,0,1,0,66.02
臺南縣,永康市,龍潭里,740,1,697,9,706,1066,3,1,3,0,1,0,66.23
臺南縣,永康市,龍潭里,741,1,624,10,634,1114,3,1,3,0,1,0,56.91
臺南縣,永康市,王行里,742,1,689,10,699,1041,3,1,3,0,1,0,67.15
臺南縣,永康市,王行里,743,1,340,2,342,465,3,1,3,0,1,0,73.55
臺南縣,永康市,烏竹里,744,1,789,6,795,1162,3,1,3,0,1,0,68.42
臺南縣,永康市,西勢里,745,1,769,12,781,1092,3,1,3,0,1,0,71.52
臺南縣,永康市,西勢里,746,1,646,6,652,970,3,1,3,0,1,0,67.22
臺南縣,永康市,西勢里,747,1,679,20,699,1020,3,1,3,0,1,0,68.53
臺南縣,永康市,新樹里,748,1,769,11,780,1133,3,1,3,0,1,0,68.84
臺南縣,永康市,大灣里,749,1,735,9,744,997,3,1,3,0,1,0,74.62
臺南縣,永康市,大灣里,750,1,528,7,535,733,3,1,3,0,1,0,72.99
臺南縣,永康市,大灣里,751,1,687,9,696,964,3,1,3,0,1,0,72.20
臺南縣,永康市,東灣里,752,1,616,7,623,870,3,1,3,0,1,0,71.61
臺南縣,永康市,東灣里,753,1,574,10,584,850,3,1,3,0,1,0,68.71
臺南縣,永康市,東灣里,754,1,683,3,686,1022,3,1,3,0,1,0,67.12
臺南縣,永康市,西灣里,755,1,849,12,861,1213,3,1,3,0,1,0,70.98
臺南縣,永康市,西灣里,756,1,825,14,839,1296,3,1,3,0,1,0,64.74
臺南縣,永康市,西灣里,757,1,861,17,878,1280,3,1,3,0,1,0,68.59
臺南縣,永康市,南灣里,758,1,620,6,626,853,3,1,3,0,1,0,73.39
臺南縣,永康市,南灣里,759,1,766,6,772,1063,3,1,3,0,1,0,72.62
臺南縣,永康市,南灣里,760,1,872,7,879,1236,3,1,3,0,1,0,71.12
臺南縣,永康市,崑山里,761,1,690,13,703,1100,3,1,3,0,1,0,63.91
臺南縣,永康市,崑山里,762,1,699,14,713,1015,3,1,3,0,1,0,70.25
臺南縣,永康市,崑山里,763,1,754,12,766,1177,3,1,3,0,1,0,65.08
臺南縣,永康市,崑山里,764,1,670,7,677,1033,3,1,3,0,1,0,65.54
臺南縣,永康市,北灣里,765,1,840,13,853,1161,3,1,3,0,1,0,73.47
臺南縣,永康市,北灣里,766,1,842,11,853,1284,3,1,3,0,1,0,66.43
臺南縣,永康市,北灣里,767,1,965,12,977,1554,3,1,3,0,1,0,62.87
臺南縣,永康市,復興里,768,1,604,17,621,891,3,1,3,0,1,0,69.70
臺南縣,永康市,復興里,769,1,727,15,742,1056,3,1,3,0,1,0,70.27
臺南縣,永康市,建國里,770,1,858,14,872,1220,3,1,3,0,1,0,71.48
臺南縣,永康市,建國里,771,1,672,12,684,878,3,1,3,0,1,0,77.90
臺南縣,永康市,復國里,772,1,714,5,719,1034,3,1,3,0,1,0,69.54
臺南縣,永康市,復國里,773,1,558,6,564,860,3,1,3,0,1,0,65.58
臺南縣,永康市,復華里,774,1,1264,16,1280,2111,3,1,3,0,1,0,60.63
臺南縣,永康市,復華里,775,1,705,14,719,1248,3,1,3,0,1,0,57.61
臺南縣,永康市,復華里,776,1,768,12,780,1166,3,1,3,0,1,0,66.90
臺南縣,永康市,復華里,777,1,806,9,815,1404,3,1,3,0,1,0,58.05
臺南縣,永康市,光復里,778,1,904,15,919,1259,3,1,3,0,1,0,72.99
臺南縣,永康市,神洲里,779,1,717,7,724,963,3,1,3,0,1,0,75.18
臺南縣,永康市,神洲里,780,1,553,8,561,863,3,1,3,0,1,0,65.01
臺南縣,永康市,成功里,781,1,800,11,811,1106,3,1,3,0,1,0,73.33
臺南縣,永康市,成功里,782,1,819,14,833,1254,3,1,3,0,1,0,66.43
臺南縣,永康市,中華里,783,1,490,4,494,797,3,1,3,0,1,0,61.98
臺南縣,永康市,中華里,784,1,496,1,497,800,3,1,3,0,1,0,62.13
臺南縣,永康市,中興里,785,1,804,14,818,1268,3,1,3,0,1,0,64.51
臺南縣,永康市,中興里,786,1,923,16,939,1458,3,1,3,0,1,0,64.40
臺南縣,永康市,勝利里,787,1,631,10,641,973,3,1,3,0,1,0,65.88
臺南縣,永康市,勝利里,788,1,643,6,649,1081,3,1,3,0,1,0,60.04
臺南縣,永康市,勝利里,789,1,577,3,580,942,3,1,3,0,1,0,61.57
臺南縣,永康市,勝利里,790,1,590,12,602,1001,3,1,3,0,1,0,60.14
高雄縣,鳳山市,鳳崗里,1,1,469,5,474,690,3,1,3,0,1,0,68.70
高雄縣,鳳山市,鳳崗里,2,1,511,6,517,754,3,1,3,0,1,0,68.57
高雄縣,鳳山市,縣衙里,3,1,584,6,590,924,3,1,3,0,1,0,63.85
高雄縣,鳳山市,曹公里,4,1,802,8,810,1184,3,1,3,0,1,0,68.41
高雄縣,鳳山市,曹公里,5,1,734,8,742,1121,3,1,3,0,1,0,66.19
高雄縣,鳳山市,鎮西里,6,1,925,14,939,1428,3,1,3,0,1,0,65.76
高雄縣,鳳山市,鎮西里,7,1,806,14,820,1267,3,1,3,0,1,0,64.72
高雄縣,鳳山市,鎮西里,8,1,777,1,778,1111,3,1,3,0,1,0,70.03
高雄縣,鳳山市,鎮西里,9,1,851,5,856,1357,3,1,3,0,1,0,63.08
高雄縣,鳳山市,北門里,10,1,696,11,707,1053,3,1,3,0,1,0,67.14
高雄縣,鳳山市,北門里,11,1,667,13,680,993,3,1,3,0,1,0,68.48
高雄縣,鳳山市,北門里,12,1,668,13,681,1043,3,1,3,0,1,0,65.29
高雄縣,鳳山市,北門里,13,1,696,6,702,1072,3,1,3,0,1,0,65.49
高雄縣,鳳山市,鎮北里,14,1,953,3,956,1557,3,1,3,0,1,0,61.40
高雄縣,鳳山市,鎮北里,15,1,827,15,842,1312,3,1,3,0,1,0,64.18
高雄縣,鳳山市,鎮北里,16,1,700,7,707,1154,3,1,3,0,1,0,61.27
高雄縣,鳳山市,鎮北里,17,1,1069,13,1082,1686,3,1,3,0,1,0,64.18
高雄縣,鳳山市,忠誠里,18,1,783,11,794,1153,3,1,3,0,1,0,68.86
高雄縣,鳳山市,忠誠里,19,1,723,5,728,1127,3,1,3,0,1,0,64.60
高雄縣,鳳山市,文英里,20,1,628,3,631,918,3,1,3,0,1,0,68.74
高雄縣,鳳山市,文英里,21,1,725,10,735,1167,3,1,3,0,1,0,62.98
高雄縣,鳳山市,文華里,22,1,697,7,704,1018,3,1,3,0,1,0,69.16
高雄縣,鳳山市,文華里,23,1,651,8,659,991,3,1,3,0,1,0,66.50
高雄縣,鳳山市,文華里,24,1,789,3,792,1218,3,1,3,0,1,0,65.02
高雄縣,鳳山市,文華里,25,1,646,4,650,992,3,1,3,0,1,0,65.52
高雄縣,鳳山市,文山里,26,1,542,4,546,813,3,1,3,0,1,0,67.16
高雄縣,鳳山市,文山里,27,1,762,9,771,1145,3,1,3,0,1,0,67.34
高雄縣,鳳山市,文山里,28,1,622,6,628,895,3,1,3,0,1,0,70.17
高雄縣,鳳山市,文山里,29,1,799,9,808,1309,3,1,3,0,1,0,61.73
高雄縣,鳳山市,文德里,30,1,601,5,606,1022,3,1,3,0,1,0,59.30
高雄縣,鳳山市,文德里,31,1,808,16,824,1188,3,1,3,0,1,0,69.36
高雄縣,鳳山市,文德里,32,1,628,4,632,1055,3,1,3,0,1,0,59.91
高雄縣,鳳山市,文德里,33,1,574,5,579,946,3,1,3,0,1,0,61.21
高雄縣,鳳山市,文德里,34,1,601,4,605,992,3,1,3,0,1,0,60.99
高雄縣,鳳山市,文德里,35,1,558,5,563,948,3,1,3,0,1,0,59.39
高雄縣,鳳山市,文德里,36,1,493,3,496,910,3,1,3,0,1,0,54.51
高雄縣,鳳山市,文德里,37,1,573,9,582,969,3,1,3,0,1,0,60.06
高雄縣,鳳山市,成功里,38,1,681,10,691,949,3,1,3,0,1,0,72.81
高雄縣,鳳山市,縣口里,39,1,387,3,390,549,3,1,3,0,1,0,71.04
高雄縣,鳳山市,光明里,40,1,421,10,431,638,3,1,3,0,1,0,67.55
高雄縣,鳳山市,光明里,41,1,595,8,603,854,3,1,3,0,1,0,70.61
高雄縣,鳳山市,和德里,42,1,619,7,626,901,3,1,3,0,1,0,69.48
高雄縣,鳳山市,和德里,43,1,494,5,499,741,3,1,3,0,1,0,67.34
高雄縣,鳳山市,和興里,44,1,744,5,749,1066,3,1,3,0,1,0,70.26
高雄縣,鳳山市,和興里,45,1,827,7,834,1224,3,1,3,0,1,0,68.14
高雄縣,鳳山市,和興里,46,1,735,2,737,1141,3,1,3,0,1,0,64.59
高雄縣,鳳山市,和興里,47,1,812,10,822,1213,3,1,3,0,1,0,67.77
高雄縣,鳳山市,南興里,48,1,714,11,725,1064,3,1,3,0,1,0,68.14
高雄縣,鳳山市,三民里,49,1,784,13,797,1181,3,1,3,0,1,0,67.49
高雄縣,鳳山市,新興里,50,1,799,9,808,1128,3,1,3,0,1,0,71.63
高雄縣,鳳山市,興仁里,51,1,747,4,751,1091,3,1,3,0,1,0,68.84
高雄縣,鳳山市,興仁里,52,1,447,4,451,689,3,1,3,0,1,0,65.46
高雄縣,鳳山市,興仁里,53,1,688,4,692,1027,3,1,3,0,1,0,67.38
高雄縣,鳳山市,興仁里,54,1,684,8,692,1009,3,1,3,0,1,0,68.58
高雄縣,鳳山市,興中里,55,1,559,8,567,831,3,1,3,0,1,0,68.23
高雄縣,鳳山市,協和里,56,1,781,21,802,1284,3,1,3,0,1,0,62.46
高雄縣,鳳山市,協和里,57,1,825,13,838,1234,3,1,3,0,1,0,67.91
高雄縣,鳳山市,協和里,58,1,835,7,842,1100,3,1,3,0,1,0,76.55
高雄縣,鳳山市,忠義里,59,1,573,7,580,875,3,1,3,0,1,0,66.29
高雄縣,鳳山市,忠義里,60,1,691,6,697,1084,3,1,3,0,1,0,64.30
高雄縣,鳳山市,忠義里,61,1,758,8,766,1171,3,1,3,0,1,0,65.41
高雄縣,鳳山市,忠孝里,62,1,717,7,724,1165,3,1,3,0,1,0,62.15
高雄縣,鳳山市,忠孝里,63,1,859,14,873,1250,3,1,3,0,1,0,69.84
高雄縣,鳳山市,忠孝里,64,1,699,9,708,1066,3,1,3,0,1,0,66.42
高雄縣,鳳山市,忠孝里,65,1,602,5,607,956,3,1,3,0,1,0,63.49
高雄縣,鳳山市,中和里,66,1,761,9,770,1109,3,1,3,0,1,0,69.43
高雄縣,鳳山市,中和里,67,1,753,7,760,1097,3,1,3,0,1,0,69.28
高雄縣,鳳山市,中和里,68,1,740,4,744,1022,3,1,3,0,1,0,72.80
高雄縣,鳳山市,誠正里,69,1,467,2,469,602,3,1,3,0,1,0,77.91
高雄縣,鳳山市,誠正里,70,1,426,5,431,555,3,1,3,0,1,0,77.66
高雄縣,鳳山市,誠義里,71,1,479,2,481,649,3,1,3,0,1,0,74.11
高雄縣,鳳山市,生明里,72,1,1053,17,1070,1454,3,1,3,0,1,0,73.59
高雄縣,鳳山市,鎮東里,73,1,738,6,744,1184,3,1,3,0,1,0,62.84
高雄縣,鳳山市,鎮東里,74,1,703,7,710,1099,3,1,3,0,1,0,64.60
高雄縣,鳳山市,瑞竹里,75,1,752,10,762,1088,3,1,3,0,1,0,70.04
高雄縣,鳳山市,瑞竹里,76,1,870,16,886,1266,3,1,3,0,1,0,69.98
高雄縣,鳳山市,瑞竹里,77,1,858,16,874,1325,3,1,3,0,1,0,65.96
高雄縣,鳳山市,瑞竹里,78,1,694,9,703,1064,3,1,3,0,1,0,66.07
高雄縣,鳳山市,瑞興里,79,1,784,11,795,1210,3,1,3,0,1,0,65.70
高雄縣,鳳山市,瑞興里,80,1,728,7,735,1106,3,1,3,0,1,0,66.46
高雄縣,鳳山市,東門里,81,1,728,9,737,1151,3,1,3,0,1,0,64.03
高雄縣,鳳山市,東門里,82,1,829,12,841,1177,3,1,3,0,1,0,71.45
高雄縣,鳳山市,東門里,83,1,705,4,709,1048,3,1,3,0,1,0,67.65
高雄縣,鳳山市,誠德里,84,1,886,3,889,1240,3,1,3,0,1,0,71.69
高雄縣,鳳山市,誠德里,85,1,986,7,993,1532,3,1,3,0,1,0,64.82
高雄縣,鳳山市,誠德里,86,1,1203,17,1220,1926,3,1,3,0,1,0,63.34
高雄縣,鳳山市,鳳東里,87,1,768,10,778,1120,3,1,3,0,1,0,69.46
高雄縣,鳳山市,鳳東里,88,1,768,16,784,1173,3,1,3,0,1,0,66.84
高雄縣,鳳山市,鳳東里,89,1,856,10,866,1335,3,1,3,0,1,0,64.87
高雄縣,鳳山市,埤頂里,90,1,798,10,808,1118,3,1,3,0,1,0,72.27
高雄縣,鳳山市,埤頂里,91,1,576,11,587,844,3,1,3,0,1,0,69.55
高雄縣,鳳山市,埤頂里,92,1,588,3,591,923,3,1,3,0,1,0,64.03
高雄縣,鳳山市,埤頂里,93,1,879,12,891,1330,3,1,3,0,1,0,66.99
高雄縣,鳳山市,美齡里,94,1,753,11,764,989,3,1,3,0,1,0,77.25
高雄縣,鳳山市,中正里,95,1,785,12,797,1052,3,1,3,0,1,0,75.76
高雄縣,鳳山市,中正里,96,1,765,7,772,1114,3,1,3,0,1,0,69.30
高雄縣,鳳山市,海光里,97,1,742,15,757,1014,3,1,3,0,1,0,74.65
高雄縣,鳳山市,海光里,98,1,638,4,642,885,3,1,3,0,1,0,72.54
高雄縣,鳳山市,海光里,99,1,707,9,716,1073,3,1,3,0,1,0,66.73
高雄縣,鳳山市,海光里,100,1,752,13,765,1140,3,1,3,0,1,0,67.11
高雄縣,鳳山市,海風里,101,1,627,5,632,830,3,1,3,0,1,0,76.14
高雄縣,鳳山市,海風里,102,1,708,4,712,901,3,1,3,0,1,0,79.02
高雄縣,鳳山市,海風里,103,1,731,6,737,947,3,1,3,0,1,0,77.82
高雄縣,鳳山市,國泰里,104,1,612,4,616,924,3,1,3,0,1,0,66.67
高雄縣,鳳山市,國泰里,105,1,535,8,543,785,3,1,3,0,1,0,69.17
高雄縣,鳳山市,國泰里,106,1,603,8,611,871,3,1,3,0,1,0,70.15
高雄縣,鳳山市,國泰里,107,1,639,10,649,1014,3,1,3,0,1,0,64.00
高雄縣,鳳山市,國光里,108,1,664,8,672,1029,3,1,3,0,1,0,65.31
高雄縣,鳳山市,國光里,109,1,605,5,610,1037,3,1,3,0,1,0,58.82
高雄縣,鳳山市,國光里,110,1,666,4,670,985,3,1,3,0,1,0,68.02
高雄縣,鳳山市,國光里,111,1,686,7,693,993,3,1,3,0,1,0,69.79
高雄縣,鳳山市,國隆里,112,1,576,7,583,955,3,1,3,0,1,0,61.05
高雄縣,鳳山市,國隆里,113,1,498,4,502,870,3,1,3,0,1,0,57.70
高雄縣,鳳山市,國隆里,114,1,464,9,473,787,3,1,3,0,1,0,60.10
高雄縣,鳳山市,國隆里,115,1,327,6,333,545,3,1,3,0,1,0,61.10
高雄縣,鳳山市,武漢里,116,1,657,11,668,1091,3,1,3,0,1,0,61.23
高雄縣,鳳山市,武漢里,117,1,669,11,680,1111,3,1,3,0,1,0,61.21
高雄縣,鳳山市,武漢里,118,1,615,12,627,1032,3,1,3,0,1,0,60.76
高雄縣,鳳山市,武漢里,119,1,683,4,687,1062,3,1,3,0,1,0,64.69
高雄縣,鳳山市,武漢里,120,1,570,8,578,953,3,1,3,0,1,0,60.65
高雄縣,鳳山市,新甲里,121,1,587,19,606,953,3,1,3,0,1,0,63.59
高雄縣,鳳山市,新甲里,122,1,488,4,492,852,3,1,3,0,1,0,57.75
高雄縣,鳳山市,新甲里,123,1,492,7,499,830,3,1,3,0,1,0,60.12
高雄縣,鳳山市,新甲里,124,1,602,7,609,1061,3,1,3,0,1,0,57.40
高雄縣,鳳山市,新甲里,125,1,595,6,601,1077,3,1,3,0,1,0,55.80
高雄縣,鳳山市,新甲里,126,1,654,15,669,1179,3,1,3,0,1,0,56.74
高雄縣,鳳山市,新甲里,127,1,633,3,636,1158,3,1,3,0,1,0,54.92
高雄縣,鳳山市,新強里,128,1,671,11,682,1016,3,1,3,0,1,0,67.13
高雄縣,鳳山市,新強里,129,1,702,6,708,1048,3,1,3,0,1,0,67.56
高雄縣,鳳山市,新強里,130,1,616,8,624,927,3,1,3,0,1,0,67.31
高雄縣,鳳山市,新富里,131,1,671,9,680,1132,3,1,3,0,1,0,60.07
高雄縣,鳳山市,新富里,132,1,604,7,611,1051,3,1,3,0,1,0,58.14
高雄縣,鳳山市,新富里,133,1,567,12,579,981,3,1,3,0,1,0,59.02
高雄縣,鳳山市,新富里,134,1,618,8,626,1076,3,1,3,0,1,0,58.18
高雄縣,鳳山市,新富里,135,1,609,10,619,1048,3,1,3,0,1,0,59.06
高雄縣,鳳山市,老爺里,136,1,660,9,669,1104,3,1,3,0,1,0,60.60
高雄縣,鳳山市,老爺里,137,1,690,11,701,1066,3,1,3,0,1,0,65.76
高雄縣,鳳山市,老爺里,138,1,913,14,927,1525,3,1,3,0,1,0,60.79
高雄縣,鳳山市,老爺里,139,1,898,10,908,1432,3,1,3,0,1,0,63.41
高雄縣,鳳山市,老爺里,140,1,475,11,486,765,3,1,3,0,1,0,63.53
高雄縣,鳳山市,過埤里,141,1,796,19,815,1243,3,1,3,0,1,0,65.57
高雄縣,鳳山市,過埤里,142,1,565,7,572,873,3,1,3,0,1,0,65.52
高雄縣,鳳山市,正義里,143,1,588,16,604,927,3,1,3,0,1,0,65.16
高雄縣,鳳山市,正義里,144,1,680,11,691,1028,3,1,3,0,1,0,67.22
高雄縣,鳳山市,正義里,145,1,681,6,687,1045,3,1,3,0,1,0,65.74
高雄縣,鳳山市,正義里,146,1,624,8,632,1078,3,1,3,0,1,0,58.63
高雄縣,鳳山市,正義里,147,1,660,13,673,1050,3,1,3,0,1,0,64.10
高雄縣,鳳山市,一甲里,148,1,745,9,754,1203,3,1,3,0,1,0,62.68
高雄縣,鳳山市,一甲里,149,1,701,12,713,1150,3,1,3,0,1,0,62.00
高雄縣,鳳山市,一甲里,150,1,806,12,818,1256,3,1,3,0,1,0,65.13
高雄縣,鳳山市,一甲里,151,1,638,8,646,995,3,1,3,0,1,0,64.92
高雄縣,鳳山市,一甲里,152,1,672,10,682,1052,3,1,3,0,1,0,64.83
高雄縣,鳳山市,鎮南里,153,1,608,5,613,926,3,1,3,0,1,0,66.20
高雄縣,鳳山市,鎮南里,154,1,522,7,529,817,3,1,3,0,1,0,64.75
高雄縣,鳳山市,鎮南里,155,1,823,16,839,1273,3,1,3,0,1,0,65.91
高雄縣,鳳山市,鎮南里,156,1,619,5,624,977,3,1,3,0,1,0,63.87
高雄縣,鳳山市,鎮南里,157,1,550,6,556,824,3,1,3,0,1,0,67.48
高雄縣,鳳山市,鎮南里,158,1,554,5,559,849,3,1,3,0,1,0,65.84
高雄縣,鳳山市,富甲里,159,1,593,9,602,910,3,1,3,0,1,0,66.15
高雄縣,鳳山市,富甲里,160,1,598,9,607,920,3,1,3,0,1,0,65.98
高雄縣,鳳山市,富甲里,161,1,441,8,449,676,3,1,3,0,1,0,66.42
高雄縣,鳳山市,富甲里,162,1,424,4,428,702,3,1,3,0,1,0,60.97
高雄縣,鳳山市,富甲里,163,1,554,6,560,966,3,1,3,0,1,0,57.97
高雄縣,鳳山市,富甲里,164,1,523,7,530,911,3,1,3,0,1,0,58.18
高雄縣,鳳山市,富甲里,165,1,542,12,554,850,3,1,3,0,1,0,65.18
高雄縣,鳳山市,富甲里,166,1,508,7,515,826,3,1,3,0,1,0,62.35
高雄縣,鳳山市,南成里,167,1,623,5,628,960,3,1,3,0,1,0,65.42
高雄縣,鳳山市,南成里,168,1,623,13,636,956,3,1,3,0,1,0,66.53
高雄縣,鳳山市,南成里,169,1,623,7,630,895,3,1,3,0,1,0,70.39
高雄縣,鳳山市,南成里,170,1,564,6,570,944,3,1,3,0,1,0,60.38
高雄縣,鳳山市,南成里,171,1,420,2,422,660,3,1,3,0,1,0,63.94
高雄縣,鳳山市,南成里,172,1,710,16,726,1099,3,1,3,0,1,0,66.06
高雄縣,鳳山市,天興里,173,1,802,8,810,1231,3,1,3,0,1,0,65.80
高雄縣,鳳山市,天興里,174,1,701,6,707,1058,3,1,3,0,1,0,66.82
高雄縣,鳳山市,天興里,175,1,776,9,785,1203,3,1,3,0,1,0,65.25
高雄縣,鳳山市,大德里,176,1,830,13,843,1377,3,1,3,0,1,0,61.22
高雄縣,鳳山市,大德里,177,1,947,12,959,1502,3,1,3,0,1,0,63.85
高雄縣,鳳山市,五福里,178,1,708,8,716,1065,3,1,3,0,1,0,67.23
高雄縣,鳳山市,五福里,179,1,711,13,724,1049,3,1,3,0,1,0,69.02
高雄縣,鳳山市,五福里,180,1,742,9,751,1131,3,1,3,0,1,0,66.40
高雄縣,鳳山市,福興里,181,1,723,12,735,1110,3,1,3,0,1,0,66.22
高雄縣,鳳山市,福興里,182,1,682,4,686,1026,3,1,3,0,1,0,66.86
高雄縣,鳳山市,福興里,183,1,732,10,742,1170,3,1,3,0,1,0,63.42
高雄縣,鳳山市,福興里,184,1,678,10,688,1015,3,1,3,0,1,0,67.78
高雄縣,鳳山市,福興里,185,1,622,9,631,949,3,1,3,0,1,0,66.49
高雄縣,鳳山市,福誠里,186,1,638,4,642,1089,3,1,3,0,1,0,58.95
高雄縣,鳳山市,福誠里,187,1,571,8,579,914,3,1,3,0,1,0,63.35
高雄縣,鳳山市,福誠里,188,1,579,7,586,929,3,1,3,0,1,0,63.08
高雄縣,鳳山市,福誠里,189,1,735,10,745,1220,3,1,3,0,1,0,61.07
高雄縣,林園鄉,林園村,190,1,878,10,888,1271,3,1,3,0,1,0,69.87
高雄縣,林園鄉,林園村,191,1,775,10,785,1136,3,1,3,0,1,0,69.10
高雄縣,林園鄉,林園村,192,1,955,17,972,1337,3,1,3,0,1,0,72.70
高雄縣,林園鄉,林園村,193,1,658,6,664,980,3,1,3,0,1,0,67.76
高雄縣,林園鄉,東林村,194,1,871,5,876,1347,3,1,3,0,1,0,65.03
高雄縣,林園鄉,東林村,195,1,927,17,944,1499,3,1,3,0,1,0,62.98
高雄縣,林園鄉,東林村,196,1,817,3,820,1180,3,1,3,0,1,0,69.49
高雄縣,林園鄉,溪州村,197,1,881,11,892,1261,3,1,3,0,1,0,70.74
高雄縣,林園鄉,溪州村,198,1,1060,20,1080,1557,3,1,3,0,1,0,69.36
高雄縣,林園鄉,溪州村,199,1,902,21,923,1498,3,1,3,0,1,0,61.62
高雄縣,林園鄉,潭頭村,200,1,834,8,842,1150,3,1,3,0,1,0,73.22
高雄縣,林園鄉,潭頭村,201,1,681,8,689,960,3,1,3,0,1,0,71.77
高雄縣,林園鄉,中厝村,202,1,888,17,905,1264,3,1,3,0,1,0,71.60
高雄縣,林園鄉,中厝村,203,1,859,20,879,1180,3,1,3,0,1,0,74.49
高雄縣,林園鄉,林內村,204,1,598,10,608,878,3,1,3,0,1,0,69.25
高雄縣,林園鄉,林內村,205,1,618,8,626,812,3,1,3,0,1,0,77.09
高雄縣,林園鄉,王公村,206,1,1003,11,1014,1490,3,1,3,0,1,0,68.05
高雄縣,林園鄉,王公村,207,1,938,33,971,1308,3,1,3,0,1,0,74.24
高雄縣,林園鄉,王公村,208,1,676,9,685,928,3,1,3,0,1,0,73.81
高雄縣,林園鄉,王公村,209,1,604,6,610,834,3,1,3,0,1,0,73.14
高雄縣,林園鄉,林家村,210,1,1004,13,1017,1279,3,1,3,0,1,0,79.52
高雄縣,林園鄉,龔厝村,211,1,990,15,1005,1411,3,1,3,0,1,0,71.23
高雄縣,林園鄉,中門村,212,1,613,16,629,807,3,1,3,0,1,0,77.94
高雄縣,林園鄉,中門村,213,1,707,13,720,969,3,1,3,0,1,0,74.30
高雄縣,林園鄉,頂厝村,214,1,1132,20,1152,1554,3,1,3,0,1,0,74.13
高雄縣,林園鄉,頂厝村,215,1,752,8,760,1132,3,1,3,0,1,0,67.14
高雄縣,林園鄉,港埔村,216,1,1084,12,1096,1494,3,1,3,0,1,0,73.36
高雄縣,林園鄉,港嘴村,217,1,821,11,832,1124,3,1,3,0,1,0,74.02
高雄縣,林園鄉,西溪村,218,1,856,9,865,1205,3,1,3,0,1,0,71.78
高雄縣,林園鄉,西溪村,219,1,811,12,823,1113,3,1,3,0,1,0,73.94
高雄縣,林園鄉,中芸村,220,1,639,4,643,888,3,1,3,0,1,0,72.41
高雄縣,林園鄉,中芸村,221,1,536,7,543,757,3,1,3,0,1,0,71.73
高雄縣,林園鄉,鳳芸村,222,1,1128,14,1142,1540,3,1,3,0,1,0,74.16
高雄縣,林園鄉,東汕村,223,1,641,12,653,897,3,1,3,0,1,0,72.80
高雄縣,林園鄉,西汕村,224,1,533,3,536,820,3,1,3,0,1,0,65.37
高雄縣,林園鄉,北汕村,225,1,596,7,603,969,3,1,3,0,1,0,62.23
高雄縣,林園鄉,北汕村,226,1,433,1,434,705,3,1,3,0,1,0,61.56
高雄縣,林園鄉,北汕村,227,1,624,12,636,994,3,1,3,0,1,0,63.98
高雄縣,林園鄉,北汕村,228,1,651,13,664,983,3,1,3,0,1,0,67.55
高雄縣,大寮鄉,義和村,229,1,685,7,692,900,3,1,3,0,1,0,76.89
高雄縣,大寮鄉,義和村,230,1,637,11,648,947,3,1,3,0,1,0,68.43
高雄縣,大寮鄉,溪寮村,231,1,843,8,851,1227,3,1,3,0,1,0,69.36
高雄縣,大寮鄉,江山村,232,1,945,13,958,1386,3,1,3,0,1,0,69.12
高雄縣,大寮鄉,中庄村,233,1,668,7,675,1020,3,1,3,0,1,0,66.18
高雄縣,大寮鄉,中庄村,234,1,588,14,602,828,3,1,3,0,1,0,72.71
高雄縣,大寮鄉,中庄村,235,1,628,8,636,937,3,1,3,0,1,0,67.88
高雄縣,大寮鄉,中庄村,236,1,690,7,697,1090,3,1,3,0,1,0,63.94
高雄縣,大寮鄉,中庄村,237,1,531,8,539,864,3,1,3,0,1,0,62.38
高雄縣,大寮鄉,中庄村,238,1,547,7,554,885,3,1,3,0,1,0,62.60
高雄縣,大寮鄉,中庄村,239,1,622,9,631,913,3,1,3,0,1,0,69.11
高雄縣,大寮鄉,中庄村,240,1,501,6,507,771,3,1,3,0,1,0,65.76
高雄縣,大寮鄉,後庄村,241,1,711,8,719,1148,3,1,3,0,1,0,62.63
高雄縣,大寮鄉,後庄村,242,1,1024,15,1039,1587,3,1,3,0,1,0,65.47
高雄縣,大寮鄉,後庄村,243,1,779,11,790,1284,3,1,3,0,1,0,61.53
高雄縣,大寮鄉,前庄村,244,1,597,9,606,816,3,1,3,0,1,0,74.26
高雄縣,大寮鄉,前庄村,245,1,632,12,644,940,3,1,3,0,1,0,68.51
高雄縣,大寮鄉,翁園村,246,1,799,5,804,1004,3,1,3,0,1,0,80.08
高雄縣,大寮鄉,翁園村,247,1,628,7,635,823,3,1,3,0,1,0,77.16
高雄縣,大寮鄉,琉球村,248,1,1099,10,1109,1630,3,1,3,0,1,0,68.04
高雄縣,大寮鄉,琉球村,249,1,772,11,783,1073,3,1,3,0,1,0,72.97
高雄縣,大寮鄉,中興村,250,1,1106,10,1116,1570,3,1,3,0,1,0,71.08
高雄縣,大寮鄉,中興村,251,1,828,10,838,1227,3,1,3,0,1,0,68.30
高雄縣,大寮鄉,中興村,252,1,914,11,925,1312,3,1,3,0,1,0,70.50
高雄縣,大寮鄉,中興村,253,1,915,18,933,1364,3,1,3,0,1,0,68.40
高雄縣,大寮鄉,忠義村,254,1,1022,12,1034,1417,3,1,3,0,1,0,72.97
高雄縣,大寮鄉,忠義村,255,1,913,9,922,1245,3,1,3,0,1,0,74.06
高雄縣,大寮鄉,光武村,256,1,870,6,876,1151,3,1,3,0,1,0,76.11
高雄縣,大寮鄉,光武村,257,1,893,6,899,1135,3,1,3,0,1,0,79.21
高雄縣,大寮鄉,復興村,258,1,691,8,699,899,3,1,3,0,1,0,77.75
高雄縣,大寮鄉,復興村,259,1,801,15,816,1020,3,1,3,0,1,0,80.00
高雄縣,大寮鄉,復興村,260,1,909,9,918,1173,3,1,3,0,1,0,78.26
高雄縣,大寮鄉,復興村,261,1,808,13,821,1030,3,1,3,0,1,0,79.71
高雄縣,大寮鄉,永芳村,262,1,779,10,789,1241,3,1,3,0,1,0,63.58
高雄縣,大寮鄉,永芳村,263,1,494,7,501,722,3,1,3,0,1,0,69.39
高雄縣,大寮鄉,永芳村,264,1,912,9,921,1352,3,1,3,0,1,0,68.12
高雄縣,大寮鄉,永芳村,265,1,879,11,890,1270,3,1,3,0,1,0,70.08
高雄縣,大寮鄉,山頂村,266,1,965,13,978,1435,3,1,3,0,1,0,68.15
高雄縣,大寮鄉,山頂村,267,1,827,20,847,1273,3,1,3,0,1,0,66.54
高雄縣,大寮鄉,山頂村,268,1,1065,8,1073,1689,3,1,3,0,1,0,63.53
高雄縣,大寮鄉,會社村,269,1,700,10,710,971,3,1,3,0,1,0,73.12
高雄縣,大寮鄉,會社村,270,1,660,9,669,937,3,1,3,0,1,0,71.40
高雄縣,大寮鄉,會社村,271,1,793,11,804,1248,3,1,3,0,1,0,64.42
高雄縣,大寮鄉,會社村,272,1,650,9,659,964,3,1,3,0,1,0,68.36
高雄縣,大寮鄉,三隆村,273,1,810,8,818,1186,3,1,3,0,1,0,68.97
高雄縣,大寮鄉,三隆村,274,1,805,12,817,1174,3,1,3,0,1,0,69.59
高雄縣,大寮鄉,三隆村,275,1,750,10,760,1114,3,1,3,0,1,0,68.22
高雄縣,大寮鄉,上寮村,276,1,649,8,657,965,3,1,3,0,1,0,68.08
高雄縣,大寮鄉,上寮村,277,1,580,3,583,813,3,1,3,0,1,0,71.71
高雄縣,大寮鄉,大寮村,278,1,648,7,655,1121,3,1,3,0,1,0,58.43
高雄縣,大寮鄉,大寮村,279,1,732,16,748,1248,3,1,3,0,1,0,59.94
高雄縣,大寮鄉,大寮村,280,1,674,10,684,1040,3,1,3,0,1,0,65.77
高雄縣,大寮鄉,大寮村,281,1,606,15,621,1032,3,1,3,0,1,0,60.17
高雄縣,大寮鄉,拷潭村,282,1,756,8,764,1056,3,1,3,0,1,0,72.35
高雄縣,大寮鄉,內坑村,283,1,519,4,523,1023,3,1,3,0,1,0,51.12
高雄縣,大寮鄉,內坑村,284,1,615,5,620,941,3,1,3,0,1,0,65.89
高雄縣,大寮鄉,內坑村,285,1,318,7,325,441,3,1,3,0,1,0,73.70
高雄縣,大寮鄉,新厝村,286,1,786,11,797,1211,3,1,3,0,1,0,65.81
高雄縣,大寮鄉,過溪村,287,1,898,11,909,1284,3,1,3,0,1,0,70.79
高雄縣,大寮鄉,潮寮村,288,1,874,14,888,1239,3,1,3,0,1,0,71.67
高雄縣,大寮鄉,潮寮村,289,1,876,12,888,1223,3,1,3,0,1,0,72.61
高雄縣,大寮鄉,會結村,290,1,886,16,902,1158,3,1,3,0,1,0,77.89
高雄縣,大寮鄉,昭明村,291,1,921,18,939,1407,3,1,3,0,1,0,66.74
高雄縣,大寮鄉,昭明村,292,1,831,12,843,1224,3,1,3,0,1,0,68.87
高雄縣,大寮鄉,義仁村,293,1,594,5,599,924,3,1,3,0,1,0,64.83
高雄縣,大寮鄉,義仁村,294,1,550,11,561,788,3,1,3,0,1,0,71.19
高雄縣,大樹鄉,竹寮村,295,1,796,8,804,1116,3,1,3,0,1,0,72.04
高雄縣,大樹鄉,竹寮村,296,1,567,11,578,767,3,1,3,0,1,0,75.36
高雄縣,大樹鄉,九曲村,297,1,1155,10,1165,1570,3,1,3,0,1,0,74.20
高雄縣,大樹鄉,九曲村,298,1,966,9,975,1327,3,1,3,0,1,0,73.47
高雄縣,大樹鄉,久堂村,299,1,1017,8,1025,1406,3,1,3,0,1,0,72.90
高雄縣,大樹鄉,久堂村,300,1,901,5,906,1127,3,1,3,0,1,0,80.39
高雄縣,大樹鄉,久堂村,301,1,1027,21,1048,1366,3,1,3,0,1,0,76.72
高雄縣,大樹鄉,水安村,302,1,734,8,742,1029,3,1,3,0,1,0,72.11
高雄縣,大樹鄉,水安村,303,1,731,6,737,1054,3,1,3,0,1,0,69.92
高雄縣,大樹鄉,水寮村,304,1,890,3,893,1193,3,1,3,0,1,0,74.85
高雄縣,大樹鄉,水寮村,305,1,775,7,782,1048,3,1,3,0,1,0,74.62
高雄縣,大樹鄉,井腳村,306,1,1163,17,1180,1514,3,1,3,0,1,0,77.94
高雄縣,大樹鄉,小坪村,307,1,856,15,871,1132,3,1,3,0,1,0,76.94
高雄縣,大樹鄉,龍目村,308,1,1160,15,1175,1519,3,1,3,0,1,0,77.35
高雄縣,大樹鄉,大樹村,309,1,780,11,791,1173,3,1,3,0,1,0,67.43
高雄縣,大樹鄉,大樹村,310,1,713,9,722,1016,3,1,3,0,1,0,71.06
高雄縣,大樹鄉,檨腳村,311,1,1152,15,1167,1623,3,1,3,0,1,0,71.90
高雄縣,大樹鄉,檨腳村,312,1,913,6,919,1310,3,1,3,0,1,0,70.15
高雄縣,大樹鄉,興山村,313,1,730,3,733,1032,3,1,3,0,1,0,71.03
高雄縣,大樹鄉,和山村,314,1,674,9,683,959,3,1,3,0,1,0,71.22
高雄縣,大樹鄉,姑山村,315,1,726,10,736,1001,3,1,3,0,1,0,73.53
高雄縣,大樹鄉,三和村,316,1,639,5,644,917,3,1,3,0,1,0,70.23
高雄縣,大樹鄉,大坑村,317,1,824,6,830,1194,3,1,3,0,1,0,69.51
高雄縣,大樹鄉,溪埔村,318,1,651,4,655,815,3,1,3,0,1,0,80.37
高雄縣,大樹鄉,溪埔村,319,1,757,7,764,1039,3,1,3,0,1,0,73.53
高雄縣,大樹鄉,興田村,320,1,649,16,665,947,3,1,3,0,1,0,70.22
高雄縣,大樹鄉,興田村,321,1,560,4,564,780,3,1,3,0,1,0,72.31
高雄縣,大樹鄉,統嶺村,322,1,507,6,513,694,3,1,3,0,1,0,73.92
高雄縣,仁武鄉,仁武村,323,1,760,19,779,1115,3,1,3,0,1,0,69.87
高雄縣,仁武鄉,仁武村,324,1,730,10,740,1080,3,1,3,0,1,0,68.52
高雄縣,仁武鄉,仁武村,325,1,959,21,980,1337,3,1,3,0,1,0,73.30
高雄縣,仁武鄉,文武村,326,1,537,8,545,770,3,1,3,0,1,0,70.78
高雄縣,仁武鄉,文武村,327,1,636,11,647,972,3,1,3,0,1,0,66.56
高雄縣,仁武鄉,文武村,328,1,626,6,632,815,3,1,3,0,1,0,77.55
高雄縣,仁武鄉,後安村,329,1,621,21,642,930,3,1,3,0,1,0,69.03
高雄縣,仁武鄉,後安村,330,1,451,11,462,754,3,1,3,0,1,0,61.27
高雄縣,仁武鄉,竹後村,331,1,666,9,675,939,3,1,3,0,1,0,71.88
高雄縣,仁武鄉,竹後村,332,1,667,9,676,1078,3,1,3,0,1,0,62.71
高雄縣,仁武鄉,竹後村,333,1,806,23,829,1202,3,1,3,0,1,0,68.97
高雄縣,仁武鄉,八卦村,334,1,749,8,757,1199,3,1,3,0,1,0,63.14
高雄縣,仁武鄉,八卦村,335,1,539,6,545,912,3,1,3,0,1,0,59.76
高雄縣,仁武鄉,八卦村,336,1,658,11,669,1120,3,1,3,0,1,0,59.73
高雄縣,仁武鄉,八卦村,337,1,537,7,544,801,3,1,3,0,1,0,67.92
高雄縣,仁武鄉,高楠村,338,1,561,15,576,792,3,1,3,0,1,0,72.73
高雄縣,仁武鄉,高楠村,339,1,621,7,628,795,3,1,3,0,1,0,78.99
高雄縣,仁武鄉,大灣村,340,1,769,6,775,1167,3,1,3,0,1,0,66.41
高雄縣,仁武鄉,灣內村,341,1,709,9,718,1114,3,1,3,0,1,0,64.45
高雄縣,仁武鄉,灣內村,342,1,715,15,730,1197,3,1,3,0,1,0,60.99
高雄縣,仁武鄉,灣內村,343,1,783,5,788,1191,3,1,3,0,1,0,66.16
高雄縣,仁武鄉,灣內村,344,1,655,10,665,1021,3,1,3,0,1,0,65.13
高雄縣,仁武鄉,考潭村,345,1,527,6,533,863,3,1,3,0,1,0,61.76
高雄縣,仁武鄉,考潭村,346,1,833,16,849,1239,3,1,3,0,1,0,68.52
高雄縣,仁武鄉,考潭村,347,1,742,5,747,1138,3,1,3,0,1,0,65.64
高雄縣,仁武鄉,烏林村,348,1,996,18,1014,1361,3,1,3,0,1,0,74.50
高雄縣,仁武鄉,烏林村,349,1,608,8,616,905,3,1,3,0,1,0,68.07
高雄縣,仁武鄉,仁福村,350,1,329,2,331,465,3,1,3,0,1,0,71.18
高雄縣,大社鄉,嘉誠村,351,1,590,8,598,861,3,1,3,0,1,0,69.45
高雄縣,大社鄉,保社村,352,1,1018,10,1028,1369,3,1,3,0,1,0,75.09
高雄縣,大社鄉,大社村,353,1,835,11,846,1374,3,1,3,0,1,0,61.57
高雄縣,大社鄉,大社村,354,1,739,17,756,1133,3,1,3,0,1,0,66.73
高雄縣,大社鄉,大社村,355,1,999,7,1006,1586,3,1,3,0,1,0,63.43
高雄縣,大社鄉,大社村,356,1,1026,9,1035,1608,3,1,3,0,1,0,64.37
高雄縣,大社鄉,三奶村,357,1,952,25,977,1375,3,1,3,0,1,0,71.05
高雄縣,大社鄉,三奶村,358,1,727,7,734,990,3,1,3,0,1,0,74.14
高雄縣,大社鄉,觀音村,359,1,726,8,734,976,3,1,3,0,1,0,75.20
高雄縣,大社鄉,觀音村,360,1,957,15,972,1452,3,1,3,0,1,0,66.94
高雄縣,大社鄉,觀音村,361,1,1016,12,1028,1579,3,1,3,0,1,0,65.10
高雄縣,大社鄉,神農村,362,1,805,9,814,1162,3,1,3,0,1,0,70.05
高雄縣,大社鄉,神農村,363,1,959,20,979,1509,3,1,3,0,1,0,64.88
高雄縣,大社鄉,中里村,364,1,891,18,909,1281,3,1,3,0,1,0,70.96
高雄縣,大社鄉,中里村,365,1,688,8,696,980,3,1,3,0,1,0,71.02
高雄縣,大社鄉,翠屏村,366,1,922,12,934,1258,3,1,3,0,1,0,74.24
高雄縣,鳥松鄉,鳥松村,367,1,756,0,756,1186,3,1,3,0,1,0,63.74
高雄縣,鳥松鄉,鳥松村,368,1,715,9,724,1101,3,1,3,0,1,0,65.76
高雄縣,鳥松鄉,鳥松村,369,1,1000,10,1010,1580,3,1,3,0,1,0,63.92
高雄縣,鳥松鄉,鳥松村,370,1,870,12,882,1252,3,1,3,0,1,0,70.45
高雄縣,鳥松鄉,夢裡村,371,1,1095,16,1111,1527,3,1,3,0,1,0,72.76
高雄縣,鳥松鄉,大華村,372,1,716,12,728,1027,3,1,3,0,1,0,70.89
高雄縣,鳥松鄉,大華村,373,1,1009,16,1025,1563,3,1,3,0,1,0,65.58
高雄縣,鳥松鄉,大華村,374,1,975,9,984,1538,3,1,3,0,1,0,63.98
高雄縣,鳥松鄉,大華村,375,1,742,5,747,1200,3,1,3,0,1,0,62.25
高雄縣,鳥松鄉,濫埔村,376,1,796,5,801,1061,3,1,3,0,1,0,75.49
高雄縣,鳥松鄉,濫埔村,377,1,761,8,769,1099,3,1,3,0,1,0,69.97
高雄縣,鳥松鄉,仁美村,378,1,1029,15,1044,1562,3,1,3,0,1,0,66.84
高雄縣,鳥松鄉,仁美村,379,1,1000,10,1010,1430,3,1,3,0,1,0,70.63
高雄縣,鳥松鄉,仁美村,380,1,1092,15,1107,1774,3,1,3,0,1,0,62.40
高雄縣,鳥松鄉,華美村,381,1,803,16,819,1214,3,1,3,0,1,0,67.46
高雄縣,鳥松鄉,華美村,382,1,1000,16,1016,1475,3,1,3,0,1,0,68.88
高雄縣,鳥松鄉,大竹村,383,1,382,16,398,541,3,1,3,0,1,0,73.57
高雄縣,岡山鎮,岡山里,384,1,791,6,797,1139,3,1,3,0,1,0,69.97
高雄縣,岡山鎮,岡山里,385,1,669,10,679,1023,3,1,3,0,1,0,66.37
高雄縣,岡山鎮,岡山里,386,1,596,6,602,899,3,1,3,0,1,0,66.96
高雄縣,岡山鎮,平安里,387,1,959,15,974,1354,3,1,3,0,1,0,71.94
高雄縣,岡山鎮,壽天里,388,1,709,14,723,1054,3,1,3,0,1,0,68.60
高雄縣,岡山鎮,壽天里,389,1,659,12,671,974,3,1,3,0,1,0,68.89
高雄縣,岡山鎮,壽天里,390,1,491,9,500,740,3,1,3,0,1,0,67.57
高雄縣,岡山鎮,維仁里,391,1,476,6,482,710,3,1,3,0,1,0,67.89
高雄縣,岡山鎮,維仁里,392,1,485,11,496,710,3,1,3,0,1,0,69.86
高雄縣,岡山鎮,灣裡里,393,1,818,9,827,1115,3,1,3,0,1,0,74.17
高雄縣,岡山鎮,大遼里,394,1,840,1,841,1122,3,1,3,0,1,0,74.96
高雄縣,岡山鎮,後紅里,395,1,613,9,622,885,3,1,3,0,1,0,70.28
高雄縣,岡山鎮,後紅里,396,1,619,11,630,893,3,1,3,0,1,0,70.55
高雄縣,岡山鎮,碧紅里,397,1,929,11,940,1323,3,1,3,0,1,0,71.05
高雄縣,岡山鎮,碧紅里,398,1,812,13,825,1186,3,1,3,0,1,0,69.56
高雄縣,岡山鎮,程香里,399,1,1065,12,1077,1557,3,1,3,0,1,0,69.17
高雄縣,岡山鎮,程香里,400,1,573,10,583,887,3,1,3,0,1,0,65.73
高雄縣,岡山鎮,竹圍里,401,1,814,10,824,1251,3,1,3,0,1,0,65.87
高雄縣,岡山鎮,竹圍里,402,1,957,10,967,1378,3,1,3,0,1,0,70.17
高雄縣,岡山鎮,台上里,403,1,863,13,876,1259,3,1,3,0,1,0,69.58
高雄縣,岡山鎮,台上里,404,1,858,9,867,1242,3,1,3,0,1,0,69.81
高雄縣,岡山鎮,為隨里,405,1,438,4,442,547,3,1,3,0,1,0,80.80
高雄縣,岡山鎮,前峰里,406,1,699,4,703,1011,3,1,3,0,1,0,69.54
高雄縣,岡山鎮,前峰里,407,1,938,15,953,1440,3,1,3,0,1,0,66.18
高雄縣,岡山鎮,壽峰里,408,1,1044,11,1055,1448,3,1,3,0,1,0,72.86
高雄縣,岡山鎮,仁壽里,409,1,689,3,692,987,3,1,3,0,1,0,70.11
高雄縣,岡山鎮,仁壽里,410,1,743,9,752,1056,3,1,3,0,1,0,71.21
高雄縣,岡山鎮,仁壽里,411,1,783,11,794,1153,3,1,3,0,1,0,68.86
高雄縣,岡山鎮,協和里,412,1,803,12,815,1188,3,1,3,0,1,0,68.60
高雄縣,岡山鎮,協和里,413,1,838,8,846,1179,3,1,3,0,1,0,71.76
高雄縣,岡山鎮,協和里,414,1,412,5,417,548,3,1,3,0,1,0,76.09
高雄縣,岡山鎮,本洲里,415,1,853,5,858,1156,3,1,3,0,1,0,74.22
高雄縣,岡山鎮,後協里,416,1,795,9,804,1149,3,1,3,0,1,0,69.97
高雄縣,岡山鎮,後協里,417,1,873,13,886,1268,3,1,3,0,1,0,69.87
高雄縣,岡山鎮,後協里,418,1,882,10,892,1281,3,1,3,0,1,0,69.63
高雄縣,岡山鎮,協榮里,419,1,706,9,715,1012,3,1,3,0,1,0,70.65
高雄縣,岡山鎮,協榮里,420,1,534,6,540,758,3,1,3,0,1,0,71.24
高雄縣,岡山鎮,劉厝里,421,1,845,10,855,1201,3,1,3,0,1,0,71.19
高雄縣,岡山鎮,白米里,422,1,496,4,500,673,3,1,3,0,1,0,74.29
高雄縣,岡山鎮,石潭里,423,1,852,13,865,1187,3,1,3,0,1,0,72.87
高雄縣,岡山鎮,福興里,424,1,661,7,668,970,3,1,3,0,1,0,68.87
高雄縣,岡山鎮,嘉興里,425,1,906,16,922,1346,3,1,3,0,1,0,68.50
高雄縣,岡山鎮,嘉興里,426,1,1073,18,1091,1603,3,1,3,0,1,0,68.06
高雄縣,岡山鎮,嘉峰里,427,1,885,12,897,1142,3,1,3,0,1,0,78.55
高雄縣,岡山鎮,嘉峰里,428,1,236,7,243,303,3,1,3,0,1,0,80.20
高雄縣,岡山鎮,潭底里,429,1,540,10,550,722,3,1,3,0,1,0,76.18
高雄縣,岡山鎮,華崗里,430,1,950,10,960,1253,3,1,3,0,1,0,76.62
高雄縣,岡山鎮,三和里,431,1,510,5,515,694,3,1,3,0,1,0,74.21
高雄縣,岡山鎮,大莊里,432,1,599,9,608,838,3,1,3,0,1,0,72.55
高雄縣,岡山鎮,忠孝里,433,1,730,7,737,984,3,1,3,0,1,0,74.90
高雄縣,岡山鎮,和平里,434,1,686,13,699,919,3,1,3,0,1,0,76.06
高雄縣,岡山鎮,信義里,435,1,671,2,673,880,3,1,3,0,1,0,76.48
高雄縣,岡山鎮,信義里,436,1,906,8,914,1271,3,1,3,0,1,0,71.91
高雄縣,岡山鎮,仁愛里,437,1,1088,10,1098,1421,3,1,3,0,1,0,77.27
高雄縣,岡山鎮,四維里,438,1,1120,12,1132,1446,3,1,3,0,1,0,78.28
高雄縣,岡山鎮,復興里,439,1,357,2,359,468,3,1,3,0,1,0,76.71
高雄縣,橋頭鄉,橋頭村,440,1,663,14,677,938,3,1,3,0,1,0,72.17
高雄縣,橋頭鄉,橋頭村,441,1,418,1,419,555,3,1,3,0,1,0,75.50
高雄縣,橋頭鄉,橋南村,442,1,712,4,716,919,3,1,3,0,1,0,77.91
高雄縣,橋頭鄉,興糖村,443,1,261,3,264,357,3,1,3,0,1,0,73.95
高雄縣,橋頭鄉,仕隆村,444,1,752,8,760,1008,3,1,3,0,1,0,75.40
高雄縣,橋頭鄉,仕隆村,445,1,838,9,847,1201,3,1,3,0,1,0,70.52
高雄縣,橋頭鄉,仕豐村,446,1,659,9,668,929,3,1,3,0,1,0,71.91
高雄縣,橋頭鄉,仕豐村,447,1,724,8,732,968,3,1,3,0,1,0,75.62
高雄縣,橋頭鄉,仕和村,448,1,856,10,866,1162,3,1,3,0,1,0,74.53
高雄縣,橋頭鄉,仕和村,449,1,1036,10,1046,1444,3,1,3,0,1,0,72.44
高雄縣,橋頭鄉,新莊村,450,1,543,4,547,728,3,1,3,0,1,0,75.14
高雄縣,橋頭鄉,新莊村,451,1,239,3,242,301,3,1,3,0,1,0,80.40
高雄縣,橋頭鄉,新莊村,452,1,148,0,148,195,3,1,3,0,1,0,75.90
高雄縣,橋頭鄉,甲北村,453,1,786,13,799,1068,3,1,3,0,1,0,74.81
高雄縣,橋頭鄉,甲北村,454,1,558,10,568,801,3,1,3,0,1,0,70.91
高雄縣,橋頭鄉,甲南村,455,1,684,10,694,1033,3,1,3,0,1,0,67.18
高雄縣,橋頭鄉,甲南村,456,1,729,10,739,962,3,1,3,0,1,0,76.82
高雄縣,橋頭鄉,頂鹽村,457,1,595,15,610,874,3,1,3,0,1,0,69.79
高雄縣,橋頭鄉,白樹村,458,1,700,11,711,939,3,1,3,0,1,0,75.72
高雄縣,橋頭鄉,白樹村,459,1,607,5,612,832,3,1,3,0,1,0,73.56
高雄縣,橋頭鄉,白樹村,460,1,388,5,393,449,3,1,3,0,1,0,87.53
高雄縣,橋頭鄉,芋寮村,461,1,788,6,794,1057,3,1,3,0,1,0,75.12
高雄縣,橋頭鄉,芋寮村,462,1,505,6,511,659,3,1,3,0,1,0,77.54
高雄縣,橋頭鄉,西林村,463,1,520,12,532,722,3,1,3,0,1,0,73.68
高雄縣,橋頭鄉,西林村,464,1,548,9,557,742,3,1,3,0,1,0,75.07
高雄縣,橋頭鄉,東林村,465,1,738,11,749,995,3,1,3,0,1,0,75.28
高雄縣,橋頭鄉,東林村,466,1,682,6,688,927,3,1,3,0,1,0,74.22
高雄縣,橋頭鄉,德松村,467,1,626,5,631,854,3,1,3,0,1,0,73.89
高雄縣,橋頭鄉,筆秀村,468,1,346,3,349,458,3,1,3,0,1,0,76.20
高雄縣,橋頭鄉,筆秀村,469,1,627,11,638,832,3,1,3,0,1,0,76.68
高雄縣,橋頭鄉,中崎村,470,1,465,0,465,610,3,1,3,0,1,0,76.23
高雄縣,燕巢鄉,金山村,471,1,358,1,359,441,3,1,3,0,1,0,81.41
高雄縣,燕巢鄉,尖山村,472,1,733,17,750,1018,3,1,3,0,1,0,73.67
高雄縣,燕巢鄉,東燕村,473,1,907,9,916,1220,3,1,3,0,1,0,75.08
高雄縣,燕巢鄉,東燕村,474,1,606,5,611,816,3,1,3,0,1,0,74.88
高雄縣,燕巢鄉,西燕村,475,1,718,8,726,969,3,1,3,0,1,0,74.92
高雄縣,燕巢鄉,西燕村,476,1,632,5,637,851,3,1,3,0,1,0,74.85
高雄縣,燕巢鄉,西燕村,477,1,664,20,684,968,3,1,3,0,1,0,70.66
高雄縣,燕巢鄉,南燕村,478,1,926,19,945,1249,3,1,3,0,1,0,75.66
高雄縣,燕巢鄉,南燕村,479,1,876,11,887,1206,3,1,3,0,1,0,73.55
高雄縣,燕巢鄉,瓊林村,480,1,1089,16,1105,1476,3,1,3,0,1,0,74.86
高雄縣,燕巢鄉,安招村,481,1,799,13,812,1039,3,1,3,0,1,0,78.15
高雄縣,燕巢鄉,安招村,482,1,998,8,1006,1299,3,1,3,0,1,0,77.44
高雄縣,燕巢鄉,安招村,483,1,352,4,356,506,3,1,3,0,1,0,70.36
高雄縣,燕巢鄉,安招村,484,1,470,7,477,616,3,1,3,0,1,0,77.44
高雄縣,燕巢鄉,安招村,485,1,569,11,580,820,3,1,3,0,1,0,70.73
高雄縣,燕巢鄉,角宿村,486,1,581,9,590,756,3,1,3,0,1,0,78.04
高雄縣,燕巢鄉,角宿村,487,1,386,26,412,569,3,1,3,0,1,0,72.41
高雄縣,燕巢鄉,角宿村,488,1,465,4,469,701,3,1,3,0,1,0,66.90
高雄縣,燕巢鄉,鳳雄村,489,1,740,15,755,1005,3,1,3,0,1,0,75.12
高雄縣,燕巢鄉,鳳雄村,490,1,912,20,932,1172,3,1,3,0,1,0,79.52
高雄縣,燕巢鄉,橫山村,491,1,616,9,625,903,3,1,3,0,1,0,69.21
高雄縣,燕巢鄉,橫山村,492,1,588,7,595,844,3,1,3,0,1,0,70.50
高雄縣,燕巢鄉,深水村,493,1,760,10,770,1169,3,1,3,0,1,0,65.87
高雄縣,燕巢鄉,深水村,494,1,865,20,885,1351,3,1,3,0,1,0,65.51
高雄縣,田寮鄉,鹿埔村,495,1,266,1,267,382,3,1,3,0,1,0,69.90
高雄縣,田寮鄉,古亭村,496,1,426,9,435,696,3,1,3,0,1,0,62.50
高雄縣,田寮鄉,崇德村,497,1,746,7,753,1017,3,1,3,0,1,0,74.04
高雄縣,田寮鄉,三和村,498,1,286,4,290,426,3,1,3,0,1,0,68.08
高雄縣,田寮鄉,西德村,499,1,628,21,649,975,3,1,3,0,1,0,66.56
高雄縣,田寮鄉,南安村,500,1,557,13,570,822,3,1,3,0,1,0,69.34
高雄縣,田寮鄉,南安村,501,1,387,3,390,590,3,1,3,0,1,0,66.10
高雄縣,田寮鄉,大同村,502,1,292,6,298,434,3,1,3,0,1,0,68.66
高雄縣,田寮鄉,田寮村,503,1,283,7,290,444,3,1,3,0,1,0,65.32
高雄縣,田寮鄉,七星村,504,1,460,12,472,695,3,1,3,0,1,0,67.91
高雄縣,田寮鄉,新興村,505,1,913,8,921,1289,3,1,3,0,1,0,71.45
高雄縣,阿蓮鄉,阿蓮村,506,1,925,9,934,1454,3,1,3,0,1,0,64.24
高雄縣,阿蓮鄉,阿蓮村,507,1,600,18,618,927,3,1,3,0,1,0,66.67
高雄縣,阿蓮鄉,阿蓮村,508,1,767,12,779,1249,3,1,3,0,1,0,62.37
高雄縣,阿蓮鄉,南蓮村,509,1,882,15,897,1355,3,1,3,0,1,0,66.20
高雄縣,阿蓮鄉,南蓮村,510,1,781,9,790,1123,3,1,3,0,1,0,70.35
高雄縣,阿蓮鄉,清蓮村,511,1,865,9,874,1206,3,1,3,0,1,0,72.47
高雄縣,阿蓮鄉,清蓮村,512,1,700,11,711,980,3,1,3,0,1,0,72.55
高雄縣,阿蓮鄉,和蓮村,513,1,547,8,555,776,3,1,3,0,1,0,71.52
高雄縣,阿蓮鄉,和蓮村,514,1,666,7,673,1023,3,1,3,0,1,0,65.79
高雄縣,阿蓮鄉,青旗村,515,1,845,11,856,1276,3,1,3,0,1,0,67.08
高雄縣,阿蓮鄉,石安村,516,1,865,16,881,1213,3,1,3,0,1,0,72.63
高雄縣,阿蓮鄉,中路村,517,1,674,9,683,941,3,1,3,0,1,0,72.58
高雄縣,阿蓮鄉,中路村,518,1,610,7,617,848,3,1,3,0,1,0,72.76
高雄縣,阿蓮鄉,峰山村,519,1,798,14,812,1070,3,1,3,0,1,0,75.89
高雄縣,阿蓮鄉,港後村,520,1,815,16,831,1074,3,1,3,0,1,0,77.37
高雄縣,阿蓮鄉,港後村,521,1,337,5,342,449,3,1,3,0,1,0,76.17
高雄縣,阿蓮鄉,崗山村,522,1,479,12,491,656,3,1,3,0,1,0,74.85
高雄縣,阿蓮鄉,復安村,523,1,1026,20,1046,1434,3,1,3,0,1,0,72.94
高雄縣,阿蓮鄉,玉庫村,524,1,673,9,682,904,3,1,3,0,1,0,75.44
高雄縣,路竹鄉,竹園村,525,1,668,1,669,838,3,1,3,0,1,0,79.83
高雄縣,路竹鄉,竹園村,526,1,614,11,625,792,3,1,3,0,1,0,78.91
高雄縣,路竹鄉,下坑村,527,1,1021,17,1038,1227,3,1,3,0,1,0,84.60
高雄縣,路竹鄉,下坑村,528,1,962,16,978,1166,3,1,3,0,1,0,83.88
高雄縣,路竹鄉,甲南村,529,1,1128,13,1141,1388,3,1,3,0,1,0,82.20
高雄縣,路竹鄉,甲南村,530,1,840,8,848,1249,3,1,3,0,1,0,67.89
高雄縣,路竹鄉,甲北村,531,1,724,6,730,899,3,1,3,0,1,0,81.20
高雄縣,路竹鄉,甲北村,532,1,706,2,708,861,3,1,3,0,1,0,82.23
高雄縣,路竹鄉,社東村,533,1,1122,11,1133,1456,3,1,3,0,1,0,77.82
高雄縣,路竹鄉,社中村,534,1,744,7,751,973,3,1,3,0,1,0,77.18
高雄縣,路竹鄉,社西村,535,1,779,13,792,1021,3,1,3,0,1,0,77.57
高雄縣,路竹鄉,社西村,536,1,786,18,804,1096,3,1,3,0,1,0,73.36
高雄縣,路竹鄉,社南村,537,1,1106,13,1119,1457,3,1,3,0,1,0,76.80
高雄縣,路竹鄉,社南村,538,1,1014,10,1024,1420,3,1,3,0,1,0,72.11
高雄縣,路竹鄉,竹東村,539,1,895,15,910,1207,3,1,3,0,1,0,75.39
高雄縣,路竹鄉,竹東村,540,1,849,5,854,1140,3,1,3,0,1,0,74.91
高雄縣,路竹鄉,竹南村,541,1,947,9,956,1363,3,1,3,0,1,0,70.14
高雄縣,路竹鄉,竹南村,542,1,823,14,837,1162,3,1,3,0,1,0,72.03
高雄縣,路竹鄉,竹西村,543,1,735,8,743,918,3,1,3,0,1,0,80.94
高雄縣,路竹鄉,竹西村,544,1,779,6,785,1041,3,1,3,0,1,0,75.41
高雄縣,路竹鄉,文南村,545,1,688,3,691,906,3,1,3,0,1,0,76.27
高雄縣,路竹鄉,文南村,546,1,678,7,685,910,3,1,3,0,1,0,75.27
高雄縣,路竹鄉,文北村,547,1,934,5,939,1118,3,1,3,0,1,0,83.99
高雄縣,路竹鄉,文北村,548,1,875,12,887,1128,3,1,3,0,1,0,78.63
高雄縣,路竹鄉,竹滬村,549,1,638,12,650,856,3,1,3,0,1,0,75.93
高雄縣,路竹鄉,竹滬村,550,1,773,10,783,1029,3,1,3,0,1,0,76.09
高雄縣,路竹鄉,頂寮村,551,1,831,2,833,1137,3,1,3,0,1,0,73.26
高雄縣,路竹鄉,新達村,552,1,849,10,859,1121,3,1,3,0,1,0,76.63
高雄縣,路竹鄉,後鄉村,553,1,645,9,654,833,3,1,3,0,1,0,78.51
高雄縣,路竹鄉,北嶺村,554,1,789,11,800,969,3,1,3,0,1,0,82.56
高雄縣,路竹鄉,三爺村,555,1,647,9,656,805,3,1,3,0,1,0,81.49
高雄縣,路竹鄉,鴨寮村,556,1,946,11,957,1213,3,1,3,0,1,0,78.90
高雄縣,湖內鄉,大湖村,557,1,954,11,965,1273,3,1,3,0,1,0,75.81
高雄縣,湖內鄉,大湖村,558,1,609,5,614,808,3,1,3,0,1,0,75.99
高雄縣,湖內鄉,田尾村,559,1,727,12,739,1008,3,1,3,0,1,0,73.31
高雄縣,湖內鄉,湖內村,560,1,630,12,642,867,3,1,3,0,1,0,74.05
高雄縣,湖內鄉,湖內村,561,1,443,5,448,656,3,1,3,0,1,0,68.29
高雄縣,湖內鄉,湖內村,562,1,424,5,429,602,3,1,3,0,1,0,71.26
高雄縣,湖內鄉,湖內村,563,1,603,13,616,947,3,1,3,0,1,0,65.05
高雄縣,湖內鄉,海埔村,564,1,524,4,528,754,3,1,3,0,1,0,70.03
高雄縣,湖內鄉,海埔村,565,1,530,12,542,864,3,1,3,0,1,0,62.73
高雄縣,湖內鄉,海山村,566,1,833,12,845,1150,3,1,3,0,1,0,73.48
高雄縣,湖內鄉,劉家村,567,1,748,18,766,1107,3,1,3,0,1,0,69.20
高雄縣,湖內鄉,太爺村,568,1,587,5,592,801,3,1,3,0,1,0,73.91
高雄縣,湖內鄉,公舘村,569,1,979,10,989,1340,3,1,3,0,1,0,73.81
高雄縣,湖內鄉,葉厝村,570,1,528,5,533,733,3,1,3,0,1,0,72.71
高雄縣,湖內鄉,葉厝村,571,1,556,7,563,799,3,1,3,0,1,0,70.46
高雄縣,湖內鄉,文賢村,572,1,754,19,773,1099,3,1,3,0,1,0,70.34
高雄縣,湖內鄉,中賢村,573,1,608,5,613,869,3,1,3,0,1,0,70.54
高雄縣,湖內鄉,中賢村,574,1,678,8,686,976,3,1,3,0,1,0,70.29
高雄縣,湖內鄉,逸賢村,575,1,573,10,583,834,3,1,3,0,1,0,69.90
高雄縣,湖內鄉,忠興村,576,1,546,6,552,724,3,1,3,0,1,0,76.24
高雄縣,茄萣鄉,福德村,577,1,690,4,694,1036,3,1,3,0,1,0,66.99
高雄縣,茄萣鄉,萬福村,578,1,553,6,559,847,3,1,3,0,1,0,66.00
高雄縣,茄萣鄉,白雲村,579,1,1061,15,1076,1537,3,1,3,0,1,0,70.01
高雄縣,茄萣鄉,嘉賜村,580,1,750,3,753,1169,3,1,3,0,1,0,64.41
高雄縣,茄萣鄉,嘉賜村,581,1,767,12,779,1190,3,1,3,0,1,0,65.46
高雄縣,茄萣鄉,嘉安村,582,1,875,8,883,1266,3,1,3,0,1,0,69.75
高雄縣,茄萣鄉,嘉樂村,583,1,1254,15,1269,1785,3,1,3,0,1,0,71.09
高雄縣,茄萣鄉,嘉泰村,584,1,827,12,839,1278,3,1,3,0,1,0,65.65
高雄縣,茄萣鄉,嘉福村,585,1,725,7,732,1090,3,1,3,0,1,0,67.16
高雄縣,茄萣鄉,和協村,586,1,760,9,769,1197,3,1,3,0,1,0,64.24
高雄縣,茄萣鄉,嘉定村,587,1,895,7,902,1307,3,1,3,0,1,0,69.01
高雄縣,茄萣鄉,保定村,588,1,669,9,678,1079,3,1,3,0,1,0,62.84
高雄縣,茄萣鄉,保定村,589,1,988,7,995,1614,3,1,3,0,1,0,61.65
高雄縣,茄萣鄉,大定村,590,1,742,10,752,1158,3,1,3,0,1,0,64.94
高雄縣,茄萣鄉,光定村,591,1,678,10,688,1027,3,1,3,0,1,0,66.99
高雄縣,茄萣鄉,吉定村,592,1,758,8,766,1110,3,1,3,0,1,0,69.01
高雄縣,茄萣鄉,崎漏村,593,1,903,12,915,1182,3,1,3,0,1,0,77.41
高雄縣,茄萣鄉,崎漏村,594,1,933,19,952,1468,3,1,3,0,1,0,64.85
高雄縣,彌陀鄉,舊港村,595,1,1045,10,1055,1340,3,1,3,0,1,0,78.73
高雄縣,彌陀鄉,文安村,596,1,1241,17,1258,1698,3,1,3,0,1,0,74.09
高雄縣,彌陀鄉,鹽埕村,597,1,1295,20,1315,1734,3,1,3,0,1,0,75.84
高雄縣,彌陀鄉,過港村,598,1,700,16,716,860,3,1,3,0,1,0,83.26
高雄縣,彌陀鄉,光和村,599,1,735,8,743,993,3,1,3,0,1,0,74.82
高雄縣,彌陀鄉,彌靖村,600,1,1265,11,1276,1682,3,1,3,0,1,0,75.86
高雄縣,彌陀鄉,彌仁村,601,1,440,3,443,575,3,1,3,0,1,0,77.04
高雄縣,彌陀鄉,彌壽村,602,1,544,7,551,724,3,1,3,0,1,0,76.10
高雄縣,彌陀鄉,彌陀村,603,1,1052,23,1075,1403,3,1,3,0,1,0,76.62
高雄縣,彌陀鄉,海尾村,604,1,611,13,624,802,3,1,3,0,1,0,77.81
高雄縣,彌陀鄉,漯底村,605,1,745,5,750,901,3,1,3,0,1,0,83.24
高雄縣,彌陀鄉,南寮村,606,1,1346,11,1357,1821,3,1,3,0,1,0,74.52
高雄縣,永安鄉,永安村,607,1,980,6,986,1333,3,1,3,0,1,0,73.97
高雄縣,永安鄉,永華村,608,1,1124,15,1139,1513,3,1,3,0,1,0,75.28
高雄縣,永安鄉,新港村,609,1,1059,5,1064,1412,3,1,3,0,1,0,75.35
高雄縣,永安鄉,新港村,610,1,451,6,457,678,3,1,3,0,1,0,67.40
高雄縣,永安鄉,鹽田村,611,1,287,2,289,429,3,1,3,0,1,0,67.37
高雄縣,永安鄉,保寧村,612,1,1177,15,1192,1520,3,1,3,0,1,0,78.42
高雄縣,永安鄉,維新村,613,1,622,6,628,808,3,1,3,0,1,0,77.72
高雄縣,永安鄉,維新村,614,1,892,3,895,1216,3,1,3,0,1,0,73.60
高雄縣,梓官鄉,梓信村,615,1,1180,25,1205,1714,3,1,3,0,1,0,70.30
高雄縣,梓官鄉,梓義村,616,1,623,8,631,916,3,1,3,0,1,0,68.89
高雄縣,梓官鄉,梓義村,617,1,725,11,736,1004,3,1,3,0,1,0,73.31
高雄縣,梓官鄉,梓和村,618,1,880,15,895,1247,3,1,3,0,1,0,71.77
高雄縣,梓官鄉,梓和村,619,1,590,8,598,846,3,1,3,0,1,0,70.69
高雄縣,梓官鄉,梓平村,620,1,743,7,750,996,3,1,3,0,1,0,75.30
高雄縣,梓官鄉,中崙村,621,1,619,10,629,861,3,1,3,0,1,0,73.05
高雄縣,梓官鄉,同安村,622,1,601,5,606,784,3,1,3,0,1,0,77.30
高雄縣,梓官鄉,大舍村,623,1,916,17,933,1285,3,1,3,0,1,0,72.61
高雄縣,梓官鄉,大舍村,624,1,1285,18,1303,1842,3,1,3,0,1,0,70.74
高雄縣,梓官鄉,赤崁村,625,1,816,15,831,1121,3,1,3,0,1,0,74.13
高雄縣,梓官鄉,赤崁村,626,1,540,11,551,769,3,1,3,0,1,0,71.65
高雄縣,梓官鄉,赤東村,627,1,988,14,1002,1352,3,1,3,0,1,0,74.11
高雄縣,梓官鄉,赤東村,628,1,768,12,780,1039,3,1,3,0,1,0,75.07
高雄縣,梓官鄉,赤西村,629,1,444,4,448,639,3,1,3,0,1,0,70.11
高雄縣,梓官鄉,禮蚵村,630,1,738,12,750,1090,3,1,3,0,1,0,68.81
高雄縣,梓官鄉,禮蚵村,631,1,821,7,828,1146,3,1,3,0,1,0,72.25
高雄縣,梓官鄉,智蚵村,632,1,569,9,578,852,3,1,3,0,1,0,67.84
高雄縣,梓官鄉,智蚵村,633,1,744,12,756,1040,3,1,3,0,1,0,72.69
高雄縣,梓官鄉,信蚵村,634,1,781,5,786,1157,3,1,3,0,1,0,67.93
高雄縣,梓官鄉,茄苳村,635,1,871,13,884,1155,3,1,3,0,1,0,76.54
高雄縣,梓官鄉,茄苳村,636,1,663,4,667,949,3,1,3,0,1,0,70.28
高雄縣,梓官鄉,典寶村,637,1,809,10,819,1020,3,1,3,0,1,0,80.29
高雄縣,梓官鄉,典寶村,638,1,609,7,616,837,3,1,3,0,1,0,73.60
高雄縣,旗山鎮,太平里,639,1,723,3,726,1055,3,1,3,0,1,0,68.82
高雄縣,旗山鎮,太平里,640,1,823,15,838,1231,3,1,3,0,1,0,68.07
高雄縣,旗山鎮,大德里,641,1,972,12,984,1327,3,1,3,0,1,0,74.15
高雄縣,旗山鎮,大德里,642,1,769,3,772,1099,3,1,3,0,1,0,70.25
高雄縣,旗山鎮,湄洲里,643,1,642,5,647,896,3,1,3,0,1,0,72.21
高雄縣,旗山鎮,鼓山里,644,1,482,7,489,635,3,1,3,0,1,0,77.01
高雄縣,旗山鎮,新山里,645,1,672,3,675,915,3,1,3,0,1,0,73.77
高雄縣,旗山鎮,和平里,646,1,466,8,474,671,3,1,3,0,1,0,70.64
高雄縣,旗山鎮,竹峰里,647,1,365,5,370,495,3,1,3,0,1,0,74.75
高雄縣,旗山鎮,瑞吉里,648,1,626,4,630,907,3,1,3,0,1,0,69.46
高雄縣,旗山鎮,瑞吉里,649,1,645,5,650,962,3,1,3,0,1,0,67.57
高雄縣,旗山鎮,永和里,650,1,981,9,990,1435,3,1,3,0,1,0,68.99
高雄縣,旗山鎮,永和里,651,1,978,19,997,1377,3,1,3,0,1,0,72.40
高雄縣,旗山鎮,三協里,652,1,1009,14,1023,1472,3,1,3,0,1,0,69.50
高雄縣,旗山鎮,三協里,653,1,9,0,9,298,3,1,3,0,1,0,3.02
高雄縣,旗山鎮,圓富里,654,1,724,22,746,1059,3,1,3,0,1,0,70.44
高雄縣,旗山鎮,圓富里,655,1,560,10,570,826,3,1,3,0,1,0,69.01
高雄縣,旗山鎮,中正里,656,1,1044,22,1066,1521,3,1,3,0,1,0,70.09
高雄縣,旗山鎮,大林里,657,1,770,11,781,1097,3,1,3,0,1,0,71.19
高雄縣,旗山鎮,大林里,658,1,427,4,431,581,3,1,3,0,1,0,74.18
高雄縣,旗山鎮,上洲里,659,1,721,9,730,954,3,1,3,0,1,0,76.52
高雄縣,旗山鎮,鯤洲里,660,1,767,7,774,986,3,1,3,0,1,0,78.50
高雄縣,旗山鎮,大山里,661,1,1061,14,1075,1402,3,1,3,0,1,0,76.68
高雄縣,旗山鎮,中洲里,662,1,825,14,839,1103,3,1,3,0,1,0,76.07
高雄縣,旗山鎮,南洲里,663,1,1124,10,1134,1452,3,1,3,0,1,0,78.10
高雄縣,旗山鎮,新光里,664,1,762,3,765,988,3,1,3,0,1,0,77.43
高雄縣,旗山鎮,南勝里,665,1,935,10,945,1220,3,1,3,0,1,0,77.46
高雄縣,旗山鎮,南勝里,666,1,909,15,924,1186,3,1,3,0,1,0,77.91
高雄縣,旗山鎮,東平里,667,1,683,6,689,932,3,1,3,0,1,0,73.93
高雄縣,旗山鎮,東平里,668,1,640,8,648,917,3,1,3,0,1,0,70.67
高雄縣,旗山鎮,東昌里,669,1,492,8,500,709,3,1,3,0,1,0,70.52
高雄縣,旗山鎮,糖廠里,670,1,283,3,286,387,3,1,3,0,1,0,73.90
高雄縣,旗山鎮,廣福里,671,1,457,3,460,612,3,1,3,0,1,0,75.16
高雄縣,旗山鎮,中寮里,672,1,139,0,139,201,3,1,3,0,1,0,69.15
高雄縣,美濃鎮,中圳里,673,1,1177,13,1190,1610,3,1,3,0,1,0,73.91
高雄縣,美濃鎮,東門里,674,1,1109,14,1123,1575,3,1,3,0,1,0,71.30
高雄縣,美濃鎮,泰安里,675,1,993,8,1001,1422,3,1,3,0,1,0,70.39
高雄縣,美濃鎮,合和里,676,1,744,13,757,1022,3,1,3,0,1,0,74.07
高雄縣,美濃鎮,合和里,677,1,810,12,822,1208,3,1,3,0,1,0,68.05
高雄縣,美濃鎮,瀰濃里,678,1,861,8,869,1241,3,1,3,0,1,0,70.02
高雄縣,美濃鎮,瀰濃里,679,1,653,10,663,975,3,1,3,0,1,0,68.00
高雄縣,美濃鎮,福安里,680,1,849,7,856,1195,3,1,3,0,1,0,71.63
高雄縣,美濃鎮,福安里,681,1,906,13,919,1352,3,1,3,0,1,0,67.97
高雄縣,美濃鎮,祿興里,682,1,887,12,899,1262,3,1,3,0,1,0,71.24
高雄縣,美濃鎮,祿興里,683,1,836,10,846,1196,3,1,3,0,1,0,70.74
高雄縣,美濃鎮,中壇里,684,1,684,2,686,907,3,1,3,0,1,0,75.63
高雄縣,美濃鎮,中壇里,685,1,804,11,815,1190,3,1,3,0,1,0,68.49
高雄縣,美濃鎮,德興里,686,1,1088,9,1097,1532,3,1,3,0,1,0,71.61
高雄縣,美濃鎮,清水里,687,1,687,13,700,1012,3,1,3,0,1,0,69.17
高雄縣,美濃鎮,清水里,688,1,501,4,505,732,3,1,3,0,1,0,68.99
高雄縣,美濃鎮,吉和里,689,1,1070,12,1082,1459,3,1,3,0,1,0,74.16
高雄縣,美濃鎮,吉洋里,690,1,737,9,746,1072,3,1,3,0,1,0,69.59
高雄縣,美濃鎮,吉洋里,691,1,704,7,711,1054,3,1,3,0,1,0,67.46
高雄縣,美濃鎮,吉東里,692,1,1185,16,1201,1638,3,1,3,0,1,0,73.32
高雄縣,美濃鎮,龍山里,693,1,835,13,848,1207,3,1,3,0,1,0,70.26
高雄縣,美濃鎮,龍山里,694,1,732,19,751,1099,3,1,3,0,1,0,68.33
高雄縣,美濃鎮,獅山里,695,1,926,50,976,1379,3,1,3,0,1,0,70.78
高雄縣,美濃鎮,獅山里,696,1,747,9,756,1005,3,1,3,0,1,0,75.22
高雄縣,美濃鎮,龍肚里,697,1,523,7,530,775,3,1,3,0,1,0,68.39
高雄縣,美濃鎮,龍肚里,698,1,619,10,629,919,3,1,3,0,1,0,68.44
高雄縣,美濃鎮,廣德里,699,1,1035,18,1053,1477,3,1,3,0,1,0,71.29
高雄縣,美濃鎮,興隆里,700,1,899,5,904,1232,3,1,3,0,1,0,73.38
高雄縣,美濃鎮,廣林里,701,1,623,12,635,934,3,1,3,0,1,0,67.99
高雄縣,美濃鎮,廣林里,702,1,539,5,544,835,3,1,3,0,1,0,65.15
高雄縣,六龜鄉,六龜村,703,1,672,13,685,1146,3,1,3,0,1,0,59.77
高雄縣,六龜鄉,義寶村,704,1,845,8,853,1191,3,1,3,0,1,0,71.62
高雄縣,六龜鄉,文武村,705,1,1031,24,1055,1670,3,1,3,0,1,0,63.17
高雄縣,六龜鄉,中興村,706,1,889,20,909,1416,3,1,3,0,1,0,64.19
高雄縣,六龜鄉,興龍村,707,1,634,12,646,1000,3,1,3,0,1,0,64.60
高雄縣,六龜鄉,新威村,708,1,591,9,600,871,3,1,3,0,1,0,68.89
高雄縣,六龜鄉,新興村,709,1,549,4,553,809,3,1,3,0,1,0,68.36
高雄縣,六龜鄉,新寮村,710,1,499,7,506,651,3,1,3,0,1,0,77.73
高雄縣,六龜鄉,大津村,711,1,276,5,281,382,3,1,3,0,1,0,73.56
高雄縣,六龜鄉,新發村,712,1,853,8,861,1510,3,1,3,0,1,0,57.02
高雄縣,六龜鄉,荖濃村,713,1,977,32,1009,1570,3,1,3,0,1,0,64.27
高雄縣,六龜鄉,寶來村,714,1,676,15,691,1024,3,1,3,0,1,0,67.48
高雄縣,甲仙鄉,東安村,715,1,435,6,441,630,3,1,3,0,1,0,70.00
高雄縣,甲仙鄉,西安村,716,1,813,5,818,1057,3,1,3,0,1,0,77.39
高雄縣,甲仙鄉,和安村,717,1,559,6,565,764,3,1,3,0,1,0,73.95
高雄縣,甲仙鄉,大田村,718,1,1064,11,1075,1472,3,1,3,0,1,0,73.03
高雄縣,甲仙鄉,寶隆村,719,1,494,5,499,712,3,1,3,0,1,0,70.08
高雄縣,甲仙鄉,關山村,720,1,494,4,498,693,3,1,3,0,1,0,71.86
高雄縣,甲仙鄉,小林村,721,1,734,8,742,1163,3,1,3,0,1,0,63.80
高雄縣,杉林鄉,杉林村,722,1,583,5,588,878,3,1,3,0,1,0,66.97
高雄縣,杉林鄉,木梓村,723,1,483,4,487,812,3,1,3,0,1,0,59.98
高雄縣,杉林鄉,集來村,724,1,638,19,657,1139,3,1,3,0,1,0,57.68
高雄縣,杉林鄉,集來村,725,1,451,7,458,763,3,1,3,0,1,0,60.03
高雄縣,杉林鄉,新庄村,726,1,1188,19,1207,1852,3,1,3,0,1,0,65.17
高雄縣,杉林鄉,上平村,727,1,1124,17,1141,1638,3,1,3,0,1,0,69.66
高雄縣,杉林鄉,月眉村,728,1,1205,22,1227,1836,3,1,3,0,1,0,66.83
高雄縣,杉林鄉,月美村,729,1,938,13,951,1411,3,1,3,0,1,0,67.40
高雄縣,內門鄉,金竹村,730,1,573,14,587,778,3,1,3,0,1,0,75.45
高雄縣,內門鄉,溝坪村,731,1,722,10,732,1055,3,1,3,0,1,0,69.38
高雄縣,內門鄉,永興村,732,1,344,4,348,510,3,1,3,0,1,0,68.24
高雄縣,內門鄉,永吉村,733,1,373,7,380,483,3,1,3,0,1,0,78.67
高雄縣,內門鄉,永富村,734,1,752,16,768,1001,3,1,3,0,1,0,76.72
高雄縣,內門鄉,觀亭村,735,1,487,5,492,670,3,1,3,0,1,0,73.43
高雄縣,內門鄉,觀亭村,736,1,788,22,810,1077,3,1,3,0,1,0,75.21
高雄縣,內門鄉,中埔村,737,1,477,5,482,623,3,1,3,0,1,0,77.37
高雄縣,內門鄉,瑞山村,738,1,291,3,294,386,3,1,3,0,1,0,76.17
高雄縣,內門鄉,內南村,739,1,281,3,284,364,3,1,3,0,1,0,78.02
高雄縣,內門鄉,內東村,740,1,665,6,671,844,3,1,3,0,1,0,79.50
高雄縣,內門鄉,光興村,741,1,507,7,514,656,3,1,3,0,1,0,78.35
高雄縣,內門鄉,東埔村,742,1,344,3,347,476,3,1,3,0,1,0,72.90
高雄縣,內門鄉,內豐村,743,1,885,3,888,1130,3,1,3,0,1,0,78.58
高雄縣,內門鄉,內門村,744,1,759,5,764,928,3,1,3,0,1,0,82.33
高雄縣,內門鄉,石坑村,745,1,379,9,388,508,3,1,3,0,1,0,76.38
高雄縣,內門鄉,三平村,746,1,502,7,509,675,3,1,3,0,1,0,75.41
高雄縣,內門鄉,木柵村,747,1,469,8,477,685,3,1,3,0,1,0,69.64
高雄縣,內門鄉,內興村,748,1,447,3,450,619,3,1,3,0,1,0,72.70
高雄縣,茂林鄉,茂林村,749,1,29,1,30,59,3,1,3,0,1,0,50.85
高雄縣,茂林鄉,萬山村,750,1,12,0,12,18,3,1,3,0,1,0,66.67
高雄縣,茂林鄉,多納村,751,1,7,0,7,17,3,1,3,0,1,0,41.18
高雄縣,桃源鄉,寶山村,752,1,3,1,4,8,3,1,3,0,1,0,50.00
高雄縣,桃源鄉,寶山村,753,1,9,1,10,21,3,1,3,0,1,0,47.62
高雄縣,桃源鄉,建山村,754,1,27,1,28,42,3,1,3,0,1,0,66.67
高雄縣,桃源鄉,高中村,755,1,46,0,46,72,3,1,3,0,1,0,63.89
高雄縣,桃源鄉,桃源村,756,1,87,0,87,130,3,1,3,0,1,0,66.92
高雄縣,桃源鄉,勤和村,757,1,7,0,7,17,3,1,3,0,1,0,41.18
高雄縣,桃源鄉,復興村,758,1,9,0,9,19,3,1,3,0,1,0,47.37
高雄縣,桃源鄉,梅蘭村,759,1,7,0,7,13,3,1,3,0,1,0,53.85
高雄縣,桃源鄉,梅山村,760,1,8,0,8,18,3,1,3,0,1,0,44.44
高雄縣,三民鄉,民族村,761,1,53,0,53,133,3,1,3,0,1,0,39.85
高雄縣,三民鄉,民權村,762,1,15,0,15,31,3,1,3,0,1,0,48.39
高雄縣,三民鄉,民生村,763,1,49,0,49,79,3,1,3,0,1,0,62.03
屏東縣,屏東市,端正里,1,1,922,4,926,1348,3,1,3,0,1,0,68.69
屏東縣,屏東市,光榮里,2,1,1092,7,1099,1561,3,1,3,0,1,0,70.40
屏東縣,屏東市,大同里,3,1,622,2,624,882,3,1,3,0,1,0,70.75
屏東縣,屏東市,泰安里,4,1,913,3,916,1412,3,1,3,0,1,0,64.87
屏東縣,屏東市,維新里,5,1,1054,9,1063,1576,3,1,3,0,1,0,67.45
屏東縣,屏東市,維新里,6,1,920,5,925,1409,3,1,3,0,1,0,65.65
屏東縣,屏東市,大埔里,7,1,988,10,998,1521,3,1,3,0,1,0,65.61
屏東縣,屏東市,崇智里,8,1,674,4,678,972,3,1,3,0,1,0,69.75
屏東縣,屏東市,楠樹里,9,1,629,4,633,968,3,1,3,0,1,0,65.39
屏東縣,屏東市,金泉里,10,1,883,4,887,1355,3,1,3,0,1,0,65.46
屏東縣,屏東市,平和里,11,1,688,2,690,1007,3,1,3,0,1,0,68.52
屏東縣,屏東市,安樂里,12,1,780,5,785,1128,3,1,3,0,1,0,69.59
屏東縣,屏東市,橋南里,13,1,915,7,922,1640,3,1,3,0,1,0,56.22
屏東縣,屏東市,橋北里,14,1,729,6,735,1128,3,1,3,0,1,0,65.16
屏東縣,屏東市,長春里,15,1,696,4,700,1043,3,1,3,0,1,0,67.11
屏東縣,屏東市,長春里,16,1,603,8,611,1001,3,1,3,0,1,0,61.04
屏東縣,屏東市,豐榮里,17,1,757,2,759,1149,3,1,3,0,1,0,66.06
屏東縣,屏東市,豐榮里,18,1,805,4,809,1166,3,1,3,0,1,0,69.38
屏東縣,屏東市,豐田里,19,1,693,3,696,1075,3,1,3,0,1,0,64.74
屏東縣,屏東市,豐田里,20,1,807,2,809,1261,3,1,3,0,1,0,64.16
屏東縣,屏東市,豐田里,21,1,910,8,918,1416,3,1,3,0,1,0,64.83
屏東縣,屏東市,大連里,22,1,1233,4,1237,1902,3,1,3,0,1,0,65.04
屏東縣,屏東市,大連里,23,1,1005,17,1022,1535,3,1,3,0,1,0,66.58
屏東縣,屏東市,大連里,24,1,1094,8,1102,1700,3,1,3,0,1,0,64.82
屏東縣,屏東市,大連里,25,1,1230,9,1239,1864,3,1,3,0,1,0,66.47
屏東縣,屏東市,豐源里,26,1,1118,10,1128,1768,3,1,3,0,1,0,63.80
屏東縣,屏東市,豐源里,27,1,1037,10,1047,1609,3,1,3,0,1,0,65.07
屏東縣,屏東市,湖南里,28,1,613,7,620,881,3,1,3,0,1,0,70.37
屏東縣,屏東市,湖西里,29,1,862,5,867,1251,3,1,3,0,1,0,69.30
屏東縣,屏東市,歸心里,30,1,713,8,721,1034,3,1,3,0,1,0,69.73
屏東縣,屏東市,瑞光里,31,1,1114,7,1121,1741,3,1,3,0,1,0,64.39
屏東縣,屏東市,瑞光里,32,1,1238,13,1251,1924,3,1,3,0,1,0,65.02
屏東縣,屏東市,瑞光里,33,1,1211,25,1236,1848,3,1,3,0,1,0,66.88
屏東縣,屏東市,一心里,34,1,940,12,952,1380,3,1,3,0,1,0,68.99
屏東縣,屏東市,擇仁里,35,1,902,7,909,1488,3,1,3,0,1,0,61.09
屏東縣,屏東市,光華里,36,1,485,5,490,774,3,1,3,0,1,0,63.31
屏東縣,屏東市,萬年里,37,1,534,5,539,838,3,1,3,0,1,0,64.32
屏東縣,屏東市,厚生里,38,1,866,10,876,1471,3,1,3,0,1,0,59.55
屏東縣,屏東市,厚生里,39,1,912,7,919,1473,3,1,3,0,1,0,62.39
屏東縣,屏東市,永安里,40,1,851,5,856,1427,3,1,3,0,1,0,59.99
屏東縣,屏東市,永安里,41,1,934,8,942,1576,3,1,3,0,1,0,59.77
屏東縣,屏東市,永安里,42,1,792,3,795,1323,3,1,3,0,1,0,60.09
屏東縣,屏東市,永安里,43,1,885,10,895,1464,3,1,3,0,1,0,61.13
屏東縣,屏東市,新生里,44,1,662,8,670,978,3,1,3,0,1,0,68.51
屏東縣,屏東市,新生里,45,1,980,11,991,1531,3,1,3,0,1,0,64.73
屏東縣,屏東市,新生里,46,1,764,10,774,1143,3,1,3,0,1,0,67.72
屏東縣,屏東市,頂宅里,47,1,363,5,368,544,3,1,3,0,1,0,67.65
屏東縣,屏東市,頂柳里,48,1,653,6,659,907,3,1,3,0,1,0,72.66
屏東縣,屏東市,龍華里,49,1,867,6,873,1209,3,1,3,0,1,0,72.21
屏東縣,屏東市,龍華里,50,1,711,7,718,1021,3,1,3,0,1,0,70.32
屏東縣,屏東市,大湖里,51,1,899,9,908,1278,3,1,3,0,1,0,71.05
屏東縣,屏東市,新興里,52,1,1372,7,1379,1956,3,1,3,0,1,0,70.50
屏東縣,屏東市,公館里,53,1,1024,9,1033,1435,3,1,3,0,1,0,71.99
屏東縣,屏東市,玉成里,54,1,815,7,822,1161,3,1,3,0,1,0,70.80
屏東縣,屏東市,永光里,55,1,763,14,777,1129,3,1,3,0,1,0,68.82
屏東縣,屏東市,安鎮里,56,1,1249,10,1259,1879,3,1,3,0,1,0,67.00
屏東縣,屏東市,永昌里,57,1,856,11,867,1293,3,1,3,0,1,0,67.05
屏東縣,屏東市,長安里,58,1,754,9,763,1152,3,1,3,0,1,0,66.23
屏東縣,屏東市,長安里,59,1,515,13,528,807,3,1,3,0,1,0,65.43
屏東縣,屏東市,崇武里,60,1,826,7,833,1169,3,1,3,0,1,0,71.26
屏東縣,屏東市,大武里,61,1,1283,17,1300,1953,3,1,3,0,1,0,66.56
屏東縣,屏東市,大武里,62,1,1244,15,1259,1974,3,1,3,0,1,0,63.78
屏東縣,屏東市,大武里,63,1,1020,12,1032,1560,3,1,3,0,1,0,66.15
屏東縣,屏東市,清溪里,64,1,960,8,968,1448,3,1,3,0,1,0,66.85
屏東縣,屏東市,清溪里,65,1,1253,13,1266,2005,3,1,3,0,1,0,63.14
屏東縣,屏東市,前進里,66,1,747,4,751,1092,3,1,3,0,1,0,68.77
屏東縣,屏東市,大洲里,67,1,644,5,649,891,3,1,3,0,1,0,72.84
屏東縣,屏東市,凌雲里,68,1,1074,6,1080,1528,3,1,3,0,1,0,70.68
屏東縣,屏東市,鵬程里,69,1,1058,13,1071,1446,3,1,3,0,1,0,74.07
屏東縣,屏東市,興樂里,70,1,734,7,741,1108,3,1,3,0,1,0,66.88
屏東縣,屏東市,斯文里,71,1,590,5,595,863,3,1,3,0,1,0,68.95
屏東縣,屏東市,斯文里,72,1,670,9,679,1000,3,1,3,0,1,0,67.90
屏東縣,屏東市,太平里,73,1,662,8,670,995,3,1,3,0,1,0,67.34
屏東縣,屏東市,華山里,74,1,821,4,825,1211,3,1,3,0,1,0,68.13
屏東縣,屏東市,華山里,75,1,898,11,909,1311,3,1,3,0,1,0,69.34
屏東縣,屏東市,華山里,76,1,885,6,891,1359,3,1,3,0,1,0,65.56
屏東縣,屏東市,溝美里,77,1,783,1,784,1247,3,1,3,0,1,0,62.87
屏東縣,屏東市,溝美里,78,1,859,4,863,1296,3,1,3,0,1,0,66.59
屏東縣,屏東市,中正里,79,1,966,7,973,1465,3,1,3,0,1,0,66.42
屏東縣,屏東市,中正里,80,1,714,9,723,1192,3,1,3,0,1,0,60.65
屏東縣,屏東市,仁愛里,81,1,571,5,576,950,3,1,3,0,1,0,60.63
屏東縣,屏東市,仁愛里,82,1,603,3,606,1037,3,1,3,0,1,0,58.44
屏東縣,屏東市,北興里,83,1,957,10,967,1417,3,1,3,0,1,0,68.24
屏東縣,屏東市,北興里,84,1,1068,11,1079,1762,3,1,3,0,1,0,61.24
屏東縣,屏東市,北興里,85,1,902,7,909,1415,3,1,3,0,1,0,64.24
屏東縣,屏東市,北勢里,86,1,708,4,712,1061,3,1,3,0,1,0,67.11
屏東縣,屏東市,北勢里,87,1,768,8,776,1092,3,1,3,0,1,0,71.06
屏東縣,屏東市,勝利里,88,1,587,4,591,930,3,1,3,0,1,0,63.55
屏東縣,屏東市,勝利里,89,1,774,12,786,1256,3,1,3,0,1,0,62.58
屏東縣,屏東市,勝利里,90,1,1028,9,1037,1597,3,1,3,0,1,0,64.93
屏東縣,屏東市,永城里,91,1,720,3,723,1058,3,1,3,0,1,0,68.34
屏東縣,屏東市,永城里,92,1,816,12,828,1376,3,1,3,0,1,0,60.17
屏東縣,屏東市,崇蘭里,93,1,868,4,872,1347,3,1,3,0,1,0,64.74
屏東縣,屏東市,崇蘭里,94,1,944,5,949,1433,3,1,3,0,1,0,66.22
屏東縣,屏東市,崇蘭里,95,1,749,4,753,1162,3,1,3,0,1,0,64.80
屏東縣,屏東市,崇蘭里,96,1,710,7,717,1066,3,1,3,0,1,0,67.26
屏東縣,屏東市,廣興里,97,1,1245,18,1263,1700,3,1,3,0,1,0,74.29
屏東縣,屏東市,空翔里,98,1,1025,9,1034,1538,3,1,3,0,1,0,67.23
屏東縣,屏東市,大鵬里,99,1,543,8,551,786,3,1,3,0,1,0,70.10
屏東縣,屏東市,潭墘里,100,1,919,7,926,1479,3,1,3,0,1,0,62.61
屏東縣,屏東市,潭墘里,101,1,842,6,848,1318,3,1,3,0,1,0,64.34
屏東縣,屏東市,潭墘里,102,1,862,4,866,1333,3,1,3,0,1,0,64.97
屏東縣,屏東市,潭墘里,103,1,952,6,958,1537,3,1,3,0,1,0,62.33
屏東縣,屏東市,三山里,104,1,822,16,838,1188,3,1,3,0,1,0,70.54
屏東縣,屏東市,海豐里,105,1,565,1,566,817,3,1,3,0,1,0,69.28
屏東縣,屏東市,仁義里,106,1,695,7,702,947,3,1,3,0,1,0,74.13
屏東縣,屏東市,信和里,107,1,936,6,942,1360,3,1,3,0,1,0,69.26
屏東縣,屏東市,和興里,108,1,640,5,645,943,3,1,3,0,1,0,68.40
屏東縣,潮州鎮,潮州里,109,1,447,0,447,696,3,1,3,0,1,0,64.22
屏東縣,潮州鎮,光華里,110,1,1029,6,1035,1642,3,1,3,0,1,0,63.03
屏東縣,潮州鎮,光華里,111,1,997,9,1006,1673,3,1,3,0,1,0,60.13
屏東縣,潮州鎮,同榮里,112,1,550,2,552,806,3,1,3,0,1,0,68.49
屏東縣,潮州鎮,新生里,113,1,841,5,846,1320,3,1,3,0,1,0,64.09
屏東縣,潮州鎮,新榮里,114,1,922,5,927,1459,3,1,3,0,1,0,63.54
屏東縣,潮州鎮,彭城里,115,1,559,0,559,781,3,1,3,0,1,0,71.57
屏東縣,潮州鎮,三星里,116,1,1026,5,1031,1672,3,1,3,0,1,0,61.66
屏東縣,潮州鎮,三星里,117,1,1185,8,1193,1890,3,1,3,0,1,0,63.12
屏東縣,潮州鎮,三共里,118,1,996,4,1000,1559,3,1,3,0,1,0,64.14
屏東縣,潮州鎮,三共里,119,1,972,11,983,1644,3,1,3,0,1,0,59.79
屏東縣,潮州鎮,三共里,120,1,965,7,972,1591,3,1,3,0,1,0,61.09
屏東縣,潮州鎮,三和里,121,1,1011,7,1018,1606,3,1,3,0,1,0,63.39
屏東縣,潮州鎮,五魁里,122,1,617,6,623,932,3,1,3,0,1,0,66.85
屏東縣,潮州鎮,蓬萊里,123,1,1156,15,1171,1747,3,1,3,0,1,0,67.03
屏東縣,潮州鎮,八爺里,124,1,1209,9,1218,1830,3,1,3,0,1,0,66.56
屏東縣,潮州鎮,永春里,125,1,594,4,598,980,3,1,3,0,1,0,61.02
屏東縣,潮州鎮,永春里,126,1,712,4,716,1193,3,1,3,0,1,0,60.02
屏東縣,潮州鎮,永春里,127,1,1211,6,1217,1954,3,1,3,0,1,0,62.28
屏東縣,潮州鎮,富春里,128,1,905,8,913,1414,3,1,3,0,1,0,64.57
屏東縣,潮州鎮,光春里,129,1,819,12,831,1254,3,1,3,0,1,0,66.27
屏東縣,潮州鎮,興美里,130,1,470,5,475,746,3,1,3,0,1,0,63.67
屏東縣,潮州鎮,檨子里,131,1,385,2,387,612,3,1,3,0,1,0,63.24
屏東縣,潮州鎮,九塊里,132,1,956,15,971,1557,3,1,3,0,1,0,62.36
屏東縣,潮州鎮,泗林里,133,1,925,10,935,1420,3,1,3,0,1,0,65.85
屏東縣,潮州鎮,四春里,134,1,1227,17,1244,1859,3,1,3,0,1,0,66.92
屏東縣,潮州鎮,崙東里,135,1,961,15,976,1545,3,1,3,0,1,0,63.17
屏東縣,東港鎮,新勝里,136,1,826,8,834,1146,3,1,3,0,1,0,72.77
屏東縣,東港鎮,新勝里,137,1,911,5,916,1229,3,1,3,0,1,0,74.53
屏東縣,東港鎮,頂新里,138,1,393,4,397,559,3,1,3,0,1,0,71.02
屏東縣,東港鎮,頂中里,139,1,367,3,370,488,3,1,3,0,1,0,75.82
屏東縣,東港鎮,東和里,140,1,491,2,493,776,3,1,3,0,1,0,63.53
屏東縣,東港鎮,興台里,141,1,460,5,465,651,3,1,3,0,1,0,71.43
屏東縣,東港鎮,興東里,142,1,907,9,916,1348,3,1,3,0,1,0,67.95
屏東縣,東港鎮,興東里,143,1,981,14,995,1603,3,1,3,0,1,0,62.07
屏東縣,東港鎮,興東里,144,1,899,12,911,1312,3,1,3,0,1,0,69.44
屏東縣,東港鎮,興農里,145,1,508,8,516,700,3,1,3,0,1,0,73.71
屏東縣,東港鎮,中興里,146,1,447,3,450,615,3,1,3,0,1,0,73.17
屏東縣,東港鎮,朝安里,147,1,815,7,822,1276,3,1,3,0,1,0,64.42
屏東縣,東港鎮,朝安里,148,1,438,3,441,652,3,1,3,0,1,0,67.64
屏東縣,東港鎮,八德里,149,1,587,10,597,925,3,1,3,0,1,0,64.54
屏東縣,東港鎮,東隆里,150,1,982,8,990,1384,3,1,3,0,1,0,71.53
屏東縣,東港鎮,豐漁里,151,1,507,2,509,735,3,1,3,0,1,0,69.25
屏東縣,東港鎮,盛漁里,152,1,728,10,738,1184,3,1,3,0,1,0,62.33
屏東縣,東港鎮,興漁里,153,1,1187,15,1202,1824,3,1,3,0,1,0,65.90
屏東縣,東港鎮,鎮海里,154,1,1478,19,1497,2287,3,1,3,0,1,0,65.46
屏東縣,東港鎮,嘉蓮里,155,1,814,7,821,1266,3,1,3,0,1,0,64.85
屏東縣,東港鎮,南平里,156,1,301,3,304,425,3,1,3,0,1,0,71.53
屏東縣,東港鎮,南平里,157,1,655,6,661,1027,3,1,3,0,1,0,64.36
屏東縣,東港鎮,船頭里,158,1,1276,11,1287,1829,3,1,3,0,1,0,70.37
屏東縣,東港鎮,船頭里,159,1,489,5,494,802,3,1,3,0,1,0,61.60
屏東縣,東港鎮,下廍里,160,1,1151,6,1157,1718,3,1,3,0,1,0,67.35
屏東縣,東港鎮,大潭里,161,1,1055,7,1062,1542,3,1,3,0,1,0,68.87
屏東縣,東港鎮,興和里,162,1,574,12,586,817,3,1,3,0,1,0,71.73
屏東縣,東港鎮,共和里,163,1,529,8,537,771,3,1,3,0,1,0,69.65
屏東縣,東港鎮,大鵬里,164,1,256,2,258,382,3,1,3,0,1,0,67.54
屏東縣,恆春鎮,城南里,165,1,652,8,660,1033,3,1,3,0,1,0,63.89
屏東縣,恆春鎮,城北里,166,1,1050,17,1067,1845,3,1,3,0,1,0,57.83
屏東縣,恆春鎮,城西里,167,1,710,7,717,1127,3,1,3,0,1,0,63.62
屏東縣,恆春鎮,山腳里,168,1,970,20,990,1807,3,1,3,0,1,0,54.79
屏東縣,恆春鎮,山腳里,169,1,772,7,779,1360,3,1,3,0,1,0,57.28
屏東縣,恆春鎮,網紗里,170,1,667,7,674,1257,3,1,3,0,1,0,53.62
屏東縣,恆春鎮,網紗里,171,1,617,6,623,1162,3,1,3,0,1,0,53.61
屏東縣,恆春鎮,仁壽里,172,1,433,9,442,786,3,1,3,0,1,0,56.23
屏東縣,恆春鎮,茄湖里,173,1,280,10,290,516,3,1,3,0,1,0,56.20
屏東縣,恆春鎮,頭溝里,174,1,237,3,240,504,3,1,3,0,1,0,47.62
屏東縣,恆春鎮,四溝里,175,1,502,5,507,916,3,1,3,0,1,0,55.35
屏東縣,恆春鎮,德和里,176,1,315,8,323,534,3,1,3,0,1,0,60.49
屏東縣,恆春鎮,龍水里,177,1,514,9,523,922,3,1,3,0,1,0,56.72
屏東縣,恆春鎮,山海里,178,1,854,8,862,1475,3,1,3,0,1,0,58.44
屏東縣,恆春鎮,大光里,179,1,991,10,1001,1728,3,1,3,0,1,0,57.93
屏東縣,恆春鎮,水泉里,180,1,709,10,719,1474,3,1,3,0,1,0,48.78
屏東縣,恆春鎮,南灣里,181,1,727,10,737,1347,3,1,3,0,1,0,54.71
屏東縣,恆春鎮,墾丁里,182,1,706,4,710,1134,3,1,3,0,1,0,62.61
屏東縣,恆春鎮,鵝鑾里,183,1,600,6,606,1044,3,1,3,0,1,0,58.05
屏東縣,萬丹鄉,社上村,184,1,776,14,790,1138,3,1,3,0,1,0,69.42
屏東縣,萬丹鄉,社中村,185,1,857,6,863,1238,3,1,3,0,1,0,69.71
屏東縣,萬丹鄉,社皮村,186,1,1085,13,1098,1625,3,1,3,0,1,0,67.57
屏東縣,萬丹鄉,磚寮村,187,1,611,12,623,786,3,1,3,0,1,0,79.26
屏東縣,萬丹鄉,社口村,188,1,748,8,756,1029,3,1,3,0,1,0,73.47
屏東縣,萬丹鄉,加興村,189,1,774,7,781,1004,3,1,3,0,1,0,77.79
屏東縣,萬丹鄉,上村村,190,1,449,5,454,582,3,1,3,0,1,0,78.01
屏東縣,萬丹鄉,廈北村,191,1,1003,9,1012,1506,3,1,3,0,1,0,67.20
屏東縣,萬丹鄉,廈南村,192,1,885,7,892,1271,3,1,3,0,1,0,70.18
屏東縣,萬丹鄉,崙頂村,193,1,888,10,898,1217,3,1,3,0,1,0,73.79
屏東縣,萬丹鄉,田厝村,194,1,573,4,577,708,3,1,3,0,1,0,81.50
屏東縣,萬丹鄉,後村村,195,1,805,5,810,956,3,1,3,0,1,0,84.73
屏東縣,萬丹鄉,灣內村,196,1,853,5,858,1106,3,1,3,0,1,0,77.58
屏東縣,萬丹鄉,香社村,197,1,960,10,970,1360,3,1,3,0,1,0,71.32
屏東縣,萬丹鄉,新庄村,198,1,1269,14,1283,1711,3,1,3,0,1,0,74.99
屏東縣,萬丹鄉,新鐘村,199,1,1292,13,1305,1694,3,1,3,0,1,0,77.04
屏東縣,萬丹鄉,水仙村,200,1,369,3,372,481,3,1,3,0,1,0,77.34
屏東縣,萬丹鄉,興安村,201,1,595,5,600,756,3,1,3,0,1,0,79.37
屏東縣,萬丹鄉,興全村,202,1,807,4,811,1063,3,1,3,0,1,0,76.29
屏東縣,萬丹鄉,甘棠村,203,1,245,1,246,351,3,1,3,0,1,0,70.09
屏東縣,萬丹鄉,水泉村,204,1,907,8,915,1270,3,1,3,0,1,0,72.05
屏東縣,萬丹鄉,竹林村,205,1,948,11,959,1368,3,1,3,0,1,0,70.10
屏東縣,萬丹鄉,廣安村,206,1,1165,9,1174,1612,3,1,3,0,1,0,72.83
屏東縣,萬丹鄉,四維村,207,1,1096,3,1099,1496,3,1,3,0,1,0,73.46
屏東縣,萬丹鄉,寶厝村,208,1,1297,16,1313,1807,3,1,3,0,1,0,72.66
屏東縣,萬丹鄉,萬生村,209,1,880,8,888,1194,3,1,3,0,1,0,74.37
屏東縣,萬丹鄉,萬惠村,210,1,567,3,570,697,3,1,3,0,1,0,81.78
屏東縣,萬丹鄉,萬安村,211,1,338,1,339,468,3,1,3,0,1,0,72.44
屏東縣,萬丹鄉,萬後村,212,1,315,2,317,413,3,1,3,0,1,0,76.76
屏東縣,萬丹鄉,萬全村,213,1,1150,12,1162,1612,3,1,3,0,1,0,72.08
屏東縣,萬丹鄉,萬全村,214,1,1046,7,1053,1445,3,1,3,0,1,0,72.87
屏東縣,長治鄉,進興村,215,1,1216,15,1231,1822,3,1,3,0,1,0,67.56
屏東縣,長治鄉,新潭村,216,1,650,3,653,971,3,1,3,0,1,0,67.25
屏東縣,長治鄉,新潭村,217,1,772,10,782,1202,3,1,3,0,1,0,65.06
屏東縣,長治鄉,潭頭村,218,1,995,4,999,1399,3,1,3,0,1,0,71.41
屏東縣,長治鄉,香楊村,219,1,885,8,893,1300,3,1,3,0,1,0,68.69
屏東縣,長治鄉,長興村,220,1,602,6,608,903,3,1,3,0,1,0,67.33
屏東縣,長治鄉,崙上村,221,1,983,5,988,1345,3,1,3,0,1,0,73.46
屏東縣,長治鄉,德榮村,222,1,696,3,699,971,3,1,3,0,1,0,71.99
屏東縣,長治鄉,德和村,223,1,551,8,559,743,3,1,3,0,1,0,75.24
屏東縣,長治鄉,復興村,224,1,930,14,944,1323,3,1,3,0,1,0,71.35
屏東縣,長治鄉,德成村,225,1,589,3,592,818,3,1,3,0,1,0,72.37
屏東縣,長治鄉,德協村,226,1,698,8,706,1015,3,1,3,0,1,0,69.56
屏東縣,長治鄉,繁榮村,227,1,836,7,843,1204,3,1,3,0,1,0,70.02
屏東縣,長治鄉,繁昌村,228,1,1103,11,1114,1535,3,1,3,0,1,0,72.57
屏東縣,長治鄉,繁隆村,229,1,672,6,678,942,3,1,3,0,1,0,71.97
屏東縣,長治鄉,繁華村,230,1,800,10,810,1101,3,1,3,0,1,0,73.57
屏東縣,長治鄉,繁華村,231,1,626,10,636,915,3,1,3,0,1,0,69.51
屏東縣,長治鄉,榮華村,232,1,361,5,366,498,3,1,3,0,1,0,73.49
屏東縣,麟洛鄉,新田村,233,1,1142,7,1149,1585,3,1,3,0,1,0,72.49
屏東縣,麟洛鄉,麟頂村,234,1,549,3,552,730,3,1,3,0,1,0,75.62
屏東縣,麟洛鄉,麟蹄村,235,1,1030,9,1039,1417,3,1,3,0,1,0,73.32
屏東縣,麟洛鄉,麟趾村,236,1,781,11,792,1054,3,1,3,0,1,0,75.14
屏東縣,麟洛鄉,麟趾村,237,1,672,10,682,971,3,1,3,0,1,0,70.24
屏東縣,麟洛鄉,田中村,238,1,745,4,749,975,3,1,3,0,1,0,76.82
屏東縣,麟洛鄉,田心村,239,1,521,5,526,689,3,1,3,0,1,0,76.34
屏東縣,麟洛鄉,田道村,240,1,515,5,520,684,3,1,3,0,1,0,76.02
屏東縣,九如鄉,九清村,241,1,1050,8,1058,1472,3,1,3,0,1,0,71.88
屏東縣,九如鄉,九塊村,242,1,863,7,870,1174,3,1,3,0,1,0,74.11
屏東縣,九如鄉,九明村,243,1,932,16,948,1304,3,1,3,0,1,0,72.70
屏東縣,九如鄉,玉水村,244,1,857,10,867,1161,3,1,3,0,1,0,74.68
屏東縣,九如鄉,玉泉村,245,1,924,16,940,1320,3,1,3,0,1,0,71.21
屏東縣,九如鄉,東寧村,246,1,476,4,480,608,3,1,3,0,1,0,78.95
屏東縣,九如鄉,東寧村,247,1,1044,17,1061,1490,3,1,3,0,1,0,71.21
屏東縣,九如鄉,東寧村,248,1,532,6,538,806,3,1,3,0,1,0,66.75
屏東縣,九如鄉,大坵村,249,1,667,4,671,893,3,1,3,0,1,0,75.14
屏東縣,九如鄉,三塊村,250,1,780,12,792,1121,3,1,3,0,1,0,70.65
屏東縣,九如鄉,後庄村,251,1,1114,7,1121,1504,3,1,3,0,1,0,74.53
屏東縣,九如鄉,耆老村,252,1,801,10,811,1060,3,1,3,0,1,0,76.51
屏東縣,九如鄉,洽興村,253,1,854,6,860,1197,3,1,3,0,1,0,71.85
屏東縣,里港鄉,玉田村,254,1,1150,14,1164,1677,3,1,3,0,1,0,69.41
屏東縣,里港鄉,大平村,255,1,834,3,837,1120,3,1,3,0,1,0,74.73
屏東縣,里港鄉,永春村,256,1,580,4,584,806,3,1,3,0,1,0,72.46
屏東縣,里港鄉,春林村,257,1,763,3,766,1115,3,1,3,0,1,0,68.70
屏東縣,里港鄉,過江村,258,1,994,7,1001,1494,3,1,3,0,1,0,67.00
屏東縣,里港鄉,鐵店村,259,1,746,8,754,1058,3,1,3,0,1,0,71.27
屏東縣,里港鄉,塔樓村,260,1,877,7,884,1259,3,1,3,0,1,0,70.21
屏東縣,里港鄉,潮厝村,261,1,843,12,855,1233,3,1,3,0,1,0,69.34
屏東縣,里港鄉,茄苳村,262,1,296,5,301,410,3,1,3,0,1,0,73.41
屏東縣,里港鄉,茄苳村,263,1,840,5,845,1153,3,1,3,0,1,0,73.29
屏東縣,里港鄉,載興村,264,1,712,6,718,961,3,1,3,0,1,0,74.71
屏東縣,里港鄉,載興村,265,1,864,7,871,1240,3,1,3,0,1,0,70.24
屏東縣,里港鄉,土庫村,266,1,1066,17,1083,1494,3,1,3,0,1,0,72.49
屏東縣,里港鄉,土庫村,267,1,419,7,426,590,3,1,3,0,1,0,72.20
屏東縣,里港鄉,三廍村,268,1,598,3,601,857,3,1,3,0,1,0,70.13
屏東縣,里港鄉,三廍村,269,1,568,8,576,861,3,1,3,0,1,0,66.90
屏東縣,里港鄉,中和村,270,1,523,5,528,763,3,1,3,0,1,0,69.20
屏東縣,里港鄉,瀰力村,271,1,368,5,373,499,3,1,3,0,1,0,74.75
屏東縣,鹽埔鄉,鹽北村,272,1,1163,10,1173,1536,3,1,3,0,1,0,76.37
屏東縣,鹽埔鄉,鹽中村,273,1,1605,22,1627,2154,3,1,3,0,1,0,75.53
屏東縣,鹽埔鄉,鹽南村,274,1,1086,8,1094,1445,3,1,3,0,1,0,75.71
屏東縣,鹽埔鄉,仕絨村,275,1,747,5,752,865,3,1,3,0,1,0,86.94
屏東縣,鹽埔鄉,高朗村,276,1,1860,20,1880,2464,3,1,3,0,1,0,76.30
屏東縣,鹽埔鄉,振興村,277,1,1311,34,1345,1864,3,1,3,0,1,0,72.16
屏東縣,鹽埔鄉,久愛村,278,1,632,7,639,810,3,1,3,0,1,0,78.89
屏東縣,鹽埔鄉,新圍村,279,1,1972,31,2003,2619,3,1,3,0,1,0,76.48
屏東縣,鹽埔鄉,新二村,280,1,1996,28,2024,2778,3,1,3,0,1,0,72.86
屏東縣,鹽埔鄉,彭厝村,281,1,706,2,708,897,3,1,3,0,1,0,78.93
屏東縣,鹽埔鄉,洛陽村,282,1,1025,17,1042,1321,3,1,3,0,1,0,78.88
屏東縣,鹽埔鄉,永隆村,283,1,436,11,447,591,3,1,3,0,1,0,75.63
屏東縣,高樹鄉,高樹村,284,1,760,5,765,1188,3,1,3,0,1,0,64.39
屏東縣,高樹鄉,高樹村,285,1,631,2,633,972,3,1,3,0,1,0,65.12
屏東縣,高樹鄉,長榮村,286,1,862,3,865,1336,3,1,3,0,1,0,64.75
屏東縣,高樹鄉,東興村,287,1,560,2,562,864,3,1,3,0,1,0,65.05
屏東縣,高樹鄉,東振村,288,1,414,4,418,686,3,1,3,0,1,0,60.93
屏東縣,高樹鄉,源泉村,289,1,641,4,645,950,3,1,3,0,1,0,67.89
屏東縣,高樹鄉,建興村,290,1,730,4,734,1224,3,1,3,0,1,0,59.97
屏東縣,高樹鄉,大埔村,291,1,463,8,471,749,3,1,3,0,1,0,62.88
屏東縣,高樹鄉,菜寮村,292,1,560,6,566,904,3,1,3,0,1,0,62.61
屏東縣,高樹鄉,司馬村,293,1,494,6,500,747,3,1,3,0,1,0,66.93
屏東縣,高樹鄉,舊寮村,294,1,898,6,904,1366,3,1,3,0,1,0,66.18
屏東縣,高樹鄉,新豐村,295,1,905,15,920,1550,3,1,3,0,1,0,59.35
屏東縣,高樹鄉,泰山村,296,1,1203,16,1219,1997,3,1,3,0,1,0,61.04
屏東縣,高樹鄉,南華村,297,1,815,8,823,1228,3,1,3,0,1,0,67.02
屏東縣,高樹鄉,廣福村,298,1,612,3,615,995,3,1,3,0,1,0,61.81
屏東縣,高樹鄉,廣興村,299,1,709,11,720,1032,3,1,3,0,1,0,69.77
屏東縣,高樹鄉,舊庄村,300,1,696,9,705,1027,3,1,3,0,1,0,68.65
屏東縣,高樹鄉,田子村,301,1,827,7,834,1144,3,1,3,0,1,0,72.90
屏東縣,高樹鄉,鹽樹村,302,1,469,8,477,722,3,1,3,0,1,0,66.07
屏東縣,高樹鄉,鹽樹村,303,1,430,6,436,675,3,1,3,0,1,0,64.59
屏東縣,高樹鄉,新南村,304,1,947,6,953,1402,3,1,3,0,1,0,67.97
屏東縣,萬巒鄉,萬巒村,305,1,864,3,867,1226,3,1,3,0,1,0,70.72
屏東縣,萬巒鄉,萬全村,306,1,572,4,576,817,3,1,3,0,1,0,70.50
屏東縣,萬巒鄉,萬和村,307,1,878,10,888,1365,3,1,3,0,1,0,65.05
屏東縣,萬巒鄉,鹿寮村,308,1,682,8,690,929,3,1,3,0,1,0,74.27
屏東縣,萬巒鄉,硫黃村,309,1,395,1,396,532,3,1,3,0,1,0,74.44
屏東縣,萬巒鄉,泗溝村,310,1,903,10,913,1305,3,1,3,0,1,0,69.96
屏東縣,萬巒鄉,五溝村,311,1,903,6,909,1162,3,1,3,0,1,0,78.23
屏東縣,萬巒鄉,成德村,312,1,901,12,913,1371,3,1,3,0,1,0,66.59
屏東縣,萬巒鄉,赤山村,313,1,934,20,954,1645,3,1,3,0,1,0,57.99
屏東縣,萬巒鄉,萬金村,314,1,1210,20,1230,1873,3,1,3,0,1,0,65.67
屏東縣,萬巒鄉,佳佐村,315,1,988,12,1000,1510,3,1,3,0,1,0,66.23
屏東縣,萬巒鄉,佳和村,316,1,1036,6,1042,1461,3,1,3,0,1,0,71.32
屏東縣,萬巒鄉,新厝村,317,1,668,8,676,1052,3,1,3,0,1,0,64.26
屏東縣,萬巒鄉,新置村,318,1,344,3,347,611,3,1,3,0,1,0,56.79
屏東縣,萬巒鄉,新置村,319,1,329,1,330,608,3,1,3,0,1,0,54.28
屏東縣,內埔鄉,內埔村,320,1,852,6,858,1304,3,1,3,0,1,0,65.80
屏東縣,內埔鄉,內埔村,321,1,1045,11,1056,1627,3,1,3,0,1,0,64.90
屏東縣,內埔鄉,內田村,322,1,774,4,778,1287,3,1,3,0,1,0,60.45
屏東縣,內埔鄉,內田村,323,1,825,11,836,1342,3,1,3,0,1,0,62.30
屏東縣,內埔鄉,興南村,324,1,981,5,986,1343,3,1,3,0,1,0,73.42
屏東縣,內埔鄉,義亭村,325,1,380,5,385,568,3,1,3,0,1,0,67.78
屏東縣,內埔鄉,美和村,326,1,641,5,646,949,3,1,3,0,1,0,68.07
屏東縣,內埔鄉,美和村,327,1,645,7,652,924,3,1,3,0,1,0,70.56
屏東縣,內埔鄉,和興村,328,1,1101,10,1111,1613,3,1,3,0,1,0,68.88
屏東縣,內埔鄉,東寧村,329,1,663,3,666,966,3,1,3,0,1,0,68.94
屏東縣,內埔鄉,東寧村,330,1,777,5,782,1220,3,1,3,0,1,0,64.10
屏東縣,內埔鄉,東寧村,331,1,931,6,937,1445,3,1,3,0,1,0,64.84
屏東縣,內埔鄉,豐田村,332,1,868,11,879,1445,3,1,3,0,1,0,60.83
屏東縣,內埔鄉,豐田村,333,1,470,7,477,763,3,1,3,0,1,0,62.52
屏東縣,內埔鄉,振豐村,334,1,1142,12,1154,1673,3,1,3,0,1,0,68.98
屏東縣,內埔鄉,富田村,335,1,582,2,584,886,3,1,3,0,1,0,65.91
屏東縣,內埔鄉,富田村,336,1,699,6,705,1027,3,1,3,0,1,0,68.65
屏東縣,內埔鄉,竹圍村,337,1,800,11,811,1344,3,1,3,0,1,0,60.34
屏東縣,內埔鄉,東勢村,338,1,857,8,865,1220,3,1,3,0,1,0,70.90
屏東縣,內埔鄉,東勢村,339,1,1148,14,1162,1690,3,1,3,0,1,0,68.76
屏東縣,內埔鄉,東片村,340,1,631,4,635,883,3,1,3,0,1,0,71.91
屏東縣,內埔鄉,上樹村,341,1,672,8,680,970,3,1,3,0,1,0,70.10
屏東縣,內埔鄉,老埤村,342,1,607,3,610,1098,3,1,3,0,1,0,55.56
屏東縣,內埔鄉,老埤村,343,1,666,8,674,1177,3,1,3,0,1,0,57.26
屏東縣,內埔鄉,中林村,344,1,839,11,850,1331,3,1,3,0,1,0,63.86
屏東縣,內埔鄉,龍泉村,345,1,889,14,903,1317,3,1,3,0,1,0,68.56
屏東縣,內埔鄉,龍泉村,346,1,743,10,753,1175,3,1,3,0,1,0,64.09
屏東縣,內埔鄉,龍潭村,347,1,171,4,175,242,3,1,3,0,1,0,72.31
屏東縣,內埔鄉,龍潭村,348,1,896,11,907,1371,3,1,3,0,1,0,66.16
屏東縣,內埔鄉,龍潭村,349,1,629,7,636,952,3,1,3,0,1,0,66.81
屏東縣,內埔鄉,建興村,350,1,443,7,450,664,3,1,3,0,1,0,67.77
屏東縣,內埔鄉,建興村,351,1,387,5,392,540,3,1,3,0,1,0,72.59
屏東縣,內埔鄉,建興村,352,1,817,15,832,1124,3,1,3,0,1,0,74.02
屏東縣,內埔鄉,大新村,353,1,1137,16,1153,1689,3,1,3,0,1,0,68.27
屏東縣,內埔鄉,黎明村,354,1,738,7,745,1091,3,1,3,0,1,0,68.29
屏東縣,內埔鄉,黎明村,355,1,714,12,726,1015,3,1,3,0,1,0,71.53
屏東縣,內埔鄉,隘寮村,356,1,713,9,722,1191,3,1,3,0,1,0,60.62
屏東縣,內埔鄉,水門村,357,1,484,4,488,784,3,1,3,0,1,0,62.24
屏東縣,竹田鄉,竹田村,358,1,942,10,952,1402,3,1,3,0,1,0,67.90
屏東縣,竹田鄉,竹南村,359,1,578,8,586,856,3,1,3,0,1,0,68.46
屏東縣,竹田鄉,糶糴村,360,1,488,1,489,656,3,1,3,0,1,0,74.54
屏東縣,竹田鄉,履豐村,361,1,431,6,437,580,3,1,3,0,1,0,75.34
屏東縣,竹田鄉,頭崙村,362,1,901,10,911,1294,3,1,3,0,1,0,70.40
屏東縣,竹田鄉,二崙村,363,1,652,1,653,965,3,1,3,0,1,0,67.67
屏東縣,竹田鄉,美崙村,364,1,422,4,426,626,3,1,3,0,1,0,68.05
屏東縣,竹田鄉,南勢村,365,1,339,2,341,461,3,1,3,0,1,0,73.97
屏東縣,竹田鄉,西勢村,366,1,950,12,962,1342,3,1,3,0,1,0,71.68
屏東縣,竹田鄉,西勢村,367,1,880,4,884,1238,3,1,3,0,1,0,71.41
屏東縣,竹田鄉,福田村,368,1,324,1,325,426,3,1,3,0,1,0,76.29
屏東縣,竹田鄉,永豐村,369,1,377,3,380,526,3,1,3,0,1,0,72.24
屏東縣,竹田鄉,六巷村,370,1,455,8,463,641,3,1,3,0,1,0,72.23
屏東縣,竹田鄉,泗洲村,371,1,734,11,745,1145,3,1,3,0,1,0,65.07
屏東縣,竹田鄉,大湖村,372,1,723,6,729,1066,3,1,3,0,1,0,68.39
屏東縣,竹田鄉,鳳明村,373,1,691,9,700,933,3,1,3,0,1,0,75.03
屏東縣,新埤鄉,新埤村,374,1,1252,9,1261,1916,3,1,3,0,1,0,65.81
屏東縣,新埤鄉,建功村,375,1,829,3,832,1253,3,1,3,0,1,0,66.40
屏東縣,新埤鄉,打鐵村,376,1,710,5,715,1086,3,1,3,0,1,0,65.84
屏東縣,新埤鄉,南豐村,377,1,516,5,521,793,3,1,3,0,1,0,65.70
屏東縣,新埤鄉,萬隆村,378,1,599,11,610,1031,3,1,3,0,1,0,59.17
屏東縣,新埤鄉,萬隆村,379,1,465,4,469,645,3,1,3,0,1,0,72.71
屏東縣,新埤鄉,餉潭村,380,1,773,8,781,1306,3,1,3,0,1,0,59.80
屏東縣,新埤鄉,箕湖村,381,1,331,4,335,528,3,1,3,0,1,0,63.45
屏東縣,新埤鄉,箕湖村,382,1,337,9,346,525,3,1,3,0,1,0,65.90
屏東縣,枋寮鄉,枋寮村,383,1,916,6,922,1415,3,1,3,0,1,0,65.16
屏東縣,枋寮鄉,新龍村,384,1,550,5,555,816,3,1,3,0,1,0,68.01
屏東縣,枋寮鄉,保生村,385,1,685,6,691,1011,3,1,3,0,1,0,68.35
屏東縣,枋寮鄉,中寮村,386,1,473,3,476,752,3,1,3,0,1,0,63.30
屏東縣,枋寮鄉,安樂村,387,1,1166,16,1182,1832,3,1,3,0,1,0,64.52
屏東縣,枋寮鄉,隆山村,388,1,1180,8,1188,1898,3,1,3,0,1,0,62.59
屏東縣,枋寮鄉,隆山村,389,1,809,6,815,1396,3,1,3,0,1,0,58.38
屏東縣,枋寮鄉,天時村,390,1,1301,8,1309,1908,3,1,3,0,1,0,68.61
屏東縣,枋寮鄉,地利村,391,1,1101,9,1110,1712,3,1,3,0,1,0,64.84
屏東縣,枋寮鄉,人和村,392,1,701,7,708,1093,3,1,3,0,1,0,64.78
屏東縣,枋寮鄉,人和村,393,1,702,3,705,1117,3,1,3,0,1,0,63.12
屏東縣,枋寮鄉,內寮村,394,1,428,1,429,804,3,1,3,0,1,0,53.36
屏東縣,枋寮鄉,新開村,395,1,543,3,546,1044,3,1,3,0,1,0,52.30
屏東縣,枋寮鄉,東海村,396,1,723,11,734,1106,3,1,3,0,1,0,66.37
屏東縣,枋寮鄉,東海村,397,1,958,9,967,1484,3,1,3,0,1,0,65.16
屏東縣,枋寮鄉,大庄村,398,1,389,0,389,555,3,1,3,0,1,0,70.09
屏東縣,枋寮鄉,太源村,399,1,533,8,541,925,3,1,3,0,1,0,58.49
屏東縣,枋寮鄉,玉泉村,400,1,255,4,259,436,3,1,3,0,1,0,59.40
屏東縣,新園鄉,瓦窯村,401,1,1071,5,1076,1505,3,1,3,0,1,0,71.50
屏東縣,新園鄉,仙吉村,402,1,662,7,669,968,3,1,3,0,1,0,69.11
屏東縣,新園鄉,仙吉村,403,1,809,5,814,1173,3,1,3,0,1,0,69.39
屏東縣,新園鄉,田洋村,404,1,1293,12,1305,1858,3,1,3,0,1,0,70.24
屏東縣,新園鄉,港墘村,405,1,467,6,473,648,3,1,3,0,1,0,72.99
屏東縣,新園鄉,內庄村,406,1,588,3,591,752,3,1,3,0,1,0,78.59
屏東縣,新園鄉,新東村,407,1,831,13,844,1191,3,1,3,0,1,0,70.86
屏東縣,新園鄉,新東村,408,1,708,3,711,951,3,1,3,0,1,0,74.76
屏東縣,新園鄉,新園村,409,1,1380,11,1391,1909,3,1,3,0,1,0,72.87
屏東縣,新園鄉,港西村,410,1,832,9,841,1056,3,1,3,0,1,0,79.64
屏東縣,新園鄉,港西村,411,1,793,6,799,1048,3,1,3,0,1,0,76.24
屏東縣,新園鄉,五房村,412,1,1145,9,1154,1669,3,1,3,0,1,0,69.14
屏東縣,新園鄉,五房村,413,1,681,8,689,1054,3,1,3,0,1,0,65.37
屏東縣,新園鄉,烏龍村,414,1,882,9,891,1211,3,1,3,0,1,0,73.58
屏東縣,新園鄉,興龍村,415,1,1348,10,1358,1967,3,1,3,0,1,0,69.04
屏東縣,新園鄉,中洲村,416,1,1054,8,1062,1602,3,1,3,0,1,0,66.29
屏東縣,新園鄉,南龍村,417,1,916,9,925,1308,3,1,3,0,1,0,70.72
屏東縣,新園鄉,鹽埔村,418,1,1176,9,1185,1906,3,1,3,0,1,0,62.17
屏東縣,新園鄉,鹽埔村,419,1,956,8,964,1620,3,1,3,0,1,0,59.51
屏東縣,新園鄉,共和村,420,1,646,4,650,1029,3,1,3,0,1,0,63.17
屏東縣,新園鄉,共和村,421,1,648,8,656,1091,3,1,3,0,1,0,60.13
屏東縣,崁頂鄉,崁頂村,422,1,1213,12,1225,1722,3,1,3,0,1,0,71.14
屏東縣,崁頂鄉,園寮村,423,1,909,9,918,1385,3,1,3,0,1,0,66.28
屏東縣,崁頂鄉,力社村,424,1,675,7,682,969,3,1,3,0,1,0,70.38
屏東縣,崁頂鄉,圍內村,425,1,783,5,788,1011,3,1,3,0,1,0,77.94
屏東縣,崁頂鄉,洲子村,426,1,591,7,598,798,3,1,3,0,1,0,74.94
屏東縣,崁頂鄉,北勢村,427,1,983,12,995,1407,3,1,3,0,1,0,70.72
屏東縣,崁頂鄉,越溪村,428,1,467,9,476,655,3,1,3,0,1,0,72.67
屏東縣,崁頂鄉,港東村,429,1,1104,11,1115,1624,3,1,3,0,1,0,68.66
屏東縣,林邊鄉,林邊村,430,1,996,10,1006,1380,3,1,3,0,1,0,72.90
屏東縣,林邊鄉,光林村,431,1,1120,7,1127,1617,3,1,3,0,1,0,69.70
屏東縣,林邊鄉,中林村,432,1,665,6,671,897,3,1,3,0,1,0,74.80
屏東縣,林邊鄉,仁和村,433,1,1063,7,1070,1473,3,1,3,0,1,0,72.64
屏東縣,林邊鄉,永樂村,434,1,1031,12,1043,1412,3,1,3,0,1,0,73.87
屏東縣,林邊鄉,永樂村,435,1,1097,9,1106,1549,3,1,3,0,1,0,71.40
屏東縣,林邊鄉,田厝村,436,1,628,4,632,889,3,1,3,0,1,0,71.09
屏東縣,林邊鄉,崎峰村,437,1,825,5,830,1266,3,1,3,0,1,0,65.56
屏東縣,林邊鄉,水利村,438,1,1131,14,1145,1737,3,1,3,0,1,0,65.92
屏東縣,林邊鄉,竹林村,439,1,1088,9,1097,1542,3,1,3,0,1,0,71.14
屏東縣,林邊鄉,竹林村,440,1,915,8,923,1300,3,1,3,0,1,0,71.00
屏東縣,林邊鄉,鎮安村,441,1,807,5,812,1155,3,1,3,0,1,0,70.30
屏東縣,南州鄉,溪洲村,442,1,1228,14,1242,1724,3,1,3,0,1,0,72.04
屏東縣,南州鄉,溪南村,443,1,703,7,710,992,3,1,3,0,1,0,71.57
屏東縣,南州鄉,仁里村,444,1,423,3,426,607,3,1,3,0,1,0,70.18
屏東縣,南州鄉,溪北村,445,1,554,5,559,756,3,1,3,0,1,0,73.94
屏東縣,南州鄉,七塊村,446,1,679,4,683,1042,3,1,3,0,1,0,65.55
屏東縣,南州鄉,萬華村,447,1,707,8,715,998,3,1,3,0,1,0,71.64
屏東縣,南州鄉,米崙村,448,1,746,7,753,1068,3,1,3,0,1,0,70.51
屏東縣,南州鄉,壽元村,449,1,758,7,765,1085,3,1,3,0,1,0,70.51
屏東縣,南州鄉,同安村,450,1,589,5,594,873,3,1,3,0,1,0,68.04
屏東縣,南州鄉,南安村,451,1,408,5,413,608,3,1,3,0,1,0,67.93
屏東縣,佳冬鄉,佳冬村,452,1,1049,10,1059,1508,3,1,3,0,1,0,70.23
屏東縣,佳冬鄉,六根村,453,1,1270,14,1284,1789,3,1,3,0,1,0,71.77
屏東縣,佳冬鄉,賴家村,454,1,678,9,687,1001,3,1,3,0,1,0,68.63
屏東縣,佳冬鄉,萬建村,455,1,1060,9,1069,1687,3,1,3,0,1,0,63.37
屏東縣,佳冬鄉,石光村,456,1,1210,13,1223,1827,3,1,3,0,1,0,66.94
屏東縣,佳冬鄉,玉光村,457,1,1408,15,1423,2211,3,1,3,0,1,0,64.36
屏東縣,佳冬鄉,昌隆村,458,1,799,4,803,1173,3,1,3,0,1,0,68.46
屏東縣,佳冬鄉,豐隆村,459,1,582,8,590,895,3,1,3,0,1,0,65.92
屏東縣,佳冬鄉,大同村,460,1,880,3,883,1204,3,1,3,0,1,0,73.34
屏東縣,佳冬鄉,羌園村,461,1,692,4,696,943,3,1,3,0,1,0,73.81
屏東縣,佳冬鄉,燄溫村,462,1,749,13,762,1089,3,1,3,0,1,0,69.97
屏東縣,佳冬鄉,塭豐村,463,1,1408,17,1425,2090,3,1,3,0,1,0,68.18
屏東縣,琉球鄉,本福村,464,1,885,10,895,1629,3,1,3,0,1,0,54.94
屏東縣,琉球鄉,中福村,465,1,543,11,554,949,3,1,3,0,1,0,58.38
屏東縣,琉球鄉,漁福村,466,1,425,6,431,762,3,1,3,0,1,0,56.56
屏東縣,琉球鄉,大福村,467,1,662,3,665,1332,3,1,3,0,1,0,49.92
屏東縣,琉球鄉,南福村,468,1,472,6,478,1023,3,1,3,0,1,0,46.73
屏東縣,琉球鄉,天福村,469,1,453,6,459,942,3,1,3,0,1,0,48.73
屏東縣,琉球鄉,上福村,470,1,610,7,617,1197,3,1,3,0,1,0,51.55
屏東縣,琉球鄉,杉福村,471,1,330,4,334,675,3,1,3,0,1,0,49.48
屏東縣,車城鄉,福興村,472,1,861,11,872,1369,3,1,3,0,1,0,63.70
屏東縣,車城鄉,福安村,473,1,363,0,363,576,3,1,3,0,1,0,63.02
屏東縣,車城鄉,田中村,474,1,426,2,428,798,3,1,3,0,1,0,53.63
屏東縣,車城鄉,海口村,475,1,472,4,476,849,3,1,3,0,1,0,56.07
屏東縣,車城鄉,統埔村,476,1,253,3,256,450,3,1,3,0,1,0,56.89
屏東縣,車城鄉,溫泉村,477,1,589,13,602,1078,3,1,3,0,1,0,55.84
屏東縣,車城鄉,保力村,478,1,775,7,782,1484,3,1,3,0,1,0,52.70
屏東縣,車城鄉,新街村,479,1,276,4,280,438,3,1,3,0,1,0,63.93
屏東縣,車城鄉,埔墘村,480,1,257,4,261,448,3,1,3,0,1,0,58.26
屏東縣,車城鄉,射寮村,481,1,307,3,310,534,3,1,3,0,1,0,58.05
屏東縣,車城鄉,後灣村,482,1,292,7,299,538,3,1,3,0,1,0,55.58
屏東縣,滿州鄉,滿州村,483,1,793,9,802,1391,3,1,3,0,1,0,57.66
屏東縣,滿州鄉,里德村,484,1,126,2,128,260,3,1,3,0,1,0,49.23
屏東縣,滿州鄉,永靖村,485,1,608,4,612,1123,3,1,3,0,1,0,54.50
屏東縣,滿州鄉,港口村,486,1,597,6,603,1043,3,1,3,0,1,0,57.81
屏東縣,滿州鄉,響林村,487,1,240,1,241,452,3,1,3,0,1,0,53.32
屏東縣,滿州鄉,長樂村,488,1,340,9,349,683,3,1,3,0,1,0,51.10
屏東縣,滿州鄉,九棚村,489,1,127,1,128,239,3,1,3,0,1,0,53.56
屏東縣,滿州鄉,港仔村,490,1,176,3,179,296,3,1,3,0,1,0,60.47
屏東縣,枋山鄉,枋山村,491,1,643,6,649,1042,3,1,3,0,1,0,62.28
屏東縣,枋山鄉,加祿村,492,1,555,5,560,838,3,1,3,0,1,0,66.83
屏東縣,枋山鄉,加祿村,493,1,606,7,613,931,3,1,3,0,1,0,65.84
屏東縣,枋山鄉,楓港村,494,1,593,7,600,1164,3,1,3,0,1,0,51.55
屏東縣,枋山鄉,善餘村,495,1,493,7,500,1030,3,1,3,0,1,0,48.54
屏東縣,三地門鄉,三地村,496,1,70,1,71,112,3,1,3,0,1,0,63.39
屏東縣,三地門鄉,賽嘉村,497,1,19,1,20,37,3,1,3,0,1,0,54.05
屏東縣,三地門鄉,口社村,498,1,28,0,28,48,3,1,3,0,1,0,58.33
屏東縣,三地門鄉,馬兒村,499,1,2,0,2,5,3,1,3,0,1,0,40.00
屏東縣,三地門鄉,安坡村,500,1,21,0,21,38,3,1,3,0,1,0,55.26
屏東縣,三地門鄉,青山村,501,1,28,1,29,46,3,1,3,0,1,0,63.04
屏東縣,三地門鄉,青葉村,502,1,21,0,21,39,3,1,3,0,1,0,53.85
屏東縣,三地門鄉,達來村,503,1,8,0,8,14,3,1,3,0,1,0,57.14
屏東縣,三地門鄉,德文村,504,1,6,0,6,11,3,1,3,0,1,0,54.55
屏東縣,三地門鄉,大社村,505,1,5,0,5,22,3,1,3,0,1,0,22.73
屏東縣,霧台鄉,霧台村,506,1,7,0,7,16,3,1,3,0,1,0,43.75
屏東縣,霧台鄉,霧台村,507,1,5,0,5,7,3,1,3,0,1,0,71.43
屏東縣,霧台鄉,霧台村,508,1,2,0,2,2,3,1,3,0,1,0,100.00
屏東縣,霧台鄉,好茶村,509,1,4,0,4,5,3,1,3,0,1,0,80.00
屏東縣,霧台鄉,阿禮村,510,1,2,0,2,4,3,1,3,0,1,0,50.00
屏東縣,霧台鄉,吉露村,511,1,2,0,2,5,3,1,3,0,1,0,40.00
屏東縣,霧台鄉,大武村,512,1,4,0,4,8,3,1,3,0,1,0,50.00
屏東縣,霧台鄉,佳暮村,513,1,2,0,2,4,3,1,3,0,1,0,50.00
屏東縣,瑪家鄉,瑪家村,514,1,5,1,6,12,3,1,3,0,1,0,50.00
屏東縣,瑪家鄉,北葉村,515,1,57,0,57,87,3,1,3,0,1,0,65.52
屏東縣,瑪家鄉,涼山村,516,1,33,1,34,46,3,1,3,0,1,0,73.91
屏東縣,瑪家鄉,佳義村,517,1,31,1,32,51,3,1,3,0,1,0,62.75
屏東縣,瑪家鄉,排灣村,518,1,8,0,8,17,3,1,3,0,1,0,47.06
屏東縣,瑪家鄉,三和村,519,1,27,0,27,44,3,1,3,0,1,0,61.36
屏東縣,瑪家鄉,三和村,520,1,31,0,31,48,3,1,3,0,1,0,64.58
屏東縣,瑪家鄉,三和村,521,1,29,1,30,57,3,1,3,0,1,0,52.63
屏東縣,泰武鄉,佳平村,522,1,19,0,19,34,3,1,3,0,1,0,55.88
屏東縣,泰武鄉,佳平村,523,1,6,0,6,13,3,1,3,0,1,0,46.15
屏東縣,泰武鄉,武潭村,524,1,16,0,16,36,3,1,3,0,1,0,44.44
屏東縣,泰武鄉,平和村,525,1,17,0,17,33,3,1,3,0,1,0,51.52
屏東縣,泰武鄉,佳興村,526,1,6,0,6,14,3,1,3,0,1,0,42.86
屏東縣,泰武鄉,泰武村,527,1,1,0,1,6,3,1,3,0,1,0,16.67
屏東縣,泰武鄉,萬安村,528,1,18,0,18,33,3,1,3,0,1,0,54.55
屏東縣,來義鄉,來義村,529,1,17,3,20,39,3,1,3,0,1,0,51.28
屏東縣,來義鄉,義林村,530,1,15,0,15,27,3,1,3,0,1,0,55.56
屏東縣,來義鄉,義林村,531,1,8,0,8,12,3,1,3,0,1,0,66.67
屏東縣,來義鄉,丹林村,532,1,16,0,16,25,3,1,3,0,1,0,64.00
屏東縣,來義鄉,丹林村,533,1,32,1,33,49,3,1,3,0,1,0,67.35
屏東縣,來義鄉,古樓村,534,1,53,0,53,106,3,1,3,0,1,0,50.00
屏東縣,來義鄉,文樂村,535,1,30,1,31,46,3,1,3,0,1,0,67.39
屏東縣,來義鄉,望嘉村,536,1,44,1,45,57,3,1,3,0,1,0,78.95
屏東縣,來義鄉,南和村,537,1,35,1,36,70,3,1,3,0,1,0,51.43
屏東縣,春日鄉,春日村,538,1,36,0,36,68,3,1,3,0,1,0,52.94
屏東縣,春日鄉,古華村,539,1,32,1,33,59,3,1,3,0,1,0,55.93
屏東縣,春日鄉,士文村,540,1,6,0,6,9,3,1,3,0,1,0,66.67
屏東縣,春日鄉,歸崇村,541,1,95,0,95,153,3,1,3,0,1,0,62.09
屏東縣,春日鄉,七佳村,542,1,76,2,78,124,3,1,3,0,1,0,62.90
屏東縣,春日鄉,力里村,543,1,14,0,14,20,3,1,3,0,1,0,70.00
屏東縣,獅子鄉,南世村,544,1,9,0,9,14,3,1,3,0,1,0,64.29
屏東縣,獅子鄉,內獅村,545,1,22,0,22,38,3,1,3,0,1,0,57.89
屏東縣,獅子鄉,獅子村,546,1,9,0,9,14,3,1,3,0,1,0,64.29
屏東縣,獅子鄉,竹坑村,547,1,18,0,18,29,3,1,3,0,1,0,62.07
屏東縣,獅子鄉,楓林村,548,1,30,0,30,45,3,1,3,0,1,0,66.67
屏東縣,獅子鄉,丹路村,549,1,32,0,32,72,3,1,3,0,1,0,44.44
屏東縣,獅子鄉,草埔村,550,1,34,0,34,58,3,1,3,0,1,0,58.62
屏東縣,獅子鄉,內文村,551,1,11,0,11,22,3,1,3,0,1,0,50.00
屏東縣,牡丹鄉,石門村,552,1,112,2,114,176,3,1,3,0,1,0,64.77
屏東縣,牡丹鄉,牡丹村,553,1,36,0,36,64,3,1,3,0,1,0,56.25
屏東縣,牡丹鄉,東源村,554,1,8,0,8,19,3,1,3,0,1,0,42.11
屏東縣,牡丹鄉,旭海村,555,1,48,1,49,91,3,1,3,0,1,0,53.85
屏東縣,牡丹鄉,高士村,556,1,15,0,15,24,3,1,3,0,1,0,62.50
屏東縣,牡丹鄉,四林村,557,1,16,1,17,27,3,1,3,0,1,0,62.96
臺東縣,台東市,文化里,1,1,854,15,869,1397,3,1,3,0,1,0,62.20
臺東縣,台東市,民族里,2,1,616,5,621,933,3,1,3,0,1,0,66.56
臺東縣,台東市,民族里,3,1,628,10,638,967,3,1,3,0,1,0,65.98
臺東縣,台東市,自強里,4,1,946,10,956,1480,3,1,3,0,1,0,64.59
臺東縣,台東市,自強里,5,1,1012,5,1017,1623,3,1,3,0,1,0,62.66
臺東縣,台東市,民生里,6,1,784,18,802,1359,3,1,3,0,1,0,59.01
臺東縣,台東市,民生里,7,1,719,4,723,1179,3,1,3,0,1,0,61.32
臺東縣,台東市,寶桑里,8,1,432,7,439,717,3,1,3,0,1,0,61.23
臺東縣,台東市,民權里,9,1,681,5,686,1117,3,1,3,0,1,0,61.41
臺東縣,台東市,四維里,10,1,248,1,249,444,3,1,3,0,1,0,56.08
臺東縣,台東市,中華里,11,1,597,7,604,945,3,1,3,0,1,0,63.92
臺東縣,台東市,中華里,12,1,460,1,461,805,3,1,3,0,1,0,57.27
臺東縣,台東市,仁愛里,13,1,484,9,493,797,3,1,3,0,1,0,61.86
臺東縣,台東市,強國里,14,1,422,2,424,677,3,1,3,0,1,0,62.63
臺東縣,台東市,大同里,15,1,458,11,469,770,3,1,3,0,1,0,60.91
臺東縣,台東市,成功里,16,1,563,9,572,991,3,1,3,0,1,0,57.72
臺東縣,台東市,建國里,17,1,885,17,902,1514,3,1,3,0,1,0,59.58
臺東縣,台東市,中正里,18,1,544,3,547,889,3,1,3,0,1,0,61.53
臺東縣,台東市,中山里,19,1,702,7,709,1116,3,1,3,0,1,0,63.53
臺東縣,台東市,興國里,20,1,523,3,526,823,3,1,3,0,1,0,63.91
臺東縣,台東市,鐵花里,21,1,283,1,284,489,3,1,3,0,1,0,58.08
臺東縣,台東市,東海里,22,1,479,2,481,815,3,1,3,0,1,0,59.02
臺東縣,台東市,東海里,23,1,758,18,776,1247,3,1,3,0,1,0,62.23
臺東縣,台東市,復國里,24,1,453,13,466,790,3,1,3,0,1,0,58.99
臺東縣,台東市,復興里,25,1,311,4,315,585,3,1,3,0,1,0,53.85
臺東縣,台東市,新興里,26,1,737,13,750,1247,3,1,3,0,1,0,60.14
臺東縣,台東市,新生里,27,1,585,5,590,979,3,1,3,0,1,0,60.27
臺東縣,台東市,新生里,28,1,830,7,837,1365,3,1,3,0,1,0,61.32
臺東縣,台東市,新生里,29,1,728,15,743,1284,3,1,3,0,1,0,57.87
臺東縣,台東市,中心里,30,1,529,9,538,848,3,1,3,0,1,0,63.44
臺東縣,台東市,中心里,31,1,625,12,637,1052,3,1,3,0,1,0,60.55
臺東縣,台東市,馬蘭里,32,1,681,2,683,1114,3,1,3,0,1,0,61.31
臺東縣,台東市,馬蘭里,33,1,723,6,729,1099,3,1,3,0,1,0,66.33
臺東縣,台東市,馬蘭里,34,1,680,10,690,1100,3,1,3,0,1,0,62.73
臺東縣,台東市,光明里,35,1,446,6,452,788,3,1,3,0,1,0,57.36
臺東縣,台東市,豐年里,36,1,284,6,290,471,3,1,3,0,1,0,61.57
臺東縣,台東市,豐年里,37,1,616,12,628,1120,3,1,3,0,1,0,56.07
臺東縣,台東市,豐樂里,38,1,453,12,465,782,3,1,3,0,1,0,59.46
臺東縣,台東市,永樂里,39,1,506,13,519,786,3,1,3,0,1,0,66.03
臺東縣,台東市,康樂里,40,1,551,9,560,941,3,1,3,0,1,0,59.51
臺東縣,台東市,豐榮里,41,1,840,10,850,1477,3,1,3,0,1,0,57.55
臺東縣,台東市,豐榮里,42,1,834,10,844,1533,3,1,3,0,1,0,55.06
臺東縣,台東市,豐榮里,43,1,869,15,884,1533,3,1,3,0,1,0,57.66
臺東縣,台東市,豐榮里,44,1,565,8,573,1072,3,1,3,0,1,0,53.45
臺東縣,台東市,豐谷里,45,1,941,14,955,1623,3,1,3,0,1,0,58.84
臺東縣,台東市,豐里里,46,1,823,10,833,1376,3,1,3,0,1,0,60.54
臺東縣,台東市,豐原里,47,1,561,13,574,973,3,1,3,0,1,0,58.99
臺東縣,台東市,富岡里,48,1,635,11,646,1101,3,1,3,0,1,0,58.67
臺東縣,台東市,富豐里,49,1,248,5,253,478,3,1,3,0,1,0,52.93
臺東縣,台東市,南榮里,50,1,726,38,764,1081,3,1,3,0,1,0,70.68
臺東縣,台東市,南榮里,51,1,282,7,289,464,3,1,3,0,1,0,62.28
臺東縣,台東市,南榮里,52,1,136,0,136,240,3,1,3,0,1,0,56.67
臺東縣,台東市,岩灣里,53,1,523,6,529,1061,3,1,3,0,1,0,49.86
臺東縣,台東市,卑南里,54,1,949,10,959,1390,3,1,3,0,1,0,68.99
臺東縣,台東市,南王里,55,1,468,5,473,786,3,1,3,0,1,0,60.18
臺東縣,台東市,南王里,56,1,302,2,304,554,3,1,3,0,1,0,54.87
臺東縣,台東市,豐田里,57,1,527,4,531,904,3,1,3,0,1,0,58.74
臺東縣,台東市,豐田里,58,1,510,8,518,834,3,1,3,0,1,0,62.11
臺東縣,台東市,新園里,59,1,662,4,666,1063,3,1,3,0,1,0,62.65
臺東縣,台東市,建和里,60,1,516,7,523,973,3,1,3,0,1,0,53.75
臺東縣,台東市,建興里,61,1,468,4,472,832,3,1,3,0,1,0,56.73
臺東縣,台東市,建業里,62,1,496,3,499,899,3,1,3,0,1,0,55.51
臺東縣,台東市,知本里,63,1,458,5,463,844,3,1,3,0,1,0,54.86
臺東縣,台東市,建農里,64,1,640,24,664,1155,3,1,3,0,1,0,57.49
臺東縣,成功鎮,信義里,65,1,132,1,133,230,3,1,3,0,1,0,57.83
臺東縣,成功鎮,信義里,66,1,104,2,106,193,3,1,3,0,1,0,54.92
臺東縣,成功鎮,信義里,67,1,51,0,51,91,3,1,3,0,1,0,56.04
臺東縣,成功鎮,和平里,68,1,110,1,111,204,3,1,3,0,1,0,54.41
臺東縣,成功鎮,忠仁里,69,1,40,1,41,105,3,1,3,0,1,0,39.05
臺東縣,成功鎮,忠仁里,70,1,563,4,567,1044,3,1,3,0,1,0,54.31
臺東縣,成功鎮,忠仁里,71,1,689,13,702,1245,3,1,3,0,1,0,56.39
臺東縣,成功鎮,忠智里,72,1,643,2,645,1129,3,1,3,0,1,0,57.13
臺東縣,成功鎮,三民里,73,1,190,1,191,390,3,1,3,0,1,0,48.97
臺東縣,成功鎮,三民里,74,1,309,5,314,602,3,1,3,0,1,0,52.16
臺東縣,成功鎮,三仙里,75,1,99,2,101,167,3,1,3,0,1,0,60.48
臺東縣,成功鎮,三仙里,76,1,199,4,203,407,3,1,3,0,1,0,49.88
臺東縣,成功鎮,忠孝里,77,1,146,4,150,294,3,1,3,0,1,0,51.02
臺東縣,成功鎮,忠孝里,78,1,145,4,149,281,3,1,3,0,1,0,53.02
臺東縣,成功鎮,博愛里,79,1,35,0,35,68,3,1,3,0,1,0,51.47
臺東縣,成功鎮,博愛里,80,1,38,0,38,71,3,1,3,0,1,0,53.52
臺東縣,關山鎮,里壟里,81,1,572,4,576,984,3,1,3,0,1,0,58.54
臺東縣,關山鎮,里壟里,82,1,369,11,380,736,3,1,3,0,1,0,51.63
臺東縣,關山鎮,中福里,83,1,538,10,548,876,3,1,3,0,1,0,62.56
臺東縣,關山鎮,新福里,84,1,375,12,387,652,3,1,3,0,1,0,59.36
臺東縣,關山鎮,豐泉里,85,1,498,5,503,922,3,1,3,0,1,0,54.56
臺東縣,關山鎮,月眉里,86,1,363,4,367,737,3,1,3,0,1,0,49.80
臺東縣,關山鎮,德高里,87,1,242,3,245,516,3,1,3,0,1,0,47.48
臺東縣,關山鎮,德高里,88,1,421,3,424,827,3,1,3,0,1,0,51.27
臺東縣,關山鎮,電光里,89,1,119,0,119,257,3,1,3,0,1,0,46.30
臺東縣,卑南鄉,賓朗村,90,1,532,6,538,845,3,1,3,0,1,0,63.67
臺東縣,卑南鄉,賓朗村,91,1,501,6,507,854,3,1,3,0,1,0,59.37
臺東縣,卑南鄉,美農村,92,1,165,1,166,257,3,1,3,0,1,0,64.59
臺東縣,卑南鄉,美農村,93,1,267,1,268,433,3,1,3,0,1,0,61.89
臺東縣,卑南鄉,美農村,94,1,157,3,160,323,3,1,3,0,1,0,49.54
臺東縣,卑南鄉,初鹿村,95,1,347,6,353,592,3,1,3,0,1,0,59.63
臺東縣,卑南鄉,初鹿村,96,1,297,4,301,474,3,1,3,0,1,0,63.50
臺東縣,卑南鄉,明峰村,97,1,401,5,406,732,3,1,3,0,1,0,55.46
臺東縣,卑南鄉,明峰村,98,1,175,5,180,330,3,1,3,0,1,0,54.55
臺東縣,卑南鄉,嘉豐村,99,1,108,3,111,201,3,1,3,0,1,0,55.22
臺東縣,卑南鄉,嘉豐村,100,1,22,0,22,40,3,1,3,0,1,0,55.00
臺東縣,卑南鄉,太平村,101,1,741,11,752,1144,3,1,3,0,1,0,65.73
臺東縣,卑南鄉,太平村,102,1,832,15,847,1158,3,1,3,0,1,0,73.14
臺東縣,卑南鄉,太平村,103,1,399,8,407,694,3,1,3,0,1,0,58.65
臺東縣,卑南鄉,泰安村,104,1,438,11,449,741,3,1,3,0,1,0,60.59
臺東縣,卑南鄉,利嘉村,105,1,221,1,222,418,3,1,3,0,1,0,53.11
臺東縣,卑南鄉,東興村,106,1,172,1,173,306,3,1,3,0,1,0,56.54
臺東縣,卑南鄉,溫泉村,107,1,491,4,495,862,3,1,3,0,1,0,57.42
臺東縣,卑南鄉,溫泉村,108,1,89,3,92,203,3,1,3,0,1,0,45.32
臺東縣,卑南鄉,富山村,109,1,241,5,246,473,3,1,3,0,1,0,52.01
臺東縣,卑南鄉,富源村,110,1,197,2,199,374,3,1,3,0,1,0,53.21
臺東縣,卑南鄉,利吉村,111,1,143,2,145,269,3,1,3,0,1,0,53.90
臺東縣,鹿野鄉,鹿野村,112,1,78,1,79,207,3,1,3,0,1,0,38.16
臺東縣,鹿野鄉,鹿野村,113,1,342,9,351,620,3,1,3,0,1,0,56.61
臺東縣,鹿野鄉,龍田村,114,1,563,6,569,1088,3,1,3,0,1,0,52.30
臺東縣,鹿野鄉,永安村,115,1,364,7,371,771,3,1,3,0,1,0,48.12
臺東縣,鹿野鄉,永安村,116,1,171,3,174,306,3,1,3,0,1,0,56.86
臺東縣,鹿野鄉,瑞隆村,117,1,449,6,455,852,3,1,3,0,1,0,53.40
臺東縣,鹿野鄉,瑞源村,118,1,348,4,352,677,3,1,3,0,1,0,51.99
臺東縣,鹿野鄉,瑞和村,119,1,222,6,228,409,3,1,3,0,1,0,55.75
臺東縣,鹿野鄉,瑞豐村,120,1,253,2,255,458,3,1,3,0,1,0,55.68
臺東縣,鹿野鄉,瑞豐村,121,1,303,2,305,573,3,1,3,0,1,0,53.23
臺東縣,池上鄉,福原村,122,1,565,10,575,960,3,1,3,0,1,0,59.90
臺東縣,池上鄉,福原村,123,1,490,1,491,860,3,1,3,0,1,0,57.09
臺東縣,池上鄉,福文村,124,1,327,7,334,645,3,1,3,0,1,0,51.78
臺東縣,池上鄉,福文村,125,1,387,9,396,781,3,1,3,0,1,0,50.70
臺東縣,池上鄉,慶豐村,126,1,357,6,363,703,3,1,3,0,1,0,51.64
臺東縣,池上鄉,大坡村,127,1,56,1,57,128,3,1,3,0,1,0,44.53
臺東縣,池上鄉,大埔村,128,1,249,3,252,412,3,1,3,0,1,0,61.17
臺東縣,池上鄉,新興村,129,1,484,8,492,882,3,1,3,0,1,0,55.78
臺東縣,池上鄉,錦園村,130,1,256,4,260,487,3,1,3,0,1,0,53.39
臺東縣,池上鄉,萬安村,131,1,207,3,210,406,3,1,3,0,1,0,51.72
臺東縣,池上鄉,富興村,132,1,219,4,223,405,3,1,3,0,1,0,55.06
臺東縣,池上鄉,振興村,133,1,91,1,92,192,3,1,3,0,1,0,47.92
臺東縣,東河鄉,都蘭村,134,1,136,1,137,315,3,1,3,0,1,0,43.49
臺東縣,東河鄉,都蘭村,135,1,213,3,216,425,3,1,3,0,1,0,50.82
臺東縣,東河鄉,都蘭村,136,1,290,1,291,566,3,1,3,0,1,0,51.41
臺東縣,東河鄉,興昌村,137,1,220,1,221,455,3,1,3,0,1,0,48.57
臺東縣,東河鄉,興昌村,138,1,133,1,134,253,3,1,3,0,1,0,52.96
臺東縣,東河鄉,隆昌村,139,1,99,2,101,212,3,1,3,0,1,0,47.64
臺東縣,東河鄉,東河村,140,1,173,4,177,369,3,1,3,0,1,0,47.97
臺東縣,東河鄉,泰源村,141,1,421,3,424,720,3,1,3,0,1,0,58.89
臺東縣,東河鄉,北源村,142,1,197,3,200,968,3,1,3,0,1,0,20.66
臺東縣,東河鄉,北源村,143,1,111,0,111,228,3,1,3,0,1,0,48.68
臺東縣,東河鄉,北源村,144,1,177,4,181,372,3,1,3,0,1,0,48.66
臺東縣,東河鄉,尚德村,145,1,79,2,81,161,3,1,3,0,1,0,50.31
臺東縣,東河鄉,尚德村,146,1,29,0,29,63,3,1,3,0,1,0,46.03
臺東縣,長濱鄉,寧埔村,147,1,58,1,59,144,3,1,3,0,1,0,40.97
臺東縣,長濱鄉,寧埔村,148,1,135,2,137,324,3,1,3,0,1,0,42.28
臺東縣,長濱鄉,竹湖村,149,1,205,4,209,443,3,1,3,0,1,0,47.18
臺東縣,長濱鄉,長濱村,150,1,675,10,685,1218,3,1,3,0,1,0,56.24
臺東縣,長濱鄉,忠勇村,151,1,244,5,249,567,3,1,3,0,1,0,43.92
臺東縣,長濱鄉,長濱村,152,1,105,1,106,238,3,1,3,0,1,0,44.54
臺東縣,長濱鄉,三間村,153,1,95,1,96,241,3,1,3,0,1,0,39.83
臺東縣,長濱鄉,三間村,154,1,84,0,84,156,3,1,3,0,1,0,53.85
臺東縣,長濱鄉,三間村,155,1,72,1,73,150,3,1,3,0,1,0,48.67
臺東縣,長濱鄉,樟原村,156,1,169,3,172,328,3,1,3,0,1,0,52.44
臺東縣,太麻里鄉,美和村,157,1,531,3,534,912,3,1,3,0,1,0,58.55
臺東縣,太麻里鄉,美和村,158,1,261,3,264,437,3,1,3,0,1,0,60.41
臺東縣,太麻里鄉,三和村,159,1,81,0,81,160,3,1,3,0,1,0,50.63
臺東縣,太麻里鄉,華源村,160,1,335,5,340,626,3,1,3,0,1,0,54.31
臺東縣,太麻里鄉,華源村,161,1,57,1,58,123,3,1,3,0,1,0,47.15
臺東縣,太麻里鄉,北里村,162,1,209,1,210,389,3,1,3,0,1,0,53.98
臺東縣,太麻里鄉,大王村,163,1,531,11,542,1092,3,1,3,0,1,0,49.63
臺東縣,太麻里鄉,大王村,164,1,50,0,50,93,3,1,3,0,1,0,53.76
臺東縣,太麻里鄉,泰和村,165,1,735,6,741,1341,3,1,3,0,1,0,55.26
臺東縣,太麻里鄉,香蘭村,166,1,214,2,216,432,3,1,3,0,1,0,50.00
臺東縣,太麻里鄉,香蘭村,167,1,87,1,88,158,3,1,3,0,1,0,55.70
臺東縣,太麻里鄉,金崙村,168,1,275,5,280,550,3,1,3,0,1,0,50.91
臺東縣,太麻里鄉,金崙村,169,1,42,0,42,88,3,1,3,0,1,0,47.73
臺東縣,太麻里鄉,多良村,170,1,12,0,12,31,3,1,3,0,1,0,38.71
臺東縣,太麻里鄉,多良村,171,1,129,0,129,223,3,1,3,0,1,0,57.85
臺東縣,大武鄉,南興村,172,1,157,0,157,272,3,1,3,0,1,0,57.72
臺東縣,大武鄉,尚武村,173,1,622,4,626,1148,3,1,3,0,1,0,54.53
臺東縣,大武鄉,大武村,174,1,493,10,503,904,3,1,3,0,1,0,55.64
臺東縣,大武鄉,大鳥村,175,1,54,2,56,137,3,1,3,0,1,0,40.88
臺東縣,大武鄉,大竹村,176,1,24,0,24,47,3,1,3,0,1,0,51.06
臺東縣,大武鄉,大竹村,177,1,18,1,19,43,3,1,3,0,1,0,44.19
臺東縣,綠島鄉,南寮村,178,1,297,7,304,596,3,1,3,0,1,0,51.01
臺東縣,綠島鄉,中寮村,179,1,336,2,338,630,3,1,3,0,1,0,53.65
臺東縣,綠島鄉,公舘村,180,1,194,2,196,377,3,1,3,0,1,0,51.99
臺東縣,綠島鄉,公舘村,181,1,72,2,74,115,3,1,3,0,1,0,64.35
臺東縣,海端鄉,加拿村,182,1,11,0,11,20,3,1,3,0,1,0,55.00
臺東縣,海端鄉,崁頂村,183,1,30,2,32,46,3,1,3,0,1,0,69.57
臺東縣,海端鄉,海端村,184,1,56,0,56,130,3,1,3,0,1,0,43.08
臺東縣,海端鄉,廣原村,185,1,60,1,61,90,3,1,3,0,1,0,67.78
臺東縣,海端鄉,霧鹿村,186,1,18,1,19,30,3,1,3,0,1,0,63.33
臺東縣,海端鄉,利稻村,187,1,19,2,21,33,3,1,3,0,1,0,63.64
臺東縣,延平鄉,桃源村,188,1,58,0,58,108,3,1,3,0,1,0,53.70
臺東縣,延平鄉,紅葉村,189,1,18,0,18,27,3,1,3,0,1,0,66.67
臺東縣,延平鄉,永康村,190,1,16,1,17,21,3,1,3,0,1,0,80.95
臺東縣,延平鄉,武陵村,191,1,19,0,19,33,3,1,3,0,1,0,57.58
臺東縣,延平鄉,鸞山村,192,1,17,0,17,32,3,1,3,0,1,0,53.13
臺東縣,延平鄉,鸞山村,193,1,46,1,47,76,3,1,3,0,1,0,61.84
臺東縣,金峰鄉,嘉蘭村,194,1,52,0,52,109,3,1,3,0,1,0,47.71
臺東縣,金峰鄉,正興村,195,1,18,0,18,46,3,1,3,0,1,0,39.13
臺東縣,金峰鄉,新興村,196,1,22,0,22,35,3,1,3,0,1,0,62.86
臺東縣,金峰鄉,賓茂村,197,1,11,0,11,20,3,1,3,0,1,0,55.00
臺東縣,金峰鄉,歷坵村,198,1,6,0,6,21,3,1,3,0,1,0,28.57
臺東縣,達仁鄉,安朔村,199,1,78,0,78,135,3,1,3,0,1,0,57.78
臺東縣,達仁鄉,安朔村,200,1,27,0,27,49,3,1,3,0,1,0,55.10
臺東縣,達仁鄉,南田村,201,1,16,0,16,37,3,1,3,0,1,0,43.24
臺東縣,達仁鄉,森永村,202,1,26,1,27,67,3,1,3,0,1,0,40.30
臺東縣,達仁鄉,新化村,203,1,2,0,2,15,3,1,3,0,1,0,13.33
臺東縣,達仁鄉,台板村,204,1,6,0,6,30,3,1,3,0,1,0,20.00
臺東縣,達仁鄉,土板村,205,1,5,0,5,11,3,1,3,0,1,0,45.45
臺東縣,蘭嶼鄉,椰油村,206,1,25,0,25,62,3,1,3,0,1,0,40.32
臺東縣,蘭嶼鄉,紅頭村,207,1,31,1,32,66,3,1,3,0,1,0,48.48
臺東縣,蘭嶼鄉,東清村,208,1,1,0,1,10,3,1,3,0,1,0,10.00
臺東縣,蘭嶼鄉,朗島村,209,1,5,0,5,14,3,1,3,0,1,0,35.71
花蓮縣,花蓮市,民德里,1,1,955,6,961,1494,3,1,3,0,1,0,64.32
花蓮縣,花蓮市,民勤里,2,1,1093,18,1111,1729,3,1,3,0,1,0,64.26
花蓮縣,花蓮市,民勤里,3,1,1042,8,1050,1621,3,1,3,0,1,0,64.77
花蓮縣,花蓮市,民意里,4,1,403,2,405,659,3,1,3,0,1,0,61.46
花蓮縣,花蓮市,民意里,5,1,806,29,835,1282,3,1,3,0,1,0,65.13
花蓮縣,花蓮市,民意里,6,1,773,12,785,1237,3,1,3,0,1,0,63.46
花蓮縣,花蓮市,民心里,7,1,386,8,394,657,3,1,3,0,1,0,59.97
花蓮縣,花蓮市,民享里,8,1,837,9,846,1370,3,1,3,0,1,0,61.75
花蓮縣,花蓮市,民享里,9,1,674,8,682,1226,3,1,3,0,1,0,55.63
花蓮縣,花蓮市,民運里,10,1,590,7,597,942,3,1,3,0,1,0,63.38
花蓮縣,花蓮市,民運里,11,1,467,15,482,768,3,1,3,0,1,0,62.76
花蓮縣,花蓮市,民政里,12,1,705,14,719,1137,3,1,3,0,1,0,63.24
花蓮縣,花蓮市,民政里,13,1,775,14,789,1264,3,1,3,0,1,0,62.42
花蓮縣,花蓮市,民立里,14,1,994,17,1011,1483,3,1,3,0,1,0,68.17
花蓮縣,花蓮市,民樂里,15,1,213,0,213,344,3,1,3,0,1,0,61.92
花蓮縣,花蓮市,民有里,16,1,421,4,425,655,3,1,3,0,1,0,64.89
花蓮縣,花蓮市,民主里,17,1,400,7,407,687,3,1,3,0,1,0,59.24
花蓮縣,花蓮市,民治里,18,1,337,6,343,535,3,1,3,0,1,0,64.11
花蓮縣,花蓮市,民族里,19,1,403,0,403,646,3,1,3,0,1,0,62.38
花蓮縣,花蓮市,民生里,20,1,910,13,923,1411,3,1,3,0,1,0,65.41
花蓮縣,花蓮市,民權里,21,1,339,6,345,550,3,1,3,0,1,0,62.73
花蓮縣,花蓮市,主商里,22,1,573,9,582,833,3,1,3,0,1,0,69.87
花蓮縣,花蓮市,主勤里,23,1,678,8,686,1094,3,1,3,0,1,0,62.71
花蓮縣,花蓮市,主工里,24,1,499,6,505,724,3,1,3,0,1,0,69.75
花蓮縣,花蓮市,主信里,25,1,497,7,504,776,3,1,3,0,1,0,64.95
花蓮縣,花蓮市,主睦里,26,1,619,7,626,1004,3,1,3,0,1,0,62.35
花蓮縣,花蓮市,主計里,27,1,466,7,473,796,3,1,3,0,1,0,59.42
花蓮縣,花蓮市,主和里,28,1,770,16,786,1241,3,1,3,0,1,0,63.34
花蓮縣,花蓮市,主和里,29,1,921,7,928,1505,3,1,3,0,1,0,61.66
花蓮縣,花蓮市,主學里,30,1,1025,8,1033,1572,3,1,3,0,1,0,65.71
花蓮縣,花蓮市,主農里,31,1,924,13,937,1408,3,1,3,0,1,0,66.55
花蓮縣,花蓮市,主農里,32,1,597,4,601,968,3,1,3,0,1,0,62.09
花蓮縣,花蓮市,主農里,33,1,598,6,604,945,3,1,3,0,1,0,63.92
花蓮縣,花蓮市,主農里,34,1,824,10,834,1321,3,1,3,0,1,0,63.13
花蓮縣,花蓮市,主權里,35,1,591,8,599,1003,3,1,3,0,1,0,59.72
花蓮縣,花蓮市,主權里,36,1,536,3,539,881,3,1,3,0,1,0,61.18
花蓮縣,花蓮市,主權里,37,1,767,7,774,1250,3,1,3,0,1,0,61.92
花蓮縣,花蓮市,主力里,38,1,762,11,773,1183,3,1,3,0,1,0,65.34
花蓮縣,花蓮市,主力里,39,1,677,7,684,1039,3,1,3,0,1,0,65.83
花蓮縣,花蓮市,國風里,40,1,1058,7,1065,1734,3,1,3,0,1,0,61.42
花蓮縣,花蓮市,國風里,41,1,799,13,812,1306,3,1,3,0,1,0,62.17
花蓮縣,花蓮市,國威里,42,1,1011,8,1019,1530,3,1,3,0,1,0,66.60
花蓮縣,花蓮市,國治里,43,1,709,11,720,1087,3,1,3,0,1,0,66.24
花蓮縣,花蓮市,國安里,44,1,297,3,300,460,3,1,3,0,1,0,65.22
花蓮縣,花蓮市,國光里,45,1,930,24,954,1456,3,1,3,0,1,0,65.52
花蓮縣,花蓮市,國防里,46,1,491,3,494,780,3,1,3,0,1,0,63.33
花蓮縣,花蓮市,國華里,47,1,793,8,801,1244,3,1,3,0,1,0,64.39
花蓮縣,花蓮市,國華里,48,1,602,7,609,919,3,1,3,0,1,0,66.27
花蓮縣,花蓮市,國魂里,49,1,590,9,599,900,3,1,3,0,1,0,66.56
花蓮縣,花蓮市,國魂里,50,1,508,4,512,848,3,1,3,0,1,0,60.38
花蓮縣,花蓮市,國聯里,51,1,1006,15,1021,1613,3,1,3,0,1,0,63.30
花蓮縣,花蓮市,國聯里,52,1,1170,11,1181,2091,3,1,3,0,1,0,56.48
花蓮縣,花蓮市,國強里,53,1,489,3,492,809,3,1,3,0,1,0,60.82
花蓮縣,花蓮市,國富里,54,1,802,11,813,1225,3,1,3,0,1,0,66.37
花蓮縣,花蓮市,國富里,55,1,866,9,875,1350,3,1,3,0,1,0,64.81
花蓮縣,花蓮市,國富里,56,1,749,11,760,1176,3,1,3,0,1,0,64.63
花蓮縣,花蓮市,國裕里,57,1,779,9,788,1220,3,1,3,0,1,0,64.59
花蓮縣,花蓮市,國裕里,58,1,738,8,746,1235,3,1,3,0,1,0,60.40
花蓮縣,花蓮市,國慶里,59,1,539,5,544,898,3,1,3,0,1,0,60.58
花蓮縣,花蓮市,國慶里,60,1,1091,11,1102,1852,3,1,3,0,1,0,59.50
花蓮縣,花蓮市,國福里,61,1,384,7,391,733,3,1,3,0,1,0,53.34
花蓮縣,新城鄉,新城村,62,1,204,1,205,349,3,1,3,0,1,0,58.74
花蓮縣,新城鄉,新城村,63,1,622,11,633,945,3,1,3,0,1,0,66.98
花蓮縣,新城鄉,順安村,64,1,296,3,299,576,3,1,3,0,1,0,51.91
花蓮縣,新城鄉,順安村,65,1,175,0,175,264,3,1,3,0,1,0,66.29
花蓮縣,新城鄉,康樂村,66,1,225,1,226,330,3,1,3,0,1,0,68.48
花蓮縣,新城鄉,康樂村,67,1,1016,13,1029,1644,3,1,3,0,1,0,62.59
花蓮縣,新城鄉,北埔村,68,1,816,15,831,1465,3,1,3,0,1,0,56.72
花蓮縣,新城鄉,北埔村,69,1,1059,17,1076,1809,3,1,3,0,1,0,59.48
花蓮縣,新城鄉,北埔村,70,1,275,4,279,398,3,1,3,0,1,0,70.10
花蓮縣,新城鄉,佳林村,71,1,317,4,321,541,3,1,3,0,1,0,59.33
花蓮縣,新城鄉,嘉里村,72,1,805,17,822,1268,3,1,3,0,1,0,64.83
花蓮縣,新城鄉,嘉里村,73,1,774,21,795,1195,3,1,3,0,1,0,66.53
花蓮縣,新城鄉,嘉新村,74,1,562,12,574,795,3,1,3,0,1,0,72.20
花蓮縣,新城鄉,嘉新村,75,1,130,6,136,258,3,1,3,0,1,0,52.71
花蓮縣,秀林鄉,和平村,76,1,161,6,167,329,3,1,3,0,1,0,50.76
花蓮縣,秀林鄉,和平村,77,1,66,0,66,115,3,1,3,0,1,0,57.39
花蓮縣,秀林鄉,崇德村,78,1,186,3,189,334,3,1,3,0,1,0,56.59
花蓮縣,秀林鄉,富世村,79,1,124,2,126,251,3,1,3,0,1,0,50.20
花蓮縣,秀林鄉,富世村,80,1,115,5,120,245,3,1,3,0,1,0,48.98
花蓮縣,秀林鄉,秀林村,81,1,59,3,62,124,3,1,3,0,1,0,50.00
花蓮縣,秀林鄉,景美村,82,1,39,0,39,82,3,1,3,0,1,0,47.56
花蓮縣,秀林鄉,景美村,83,1,39,1,40,86,3,1,3,0,1,0,46.51
花蓮縣,秀林鄉,佳民村,84,1,76,0,76,124,3,1,3,0,1,0,61.29
花蓮縣,秀林鄉,水源村,85,1,79,1,80,114,3,1,3,0,1,0,70.18
花蓮縣,秀林鄉,銅門村,86,1,78,1,79,122,3,1,3,0,1,0,64.75
花蓮縣,秀林鄉,文蘭村,87,1,41,0,41,75,3,1,3,0,1,0,54.67
花蓮縣,秀林鄉,文蘭村,88,1,6,0,6,17,3,1,3,0,1,0,35.29
花蓮縣,吉安鄉,永安村,89,1,760,12,772,1233,3,1,3,0,1,0,62.61
花蓮縣,吉安鄉,永安村,90,1,805,13,818,1373,3,1,3,0,1,0,59.58
花蓮縣,吉安鄉,太昌村,91,1,612,3,615,1031,3,1,3,0,1,0,59.65
花蓮縣,吉安鄉,太昌村,92,1,624,13,637,1036,3,1,3,0,1,0,61.49
花蓮縣,吉安鄉,慶豐村,93,1,902,16,918,1583,3,1,3,0,1,0,57.99
花蓮縣,吉安鄉,慶豐村,94,1,1108,23,1131,1758,3,1,3,0,1,0,64.33
花蓮縣,吉安鄉,吉安村,95,1,516,2,518,850,3,1,3,0,1,0,60.94
花蓮縣,吉安鄉,吉安村,96,1,852,11,863,1404,3,1,3,0,1,0,61.47
花蓮縣,吉安鄉,福興村,97,1,1001,8,1009,1652,3,1,3,0,1,0,61.08
花蓮縣,吉安鄉,南華村,98,1,710,9,719,1133,3,1,3,0,1,0,63.46
花蓮縣,吉安鄉,干城村,99,1,517,17,534,1034,3,1,3,0,1,0,51.64
花蓮縣,吉安鄉,永興村,100,1,884,13,897,1425,3,1,3,0,1,0,62.95
花蓮縣,吉安鄉,稻香村,101,1,1252,25,1277,1984,3,1,3,0,1,0,64.36
花蓮縣,吉安鄉,南昌村,102,1,899,24,923,1599,3,1,3,0,1,0,57.72
花蓮縣,吉安鄉,宜昌村,103,1,738,7,745,1178,3,1,3,0,1,0,63.24
花蓮縣,吉安鄉,宜昌村,104,1,708,8,716,1136,3,1,3,0,1,0,63.03
花蓮縣,吉安鄉,北昌村,105,1,1132,11,1143,1768,3,1,3,0,1,0,64.65
花蓮縣,吉安鄉,北昌村,106,1,644,9,653,1029,3,1,3,0,1,0,63.46
花蓮縣,吉安鄉,北昌村,107,1,1383,16,1399,2149,3,1,3,0,1,0,65.10
花蓮縣,吉安鄉,勝安村,108,1,766,11,777,1240,3,1,3,0,1,0,62.66
花蓮縣,吉安鄉,勝安村,109,1,896,8,904,1433,3,1,3,0,1,0,63.08
花蓮縣,吉安鄉,仁里村,110,1,739,11,750,1257,3,1,3,0,1,0,59.67
花蓮縣,吉安鄉,仁里村,111,1,829,6,835,1389,3,1,3,0,1,0,60.12
花蓮縣,吉安鄉,仁里村,112,1,853,14,867,1388,3,1,3,0,1,0,62.46
花蓮縣,吉安鄉,東昌村,113,1,746,9,755,1227,3,1,3,0,1,0,61.53
花蓮縣,吉安鄉,東昌村,114,1,715,9,724,1242,3,1,3,0,1,0,58.29
花蓮縣,吉安鄉,仁安村,115,1,703,10,713,1301,3,1,3,0,1,0,54.80
花蓮縣,吉安鄉,仁和村,116,1,1141,18,1159,1873,3,1,3,0,1,0,61.88
花蓮縣,吉安鄉,仁和村,117,1,499,11,510,873,3,1,3,0,1,0,58.42
花蓮縣,吉安鄉,光華村,118,1,499,21,520,856,3,1,3,0,1,0,60.75
花蓮縣,壽豐鄉,溪口村,119,1,453,9,462,769,3,1,3,0,1,0,60.08
花蓮縣,壽豐鄉,樹湖村,120,1,177,1,178,326,3,1,3,0,1,0,54.60
花蓮縣,壽豐鄉,豐山村,121,1,1064,17,1081,1843,3,1,3,0,1,0,58.65
花蓮縣,壽豐鄉,豐裡村,122,1,679,11,690,1163,3,1,3,0,1,0,59.33
花蓮縣,壽豐鄉,豐坪村,123,1,410,3,413,666,3,1,3,0,1,0,62.01
花蓮縣,壽豐鄉,壽豐村,124,1,627,10,637,1088,3,1,3,0,1,0,58.55
花蓮縣,壽豐鄉,共和村,125,1,380,5,385,604,3,1,3,0,1,0,63.74
花蓮縣,壽豐鄉,光榮村,126,1,87,2,89,156,3,1,3,0,1,0,57.05
花蓮縣,壽豐鄉,池南村,127,1,328,5,333,561,3,1,3,0,1,0,59.36
花蓮縣,壽豐鄉,平和村,128,1,452,9,461,789,3,1,3,0,1,0,58.43
花蓮縣,壽豐鄉,平和村,129,1,182,5,187,324,3,1,3,0,1,0,57.72
花蓮縣,壽豐鄉,志學村,130,1,937,23,960,1657,3,1,3,0,1,0,57.94
花蓮縣,壽豐鄉,志學村,131,1,233,8,241,389,3,1,3,0,1,0,61.95
花蓮縣,壽豐鄉,米棧村,132,1,71,1,72,97,3,1,3,0,1,0,74.23
花蓮縣,壽豐鄉,米棧村,133,1,21,2,23,45,3,1,3,0,1,0,51.11
花蓮縣,壽豐鄉,月眉村,134,1,108,1,109,270,3,1,3,0,1,0,40.37
花蓮縣,壽豐鄉,鹽寮村,135,1,173,6,179,388,3,1,3,0,1,0,46.13
花蓮縣,壽豐鄉,水璉村,136,1,232,3,235,441,3,1,3,0,1,0,53.29
花蓮縣,壽豐鄉,水璉村,137,1,34,1,35,58,3,1,3,0,1,0,60.34
花蓮縣,鳳林鎮,鳳仁里,138,1,705,6,711,1124,3,1,3,0,1,0,63.26
花蓮縣,鳳林鎮,鳳義里,139,1,417,6,423,722,3,1,3,0,1,0,58.59
花蓮縣,鳳林鎮,鳳禮里,140,1,493,4,497,739,3,1,3,0,1,0,67.25
花蓮縣,鳳林鎮,鳳智里,141,1,804,9,813,1244,3,1,3,0,1,0,65.35
花蓮縣,鳳林鎮,鳳信里,142,1,442,1,443,699,3,1,3,0,1,0,63.38
花蓮縣,鳳林鎮,鳳信里,143,1,155,0,155,236,3,1,3,0,1,0,65.68
花蓮縣,鳳林鎮,山興里,144,1,109,3,112,196,3,1,3,0,1,0,57.14
花蓮縣,鳳林鎮,山興里,145,1,55,0,55,99,3,1,3,0,1,0,55.56
花蓮縣,鳳林鎮,大榮里,146,1,371,6,377,714,3,1,3,0,1,0,52.80
花蓮縣,鳳林鎮,大榮里,147,1,353,7,360,606,3,1,3,0,1,0,59.41
花蓮縣,鳳林鎮,北林里,148,1,437,9,446,684,3,1,3,0,1,0,65.20
花蓮縣,鳳林鎮,南平里,149,1,441,1,442,739,3,1,3,0,1,0,59.81
花蓮縣,鳳林鎮,林榮里,150,1,602,10,612,905,3,1,3,0,1,0,67.62
花蓮縣,鳳林鎮,長橋里,151,1,635,16,651,1087,3,1,3,0,1,0,59.89
花蓮縣,鳳林鎮,森榮里,152,1,108,2,110,196,3,1,3,0,1,0,56.12
花蓮縣,光復鄉,大華村,153,1,535,8,543,931,3,1,3,0,1,0,58.32
花蓮縣,光復鄉,大安村,154,1,540,2,542,912,3,1,3,0,1,0,59.43
花蓮縣,光復鄉,大馬村,155,1,250,4,254,456,3,1,3,0,1,0,55.70
花蓮縣,光復鄉,大平村,156,1,139,3,142,324,3,1,3,0,1,0,43.83
花蓮縣,光復鄉,大同村,157,1,405,7,412,735,3,1,3,0,1,0,56.05
花蓮縣,光復鄉,東富村,158,1,46,1,47,92,3,1,3,0,1,0,51.09
花蓮縣,光復鄉,東富村,159,1,70,1,71,174,3,1,3,0,1,0,40.80
花蓮縣,光復鄉,西富村,160,1,67,0,67,134,3,1,3,0,1,0,50.00
花蓮縣,光復鄉,南富村,161,1,55,1,56,127,3,1,3,0,1,0,44.09
花蓮縣,光復鄉,北富村,162,1,89,1,90,237,3,1,3,0,1,0,37.97
花蓮縣,光復鄉,西富村,163,1,129,2,131,258,3,1,3,0,1,0,50.78
花蓮縣,光復鄉,大進村,164,1,366,3,369,566,3,1,3,0,1,0,65.19
花蓮縣,光復鄉,大全村,165,1,308,4,312,556,3,1,3,0,1,0,56.12
花蓮縣,光復鄉,大全村,166,1,77,2,79,166,3,1,3,0,1,0,47.59
花蓮縣,光復鄉,大興村,167,1,211,1,212,386,3,1,3,0,1,0,54.92
花蓮縣,光復鄉,大富村,168,1,232,5,237,427,3,1,3,0,1,0,55.50
花蓮縣,光復鄉,大豐村,169,1,345,8,353,642,3,1,3,0,1,0,54.98
花蓮縣,豐濱鄉,靜浦村,170,1,54,0,54,148,3,1,3,0,1,0,36.49
花蓮縣,豐濱鄉,港口村,171,1,68,2,70,160,3,1,3,0,1,0,43.75
花蓮縣,豐濱鄉,豐濱村,172,1,58,1,59,95,3,1,3,0,1,0,62.11
花蓮縣,豐濱鄉,豐濱村,173,1,337,4,341,619,3,1,3,0,1,0,55.09
花蓮縣,豐濱鄉,豐濱村,174,1,45,2,47,93,3,1,3,0,1,0,50.54
花蓮縣,豐濱鄉,新社村,175,1,57,1,58,145,3,1,3,0,1,0,40.00
花蓮縣,豐濱鄉,磯崎村,176,1,73,0,73,116,3,1,3,0,1,0,62.93
花蓮縣,萬榮鄉,西林村,177,1,29,2,31,63,3,1,3,0,1,0,49.21
花蓮縣,萬榮鄉,見晴村,178,1,15,0,15,29,3,1,3,0,1,0,51.72
花蓮縣,萬榮鄉,萬榮村,179,1,30,1,31,47,3,1,3,0,1,0,65.96
花蓮縣,萬榮鄉,明利村,180,1,34,0,34,64,3,1,3,0,1,0,53.13
花蓮縣,萬榮鄉,馬遠村,181,1,6,0,6,12,3,1,3,0,1,0,50.00
花蓮縣,萬榮鄉,馬遠村,182,1,6,0,6,15,3,1,3,0,1,0,40.00
花蓮縣,萬榮鄉,紅葉村,183,1,56,1,57,118,3,1,3,0,1,0,48.31
花蓮縣,瑞穗鄉,瑞穗村,184,1,415,6,421,684,3,1,3,0,1,0,61.55
花蓮縣,瑞穗鄉,瑞穗村,185,1,711,6,717,1270,3,1,3,0,1,0,56.46
花蓮縣,瑞穗鄉,瑞美村,186,1,482,7,489,803,3,1,3,0,1,0,60.90
花蓮縣,瑞穗鄉,瑞美村,187,1,466,2,468,788,3,1,3,0,1,0,59.39
花蓮縣,瑞穗鄉,瑞良村,188,1,281,2,283,442,3,1,3,0,1,0,64.03
花蓮縣,瑞穗鄉,瑞祥村,189,1,472,8,480,844,3,1,3,0,1,0,56.87
花蓮縣,瑞穗鄉,瑞北村,190,1,240,2,242,452,3,1,3,0,1,0,53.54
花蓮縣,瑞穗鄉,舞鶴村,191,1,262,9,271,504,3,1,3,0,1,0,53.77
花蓮縣,瑞穗鄉,鶴岡村,192,1,159,2,161,364,3,1,3,0,1,0,44.23
花蓮縣,瑞穗鄉,奇美村,193,1,19,0,19,52,3,1,3,0,1,0,36.54
花蓮縣,瑞穗鄉,富源村,194,1,426,7,433,716,3,1,3,0,1,0,60.47
花蓮縣,瑞穗鄉,富興村,195,1,273,3,276,538,3,1,3,0,1,0,51.30
花蓮縣,瑞穗鄉,富民村,196,1,134,6,140,311,3,1,3,0,1,0,45.02
花蓮縣,玉里鎮,中城里,197,1,838,17,855,1478,3,1,3,0,1,0,57.85
花蓮縣,玉里鎮,中城里,198,1,719,16,735,1316,3,1,3,0,1,0,55.85
花蓮縣,玉里鎮,中城里,199,1,669,9,678,1157,3,1,3,0,1,0,58.60
花蓮縣,玉里鎮,國武里,200,1,833,5,838,1422,3,1,3,0,1,0,58.93
花蓮縣,玉里鎮,啟模里,201,1,473,9,482,904,3,1,3,0,1,0,53.32
花蓮縣,玉里鎮,啟模里,202,1,578,7,585,1007,3,1,3,0,1,0,58.09
花蓮縣,玉里鎮,泰昌里,203,1,726,14,740,1210,3,1,3,0,1,0,61.16
花蓮縣,玉里鎮,泰昌里,204,1,175,39,214,689,3,1,3,0,1,0,31.06
花蓮縣,玉里鎮,泰昌里,205,1,193,37,230,597,3,1,3,0,1,0,38.53
花蓮縣,玉里鎮,泰昌里,206,1,310,57,367,595,3,1,3,0,1,0,61.68
花蓮縣,玉里鎮,永昌里,207,1,624,15,639,1127,3,1,3,0,1,0,56.70
花蓮縣,玉里鎮,源城里,208,1,583,9,592,1150,3,1,3,0,1,0,51.48
花蓮縣,玉里鎮,長良里,209,1,350,46,396,769,3,1,3,0,1,0,51.50
花蓮縣,玉里鎮,樂合里,210,1,185,4,189,406,3,1,3,0,1,0,46.55
花蓮縣,玉里鎮,東豐里,211,1,193,2,195,379,3,1,3,0,1,0,51.45
花蓮縣,玉里鎮,觀音里,212,1,313,12,325,746,3,1,3,0,1,0,43.57
花蓮縣,玉里鎮,觀音里,213,1,176,5,181,360,3,1,3,0,1,0,50.28
花蓮縣,玉里鎮,松浦里,214,1,53,5,58,133,3,1,3,0,1,0,43.61
花蓮縣,玉里鎮,松浦里,215,1,196,2,198,467,3,1,3,0,1,0,42.40
花蓮縣,玉里鎮,春日里,216,1,247,3,250,531,3,1,3,0,1,0,47.08
花蓮縣,玉里鎮,德武里,217,1,43,1,44,97,3,1,3,0,1,0,45.36
花蓮縣,玉里鎮,三民里,218,1,520,8,528,1030,3,1,3,0,1,0,51.26
花蓮縣,玉里鎮,大禹里,219,1,587,7,594,1119,3,1,3,0,1,0,53.08
花蓮縣,富里鄉,吳江村,220,1,244,4,248,508,3,1,3,0,1,0,48.82
花蓮縣,富里鄉,東里村,221,1,633,20,653,1308,3,1,3,0,1,0,49.92
花蓮縣,富里鄉,萬寧村,222,1,619,43,662,1134,3,1,3,0,1,0,58.38
花蓮縣,富里鄉,新興村,223,1,324,6,330,674,3,1,3,0,1,0,48.96
花蓮縣,富里鄉,竹田村,224,1,630,11,641,1133,3,1,3,0,1,0,56.58
花蓮縣,富里鄉,羅山村,225,1,224,0,224,482,3,1,3,0,1,0,46.47
花蓮縣,富里鄉,石牌村,226,1,517,4,521,931,3,1,3,0,1,0,55.96
花蓮縣,富里鄉,明里村,227,1,255,3,258,440,3,1,3,0,1,0,58.64
花蓮縣,富里鄉,富里村,228,1,922,13,935,1744,3,1,3,0,1,0,53.61
花蓮縣,富里鄉,永豐村,229,1,302,1,303,589,3,1,3,0,1,0,51.44
花蓮縣,富里鄉,豐南村,230,1,212,5,217,397,3,1,3,0,1,0,54.66
花蓮縣,富里鄉,富南村,231,1,281,8,289,555,3,1,3,0,1,0,52.07
花蓮縣,富里鄉,學田村,232,1,332,4,336,583,3,1,3,0,1,0,57.63
花蓮縣,卓溪鄉,崙山村,233,1,14,0,14,34,3,1,3,0,1,0,41.18
花蓮縣,卓溪鄉,立山村,234,1,10,1,11,24,3,1,3,0,1,0,45.83
花蓮縣,卓溪鄉,立山村,235,1,8,1,9,25,3,1,3,0,1,0,36.00
花蓮縣,卓溪鄉,太平村,236,1,7,0,7,14,3,1,3,0,1,0,50.00
花蓮縣,卓溪鄉,太平村,237,1,11,1,12,22,3,1,3,0,1,0,54.55
花蓮縣,卓溪鄉,卓溪村,238,1,41,1,42,81,3,1,3,0,1,0,51.85
花蓮縣,卓溪鄉,卓清村,239,1,39,2,41,75,3,1,3,0,1,0,54.67
花蓮縣,卓溪鄉,卓清村,240,1,19,2,21,32,3,1,3,0,1,0,65.63
花蓮縣,卓溪鄉,古風村,241,1,19,0,19,41,3,1,3,0,1,0,46.34
花蓮縣,卓溪鄉,古風村,242,1,17,0,17,33,3,1,3,0,1,0,51.52
花蓮縣,卓溪鄉,古風村,243,1,12,0,12,23,3,1,3,0,1,0,52.17
澎湖縣,馬公市,新復里,1,1,259,3,262,405,3,1,3,0,1,0,64.69
澎湖縣,馬公市,復興里,2,1,266,5,271,353,3,1,3,0,1,0,76.77
澎湖縣,馬公市,長安里,3,1,418,6,424,644,3,1,3,0,1,0,65.84
澎湖縣,馬公市,中央里,4,1,392,5,397,553,3,1,3,0,1,0,71.79
澎湖縣,馬公市,啟明里,5,1,645,4,649,944,3,1,3,0,1,0,68.75
澎湖縣,馬公市,重慶里,6,1,808,4,812,1154,3,1,3,0,1,0,70.36
澎湖縣,馬公市,中興里,7,1,557,5,562,789,3,1,3,0,1,0,71.23
澎湖縣,馬公市,光復里,8,1,621,8,629,937,3,1,3,0,1,0,67.13
澎湖縣,馬公市,光復里,9,1,621,5,626,877,3,1,3,0,1,0,71.38
澎湖縣,馬公市,光明里,10,1,538,7,545,778,3,1,3,0,1,0,70.05
澎湖縣,馬公市,光明里,11,1,413,9,422,646,3,1,3,0,1,0,65.33
澎湖縣,馬公市,光榮里,12,1,607,10,617,925,3,1,3,0,1,0,66.70
澎湖縣,馬公市,光榮里,13,1,840,8,848,1244,3,1,3,0,1,0,68.17
澎湖縣,馬公市,朝陽里,14,1,869,7,876,1308,3,1,3,0,1,0,66.97
澎湖縣,馬公市,朝陽里,15,1,767,9,776,1177,3,1,3,0,1,0,65.93
澎湖縣,馬公市,朝陽里,16,1,992,12,1004,1447,3,1,3,0,1,0,69.38
澎湖縣,馬公市,陽明里,17,1,724,14,738,1135,3,1,3,0,1,0,65.02
澎湖縣,馬公市,陽明里,18,1,728,9,737,1141,3,1,3,0,1,0,64.59
澎湖縣,馬公市,重光里,19,1,563,9,572,810,3,1,3,0,1,0,70.62
澎湖縣,馬公市,西衛里,20,1,781,7,788,1154,3,1,3,0,1,0,68.28
澎湖縣,馬公市,西衛里,21,1,640,9,649,953,3,1,3,0,1,0,68.10
澎湖縣,馬公市,西文里,22,1,633,6,639,899,3,1,3,0,1,0,71.08
澎湖縣,馬公市,西文里,23,1,534,3,537,829,3,1,3,0,1,0,64.78
澎湖縣,馬公市,東文里,24,1,934,11,945,1369,3,1,3,0,1,0,69.03
澎湖縣,馬公市,案山里,25,1,808,14,822,1125,3,1,3,0,1,0,73.07
澎湖縣,馬公市,光華里,26,1,321,2,323,509,3,1,3,0,1,0,63.46
澎湖縣,馬公市,前寮里,27,1,342,3,345,467,3,1,3,0,1,0,73.88
澎湖縣,馬公市,石泉里,28,1,694,8,702,1026,3,1,3,0,1,0,68.42
澎湖縣,馬公市,菜園里,29,1,247,0,247,330,3,1,3,0,1,0,74.85
澎湖縣,馬公市,東衛里,30,1,768,12,780,1119,3,1,3,0,1,0,69.71
澎湖縣,馬公市,安宅里,31,1,305,5,310,434,3,1,3,0,1,0,71.43
澎湖縣,馬公市,興仁里,32,1,348,7,355,533,3,1,3,0,1,0,66.60
澎湖縣,馬公市,烏崁里,33,1,484,3,487,770,3,1,3,0,1,0,63.25
澎湖縣,馬公市,鐵線里,34,1,242,1,243,323,3,1,3,0,1,0,75.23
澎湖縣,馬公市,鎖港里,35,1,559,8,567,895,3,1,3,0,1,0,63.35
澎湖縣,馬公市,鎖港里,36,1,575,8,583,964,3,1,3,0,1,0,60.48
澎湖縣,馬公市,山水里,37,1,821,6,827,1248,3,1,3,0,1,0,66.27
澎湖縣,馬公市,五德里,38,1,113,2,115,171,3,1,3,0,1,0,67.25
澎湖縣,馬公市,井垵里,39,1,215,3,218,321,3,1,3,0,1,0,67.91
澎湖縣,馬公市,時裡里,40,1,799,5,804,967,3,1,3,0,1,0,83.14
澎湖縣,馬公市,風櫃里,41,1,731,17,748,1080,3,1,3,0,1,0,69.26
澎湖縣,馬公市,虎井里,42,1,203,1,204,550,3,1,3,0,1,0,37.09
澎湖縣,馬公市,桶盤里,43,1,54,0,54,147,3,1,3,0,1,0,36.73
澎湖縣,湖西鄉,湖西村,44,1,526,13,539,797,3,1,3,0,1,0,67.63
澎湖縣,湖西鄉,湖東村,45,1,168,4,172,262,3,1,3,0,1,0,65.65
澎湖縣,湖西鄉,青螺村,46,1,130,1,131,210,3,1,3,0,1,0,62.38
澎湖縣,湖西鄉,白坑村,47,1,153,5,158,244,3,1,3,0,1,0,64.75
澎湖縣,湖西鄉,南寮村,48,1,344,3,347,596,3,1,3,0,1,0,58.22
澎湖縣,湖西鄉,北寮村,49,1,179,0,179,264,3,1,3,0,1,0,67.80
澎湖縣,湖西鄉,紅羅村,50,1,339,3,342,507,3,1,3,0,1,0,67.46
澎湖縣,湖西鄉,西溪村,51,1,239,7,246,404,3,1,3,0,1,0,60.89
澎湖縣,湖西鄉,成功村,52,1,263,2,265,384,3,1,3,0,1,0,69.01
澎湖縣,湖西鄉,東石村,53,1,72,1,73,108,3,1,3,0,1,0,67.59
澎湖縣,湖西鄉,沙港村,54,1,454,4,458,733,3,1,3,0,1,0,62.48
澎湖縣,湖西鄉,中西村,55,1,101,1,102,160,3,1,3,0,1,0,63.75
澎湖縣,湖西鄉,鼎灣村,56,1,210,3,213,449,3,1,3,0,1,0,47.44
澎湖縣,湖西鄉,潭邊村,57,1,176,3,179,230,3,1,3,0,1,0,77.83
澎湖縣,湖西鄉,許家村,58,1,115,4,119,186,3,1,3,0,1,0,63.98
澎湖縣,湖西鄉,城北村,59,1,127,1,128,192,3,1,3,0,1,0,66.67
澎湖縣,湖西鄉,太武村,60,1,56,0,56,77,3,1,3,0,1,0,72.73
澎湖縣,湖西鄉,隘門村,61,1,401,4,405,617,3,1,3,0,1,0,65.64
澎湖縣,湖西鄉,林投村,62,1,518,8,526,786,3,1,3,0,1,0,66.92
澎湖縣,湖西鄉,尖山村,63,1,286,4,290,461,3,1,3,0,1,0,62.91
澎湖縣,湖西鄉,尖山村,64,1,397,5,402,744,3,1,3,0,1,0,54.03
澎湖縣,湖西鄉,龍門村,65,1,379,4,383,746,3,1,3,0,1,0,51.34
澎湖縣,湖西鄉,果葉村,66,1,354,6,360,608,3,1,3,0,1,0,59.21
澎湖縣,白沙鄉,中屯村,67,1,270,4,274,408,3,1,3,0,1,0,67.16
澎湖縣,白沙鄉,講美村,68,1,337,4,341,485,3,1,3,0,1,0,70.31
澎湖縣,白沙鄉,城前村,69,1,63,0,63,87,3,1,3,0,1,0,72.41
澎湖縣,白沙鄉,鎮海村,70,1,72,0,72,103,3,1,3,0,1,0,69.90
澎湖縣,白沙鄉,港子村,71,1,170,3,173,264,3,1,3,0,1,0,65.53
澎湖縣,白沙鄉,岐頭村,72,1,115,2,117,179,3,1,3,0,1,0,65.36
澎湖縣,白沙鄉,小赤村,73,1,106,2,108,160,3,1,3,0,1,0,67.50
澎湖縣,白沙鄉,赤崁村,74,1,818,9,827,1235,3,1,3,0,1,0,66.96
澎湖縣,白沙鄉,瓦硐村,75,1,178,1,179,276,3,1,3,0,1,0,64.86
澎湖縣,白沙鄉,後寮村,76,1,362,2,364,640,3,1,3,0,1,0,56.88
澎湖縣,白沙鄉,通梁村,77,1,429,3,432,705,3,1,3,0,1,0,61.28
澎湖縣,白沙鄉,吉貝村,78,1,443,5,448,1149,3,1,3,0,1,0,38.99
澎湖縣,白沙鄉,鳥嶼村,79,1,379,2,381,828,3,1,3,0,1,0,46.01
澎湖縣,白沙鄉,員貝村,80,1,85,0,85,180,3,1,3,0,1,0,47.22
澎湖縣,白沙鄉,大倉村,81,1,86,0,86,158,3,1,3,0,1,0,54.43
澎湖縣,西嶼鄉,橫礁村,82,1,122,3,125,230,3,1,3,0,1,0,54.35
澎湖縣,西嶼鄉,合界村,83,1,230,2,232,422,3,1,3,0,1,0,54.98
澎湖縣,西嶼鄉,竹灣村,84,1,438,8,446,793,3,1,3,0,1,0,56.24
澎湖縣,西嶼鄉,小門村,85,1,151,0,151,242,3,1,3,0,1,0,62.40
澎湖縣,西嶼鄉,大池村,86,1,326,6,332,604,3,1,3,0,1,0,54.97
澎湖縣,西嶼鄉,二崁村,87,1,51,1,52,104,3,1,3,0,1,0,50.00
澎湖縣,西嶼鄉,池東村,88,1,310,3,313,498,3,1,3,0,1,0,62.85
澎湖縣,西嶼鄉,池西村,89,1,111,1,112,202,3,1,3,0,1,0,55.45
澎湖縣,西嶼鄉,赤馬村,90,1,315,3,318,618,3,1,3,0,1,0,51.46
澎湖縣,西嶼鄉,內垵村,91,1,669,6,675,1179,3,1,3,0,1,0,57.25
澎湖縣,西嶼鄉,外垵村,92,1,391,4,395,762,3,1,3,0,1,0,51.84
澎湖縣,西嶼鄉,外垵村,93,1,457,3,460,888,3,1,3,0,1,0,51.80
澎湖縣,望安鄉,東安村,94,1,168,7,175,371,3,1,3,0,1,0,47.17
澎湖縣,望安鄉,西安村,95,1,162,4,166,326,3,1,3,0,1,0,50.92
澎湖縣,望安鄉,中社村,96,1,87,2,89,198,3,1,3,0,1,0,44.95
澎湖縣,望安鄉,水垵村,97,1,95,2,97,228,3,1,3,0,1,0,42.54
澎湖縣,望安鄉,將軍村,98,1,470,6,476,1049,3,1,3,0,1,0,45.38
澎湖縣,望安鄉,東吉村,99,1,16,0,16,66,3,1,3,0,1,0,24.24
澎湖縣,望安鄉,東坪村,100,1,63,1,64,172,3,1,3,0,1,0,37.21
澎湖縣,望安鄉,西坪村,101,1,41,0,41,104,3,1,3,0,1,0,39.42
澎湖縣,望安鄉,花嶼村,102,1,120,1,121,233,3,1,3,0,1,0,51.93
澎湖縣,七美鄉,東湖村,103,1,110,3,113,230,3,1,3,0,1,0,49.13
澎湖縣,七美鄉,西湖村,104,1,178,1,179,373,3,1,3,0,1,0,47.99
澎湖縣,七美鄉,中和村,105,1,207,2,209,422,3,1,3,0,1,0,49.53
澎湖縣,七美鄉,平和村,106,1,95,2,97,220,3,1,3,0,1,0,44.09
澎湖縣,七美鄉,海豐村,107,1,91,0,91,238,3,1,3,0,1,0,38.24
澎湖縣,七美鄉,南港村,108,1,413,8,421,761,3,1,3,0,1,0,55.32
基隆市,中正區,長潭里,1,1,505,11,516,754,3,1,3,0,1,0,68.44
基隆市,中正區,砂子里,2,1,823,7,830,1373,3,1,3,0,1,0,60.45
基隆市,中正區,砂子里,3,1,329,8,337,602,3,1,3,0,1,0,55.98
基隆市,中正區,八斗里,4,1,1054,16,1070,1658,3,1,3,0,1,0,64.54
基隆市,中正區,碧砂里,5,1,729,17,746,1274,3,1,3,0,1,0,58.56
基隆市,中正區,碧砂里,6,1,389,6,395,894,3,1,3,0,1,0,44.18
基隆市,中正區,碧砂里,7,1,550,9,559,1052,3,1,3,0,1,0,53.14
基隆市,中正區,平寮里,8,1,1073,15,1088,1667,3,1,3,0,1,0,65.27
基隆市,中正區,社寮里,9,1,756,8,764,1183,3,1,3,0,1,0,64.58
基隆市,中正區,社寮里,10,1,628,10,638,1004,3,1,3,0,1,0,63.55
基隆市,中正區,和憲里,11,1,663,7,670,1033,3,1,3,0,1,0,64.86
基隆市,中正區,海濱里,12,1,671,18,689,1088,3,1,3,0,1,0,63.33
基隆市,中正區,正濱里,13,1,925,15,940,1466,3,1,3,0,1,0,64.12
基隆市,中正區,中正里,14,1,625,9,634,1038,3,1,3,0,1,0,61.08
基隆市,中正區,中正里,15,1,700,12,712,1116,3,1,3,0,1,0,63.80
基隆市,中正區,中濱里,16,1,1013,7,1020,1638,3,1,3,0,1,0,62.27
基隆市,中正區,建國里,17,1,728,8,736,1141,3,1,3,0,1,0,64.50
基隆市,中正區,建國里,18,1,798,10,808,1144,3,1,3,0,1,0,70.63
基隆市,中正區,砂灣里,19,1,718,6,724,1165,3,1,3,0,1,0,62.15
基隆市,中正區,砂灣里,20,1,645,14,659,1044,3,1,3,0,1,0,63.12
基隆市,中正區,真砂里,21,1,1004,13,1017,1578,3,1,3,0,1,0,64.45
基隆市,中正區,正砂里,22,1,721,5,726,1087,3,1,3,0,1,0,66.79
基隆市,中正區,正砂里,23,1,870,7,877,1385,3,1,3,0,1,0,63.32
基隆市,中正區,中砂里,24,1,1046,11,1057,1584,3,1,3,0,1,0,66.73
基隆市,中正區,入船里,25,1,958,15,973,1529,3,1,3,0,1,0,63.64
基隆市,中正區,正船里,26,1,1040,11,1051,1667,3,1,3,0,1,0,63.05
基隆市,中正區,中船里,27,1,999,12,1011,1615,3,1,3,0,1,0,62.60
基隆市,中正區,港通里,28,1,915,14,929,1412,3,1,3,0,1,0,65.79
基隆市,中正區,義重里,29,1,829,11,840,1299,3,1,3,0,1,0,64.67
基隆市,中正區,信義里,30,1,788,12,800,1222,3,1,3,0,1,0,65.47
基隆市,中正區,正義里,31,1,974,10,984,1517,3,1,3,0,1,0,64.86
基隆市,中正區,德義里,32,1,618,5,623,912,3,1,3,0,1,0,68.31
基隆市,七堵區,長興里,33,1,1017,22,1039,1649,3,1,3,0,1,0,63.01
基隆市,七堵區,長興里,34,1,1428,17,1445,2261,3,1,3,0,1,0,63.91
基隆市,七堵區,正光里,35,1,776,20,796,1195,3,1,3,0,1,0,66.61
基隆市,七堵區,正光里,36,1,572,6,578,856,3,1,3,0,1,0,67.52
基隆市,七堵區,正明里,37,1,905,14,919,1454,3,1,3,0,1,0,63.20
基隆市,七堵區,正明里,38,1,596,13,609,842,3,1,3,0,1,0,72.33
基隆市,七堵區,富民里,39,1,1223,13,1236,1869,3,1,3,0,1,0,66.13
基隆市,七堵區,富民里,40,1,1180,20,1200,1771,3,1,3,0,1,0,67.76
基隆市,七堵區,永平里,41,1,743,5,748,1158,3,1,3,0,1,0,64.59
基隆市,七堵區,永平里,42,1,723,10,733,1093,3,1,3,0,1,0,67.06
基隆市,七堵區,永安里,43,1,872,12,884,1309,3,1,3,0,1,0,67.53
基隆市,七堵區,永安里,44,1,638,13,651,967,3,1,3,0,1,0,67.32
基隆市,七堵區,八德里,45,1,157,4,161,274,3,1,3,0,1,0,58.76
基隆市,七堵區,八德里,46,1,774,6,780,1268,3,1,3,0,1,0,61.51
基隆市,七堵區,自強里,47,1,499,6,505,873,3,1,3,0,1,0,57.85
基隆市,七堵區,泰安里,48,1,737,10,747,1183,3,1,3,0,1,0,63.14
基隆市,七堵區,泰安里,49,1,677,11,688,1087,3,1,3,0,1,0,63.29
基隆市,七堵區,六堵里,50,1,650,11,661,1068,3,1,3,0,1,0,61.89
基隆市,七堵區,堵南里,51,1,770,5,775,1281,3,1,3,0,1,0,60.50
基隆市,七堵區,堵南里,52,1,803,8,811,1398,3,1,3,0,1,0,58.01
基隆市,七堵區,堵北里,53,1,682,14,696,1147,3,1,3,0,1,0,60.68
基隆市,七堵區,堵北里,54,1,773,21,794,1295,3,1,3,0,1,0,61.31
基隆市,七堵區,百福里,55,1,1075,14,1089,1744,3,1,3,0,1,0,62.44
基隆市,七堵區,百福里,56,1,931,17,948,1638,3,1,3,0,1,0,57.88
基隆市,七堵區,實踐里,57,1,873,15,888,1485,3,1,3,0,1,0,59.80
基隆市,七堵區,實踐里,58,1,990,13,1003,1679,3,1,3,0,1,0,59.74
基隆市,七堵區,瑪南里,59,1,285,3,288,432,3,1,3,0,1,0,66.67
基隆市,七堵區,瑪東里,60,1,208,4,212,344,3,1,3,0,1,0,61.63
基隆市,七堵區,瑪西里,61,1,277,2,279,396,3,1,3,0,1,0,70.45
基隆市,七堵區,友一里,62,1,563,5,568,884,3,1,3,0,1,0,64.25
基隆市,七堵區,友二里,63,1,290,0,290,440,3,1,3,0,1,0,65.91
基隆市,暖暖區,八西里,64,1,789,20,809,1267,3,1,3,0,1,0,63.85
基隆市,暖暖區,八中里,65,1,433,13,446,691,3,1,3,0,1,0,64.54
基隆市,暖暖區,八堵里,66,1,622,9,631,943,3,1,3,0,1,0,66.91
基隆市,暖暖區,八南里,67,1,356,4,360,573,3,1,3,0,1,0,62.83
基隆市,暖暖區,過港里,68,1,927,18,945,1466,3,1,3,0,1,0,64.46
基隆市,暖暖區,過港里,69,1,846,12,858,1250,3,1,3,0,1,0,68.64
基隆市,暖暖區,暖暖里,70,1,632,9,641,972,3,1,3,0,1,0,65.95
基隆市,暖暖區,暖暖里,71,1,611,5,616,933,3,1,3,0,1,0,66.02
基隆市,暖暖區,暖同里,72,1,1079,17,1096,1664,3,1,3,0,1,0,65.87
基隆市,暖暖區,暖東里,73,1,272,3,275,396,3,1,3,0,1,0,69.44
基隆市,暖暖區,暖西里,74,1,1096,23,1119,1745,3,1,3,0,1,0,64.13
基隆市,暖暖區,暖西里,75,1,783,14,797,1295,3,1,3,0,1,0,61.54
基隆市,暖暖區,碇內里,76,1,582,9,591,863,3,1,3,0,1,0,68.48
基隆市,暖暖區,碇內里,77,1,706,18,724,1101,3,1,3,0,1,0,65.76
基隆市,暖暖區,碇和里,78,1,1693,21,1714,2619,3,1,3,0,1,0,65.44
基隆市,暖暖區,碇安里,79,1,910,11,921,1393,3,1,3,0,1,0,66.12
基隆市,暖暖區,碇安里,80,1,1018,14,1032,1459,3,1,3,0,1,0,70.73
基隆市,仁愛區,林泉里,81,1,561,7,568,904,3,1,3,0,1,0,62.83
基隆市,仁愛區,林泉里,82,1,701,11,712,1084,3,1,3,0,1,0,65.68
基隆市,仁愛區,花崗里,83,1,762,12,774,1049,3,1,3,0,1,0,73.78
基隆市,仁愛區,虹橋里,84,1,1154,17,1171,1717,3,1,3,0,1,0,68.20
基隆市,仁愛區,水錦里,85,1,1272,21,1293,1934,3,1,3,0,1,0,66.86
基隆市,仁愛區,智仁里,86,1,900,9,909,1345,3,1,3,0,1,0,67.58
基隆市,仁愛區,智仁里,87,1,814,9,823,1211,3,1,3,0,1,0,67.96
基隆市,仁愛區,和明里,88,1,882,11,893,1350,3,1,3,0,1,0,66.15
基隆市,仁愛區,忠勇里,89,1,772,10,782,1213,3,1,3,0,1,0,64.47
基隆市,仁愛區,玉田里,90,1,880,7,887,1273,3,1,3,0,1,0,69.68
基隆市,仁愛區,仁德里,91,1,793,7,800,1168,3,1,3,0,1,0,68.49
基隆市,仁愛區,博愛里,92,1,850,10,860,1234,3,1,3,0,1,0,69.69
基隆市,仁愛區,博愛里,93,1,415,8,423,576,3,1,3,0,1,0,73.44
基隆市,仁愛區,福仁里,94,1,632,4,636,976,3,1,3,0,1,0,65.16
基隆市,仁愛區,誠仁里,95,1,727,19,746,1134,3,1,3,0,1,0,65.78
基隆市,仁愛區,吉仁里,96,1,1102,10,1112,1633,3,1,3,0,1,0,68.10
基隆市,仁愛區,吉仁里,97,1,1102,23,1125,1725,3,1,3,0,1,0,65.22
基隆市,仁愛區,育仁里,98,1,591,5,596,922,3,1,3,0,1,0,64.64
基隆市,仁愛區,英仁里,99,1,566,2,568,866,3,1,3,0,1,0,65.59
基隆市,仁愛區,英仁里,100,1,506,10,516,806,3,1,3,0,1,0,64.02
基隆市,仁愛區,龍門里,101,1,595,14,609,963,3,1,3,0,1,0,63.24
基隆市,仁愛區,德厚里,102,1,913,14,927,1335,3,1,3,0,1,0,69.44
基隆市,仁愛區,曲水里,103,1,735,4,739,1055,3,1,3,0,1,0,70.05
基隆市,仁愛區,崇文里,104,1,653,8,661,1001,3,1,3,0,1,0,66.03
基隆市,仁愛區,文安里,105,1,865,10,875,1288,3,1,3,0,1,0,67.93
基隆市,仁愛區,兆連里,106,1,524,11,535,792,3,1,3,0,1,0,67.55
基隆市,仁愛區,獅球里,107,1,910,8,918,1343,3,1,3,0,1,0,68.35
基隆市,仁愛區,書院里,108,1,913,10,923,1296,3,1,3,0,1,0,71.22
基隆市,仁愛區,朝棟里,109,1,576,8,584,874,3,1,3,0,1,0,66.82
基隆市,仁愛區,朝棟里,110,1,615,19,634,996,3,1,3,0,1,0,63.65
基隆市,仁愛區,光華里,111,1,582,3,585,865,3,1,3,0,1,0,67.63
基隆市,仁愛區,光華里,112,1,821,11,832,1196,3,1,3,0,1,0,69.57
基隆市,仁愛區,明德里,113,1,584,9,593,840,3,1,3,0,1,0,70.60
基隆市,仁愛區,同風里,114,1,545,7,552,783,3,1,3,0,1,0,70.50
基隆市,仁愛區,文昌里,115,1,665,6,671,953,3,1,3,0,1,0,70.41
基隆市,仁愛區,新店里,116,1,605,14,619,902,3,1,3,0,1,0,68.63
基隆市,中山區,新建里,117,1,647,5,652,937,3,1,3,0,1,0,69.58
基隆市,中山區,安民里,118,1,840,8,848,1255,3,1,3,0,1,0,67.57
基隆市,中山區,安平里,119,1,697,19,716,1046,3,1,3,0,1,0,68.45
基隆市,中山區,中山里,120,1,862,10,872,1276,3,1,3,0,1,0,68.34
基隆市,中山區,民治里,121,1,773,12,785,1202,3,1,3,0,1,0,65.31
基隆市,中山區,中興里,122,1,1047,12,1059,1559,3,1,3,0,1,0,67.93
基隆市,中山區,仁正里,123,1,607,11,618,915,3,1,3,0,1,0,67.54
基隆市,中山區,健民里,124,1,1202,21,1223,1811,3,1,3,0,1,0,67.53
基隆市,中山區,通化里,125,1,938,15,953,1419,3,1,3,0,1,0,67.16
基隆市,中山區,居仁里,126,1,643,6,649,968,3,1,3,0,1,0,67.05
基隆市,中山區,居仁里,127,1,618,7,625,1038,3,1,3,0,1,0,60.21
基隆市,中山區,通明里,128,1,969,15,984,1412,3,1,3,0,1,0,69.69
基隆市,中山區,通明里,129,1,558,17,575,814,3,1,3,0,1,0,70.64
基隆市,中山區,和平里,130,1,593,5,598,880,3,1,3,0,1,0,67.95
基隆市,中山區,仙洞里,131,1,542,8,550,897,3,1,3,0,1,0,61.32
基隆市,中山區,太白里,132,1,744,15,759,1108,3,1,3,0,1,0,68.50
基隆市,中山區,協和里,133,1,450,3,453,654,3,1,3,0,1,0,69.27
基隆市,中山區,協和里,134,1,712,16,728,1068,3,1,3,0,1,0,68.16
基隆市,中山區,文化里,135,1,784,16,800,1173,3,1,3,0,1,0,68.20
基隆市,中山區,德安里,136,1,1409,24,1433,2212,3,1,3,0,1,0,64.78
基隆市,中山區,德和里,137,1,1283,18,1301,1913,3,1,3,0,1,0,68.01
基隆市,中山區,德和里,138,1,884,15,899,1247,3,1,3,0,1,0,72.09
基隆市,中山區,中和里,139,1,927,18,945,1456,3,1,3,0,1,0,64.90
基隆市,中山區,中和里,140,1,697,15,712,1194,3,1,3,0,1,0,59.63
基隆市,中山區,西康里,141,1,1272,26,1298,2007,3,1,3,0,1,0,64.67
基隆市,中山區,西定里,142,1,760,7,767,1154,3,1,3,0,1,0,66.46
基隆市,中山區,西華里,143,1,802,8,810,1199,3,1,3,0,1,0,67.56
基隆市,中山區,西榮里,144,1,645,8,653,957,3,1,3,0,1,0,68.23
基隆市,安樂區,新西里,145,1,1151,11,1162,1824,3,1,3,0,1,0,63.71
基隆市,安樂區,西川里,146,1,1010,15,1025,1571,3,1,3,0,1,0,65.25
基隆市,安樂區,定國里,147,1,893,13,906,1412,3,1,3,0,1,0,64.16
基隆市,安樂區,定邦里,148,1,965,23,988,1511,3,1,3,0,1,0,65.39
基隆市,安樂區,干城里,149,1,1149,12,1161,1746,3,1,3,0,1,0,66.49
基隆市,安樂區,干城里,150,1,642,12,654,926,3,1,3,0,1,0,70.63
基隆市,安樂區,永康里,151,1,964,19,983,1588,3,1,3,0,1,0,61.90
基隆市,安樂區,永康里,152,1,363,4,367,546,3,1,3,0,1,0,67.22
基隆市,安樂區,慈仁里,153,1,713,14,727,1168,3,1,3,0,1,0,62.24
基隆市,安樂區,安和里,154,1,639,8,647,950,3,1,3,0,1,0,68.11
基隆市,安樂區,樂一里,155,1,608,19,627,853,3,1,3,0,1,0,73.51
基隆市,安樂區,嘉仁里,156,1,1120,15,1135,1763,3,1,3,0,1,0,64.38
基隆市,安樂區,嘉仁里,157,1,1063,15,1078,1682,3,1,3,0,1,0,64.09
基隆市,安樂區,鶯歌里,158,1,927,7,934,1321,3,1,3,0,1,0,70.70
基隆市,安樂區,鶯歌里,159,1,779,7,786,1253,3,1,3,0,1,0,62.73
基隆市,安樂區,七賢里,160,1,1063,13,1076,1592,3,1,3,0,1,0,67.59
基隆市,安樂區,七賢里,161,1,930,13,943,1463,3,1,3,0,1,0,64.46
基隆市,安樂區,三民里,162,1,1198,22,1220,1759,3,1,3,0,1,0,69.36
基隆市,安樂區,三民里,163,1,1132,13,1145,1716,3,1,3,0,1,0,66.72
基隆市,安樂區,四維里,164,1,1024,17,1041,1514,3,1,3,0,1,0,68.76
基隆市,安樂區,五福里,165,1,1098,20,1118,1646,3,1,3,0,1,0,67.92
基隆市,安樂區,五福里,166,1,1270,31,1301,1872,3,1,3,0,1,0,69.50
基隆市,安樂區,六合里,167,1,1118,7,1125,1720,3,1,3,0,1,0,65.41
基隆市,安樂區,六合里,168,1,1206,17,1223,1803,3,1,3,0,1,0,67.83
基隆市,安樂區,外寮里,169,1,977,22,999,1597,3,1,3,0,1,0,62.55
基隆市,安樂區,外寮里,170,1,665,7,672,1177,3,1,3,0,1,0,57.09
基隆市,安樂區,新崙里,171,1,1409,24,1433,2369,3,1,3,0,1,0,60.49
基隆市,安樂區,新崙里,172,1,292,4,296,503,3,1,3,0,1,0,58.85
基隆市,安樂區,中崙里,173,1,631,10,641,1081,3,1,3,0,1,0,59.30
基隆市,安樂區,內寮里,174,1,564,8,572,917,3,1,3,0,1,0,62.38
基隆市,安樂區,內寮里,175,1,752,10,762,1276,3,1,3,0,1,0,59.72
基隆市,信義區,仁壽里,176,1,853,11,864,1264,3,1,3,0,1,0,68.35
基隆市,信義區,仁義里,177,1,978,13,991,1333,3,1,3,0,1,0,74.34
基隆市,信義區,義昭里,178,1,839,5,844,1222,3,1,3,0,1,0,69.07
基隆市,信義區,義幸里,179,1,963,12,975,1339,3,1,3,0,1,0,72.82
基隆市,信義區,義幸里,180,1,871,14,885,1217,3,1,3,0,1,0,72.72
基隆市,信義區,義民里,181,1,620,7,627,896,3,1,3,0,1,0,69.98
基隆市,信義區,義和里,182,1,1012,14,1026,1495,3,1,3,0,1,0,68.63
基隆市,信義區,智慧里,183,1,585,7,592,826,3,1,3,0,1,0,71.67
基隆市,信義區,智誠里,184,1,531,8,539,790,3,1,3,0,1,0,68.23
基隆市,信義區,智誠里,185,1,790,9,799,1119,3,1,3,0,1,0,71.40
基隆市,信義區,禮儀里,186,1,1079,14,1093,1592,3,1,3,0,1,0,68.66
基隆市,信義區,禮東里,187,1,1139,12,1151,1694,3,1,3,0,1,0,67.95
基隆市,信義區,信綠里,188,1,1190,8,1198,1709,3,1,3,0,1,0,70.10
基隆市,信義區,信綠里,189,1,461,9,470,703,3,1,3,0,1,0,66.86
基隆市,信義區,東信里,190,1,681,7,688,1020,3,1,3,0,1,0,67.45
基隆市,信義區,東信里,191,1,733,9,742,1152,3,1,3,0,1,0,64.41
基隆市,信義區,東光里,192,1,1142,13,1155,1660,3,1,3,0,1,0,69.58
基隆市,信義區,東明里,193,1,975,18,993,1453,3,1,3,0,1,0,68.34
基隆市,信義區,東明里,194,1,733,14,747,1307,3,1,3,0,1,0,57.15
基隆市,信義區,東安里,195,1,940,14,954,1397,3,1,3,0,1,0,68.29
基隆市,信義區,東安里,196,1,947,16,963,1369,3,1,3,0,1,0,70.34
基隆市,信義區,孝深里,197,1,1318,11,1329,1989,3,1,3,0,1,0,66.82
基隆市,信義區,孝深里,198,1,1147,22,1169,1832,3,1,3,0,1,0,63.81
基隆市,信義區,孝岡里,199,1,456,4,460,748,3,1,3,0,1,0,61.50
新竹市,東區,育賢里,1,1,661,4,665,1121,3,1,3,0,1,0,59.32
新竹市,東區,親仁里,2,1,562,8,570,952,3,1,3,0,1,0,59.87
新竹市,東區,親仁里,3,1,610,3,613,962,3,1,3,0,1,0,63.72
新竹市,東區,東門里,4,1,528,5,533,884,3,1,3,0,1,0,60.29
新竹市,東區,成功里,5,1,491,4,495,873,3,1,3,0,1,0,56.70
新竹市,東區,榮光里,6,1,329,3,332,584,3,1,3,0,1,0,56.85
新竹市,東區,中正里,7,1,350,2,352,630,3,1,3,0,1,0,55.87
新竹市,東區,錦華里,8,1,807,12,819,1281,3,1,3,0,1,0,63.93
新竹市,東區,錦華里,9,1,401,3,404,589,3,1,3,0,1,0,68.59
新竹市,東區,文華里,10,1,625,5,630,1002,3,1,3,0,1,0,62.87
新竹市,東區,文華里,11,1,589,14,603,919,3,1,3,0,1,0,65.61
新竹市,東區,文華里,12,1,551,6,557,962,3,1,3,0,1,0,57.90
新竹市,東區,復中里,13,1,907,9,916,1529,3,1,3,0,1,0,59.91
新竹市,東區,復中里,14,1,934,10,944,1567,3,1,3,0,1,0,60.24
新竹市,東區,復興里,15,1,597,8,605,1085,3,1,3,0,1,0,55.76
新竹市,東區,復興里,16,1,794,12,806,1303,3,1,3,0,1,0,61.86
新竹市,東區,三民里,17,1,682,9,691,1146,3,1,3,0,1,0,60.30
新竹市,東區,三民里,18,1,846,7,853,1332,3,1,3,0,1,0,64.04
新竹市,東區,三民里,19,1,644,8,652,1082,3,1,3,0,1,0,60.26
新竹市,東區,東園里,20,1,483,7,490,799,3,1,3,0,1,0,61.33
新竹市,東區,東園里,21,1,661,3,664,1070,3,1,3,0,1,0,62.06
新竹市,東區,公園里,22,1,510,2,512,888,3,1,3,0,1,0,57.66
新竹市,東區,公園里,23,1,558,6,564,917,3,1,3,0,1,0,61.50
新竹市,東區,建華里,24,1,700,8,708,1204,3,1,3,0,1,0,58.80
新竹市,東區,建華里,25,1,540,3,543,904,3,1,3,0,1,0,60.07
新竹市,東區,東山里,26,1,1023,11,1034,1677,3,1,3,0,1,0,61.66
新竹市,東區,東山里,27,1,655,5,660,1092,3,1,3,0,1,0,60.44
新竹市,東區,綠水里,28,1,765,9,774,1222,3,1,3,0,1,0,63.34
新竹市,東區,綠水里,29,1,926,11,937,1541,3,1,3,0,1,0,60.80
新竹市,東區,綠水里,30,1,713,6,719,1081,3,1,3,0,1,0,66.51
新竹市,東區,光復里,31,1,901,12,913,1620,3,1,3,0,1,0,56.36
新竹市,東區,東勢里,32,1,584,6,590,984,3,1,3,0,1,0,59.96
新竹市,東區,前溪里,33,1,689,21,710,1383,3,1,3,0,1,0,51.34
新竹市,東區,前溪里,34,1,464,14,478,821,3,1,3,0,1,0,58.22
新竹市,東區,水源里,35,1,802,18,820,1373,3,1,3,0,1,0,59.72
新竹市,東區,水源里,36,1,858,11,869,1430,3,1,3,0,1,0,60.77
新竹市,東區,千甲里,37,1,867,26,893,1394,3,1,3,0,1,0,64.06
新竹市,東區,豐功里,38,1,928,11,939,1491,3,1,3,0,1,0,62.98
新竹市,東區,豐功里,39,1,815,11,826,1222,3,1,3,0,1,0,67.59
新竹市,東區,偉功里,40,1,519,4,523,785,3,1,3,0,1,0,66.62
新竹市,東區,武功里,41,1,320,6,326,539,3,1,3,0,1,0,60.48
新竹市,東區,軍功里,42,1,952,14,966,1385,3,1,3,0,1,0,69.75
新竹市,東區,軍功里,43,1,1020,9,1029,1562,3,1,3,0,1,0,65.88
新竹市,東區,立功里,44,1,833,14,847,1249,3,1,3,0,1,0,67.81
新竹市,東區,建功里,45,1,1101,15,1116,1580,3,1,3,0,1,0,70.63
新竹市,東區,建功里,46,1,532,2,534,764,3,1,3,0,1,0,69.90
新竹市,東區,光明里,47,1,671,5,676,1071,3,1,3,0,1,0,63.12
新竹市,東區,光明里,48,1,431,1,432,659,3,1,3,0,1,0,65.55
新竹市,東區,光明里,49,1,474,4,478,761,3,1,3,0,1,0,62.81
新竹市,東區,龍山里,50,1,744,7,751,1203,3,1,3,0,1,0,62.43
新竹市,東區,龍山里,51,1,515,7,522,794,3,1,3,0,1,0,65.74
新竹市,東區,科園里,52,1,954,6,960,1465,3,1,3,0,1,0,65.53
新竹市,東區,科園里,53,1,984,10,994,1509,3,1,3,0,1,0,65.87
新竹市,東區,科園里,54,1,851,11,862,1250,3,1,3,0,1,0,68.96
新竹市,東區,埔頂里,55,1,985,23,1008,1730,3,1,3,0,1,0,58.27
新竹市,東區,新莊里,56,1,1015,11,1026,1761,3,1,3,0,1,0,58.26
新竹市,東區,新莊里,57,1,1189,22,1211,1900,3,1,3,0,1,0,63.74
新竹市,東區,關東里,58,1,1026,17,1043,1725,3,1,3,0,1,0,60.46
新竹市,東區,關東里,59,1,841,10,851,1404,3,1,3,0,1,0,60.61
新竹市,東區,金山里,60,1,382,1,383,681,3,1,3,0,1,0,56.24
新竹市,東區,金山里,61,1,480,5,485,740,3,1,3,0,1,0,65.54
新竹市,東區,金山里,62,1,616,8,624,906,3,1,3,0,1,0,68.87
新竹市,東區,仙水里,63,1,685,7,692,1148,3,1,3,0,1,0,60.28
新竹市,東區,仙水里,64,1,711,6,717,1131,3,1,3,0,1,0,63.40
新竹市,東區,仙宮里,65,1,297,5,302,532,3,1,3,0,1,0,56.77
新竹市,東區,關帝里,66,1,365,6,371,668,3,1,3,0,1,0,55.54
新竹市,東區,南門里,67,1,410,5,415,690,3,1,3,0,1,0,60.14
新竹市,東區,南市里,68,1,569,11,580,981,3,1,3,0,1,0,59.12
新竹市,東區,福德里,69,1,733,12,745,1248,3,1,3,0,1,0,59.70
新竹市,東區,振興里,70,1,651,8,659,1134,3,1,3,0,1,0,58.11
新竹市,東區,振興里,71,1,760,9,769,1345,3,1,3,0,1,0,57.17
新竹市,東區,振興里,72,1,535,8,543,1009,3,1,3,0,1,0,53.82
新竹市,東區,新興里,73,1,941,18,959,1575,3,1,3,0,1,0,60.89
新竹市,東區,新興里,74,1,857,13,870,1551,3,1,3,0,1,0,56.09
新竹市,東區,寺前里,75,1,466,6,472,862,3,1,3,0,1,0,54.76
新竹市,東區,竹蓮里,76,1,530,5,535,896,3,1,3,0,1,0,59.71
新竹市,東區,下竹里,77,1,809,14,823,1305,3,1,3,0,1,0,63.07
新竹市,東區,頂竹里,78,1,875,9,884,1547,3,1,3,0,1,0,57.14
新竹市,東區,頂竹里,79,1,891,7,898,1566,3,1,3,0,1,0,57.34
新竹市,東區,南大里,80,1,354,5,359,719,3,1,3,0,1,0,49.93
新竹市,東區,南大里,81,1,526,9,535,960,3,1,3,0,1,0,55.73
新竹市,東區,新光里,82,1,721,12,733,1338,3,1,3,0,1,0,54.78
新竹市,東區,新光里,83,1,632,7,639,1021,3,1,3,0,1,0,62.59
新竹市,東區,光鎮里,84,1,728,13,741,1285,3,1,3,0,1,0,57.67
新竹市,東區,光鎮里,85,1,771,12,783,1336,3,1,3,0,1,0,58.61
新竹市,東區,高峰里,86,1,1079,12,1091,1801,3,1,3,0,1,0,60.58
新竹市,東區,高峰里,87,1,577,8,585,1073,3,1,3,0,1,0,54.52
新竹市,東區,高峰里,88,1,643,8,651,1197,3,1,3,0,1,0,54.39
新竹市,東區,柴橋里,89,1,721,6,727,1391,3,1,3,0,1,0,52.26
新竹市,東區,柴橋里,90,1,599,6,605,1022,3,1,3,0,1,0,59.20
新竹市,東區,柴橋里,91,1,715,7,722,1192,3,1,3,0,1,0,60.57
新竹市,東區,柴橋里,92,1,838,14,852,1575,3,1,3,0,1,0,54.10
新竹市,北區,西門里,93,1,314,3,317,558,3,1,3,0,1,0,56.81
新竹市,北區,仁德里,94,1,446,2,448,771,3,1,3,0,1,0,58.11
新竹市,北區,中央里,95,1,359,2,361,601,3,1,3,0,1,0,60.07
新竹市,北區,石坊里,96,1,298,4,302,499,3,1,3,0,1,0,60.52
新竹市,北區,潛園里,97,1,524,11,535,938,3,1,3,0,1,0,57.04
新竹市,北區,崇禮里,98,1,699,7,706,1112,3,1,3,0,1,0,63.49
新竹市,北區,興南里,99,1,809,8,817,1374,3,1,3,0,1,0,59.46
新竹市,北區,育英里,100,1,413,5,418,708,3,1,3,0,1,0,59.04
新竹市,北區,育英里,101,1,897,12,909,1538,3,1,3,0,1,0,59.10
新竹市,北區,育英里,102,1,850,14,864,1535,3,1,3,0,1,0,56.29
新竹市,北區,曲溪里,103,1,510,6,516,892,3,1,3,0,1,0,57.85
新竹市,北區,曲溪里,104,1,1122,22,1144,1845,3,1,3,0,1,0,62.01
新竹市,北區,曲溪里,105,1,465,17,482,593,3,1,3,0,1,0,81.28
新竹市,北區,曲溪里,106,1,572,10,582,797,3,1,3,0,1,0,73.02
新竹市,北區,曲溪里,107,1,681,8,689,1216,3,1,3,0,1,0,56.66
新竹市,北區,西雅里,108,1,649,9,658,1161,3,1,3,0,1,0,56.68
新竹市,北區,西雅里,109,1,720,8,728,1289,3,1,3,0,1,0,56.48
新竹市,北區,客雅里,110,1,595,5,600,925,3,1,3,0,1,0,64.86
新竹市,北區,客雅里,111,1,753,2,755,1088,3,1,3,0,1,0,69.39
新竹市,北區,客雅里,112,1,631,13,644,1181,3,1,3,0,1,0,54.53
新竹市,北區,南勢里,113,1,537,8,545,886,3,1,3,0,1,0,61.51
新竹市,北區,南勢里,114,1,764,13,777,1263,3,1,3,0,1,0,61.52
新竹市,北區,南勢里,115,1,557,7,564,946,3,1,3,0,1,0,59.62
新竹市,北區,大鵬里,116,1,699,14,713,947,3,1,3,0,1,0,75.29
新竹市,北區,大鵬里,117,1,579,2,581,744,3,1,3,0,1,0,78.09
新竹市,北區,大同里,118,1,511,4,515,862,3,1,3,0,1,0,59.74
新竹市,北區,中山里,119,1,423,3,426,696,3,1,3,0,1,0,61.21
新竹市,北區,中興里,120,1,335,6,341,625,3,1,3,0,1,0,54.56
新竹市,北區,新民里,121,1,731,14,745,1299,3,1,3,0,1,0,57.35
新竹市,北區,長和里,122,1,582,10,592,960,3,1,3,0,1,0,61.67
新竹市,北區,北門里,123,1,578,5,583,995,3,1,3,0,1,0,58.59
新竹市,北區,民富里,124,1,643,7,650,1156,3,1,3,0,1,0,56.23
新竹市,北區,民富里,125,1,746,9,755,1346,3,1,3,0,1,0,56.09
新竹市,北區,民富里,126,1,700,7,707,1463,3,1,3,0,1,0,48.33
新竹市,北區,磐石里,127,1,828,9,837,1525,3,1,3,0,1,0,54.89
新竹市,北區,磐石里,128,1,874,14,888,1550,3,1,3,0,1,0,57.29
新竹市,北區,新雅里,129,1,772,15,787,1293,3,1,3,0,1,0,60.87
新竹市,北區,新雅里,130,1,694,9,703,1181,3,1,3,0,1,0,59.53
新竹市,北區,新雅里,131,1,431,3,434,803,3,1,3,0,1,0,54.05
新竹市,北區,文雅里,132,1,799,10,809,1336,3,1,3,0,1,0,60.55
新竹市,北區,文雅里,133,1,867,12,879,1381,3,1,3,0,1,0,63.65
新竹市,北區,水田里,134,1,662,8,670,1077,3,1,3,0,1,0,62.21
新竹市,北區,水田里,135,1,666,4,670,1178,3,1,3,0,1,0,56.88
新竹市,北區,光田里,136,1,576,11,587,1009,3,1,3,0,1,0,58.18
新竹市,北區,光田里,137,1,637,13,650,1042,3,1,3,0,1,0,62.38
新竹市,北區,光華里,138,1,738,8,746,1378,3,1,3,0,1,0,54.14
新竹市,北區,光華里,139,1,543,7,550,944,3,1,3,0,1,0,58.26
新竹市,北區,金華里,140,1,715,3,718,1352,3,1,3,0,1,0,53.11
新竹市,北區,金華里,141,1,758,13,771,1259,3,1,3,0,1,0,61.24
新竹市,北區,湳雅里,142,1,770,10,780,1306,3,1,3,0,1,0,59.72
新竹市,北區,湳雅里,143,1,864,16,880,1510,3,1,3,0,1,0,58.28
新竹市,北區,湳雅里,144,1,665,11,676,1201,3,1,3,0,1,0,56.29
新竹市,北區,舊社里,145,1,908,15,923,1588,3,1,3,0,1,0,58.12
新竹市,北區,舊社里,146,1,862,12,874,1373,3,1,3,0,1,0,63.66
新竹市,北區,金竹里,147,1,869,8,877,1486,3,1,3,0,1,0,59.02
新竹市,北區,金竹里,148,1,819,11,830,1379,3,1,3,0,1,0,60.19
新竹市,北區,武陵里,149,1,697,5,702,981,3,1,3,0,1,0,71.56
新竹市,北區,武陵里,150,1,85,1,86,166,3,1,3,0,1,0,51.81
新竹市,北區,福林里,151,1,710,8,718,1129,3,1,3,0,1,0,63.60
新竹市,北區,福林里,152,1,863,21,884,1474,3,1,3,0,1,0,59.97
新竹市,北區,境福里,153,1,821,15,836,1525,3,1,3,0,1,0,54.82
新竹市,北區,境福里,154,1,832,13,845,1368,3,1,3,0,1,0,61.77
新竹市,北區,士林里,155,1,681,5,686,1149,3,1,3,0,1,0,59.70
新竹市,北區,士林里,156,1,630,4,634,883,3,1,3,0,1,0,71.80
新竹市,北區,士林里,157,1,626,6,632,895,3,1,3,0,1,0,70.61
新竹市,北區,古賢里,158,1,430,12,442,757,3,1,3,0,1,0,58.39
新竹市,北區,南寮里,159,1,842,15,857,1615,3,1,3,0,1,0,53.07
新竹市,北區,南寮里,160,1,720,7,727,1517,3,1,3,0,1,0,47.92
新竹市,北區,康樂里,161,1,739,8,747,1240,3,1,3,0,1,0,60.24
新竹市,北區,中寮里,162,1,503,9,512,847,3,1,3,0,1,0,60.45
新竹市,北區,海濱里,163,1,628,10,638,1185,3,1,3,0,1,0,53.84
新竹市,北區,港北里,164,1,567,7,574,1014,3,1,3,0,1,0,56.61
新竹市,北區,舊港里,165,1,314,4,318,516,3,1,3,0,1,0,61.63
新竹市,香山區,頂埔里,166,1,719,3,722,1325,3,1,3,0,1,0,54.49
新竹市,香山區,頂埔里,167,1,747,14,761,1282,3,1,3,0,1,0,59.36
新竹市,香山區,頂埔里,168,1,940,16,956,1569,3,1,3,0,1,0,60.93
新竹市,香山區,中埔里,169,1,496,8,504,852,3,1,3,0,1,0,59.15
新竹市,香山區,中埔里,170,1,568,8,576,972,3,1,3,0,1,0,59.26
新竹市,香山區,牛埔里,171,1,742,10,752,1350,3,1,3,0,1,0,55.70
新竹市,香山區,埔前里,172,1,551,2,553,999,3,1,3,0,1,0,55.36
新竹市,香山區,埔前里,173,1,574,8,582,1005,3,1,3,0,1,0,57.91
新竹市,香山區,樹下里,174,1,427,4,431,759,3,1,3,0,1,0,56.79
新竹市,香山區,樹下里,175,1,479,6,485,815,3,1,3,0,1,0,59.51
新竹市,香山區,浸水里,176,1,719,15,734,1293,3,1,3,0,1,0,56.77
新竹市,香山區,虎林里,177,1,845,10,855,1445,3,1,3,0,1,0,59.17
新竹市,香山區,虎山里,178,1,571,10,581,1064,3,1,3,0,1,0,54.61
新竹市,香山區,虎山里,179,1,551,6,557,1098,3,1,3,0,1,0,50.73
新竹市,香山區,虎山里,180,1,745,11,756,1493,3,1,3,0,1,0,50.64
新竹市,香山區,港南里,181,1,486,4,490,847,3,1,3,0,1,0,57.85
新竹市,香山區,港南里,182,1,401,8,409,713,3,1,3,0,1,0,57.36
新竹市,香山區,東香里,183,1,528,4,532,1044,3,1,3,0,1,0,50.96
新竹市,香山區,香村里,184,1,764,14,778,1484,3,1,3,0,1,0,52.43
新竹市,香山區,香山里,185,1,594,6,600,1054,3,1,3,0,1,0,56.93
新竹市,香山區,香山里,186,1,678,9,687,1204,3,1,3,0,1,0,57.06
新竹市,香山區,大庄里,187,1,890,10,900,1549,3,1,3,0,1,0,58.10
新竹市,香山區,美山里,188,1,475,3,478,884,3,1,3,0,1,0,54.07
新竹市,香山區,朝山里,189,1,798,11,809,1427,3,1,3,0,1,0,56.69
新竹市,香山區,海山里,190,1,722,20,742,1293,3,1,3,0,1,0,57.39
新竹市,香山區,鹽水里,191,1,555,4,559,935,3,1,3,0,1,0,59.79
新竹市,香山區,內湖里,192,1,708,11,719,1253,3,1,3,0,1,0,57.38
新竹市,香山區,內湖里,193,1,672,11,683,1348,3,1,3,0,1,0,50.67
新竹市,香山區,南港里,194,1,421,4,425,677,3,1,3,0,1,0,62.78
新竹市,香山區,中隘里,195,1,604,14,618,1053,3,1,3,0,1,0,58.69
新竹市,香山區,南隘里,196,1,347,5,352,577,3,1,3,0,1,0,61.01
新竹市,香山區,大湖里,197,1,384,10,394,643,3,1,3,0,1,0,61.28
新竹市,香山區,茄苳里,198,1,330,8,338,654,3,1,3,0,1,0,51.68
臺中市,中區,中山里,1,1,602,7,609,966,3,1,3,0,1,0,63.04
臺中市,中區,南京里,2,1,678,3,681,1083,3,1,3,0,1,0,62.88
臺中市,中區,繼光里,3,1,784,4,788,1296,3,1,3,0,1,0,60.80
臺中市,中區,自由里,4,1,950,10,960,1584,3,1,3,0,1,0,60.61
臺中市,中區,重慶里,5,1,647,6,653,993,3,1,3,0,1,0,65.76
臺中市,中區,錦上里,6,1,945,10,955,1390,3,1,3,0,1,0,68.71
臺中市,中區,錦花里,7,1,835,1,836,1310,3,1,3,0,1,0,63.82
臺中市,中區,大墩里,8,1,944,7,951,1442,3,1,3,0,1,0,65.95
臺中市,中區,中墩里,9,1,765,15,780,1238,3,1,3,0,1,0,63.00
臺中市,中區,正音里,10,1,745,10,755,1114,3,1,3,0,1,0,67.77
臺中市,中區,柳原里,11,1,733,10,743,1125,3,1,3,0,1,0,66.04
臺中市,中區,光音里,12,1,807,12,819,1307,3,1,3,0,1,0,62.66
臺中市,中區,博松里,13,1,903,7,910,1301,3,1,3,0,1,0,69.95
臺中市,中區,中政里,14,1,754,17,771,1267,3,1,3,0,1,0,60.85
臺中市,東區,新庄里,15,1,734,7,741,1123,3,1,3,0,1,0,65.98
臺中市,東區,立德里,16,1,428,6,434,624,3,1,3,0,1,0,69.55
臺中市,東區,朱文里,17,1,646,6,652,998,3,1,3,0,1,0,65.33
臺中市,東區,翰第里,18,1,669,6,675,1044,3,1,3,0,1,0,64.66
臺中市,東區,振興里,19,1,783,10,793,1283,3,1,3,0,1,0,61.81
臺中市,東區,曙峰里,20,1,762,7,769,1178,3,1,3,0,1,0,65.28
臺中市,東區,頂峰里,21,1,878,6,884,1298,3,1,3,0,1,0,68.10
臺中市,東區,忠孝里,22,1,663,7,670,992,3,1,3,0,1,0,67.54
臺中市,東區,東橋里,23,1,742,7,749,1165,3,1,3,0,1,0,64.29
臺中市,東區,東橋里,24,1,706,12,718,1113,3,1,3,0,1,0,64.51
臺中市,東區,東橋里,25,1,776,7,783,1271,3,1,3,0,1,0,61.61
臺中市,東區,東興里,26,1,650,7,657,908,3,1,3,0,1,0,72.36
臺中市,東區,東興里,27,1,643,12,655,1023,3,1,3,0,1,0,64.03
臺中市,東區,樂業里,28,1,689,14,703,1014,3,1,3,0,1,0,69.33
臺中市,東區,泉源里,29,1,634,7,641,916,3,1,3,0,1,0,69.98
臺中市,東區,文化里,30,1,767,9,776,1213,3,1,3,0,1,0,63.97
臺中市,東區,干城里,31,1,540,5,545,842,3,1,3,0,1,0,64.73
臺中市,東區,旱溪里,32,1,709,8,717,1070,3,1,3,0,1,0,67.01
臺中市,東區,樂成里,33,1,950,14,964,1384,3,1,3,0,1,0,69.65
臺中市,東區,東門里,34,1,915,9,924,1337,3,1,3,0,1,0,69.11
臺中市,東區,東門里,35,1,510,8,518,793,3,1,3,0,1,0,65.32
臺中市,東區,東門里,36,1,1025,15,1040,1527,3,1,3,0,1,0,68.11
臺中市,東區,東信里,37,1,1039,21,1060,1593,3,1,3,0,1,0,66.54
臺中市,東區,東信里,38,1,1200,11,1211,1961,3,1,3,0,1,0,61.75
臺中市,東區,東信里,39,1,1124,14,1138,1768,3,1,3,0,1,0,64.37
臺中市,東區,十甲里,40,1,1022,15,1037,1631,3,1,3,0,1,0,63.58
臺中市,東區,十甲里,41,1,1008,7,1015,1477,3,1,3,0,1,0,68.72
臺中市,東區,東南里,42,1,538,5,543,828,3,1,3,0,1,0,65.58
臺中市,東區,東南里,43,1,507,5,512,843,3,1,3,0,1,0,60.74
臺中市,東區,東明里,44,1,540,5,545,884,3,1,3,0,1,0,61.65
臺中市,東區,東勢里,45,1,572,9,581,919,3,1,3,0,1,0,63.22
臺中市,東區,東勢里,46,1,1045,16,1061,1614,3,1,3,0,1,0,65.74
臺中市,東區,成功里,47,1,586,5,591,921,3,1,3,0,1,0,64.17
臺中市,東區,合作里,48,1,966,15,981,1476,3,1,3,0,1,0,66.46
臺中市,東區,合作里,49,1,1046,21,1067,1540,3,1,3,0,1,0,69.29
臺中市,東區,尚武里,50,1,672,9,681,967,3,1,3,0,1,0,70.42
臺中市,東區,富台里,51,1,439,4,443,756,3,1,3,0,1,0,58.60
臺中市,東區,富仁里,52,1,521,11,532,872,3,1,3,0,1,0,61.01
臺中市,東區,富仁里,53,1,1004,17,1021,1578,3,1,3,0,1,0,64.70
臺中市,東區,祖聖里,54,1,970,10,980,1483,3,1,3,0,1,0,66.08
臺中市,西區,福壽里,55,1,1053,11,1064,1538,3,1,3,0,1,0,69.18
臺中市,西區,光明里,56,1,727,6,733,1107,3,1,3,0,1,0,66.21
臺中市,西區,利民里,57,1,646,7,653,1024,3,1,3,0,1,0,63.77
臺中市,西區,利民里,58,1,710,2,712,1372,3,1,3,0,1,0,51.90
臺中市,西區,平和里,59,1,993,4,997,1522,3,1,3,0,1,0,65.51
臺中市,西區,公民里,60,1,760,6,766,1196,3,1,3,0,1,0,64.05
臺中市,西區,公民里,61,1,765,7,772,1172,3,1,3,0,1,0,65.87
臺中市,西區,公民里,62,1,760,3,763,1209,3,1,3,0,1,0,63.11
臺中市,西區,中民里,63,1,1089,8,1097,1550,3,1,3,0,1,0,70.77
臺中市,西區,藍興里,64,1,625,8,633,942,3,1,3,0,1,0,67.20
臺中市,西區,藍興里,65,1,930,11,941,1336,3,1,3,0,1,0,70.43
臺中市,西區,公舘里,66,1,802,7,809,1186,3,1,3,0,1,0,68.21
臺中市,西區,公舘里,67,1,764,19,783,1060,3,1,3,0,1,0,73.87
臺中市,西區,公舘里,68,1,1021,16,1037,1548,3,1,3,0,1,0,66.99
臺中市,西區,元龍里,69,1,554,6,560,856,3,1,3,0,1,0,65.42
臺中市,西區,和龍里,70,1,963,12,975,1571,3,1,3,0,1,0,62.06
臺中市,西區,三民里,71,1,742,3,745,1205,3,1,3,0,1,0,61.83
臺中市,西區,三民里,72,1,889,8,897,1317,3,1,3,0,1,0,68.11
臺中市,西區,東昇里,73,1,551,2,553,847,3,1,3,0,1,0,65.29
臺中市,西區,東昇里,74,1,544,5,549,834,3,1,3,0,1,0,65.83
臺中市,西區,廣民里,75,1,953,6,959,1444,3,1,3,0,1,0,66.41
臺中市,西區,民龍里,76,1,631,5,636,959,3,1,3,0,1,0,66.32
臺中市,西區,民龍里,77,1,514,5,519,832,3,1,3,0,1,0,62.38
臺中市,西區,福龍里,78,1,909,4,913,1381,3,1,3,0,1,0,66.11
臺中市,西區,靖龍里,79,1,601,6,607,962,3,1,3,0,1,0,63.10
臺中市,西區,靖龍里,80,1,521,2,523,851,3,1,3,0,1,0,61.46
臺中市,西區,雲龍里,81,1,613,3,616,1007,3,1,3,0,1,0,61.17
臺中市,西區,雲龍里,82,1,646,7,653,967,3,1,3,0,1,0,67.53
臺中市,西區,永龍里,83,1,648,7,655,891,3,1,3,0,1,0,73.51
臺中市,西區,安龍里,84,1,707,4,711,1108,3,1,3,0,1,0,64.17
臺中市,西區,安龍里,85,1,595,10,605,942,3,1,3,0,1,0,64.23
臺中市,西區,吉龍里,86,1,749,6,755,1129,3,1,3,0,1,0,66.87
臺中市,西區,吉龍里,87,1,1020,14,1034,1583,3,1,3,0,1,0,65.32
臺中市,西區,吉龍里,88,1,985,10,995,1567,3,1,3,0,1,0,63.50
臺中市,西區,昇平里,89,1,825,2,827,1197,3,1,3,0,1,0,69.09
臺中市,西區,昇平里,90,1,699,7,706,1105,3,1,3,0,1,0,63.89
臺中市,西區,昇平里,91,1,588,9,597,1029,3,1,3,0,1,0,58.02
臺中市,西區,忠明里,92,1,756,6,762,1184,3,1,3,0,1,0,64.36
臺中市,西區,忠明里,93,1,835,16,851,1352,3,1,3,0,1,0,62.94
臺中市,西區,忠明里,94,1,897,8,905,1442,3,1,3,0,1,0,62.76
臺中市,西區,忠誠里,95,1,754,6,760,1203,3,1,3,0,1,0,63.18
臺中市,西區,忠誠里,96,1,695,2,697,1125,3,1,3,0,1,0,61.96
臺中市,西區,忠誠里,97,1,922,7,929,1378,3,1,3,0,1,0,67.42
臺中市,西區,忠誠里,98,1,622,3,625,953,3,1,3,0,1,0,65.58
臺中市,西區,公正里,99,1,898,14,912,1422,3,1,3,0,1,0,64.14
臺中市,西區,公正里,100,1,839,10,849,1243,3,1,3,0,1,0,68.30
臺中市,西區,公正里,101,1,696,11,707,1156,3,1,3,0,1,0,61.16
臺中市,西區,公正里,102,1,702,9,711,1158,3,1,3,0,1,0,61.40
臺中市,西區,公正里,103,1,1013,11,1024,1630,3,1,3,0,1,0,62.82
臺中市,西區,公正里,104,1,697,8,705,1071,3,1,3,0,1,0,65.83
臺中市,西區,公益里,105,1,852,11,863,1271,3,1,3,0,1,0,67.90
臺中市,西區,公益里,106,1,847,17,864,1234,3,1,3,0,1,0,70.02
臺中市,西區,中興里,107,1,536,6,542,797,3,1,3,0,1,0,68.01
臺中市,西區,中興里,108,1,645,6,651,974,3,1,3,0,1,0,66.84
臺中市,西區,中興里,109,1,706,7,713,1043,3,1,3,0,1,0,68.36
臺中市,西區,土庫里,110,1,1203,21,1224,1805,3,1,3,0,1,0,67.81
臺中市,西區,土庫里,111,1,774,4,778,1194,3,1,3,0,1,0,65.16
臺中市,西區,土庫里,112,1,1030,8,1038,1640,3,1,3,0,1,0,63.29
臺中市,西區,土庫里,113,1,700,7,707,1082,3,1,3,0,1,0,65.34
臺中市,南區,南興里,114,1,488,4,492,750,3,1,3,0,1,0,65.60
臺中市,南區,正義里,115,1,543,8,551,865,3,1,3,0,1,0,63.70
臺中市,南區,民主里,116,1,650,5,655,995,3,1,3,0,1,0,65.83
臺中市,南區,復興里,117,1,1074,11,1085,1579,3,1,3,0,1,0,68.71
臺中市,南區,萬安里,118,1,772,11,783,1159,3,1,3,0,1,0,67.56
臺中市,南區,信義里,119,1,698,9,707,1059,3,1,3,0,1,0,66.76
臺中市,南區,城隍里,120,1,939,5,944,1488,3,1,3,0,1,0,63.44
臺中市,南區,中南里,121,1,744,3,747,1147,3,1,3,0,1,0,65.13
臺中市,南區,國光里,122,1,997,11,1008,1600,3,1,3,0,1,0,63.00
臺中市,南區,國光里,123,1,1021,11,1032,1581,3,1,3,0,1,0,65.28
臺中市,南區,南門里,124,1,899,6,905,1434,3,1,3,0,1,0,63.11
臺中市,南區,南門里,125,1,1020,11,1031,1586,3,1,3,0,1,0,65.01
臺中市,南區,德義里,126,1,619,7,626,920,3,1,3,0,1,0,68.04
臺中市,南區,德義里,127,1,775,9,784,1131,3,1,3,0,1,0,69.32
臺中市,南區,積善里,128,1,652,6,658,1158,3,1,3,0,1,0,56.82
臺中市,南區,積善里,129,1,946,24,970,1517,3,1,3,0,1,0,63.94
臺中市,南區,江川里,130,1,1159,12,1171,1720,3,1,3,0,1,0,68.08
臺中市,南區,新榮里,131,1,808,5,813,1270,3,1,3,0,1,0,64.02
臺中市,南區,福興里,132,1,715,6,721,1070,3,1,3,0,1,0,67.38
臺中市,南區,福興里,133,1,758,7,765,1149,3,1,3,0,1,0,66.58
臺中市,南區,福平里,134,1,834,8,842,1291,3,1,3,0,1,0,65.22
臺中市,南區,福平里,135,1,1012,11,1023,1644,3,1,3,0,1,0,62.23
臺中市,南區,福平里,136,1,961,18,979,1528,3,1,3,0,1,0,64.07
臺中市,南區,福平里,137,1,764,5,769,1233,3,1,3,0,1,0,62.37
臺中市,南區,和平里,138,1,946,9,955,1546,3,1,3,0,1,0,61.77
臺中市,南區,和平里,139,1,930,14,944,1502,3,1,3,0,1,0,62.85
臺中市,南區,和平里,140,1,1234,21,1255,1854,3,1,3,0,1,0,67.69
臺中市,南區,永興里,141,1,1004,7,1011,1768,3,1,3,0,1,0,57.18
臺中市,南區,永興里,142,1,802,9,811,1286,3,1,3,0,1,0,63.06
臺中市,南區,永興里,143,1,711,9,720,1154,3,1,3,0,1,0,62.39
臺中市,南區,樹義里,144,1,960,15,975,1528,3,1,3,0,1,0,63.81
臺中市,南區,樹義里,145,1,993,10,1003,1534,3,1,3,0,1,0,65.38
臺中市,南區,樹義里,146,1,949,11,960,1621,3,1,3,0,1,0,59.22
臺中市,南區,樹德里,147,1,1188,14,1202,1892,3,1,3,0,1,0,63.53
臺中市,南區,西川里,148,1,1061,17,1078,1670,3,1,3,0,1,0,64.55
臺中市,南區,西川里,149,1,933,10,943,1474,3,1,3,0,1,0,63.98
臺中市,南區,西川里,150,1,956,14,970,1461,3,1,3,0,1,0,66.39
臺中市,北區,高風里,151,1,1038,10,1048,1496,3,1,3,0,1,0,70.05
臺中市,北區,高平里,152,1,579,7,586,882,3,1,3,0,1,0,66.44
臺中市,北區,大安里,153,1,710,8,718,1075,3,1,3,0,1,0,66.79
臺中市,北區,光榮里,154,1,504,9,513,893,3,1,3,0,1,0,57.45
臺中市,北區,光大里,155,1,720,10,730,1095,3,1,3,0,1,0,66.67
臺中市,北區,光大里,156,1,507,7,514,839,3,1,3,0,1,0,61.26
臺中市,北區,文莊里,157,1,663,12,675,1045,3,1,3,0,1,0,64.59
臺中市,北區,文莊里,158,1,579,4,583,949,3,1,3,0,1,0,61.43
臺中市,北區,湖北里,159,1,658,11,669,1082,3,1,3,0,1,0,61.83
臺中市,北區,中湖里,160,1,487,7,494,709,3,1,3,0,1,0,69.68
臺中市,北區,平等里,161,1,615,3,618,980,3,1,3,0,1,0,63.06
臺中市,北區,五常里,162,1,951,13,964,1563,3,1,3,0,1,0,61.68
臺中市,北區,仁和里,163,1,556,8,564,837,3,1,3,0,1,0,67.38
臺中市,北區,錦和里,164,1,673,11,684,1030,3,1,3,0,1,0,66.41
臺中市,北區,新興里,165,1,775,6,781,1251,3,1,3,0,1,0,62.43
臺中市,北區,武順里,166,1,611,5,616,1000,3,1,3,0,1,0,61.60
臺中市,北區,新北里,167,1,901,12,913,1383,3,1,3,0,1,0,66.02
臺中市,北區,新北里,168,1,642,7,649,1039,3,1,3,0,1,0,62.46
臺中市,北區,樂英里,169,1,767,4,771,1112,3,1,3,0,1,0,69.33
臺中市,北區,樂英里,170,1,868,6,874,1239,3,1,3,0,1,0,70.54
臺中市,北區,樂英里,171,1,606,8,614,965,3,1,3,0,1,0,63.63
臺中市,北區,錦村里,172,1,623,3,626,927,3,1,3,0,1,0,67.53
臺中市,北區,錦村里,173,1,663,7,670,978,3,1,3,0,1,0,68.51
臺中市,北區,錦村里,174,1,735,2,737,1154,3,1,3,0,1,0,63.86
臺中市,北區,建成里,175,1,765,7,772,1197,3,1,3,0,1,0,64.49
臺中市,北區,建成里,176,1,719,13,732,1102,3,1,3,0,1,0,66.42
臺中市,北區,建成里,177,1,718,10,728,1045,3,1,3,0,1,0,69.67
臺中市,北區,建成里,178,1,839,6,845,1361,3,1,3,0,1,0,62.09
臺中市,北區,建成里,179,1,848,15,863,1502,3,1,3,0,1,0,57.46
臺中市,北區,錦洲里,180,1,1006,7,1013,1492,3,1,3,0,1,0,67.90
臺中市,北區,錦洲里,181,1,845,6,851,1348,3,1,3,0,1,0,63.13
臺中市,北區,錦祥里,182,1,910,6,916,1585,3,1,3,0,1,0,57.79
臺中市,北區,錦祥里,183,1,847,6,853,1398,3,1,3,0,1,0,61.02
臺中市,北區,金華里,184,1,1017,8,1025,1553,3,1,3,0,1,0,66.00
臺中市,北區,金龍里,185,1,872,7,879,1371,3,1,3,0,1,0,64.11
臺中市,北區,金龍里,186,1,872,8,880,1416,3,1,3,0,1,0,62.15
臺中市,北區,金龍里,187,1,937,7,944,1412,3,1,3,0,1,0,66.86
臺中市,北區,邱厝里,188,1,723,2,725,1173,3,1,3,0,1,0,61.81
臺中市,北區,邱厝里,189,1,590,5,595,1062,3,1,3,0,1,0,56.03
臺中市,北區,建興里,190,1,1005,13,1018,1628,3,1,3,0,1,0,62.53
臺中市,北區,建興里,191,1,917,7,924,1420,3,1,3,0,1,0,65.07
臺中市,北區,建興里,192,1,912,8,920,1485,3,1,3,0,1,0,61.95
臺中市,北區,頂厝里,193,1,688,12,700,1052,3,1,3,0,1,0,66.54
臺中市,北區,頂厝里,194,1,803,7,810,1264,3,1,3,0,1,0,64.08
臺中市,北區,頂厝里,195,1,681,3,684,1055,3,1,3,0,1,0,64.83
臺中市,北區,頂厝里,196,1,792,6,798,1340,3,1,3,0,1,0,59.55
臺中市,北區,賴厝里,197,1,1140,10,1150,1687,3,1,3,0,1,0,68.17
臺中市,北區,賴厝里,198,1,1015,10,1025,1577,3,1,3,0,1,0,65.00
臺中市,北區,賴明里,199,1,758,9,767,1234,3,1,3,0,1,0,62.16
臺中市,北區,賴明里,200,1,804,2,806,1247,3,1,3,0,1,0,64.64
臺中市,北區,賴明里,201,1,731,12,743,1182,3,1,3,0,1,0,62.86
臺中市,北區,賴興里,202,1,645,10,655,1153,3,1,3,0,1,0,56.81
臺中市,北區,賴興里,203,1,715,8,723,1185,3,1,3,0,1,0,61.01
臺中市,北區,賴興里,204,1,697,8,705,1104,3,1,3,0,1,0,63.86
臺中市,北區,賴興里,205,1,718,8,726,1207,3,1,3,0,1,0,60.15
臺中市,北區,賴村里,206,1,644,14,658,1034,3,1,3,0,1,0,63.64
臺中市,北區,賴村里,207,1,656,10,666,1103,3,1,3,0,1,0,60.38
臺中市,北區,賴村里,208,1,746,6,752,1160,3,1,3,0,1,0,64.83
臺中市,北區,育德里,209,1,864,7,871,1388,3,1,3,0,1,0,62.75
臺中市,北區,育德里,210,1,869,13,882,1404,3,1,3,0,1,0,62.82
臺中市,北區,淡溝里,211,1,548,7,555,913,3,1,3,0,1,0,60.79
臺中市,北區,淡溝里,212,1,622,7,629,1018,3,1,3,0,1,0,61.79
臺中市,北區,淡溝里,213,1,789,7,796,1212,3,1,3,0,1,0,65.68
臺中市,北區,健行里,214,1,755,3,758,1139,3,1,3,0,1,0,66.55
臺中市,北區,健行里,215,1,836,8,844,1275,3,1,3,0,1,0,66.20
臺中市,北區,健行里,216,1,856,14,870,1349,3,1,3,0,1,0,64.49
臺中市,北區,健行里,217,1,800,7,807,1273,3,1,3,0,1,0,63.39
臺中市,北區,明德里,218,1,996,9,1005,1566,3,1,3,0,1,0,64.18
臺中市,北區,明德里,219,1,1058,10,1068,1743,3,1,3,0,1,0,61.27
臺中市,北區,明德里,220,1,818,6,824,1272,3,1,3,0,1,0,64.78
臺中市,北區,明德里,221,1,661,9,670,1048,3,1,3,0,1,0,63.93
臺中市,北區,長青里,222,1,1029,7,1036,1722,3,1,3,0,1,0,60.16
臺中市,北區,長青里,223,1,990,10,1000,1641,3,1,3,0,1,0,60.94
臺中市,北區,長青里,224,1,926,10,936,1549,3,1,3,0,1,0,60.43
臺中市,北區,長青里,225,1,863,4,867,1413,3,1,3,0,1,0,61.36
臺中市,北區,中達里,226,1,770,8,778,1286,3,1,3,0,1,0,60.50
臺中市,北區,中達里,227,1,880,5,885,1377,3,1,3,0,1,0,64.27
臺中市,西屯區,西安里,228,1,1044,8,1052,1465,3,1,3,0,1,0,71.81
臺中市,西屯區,西安里,229,1,1024,9,1033,1546,3,1,3,0,1,0,66.82
臺中市,西屯區,西安里,230,1,927,9,936,1395,3,1,3,0,1,0,67.10
臺中市,西屯區,西平里,231,1,702,14,716,1108,3,1,3,0,1,0,64.62
臺中市,西屯區,西平里,232,1,774,11,785,1233,3,1,3,0,1,0,63.67
臺中市,西屯區,西平里,233,1,883,10,893,1182,3,1,3,0,1,0,75.55
臺中市,西屯區,西墩里,234,1,1141,15,1156,1613,3,1,3,0,1,0,71.67
臺中市,西屯區,西墩里,235,1,1096,10,1106,1580,3,1,3,0,1,0,70.00
臺中市,西屯區,潮洋里,236,1,741,10,751,1052,3,1,3,0,1,0,71.39
臺中市,西屯區,龍潭里,237,1,676,10,686,883,3,1,3,0,1,0,77.69
臺中市,西屯區,惠來里,238,1,1058,9,1067,1518,3,1,3,0,1,0,70.29
臺中市,西屯區,惠來里,239,1,1000,18,1018,1456,3,1,3,0,1,0,69.92
臺中市,西屯區,上石里,240,1,872,9,881,1294,3,1,3,0,1,0,68.08
臺中市,西屯區,上石里,241,1,1103,10,1113,1742,3,1,3,0,1,0,63.89
臺中市,西屯區,上石里,242,1,1005,13,1018,1564,3,1,3,0,1,0,65.09
臺中市,西屯區,逢甲里,243,1,970,15,985,1543,3,1,3,0,1,0,63.84
臺中市,西屯區,逢甲里,244,1,847,9,856,1243,3,1,3,0,1,0,68.87
臺中市,西屯區,逢甲里,245,1,805,10,815,1193,3,1,3,0,1,0,68.32
臺中市,西屯區,逢甲里,246,1,894,5,899,1284,3,1,3,0,1,0,70.02
臺中市,西屯區,鵬程里,247,1,754,11,765,989,3,1,3,0,1,0,77.35
臺中市,西屯區,鵬程里,248,1,735,9,744,955,3,1,3,0,1,0,77.91
臺中市,西屯區,何厝里,249,1,1010,6,1016,1596,3,1,3,0,1,0,63.66
臺中市,西屯區,何厝里,250,1,1035,8,1043,1587,3,1,3,0,1,0,65.72
臺中市,西屯區,何厝里,251,1,811,10,821,1372,3,1,3,0,1,0,59.84
臺中市,西屯區,何南里,252,1,1112,12,1124,1619,3,1,3,0,1,0,69.43
臺中市,西屯區,何南里,253,1,960,13,973,1476,3,1,3,0,1,0,65.92
臺中市,西屯區,何南里,254,1,801,11,812,1250,3,1,3,0,1,0,64.96
臺中市,西屯區,何安里,255,1,708,9,717,1046,3,1,3,0,1,0,68.55
臺中市,西屯區,何安里,256,1,767,2,769,1147,3,1,3,0,1,0,67.04
臺中市,西屯區,何安里,257,1,735,10,745,1103,3,1,3,0,1,0,67.54
臺中市,西屯區,何仁里,258,1,734,12,746,1168,3,1,3,0,1,0,63.87
臺中市,西屯區,何仁里,259,1,897,7,904,1319,3,1,3,0,1,0,68.54
臺中市,西屯區,何仁里,260,1,773,4,777,1246,3,1,3,0,1,0,62.36
臺中市,西屯區,何德里,261,1,907,3,910,1338,3,1,3,0,1,0,68.01
臺中市,西屯區,何德里,262,1,973,13,986,1514,3,1,3,0,1,0,65.13
臺中市,西屯區,何德里,263,1,887,5,892,1399,3,1,3,0,1,0,63.76
臺中市,西屯區,何源里,264,1,624,4,628,999,3,1,3,0,1,0,62.86
臺中市,西屯區,何源里,265,1,781,9,790,1234,3,1,3,0,1,0,64.02
臺中市,西屯區,何源里,266,1,892,11,903,1385,3,1,3,0,1,0,65.20
臺中市,西屯區,大河里,267,1,1053,15,1068,1538,3,1,3,0,1,0,69.44
臺中市,西屯區,大河里,268,1,1051,14,1065,1543,3,1,3,0,1,0,69.02
臺中市,西屯區,大石里,269,1,782,8,790,1019,3,1,3,0,1,0,77.53
臺中市,西屯區,大福里,270,1,948,22,970,1355,3,1,3,0,1,0,71.59
臺中市,西屯區,大福里,271,1,947,8,955,1317,3,1,3,0,1,0,72.51
臺中市,西屯區,大鵬里,272,1,890,6,896,1307,3,1,3,0,1,0,68.55
臺中市,西屯區,大鵬里,273,1,773,6,779,1193,3,1,3,0,1,0,65.30
臺中市,西屯區,大鵬里,274,1,776,8,784,1204,3,1,3,0,1,0,65.12
臺中市,西屯區,港尾里,275,1,686,6,692,838,3,1,3,0,1,0,82.58
臺中市,西屯區,港尾里,276,1,1019,13,1032,1494,3,1,3,0,1,0,69.08
臺中市,西屯區,港尾里,277,1,1173,18,1191,1629,3,1,3,0,1,0,73.11
臺中市,西屯區,廣福里,278,1,660,13,673,931,3,1,3,0,1,0,72.29
臺中市,西屯區,廣福里,279,1,595,9,604,842,3,1,3,0,1,0,71.73
臺中市,西屯區,林厝里,280,1,690,17,707,1015,3,1,3,0,1,0,69.66
臺中市,西屯區,林厝里,281,1,689,10,699,1004,3,1,3,0,1,0,69.62
臺中市,西屯區,永安里,282,1,946,9,955,1431,3,1,3,0,1,0,66.74
臺中市,西屯區,永安里,283,1,1019,10,1029,1580,3,1,3,0,1,0,65.13
臺中市,西屯區,福安里,284,1,669,8,677,1090,3,1,3,0,1,0,62.11
臺中市,西屯區,福安里,285,1,704,12,716,1087,3,1,3,0,1,0,65.87
臺中市,西屯區,福安里,286,1,730,7,737,1224,3,1,3,0,1,0,60.21
臺中市,西屯區,福安里,287,1,723,7,730,1106,3,1,3,0,1,0,66.00
臺中市,西屯區,福安里,288,1,853,5,858,1324,3,1,3,0,1,0,64.80
臺中市,西屯區,福安里,289,1,980,8,988,1508,3,1,3,0,1,0,65.52
臺中市,西屯區,福安里,290,1,748,13,761,1185,3,1,3,0,1,0,64.22
臺中市,西屯區,福安里,291,1,968,8,976,1636,3,1,3,0,1,0,59.66
臺中市,西屯區,福安里,292,1,751,5,756,1437,3,1,3,0,1,0,52.61
臺中市,西屯區,福安里,293,1,660,3,663,988,3,1,3,0,1,0,67.11
臺中市,西屯區,協和里,294,1,705,9,714,1035,3,1,3,0,1,0,68.99
臺中市,西屯區,協和里,295,1,835,15,850,1320,3,1,3,0,1,0,64.39
臺中市,南屯區,南屯里,296,1,1222,23,1245,1704,3,1,3,0,1,0,73.06
臺中市,南屯區,南屯里,297,1,1159,20,1179,1696,3,1,3,0,1,0,69.52
臺中市,南屯區,豐樂里,298,1,1034,13,1047,1514,3,1,3,0,1,0,69.15
臺中市,南屯區,豐樂里,299,1,902,12,914,1368,3,1,3,0,1,0,66.81
臺中市,南屯區,楓樹里,300,1,1139,16,1155,1591,3,1,3,0,1,0,72.60
臺中市,南屯區,楓樹里,301,1,1035,13,1048,1594,3,1,3,0,1,0,65.75
臺中市,南屯區,中和里,302,1,1056,7,1063,1512,3,1,3,0,1,0,70.30
臺中市,南屯區,中和里,303,1,1147,24,1171,1622,3,1,3,0,1,0,72.19
臺中市,南屯區,鎮平里,304,1,662,13,675,898,3,1,3,0,1,0,75.17
臺中市,南屯區,鎮平里,305,1,428,4,432,600,3,1,3,0,1,0,72.00
臺中市,南屯區,永定里,306,1,672,9,681,1137,3,1,3,0,1,0,59.89
臺中市,南屯區,永定里,307,1,821,6,827,1167,3,1,3,0,1,0,70.87
臺中市,南屯區,春社里,308,1,721,11,732,1162,3,1,3,0,1,0,62.99
臺中市,南屯區,春社里,309,1,797,10,807,1186,3,1,3,0,1,0,68.04
臺中市,南屯區,春社里,310,1,617,9,626,883,3,1,3,0,1,0,70.89
臺中市,南屯區,春社里,311,1,425,5,430,1768,3,1,3,0,1,0,24.32
臺中市,南屯區,春安里,312,1,839,12,851,1102,3,1,3,0,1,0,77.22
臺中市,南屯區,春安里,313,1,854,10,864,1099,3,1,3,0,1,0,78.62
臺中市,南屯區,文山里,314,1,872,11,883,1324,3,1,3,0,1,0,66.69
臺中市,南屯區,文山里,315,1,1272,20,1292,1999,3,1,3,0,1,0,64.63
臺中市,南屯區,文山里,316,1,741,5,746,1101,3,1,3,0,1,0,67.76
臺中市,南屯區,新生里,317,1,896,15,911,1219,3,1,3,0,1,0,74.73
臺中市,南屯區,三厝里,318,1,897,9,906,1341,3,1,3,0,1,0,67.56
臺中市,南屯區,三厝里,319,1,692,3,695,1108,3,1,3,0,1,0,62.73
臺中市,南屯區,三厝里,320,1,541,3,544,783,3,1,3,0,1,0,69.48
臺中市,南屯區,黎明里,321,1,1000,7,1007,1345,3,1,3,0,1,0,74.87
臺中市,南屯區,黎光里,322,1,843,6,849,1152,3,1,3,0,1,0,73.70
臺中市,南屯區,黎光里,323,1,788,6,794,1214,3,1,3,0,1,0,65.40
臺中市,南屯區,田心里,324,1,927,7,934,1427,3,1,3,0,1,0,65.45
臺中市,南屯區,田心里,325,1,917,7,924,1275,3,1,3,0,1,0,72.47
臺中市,南屯區,田心里,326,1,941,17,958,1436,3,1,3,0,1,0,66.71
臺中市,南屯區,田心里,327,1,864,6,870,1396,3,1,3,0,1,0,62.32
臺中市,南屯區,田心里,328,1,1173,10,1183,1775,3,1,3,0,1,0,66.65
臺中市,南屯區,大同里,329,1,926,6,932,1449,3,1,3,0,1,0,64.32
臺中市,南屯區,大同里,330,1,879,12,891,1307,3,1,3,0,1,0,68.17
臺中市,南屯區,大同里,331,1,951,14,965,1462,3,1,3,0,1,0,66.01
臺中市,南屯區,大同里,332,1,1015,15,1030,1625,3,1,3,0,1,0,63.38
臺中市,南屯區,溝墘里,333,1,1002,7,1009,1444,3,1,3,0,1,0,69.88
臺中市,南屯區,溝墘里,334,1,1077,10,1087,1695,3,1,3,0,1,0,64.13
臺中市,南屯區,溝墘里,335,1,1049,4,1053,1554,3,1,3,0,1,0,67.76
臺中市,南屯區,溝墘里,336,1,1009,4,1013,1579,3,1,3,0,1,0,64.15
臺中市,北屯區,北屯里,337,1,682,9,691,1077,3,1,3,0,1,0,64.16
臺中市,北屯區,北屯里,338,1,820,5,825,1215,3,1,3,0,1,0,67.90
臺中市,北屯區,北屯里,339,1,848,8,856,1281,3,1,3,0,1,0,66.82
臺中市,北屯區,北屯里,340,1,794,7,801,1243,3,1,3,0,1,0,64.44
臺中市,北屯區,北興里,341,1,1003,7,1010,1440,3,1,3,0,1,0,70.14
臺中市,北屯區,北興里,342,1,1070,12,1082,1557,3,1,3,0,1,0,69.49
臺中市,北屯區,三光里,343,1,1037,16,1053,1683,3,1,3,0,1,0,62.57
臺中市,北屯區,三光里,344,1,847,11,858,1372,3,1,3,0,1,0,62.54
臺中市,北屯區,三光里,345,1,1142,15,1157,1906,3,1,3,0,1,0,60.70
臺中市,北屯區,三光里,346,1,1046,17,1063,1650,3,1,3,0,1,0,64.42
臺中市,北屯區,三光里,347,1,740,6,746,1041,3,1,3,0,1,0,71.66
臺中市,北屯區,平田里,348,1,555,7,562,880,3,1,3,0,1,0,63.86
臺中市,北屯區,平田里,349,1,1169,12,1181,1994,3,1,3,0,1,0,59.23
臺中市,北屯區,平田里,350,1,1042,7,1049,1695,3,1,3,0,1,0,61.89
臺中市,北屯區,平田里,351,1,780,7,787,1206,3,1,3,0,1,0,65.26
臺中市,北屯區,平田里,352,1,882,7,889,1297,3,1,3,0,1,0,68.54
臺中市,北屯區,平和里,353,1,1010,3,1013,1670,3,1,3,0,1,0,60.66
臺中市,北屯區,平和里,354,1,859,14,873,1407,3,1,3,0,1,0,62.05
臺中市,北屯區,平和里,355,1,1070,8,1078,1709,3,1,3,0,1,0,63.08
臺中市,北屯區,平安里,356,1,720,8,728,1142,3,1,3,0,1,0,63.75
臺中市,北屯區,平安里,357,1,779,10,789,1261,3,1,3,0,1,0,62.57
臺中市,北屯區,平安里,358,1,751,13,764,1137,3,1,3,0,1,0,67.19
臺中市,北屯區,平順里,359,1,991,16,1007,1513,3,1,3,0,1,0,66.56
臺中市,北屯區,平順里,360,1,1124,16,1140,1858,3,1,3,0,1,0,61.36
臺中市,北屯區,平順里,361,1,1063,12,1075,1646,3,1,3,0,1,0,65.31
臺中市,北屯區,平德里,362,1,1025,8,1033,1620,3,1,3,0,1,0,63.77
臺中市,北屯區,平德里,363,1,1018,18,1036,1587,3,1,3,0,1,0,65.28
臺中市,北屯區,東光里,364,1,815,9,824,1277,3,1,3,0,1,0,64.53
臺中市,北屯區,東光里,365,1,942,7,949,1444,3,1,3,0,1,0,65.72
臺中市,北屯區,舊社里,366,1,879,11,890,1334,3,1,3,0,1,0,66.72
臺中市,北屯區,舊社里,367,1,1006,16,1022,1642,3,1,3,0,1,0,62.24
臺中市,北屯區,舊社里,368,1,594,7,601,981,3,1,3,0,1,0,61.26
臺中市,北屯區,水景里,369,1,854,13,867,1346,3,1,3,0,1,0,64.41
臺中市,北屯區,水景里,370,1,1015,13,1028,1634,3,1,3,0,1,0,62.91
臺中市,北屯區,水景里,371,1,1106,16,1122,1655,3,1,3,0,1,0,67.79
臺中市,北屯區,軍功里,372,1,952,7,959,1436,3,1,3,0,1,0,66.78
臺中市,北屯區,軍功里,373,1,889,16,905,1366,3,1,3,0,1,0,66.25
臺中市,北屯區,軍功里,374,1,821,21,842,1337,3,1,3,0,1,0,62.98
臺中市,北屯區,軍功里,375,1,801,6,807,1259,3,1,3,0,1,0,64.10
臺中市,北屯區,和平里,376,1,1082,18,1100,1609,3,1,3,0,1,0,68.37
臺中市,北屯區,和平里,377,1,1049,8,1057,1517,3,1,3,0,1,0,69.68
臺中市,北屯區,和平里,378,1,494,5,499,701,3,1,3,0,1,0,71.18
臺中市,北屯區,東山里,379,1,942,11,953,1401,3,1,3,0,1,0,68.02
臺中市,北屯區,民政里,380,1,536,4,540,859,3,1,3,0,1,0,62.86
臺中市,北屯區,廍子里,381,1,551,10,561,894,3,1,3,0,1,0,62.75
臺中市,北屯區,廍子里,382,1,645,22,667,931,3,1,3,0,1,0,71.64
臺中市,北屯區,大坑里,383,1,840,8,848,1255,3,1,3,0,1,0,67.57
臺中市,北屯區,民德里,384,1,464,7,471,693,3,1,3,0,1,0,67.97
臺中市,北屯區,松竹里,385,1,1068,10,1078,1697,3,1,3,0,1,0,63.52
臺中市,北屯區,松竹里,386,1,1110,17,1127,1697,3,1,3,0,1,0,66.41
臺中市,北屯區,松安里,387,1,1123,8,1131,1840,3,1,3,0,1,0,61.47
臺中市,北屯區,松安里,388,1,1045,12,1057,1730,3,1,3,0,1,0,61.10
臺中市,北屯區,松安里,389,1,773,6,779,1207,3,1,3,0,1,0,64.54
臺中市,北屯區,松安里,390,1,788,10,798,1261,3,1,3,0,1,0,63.28
臺中市,北屯區,松茂里,391,1,950,11,961,1460,3,1,3,0,1,0,65.82
臺中市,北屯區,松茂里,392,1,1000,10,1010,1563,3,1,3,0,1,0,64.62
臺中市,北屯區,松茂里,393,1,859,6,865,1287,3,1,3,0,1,0,67.21
臺中市,北屯區,松茂里,394,1,668,11,679,1157,3,1,3,0,1,0,58.69
臺中市,北屯區,松茂里,395,1,873,10,883,1306,3,1,3,0,1,0,67.61
臺中市,北屯區,仁和里,396,1,993,3,996,1341,3,1,3,0,1,0,74.27
臺中市,北屯區,仁和里,397,1,992,10,1002,1517,3,1,3,0,1,0,66.05
臺中市,北屯區,仁和里,398,1,1012,9,1021,1496,3,1,3,0,1,0,68.25
臺中市,北屯區,仁和里,399,1,835,7,842,1229,3,1,3,0,1,0,68.51
臺中市,北屯區,仁美里,400,1,1021,11,1032,1495,3,1,3,0,1,0,69.03
臺中市,北屯區,仁美里,401,1,1242,15,1257,1686,3,1,3,0,1,0,74.56
臺中市,北屯區,仁美里,402,1,1113,14,1127,1553,3,1,3,0,1,0,72.57
臺中市,北屯區,四民里,403,1,723,10,733,1021,3,1,3,0,1,0,71.79
臺中市,北屯區,同榮里,404,1,992,8,1000,1444,3,1,3,0,1,0,69.25
臺中市,北屯區,同榮里,405,1,1017,10,1027,1580,3,1,3,0,1,0,65.00
臺中市,北屯區,同榮里,406,1,972,11,983,1362,3,1,3,0,1,0,72.17
臺中市,北屯區,后庄里,407,1,1108,10,1118,1624,3,1,3,0,1,0,68.84
臺中市,北屯區,后庄里,408,1,986,13,999,1432,3,1,3,0,1,0,69.76
臺中市,北屯區,后庄里,409,1,542,8,550,812,3,1,3,0,1,0,67.73
臺中市,北屯區,陳平里,410,1,1211,13,1224,1950,3,1,3,0,1,0,62.77
臺中市,北屯區,陳平里,411,1,1127,9,1136,1759,3,1,3,0,1,0,64.58
臺中市,北屯區,陳平里,412,1,928,10,938,1465,3,1,3,0,1,0,64.03
臺中市,北屯區,大德里,413,1,958,6,964,1444,3,1,3,0,1,0,66.76
臺中市,北屯區,大德里,414,1,1392,15,1407,2015,3,1,3,0,1,0,69.83
臺中市,北屯區,新平里,415,1,904,17,921,1442,3,1,3,0,1,0,63.87
臺中市,北屯區,新平里,416,1,1018,11,1029,1431,3,1,3,0,1,0,71.91
臺中市,北屯區,新平里,417,1,863,12,875,1248,3,1,3,0,1,0,70.11
臺中市,北屯區,仁愛里,418,1,620,4,624,857,3,1,3,0,1,0,72.81
臺中市,北屯區,水湳里,419,1,910,10,920,1362,3,1,3,0,1,0,67.55
臺中市,北屯區,水湳里,420,1,766,12,778,1212,3,1,3,0,1,0,64.19
臺中市,北屯區,水湳里,421,1,836,8,844,1273,3,1,3,0,1,0,66.30
臺中市,北屯區,水湳里,422,1,779,11,790,1179,3,1,3,0,1,0,67.01
嘉義市,東區,短竹里,1,1,877,7,884,1234,3,1,3,0,1,0,71.64
嘉義市,東區,短竹里,2,1,595,3,598,827,3,1,3,0,1,0,72.31
嘉義市,東區,短竹里,3,1,873,4,877,1183,3,1,3,0,1,0,74.13
嘉義市,東區,東川里,4,1,1101,6,1107,1472,3,1,3,0,1,0,75.20
嘉義市,東區,東川里,5,1,677,4,681,965,3,1,3,0,1,0,70.57
嘉義市,東區,鹿寮里,6,1,428,3,431,590,3,1,3,0,1,0,73.05
嘉義市,東區,盧厝里,7,1,655,10,665,939,3,1,3,0,1,0,70.82
嘉義市,東區,盧厝里,8,1,654,6,660,888,3,1,3,0,1,0,74.32
嘉義市,東區,東平里,9,1,731,8,739,958,3,1,3,0,1,0,77.14
嘉義市,東區,太平里,10,1,1043,8,1051,1376,3,1,3,0,1,0,76.38
嘉義市,東區,太平里,11,1,527,5,532,755,3,1,3,0,1,0,70.46
嘉義市,東區,太平里,12,1,672,4,676,894,3,1,3,0,1,0,75.62
嘉義市,東區,王田里,13,1,766,3,769,998,3,1,3,0,1,0,77.05
嘉義市,東區,王田里,14,1,812,7,819,1049,3,1,3,0,1,0,78.07
嘉義市,東區,長竹里,15,1,708,3,711,923,3,1,3,0,1,0,77.03
嘉義市,東區,長竹里,16,1,732,2,734,969,3,1,3,0,1,0,75.75
嘉義市,東區,後庄里,17,1,896,7,903,1193,3,1,3,0,1,0,75.69
嘉義市,東區,後庄里,18,1,719,4,723,895,3,1,3,0,1,0,80.78
嘉義市,東區,後庄里,19,1,531,3,534,690,3,1,3,0,1,0,77.39
嘉義市,東區,新店里,20,1,899,2,901,1154,3,1,3,0,1,0,78.08
嘉義市,東區,新店里,21,1,693,4,697,946,3,1,3,0,1,0,73.68
嘉義市,東區,新店里,22,1,624,7,631,852,3,1,3,0,1,0,74.06
嘉義市,東區,圳頭里,23,1,899,9,908,1245,3,1,3,0,1,0,72.93
嘉義市,東區,圳頭里,24,1,766,5,771,1019,3,1,3,0,1,0,75.66
嘉義市,東區,圳頭里,25,1,1055,4,1059,1392,3,1,3,0,1,0,76.08
嘉義市,東區,東噴里,26,1,970,3,973,1340,3,1,3,0,1,0,72.61
嘉義市,東區,希康里,27,1,261,2,263,351,3,1,3,0,1,0,74.93
嘉義市,東區,東山里,28,1,391,6,397,518,3,1,3,0,1,0,76.64
嘉義市,東區,東安里,29,1,461,4,465,601,3,1,3,0,1,0,77.37
嘉義市,東區,大街里,30,1,436,3,439,564,3,1,3,0,1,0,77.84
嘉義市,東區,祐民里,31,1,499,4,503,642,3,1,3,0,1,0,78.35
嘉義市,東區,東仁里,32,1,447,4,451,603,3,1,3,0,1,0,74.79
嘉義市,東區,內安里,33,1,390,2,392,524,3,1,3,0,1,0,74.81
嘉義市,東區,雲霄里,34,1,508,2,510,684,3,1,3,0,1,0,74.56
嘉義市,東區,雲霄里,35,1,528,1,529,693,3,1,3,0,1,0,76.33
嘉義市,東區,建國里,36,1,498,1,499,675,3,1,3,0,1,0,73.93
嘉義市,東區,府路里,37,1,787,1,788,1023,3,1,3,0,1,0,77.03
嘉義市,東區,鎮南里,38,1,297,3,300,411,3,1,3,0,1,0,72.99
嘉義市,東區,神農里,39,1,842,3,845,1126,3,1,3,0,1,0,75.04
嘉義市,東區,崇文里,40,1,509,3,512,681,3,1,3,0,1,0,75.18
嘉義市,東區,龍山里,41,1,594,1,595,784,3,1,3,0,1,0,75.89
嘉義市,東區,安平里,42,1,617,3,620,828,3,1,3,0,1,0,74.88
嘉義市,東區,文昌里,43,1,585,2,587,754,3,1,3,0,1,0,77.85
嘉義市,東區,志航里,44,1,969,9,978,1272,3,1,3,0,1,0,76.89
嘉義市,東區,志航里,45,1,505,4,509,667,3,1,3,0,1,0,76.31
嘉義市,東區,蘭井里,46,1,882,10,892,1231,3,1,3,0,1,0,72.46
嘉義市,東區,光復里,47,1,951,7,958,1262,3,1,3,0,1,0,75.91
嘉義市,東區,初陽里,48,1,692,10,702,931,3,1,3,0,1,0,75.40
嘉義市,東區,新開里,49,1,558,2,560,716,3,1,3,0,1,0,78.21
嘉義市,東區,新開里,50,1,484,4,488,649,3,1,3,0,1,0,75.19
嘉義市,東區,新開里,51,1,781,8,789,1104,3,1,3,0,1,0,71.47
嘉義市,東區,宣信里,52,1,716,7,723,1010,3,1,3,0,1,0,71.58
嘉義市,東區,宣信里,53,1,484,2,486,663,3,1,3,0,1,0,73.30
嘉義市,東區,興南里,54,1,592,1,593,781,3,1,3,0,1,0,75.93
嘉義市,東區,豐年里,55,1,546,6,552,752,3,1,3,0,1,0,73.40
嘉義市,東區,豐年里,56,1,682,3,685,922,3,1,3,0,1,0,74.30
嘉義市,東區,芳草里,57,1,812,6,818,1125,3,1,3,0,1,0,72.71
嘉義市,東區,芳草里,58,1,714,3,717,912,3,1,3,0,1,0,78.62
嘉義市,東區,芳草里,59,1,663,10,673,960,3,1,3,0,1,0,70.10
嘉義市,東區,芳安里,60,1,946,3,949,1253,3,1,3,0,1,0,75.74
嘉義市,東區,芳安里,61,1,628,6,634,839,3,1,3,0,1,0,75.57
嘉義市,東區,頂寮里,62,1,753,4,757,986,3,1,3,0,1,0,76.77
嘉義市,東區,頂寮里,63,1,637,4,641,834,3,1,3,0,1,0,76.86
嘉義市,東區,安寮里,64,1,574,6,580,786,3,1,3,0,1,0,73.79
嘉義市,東區,安寮里,65,1,727,5,732,1030,3,1,3,0,1,0,71.07
嘉義市,東區,安寮里,66,1,884,5,889,1184,3,1,3,0,1,0,75.08
嘉義市,東區,安寮里,67,1,1009,7,1016,1310,3,1,3,0,1,0,77.56
嘉義市,東區,興村里,68,1,896,4,900,1172,3,1,3,0,1,0,76.79
嘉義市,東區,興村里,69,1,876,6,882,1269,3,1,3,0,1,0,69.50
嘉義市,東區,興安里,70,1,768,6,774,1106,3,1,3,0,1,0,69.98
嘉義市,東區,興安里,71,1,621,8,629,875,3,1,3,0,1,0,71.89
嘉義市,東區,興仁里,72,1,1018,15,1033,1405,3,1,3,0,1,0,73.52
嘉義市,東區,興仁里,73,1,822,5,827,1077,3,1,3,0,1,0,76.79
嘉義市,東區,北城里,74,1,642,8,650,853,3,1,3,0,1,0,76.20
嘉義市,東區,仁武里,75,1,529,5,534,710,3,1,3,0,1,0,75.21
嘉義市,東區,泰安里,76,1,863,2,865,1179,3,1,3,0,1,0,73.37
嘉義市,東區,檜村里,77,1,709,3,712,954,3,1,3,0,1,0,74.63
嘉義市,東區,檜村里,78,1,436,0,436,569,3,1,3,0,1,0,76.63
嘉義市,東區,社口里,79,1,739,4,743,954,3,1,3,0,1,0,77.88
嘉義市,東區,仁和里,80,1,398,5,403,496,3,1,3,0,1,0,81.25
嘉義市,東區,中庄里,81,1,843,6,849,1150,3,1,3,0,1,0,73.83
嘉義市,東區,中庄里,82,1,964,9,973,1336,3,1,3,0,1,0,72.83
嘉義市,東區,仁義里,83,1,841,8,849,1089,3,1,3,0,1,0,77.96
嘉義市,東區,仁義里,84,1,622,4,626,852,3,1,3,0,1,0,73.47
嘉義市,東區,後湖里,85,1,986,5,991,1338,3,1,3,0,1,0,74.07
嘉義市,東區,後湖里,86,1,907,6,913,1200,3,1,3,0,1,0,76.08
嘉義市,東區,荖藤里,87,1,463,2,465,631,3,1,3,0,1,0,73.69
嘉義市,東區,荖藤里,88,1,720,2,722,933,3,1,3,0,1,0,77.38
嘉義市,東區,頂庄里,89,1,823,5,828,1128,3,1,3,0,1,0,73.40
嘉義市,東區,頂庄里,90,1,1074,9,1083,1461,3,1,3,0,1,0,74.13
嘉義市,東區,頂庄里,91,1,1001,4,1005,1295,3,1,3,0,1,0,77.61
嘉義市,西區,書院里,92,1,840,3,843,1096,3,1,3,0,1,0,76.92
嘉義市,西區,驛站里,93,1,553,1,554,722,3,1,3,0,1,0,76.73
嘉義市,西區,長安里,94,1,397,3,400,519,3,1,3,0,1,0,77.07
嘉義市,西區,菜園里,95,1,488,5,493,661,3,1,3,0,1,0,74.58
嘉義市,西區,集英里,96,1,461,4,465,603,3,1,3,0,1,0,77.11
嘉義市,西區,福松里,97,1,696,5,701,873,3,1,3,0,1,0,80.30
嘉義市,西區,義昌里,98,1,464,1,465,581,3,1,3,0,1,0,80.03
嘉義市,西區,自治里,99,1,769,12,781,1022,3,1,3,0,1,0,76.42
嘉義市,西區,大業里,100,1,758,1,759,1006,3,1,3,0,1,0,75.45
嘉義市,西區,中庸里,101,1,637,2,639,853,3,1,3,0,1,0,74.91
嘉義市,西區,學圃里,102,1,443,5,448,548,3,1,3,0,1,0,81.75
嘉義市,西區,北杏里,103,1,613,3,616,821,3,1,3,0,1,0,75.03
嘉義市,西區,社內里,104,1,423,1,424,574,3,1,3,0,1,0,73.87
嘉義市,西區,民生里,105,1,432,7,439,573,3,1,3,0,1,0,76.61
嘉義市,西區,慶昇里,106,1,355,3,358,475,3,1,3,0,1,0,75.37
嘉義市,西區,通運里,107,1,360,4,364,483,3,1,3,0,1,0,75.36
嘉義市,西區,榮檜里,108,1,481,4,485,659,3,1,3,0,1,0,73.60
嘉義市,西區,功科里,109,1,606,4,610,749,3,1,3,0,1,0,81.44
嘉義市,西區,康莊里,110,1,531,2,533,689,3,1,3,0,1,0,77.36
嘉義市,西區,福全里,111,1,904,4,908,1211,3,1,3,0,1,0,74.98
嘉義市,西區,福全里,112,1,707,6,713,1030,3,1,3,0,1,0,69.22
嘉義市,西區,福全里,113,1,565,3,568,753,3,1,3,0,1,0,75.43
嘉義市,西區,福全里,114,1,984,14,998,1323,3,1,3,0,1,0,75.43
嘉義市,西區,力行里,115,1,734,10,744,979,3,1,3,0,1,0,76.00
嘉義市,西區,劉厝里,116,1,1047,7,1054,1437,3,1,3,0,1,0,73.35
嘉義市,西區,劉厝里,117,1,938,12,950,1268,3,1,3,0,1,0,74.92
嘉義市,西區,港坪里,118,1,913,10,923,1180,3,1,3,0,1,0,78.22
嘉義市,西區,頭港里,119,1,768,8,776,976,3,1,3,0,1,0,79.51
嘉義市,西區,西平里,120,1,951,4,955,1231,3,1,3,0,1,0,77.58
嘉義市,西區,大溪里,121,1,646,1,647,877,3,1,3,0,1,0,73.77
嘉義市,西區,大溪里,122,1,591,1,592,744,3,1,3,0,1,0,79.57
嘉義市,西區,磚窯里,123,1,732,6,738,959,3,1,3,0,1,0,76.96
嘉義市,西區,磚窯里,124,1,1094,7,1101,1466,3,1,3,0,1,0,75.10
嘉義市,西區,新西里,125,1,745,7,752,1030,3,1,3,0,1,0,73.01
嘉義市,西區,新西里,126,1,858,3,861,1131,3,1,3,0,1,0,76.13
嘉義市,西區,華明里,127,1,621,4,625,816,3,1,3,0,1,0,76.59
嘉義市,西區,導民里,128,1,415,2,417,568,3,1,3,0,1,0,73.42
嘉義市,西區,導民里,129,1,569,4,573,788,3,1,3,0,1,0,72.72
嘉義市,西區,培元里,130,1,818,5,823,1096,3,1,3,0,1,0,75.09
嘉義市,西區,垂楊里,131,1,679,3,682,943,3,1,3,0,1,0,72.32
嘉義市,西區,垂楊里,132,1,800,7,807,1107,3,1,3,0,1,0,72.90
嘉義市,西區,車店里,133,1,768,5,773,1046,3,1,3,0,1,0,73.90
嘉義市,西區,車店里,134,1,786,11,797,1050,3,1,3,0,1,0,75.90
嘉義市,西區,車店里,135,1,945,7,952,1268,3,1,3,0,1,0,75.08
嘉義市,西區,福民里,136,1,1032,5,1037,1318,3,1,3,0,1,0,78.68
嘉義市,西區,福民里,137,1,1201,5,1206,1559,3,1,3,0,1,0,77.36
嘉義市,西區,湖內里,138,1,876,10,886,1168,3,1,3,0,1,0,75.86
嘉義市,西區,湖內里,139,1,1119,10,1129,1536,3,1,3,0,1,0,73.50
嘉義市,西區,湖內里,140,1,969,5,974,1320,3,1,3,0,1,0,73.79
嘉義市,西區,湖內里,141,1,696,7,703,987,3,1,3,0,1,0,71.23
嘉義市,西區,美源里,142,1,1225,11,1236,1619,3,1,3,0,1,0,76.34
嘉義市,西區,美源里,143,1,1058,10,1068,1434,3,1,3,0,1,0,74.48
嘉義市,西區,光路里,144,1,832,2,834,1094,3,1,3,0,1,0,76.23
嘉義市,西區,光路里,145,1,964,7,971,1269,3,1,3,0,1,0,76.52
嘉義市,西區,光路里,146,1,939,8,947,1263,3,1,3,0,1,0,74.98
嘉義市,西區,育英里,147,1,931,5,936,1253,3,1,3,0,1,0,74.70
嘉義市,西區,育英里,148,1,853,3,856,1132,3,1,3,0,1,0,75.62
嘉義市,西區,致遠里,149,1,511,3,514,671,3,1,3,0,1,0,76.60
嘉義市,西區,翠岱里,150,1,398,4,402,522,3,1,3,0,1,0,77.01
嘉義市,西區,自強里,151,1,684,4,688,890,3,1,3,0,1,0,77.30
嘉義市,西區,自強里,152,1,645,5,650,900,3,1,3,0,1,0,72.22
嘉義市,西區,長安里,153,1,1002,6,1008,1324,3,1,3,0,1,0,76.13
嘉義市,西區,北榮里,154,1,665,3,668,935,3,1,3,0,1,0,71.44
嘉義市,西區,北榮里,155,1,570,4,574,775,3,1,3,0,1,0,74.06
嘉義市,西區,重興里,156,1,796,9,805,1132,3,1,3,0,1,0,71.11
嘉義市,西區,重興里,157,1,735,9,744,984,3,1,3,0,1,0,75.61
嘉義市,西區,慶昌里,158,1,472,3,475,612,3,1,3,0,1,0,77.61
嘉義市,西區,小湖里,159,1,519,6,525,728,3,1,3,0,1,0,72.12
嘉義市,西區,竹文里,160,1,601,6,607,847,3,1,3,0,1,0,71.66
嘉義市,西區,竹文里,161,1,509,1,510,669,3,1,3,0,1,0,76.23
嘉義市,西區,香湖里,162,1,938,10,948,1293,3,1,3,0,1,0,73.32
嘉義市,西區,湖邊里,163,1,643,5,648,839,3,1,3,0,1,0,77.23
嘉義市,西區,湖邊里,164,1,664,1,665,891,3,1,3,0,1,0,74.64
嘉義市,西區,竹圍里,165,1,965,7,972,1248,3,1,3,0,1,0,77.88
嘉義市,西區,竹圍里,166,1,684,9,693,942,3,1,3,0,1,0,73.57
嘉義市,西區,竹圍里,167,1,797,6,803,1075,3,1,3,0,1,0,74.70
嘉義市,西區,保安里,168,1,1166,14,1180,1435,3,1,3,0,1,0,82.23
嘉義市,西區,保安里,169,1,1249,13,1262,1691,3,1,3,0,1,0,74.63
嘉義市,西區,保安里,170,1,1294,9,1303,1664,3,1,3,0,1,0,78.31
嘉義市,西區,保安里,171,1,1039,7,1046,1352,3,1,3,0,1,0,77.37
嘉義市,西區,新厝里,172,1,1069,11,1080,1429,3,1,3,0,1,0,75.58
嘉義市,西區,新厝里,173,1,1067,7,1074,1445,3,1,3,0,1,0,74.33
嘉義市,西區,北湖里,174,1,807,3,810,1030,3,1,3,0,1,0,78.64
嘉義市,西區,北湖里,175,1,810,5,815,1034,3,1,3,0,1,0,78.82
嘉義市,西區,下埤里,176,1,772,5,777,1037,3,1,3,0,1,0,74.93
嘉義市,西區,竹村里,177,1,672,6,678,884,3,1,3,0,1,0,76.70
臺南市,東區,崇學里,1,1,1121,11,1132,1783,3,1,3,0,1,0,63.49
臺南市,東區,崇學里,2,1,1184,13,1197,1880,3,1,3,0,1,0,63.67
臺南市,東區,崇學里,3,1,1053,17,1070,1565,3,1,3,0,1,0,68.37
臺南市,東區,崇德里,4,1,1190,13,1203,1645,3,1,3,0,1,0,73.13
臺南市,東區,崇德里,5,1,938,13,951,1474,3,1,3,0,1,0,64.52
臺南市,東區,崇善里,6,1,741,7,748,1164,3,1,3,0,1,0,64.26
臺南市,東區,崇善里,7,1,822,7,829,1295,3,1,3,0,1,0,64.02
臺南市,東區,崇成里,8,1,892,11,903,1402,3,1,3,0,1,0,64.41
臺南市,東區,崇成里,9,1,1093,14,1107,1590,3,1,3,0,1,0,69.62
臺南市,東區,崇成里,10,1,831,6,837,1251,3,1,3,0,1,0,66.91
臺南市,東區,大智里,11,1,783,10,793,1206,3,1,3,0,1,0,65.75
臺南市,東區,大智里,12,1,1005,16,1021,1390,3,1,3,0,1,0,73.45
臺南市,東區,大智里,13,1,851,4,855,1202,3,1,3,0,1,0,71.13
臺南市,東區,東智里,14,1,1174,14,1188,1751,3,1,3,0,1,0,67.85
臺南市,東區,德高里,15,1,613,9,622,970,3,1,3,0,1,0,64.12
臺南市,東區,德高里,16,1,965,17,982,1505,3,1,3,0,1,0,65.25
臺南市,東區,和平里,17,1,501,8,509,724,3,1,3,0,1,0,70.30
臺南市,東區,和平里,18,1,863,6,869,1292,3,1,3,0,1,0,67.26
臺南市,東區,仁和里,19,1,761,6,767,1103,3,1,3,0,1,0,69.54
臺南市,東區,仁和里,20,1,575,15,590,885,3,1,3,0,1,0,66.67
臺南市,東區,虎尾里,21,1,961,14,975,1434,3,1,3,0,1,0,67.99
臺南市,東區,虎尾里,22,1,1064,4,1068,1560,3,1,3,0,1,0,68.46
臺南市,東區,虎尾里,23,1,883,8,891,1313,3,1,3,0,1,0,67.86
臺南市,東區,自強里,24,1,1111,14,1125,1741,3,1,3,0,1,0,64.62
臺南市,東區,自強里,25,1,835,11,846,1223,3,1,3,0,1,0,69.17
臺南市,東區,自強里,26,1,999,11,1010,1437,3,1,3,0,1,0,70.29
臺南市,東區,東聖里,27,1,693,4,697,1066,3,1,3,0,1,0,65.38
臺南市,東區,東聖里,28,1,547,2,549,813,3,1,3,0,1,0,67.53
臺南市,東區,關聖里,29,1,872,19,891,1301,3,1,3,0,1,0,68.49
臺南市,東區,關聖里,30,1,721,14,735,1125,3,1,3,0,1,0,65.33
臺南市,東區,後甲里,31,1,776,9,785,1158,3,1,3,0,1,0,67.79
臺南市,東區,後甲里,32,1,983,4,987,1405,3,1,3,0,1,0,70.25
臺南市,東區,復國里,33,1,854,7,861,1110,3,1,3,0,1,0,77.57
臺南市,東區,復國里,34,1,878,14,892,1140,3,1,3,0,1,0,78.25
臺南市,東區,中興里,35,1,812,16,828,1046,3,1,3,0,1,0,79.16
臺南市,東區,中興里,36,1,681,11,692,878,3,1,3,0,1,0,78.82
臺南市,東區,東光里,37,1,1057,11,1068,1541,3,1,3,0,1,0,69.31
臺南市,東區,東光里,38,1,1097,8,1105,1560,3,1,3,0,1,0,70.83
臺南市,東區,東明里,39,1,947,6,953,1388,3,1,3,0,1,0,68.66
臺南市,東區,東明里,40,1,1070,12,1082,1554,3,1,3,0,1,0,69.63
臺南市,東區,莊敬里,41,1,1002,15,1017,1422,3,1,3,0,1,0,71.52
臺南市,東區,莊敬里,42,1,789,7,796,1154,3,1,3,0,1,0,68.98
臺南市,東區,小東里,43,1,800,14,814,1193,3,1,3,0,1,0,68.23
臺南市,東區,小東里,44,1,787,11,798,1167,3,1,3,0,1,0,68.38
臺南市,東區,小東里,45,1,754,8,762,1152,3,1,3,0,1,0,66.15
臺南市,東區,大學里,46,1,1118,16,1134,1674,3,1,3,0,1,0,67.74
臺南市,東區,育樂里,47,1,699,5,704,1022,3,1,3,0,1,0,68.88
臺南市,東區,前鋒里,48,1,576,12,588,871,3,1,3,0,1,0,67.51
臺南市,東區,大廟里,49,1,832,10,842,1309,3,1,3,0,1,0,64.32
臺南市,東區,泉北里,50,1,691,9,700,1077,3,1,3,0,1,0,65.00
臺南市,東區,圍上里,51,1,527,6,533,830,3,1,3,0,1,0,64.22
臺南市,東區,圍下里,52,1,613,9,622,908,3,1,3,0,1,0,68.50
臺南市,東區,圍下里,53,1,569,6,575,854,3,1,3,0,1,0,67.33
臺南市,東區,中西里,54,1,898,12,910,1310,3,1,3,0,1,0,69.47
臺南市,東區,中西里,55,1,887,7,894,1419,3,1,3,0,1,0,63.00
臺南市,東區,中西里,56,1,1133,15,1148,1743,3,1,3,0,1,0,65.86
臺南市,東區,新東里,57,1,795,7,802,1138,3,1,3,0,1,0,70.47
臺南市,東區,新東里,58,1,815,9,824,1194,3,1,3,0,1,0,69.01
臺南市,東區,崇誨里,59,1,1039,12,1051,1479,3,1,3,0,1,0,71.06
臺南市,東區,崇誨里,60,1,847,16,863,1273,3,1,3,0,1,0,67.79
臺南市,東區,衛國里,61,1,989,11,1000,1510,3,1,3,0,1,0,66.23
臺南市,東區,裕農里,62,1,910,12,922,1287,3,1,3,0,1,0,71.64
臺南市,東區,裕農里,63,1,835,10,845,1247,3,1,3,0,1,0,67.76
臺南市,東區,富裕里,64,1,617,9,626,942,3,1,3,0,1,0,66.45
臺南市,東區,富裕里,65,1,664,8,672,986,3,1,3,0,1,0,68.15
臺南市,東區,富強里,66,1,656,8,664,949,3,1,3,0,1,0,69.97
臺南市,東區,富強里,67,1,766,11,777,1104,3,1,3,0,1,0,70.38
臺南市,東區,富強里,68,1,984,13,997,1375,3,1,3,0,1,0,72.51
臺南市,東區,崇明里,69,1,1106,11,1117,1662,3,1,3,0,1,0,67.21
臺南市,東區,大德里,70,1,1168,20,1188,1816,3,1,3,0,1,0,65.42
臺南市,東區,忠孝里,71,1,973,13,986,1321,3,1,3,0,1,0,74.64
臺南市,東區,忠孝里,72,1,1197,17,1214,1898,3,1,3,0,1,0,63.96
臺南市,東區,忠孝里,73,1,988,15,1003,1545,3,1,3,0,1,0,64.92
臺南市,東區,大福里,74,1,704,9,713,1029,3,1,3,0,1,0,69.29
臺南市,東區,大福里,75,1,590,6,596,969,3,1,3,0,1,0,61.51
臺南市,東區,路東里,76,1,725,6,731,1060,3,1,3,0,1,0,68.96
臺南市,東區,府宅里,77,1,828,11,839,1242,3,1,3,0,1,0,67.55
臺南市,東區,川東里,78,1,585,5,590,871,3,1,3,0,1,0,67.74
臺南市,東區,大興里,79,1,713,9,722,1087,3,1,3,0,1,0,66.42
臺南市,東區,泉南里,80,1,1252,13,1265,1905,3,1,3,0,1,0,66.40
臺南市,東區,泉南里,81,1,1208,14,1222,1808,3,1,3,0,1,0,67.59
臺南市,東區,龍山里,82,1,959,13,972,1404,3,1,3,0,1,0,69.23
臺南市,東區,龍山里,83,1,872,7,879,1314,3,1,3,0,1,0,66.89
臺南市,東區,龍山里,84,1,999,20,1019,1464,3,1,3,0,1,0,69.60
臺南市,南區,大恩里,85,1,973,15,988,1474,3,1,3,0,1,0,67.03
臺南市,南區,大恩里,86,1,995,20,1015,1430,3,1,3,0,1,0,70.98
臺南市,南區,大林里,87,1,611,5,616,938,3,1,3,0,1,0,65.67
臺南市,南區,大林里,88,1,685,7,692,1019,3,1,3,0,1,0,67.91
臺南市,南區,大忠里,89,1,874,10,884,1230,3,1,3,0,1,0,71.87
臺南市,南區,大忠里,90,1,935,9,944,1375,3,1,3,0,1,0,68.65
臺南市,南區,大忠里,91,1,977,13,990,1502,3,1,3,0,1,0,65.91
臺南市,南區,新生里,92,1,798,11,809,1166,3,1,3,0,1,0,69.38
臺南市,南區,竹溪里,93,1,943,12,955,1411,3,1,3,0,1,0,67.68
臺南市,南區,明德里,94,1,854,14,868,1204,3,1,3,0,1,0,72.09
臺南市,南區,興中里,95,1,948,11,959,1289,3,1,3,0,1,0,74.40
臺南市,南區,荔宅里,96,1,1089,13,1102,1527,3,1,3,0,1,0,72.17
臺南市,南區,大成里,97,1,723,9,732,1042,3,1,3,0,1,0,70.25
臺南市,南區,田寮里,98,1,809,13,822,1187,3,1,3,0,1,0,69.25
臺南市,南區,田寮里,99,1,749,6,755,1120,3,1,3,0,1,0,67.41
臺南市,南區,田寮里,100,1,727,5,732,1038,3,1,3,0,1,0,70.52
臺南市,南區,新興里,101,1,696,7,703,1004,3,1,3,0,1,0,70.02
臺南市,南區,新興里,102,1,1011,10,1021,1526,3,1,3,0,1,0,66.91
臺南市,南區,再興里,103,1,731,5,736,1033,3,1,3,0,1,0,71.25
臺南市,南區,再興里,104,1,718,6,724,1022,3,1,3,0,1,0,70.84
臺南市,南區,廣州里,105,1,904,8,912,1254,3,1,3,0,1,0,72.73
臺南市,南區,廣州里,106,1,1065,10,1075,1386,3,1,3,0,1,0,77.56
臺南市,南區,新昌里,107,1,722,7,729,1089,3,1,3,0,1,0,66.94
臺南市,南區,新昌里,108,1,913,5,918,1356,3,1,3,0,1,0,67.70
臺南市,南區,文華里,109,1,1036,10,1046,1493,3,1,3,0,1,0,70.06
臺南市,南區,文華里,110,1,1019,11,1030,1499,3,1,3,0,1,0,68.71
臺南市,南區,文南里,111,1,1062,6,1068,1437,3,1,3,0,1,0,74.32
臺南市,南區,文南里,112,1,1094,13,1107,1557,3,1,3,0,1,0,71.10
臺南市,南區,金華里,113,1,983,12,995,1407,3,1,3,0,1,0,70.72
臺南市,南區,金華里,114,1,1001,6,1007,1484,3,1,3,0,1,0,67.86
臺南市,南區,金華里,115,1,1062,5,1067,1489,3,1,3,0,1,0,71.66
臺南市,南區,國宅里,116,1,1110,10,1120,1583,3,1,3,0,1,0,70.75
臺南市,南區,國宅里,117,1,982,12,994,1464,3,1,3,0,1,0,67.90
臺南市,南區,日新里,118,1,678,5,683,959,3,1,3,0,1,0,71.22
臺南市,南區,日新里,119,1,689,9,698,1042,3,1,3,0,1,0,66.99
臺南市,南區,光明里,120,1,1302,11,1313,1776,3,1,3,0,1,0,73.93
臺南市,南區,光明里,121,1,1298,16,1314,1920,3,1,3,0,1,0,68.44
臺南市,南區,白雪里,122,1,587,4,591,807,3,1,3,0,1,0,73.23
臺南市,南區,白雪里,123,1,866,9,875,1168,3,1,3,0,1,0,74.91
臺南市,南區,明亮里,124,1,1005,8,1013,1532,3,1,3,0,1,0,66.12
臺南市,南區,明亮里,125,1,1219,21,1240,1718,3,1,3,0,1,0,72.18
臺南市,南區,府南里,126,1,987,14,1001,1540,3,1,3,0,1,0,65.00
臺南市,南區,府南里,127,1,1303,18,1321,1927,3,1,3,0,1,0,68.55
臺南市,南區,明興里,128,1,1055,11,1066,1454,3,1,3,0,1,0,73.31
臺南市,南區,明興里,129,1,1077,15,1092,1465,3,1,3,0,1,0,74.54
臺南市,南區,郡南里,130,1,1154,15,1169,1607,3,1,3,0,1,0,72.74
臺南市,南區,郡南里,131,1,1127,10,1137,1596,3,1,3,0,1,0,71.24
臺南市,南區,建南里,132,1,1080,6,1086,1549,3,1,3,0,1,0,70.11
臺南市,南區,建南里,133,1,1001,14,1015,1497,3,1,3,0,1,0,67.80
臺南市,南區,南都里,134,1,856,5,861,1227,3,1,3,0,1,0,70.17
臺南市,南區,南都里,135,1,998,12,1010,1475,3,1,3,0,1,0,68.47
臺南市,南區,南都里,136,1,917,9,926,1400,3,1,3,0,1,0,66.14
臺南市,南區,開南里,137,1,1098,15,1113,1671,3,1,3,0,1,0,66.61
臺南市,南區,開南里,138,1,1093,19,1112,1700,3,1,3,0,1,0,65.41
臺南市,南區,彰南里,139,1,619,3,622,919,3,1,3,0,1,0,67.68
臺南市,南區,彰南里,140,1,689,3,692,1051,3,1,3,0,1,0,65.84
臺南市,南區,清泉里,141,1,697,9,706,1003,3,1,3,0,1,0,70.39
臺南市,南區,龍崗里,142,1,688,10,698,949,3,1,3,0,1,0,73.55
臺南市,南區,喜北里,143,1,794,7,801,1087,3,1,3,0,1,0,73.69
臺南市,南區,喜北里,144,1,622,6,628,919,3,1,3,0,1,0,68.34
臺南市,南區,喜南里,145,1,1081,10,1091,1552,3,1,3,0,1,0,70.30
臺南市,南區,喜東里,146,1,943,11,954,1377,3,1,3,0,1,0,69.28
臺南市,南區,省躬里,147,1,729,6,735,1047,3,1,3,0,1,0,70.20
臺南市,南區,省躬里,148,1,866,7,873,1234,3,1,3,0,1,0,70.75
臺南市,南區,覺醒里,149,1,451,4,455,606,3,1,3,0,1,0,75.08
臺南市,南區,海豐里,150,1,401,9,410,588,3,1,3,0,1,0,69.73
臺南市,南區,松山里,151,1,666,4,670,986,3,1,3,0,1,0,67.95
臺南市,南區,南山里,152,1,495,3,498,708,3,1,3,0,1,0,70.34
臺南市,南區,佛壇里,153,1,967,13,980,1398,3,1,3,0,1,0,70.10
臺南市,南區,同安里,154,1,1169,9,1178,1699,3,1,3,0,1,0,69.33
臺南市,南區,中和里,155,1,525,6,531,737,3,1,3,0,1,0,72.05
臺南市,南區,興農里,156,1,1182,10,1192,1637,3,1,3,0,1,0,72.82
臺南市,西區,普濟里,157,1,555,8,563,788,3,1,3,0,1,0,71.45
臺南市,西區,濟同里,158,1,504,3,507,683,3,1,3,0,1,0,74.23
臺南市,西區,金安里,159,1,461,9,470,666,3,1,3,0,1,0,70.57
臺南市,西區,忠信里,160,1,553,3,556,788,3,1,3,0,1,0,70.56
臺南市,西區,工業里,161,1,545,4,549,841,3,1,3,0,1,0,65.28
臺南市,西區,協和里,162,1,846,11,857,1159,3,1,3,0,1,0,73.94
臺南市,西區,協和里,163,1,724,12,736,1009,3,1,3,0,1,0,72.94
臺南市,西區,文賢里,164,1,921,9,930,1370,3,1,3,0,1,0,67.88
臺南市,西區,光賢里,165,1,930,12,942,1321,3,1,3,0,1,0,71.31
臺南市,西區,光賢里,166,1,663,3,666,881,3,1,3,0,1,0,75.60
臺南市,西區,西湖里,167,1,582,4,586,867,3,1,3,0,1,0,67.59
臺南市,西區,西湖里,168,1,982,8,990,1386,3,1,3,0,1,0,71.43
臺南市,西區,西賢里,169,1,1045,14,1059,1556,3,1,3,0,1,0,68.06
臺南市,西區,西賢里,170,1,637,4,641,923,3,1,3,0,1,0,69.45
臺南市,西區,藥王里,171,1,748,6,754,1067,3,1,3,0,1,0,70.67
臺南市,西區,藥王里,172,1,817,12,829,1214,3,1,3,0,1,0,68.29
臺南市,西區,協進里,173,1,790,14,804,1115,3,1,3,0,1,0,72.11
臺南市,西區,西羅里,174,1,678,12,690,938,3,1,3,0,1,0,73.56
臺南市,西區,北勢里,175,1,634,24,658,927,3,1,3,0,1,0,70.98
臺南市,西區,水仙里,176,1,669,7,676,1005,3,1,3,0,1,0,67.26
臺南市,西區,安新里,177,1,408,8,416,569,3,1,3,0,1,0,73.11
臺南市,西區,中正里,178,1,658,9,667,960,3,1,3,0,1,0,69.48
臺南市,西區,正德里,179,1,431,10,441,633,3,1,3,0,1,0,69.67
臺南市,西區,安海里,180,1,597,7,604,936,3,1,3,0,1,0,64.53
臺南市,西區,大涼里,181,1,530,6,536,812,3,1,3,0,1,0,66.01
臺南市,西區,大涼里,182,1,832,10,842,1302,3,1,3,0,1,0,64.67
臺南市,西區,民主里,183,1,590,9,599,904,3,1,3,0,1,0,66.26
臺南市,西區,運河里,184,1,416,7,423,604,3,1,3,0,1,0,70.03
臺南市,西區,北頭里,185,1,199,0,199,248,3,1,3,0,1,0,80.24
臺南市,西區,保民里,186,1,346,2,348,466,3,1,3,0,1,0,74.68
臺南市,西區,保良里,187,1,385,1,386,507,3,1,3,0,1,0,76.13
臺南市,西區,元安里,188,1,1046,10,1056,1552,3,1,3,0,1,0,68.04
臺南市,西區,天池里,189,1,217,3,220,306,3,1,3,0,1,0,71.90
臺南市,西區,新安里,190,1,619,11,630,821,3,1,3,0,1,0,76.74
臺南市,西區,中頭里,191,1,669,9,678,1005,3,1,3,0,1,0,67.46
臺南市,西區,民生里,192,1,845,10,855,1151,3,1,3,0,1,0,74.28
臺南市,北區,城隍里,193,1,654,6,660,958,3,1,3,0,1,0,68.89
臺南市,北區,元和里,194,1,698,8,706,1051,3,1,3,0,1,0,67.17
臺南市,北區,城朔里,195,1,638,6,644,971,3,1,3,0,1,0,66.32
臺南市,北區,共和里,196,1,822,7,829,1270,3,1,3,0,1,0,65.28
臺南市,北區,福德里,197,1,679,9,688,985,3,1,3,0,1,0,69.85
臺南市,北區,花園里,198,1,753,8,761,1143,3,1,3,0,1,0,66.58
臺南市,北區,西華里,199,1,798,7,805,1203,3,1,3,0,1,0,66.92
臺南市,北區,北門里,200,1,647,9,656,951,3,1,3,0,1,0,68.98
臺南市,北區,東豐里,201,1,846,13,859,1191,3,1,3,0,1,0,72.12
臺南市,北區,水源里,202,1,740,5,745,1037,3,1,3,0,1,0,71.84
臺南市,北區,仁愛里,203,1,519,6,525,809,3,1,3,0,1,0,64.89
臺南市,北區,仁愛里,204,1,637,6,643,925,3,1,3,0,1,0,69.51
臺南市,北區,振興里,205,1,680,5,685,1013,3,1,3,0,1,0,67.62
臺南市,北區,振興里,206,1,696,4,700,1030,3,1,3,0,1,0,67.96
臺南市,北區,東興里,207,1,677,12,689,973,3,1,3,0,1,0,70.81
臺南市,北區,東興里,208,1,770,10,780,1067,3,1,3,0,1,0,73.10
臺南市,北區,重興里,209,1,838,14,852,1327,3,1,3,0,1,0,64.20
臺南市,北區,重興里,210,1,838,15,853,1093,3,1,3,0,1,0,78.04
臺南市,北區,華興里,211,1,736,13,749,1136,3,1,3,0,1,0,65.93
臺南市,北區,華興里,212,1,655,6,661,999,3,1,3,0,1,0,66.17
臺南市,北區,力行里,213,1,692,6,698,1051,3,1,3,0,1,0,66.41
臺南市,北區,力行里,214,1,678,10,688,966,3,1,3,0,1,0,71.22
臺南市,北區,國興里,215,1,1002,9,1011,1418,3,1,3,0,1,0,71.30
臺南市,北區,新勝里,216,1,647,8,655,912,3,1,3,0,1,0,71.82
臺南市,北區,新勝里,217,1,653,7,660,1006,3,1,3,0,1,0,65.61
臺南市,北區,開元里,218,1,940,9,949,1464,3,1,3,0,1,0,64.82
臺南市,北區,開元里,219,1,1022,11,1033,1406,3,1,3,0,1,0,73.47
臺南市,北區,北垣里,220,1,778,11,789,1004,3,1,3,0,1,0,78.59
臺南市,北區,富台里,221,1,458,5,463,608,3,1,3,0,1,0,76.15
臺南市,北區,勝安里,222,1,934,7,941,1369,3,1,3,0,1,0,68.74
臺南市,北區,大仁里,223,1,838,7,845,1168,3,1,3,0,1,0,72.35
臺南市,北區,大山里,224,1,1036,24,1060,1477,3,1,3,0,1,0,71.77
臺南市,北區,大道里,225,1,1037,8,1045,1360,3,1,3,0,1,0,76.84
臺南市,北區,光武里,226,1,711,11,722,994,3,1,3,0,1,0,72.64
臺南市,北區,實踐里,227,1,666,6,672,944,3,1,3,0,1,0,71.19
臺南市,北區,實踐里,228,1,739,7,746,1020,3,1,3,0,1,0,73.14
臺南市,北區,小康里,229,1,788,9,797,1117,3,1,3,0,1,0,71.35
臺南市,北區,小康里,230,1,816,8,824,1149,3,1,3,0,1,0,71.71
臺南市,北區,小康里,231,1,825,8,833,1202,3,1,3,0,1,0,69.30
臺南市,北區,小康里,232,1,825,10,835,1212,3,1,3,0,1,0,68.89
臺南市,北區,正風里,233,1,1060,15,1075,1544,3,1,3,0,1,0,69.62
臺南市,北區,延平里,234,1,662,8,670,971,3,1,3,0,1,0,69.00
臺南市,北區,延平里,235,1,695,8,703,1028,3,1,3,0,1,0,68.39
臺南市,北區,興北里,236,1,1146,13,1159,1666,3,1,3,0,1,0,69.57
臺南市,北區,興南里,237,1,938,11,949,1379,3,1,3,0,1,0,68.82
臺南市,北區,國姓里,238,1,1096,8,1104,1601,3,1,3,0,1,0,68.96
臺南市,北區,六甲里,239,1,617,7,624,955,3,1,3,0,1,0,65.34
臺南市,北區,六甲里,240,1,618,6,624,912,3,1,3,0,1,0,68.42
臺南市,北區,正覺里,241,1,722,4,726,1074,3,1,3,0,1,0,67.60
臺南市,北區,正覺里,242,1,739,7,746,1106,3,1,3,0,1,0,67.45
臺南市,北區,正覺里,243,1,797,12,809,1192,3,1,3,0,1,0,67.87
臺南市,北區,成功里,244,1,818,7,825,1202,3,1,3,0,1,0,68.64
臺南市,北區,成功里,245,1,900,10,910,1341,3,1,3,0,1,0,67.86
臺南市,北區,成功里,246,1,1199,18,1217,1786,3,1,3,0,1,0,68.14
臺南市,北區,和順里,247,1,1017,14,1031,1484,3,1,3,0,1,0,69.47
臺南市,北區,和順里,248,1,1054,5,1059,1507,3,1,3,0,1,0,70.27
臺南市,北區,安民里,249,1,873,8,881,1229,3,1,3,0,1,0,71.68
臺南市,北區,裕民里,250,1,919,13,932,1368,3,1,3,0,1,0,68.13
臺南市,北區,文元里,251,1,920,10,930,1378,3,1,3,0,1,0,67.49
臺南市,北區,文元里,252,1,924,7,931,1391,3,1,3,0,1,0,66.93
臺南市,北區,文元里,253,1,1040,11,1051,1460,3,1,3,0,1,0,71.99
臺南市,北區,大港里,254,1,822,8,830,1162,3,1,3,0,1,0,71.43
臺南市,北區,大港里,255,1,942,9,951,1347,3,1,3,0,1,0,70.60
臺南市,北區,大港里,256,1,1024,11,1035,1525,3,1,3,0,1,0,67.87
臺南市,北區,大港里,257,1,981,16,997,1366,3,1,3,0,1,0,72.99
臺南市,北區,大豐里,258,1,850,17,867,1227,3,1,3,0,1,0,70.66
臺南市,北區,大豐里,259,1,614,7,621,962,3,1,3,0,1,0,64.55
臺南市,北區,大豐里,260,1,712,6,718,1008,3,1,3,0,1,0,71.23
臺南市,北區,大豐里,261,1,1026,11,1037,1549,3,1,3,0,1,0,66.95
臺南市,中區,萬壽里,262,1,957,9,966,1348,3,1,3,0,1,0,71.66
臺南市,中區,文昌里,263,1,821,8,829,1136,3,1,3,0,1,0,72.98
臺南市,中區,萬鍾里,264,1,781,7,788,1127,3,1,3,0,1,0,69.92
臺南市,中區,銀同里,265,1,995,15,1010,1481,3,1,3,0,1,0,68.20
臺南市,中區,清水里,266,1,543,3,546,795,3,1,3,0,1,0,68.68
臺南市,中區,環翠里,267,1,455,4,459,684,3,1,3,0,1,0,67.11
臺南市,中區,公正里,268,1,329,2,331,485,3,1,3,0,1,0,68.25
臺南市,中區,廣慈里,269,1,361,3,364,536,3,1,3,0,1,0,67.91
臺南市,中區,啟智里,270,1,916,6,922,1294,3,1,3,0,1,0,71.25
臺南市,中區,永慶里,271,1,302,3,305,431,3,1,3,0,1,0,70.77
臺南市,中區,天中里,272,1,417,4,421,559,3,1,3,0,1,0,75.31
臺南市,中區,中山里,273,1,427,5,432,589,3,1,3,0,1,0,73.34
臺南市,中區,白金里,274,1,531,7,538,715,3,1,3,0,1,0,75.24
臺南市,中區,武聖里,275,1,536,4,540,766,3,1,3,0,1,0,70.50
臺南市,中區,蓬壺里,276,1,757,6,763,1138,3,1,3,0,1,0,67.05
臺南市,中區,赤嵌里,277,1,393,5,398,576,3,1,3,0,1,0,69.10
臺南市,中區,觀音里,278,1,462,5,467,657,3,1,3,0,1,0,71.08
臺南市,中區,竹翠里,279,1,395,6,401,560,3,1,3,0,1,0,71.61
臺南市,中區,溫陵里,280,1,454,6,460,705,3,1,3,0,1,0,65.25
臺南市,中區,開仙里,281,1,551,6,557,843,3,1,3,0,1,0,66.07
臺南市,中區,保西里,282,1,586,9,595,844,3,1,3,0,1,0,70.50
臺南市,中區,中南里,283,1,430,2,432,600,3,1,3,0,1,0,72.00
臺南市,中區,福安里,284,1,645,7,652,987,3,1,3,0,1,0,66.06
臺南市,中區,昇平里,285,1,374,3,377,512,3,1,3,0,1,0,73.63
臺南市,中區,聖前里,286,1,352,7,359,512,3,1,3,0,1,0,70.12
臺南市,中區,小西里,287,1,832,8,840,1233,3,1,3,0,1,0,68.13
臺南市,中區,仙草里,288,1,846,8,854,1312,3,1,3,0,1,0,65.09
臺南市,中區,仙草里,289,1,762,5,767,1094,3,1,3,0,1,0,70.11
臺南市,中區,五妃里,290,1,774,2,776,1096,3,1,3,0,1,0,70.80
臺南市,中區,大南里,291,1,1012,13,1025,1510,3,1,3,0,1,0,67.88
臺南市,中區,進學里,292,1,503,7,510,727,3,1,3,0,1,0,70.15
臺南市,中區,川西里,293,1,563,9,572,830,3,1,3,0,1,0,68.92
臺南市,中區,開山里,294,1,1065,8,1073,1609,3,1,3,0,1,0,66.69
臺南市,中區,郡王里,295,1,1253,10,1263,1756,3,1,3,0,1,0,71.92
臺南市,中區,法華里,296,1,923,6,929,1330,3,1,3,0,1,0,69.85
臺南市,中區,法華里,297,1,1191,9,1200,1769,3,1,3,0,1,0,67.83
臺南市,安南區,溪頂里,298,1,736,9,745,1089,3,1,3,0,1,0,68.41
臺南市,安南區,溪頂里,299,1,1072,13,1085,1560,3,1,3,0,1,0,69.55
臺南市,安南區,溪北里,300,1,1344,24,1368,1947,3,1,3,0,1,0,70.26
臺南市,安南區,安和里,301,1,1314,17,1331,1820,3,1,3,0,1,0,73.13
臺南市,安南區,安西里,302,1,1113,13,1126,1543,3,1,3,0,1,0,72.97
臺南市,安南區,安西里,303,1,319,3,322,414,3,1,3,0,1,0,77.78
臺南市,安南區,安東里,304,1,897,11,908,1236,3,1,3,0,1,0,73.46
臺南市,安南區,安東里,305,1,788,13,801,1209,3,1,3,0,1,0,66.25
臺南市,安南區,安慶里,306,1,1338,19,1357,1954,3,1,3,0,1,0,69.45
臺南市,安南區,安慶里,307,1,903,11,914,1303,3,1,3,0,1,0,70.15
臺南市,安南區,頂安里,308,1,716,6,722,949,3,1,3,0,1,0,76.08
臺南市,安南區,頂安里,309,1,750,10,760,1065,3,1,3,0,1,0,71.36
臺南市,安南區,鳳凰里,310,1,773,13,786,1229,3,1,3,0,1,0,63.95
臺南市,安南區,鳳凰里,311,1,713,3,716,1178,3,1,3,0,1,0,60.78
臺南市,安南區,梅花里,312,1,777,11,788,1159,3,1,3,0,1,0,67.99
臺南市,安南區,梅花里,313,1,798,6,804,1203,3,1,3,0,1,0,66.83
臺南市,安南區,新順里,314,1,712,5,717,1044,3,1,3,0,1,0,68.68
臺南市,安南區,新順里,315,1,550,7,557,831,3,1,3,0,1,0,67.03
臺南市,安南區,安順里,316,1,665,5,670,992,3,1,3,0,1,0,67.54
臺南市,安南區,安順里,317,1,539,5,544,813,3,1,3,0,1,0,66.91
臺南市,安南區,州南里,318,1,959,11,970,1384,3,1,3,0,1,0,70.09
臺南市,安南區,州南里,319,1,827,11,838,1198,3,1,3,0,1,0,69.95
臺南市,安南區,州南里,320,1,901,15,916,1268,3,1,3,0,1,0,72.24
臺南市,安南區,東和里,321,1,349,3,352,468,3,1,3,0,1,0,75.21
臺南市,安南區,州北里,322,1,808,11,819,1092,3,1,3,0,1,0,75.00
臺南市,安南區,州北里,323,1,828,7,835,1246,3,1,3,0,1,0,67.01
臺南市,安南區,塭南里,324,1,1063,10,1073,1545,3,1,3,0,1,0,69.45
臺南市,安南區,塭南里,325,1,910,18,928,1306,3,1,3,0,1,0,71.06
臺南市,安南區,布袋里,326,1,670,10,680,951,3,1,3,0,1,0,71.50
臺南市,安南區,總頭里,327,1,1095,7,1102,1448,3,1,3,0,1,0,76.10
臺南市,安南區,原佃里,328,1,870,11,881,1144,3,1,3,0,1,0,77.01
臺南市,安南區,長安里,329,1,790,7,797,1107,3,1,3,0,1,0,72.00
臺南市,安南區,長安里,330,1,937,15,952,1317,3,1,3,0,1,0,72.29
臺南市,安南區,公親里,331,1,592,13,605,790,3,1,3,0,1,0,76.58
臺南市,安南區,佃東里,332,1,1242,12,1254,1708,3,1,3,0,1,0,73.42
臺南市,安南區,佃西里,333,1,757,7,764,1059,3,1,3,0,1,0,72.14
臺南市,安南區,公塭里,334,1,610,4,614,765,3,1,3,0,1,0,80.26
臺南市,安南區,南興里,335,1,722,7,729,1026,3,1,3,0,1,0,71.05
臺南市,安南區,學東里,336,1,1039,11,1050,1511,3,1,3,0,1,0,69.49
臺南市,安南區,砂崙里,337,1,375,6,381,476,3,1,3,0,1,0,80.04
臺南市,安南區,砂崙里,338,1,357,0,357,440,3,1,3,0,1,0,81.14
臺南市,安南區,青草里,339,1,804,17,821,1017,3,1,3,0,1,0,80.73
臺南市,安南區,城西里,340,1,579,7,586,763,3,1,3,0,1,0,76.80
臺南市,安南區,城南里,341,1,1030,14,1044,1423,3,1,3,0,1,0,73.37
臺南市,安南區,城南里,342,1,399,7,406,526,3,1,3,0,1,0,77.19
臺南市,安南區,城中里,343,1,436,3,439,556,3,1,3,0,1,0,78.96
臺南市,安南區,城北里,344,1,782,7,789,1039,3,1,3,0,1,0,75.94
臺南市,安南區,城東里,345,1,906,4,910,1245,3,1,3,0,1,0,73.09
臺南市,安南區,顯宮里,346,1,707,8,715,943,3,1,3,0,1,0,75.82
臺南市,安南區,鹿耳里,347,1,422,5,427,558,3,1,3,0,1,0,76.52
臺南市,安南區,四草里,348,1,923,9,932,1236,3,1,3,0,1,0,75.40
臺南市,安南區,鹽田里,349,1,400,3,403,486,3,1,3,0,1,0,82.92
臺南市,安南區,淵西里,350,1,1240,15,1255,1822,3,1,3,0,1,0,68.88
臺南市,安南區,淵中里,351,1,857,9,866,1266,3,1,3,0,1,0,68.40
臺南市,安南區,淵中里,352,1,719,10,729,1052,3,1,3,0,1,0,69.30
臺南市,安南區,溪心里,353,1,1100,18,1118,1646,3,1,3,0,1,0,67.92
臺南市,安南區,溪心里,354,1,438,9,447,636,3,1,3,0,1,0,70.28
臺南市,安南區,淵東里,355,1,676,7,683,987,3,1,3,0,1,0,69.20
臺南市,安南區,淵東里,356,1,610,14,624,885,3,1,3,0,1,0,70.51
臺南市,安南區,海西里,357,1,729,13,742,1076,3,1,3,0,1,0,68.96
臺南市,安南區,海西里,358,1,655,4,659,965,3,1,3,0,1,0,68.29
臺南市,安南區,海東里,359,1,812,14,826,1196,3,1,3,0,1,0,69.06
臺南市,安南區,海東里,360,1,735,7,742,1120,3,1,3,0,1,0,66.25
臺南市,安南區,理想里,361,1,930,11,941,1452,3,1,3,0,1,0,64.81
臺南市,安南區,理想里,362,1,1202,23,1225,1818,3,1,3,0,1,0,67.38
臺南市,安南區,理想里,363,1,1208,22,1230,1756,3,1,3,0,1,0,70.05
臺南市,安南區,海佃里,364,1,1046,17,1063,1451,3,1,3,0,1,0,73.26
臺南市,安南區,海佃里,365,1,1068,7,1075,1488,3,1,3,0,1,0,72.24
臺南市,安南區,海佃里,366,1,1149,20,1169,1676,3,1,3,0,1,0,69.75
臺南市,安南區,幸福里,367,1,923,12,935,1358,3,1,3,0,1,0,68.85
臺南市,安南區,幸福里,368,1,1202,13,1215,1747,3,1,3,0,1,0,69.55
臺南市,安南區,海南里,369,1,670,3,673,952,3,1,3,0,1,0,70.69
臺南市,安南區,海南里,370,1,614,7,621,910,3,1,3,0,1,0,68.24
臺南市,安南區,溪墘里,371,1,858,17,875,1214,3,1,3,0,1,0,72.08
臺南市,安南區,溪墘里,372,1,835,4,839,1250,3,1,3,0,1,0,67.12
臺南市,安南區,溪東里,373,1,1170,18,1188,1671,3,1,3,0,1,0,71.10
臺南市,安南區,溪東里,374,1,902,9,911,1326,3,1,3,0,1,0,68.70
臺南市,安南區,溪東里,375,1,869,12,881,1263,3,1,3,0,1,0,69.75
臺南市,安南區,溪東里,376,1,728,5,733,1119,3,1,3,0,1,0,65.50
臺南市,安平區,校前里,377,1,558,6,564,862,3,1,3,0,1,0,65.43
臺南市,安平區,校前里,378,1,1762,11,1773,2802,3,1,3,0,1,0,63.28
臺南市,安平區,校前里,379,1,1472,15,1487,2391,3,1,3,0,1,0,62.19
臺南市,安平區,校前里,380,1,813,12,825,1379,3,1,3,0,1,0,59.83
臺南市,安平區,校前里,381,1,1316,12,1328,2265,3,1,3,0,1,0,58.63
臺南市,安平區,石門里,382,1,804,10,814,1162,3,1,3,0,1,0,70.05
臺南市,安平區,石門里,383,1,978,10,988,1420,3,1,3,0,1,0,69.58
臺南市,安平區,石門里,384,1,915,18,933,1362,3,1,3,0,1,0,68.50
臺南市,安平區,菩薩里,385,1,300,4,304,374,3,1,3,0,1,0,81.28
臺南市,安平區,安中里,386,1,345,8,353,488,3,1,3,0,1,0,72.34
臺南市,安平區,文朱里,387,1,271,1,272,371,3,1,3,0,1,0,73.32
臺南市,安平區,妙壽里,388,1,253,2,255,399,3,1,3,0,1,0,63.91
臺南市,安平區,海興里,389,1,606,7,613,879,3,1,3,0,1,0,69.74
臺南市,安平區,西門里,390,1,843,18,861,1178,3,1,3,0,1,0,73.09
臺南市,安平區,西門里,391,1,777,7,784,1024,3,1,3,0,1,0,76.56
臺南市,安平區,金城里,392,1,777,6,783,1240,3,1,3,0,1,0,63.15
臺南市,安平區,金城里,393,1,523,4,527,690,3,1,3,0,1,0,76.38
臺南市,安平區,漁光里,394,1,313,5,318,425,3,1,3,0,1,0,74.82
金門縣,金城鎮,東門里,1,1,946,10,956,1342,3,1,3,0,1,0,71.24
金門縣,金城鎮,南門里,2,1,607,4,611,862,3,1,3,0,1,0,70.88
金門縣,金城鎮,南門里,3,1,687,4,691,927,3,1,3,0,1,0,74.54
金門縣,金城鎮,西門里,4,1,792,8,800,1137,3,1,3,0,1,0,70.36
金門縣,金城鎮,西門里,5,1,873,8,881,1221,3,1,3,0,1,0,72.15
金門縣,金城鎮,北門里,6,1,855,10,865,1195,3,1,3,0,1,0,72.38
金門縣,金城鎮,賢庵里,7,1,585,9,594,844,3,1,3,0,1,0,70.38
金門縣,金城鎮,金水里,8,1,380,1,381,541,3,1,3,0,1,0,70.43
金門縣,金城鎮,古城里,9,1,688,14,702,1005,3,1,3,0,1,0,69.85
金門縣,金城鎮,珠沙里,10,1,307,4,311,472,3,1,3,0,1,0,65.89
金門縣,金寧鄉,古寧村,11,1,619,8,627,961,3,1,3,0,1,0,65.24
金門縣,金寧鄉,安美村,12,1,784,8,792,1156,3,1,3,0,1,0,68.51
金門縣,金寧鄉,湖埔村,13,1,626,10,636,886,3,1,3,0,1,0,71.78
金門縣,金寧鄉,榜林村,14,1,702,20,722,1112,3,1,3,0,1,0,64.93
金門縣,金寧鄉,盤山村,15,1,576,4,580,824,3,1,3,0,1,0,70.39
金門縣,金寧鄉,后盤村,16,1,263,2,265,402,3,1,3,0,1,0,65.92
金門縣,金湖鎮,新市里,17,1,1085,13,1098,1497,3,1,3,0,1,0,73.35
金門縣,金湖鎮,山外里,18,1,788,9,797,1055,3,1,3,0,1,0,75.55
金門縣,金湖鎮,溪湖里,19,1,335,6,341,456,3,1,3,0,1,0,74.78
金門縣,金湖鎮,蓮庵里,20,1,304,1,305,434,3,1,3,0,1,0,70.28
金門縣,金湖鎮,料羅里,21,1,326,1,327,477,3,1,3,0,1,0,68.55
金門縣,金湖鎮,新湖里,22,1,788,6,794,1026,3,1,3,0,1,0,77.39
金門縣,金湖鎮,正義里,23,1,556,5,561,709,3,1,3,0,1,0,79.13
金門縣,金湖鎮,瓊林里,24,1,664,4,668,958,3,1,3,0,1,0,69.73
金門縣,金沙鎮,汶沙里,25,1,1053,16,1069,1490,3,1,3,0,1,0,71.74
金門縣,金沙鎮,何斗里,26,1,444,7,451,620,3,1,3,0,1,0,72.74
金門縣,金沙鎮,浦山里,27,1,445,11,456,698,3,1,3,0,1,0,65.33
金門縣,金沙鎮,西園里,28,1,306,4,310,445,3,1,3,0,1,0,69.66
金門縣,金沙鎮,官嶼里,29,1,331,1,332,529,3,1,3,0,1,0,62.76
金門縣,金沙鎮,三山里,30,1,356,3,359,531,3,1,3,0,1,0,67.61
金門縣,金沙鎮,大洋里,31,1,258,2,260,372,3,1,3,0,1,0,69.89
金門縣,金沙鎮,光前里,32,1,389,6,395,589,3,1,3,0,1,0,67.06
金門縣,烈嶼鄉,林湖村,33,1,708,5,713,921,3,1,3,0,1,0,77.42
金門縣,烈嶼鄉,黃埔村,34,1,267,1,268,387,3,1,3,0,1,0,69.25
金門縣,烈嶼鄉,西口村,35,1,370,9,379,548,3,1,3,0,1,0,69.16
金門縣,烈嶼鄉,上林村,36,1,272,2,274,373,3,1,3,0,1,0,73.46
金門縣,烈嶼鄉,上歧村,37,1,566,6,572,768,3,1,3,0,1,0,74.48
金門縣,烏坵鄉,大坵村,38,1,33,0,33,82,3,1,3,0,1,0,40.24
連江縣,南竿鄉,介壽村,1,1,1297,18,1315,1508,3,1,3,0,1,0,87.20
連江縣,南竿鄉,馬祖村,2,1,601,10,611,724,3,1,3,0,1,0,84.39
連江縣,北竿鄉,塘歧村,3,1,420,4,424,515,3,1,3,0,1,0,82.33
連江縣,北竿鄉,白沙村,4,1,183,3,186,234,3,1,3,0,1,0,79.49
連江縣,莒光鄉,青帆村,5,1,177,0,177,219,3,1,3,0,1,0,80.82
連江縣,莒光鄉,大坪村,6,1,127,1,128,155,3,1,3,0,1,0,82.58
連江縣,東引鄉,中柳村,7,1,308,4,312,426,3,1,3,0,1,0,73.24
