CountyCityName,TownshipName,VillageName,PollStationNo,DistrictName,BallotsAccepted,BallotsRejected,BallotsCast,Voters,CandidateCounts,ElectedCounts,CandidateMaleCounts,CandidateFemaleCounts,ElectedMaleCounts,ElectedFemaleCounts,BallotsRate
全國,,,0,0,6255321,192061,6447382,10069401,827,319,760,67,301,18,64.03
臺北縣,,,0,0,1044573,26733,1071306,2236468,74,29,65,9,26,3,47.90
宜蘭縣,,,0,0,204436,4734,209170,314541,31,12,25,6,11,1,66.50
桃園縣,,,0,0,547139,16009,563148,1034243,39,13,36,3,13,0,54.45
新竹縣,,,0,0,187047,5175,192222,278052,35,13,34,1,13,0,69.13
苗栗縣,,,0,0,247254,7157,254411,378337,48,18,39,9,15,3,67.24
臺中縣,,,0,0,604815,20510,625325,927456,65,21,61,4,20,1,67.42
彰化縣,,,0,0,628004,24509,652513,857455,69,26,65,4,24,2,76.10
南投縣,,,0,0,244611,11202,255813,373237,39,13,34,5,12,1,68.54
雲林縣,,,0,0,387653,11161,398814,524496,45,20,44,1,19,1,76.04
嘉義縣,,,0,0,287320,9144,296464,401418,44,18,40,4,16,2,73.85
臺南縣,,,0,0,517393,13975,531368,755552,88,31,79,9,31,0,70.33
高雄縣,,,0,0,587729,18506,606235,834697,67,27,63,4,25,2,72.63
屏東縣,,,0,0,444507,8355,452862,629047,83,33,81,2,33,0,71.99
臺東縣,,,0,0,107649,4259,111908,175688,37,16,36,1,16,0,63.70
花蓮縣,,,0,0,139340,7500,146840,245324,31,13,27,4,12,1,59.86
澎湖縣,,,0,0,45450,2174,47624,64234,10,6,9,1,5,1,74.14
金門縣,,,0,0,25897,774,26671,33010,15,6,15,0,6,0,80.80
連江縣,,,0,0,4504,184,4688,6146,7,4,7,0,4,0,76.28
臺北縣,板橋市,,0,0,162594,4775,167369,338061,2,1,2,0,1,0,49.51
臺北縣,三重市,,0,0,117335,3608,120943,248841,2,1,2,0,1,0,48.60
臺北縣,中和市,,0,0,119150,2440,121590,262443,3,1,3,0,1,0,46.33
臺北縣,永和市,,0,0,66434,2032,68466,156991,2,1,2,0,1,0,43.61
臺北縣,新莊市,,0,0,88461,2188,90649,215932,3,1,1,2,0,1,41.98
臺北縣,新店市,,0,0,74156,806,74962,181492,3,1,3,0,1,0,41.30
臺北縣,樹林市,,0,0,42939,705,43644,88675,2,1,2,0,1,0,49.22
臺北縣,鶯歌鎮,,0,0,19367,1685,21052,46374,1,1,1,0,1,0,45.40
臺北縣,三峽鎮,,0,0,25165,409,25574,49140,4,1,3,1,1,0,52.04
臺北縣,淡水鎮,,0,0,31035,1320,32355,70640,2,1,2,0,1,0,45.80
臺北縣,汐止市,,0,0,38673,572,39245,95723,3,1,1,2,0,1,41.00
臺北縣,瑞芳鎮,,0,0,23753,628,24381,35606,2,1,2,0,1,0,68.47
臺北縣,土城市,,0,0,57247,1192,58439,131031,2,1,2,0,1,0,44.60
臺北縣,蘆洲市,,0,0,46485,849,47334,91994,4,1,3,1,1,0,51.45
臺北縣,五股鄉,,0,0,20426,343,20769,39883,4,1,4,0,1,0,52.07
臺北縣,泰山鄉,,0,0,20203,408,20611,37900,3,1,3,0,1,0,54.38
臺北縣,林口鄉,,0,0,16057,484,16541,30041,2,1,2,0,1,0,55.06
臺北縣,深坑鄉,,0,0,6136,155,6291,13186,4,1,3,1,0,1,47.71
臺北縣,石碇鄉,,0,0,4017,70,4087,5783,2,1,2,0,1,0,70.67
臺北縣,坪林鄉,,0,0,3899,48,3947,4662,5,1,4,1,1,0,84.66
臺北縣,三芝鄉,,0,0,8924,147,9071,14390,2,1,2,0,1,0,63.04
臺北縣,石門鄉,,0,0,5311,76,5387,7180,3,1,3,0,1,0,75.03
臺北縣,八里鄉,,0,0,6791,1193,7984,16621,1,1,1,0,1,0,48.04
臺北縣,平溪鄉,,0,0,3558,56,3614,4885,3,1,3,0,1,0,73.98
臺北縣,雙溪鄉,,0,0,6504,83,6587,8557,2,1,2,0,1,0,76.98
臺北縣,貢寮鄉,,0,0,7716,103,7819,10425,2,1,2,0,1,0,75.00
臺北縣,金山鄉,,0,0,10848,163,11011,14046,2,1,1,1,1,0,78.39
臺北縣,萬里鄉,,0,0,9518,167,9685,13506,2,1,2,0,1,0,71.71
臺北縣,烏來鄉,,0,0,1871,28,1899,2460,2,1,2,0,1,0,77.20
宜蘭縣,宜蘭市,,0,0,39106,719,39825,60665,2,1,2,0,1,0,65.65
宜蘭縣,羅東鎮,,0,0,24268,963,25231,44190,2,1,2,0,1,0,57.10
宜蘭縣,蘇澳鎮,,0,0,22441,584,23025,33438,3,1,2,1,1,0,68.86
宜蘭縣,頭城鎮,,0,0,15941,470,16411,22894,2,1,1,1,1,0,71.68
宜蘭縣,礁溪鄉,,0,0,18521,393,18914,25961,2,1,2,0,1,0,72.86
宜蘭縣,壯圍鄉,,0,0,13891,300,14191,18431,4,1,4,0,1,0,77.00
宜蘭縣,員山鄉,,0,0,15136,265,15401,23376,2,1,1,1,1,0,65.88
宜蘭縣,冬山鄉,,0,0,22291,480,22771,35400,2,1,1,1,1,0,64.32
宜蘭縣,五結鄉,,0,0,16334,200,16534,26417,2,1,2,0,1,0,62.59
宜蘭縣,三星鄉,,0,0,10997,262,11259,16323,2,1,2,0,1,0,68.98
宜蘭縣,大同鄉,,0,0,2737,34,2771,3733,3,1,2,1,0,1,74.23
宜蘭縣,南澳鄉,,0,0,2773,64,2837,3713,5,1,4,1,1,0,76.41
桃園縣,桃園市,,0,0,88134,3417,91551,185992,3,1,3,0,1,0,49.22
桃園縣,中壢市,,0,0,107181,2567,109748,201951,4,1,4,0,1,0,54.34
桃園縣,大溪鎮,,0,0,30472,631,31103,54376,3,1,3,0,1,0,57.20
桃園縣,楊梅鎮,,0,0,39970,884,40854,75859,5,1,4,1,1,0,53.86
桃園縣,蘆竹鄉,,0,0,26529,714,27243,50223,2,1,2,0,1,0,54.24
桃園縣,大園鄉,,0,0,29546,722,30268,46656,3,1,2,1,1,0,64.87
桃園縣,龜山鄉,,0,0,33713,821,34534,71080,2,1,2,0,1,0,48.58
桃園縣,八德市,,0,0,52481,2411,54892,98764,3,1,3,0,1,0,55.58
桃園縣,龍潭鄉,,0,0,34304,661,34965,61772,3,1,2,1,1,0,56.60
桃園縣,平鎮市,,0,0,55460,2188,57648,112147,3,1,3,0,1,0,51.40
桃園縣,新屋鄉,,0,0,22656,399,23055,33497,4,1,4,0,1,0,68.83
桃園縣,觀音鄉,,0,0,21256,457,21713,34170,2,1,2,0,1,0,63.54
桃園縣,復興鄉,,0,0,5437,137,5574,7756,2,1,2,0,1,0,71.87
新竹縣,竹北市,,0,0,31502,937,32439,52457,2,1,2,0,1,0,61.84
新竹縣,竹東鎮,,0,0,35728,940,36668,55512,3,1,3,0,1,0,66.05
新竹縣,新埔鎮,,0,0,16890,379,17269,24895,3,1,3,0,1,0,69.37
新竹縣,關西鎮,,0,0,16612,278,16890,22719,2,1,1,1,1,0,74.34
新竹縣,湖口鄉,,0,0,28033,1569,29602,40811,3,1,3,0,1,0,72.53
新竹縣,新豐鄉,,0,0,17435,294,17729,27531,3,1,3,0,1,0,64.40
新竹縣,芎林鄉,,0,0,9456,216,9672,13256,2,1,2,0,1,0,72.96
新竹縣,橫山鄉,,0,0,8154,137,8291,10986,2,1,2,0,1,0,75.47
新竹縣,北埔鄉,,0,0,6152,116,6268,7468,2,1,2,0,1,0,83.93
新竹縣,寶山鄉,,0,0,6569,96,6665,8839,2,1,2,0,1,0,75.40
新竹縣,峨眉鄉,,0,0,4104,57,4161,4933,4,1,4,0,1,0,84.35
新竹縣,尖石鄉,,0,0,3781,98,3879,5301,3,1,3,0,1,0,73.17
新竹縣,五峰鄉,,0,0,2631,58,2689,3344,4,1,4,0,1,0,80.41
苗栗縣,苗栗市,,0,0,37964,839,38803,60647,5,1,5,0,1,0,63.98
苗栗縣,苑裡鎮,,0,0,22408,450,22858,33117,4,1,4,0,1,0,69.02
苗栗縣,通霄鎮,,0,0,20657,329,20986,28971,3,1,3,0,1,0,72.44
苗栗縣,竹南鎮,,0,0,27830,435,28265,43562,3,1,3,0,1,0,64.88
苗栗縣,頭份鎮,,0,0,33609,1189,34798,55863,2,1,2,0,1,0,62.29
苗栗縣,後龍鎮,,0,0,18757,434,19191,30013,2,1,1,1,1,0,63.94
苗栗縣,卓蘭鎮,,0,0,9692,196,9888,13897,2,1,1,1,1,0,71.15
苗栗縣,大湖鄉,,0,0,8302,178,8480,12912,3,1,2,1,1,0,65.68
苗栗縣,公館鄉,,0,0,13507,1762,15269,23244,1,1,1,0,1,0,65.69
苗栗縣,銅鑼鄉,,0,0,10850,178,11028,14620,2,1,1,1,0,1,75.43
苗栗縣,南庄鄉,,0,0,6362,174,6536,9592,4,1,4,0,1,0,68.14
苗栗縣,頭屋鄉,,0,0,7075,105,7180,8789,4,1,3,1,1,0,81.69
苗栗縣,三義鄉,,0,0,8942,145,9087,12060,2,1,2,0,1,0,75.35
苗栗縣,西湖鄉,,0,0,4684,89,4773,6717,2,1,1,1,0,1,71.06
苗栗縣,造橋鄉,,0,0,5663,475,6138,9933,1,1,1,0,1,0,61.79
苗栗縣,三灣鄉,,0,0,4272,84,4356,5857,2,1,2,0,1,0,74.37
苗栗縣,獅潭鄉,,0,0,3267,50,3317,4460,3,1,2,1,1,0,74.37
苗栗縣,泰安鄉,,0,0,3413,45,3458,4083,3,1,1,2,0,1,84.69
臺中縣,豐原市,,0,0,57595,1669,59264,102649,4,1,3,1,1,0,57.73
臺中縣,東勢鎮,,0,0,27679,858,28537,41306,5,1,5,0,1,0,69.09
臺中縣,大甲鎮,,0,0,32800,693,33493,49152,5,1,5,0,1,0,68.14
臺中縣,清水鎮,,0,0,38484,1340,39824,55278,2,1,2,0,1,0,72.04
臺中縣,沙鹿鎮,,0,0,35607,759,36366,44798,6,1,5,1,1,0,81.18
臺中縣,梧棲鎮,,0,0,23465,529,23994,30261,2,1,1,1,0,1,79.29
臺中縣,后里鄉,,0,0,26525,550,27075,36545,5,1,5,0,1,0,74.09
臺中縣,神岡鄉,,0,0,27689,572,28261,38604,2,1,2,0,1,0,73.21
臺中縣,潭子鄉,,0,0,27430,988,28418,52429,3,1,3,0,1,0,54.20
臺中縣,大雅鄉,,0,0,29117,781,29898,45897,4,1,4,0,1,0,65.14
臺中縣,新社鄉,,0,0,14718,385,15103,19191,2,1,2,0,1,0,78.70
臺中縣,石岡鄉,,0,0,8253,201,8454,10861,2,1,2,0,1,0,77.84
臺中縣,外埔鄉,,0,0,15456,439,15895,19591,2,1,2,0,1,0,81.13
臺中縣,大安鄉,,0,0,9242,867,10109,14415,1,1,1,0,1,0,70.13
臺中縣,烏日鄉,,0,0,29409,860,30269,40793,4,1,4,0,1,0,74.20
臺中縣,大肚鄉,,0,0,22096,3123,25219,33566,1,1,1,0,1,0,75.13
臺中縣,龍井鄉,,0,0,29319,870,30189,38488,3,1,2,1,1,0,78.44
臺中縣,霧峰鄉,,0,0,30376,809,31185,44041,3,1,3,0,1,0,70.81
臺中縣,太平市,,0,0,56257,1901,58158,99584,3,1,3,0,1,0,58.40
臺中縣,大里市,,0,0,57142,2189,59331,101753,2,1,2,0,1,0,58.31
臺中縣,和平鄉,,0,0,6156,127,6283,8254,4,1,4,0,1,0,76.12
彰化縣,彰化市,,0,0,100705,3015,103720,144942,5,1,5,0,1,0,71.56
彰化縣,鹿港鎮,,0,0,37250,1570,38820,52757,3,1,3,0,1,0,73.58
彰化縣,和美鎮,,0,0,40858,1336,42194,52943,3,1,3,0,1,0,79.70
彰化縣,線西鄉,,0,0,7020,978,7998,10761,1,1,1,0,1,0,74.32
彰化縣,伸港鄉,,0,0,17368,376,17744,20771,2,1,2,0,1,0,85.43
彰化縣,福興鄉,,0,0,25243,392,25635,30748,4,1,4,0,1,0,83.37
彰化縣,秀水鄉,,0,0,18667,374,19041,23575,5,1,5,0,1,0,80.77
彰化縣,花壇鄉,,0,0,22125,518,22643,29391,3,1,3,0,1,0,77.04
彰化縣,芬園鄉,,0,0,12636,1382,14018,18443,1,1,1,0,1,0,76.01
彰化縣,員林鎮,,0,0,56000,1387,57387,80752,4,1,4,0,1,0,71.07
彰化縣,溪湖鎮,,0,0,27655,429,28084,35001,2,1,2,0,1,0,80.24
彰化縣,田中鎮,,0,0,23773,516,24289,32269,4,1,4,0,1,0,75.27
彰化縣,大村鄉,,0,0,18413,290,18703,23088,3,1,3,0,1,0,81.01
彰化縣,埔鹽鄉,,0,0,20465,405,20870,24223,2,1,2,0,1,0,86.16
彰化縣,埔心鄉,,0,0,17714,325,18039,22886,4,1,4,0,1,0,78.82
彰化縣,永靖鄉,,0,0,20327,482,20809,26476,4,1,4,0,1,0,78.60
彰化縣,社頭鄉,,0,0,23227,748,23975,29514,2,1,1,1,0,1,81.23
彰化縣,二水鄉,,0,0,10269,340,10609,13581,2,1,2,0,1,0,78.12
彰化縣,北斗鎮,,0,0,17071,367,17438,22159,3,1,3,0,1,0,78.69
彰化縣,二林鎮,,0,0,26606,3182,29788,38630,1,1,1,0,1,0,77.11
彰化縣,田尾鄉,,0,0,16240,263,16503,19901,3,1,2,1,0,1,82.93
彰化縣,埤頭鄉,,0,0,14783,467,15250,22520,2,1,1,1,1,0,67.72
彰化縣,芳苑鄉,,0,0,17417,3690,21107,29513,1,1,1,0,1,0,71.52
彰化縣,大城鄉,,0,0,12558,200,12758,16381,2,1,1,1,1,0,77.88
彰化縣,竹塘鄉,,0,0,9672,152,9824,12733,2,1,2,0,1,0,77.15
彰化縣,溪州鄉,,0,0,13942,1325,15267,23497,1,1,1,0,1,0,64.97
南投縣,南投市,,0,0,47691,1138,48829,68293,3,1,3,0,1,0,71.50
南投縣,埔里鎮,,0,0,36978,992,37970,60073,3,1,2,1,1,0,63.21
南投縣,草屯鎮,,0,0,42203,1512,43715,63871,2,1,2,0,1,0,68.44
南投縣,竹山鎮,,0,0,21824,5270,27094,43068,1,1,1,0,1,0,62.91
南投縣,集集鎮,,0,0,6638,87,6725,8948,2,1,2,0,1,0,75.16
南投縣,名間鄉,,0,0,22065,825,22890,29855,4,1,3,1,0,1,76.67
南投縣,鹿谷鄉,,0,0,11910,158,12068,15365,3,1,3,0,1,0,78.54
南投縣,中寮鄉,,0,0,10404,170,10574,13789,5,1,4,1,1,0,76.68
南投縣,魚池鄉,,0,0,8031,137,8168,13266,2,1,2,0,1,0,61.57
南投縣,國姓鄉,,0,0,10793,196,10989,18009,3,1,3,0,1,0,61.02
南投縣,水里鄉,,0,0,11629,130,11759,16831,3,1,2,1,1,0,69.87
南投縣,信義鄉,,0,0,7286,489,7775,11565,2,1,2,0,1,0,67.23
南投縣,仁愛鄉,,0,0,7159,98,7257,10304,6,1,5,1,1,0,70.43
雲林縣,斗六市,,0,0,46566,1347,47913,64676,2,1,2,0,1,0,74.08
雲林縣,斗南鎮,,0,0,22597,1450,24047,32480,2,1,2,0,1,0,74.04
雲林縣,虎尾鎮,,0,0,32932,1000,33932,45412,2,1,2,0,1,0,74.72
雲林縣,西螺鎮,,0,0,25127,524,25651,34750,2,1,2,0,1,0,73.82
雲林縣,土庫鎮,,0,0,13989,1770,15759,22882,1,1,1,0,1,0,68.87
雲林縣,北港鎮,,0,0,24630,706,25336,33305,3,1,3,0,1,0,76.07
雲林縣,古坑鄉,,0,0,19373,445,19818,25905,4,1,3,1,0,1,76.50
雲林縣,大埤鄉,,0,0,12809,353,13162,16934,2,1,2,0,1,0,77.73
雲林縣,莿桐鄉,,0,0,17021,312,17333,21990,3,1,3,0,1,0,78.82
雲林縣,林內鄉,,0,0,11278,308,11586,14610,3,1,3,0,1,0,79.30
雲林縣,二崙鄉,,0,0,17571,274,17845,23902,2,1,2,0,1,0,74.66
雲林縣,崙背鄉,,0,0,16218,285,16503,21019,2,1,2,0,1,0,78.51
雲林縣,麥寮鄉,,0,0,17810,335,18145,22155,2,1,2,0,1,0,81.90
雲林縣,東勢鄉,,0,0,11422,304,11726,14317,2,1,2,0,1,0,81.90
雲林縣,褒忠鄉,,0,0,9020,142,9162,11078,2,1,2,0,1,0,82.70
雲林縣,臺西鄉,,0,0,18020,337,18357,21774,2,1,2,0,1,0,84.31
雲林縣,元長鄉,,0,0,16855,280,17135,24332,2,1,2,0,1,0,70.42
雲林縣,四湖鄉,,0,0,15725,330,16055,23282,2,1,2,0,1,0,68.96
雲林縣,口湖鄉,,0,0,19266,382,19648,24458,2,1,2,0,1,0,80.33
雲林縣,水林鄉,,0,0,19424,277,19701,25235,3,1,3,0,1,0,78.07
嘉義縣,太保市,,0,0,16209,314,16523,20531,3,1,2,1,1,0,80.48
嘉義縣,朴子市,,0,0,21114,701,21815,30935,2,1,1,1,0,1,70.52
嘉義縣,布袋鎮,,0,0,18870,333,19203,25140,2,1,2,0,1,0,76.38
嘉義縣,大林鎮,,0,0,19101,398,19499,26169,3,1,2,1,0,1,74.51
嘉義縣,民雄鄉,,0,0,33768,772,34540,45837,3,1,3,0,1,0,75.35
嘉義縣,溪口鄉,,0,0,8478,1064,9542,13972,2,1,1,1,1,0,68.29
嘉義縣,新港鄉,,0,0,18985,323,19308,25771,3,1,3,0,1,0,74.92
嘉義縣,六腳鄉,,0,0,15779,398,16177,23104,2,1,2,0,1,0,70.02
嘉義縣,東石鄉,,0,0,13913,1779,15692,23424,2,1,2,0,1,0,66.99
嘉義縣,義竹鄉,,0,0,15537,292,15829,18602,2,1,2,0,1,0,85.09
嘉義縣,鹿草鄉,,0,0,10628,194,10822,14236,2,1,2,0,1,0,76.02
嘉義縣,水上鄉,,0,0,27307,990,28297,38227,2,1,2,0,1,0,74.02
嘉義縣,中埔鄉,,0,0,22266,765,23031,32871,2,1,2,0,1,0,70.06
嘉義縣,竹崎鄉,,0,0,20269,474,20743,29182,2,1,2,0,1,0,71.08
嘉義縣,梅山鄉,,0,0,13321,192,13513,17138,5,1,5,0,1,0,78.85
嘉義縣,番路鄉,,0,0,6639,80,6719,8865,2,1,2,0,1,0,75.79
嘉義縣,大埔鄉,,0,0,2166,25,2191,2867,2,1,2,0,1,0,76.42
嘉義縣,阿里山鄉,,0,0,2970,50,3020,4547,3,1,3,0,1,0,66.42
臺南縣,新營市,,0,0,33653,794,34447,50732,3,1,2,1,1,0,67.90
臺南縣,鹽水鎮,,0,0,14701,380,15081,20931,2,1,2,0,1,0,72.05
臺南縣,白河鎮,,0,0,16383,2060,18443,26842,1,1,1,0,1,0,68.71
臺南縣,柳營鄉,,0,0,11422,928,12350,17731,1,1,1,0,1,0,69.65
臺南縣,後壁鄉,,0,0,15502,338,15840,21770,3,1,2,1,1,0,72.76
臺南縣,東山鄉,,0,0,14151,220,14371,19386,4,1,4,0,1,0,74.13
臺南縣,麻豆鎮,,0,0,25433,345,25778,33398,3,1,2,1,1,0,77.18
臺南縣,下營鄉,,0,0,15616,211,15827,20305,4,1,3,1,1,0,77.95
臺南縣,六甲鄉,,0,0,12715,160,12875,17481,2,1,1,1,1,0,73.65
臺南縣,官田鄉,,0,0,11638,320,11958,17466,2,1,2,0,1,0,68.46
臺南縣,大內鄉,,0,0,7684,128,7812,9544,2,1,2,0,1,0,81.85
臺南縣,佳里鎮,,0,0,27582,403,27985,38289,4,1,3,1,1,0,73.09
臺南縣,學甲鎮,,0,0,15952,245,16197,21376,5,1,5,0,1,0,75.77
臺南縣,西港鄉,,0,0,13940,210,14150,17523,2,1,2,0,1,0,80.75
臺南縣,七股鄉,,0,0,14430,244,14674,19536,2,1,1,1,1,0,75.11
臺南縣,將軍鄉,,0,0,13708,202,13910,17812,3,1,3,0,1,0,78.09
臺南縣,北門鄉,,0,0,8664,115,8779,10361,2,1,2,0,1,0,84.73
臺南縣,新化鎮,,0,0,21235,345,21580,30471,4,1,3,1,1,0,70.82
臺南縣,善化鎮,,0,0,20210,467,20677,29175,6,1,6,0,1,0,70.87
臺南縣,新市鄉,,0,0,14572,467,15039,21023,3,1,3,0,1,0,71.54
臺南縣,安定鄉,,0,0,16072,456,16528,20417,2,1,2,0,1,0,80.95
臺南縣,山上鄉,,0,0,5197,72,5269,5929,4,1,4,0,1,0,88.87
臺南縣,玉井鄉,,0,0,9554,146,9700,12605,3,1,3,0,1,0,76.95
臺南縣,楠西鄉,,0,0,7930,128,8058,9248,2,1,2,0,1,0,87.13
臺南縣,南化鄉,,0,0,6125,68,6193,7402,2,1,2,0,1,0,83.67
臺南縣,左鎮鄉,,0,0,4172,42,4214,5061,3,1,2,1,1,0,83.26
臺南縣,仁德鄉,,0,0,31228,1259,32487,44251,2,1,2,0,1,0,73.42
臺南縣,歸仁鄉,,0,0,27829,517,28346,39788,4,1,4,0,1,0,71.24
臺南縣,關廟鄉,,0,0,20566,286,20852,27264,3,1,3,0,1,0,76.48
臺南縣,龍崎鄉,,0,0,3017,75,3092,3671,2,1,2,0,1,0,84.23
臺南縣,永康市,,0,0,56512,2344,58856,118764,3,1,3,0,1,0,49.56
高雄縣,鳳山市,,0,0,120977,4480,125457,210291,4,1,4,0,1,0,59.66
高雄縣,林園鄉,,0,0,37197,541,37738,46621,3,1,2,1,0,1,80.95
高雄縣,大寮鄉,,0,0,55902,1420,57322,77584,3,1,1,2,0,1,73.88
高雄縣,大樹鄉,,0,0,24862,484,25346,32818,2,1,2,0,1,0,77.23
高雄縣,大社鄉,,0,0,17554,418,17972,22526,4,1,4,0,1,0,79.78
高雄縣,仁武鄉,,0,0,22969,468,23437,31078,3,1,3,0,1,0,75.41
高雄縣,鳥松鄉,,0,0,18327,545,18872,25098,2,1,2,0,1,0,75.19
高雄縣,岡山鎮,,0,0,34774,4692,39466,60971,1,1,1,0,1,0,64.73
高雄縣,橋頭鄉,,0,0,19863,564,20427,26863,2,1,2,0,1,0,76.04
高雄縣,燕巢鄉,,0,0,18217,337,18554,23083,2,1,2,0,1,0,80.38
高雄縣,田寮鄉,,0,0,6512,95,6607,7908,4,1,4,0,1,0,83.55
高雄縣,阿蓮鄉,,0,0,14372,288,14660,20614,2,1,2,0,1,0,71.12
高雄縣,路竹鄉,,0,0,29208,704,29912,35726,2,1,2,0,1,0,83.73
高雄縣,湖內鄉,,0,0,14897,340,15237,19305,2,1,2,0,1,0,78.93
高雄縣,茄萣鄉,,0,0,18745,361,19106,22881,3,1,3,0,1,0,83.50
高雄縣,永安鄉,,0,0,9108,209,9317,10563,2,1,2,0,1,0,88.20
高雄縣,彌陀鄉,,0,0,13465,206,13671,15755,3,1,3,0,1,0,86.77
高雄縣,梓官鄉,,0,0,20660,631,21291,27167,2,1,2,0,1,0,78.37
高雄縣,旗山鎮,,0,0,24726,320,25046,32638,4,1,3,1,1,0,76.74
高雄縣,美濃鎮,,0,0,26846,526,27372,35179,2,1,2,0,1,0,77.81
高雄縣,六龜鄉,,0,0,8735,280,9015,13283,2,1,2,0,1,0,67.87
高雄縣,甲仙鄉,,0,0,5409,39,5448,6519,2,1,2,0,1,0,83.57
高雄縣,杉林鄉,,0,0,7700,151,7851,10530,2,1,2,0,1,0,74.56
高雄縣,內門鄉,,0,0,11859,110,11969,13419,2,1,2,0,1,0,89.19
高雄縣,茂林鄉,,0,0,1141,27,1168,1303,3,1,3,0,1,0,89.64
高雄縣,桃源鄉,,0,0,2008,247,2255,3022,1,1,1,0,1,0,74.62
高雄縣,三民鄉,,0,0,1696,23,1719,1952,3,1,3,0,1,0,88.06
屏東縣,屏東市,,0,0,93377,1482,94859,145040,4,1,4,0,1,0,65.40
屏東縣,潮州鎮,,0,0,25672,412,26084,38981,3,1,2,1,1,0,66.91
屏東縣,東港鎮,,0,0,22515,720,23235,32109,2,1,2,0,1,0,72.36
屏東縣,恆春鎮,,0,0,15208,244,15452,22191,2,1,2,0,1,0,69.63
屏東縣,萬丹鄉,,0,0,26481,718,27199,35957,3,1,3,0,1,0,75.64
屏東縣,長治鄉,,0,0,14583,309,14892,20754,3,1,3,0,1,0,71.75
屏東縣,麟洛鄉,,0,0,6524,61,6585,8295,3,1,3,0,1,0,79.39
屏東縣,九如鄉,,0,0,12370,224,12594,15669,2,1,2,0,1,0,80.38
屏東縣,里港鄉,,0,0,15022,221,15243,18972,2,1,2,0,1,0,80.34
屏東縣,鹽埔鄉,,0,0,15697,386,16083,19624,2,1,2,0,1,0,81.96
屏東縣,高樹鄉,,0,0,15698,292,15990,22567,4,1,4,0,1,0,70.86
屏東縣,萬巒鄉,,0,0,12853,215,13068,17729,2,1,2,0,1,0,73.71
屏東縣,內埔鄉,,0,0,27933,505,28438,43923,6,1,6,0,1,0,64.75
屏東縣,竹田鄉,,0,0,10751,164,10915,14152,2,1,2,0,1,0,77.13
屏東縣,新埤鄉,,0,0,6711,86,6797,8945,2,1,1,1,1,0,75.99
屏東縣,枋寮鄉,,0,0,15883,228,16111,21496,2,1,2,0,1,0,74.95
屏東縣,新園鄉,,0,0,22934,475,23409,27938,2,1,2,0,1,0,83.79
屏東縣,崁頂鄉,,0,0,7642,130,7772,9805,2,1,2,0,1,0,79.27
屏東縣,林邊鄉,,0,0,11423,186,11609,16465,4,1,4,0,1,0,70.51
屏東縣,南州鄉,,0,0,6959,111,7070,9670,2,1,2,0,1,0,73.11
屏東縣,佳冬鄉,,0,0,12391,220,12611,17359,2,1,2,0,1,0,72.65
屏東縣,琉球鄉,,0,0,7372,109,7481,9608,2,1,2,0,1,0,77.86
屏東縣,車城鄉,,0,0,5834,95,5929,8424,2,1,2,0,1,0,70.38
屏東縣,滿州鄉,,0,0,5099,94,5193,6851,2,1,2,0,1,0,75.80
屏東縣,枋山鄉,,0,0,4216,102,4318,5245,2,1,2,0,1,0,82.33
屏東縣,三地門鄉,,0,0,3836,58,3894,4914,2,1,2,0,1,0,79.24
屏東縣,霧臺鄉,,0,0,2203,36,2239,2555,3,1,3,0,1,0,87.63
屏東縣,瑪家鄉,,0,0,3419,53,3472,4338,3,1,3,0,1,0,80.04
屏東縣,泰武鄉,,0,0,2439,50,2489,3253,3,1,3,0,1,0,76.51
屏東縣,來義鄉,,0,0,3747,221,3968,5343,1,1,1,0,1,0,74.27
屏東縣,春日鄉,,0,0,2689,60,2749,3438,2,1,2,0,1,0,79.96
屏東縣,獅子鄉,,0,0,2574,40,2614,3634,3,1,3,0,1,0,71.93
屏東縣,牡丹鄉,,0,0,2452,48,2500,3803,2,1,2,0,1,0,65.74
臺東縣,臺東市,,0,0,49300,1065,50365,75878,5,1,4,1,1,0,66.38
臺東縣,成功鎮,,0,0,7665,110,7775,13815,2,1,2,0,1,0,56.28
臺東縣,關山鎮,,0,0,5126,74,5200,8042,2,1,2,0,1,0,64.66
臺東縣,卑南鄉,,0,0,8601,916,9517,14855,1,1,1,0,1,0,64.07
臺東縣,鹿野鄉,,0,0,4951,93,5044,7548,3,1,3,0,1,0,66.83
臺東縣,池上鄉,,0,0,5067,124,5191,8306,4,1,4,0,1,0,62.50
臺東縣,東河鄉,,0,0,4368,616,4984,9315,1,1,1,0,1,0,53.51
臺東縣,長濱鄉,,0,0,4593,57,4650,8508,3,1,3,0,1,0,54.65
臺東縣,太麻里鄉,,0,0,5608,567,6175,9978,1,1,1,0,1,0,61.89
臺東縣,大武鄉,,0,0,2726,186,2912,4821,1,1,1,0,1,0,60.40
臺東縣,綠島鄉,,0,0,1394,15,1409,1759,2,1,2,0,1,0,80.10
臺東縣,海端鄉,,0,0,1945,60,2005,3088,2,1,2,0,1,0,64.93
臺東縣,延平鄉,,0,0,1493,216,1709,2611,1,1,1,0,1,0,65.45
臺東縣,金峰鄉,,0,0,1782,18,1800,2291,5,1,5,0,1,0,78.57
臺東縣,達仁鄉,,0,0,1674,87,1761,2973,1,1,1,0,1,0,59.23
臺東縣,蘭嶼鄉,,0,0,1356,55,1411,1900,3,1,3,0,1,0,74.26
花蓮縣,花蓮市,,0,0,42181,1395,43576,72222,2,1,1,1,1,0,60.34
花蓮縣,鳳林鎮,,0,0,6342,678,7020,11042,1,1,1,0,1,0,63.58
花蓮縣,玉里鎮,,0,0,13522,500,14022,24273,3,1,2,1,1,0,57.77
花蓮縣,新城鄉,,0,0,7464,1036,8500,14236,1,1,1,0,1,0,59.71
花蓮縣,吉安鄉,,0,0,24215,2486,26701,48847,1,1,1,0,1,0,54.66
花蓮縣,壽豐鄉,,0,0,10276,176,10452,15260,3,1,2,1,0,1,68.49
花蓮縣,光復鄉,,0,0,7501,167,7668,12592,3,1,3,0,1,0,60.90
花蓮縣,豐濱鄉,,0,0,2777,44,2821,5034,3,1,3,0,1,0,56.04
花蓮縣,瑞穗鄉,,0,0,6513,107,6620,11286,3,1,3,0,1,0,58.66
花蓮縣,富里鄉,,0,0,5463,581,6044,11282,1,1,1,0,1,0,53.57
花蓮縣,秀林鄉,,0,0,6730,158,6888,9559,3,1,3,0,1,0,72.06
花蓮縣,萬榮鄉,,0,0,3261,98,3359,4814,4,1,4,0,1,0,69.78
花蓮縣,卓溪鄉,,0,0,3095,74,3169,4877,3,1,2,1,1,0,64.98
澎湖縣,馬公市,,0,0,25045,759,25804,34688,2,1,1,1,0,1,74.39
澎湖縣,湖西鄉,,0,0,6969,123,7092,9462,2,1,2,0,1,0,74.95
澎湖縣,白沙鄉,,0,0,4750,547,5297,6902,1,1,1,0,1,0,76.75
澎湖縣,西嶼鄉,,0,0,3914,667,4581,6788,1,1,1,0,1,0,67.49
澎湖縣,望安鄉,,0,0,2962,52,3014,3991,2,1,2,0,1,0,75.52
澎湖縣,七美鄉,,0,0,1810,26,1836,2403,2,1,2,0,1,0,76.40
金門縣,金城鎮,,0,0,8287,246,8533,10533,5,1,5,0,1,0,81.01
金門縣,金沙鎮,,0,0,4366,157,4523,5799,2,1,2,0,1,0,78.00
金門縣,金湖鎮,,0,0,6054,172,6226,7419,3,1,3,0,1,0,83.92
金門縣,金寧鄉,,0,0,4607,146,4753,5884,2,1,2,0,1,0,80.78
金門縣,烈嶼鄉,,0,0,2554,53,2607,3277,2,1,2,0,1,0,79.55
金門縣,烏坵鄉,,0,0,29,0,29,98,1,1,1,0,1,0,29.59
連江縣,南竿鄉,,0,0,2318,88,2406,3214,2,1,2,0,1,0,74.86
連江縣,北竿鄉,,0,0,1028,29,1057,1332,2,1,2,0,1,0,79.35
連江縣,莒光鄉,,0,0,830,17,847,1103,2,1,2,0,1,0,76.79
連江縣,東引鄉,,0,0,328,50,378,497,1,1,1,0,1,0,76.06
