CountyCityName,TownshipName,VillageName,PollStationNo,DistrictName,BallotsAccepted,BallotsRejected,BallotsCast,Voters,CandidateCounts,ElectedCounts,CandidateMaleCounts,CandidateFemaleCounts,ElectedMaleCounts,ElectedFemaleCounts,BallotsRate
全國,,,0,0,3485328,102609,3587937,6257549,3819,2322,3013,806,1795,527,57.34
宜蘭縣,,,0,0,204024,5430,209454,351390,220,131,192,28,115,16,59.61
桃園縣,,,0,0,627086,14850,641936,1442469,334,225,249,85,164,61,44.50
新竹縣,,,0,0,198415,6966,205381,371319,247,144,205,42,115,29,55.31
苗栗縣,,,0,0,265734,7130,272864,426331,320,193,245,75,152,41,64.00
彰化縣,,,0,0,595660,21734,617394,991443,507,317,395,112,238,79,62.27
南投縣,,,0,0,235353,8140,243493,407863,258,163,199,59,120,43,59.70
雲林縣,,,0,0,353774,10131,363905,559625,369,228,308,61,189,39,65.03
嘉義縣,,,0,0,277476,10900,288376,428932,275,193,201,74,141,52,67.23
屏東縣,,,0,0,414803,9124,423927,681325,587,334,485,102,272,62,62.22
臺東縣,,,0,0,104121,3082,107203,178371,247,136,196,51,101,35,60.10
花蓮縣,,,0,0,127557,3157,130714,259947,273,142,202,71,102,40,50.28
澎湖縣,,,0,0,44591,1265,45856,75876,85,51,65,20,36,15,60.44
金門縣,,,0,0,31549,605,32154,74843,65,43,46,19,33,10,42.96
連江縣,,,0,0,5185,95,5280,7815,32,22,25,7,17,5,67.56
宜蘭縣,宜蘭市,,0,0,33154,1144,34298,70525,26,16,22,4,14,2,48.63
宜蘭縣,羅東鎮,,0,0,22768,601,23369,52526,24,13,18,6,11,2,44.49
宜蘭縣,蘇澳鎮,,0,0,22398,357,22755,34201,19,11,14,5,7,4,66.53
宜蘭縣,頭城鎮,,0,0,17807,323,18130,24175,18,11,16,2,10,1,74.99
宜蘭縣,礁溪鄉,,0,0,19337,384,19721,28020,16,11,13,3,9,2,70.38
宜蘭縣,壯圍鄉,,0,0,13789,958,14747,19675,16,11,16,0,11,0,74.95
宜蘭縣,員山鄉,,0,0,15278,315,15593,25260,19,11,18,1,11,0,61.73
宜蘭縣,冬山鄉,,0,0,22502,609,23111,40435,17,11,15,2,10,1,57.16
宜蘭縣,五結鄉,,0,0,18904,339,19243,30636,21,11,19,2,9,2,62.81
宜蘭縣,三星鄉,,0,0,10812,339,11151,17297,15,11,14,1,10,1,64.47
宜蘭縣,大同鄉,,0,0,3707,39,3746,4407,13,7,13,0,7,0,85.00
宜蘭縣,南澳鄉,,0,0,3568,22,3590,4233,16,7,14,2,6,1,84.81
桃園縣,桃園市,,0,0,94370,1799,96169,288428,40,27,26,14,18,9,33.34
桃園縣,龜山鄉,,0,0,39866,999,40865,101053,22,18,16,6,13,5,40.44
桃園縣,八德市,,0,0,60683,1712,62395,130750,26,19,15,11,9,10,47.72
桃園縣,蘆竹鄉,,0,0,42604,607,43211,96898,28,18,20,8,14,4,44.59
桃園縣,大園鄉,,0,0,35109,656,35765,58953,22,13,19,3,11,2,60.67
桃園縣,大溪鎮,,0,0,36169,644,36813,67674,24,16,18,6,11,5,54.40
桃園縣,復興鄉,,0,0,5968,98,6066,8057,21,11,18,3,9,2,75.29
桃園縣,中壢市,,0,0,112784,2158,114942,269127,39,27,28,11,20,7,42.71
桃園縣,平鎮市,,0,0,63287,1524,64811,149779,29,20,22,7,15,5,43.27
桃園縣,楊梅鎮,,0,0,51704,1203,52907,106671,30,18,22,8,13,5,49.60
桃園縣,龍潭鄉,,0,0,36606,706,37312,83861,24,16,20,4,13,3,44.49
桃園縣,新屋鄉,,0,0,23909,910,24819,37018,16,11,14,2,9,2,67.05
桃園縣,觀音鄉,,0,0,24027,1834,25861,44200,13,11,11,2,9,2,58.51
新竹縣,竹北市,,0,0,35881,1140,37021,95379,28,18,23,5,14,4,38.81
新竹縣,竹東鎮,,0,0,33764,909,34673,69369,24,15,19,5,13,2,49.98
新竹縣,新埔鎮,,0,0,15617,765,16382,27931,14,11,13,1,10,1,58.65
新竹縣,關西鎮,,0,0,16717,598,17315,24877,20,11,17,3,10,1,69.60
新竹縣,湖口鄉,,0,0,30615,1856,32471,54813,20,13,16,4,10,3,59.24
新竹縣,新豐鄉,,0,0,21268,668,21936,37824,19,11,16,3,9,2,57.99
新竹縣,芎林鄉,,0,0,11000,211,11211,16002,17,11,13,4,9,2,70.06
新竹縣,橫山鄉,,0,0,8791,300,9091,11577,17,11,15,2,9,2,78.53
新竹縣,北埔鄉,,0,0,5721,112,5833,8024,15,11,10,5,7,4,72.69
新竹縣,寶山鄉,,0,0,7169,115,7284,10813,18,11,15,3,9,2,67.36
新竹縣,峨眉鄉,,0,0,4148,59,4207,5007,12,7,8,4,3,4,84.02
新竹縣,尖石鄉,,0,0,4656,123,4779,5994,22,7,21,1,6,1,79.73
新竹縣,五峰鄉,,0,0,3068,110,3178,3709,21,7,19,2,6,1,85.68
苗栗縣,苗栗市,,0,0,35370,979,36349,68940,28,16,17,11,10,6,52.73
苗栗縣,苑裡鎮,,0,0,24096,908,25004,36901,16,11,13,3,8,3,67.76
苗栗縣,通霄鎮,,0,0,20175,367,20542,30095,19,11,14,5,8,3,68.26
苗栗縣,竹南鎮,,0,0,32892,758,33650,56542,24,13,19,5,12,1,59.51
苗栗縣,頭份鎮,,0,0,36608,1652,38260,70658,21,15,17,4,13,2,54.15
苗栗縣,後龍鎮,,0,0,20697,724,21421,30515,18,11,14,4,9,2,70.20
苗栗縣,卓蘭鎮,,0,0,10370,288,10658,14697,16,11,10,6,7,4,72.52
苗栗縣,大湖鄉,,0,0,9618,135,9753,12604,17,11,14,3,9,2,77.38
苗栗縣,公館鄉,,0,0,16637,327,16964,26365,16,11,10,6,6,5,64.34
苗栗縣,銅鑼鄉,,0,0,10450,197,10647,15216,21,11,18,3,11,0,69.97
苗栗縣,南庄鄉,,0,0,6147,109,6256,8925,20,11,14,6,8,3,70.10
苗栗縣,頭屋鄉,,0,0,7135,156,7291,9279,24,11,19,5,10,1,78.58
苗栗縣,三義鄉,,0,0,9886,144,10030,13545,17,11,14,3,9,2,74.05
苗栗縣,西湖鄉,,0,0,5307,75,5382,6469,9,7,5,4,4,3,83.20
苗栗縣,造橋鄉,,0,0,8277,150,8427,10731,19,11,16,3,10,1,78.53
苗栗縣,三灣鄉,,0,0,4486,57,4543,5899,11,7,8,3,5,2,77.01
苗栗縣,獅潭鄉,,0,0,3400,54,3454,4258,10,7,9,1,6,1,81.12
苗栗縣,泰安鄉,,0,0,4183,50,4233,4692,14,7,14,0,7,0,90.22
彰化縣,彰化市,,0,0,84091,3584,87675,175502,41,24,32,9,16,8,49.96
彰化縣,花壇鄉,,0,0,20739,834,21573,35203,18,11,13,5,6,5,61.28
彰化縣,芬園鄉,,0,0,15316,318,15634,19641,23,11,20,3,10,1,79.60
彰化縣,鹿港鎮,,0,0,36427,999,37426,63487,20,15,14,6,12,3,58.95
彰化縣,福興鄉,,0,0,23689,971,24660,36821,18,11,16,2,9,2,66.97
彰化縣,秀水鄉,,0,0,18556,548,19104,28814,15,11,11,4,9,2,66.30
彰化縣,和美鎮,,0,0,35963,2119,38082,67372,24,15,15,9,9,6,56.52
彰化縣,線西鄉,,0,0,8926,274,9200,12966,17,11,12,5,9,2,70.95
彰化縣,伸港鄉,,0,0,16816,348,17164,26645,18,11,14,4,8,3,64.42
彰化縣,員林鎮,,0,0,49071,1357,50428,93486,30,19,20,10,12,7,53.94
彰化縣,大村鄉,,0,0,18382,765,19147,28078,19,11,14,5,7,4,68.19
彰化縣,永靖鄉,,0,0,19980,828,20808,30089,19,11,15,4,9,2,69.15
彰化縣,溪湖鎮,,0,0,28121,1304,29425,41488,17,12,11,6,8,4,70.92
彰化縣,埔鹽鄉,,0,0,18786,959,19745,26659,14,11,9,5,6,5,74.07
彰化縣,埔心鄉,,0,0,17607,653,18260,27344,15,11,13,2,10,1,66.78
彰化縣,田中鎮,,0,0,19636,672,20308,34263,17,11,13,4,8,3,59.27
彰化縣,社頭鄉,,0,0,20373,643,21016,34171,18,11,16,2,10,1,61.50
彰化縣,二水鄉,,0,0,10103,248,10351,13563,19,11,16,3,8,3,76.32
彰化縣,北斗鎮,,0,0,15333,449,15782,25320,17,11,14,3,10,1,62.33
彰化縣,溪州鄉,,0,0,16305,611,16916,24832,21,11,18,3,9,2,68.12
彰化縣,田尾鄉,,0,0,14657,626,15283,21980,16,11,13,3,9,2,69.53
彰化縣,埤頭鄉,,0,0,16300,429,16729,24478,18,11,14,4,8,3,68.34
彰化縣,二林鎮,,0,0,27863,1056,28919,41745,17,12,14,3,9,3,69.28
彰化縣,芳苑鄉,,0,0,20630,589,21219,29042,18,11,15,3,9,2,73.06
彰化縣,大城鄉,,0,0,12049,220,12269,15571,21,11,16,5,7,4,78.79
彰化縣,竹塘鄉,,0,0,9941,330,10271,12883,17,11,17,0,11,0,79.73
南投縣,南投市,,0,0,40544,1037,41581,78749,28,18,17,11,12,6,52.80
南投縣,埔里鎮,,0,0,33112,1057,34169,65341,26,16,19,7,11,5,52.29
南投縣,草屯鎮,,0,0,41830,1240,43070,75775,29,17,21,8,11,6,56.84
南投縣,竹山鎮,,0,0,24540,1600,26140,45823,18,13,12,6,8,5,57.05
南投縣,集集鎮,,0,0,7387,131,7518,9694,18,11,14,4,8,3,77.55
南投縣,名間鄉,,0,0,19467,1155,20622,32268,14,11,12,2,10,1,63.91
南投縣,鹿谷鄉,,0,0,10466,157,10623,15712,16,11,12,4,9,2,67.61
南投縣,中寮鄉,,0,0,8294,555,8849,13349,13,11,11,2,9,2,66.29
南投縣,魚池鄉,,0,0,9301,247,9548,13964,16,11,15,1,10,1,68.38
南投縣,國姓鄉,,0,0,11621,307,11928,16823,18,11,13,5,8,3,70.90
南投縣,水里鄉,,0,0,11313,227,11540,16274,16,11,12,4,7,4,70.91
南投縣,信義鄉,,0,0,9333,317,9650,12622,22,11,20,2,9,2,76.45
南投縣,仁愛鄉,,0,0,8145,110,8255,11469,24,11,21,3,8,3,71.98
雲林縣,斗六市,,0,0,40417,1039,41456,79254,32,17,25,7,12,5,52.31
雲林縣,斗南鎮,,0,0,23009,514,23523,36323,26,11,21,5,9,2,64.76
雲林縣,虎尾鎮,,0,0,31740,888,32628,52743,19,13,14,5,10,3,61.86
雲林縣,西螺鎮,,0,0,23055,1027,24082,36752,14,11,12,2,10,1,65.53
雲林縣,土庫鎮,,0,0,16035,654,16689,23769,20,11,16,4,9,2,70.21
雲林縣,北港鎮,,0,0,20685,642,21327,33704,16,11,12,4,8,3,63.28
雲林縣,古坑鄉,,0,0,17434,311,17745,26661,20,11,18,2,9,2,66.56
雲林縣,大埤鄉,,0,0,11859,226,12085,16892,17,11,15,2,10,1,71.54
雲林縣,莿桐鄉,,0,0,16721,319,17040,23859,16,11,11,5,7,4,71.42
雲林縣,林內鄉,,0,0,9995,319,10314,15470,20,11,18,2,9,2,66.67
雲林縣,二崙鄉,,0,0,15751,326,16077,23632,20,11,19,1,10,1,68.03
雲林縣,崙背鄉,,0,0,12795,583,13378,21861,13,11,12,1,10,1,61.20
雲林縣,麥寮鄉,,0,0,17846,706,18552,25959,18,11,13,5,9,2,71.47
雲林縣,東勢鄉,,0,0,9396,248,9644,14040,19,11,18,1,10,1,68.69
雲林縣,褒忠鄉,,0,0,7978,146,8124,11527,18,11,13,5,8,3,70.48
雲林縣,台西鄉,,0,0,12388,650,13038,21657,14,11,12,2,10,1,60.20
雲林縣,元長鄉,,0,0,16416,287,16703,23934,16,11,14,2,10,1,69.79
雲林縣,四湖鄉,,0,0,15241,257,15498,22484,18,11,16,2,9,2,68.93
雲林縣,口湖鄉,,0,0,17943,329,18272,25016,17,11,16,1,11,0,73.04
雲林縣,水林鄉,,0,0,17070,660,17730,24088,16,11,13,3,9,2,73.61
嘉義縣,太保市,,0,0,19167,490,19657,26793,15,11,10,5,8,3,73.37
嘉義縣,朴子市,,0,0,19180,1345,20525,33378,14,11,9,5,8,3,61.49
嘉義縣,布袋鎮,,0,0,16678,394,17072,24815,17,11,13,4,8,3,68.80
嘉義縣,大林鎮,,0,0,17746,337,18083,26480,16,11,11,5,6,5,68.29
嘉義縣,民雄鄉,,0,0,34000,1556,35556,55209,18,13,11,7,8,5,64.40
嘉義縣,溪口鄉,,0,0,10006,125,10131,13250,15,11,10,5,7,4,76.46
嘉義縣,新港鄉,,0,0,19267,409,19676,26724,16,11,11,5,7,4,73.63
嘉義縣,六腳鄉,,0,0,15316,856,16172,21981,16,11,12,4,8,3,73.57
嘉義縣,東石鄉,,0,0,16379,396,16775,23114,18,11,12,6,8,3,72.58
嘉義縣,義竹鄉,,0,0,10987,393,11380,17696,14,11,9,5,7,4,64.31
嘉義縣,鹿草鄉,,0,0,10356,552,10908,14253,13,11,9,4,8,3,76.53
嘉義縣,水上鄉,,0,0,25635,1377,27012,41557,18,12,16,2,11,1,65.00
嘉義縣,中埔鄉,,0,0,17360,1704,19064,37437,12,11,9,3,8,3,50.92
嘉義縣,竹崎鄉,,0,0,20990,403,21393,30774,17,11,13,4,9,2,69.52
嘉義縣,梅山鄉,,0,0,10781,392,11173,17551,16,11,13,3,9,2,63.66
嘉義縣,番路鄉,,0,0,7272,73,7345,9468,15,11,11,4,8,3,77.58
嘉義縣,大埔鄉,,0,0,3106,45,3151,3682,11,7,9,2,6,1,85.58
嘉義縣,阿里山鄉,,0,0,3250,53,3303,4770,14,7,13,1,7,0,69.25
屏東縣,屏東市,,0,0,69347,1203,70550,162828,38,23,23,15,14,9,43.33
屏東縣,潮州鎮,,0,0,24340,436,24776,42960,22,12,18,4,8,4,57.67
屏東縣,東港鎮,,0,0,21115,1200,22315,36934,16,11,14,2,10,1,60.42
屏東縣,恆春鎮,,0,0,14957,238,15195,23394,23,11,21,2,11,0,64.95
屏東縣,萬丹鄉,,0,0,26901,491,27392,41313,21,11,19,2,10,1,66.30
屏東縣,長治鄉,,0,0,14840,241,15081,24489,22,11,19,3,10,1,61.58
屏東縣,麟洛鄉,,0,0,6508,79,6587,9570,17,11,15,2,9,2,68.83
屏東縣,九如鄉,,0,0,13071,174,13245,17653,18,11,16,2,10,1,75.03
屏東縣,里港鄉,,0,0,11226,648,11874,20249,12,11,11,1,11,0,58.64
屏東縣,鹽埔鄉,,0,0,14312,313,14625,21470,18,11,16,2,9,2,68.12
屏東縣,高樹鄉,,0,0,15209,982,16191,21944,15,11,13,2,10,1,73.78
屏東縣,萬巒鄉,,0,0,11982,236,12218,17591,22,11,18,4,9,2,69.46
屏東縣,內埔鄉,,0,0,27095,461,27556,45577,25,13,19,6,8,5,60.46
屏東縣,竹田鄉,,0,0,11492,142,11634,14950,16,11,11,5,7,4,77.82
屏東縣,新埤鄉,,0,0,6907,69,6976,8937,18,11,15,3,9,2,78.06
屏東縣,枋寮鄉,,0,0,15235,214,15449,21388,16,11,11,5,7,4,72.23
屏東縣,新園鄉,,0,0,19654,729,20383,29999,17,11,17,0,11,0,67.95
屏東縣,崁頂鄉,,0,0,8729,130,8859,11858,17,11,14,3,9,2,74.71
屏東縣,林邊鄉,,0,0,12166,128,12294,16664,21,11,17,4,8,3,73.78
屏東縣,南州鄉,,0,0,7471,106,7577,9623,20,11,17,3,9,2,78.74
屏東縣,佳冬鄉,,0,0,12482,277,12759,17293,15,11,13,2,10,1,73.78
屏東縣,琉球鄉,,0,0,6215,123,6338,10036,16,11,16,0,11,0,63.15
屏東縣,車城鄉,,0,0,6044,98,6142,7959,18,7,17,1,7,0,77.17
屏東縣,滿州鄉,,0,0,5061,78,5139,6984,14,7,13,1,6,1,73.58
屏東縣,枋山鄉,,0,0,3832,52,3884,4866,14,7,13,1,6,1,79.82
屏東縣,三地門鄉,,0,0,4911,49,4960,5852,15,7,12,3,6,1,84.76
屏東縣,霧臺鄉,,0,0,2233,16,2249,2461,16,7,13,3,6,1,91.39
屏東縣,瑪家鄉,,0,0,4231,42,4273,5177,13,7,10,3,4,3,82.54
屏東縣,泰武鄉,,0,0,3231,31,3262,3872,18,7,12,6,5,2,84.25
屏東縣,來義鄉,,0,0,4667,37,4704,5922,12,7,9,3,5,2,79.43
屏東縣,春日鄉,,0,0,3112,33,3145,3645,11,7,8,3,5,2,86.28
屏東縣,獅子鄉,,0,0,3149,29,3178,3843,15,7,12,3,6,1,82.70
屏東縣,牡丹鄉,,0,0,3078,39,3117,4024,16,7,13,3,6,1,77.46
臺東縣,台東市,,0,0,40874,1434,42308,81006,35,19,29,6,15,4,52.23
臺東縣,成功鎮,,0,0,7636,93,7729,12813,16,11,13,3,8,3,60.32
臺東縣,關山鎮,,0,0,4666,132,4798,7553,11,7,10,1,7,0,63.52
臺東縣,卑南鄉,,0,0,9166,299,9465,14588,18,11,15,3,9,2,64.88
臺東縣,鹿野鄉,,0,0,4260,138,4398,6948,14,7,11,3,5,2,63.30
臺東縣,池上鄉,,0,0,4584,139,4723,7417,13,7,10,3,5,2,63.68
臺東縣,東河鄉,,0,0,4892,154,5046,7961,11,7,8,3,5,2,63.38
臺東縣,長濱鄉,,0,0,4251,53,4304,7053,15,7,10,5,3,4,61.02
臺東縣,太麻里鄉,,0,0,6687,148,6835,9531,21,11,15,6,6,5,71.71
臺東縣,大武鄉,,0,0,4085,77,4162,5693,15,7,14,1,6,1,73.11
臺東縣,綠島鄉,,0,0,1787,132,1919,2651,9,7,6,3,5,2,72.39
臺東縣,海端鄉,,0,0,2109,61,2170,3195,13,7,11,2,6,1,67.92
臺東縣,延平鄉,,0,0,2108,62,2170,2761,10,7,8,2,7,0,78.59
臺東縣,金峰鄉,,0,0,2290,45,2335,2733,13,7,10,3,5,2,85.44
臺東縣,達仁鄉,,0,0,2565,24,2589,3282,13,7,8,5,3,4,78.88
臺東縣,蘭嶼鄉,,0,0,2161,91,2252,3186,20,7,18,2,6,1,70.68
花蓮縣,花蓮市,,0,0,31149,603,31752,80081,36,19,24,12,13,6,39.65
花蓮縣,鳳林鎮,,0,0,7006,266,7272,9882,18,11,14,4,9,2,73.59
花蓮縣,玉里鎮,,0,0,11925,484,12409,21381,21,11,16,5,7,4,58.04
花蓮縣,新城鄉,,0,0,7937,153,8090,15501,23,11,18,5,7,4,52.19
花蓮縣,吉安鄉,,0,0,22289,568,22857,62185,25,14,19,6,12,2,36.76
花蓮縣,壽豐鄉,,0,0,9751,207,9958,15085,21,11,18,3,9,2,66.01
花蓮縣,光復鄉,,0,0,7443,120,7563,11557,21,11,15,6,9,2,65.44
花蓮縣,豐濱鄉,,0,0,3121,56,3177,4351,18,7,13,5,6,1,73.02
花蓮縣,瑞穗鄉,,0,0,6525,129,6654,10370,22,11,19,3,9,2,64.17
花蓮縣,富里鄉,,0,0,5843,193,6036,9544,15,11,10,5,6,5,63.24
花蓮縣,秀林鄉,,0,0,7971,190,8161,10400,17,11,10,7,6,5,78.47
花蓮縣,萬榮鄉,,0,0,3496,100,3596,4886,22,7,17,5,6,1,73.60
花蓮縣,卓溪鄉,,0,0,3101,88,3189,4724,14,7,9,5,3,4,67.51
澎湖縣,馬公市,,0,0,22786,846,23632,43542,20,12,14,6,7,5,54.27
澎湖縣,湖西鄉,,0,0,7614,196,7810,10942,18,11,13,5,7,4,71.38
澎湖縣,白沙鄉,,0,0,5270,80,5350,7713,14,7,12,2,6,1,69.36
澎湖縣,西嶼鄉,,0,0,4388,65,4453,6879,12,7,11,1,6,1,64.73
澎湖縣,望安鄉,,0,0,2502,44,2546,3909,10,7,6,4,4,3,65.13
澎湖縣,七美鄉,,0,0,2031,34,2065,2891,11,7,9,2,6,1,71.43
金門縣,金城鎮,,0,0,9025,180,9205,24871,14,11,9,5,7,4,37.01
金門縣,金湖鎮,,0,0,6966,148,7114,16409,13,9,7,6,7,2,43.35
金門縣,金沙鎮,,0,0,5333,105,5438,11966,10,7,8,2,5,2,45.45
金門縣,金寧鄉,,0,0,5681,120,5801,14085,13,7,11,2,6,1,41.19
金門縣,烈嶼鄉,,0,0,4247,52,4299,7151,10,6,7,3,5,1,60.12
金門縣,烏坵鄉,,0,0,297,0,297,361,5,3,4,1,3,0,82.27
連江縣,南竿鄉,,0,0,2991,40,3031,4613,15,7,13,2,6,1,65.71
連江縣,北竿鄉,,0,0,1107,13,1120,1397,6,5,3,3,3,2,80.17
連江縣,莒光鄉,,0,0,417,35,452,973,5,5,4,1,4,1,46.45
連江縣,東引鄉,,0,0,670,7,677,832,6,5,5,1,4,1,81.37
